Date,Price, Grid load forecast [MW], Wind power forecast (DK) [MWh],Wind power forecast (EE) [MWh],Wind power forecast (LT) [MWh],Wind power forecast (SE) [MWh],Wind power forecast (LV) [MWh],Total Wind [MWh],Hydro reservoir [GWh]
01/01/2015 00:00,27.48,42185,2362,83,87,3277,4,5813,469.297.619
01/01/2015 01:00,26.68,41207,2411,78,85,3328,5,5907,469.297.619
01/01/2015 02:00,26.23,40354,2482,72,89,3421,7,6071,469.297.619
01/01/2015 03:00,25.95,39965,2568,68,93,3479,7,6215,469.297.619
01/01/2015 04:00,25.91,39928,2657,67,97,3489,11,6321,469.297.619
01/01/2015 05:00,26.24,40379,2762,72,101,3438,14,6387,469.297.619
01/01/2015 06:00,26.81,40940,2932,77,106,3417,13,6545,469.297.619
01/01/2015 07:00,26.82,41796,3138,81,111,3424,16,6770,469.297.619
01/01/2015 08:00,26.96,42698,3293,86,118,3449,17,6963,469.297.619
01/01/2015 09:00,26.74,43493,3339,93,125,3437,19,7013,469.297.619
01/01/2015 10:00,26.75,44634,3305,101,132,3473,22,7033,469.297.619
01/01/2015 11:00,26.77,45284,3322,114,138,3471,23,7068,469.297.619
01/01/2015 12:00,26.79,45478,3343,129,144,3404,19,7039,469.297.619
01/01/2015 13:00,26.59,45607,3322,144,149,3441,18,7074,469.297.619
01/01/2015 14:00,27.01,46186,3297,153,148,3469,21,7088,469.297.619
01/01/2015 15:00,27.62,47386,3288,161,145,3564,23,7181,469.297.619
01/01/2015 16:00,28.29,48682,3366,167,138,3597,20,7288,469.297.619
01/01/2015 17:00,28.34,49260,3548,172,142,3625,22,7509,469.297.619
01/01/2015 18:00,28.22,48788,3751,176,140,3619,25,7711,469.297.619
01/01/2015 19:00,27.91,47788,3943,177,141,3643,23,7927,469.297.619
01/01/2015 20:00,27.54,46534,4086,175,146,3761,22,8190,469.297.619
01/01/2015 21:00,27.13,45764,4164,171,152,3802,20,8309,469.297.619
01/01/2015 22:00,26.92,44310,4225,169,153,3899,20,8466,469.297.619
01/01/2015 23:00,25.96,42544,4274,166,155,3966,26,8587,469.297.619
02/01/2015 00:00,24.79,41418,3648,168,183,4013,40,8052,469.297.619
02/01/2015 01:00,22.23,40382,3138,159,180,4012,27,7516,469.297.619
02/01/2015 02:00,20.93,39990,3155,152,181,3948,27,7463,469.297.619
02/01/2015 03:00,18.57,40070,3141,151,188,3910,29,7419,469.297.619
02/01/2015 04:00,18.59,40793,3148,159,195,3886,53,7441,469.297.619
02/01/2015 05:00,24.55,42806,3156,172,199,3863,56,7446,469.297.619
02/01/2015 06:00,27.1,45626,3718,187,206,3796,56,7963,469.297.619
02/01/2015 07:00,28.34,48926,3903,203,212,3772,57,8147,469.297.619
02/01/2015 08:00,28.4,50475,3868,221,219,3806,59,8173,469.297.619
02/01/2015 09:00,28.38,50627,3868,237,221,3853,60,8239,469.297.619
02/01/2015 10:00,28.34,50896,3864,246,222,3853,62,8247,469.297.619
02/01/2015 11:00,28.4,51014,3830,246,222,3983,62,8343,469.297.619
02/01/2015 12:00,28.32,50928,3758,239,222,4046,63,8328,469.297.619
02/01/2015 13:00,28.22,50858,3747,234,222,4165,39,8407,469.297.619
02/01/2015 14:00,28.16,51175,3814,225,222,4349,40,8650,469.297.619
02/01/2015 15:00,28.34,52049,3802,218,222,4422,40,8704,469.297.619
02/01/2015 16:00,28.67,53061,3788,215,222,4474,40,8739,469.297.619
02/01/2015 17:00,28.75,53466,3807,212,222,4474,40,8755,469.297.619
02/01/2015 18:00,28.55,52870,3838,209,222,4490,40,8799,469.297.619
02/01/2015 19:00,28.44,51831,3880,209,222,4502,40,8853,469.297.619
02/01/2015 20:00,27.94,50150,3917,208,222,4496,40,8883,469.297.619
02/01/2015 21:00,27.51,48906,3927,207,222,4523,40,8919,469.297.619
02/01/2015 22:00,27.2,47360,3920,205,222,4536,40,8923,469.297.619
02/01/2015 23:00,26.09,45123,3543,206,222,4560,40,8571,469.297.619
03/01/2015 00:00,24.61,43289,3435,249,215,4893,56,8848,469.297.619
03/01/2015 01:00,24.11,42189,3466,245,215,4907,57,8890,469.297.619
03/01/2015 02:00,23.31,41614,3513,239,215,4899,40,8906,469.297.619
03/01/2015 03:00,23.33,41375,3523,231,215,4889,40,8898,469.297.619
03/01/2015 04:00,23.44,41649,3490,223,215,4884,40,8852,469.297.619
03/01/2015 05:00,24.28,42505,3572,213,215,4850,40,8890,469.297.619
03/01/2015 06:00,24.4,43665,3553,209,215,4802,40,8819,469.297.619
03/01/2015 07:00,26.36,45539,3844,207,215,4757,56,9079,469.297.619
03/01/2015 08:00,26.65,48157,3863,204,215,4682,59,9023,469.297.619
03/01/2015 09:00,27.5,49165,3855,203,215,4606,62,8941,469.297.619
03/01/2015 10:00,27.72,50134,3839,204,215,4516,61,8835,469.297.619
03/01/2015 11:00,27.77,50216,3793,207,215,4416,61,8692,469.297.619
03/01/2015 12:00,27.72,49948,3704,209,215,4341,61,8530,469.297.619
03/01/2015 13:00,27.71,49716,3553,211,215,4236,59,8274,469.297.619
03/01/2015 14:00,27.87,50215,3377,211,205,4179,46,8018,469.297.619
03/01/2015 15:00,28.4,51512,3169,211,205,4044,51,7680,469.297.619
03/01/2015 16:00,28.97,53243,2951,210,200,3934,46,7341,469.297.619
03/01/2015 17:00,29.4,54105,2783,209,192,3842,49,7075,469.297.619
03/01/2015 18:00,29.46,53523,2700,207,182,3799,48,6936,469.297.619
03/01/2015 19:00,28.98,51900,2653,205,173,3706,50,6787,469.297.619
03/01/2015 20:00,28.4,50265,2647,204,168,3645,47,6711,469.297.619
03/01/2015 21:00,27.96,49376,2716,201,164,3592,45,6718,469.297.619
03/01/2015 22:00,27.76,47984,2771,199,162,3580,41,6753,469.297.619
03/01/2015 23:00,27.22,46347,2779,199,162,3629,37,6806,469.297.619
04/01/2015 00:00,27.42,44677,2944,191,155,3877,26,7193,469.297.619
04/01/2015 01:00,27.08,43748,2961,186,162,3892,29,7230,469.297.619
04/01/2015 02:00,26.81,43310,3007,180,164,3938,31,7320,469.297.619
04/01/2015 03:00,26.57,43263,3028,177,165,3949,33,7352,469.297.619
04/01/2015 04:00,26.64,43550,3014,179,165,3963,40,7361,469.297.619
04/01/2015 05:00,27.02,44107,3012,183,168,3958,46,7367,469.297.619
04/01/2015 06:00,27.09,44974,3014,188,177,3979,48,7406,469.297.619
04/01/2015 07:00,27.16,46344,3013,191,189,4007,50,7450,469.297.619
04/01/2015 08:00,27.64,47743,2986,192,198,3978,51,7405,469.297.619
04/01/2015 09:00,28.03,49208,2918,192,203,3960,51,7324,469.297.619
04/01/2015 10:00,28.22,50545,2882,192,210,3950,51,7285,469.297.619
04/01/2015 11:00,28.28,51222,2884,194,215,3912,53,7258,469.297.619
04/01/2015 12:00,28.23,51226,2880,197,215,3897,54,7243,469.297.619
04/01/2015 13:00,28.25,51153,2874,199,215,3817,54,7159,469.297.619
04/01/2015 14:00,28.33,51568,2814,202,215,3687,54,6972,469.297.619
04/01/2015 15:00,28.66,52617,2683,203,215,3566,55,6722,469.297.619
04/01/2015 16:00,29.28,54085,2511,201,215,3430,56,6413,469.297.619
04/01/2015 17:00,29.68,54979,2324,195,213,3348,56,6136,469.297.619
04/01/2015 18:00,29.86,54593,2158,188,212,3217,58,5833,469.297.619
04/01/2015 19:00,29.71,53680,1988,183,209,3082,56,5518,469.297.619
04/01/2015 20:00,29.22,52444,1787,180,204,2923,55,5149,469.297.619
04/01/2015 21:00,28.88,51570,1606,177,198,2787,54,4822,469.297.619
04/01/2015 22:00,28.82,49942,1454,173,192,2681,52,4552,469.297.619
04/01/2015 23:00,28.05,48108,1317,165,185,2600,49,4316,469.297.619
05/01/2015 00:00,28.54,46931,1589,154,176,2373,42,4334,4.545.595.238
05/01/2015 01:00,28.43,46012,1564,142,168,2218,35,4127,4.545.595.238
05/01/2015 02:00,28.41,45520,1602,137,162,2089,32,4022,4.545.595.238
05/01/2015 03:00,28.37,45549,1659,134,162,1937,34,3926,4.545.595.238
05/01/2015 04:00,28.5,46222,1613,133,159,1843,34,3782,4.545.595.238
05/01/2015 05:00,29.32,48190,1437,135,154,1702,37,3465,4.545.595.238
05/01/2015 06:00,30.48,51902,1202,133,149,1584,37,3105,4.545.595.238
05/01/2015 07:00,32.96,55855,970,129,143,1449,37,2728,4.545.595.238
05/01/2015 08:00,38.45,57447,720,128,138,1341,34,2361,4.545.595.238
05/01/2015 09:00,40.19,57652,489,127,134,1286,34,2070,4.545.595.238
05/01/2015 10:00,39.61,57981,327,125,130,1218,37,1837,4.545.595.238
05/01/2015 11:00,39.64,57740,252,122,127,1123,37,1661,4.545.595.238
05/01/2015 12:00,39.21,57225,214,119,124,949,38,1444,4.545.595.238
05/01/2015 13:00,39.72,56864,181,113,121,873,38,1326,4.545.595.238
05/01/2015 14:00,40.72,57135,155,108,118,800,37,1218,4.545.595.238
05/01/2015 15:00,42.11,58001,136,102,112,741,36,1127,4.545.595.238
05/01/2015 16:00,46.05,59240,122,98,107,693,33,1053,4.545.595.238
05/01/2015 17:00,48.72,59506,132,93,95,648,24,992,4.545.595.238
05/01/2015 18:00,48.75,58469,165,86,84,624,21,980,4.545.595.238
05/01/2015 19:00,46.02,57069,196,79,73,636,17,1001,4.545.595.238
05/01/2015 20:00,37.17,55438,238,69,59,604,11,981,4.545.595.238
05/01/2015 21:00,34.35,54171,301,61,48,583,9,1002,4.545.595.238
05/01/2015 22:00,31.83,52145,359,52,39,631,7,1088,4.545.595.238
05/01/2015 23:00,29.73,49615,422,44,32,645,5,1148,4.545.595.238
06/01/2015 00:00,29.59,48052,465,33,27,903,2,1430,4.545.595.238
06/01/2015 01:00,29.28,46889,493,22,22,1033,1,1571,4.545.595.238
06/01/2015 02:00,28.84,46386,517,16,19,1208,1,1761,4.545.595.238
06/01/2015 03:00,28.55,46300,563,12,17,1346,0,1938,4.545.595.238
06/01/2015 04:00,28.61,46700,654,11,15,1455,0,2135,4.545.595.238
06/01/2015 05:00,29.11,47771,769,12,14,1535,0,2330,4.545.595.238
06/01/2015 06:00,29.47,50430,894,14,12,1689,0,2609,4.545.595.238
06/01/2015 07:00,30.18,53414,1011,15,10,1809,0,2845,4.545.595.238
06/01/2015 08:00,30.7,54997,1149,15,7,1996,0,3167,4.545.595.238
06/01/2015 09:00,30.52,55790,1340,16,5,2160,0,3521,4.545.595.238
06/01/2015 10:00,30.74,56514,1548,15,4,2244,0,3811,4.545.595.238
06/01/2015 11:00,30.55,56764,1723,13,3,2399,0,4138,4.545.595.238
06/01/2015 12:00,30.07,56479,1850,11,4,2519,0,4384,4.545.595.238
06/01/2015 13:00,29.97,56493,1945,10,5,2503,2,4465,4.545.595.238
06/01/2015 14:00,30.03,56695,2031,10,6,2645,1,4693,4.545.595.238
06/01/2015 15:00,30.57,57448,2110,12,8,2797,3,4930,4.545.595.238
06/01/2015 16:00,30.95,58583,2188,15,10,2968,4,5185,4.545.595.238
06/01/2015 17:00,30.94,58804,2268,21,17,3201,5,5512,4.545.595.238
06/01/2015 18:00,30.57,57910,2353,29,25,3323,7,5737,4.545.595.238
06/01/2015 19:00,29.95,56514,2432,39,36,3362,7,5876,4.545.595.238
06/01/2015 20:00,29.57,54891,2455,50,45,3475,13,6038,4.545.595.238
06/01/2015 21:00,29.15,53582,2420,61,54,3520,13,6068,4.545.595.238
06/01/2015 22:00,28,51616,2246,73,63,3495,13,5890,4.545.595.238
06/01/2015 23:00,27.34,49292,1960,82,69,3506,15,5632,4.545.595.238
07/01/2015 00:00,26.38,47423,2298,116,68,3859,14,6355,4.545.595.238
07/01/2015 01:00,26.15,46415,2160,127,75,3796,13,6171,4.545.595.238
07/01/2015 02:00,26.09,46032,1972,138,80,3733,15,5938,4.545.595.238
07/01/2015 03:00,26.21,46166,1868,146,85,3603,17,5719,4.545.595.238
07/01/2015 04:00,26.7,47081,1779,154,91,3422,20,5466,4.545.595.238
07/01/2015 05:00,27.99,49450,1620,163,100,3223,24,5130,4.545.595.238
07/01/2015 06:00,30.07,53472,1461,172,109,2941,24,4707,4.545.595.238
07/01/2015 07:00,33.25,57359,1399,180,117,2715,32,4443,4.545.595.238
07/01/2015 08:00,34.07,59158,1422,187,123,2434,34,4200,4.545.595.238
07/01/2015 09:00,33.22,58170,1490,194,160,2192,38,4074,4.545.595.238
07/01/2015 10:00,33.6,58100,1541,200,167,2008,38,3954,4.545.595.238
07/01/2015 11:00,33.35,57672,1539,206,173,1951,39,3908,4.545.595.238
07/01/2015 12:00,32.73,57111,1529,212,176,1865,41,3823,4.545.595.238
07/01/2015 13:00,32.53,56924,1472,216,177,1778,44,3687,4.545.595.238
07/01/2015 14:00,32.68,57199,1393,216,177,1666,44,3496,4.545.595.238
07/01/2015 15:00,33.11,57819,1388,215,178,1585,44,3410,4.545.595.238
07/01/2015 16:00,34.3,58561,1554,214,175,1514,38,3495,4.545.595.238
07/01/2015 17:00,34.03,58608,1882,212,170,1553,35,3852,4.545.595.238
07/01/2015 18:00,32.54,57528,2227,211,164,1502,34,4138,4.545.595.238
07/01/2015 19:00,31.03,56045,2566,212,162,1477,34,4451,4.545.595.238
07/01/2015 20:00,29.64,54042,2908,216,160,1601,37,4922,4.545.595.238
07/01/2015 21:00,28.89,52426,3206,220,124,1793,34,5377,4.545.595.238
07/01/2015 22:00,27.69,50144,3456,222,119,2013,32,5842,4.545.595.238
07/01/2015 23:00,26.87,47461,3650,221,114,2258,30,6273,4.545.595.238
08/01/2015 00:00,26.24,46250,3879,234,127,2556,32,6828,4.545.595.238
08/01/2015 01:00,25.4,45224,3983,234,121,2803,33,7174,4.545.595.238
08/01/2015 02:00,24.74,44699,4037,237,121,3032,33,7460,4.545.595.238
08/01/2015 03:00,24.57,44716,4057,239,121,3349,32,7798,4.545.595.238
08/01/2015 04:00,24.65,45379,4031,237,121,3569,31,7989,4.545.595.238
08/01/2015 05:00,26.14,47764,3948,232,125,3722,33,8060,4.545.595.238
08/01/2015 06:00,27.58,51627,3801,227,128,3837,34,8027,4.545.595.238
08/01/2015 07:00,29.04,55018,3533,220,132,3838,33,7756,4.545.595.238
08/01/2015 08:00,29.5,55740,3159,214,140,3759,35,7307,4.545.595.238
08/01/2015 09:00,29.38,55878,2845,210,146,3633,40,6874,4.545.595.238
08/01/2015 10:00,29.41,55774,2624,207,152,3440,40,6463,4.545.595.238
08/01/2015 11:00,29.56,55457,2413,209,157,3261,40,6080,4.545.595.238
08/01/2015 12:00,29.57,54831,2200,213,171,3080,41,5705,4.545.595.238
08/01/2015 13:00,29.65,54652,2084,219,182,2905,42,5432,4.545.595.238
08/01/2015 14:00,29.73,54752,2115,224,188,2779,38,5344,4.545.595.238
08/01/2015 15:00,30.09,55443,2221,228,189,2619,40,5297,4.545.595.238
08/01/2015 16:00,30.6,56272,2346,228,185,2477,41,5277,4.545.595.238
08/01/2015 17:00,30.68,56463,2513,223,176,2423,42,5377,4.545.595.238
08/01/2015 18:00,30.05,55556,2759,218,156,2554,32,5719,4.545.595.238
08/01/2015 19:00,29.6,54297,3020,210,152,2553,35,5970,4.545.595.238
08/01/2015 20:00,28.59,52430,3210,196,143,2637,29,6215,4.545.595.238
08/01/2015 21:00,27.9,50916,3350,178,132,2810,23,6493,4.545.595.238
08/01/2015 22:00,27.08,48557,3470,165,121,2974,15,6745,4.545.595.238
08/01/2015 23:00,26.11,46003,3508,144,112,3119,13,6896,4.545.595.238
09/01/2015 00:00,25.75,45159,3261,97,97,2473,12,5940,4.545.595.238
09/01/2015 01:00,25.28,44269,3206,84,86,3268,11,6655,4.545.595.238
09/01/2015 02:00,25.11,43838,3110,71,102,3330,14,6627,4.545.595.238
09/01/2015 03:00,25.1,43949,3014,61,118,3322,17,6532,4.545.595.238
09/01/2015 04:00,25.45,44787,3018,54,133,3250,18,6473,4.545.595.238
09/01/2015 05:00,26.39,47322,3156,52,173,3125,30,6536,4.545.595.238
09/01/2015 06:00,27.31,51397,3347,55,192,2959,34,6587,4.545.595.238
09/01/2015 07:00,28.95,55390,3532,57,199,2790,32,6610,4.545.595.238
09/01/2015 08:00,29.45,56767,3636,60,202,2600,32,6530,4.545.595.238
09/01/2015 09:00,29.08,57758,3622,58,198,2407,38,6323,4.545.595.238
09/01/2015 10:00,29.21,57568,3511,57,200,2257,35,6060,4.545.595.238
09/01/2015 11:00,29.21,56876,3555,57,194,2119,28,5953,4.545.595.238
09/01/2015 12:00,29.19,55899,3607,57,179,1909,25,5777,4.545.595.238
09/01/2015 13:00,28.85,55450,3500,53,168,1956,23,5700,4.545.595.238
09/01/2015 14:00,28.61,55417,3286,48,144,1915,18,5411,4.545.595.238
09/01/2015 15:00,28.69,55801,2985,45,121,1904,11,5066,4.545.595.238
09/01/2015 16:00,29.09,56775,2803,40,97,1872,7,4819,4.545.595.238
09/01/2015 17:00,29.5,57187,3122,37,78,1845,4,5086,4.545.595.238
09/01/2015 18:00,29.25,56334,3645,35,65,1851,2,5598,4.545.595.238
09/01/2015 19:00,28.7,54733,3924,35,56,1850,2,5867,4.545.595.238
09/01/2015 20:00,27.92,52746,3834,36,52,1827,2,5751,4.545.595.238
09/01/2015 21:00,27.38,51355,3320,36,48,1789,2,5195,4.545.595.238
09/01/2015 22:00,27.06,49491,2716,37,43,1736,1,4533,4.545.595.238
09/01/2015 23:00,26.35,47349,2312,39,38,1645,10,4044,4.545.595.238
10/01/2015 00:00,26.32,45645,2450,26,28,1379,2,3885,4.545.595.238
10/01/2015 01:00,26.12,44526,1872,28,27,1267,3,3197,4.545.595.238
10/01/2015 02:00,25.83,43987,1484,33,25,1140,2,2684,4.545.595.238
10/01/2015 03:00,25.79,43997,1362,37,24,999,2,2424,4.545.595.238
10/01/2015 04:00,25.88,44431,1502,41,24,889,3,2459,4.545.595.238
10/01/2015 05:00,25.71,45348,1968,41,21,794,2,2826,4.545.595.238
10/01/2015 06:00,25.94,46568,2675,39,19,810,0,3543,4.545.595.238
10/01/2015 07:00,26.46,48477,3266,37,17,951,0,4271,4.545.595.238
10/01/2015 08:00,26.85,50242,3663,34,19,1184,0,4900,4.545.595.238
10/01/2015 09:00,27.05,51818,3904,32,24,1591,1,5552,4.545.595.238
10/01/2015 10:00,27.25,52928,3903,29,29,2104,1,6066,4.545.595.238
10/01/2015 11:00,27.01,53125,3685,25,45,2520,2,6277,4.545.595.238
10/01/2015 12:00,26.81,52838,3291,26,66,2867,4,6254,4.545.595.238
10/01/2015 13:00,26.62,52488,3258,35,88,3137,7,6525,4.545.595.238
10/01/2015 14:00,26.58,52732,3442,52,110,3428,15,7047,4.545.595.238
10/01/2015 15:00,26.71,53782,3481,76,137,3577,24,7295,4.545.595.238
10/01/2015 16:00,26.95,55339,3523,103,161,3782,39,7608,4.545.595.238
10/01/2015 17:00,27.29,56100,3548,130,185,3784,43,7690,4.545.595.238
10/01/2015 18:00,26.97,55430,3543,153,202,3630,50,7578,4.545.595.238
10/01/2015 19:00,26.63,53634,3560,170,204,3643,51,7628,4.545.595.238
10/01/2015 20:00,26.68,51872,3574,181,206,3640,57,7658,4.545.595.238
10/01/2015 21:00,26.46,50884,3616,189,215,3628,56,7704,4.545.595.238
10/01/2015 22:00,26.06,49456,3799,191,215,3680,55,7940,4.545.595.238
10/01/2015 23:00,25.63,47733,3988,184,215,3671,55,8113,4.545.595.238
11/01/2015 00:00,24.84,46164,2898,147,210,3754,39,7048,4.545.595.238
11/01/2015 01:00,24.09,45242,3011,141,208,3827,40,7227,4.545.595.238
11/01/2015 02:00,23.82,44826,3333,130,204,3786,39,7492,4.545.595.238
11/01/2015 03:00,23.22,44715,3625,118,200,3820,39,7802,4.545.595.238
11/01/2015 04:00,23.35,44924,3772,105,194,3841,40,7952,4.545.595.238
11/01/2015 05:00,23.65,45521,3814,93,194,3861,40,8002,4.545.595.238
11/01/2015 06:00,23.83,46450,3829,83,194,3867,40,8013,4.545.595.238
11/01/2015 07:00,24.41,47875,4238,78,194,3814,39,8363,4.545.595.238
11/01/2015 08:00,25.05,49758,4233,81,194,3780,39,8327,4.545.595.238
11/01/2015 09:00,25.83,51243,4222,89,194,3682,39,8226,4.545.595.238
11/01/2015 10:00,26.22,52553,4223,97,194,3515,39,8068,4.545.595.238
11/01/2015 11:00,26.54,53361,4186,103,198,3424,39,7950,4.545.595.238
11/01/2015 12:00,26.51,53570,4140,111,201,3134,39,7625,4.545.595.238
11/01/2015 13:00,26.38,53762,4094,117,206,2926,39,7382,4.545.595.238
11/01/2015 14:00,26.37,54242,4106,120,211,2816,39,7292,4.545.595.238
11/01/2015 15:00,26.71,55284,4098,126,215,2707,39,7185,4.545.595.238
11/01/2015 16:00,27.57,56731,4143,143,215,2586,39,7126,4.545.595.238
11/01/2015 17:00,27.94,57694,4196,153,215,2487,38,7089,4.545.595.238
11/01/2015 18:00,27.97,57282,4172,154,215,2444,36,7021,4.545.595.238
11/01/2015 19:00,27.76,56241,4089,146,213,2322,30,6800,4.545.595.238
11/01/2015 20:00,27.46,54983,3917,143,209,2198,15,6482,4.545.595.238
11/01/2015 21:00,27.1,54121,3669,141,203,2029,15,6057,4.545.595.238
11/01/2015 22:00,26.73,52667,3439,140,197,1928,18,5722,4.545.595.238
11/01/2015 23:00,26.24,50856,3324,136,189,1759,17,5425,4.545.595.238
12/01/2015 00:00,26.99,49829,2746,154,175,1488,44,4607,438.625
12/01/2015 01:00,26.83,49091,2893,150,171,1316,41,4571,438.625
12/01/2015 02:00,26.45,48889,3246,144,168,1177,39,4774,438.625
12/01/2015 03:00,26.36,49205,3582,141,164,1155,42,5084,438.625
12/01/2015 04:00,26.56,50276,3810,136,170,1198,43,5357,438.625
12/01/2015 05:00,27.44,52891,3939,128,150,1353,46,5616,438.625
12/01/2015 06:00,29.55,57184,4012,116,128,1477,46,5779,438.625
12/01/2015 07:00,34.29,61548,4068,96,105,1696,36,6001,438.625
12/01/2015 08:00,34.71,63400,4115,73,79,1969,17,6253,438.625
12/01/2015 09:00,34.03,63081,4149,57,55,2161,12,6434,438.625
12/01/2015 10:00,31.76,62892,4177,49,35,2378,8,6647,438.625
12/01/2015 11:00,30.35,62457,4200,41,36,2603,8,6888,438.625
12/01/2015 12:00,29.69,61706,4235,33,38,2806,7,7119,438.625
12/01/2015 13:00,29.65,61476,4271,24,42,3029,4,7370,438.625
12/01/2015 14:00,29.46,61487,4292,18,73,3192,5,7580,438.625
12/01/2015 15:00,29.83,61819,4296,16,105,3378,5,7800,438.625
12/01/2015 16:00,30.14,62465,4291,21,135,3559,9,8015,438.625
12/01/2015 17:00,30.81,62595,4275,32,152,3697,19,8175,438.625
12/01/2015 18:00,30.21,61726,4248,55,168,3717,27,8215,438.625
12/01/2015 19:00,28.95,60403,4212,89,177,3768,31,8277,438.625
12/01/2015 20:00,27.92,58476,4155,118,190,3760,40,8263,438.625
12/01/2015 21:00,27.57,56884,4068,141,203,3733,44,8189,438.625
12/01/2015 22:00,27.12,54629,3931,158,214,3685,45,8033,438.625
12/01/2015 23:00,26.42,51983,3706,178,215,3553,45,7697,438.625
13/01/2015 00:00,26.26,48956,3136,219,215,3607,54,7231,438.625
13/01/2015 01:00,26.07,47987,2550,224,215,3442,54,6485,438.625
13/01/2015 02:00,26.02,47613,2003,221,215,3267,51,5757,438.625
13/01/2015 03:00,25.95,47722,1645,221,215,3081,49,5211,438.625
13/01/2015 04:00,26.23,48610,1529,224,215,2873,43,4884,438.625
13/01/2015 05:00,27.1,51352,1548,226,212,2669,44,4699,438.625
13/01/2015 06:00,29.58,55350,1615,231,204,2516,42,4608,438.625
13/01/2015 07:00,32.81,59530,1722,232,184,2446,37,4621,438.625
13/01/2015 08:00,33.97,60438,1891,232,166,2375,30,4694,438.625
13/01/2015 09:00,32.07,60157,2042,227,147,2380,24,4820,438.625
13/01/2015 10:00,31.17,60051,2169,221,123,2383,19,4915,438.625
13/01/2015 11:00,30.01,59730,2314,207,104,2338,14,4977,438.625
13/01/2015 12:00,29.74,59317,2404,191,85,2329,10,5019,438.625
13/01/2015 13:00,29.64,59247,2383,168,70,2319,10,4950,438.625
13/01/2015 14:00,30.24,59410,2192,146,93,2287,10,4728,438.625
13/01/2015 15:00,31.75,59909,1950,124,120,2280,9,4483,438.625
13/01/2015 16:00,32.59,60559,1729,112,144,2354,10,4349,438.625
13/01/2015 17:00,34.05,60766,1654,105,153,2330,16,4258,438.625
13/01/2015 18:00,33.34,59816,1726,103,162,2319,27,4337,438.625
13/01/2015 19:00,31.37,58487,1884,104,170,2318,33,4509,438.625
13/01/2015 20:00,29.23,56444,2117,102,172,2314,36,4741,438.625
13/01/2015 21:00,28.55,54763,2396,101,171,2275,40,4983,438.625
13/01/2015 22:00,27.91,52488,2628,98,165,2148,40,5079,438.625
13/01/2015 23:00,26.5,49907,2738,92,172,2105,39,5146,438.625
14/01/2015 00:00,26.1,47416,2176,111,170,2069,36,4562,438.625
14/01/2015 01:00,25.82,46480,2350,130,172,2034,32,4718,438.625
14/01/2015 02:00,25.72,46156,2543,146,141,2018,34,4882,438.625
14/01/2015 03:00,25.73,46378,2748,177,124,1984,30,5063,438.625
14/01/2015 04:00,25.91,47214,2785,195,108,2056,23,5167,438.625
14/01/2015 05:00,26.6,49505,2706,193,105,2091,15,5110,438.625
14/01/2015 06:00,28.46,53520,2702,177,101,2097,11,5088,438.625
14/01/2015 07:00,30.83,57590,2731,163,96,2185,12,5187,438.625
14/01/2015 08:00,33.41,58557,2718,154,101,2141,10,5124,438.625
14/01/2015 09:00,32.16,57877,2763,148,105,2072,9,5097,438.625
14/01/2015 10:00,31.25,58070,2879,142,110,2098,12,5241,438.625
14/01/2015 11:00,30.89,58028,2971,139,113,2099,17,5339,438.625
14/01/2015 12:00,29.99,57602,3014,138,118,2179,17,5466,438.625
14/01/2015 13:00,29.91,57460,2973,139,122,2190,21,5445,438.625
14/01/2015 14:00,30.82,57471,2807,139,125,2182,34,5287,438.625
14/01/2015 15:00,32.78,58051,2629,136,123,2167,45,5100,438.625
14/01/2015 16:00,34.23,59136,2502,139,120,2123,50,4934,438.625
14/01/2015 17:00,35.47,59553,2393,140,122,2109,48,4812,438.625
14/01/2015 18:00,34.28,58624,2316,142,125,2122,41,4746,438.625
14/01/2015 19:00,31.05,57271,2317,144,128,2178,37,4804,438.625
14/01/2015 20:00,29.14,55366,2370,151,126,2227,30,4904,438.625
14/01/2015 21:00,28.49,53850,2469,150,123,2228,26,4996,438.625
14/01/2015 22:00,27.13,51795,2574,146,120,2131,17,4988,438.625
14/01/2015 23:00,26.31,49504,2671,137,114,2179,15,5116,438.625
15/01/2015 00:00,26.44,47756,2407,70,135,2213,4,4829,438.625
15/01/2015 01:00,26.03,46872,2511,73,130,2216,5,4935,438.625
15/01/2015 02:00,25.78,46525,2645,80,115,2246,8,5094,438.625
15/01/2015 03:00,25.8,46638,2887,84,100,2256,8,5335,438.625
15/01/2015 04:00,26.11,47409,3221,88,87,2262,8,5666,438.625
15/01/2015 05:00,26.82,49773,3570,89,80,2204,7,5950,438.625
15/01/2015 06:00,28.62,53597,3854,91,73,2204,7,6229,438.625
15/01/2015 07:00,30.04,57400,4041,92,67,2241,8,6449,438.625
15/01/2015 08:00,30.59,58775,4148,92,58,2361,7,6666,438.625
15/01/2015 09:00,29.62,58381,4194,92,49,2655,5,6995,438.625
15/01/2015 10:00,29.31,58307,4248,92,41,2870,5,7256,438.625
15/01/2015 11:00,28.93,57944,4236,91,45,3028,7,7407,438.625
15/01/2015 12:00,28.68,57521,4192,91,50,3225,8,7566,438.625
15/01/2015 13:00,28.59,57385,4101,88,58,3397,7,7651,438.625
15/01/2015 14:00,28.65,57513,3944,86,69,3563,8,7670,438.625
15/01/2015 15:00,28.83,58095,3739,89,83,3698,9,7618,438.625
15/01/2015 16:00,29.55,58971,3587,100,97,3856,13,7653,438.625
15/01/2015 17:00,30.21,59298,3564,118,116,3954,15,7767,438.625
15/01/2015 18:00,29.64,58356,3603,135,136,3958,20,7852,438.625
15/01/2015 19:00,28.55,57035,3694,151,156,3956,27,7984,438.625
15/01/2015 20:00,27.75,55121,3791,166,160,3887,31,8035,438.625
15/01/2015 21:00,27.3,53494,3895,181,176,3849,33,8134,438.625
15/01/2015 22:00,26.58,51154,3973,191,184,3794,34,8176,438.625
15/01/2015 23:00,25.85,48423,3993,200,187,3740,39,8159,438.625
16/01/2015 00:00,25.66,45462,3977,223,188,3632,40,8060,438.625
16/01/2015 01:00,25.22,44524,3927,228,189,3631,38,8013,438.625
16/01/2015 02:00,24.95,44183,3898,233,186,3602,38,7957,438.625
16/01/2015 03:00,24.65,44353,3894,237,183,3606,39,7959,438.625
16/01/2015 04:00,25.22,45227,3907,240,180,3594,40,7961,438.625
16/01/2015 05:00,26.38,47713,3958,240,175,3563,43,7979,438.625
16/01/2015 06:00,27.7,51875,4017,238,169,3580,45,8049,438.625
16/01/2015 07:00,29.07,55974,4129,237,163,3603,49,8181,438.625
16/01/2015 08:00,29.35,57421,4280,234,155,3637,49,8355,438.625
16/01/2015 09:00,29.09,57171,4306,234,148,3634,48,8370,438.625
16/01/2015 10:00,28.94,56999,4253,234,139,3676,44,8346,438.625
16/01/2015 11:00,28.78,56521,4164,234,135,3671,42,8246,438.625
16/01/2015 12:00,28.45,55867,4013,235,129,3676,39,8092,438.625
16/01/2015 13:00,28.37,55427,3790,236,126,3688,39,7879,438.625
16/01/2015 14:00,28.47,55063,3462,239,117,3611,41,7470,438.625
16/01/2015 15:00,28.8,55276,3046,242,110,3624,40,7062,438.625
16/01/2015 16:00,29.46,56172,2617,244,104,3553,40,6558,438.625
16/01/2015 17:00,30.35,56587,2273,247,98,3479,40,6137,438.625
16/01/2015 18:00,31.2,55619,1982,246,94,3410,39,5771,438.625
16/01/2015 19:00,29.16,54014,1760,245,89,3285,37,5416,438.625
16/01/2015 20:00,28.4,51980,1614,244,81,3213,30,5182,438.625
16/01/2015 21:00,28.22,50470,1515,244,73,3123,25,4980,438.625
16/01/2015 22:00,28.03,48730,1447,244,64,3049,17,4821,438.625
16/01/2015 23:00,27.34,46633,1410,243,57,2965,16,4691,438.625
17/01/2015 00:00,27.32,44474,1453,241,51,2717,9,4471,438.625
17/01/2015 01:00,26.93,43400,1483,235,44,2668,7,4437,438.625
17/01/2015 02:00,26.8,42832,1508,226,38,2645,4,4421,438.625
17/01/2015 03:00,26.82,42777,1532,212,33,2609,3,4389,438.625
17/01/2015 04:00,26.77,43144,1591,199,28,2534,3,4355,438.625
17/01/2015 05:00,26.88,43953,1720,189,26,2443,4,4382,438.625
17/01/2015 06:00,27.1,45182,1870,181,24,2372,4,4451,438.625
17/01/2015 07:00,27.96,47036,1965,174,23,2302,3,4467,438.625
17/01/2015 08:00,28.47,48981,2016,171,21,2285,2,4495,438.625
17/01/2015 09:00,29.09,50533,2056,165,19,2295,1,4536,438.625
17/01/2015 10:00,29.29,51531,2148,156,17,2341,0,4662,438.625
17/01/2015 11:00,29.1,51531,2298,142,14,2363,0,4817,438.625
17/01/2015 12:00,28.61,51408,2457,129,12,2466,0,5064,438.625
17/01/2015 13:00,28.24,51063,2531,121,10,2443,1,5106,438.625
17/01/2015 14:00,28.16,51123,2441,116,14,2468,2,5041,438.625
17/01/2015 15:00,28.58,52278,2273,113,19,2491,3,4899,438.625
17/01/2015 16:00,29.33,54025,2169,112,25,2504,4,4814,438.625
17/01/2015 17:00,30.39,55032,2124,111,33,2520,6,4794,438.625
17/01/2015 18:00,29.77,54315,2112,111,41,2518,7,4789,438.625
17/01/2015 19:00,28.94,52464,2094,114,50,2478,7,4743,438.625
17/01/2015 20:00,27.94,50648,2086,121,54,2422,7,4690,438.625
17/01/2015 21:00,27.67,49608,2095,130,57,2392,7,4681,438.625
17/01/2015 22:00,27.38,48197,2091,139,59,2391,5,4685,438.625
17/01/2015 23:00,26.7,46586,2048,145,56,2374,4,4627,438.625
18/01/2015 00:00,26.26,44694,1925,194,99,2588,21,4827,438.625
18/01/2015 01:00,25.97,43666,1777,195,95,2548,20,4635,438.625
18/01/2015 02:00,25.64,43168,1627,196,91,2465,20,4399,438.625
18/01/2015 03:00,25.68,43076,1539,195,88,2412,21,4255,438.625
18/01/2015 04:00,25.39,43243,1456,192,85,2259,20,4012,438.625
18/01/2015 05:00,25.79,43674,1352,188,80,2133,19,3772,438.625
18/01/2015 06:00,26.43,44440,1271,186,75,2054,17,3603,438.625
18/01/2015 07:00,26.78,45715,1191,183,70,1941,18,3403,438.625
18/01/2015 08:00,27.11,46782,1093,180,62,1890,17,3242,438.625
18/01/2015 09:00,27.46,48286,1018,178,54,1755,14,3019,438.625
18/01/2015 10:00,27.9,49513,961,176,46,1630,14,2827,438.625
18/01/2015 11:00,28.24,50135,885,173,39,1535,14,2646,438.625
18/01/2015 12:00,28.16,50141,810,169,33,1440,13,2465,438.625
18/01/2015 13:00,27.89,50073,692,161,28,1324,11,2216,438.625
18/01/2015 14:00,28.25,50332,558,153,20,1303,10,2044,438.625
18/01/2015 15:00,29.24,51279,446,142,20,1249,7,1864,438.625
18/01/2015 16:00,30.45,52783,378,135,21,1227,6,1767,438.625
18/01/2015 17:00,32.32,53862,352,127,24,1198,5,1706,438.625
18/01/2015 18:00,32.34,53466,343,119,28,1205,5,1700,438.625
18/01/2015 19:00,30.93,52437,332,109,31,1240,4,1716,438.625
18/01/2015 20:00,29.8,51054,312,98,32,1188,4,1634,438.625
18/01/2015 21:00,29.66,49999,296,86,31,1108,4,1525,438.625
18/01/2015 22:00,29.34,48260,260,73,30,1063,3,1429,438.625
18/01/2015 23:00,28.47,46390,216,59,27,1036,3,1341,438.625
19/01/2015 00:00,27.89,45223,193,72,25,993,1,1284,4.141.428.571
19/01/2015 01:00,27.67,44421,159,66,21,942,1,1189,4.141.428.571
19/01/2015 02:00,27.61,44269,130,59,19,931,1,1140,4.141.428.571
19/01/2015 03:00,27.7,44604,109,51,17,894,1,1072,4.141.428.571
19/01/2015 04:00,28.03,45683,101,41,16,888,1,1047,4.141.428.571
19/01/2015 05:00,29.16,48518,92,30,17,920,1,1060,4.141.428.571
19/01/2015 06:00,32.08,53111,87,22,19,921,1,1050,4.141.428.571
19/01/2015 07:00,38.7,57720,90,19,20,878,0,1007,4.141.428.571
19/01/2015 08:00,44.76,59189,96,17,18,890,0,1021,4.141.428.571
19/01/2015 09:00,40.41,58775,115,14,16,914,0,1059,4.141.428.571
19/01/2015 10:00,37.62,58671,134,11,14,936,1,1096,4.141.428.571
19/01/2015 11:00,36.19,58514,149,8,11,993,1,1162,4.141.428.571
19/01/2015 12:00,40.44,58185,163,7,8,1040,1,1219,4.141.428.571
19/01/2015 13:00,42.68,57974,167,6,7,1042,1,1223,4.141.428.571
19/01/2015 14:00,41.79,58011,182,8,4,1111,1,1306,4.141.428.571
19/01/2015 15:00,36.55,58473,216,10,5,1203,0,1434,4.141.428.571
19/01/2015 16:00,37.22,59349,269,14,9,1296,0,1588,4.141.428.571
19/01/2015 17:00,42.89,59825,346,17,14,1357,0,1734,4.141.428.571
19/01/2015 18:00,35.22,59049,449,20,20,1440,0,1929,4.141.428.571
19/01/2015 19:00,31.97,57729,515,21,26,1491,0,2053,4.141.428.571
19/01/2015 20:00,30.49,55811,530,22,30,1454,1,2037,4.141.428.571
19/01/2015 21:00,29.88,54295,551,23,34,1479,1,2088,4.141.428.571
19/01/2015 22:00,29.11,51913,571,24,37,1447,1,2080,4.141.428.571
19/01/2015 23:00,28.6,49301,536,26,38,1413,0,2013,4.141.428.571
20/01/2015 00:00,28.61,47544,441,11,42,1233,1,1728,4.141.428.571
20/01/2015 01:00,28.21,46554,451,11,47,1269,1,1779,4.141.428.571
20/01/2015 02:00,28.06,46237,472,11,50,1312,3,1848,4.141.428.571
20/01/2015 03:00,28.02,46436,471,11,54,1337,3,1876,4.141.428.571
20/01/2015 04:00,28.38,47808,495,12,59,1422,4,1992,4.141.428.571
20/01/2015 05:00,29.55,50425,534,14,66,1473,7,2094,4.141.428.571
20/01/2015 06:00,32,54870,554,16,73,1550,7,2200,4.141.428.571
20/01/2015 07:00,44.42,59322,553,18,80,1612,9,2272,4.141.428.571
20/01/2015 08:00,45.01,61784,550,19,82,1652,11,2314,4.141.428.571
20/01/2015 09:00,44.05,61077,592,22,85,1693,11,2403,4.141.428.571
20/01/2015 10:00,40.56,60905,589,25,87,1708,12,2421,4.141.428.571
20/01/2015 11:00,38.96,60517,571,27,85,1736,14,2433,4.141.428.571
20/01/2015 12:00,36.94,59814,541,30,83,1724,14,2392,4.141.428.571
20/01/2015 13:00,37.36,59758,514,35,82,1725,15,2371,4.141.428.571
20/01/2015 14:00,37.46,59742,490,42,78,1681,16,2307,4.141.428.571
20/01/2015 15:00,38.97,60226,481,49,84,1768,16,2398,4.141.428.571
20/01/2015 16:00,44.51,61008,468,54,91,1746,16,2375,4.141.428.571
20/01/2015 17:00,45.26,61368,448,60,94,1772,18,2392,4.141.428.571
20/01/2015 18:00,44.41,60448,414,66,98,1811,20,2409,4.141.428.571
20/01/2015 19:00,33.32,59092,348,71,101,1752,22,2294,4.141.428.571
20/01/2015 20:00,30.75,57164,293,74,101,1725,22,2215,4.141.428.571
20/01/2015 21:00,30.12,55505,232,77,101,1731,21,2162,4.141.428.571
20/01/2015 22:00,29.42,52990,180,79,98,1661,22,2040,4.141.428.571
20/01/2015 23:00,28.5,50503,148,78,94,1657,22,1999,4.141.428.571
21/01/2015 00:00,28.15,48601,246,91,103,1606,27,2073,4.141.428.571
21/01/2015 01:00,27.89,47551,205,93,99,1560,26,1983,4.141.428.571
21/01/2015 02:00,27.8,47135,166,94,98,1520,26,1904,4.141.428.571
21/01/2015 03:00,27.87,47378,132,94,98,1498,25,1847,4.141.428.571
21/01/2015 04:00,28.22,48557,119,96,97,1446,25,1783,4.141.428.571
21/01/2015 05:00,29.62,51319,111,96,96,1387,26,1716,4.141.428.571
21/01/2015 06:00,32.67,55888,113,98,94,1323,25,1653,4.141.428.571
21/01/2015 07:00,46.3,60222,115,100,92,1238,24,1569,4.141.428.571
21/01/2015 08:00,50.48,61609,111,101,86,1194,25,1517,4.141.428.571
21/01/2015 09:00,49.63,61130,107,100,79,1145,24,1455,4.141.428.571
21/01/2015 10:00,46.39,61087,100,97,72,1077,23,1369,4.141.428.571
21/01/2015 11:00,46.33,60947,88,94,58,1017,22,1279,4.141.428.571
21/01/2015 12:00,44.71,60504,86,91,46,957,20,1200,4.141.428.571
21/01/2015 13:00,43.41,60162,80,91,36,920,17,1144,4.141.428.571
21/01/2015 14:00,43.39,60235,66,92,24,890,16,1088,4.141.428.571
21/01/2015 15:00,45.19,60766,56,95,22,858,10,1041,4.141.428.571
21/01/2015 16:00,47.15,61623,56,95,21,830,8,1010,4.141.428.571
21/01/2015 17:00,52.37,61961,61,95,22,780,8,966,4.141.428.571
21/01/2015 18:00,51.88,60975,64,91,22,714,8,899,4.141.428.571
21/01/2015 19:00,37.49,59585,65,86,23,682,5,861,4.141.428.571
21/01/2015 20:00,33.11,57655,61,80,23,663,5,832,4.141.428.571
21/01/2015 21:00,32.46,56036,59,77,22,669,4,831,4.141.428.571
21/01/2015 22:00,31.3,53624,57,74,20,652,4,807,4.141.428.571
21/01/2015 23:00,29.36,50936,53,69,18,648,2,790,4.141.428.571
22/01/2015 00:00,28.8,49336,42,66,9,610,2,729,4.141.428.571
22/01/2015 01:00,28.51,48278,38,66,7,586,1,698,4.141.428.571
22/01/2015 02:00,28.3,47900,40,66,5,571,1,683,4.141.428.571
22/01/2015 03:00,28.26,48038,44,65,5,559,1,674,4.141.428.571
22/01/2015 04:00,28.57,48945,46,63,4,570,1,684,4.141.428.571
22/01/2015 05:00,29.97,51778,47,60,5,569,1,682,4.141.428.571
22/01/2015 06:00,33.96,56254,50,56,6,524,1,637,4.141.428.571
22/01/2015 07:00,45.11,60485,49,52,7,499,1,608,4.141.428.571
22/01/2015 08:00,50.08,61946,54,49,7,477,1,588,4.141.428.571
22/01/2015 09:00,45.96,61390,56,46,6,443,1,552,4.141.428.571
22/01/2015 10:00,45.82,61198,59,43,5,400,0,507,4.141.428.571
22/01/2015 11:00,45.78,60769,68,41,4,372,0,485,4.141.428.571
22/01/2015 12:00,45,60574,80,40,4,357,0,481,4.141.428.571
22/01/2015 13:00,44.38,60534,84,43,4,336,0,467,4.141.428.571
22/01/2015 14:00,44.89,60591,84,45,3,337,0,469,4.141.428.571
22/01/2015 15:00,44.99,61102,82,46,3,341,0,472,4.141.428.571
22/01/2015 16:00,49.82,61884,86,47,4,345,0,482,4.141.428.571
22/01/2015 17:00,56.67,62404,91,47,7,338,0,483,4.141.428.571
22/01/2015 18:00,50.06,61573,104,47,11,337,0,499,4.141.428.571
22/01/2015 19:00,44.09,60266,114,45,14,351,0,524,4.141.428.571
22/01/2015 20:00,35.88,58317,128,44,16,344,0,532,4.141.428.571
22/01/2015 21:00,36.2,56690,149,43,16,331,0,539,4.141.428.571
22/01/2015 22:00,32.37,54224,167,42,16,328,0,553,4.141.428.571
22/01/2015 23:00,30.07,51609,160,21,14,331,0,526,4.141.428.571
23/01/2015 00:00,29.87,50277,109,11,8,302,1,431,4.141.428.571
23/01/2015 01:00,29.17,49242,111,11,7,295,2,426,4.141.428.571
23/01/2015 02:00,28.86,48903,110,11,6,294,2,423,4.141.428.571
23/01/2015 03:00,28.79,49110,112,11,5,297,3,428,4.141.428.571
23/01/2015 04:00,29.24,50155,110,12,5,294,2,423,4.141.428.571
23/01/2015 05:00,31,52975,105,12,5,290,2,414,4.141.428.571
23/01/2015 06:00,35.92,57662,100,12,6,280,2,400,4.141.428.571
23/01/2015 07:00,54.95,62216,95,14,6,271,2,388,4.141.428.571
23/01/2015 08:00,53.57,63388,97,15,6,269,2,389,4.141.428.571
23/01/2015 09:00,57.68,63166,111,17,6,254,2,390,4.141.428.571
23/01/2015 10:00,55.02,63047,135,19,5,244,1,404,4.141.428.571
23/01/2015 11:00,52.42,62641,177,20,5,234,1,437,4.141.428.571
23/01/2015 12:00,47.63,62004,242,21,5,239,1,508,4.141.428.571
23/01/2015 13:00,44.95,61275,315,21,4,255,1,596,4.141.428.571
23/01/2015 14:00,42.47,60828,383,22,5,295,0,705,4.141.428.571
23/01/2015 15:00,40.96,60910,485,23,7,338,0,853,4.141.428.571
23/01/2015 16:00,44.11,61845,616,23,10,393,0,1042,4.141.428.571
23/01/2015 17:00,48.08,62674,767,23,14,442,0,1246,4.141.428.571
23/01/2015 18:00,45.07,61909,958,22,19,557,1,1557,4.141.428.571
23/01/2015 19:00,31.97,60259,1205,22,24,656,1,1908,4.141.428.571
23/01/2015 20:00,30.46,58087,1483,20,23,772,0,2298,4.141.428.571
23/01/2015 21:00,29.85,56457,1782,18,22,894,0,2716,4.141.428.571
23/01/2015 22:00,28.9,54487,2076,17,21,1019,0,3133,4.141.428.571
23/01/2015 23:00,28.53,52199,2335,15,17,1142,0,3509,4.141.428.571
24/01/2015 00:00,28.01,50356,2886,27,10,1519,0,4442,4.141.428.571
24/01/2015 01:00,27.14,49089,3051,27,7,1681,0,4766,4.141.428.571
24/01/2015 02:00,26.46,48421,3151,26,6,1837,0,5020,4.141.428.571
24/01/2015 03:00,26.23,48168,3203,25,5,1983,0,5216,4.141.428.571
24/01/2015 04:00,26.45,48293,3226,24,4,2083,0,5337,4.141.428.571
24/01/2015 05:00,26.75,48885,3217,23,4,2190,0,5434,4.141.428.571
24/01/2015 06:00,27.08,49946,3138,22,5,2309,0,5474,4.141.428.571
24/01/2015 07:00,27.55,51813,2880,21,5,2359,1,5266,4.141.428.571
24/01/2015 08:00,28.15,53596,2446,22,6,2422,1,4897,4.141.428.571
24/01/2015 09:00,28.96,55095,2151,26,6,2454,1,4638,4.141.428.571
24/01/2015 10:00,29.24,56044,1928,29,6,2485,1,4449,4.141.428.571
24/01/2015 11:00,29.28,56079,1759,34,6,2443,2,4244,4.141.428.571
24/01/2015 12:00,29.22,55691,1722,38,6,2328,3,4097,4.141.428.571
24/01/2015 13:00,29.18,55107,1598,41,6,2193,3,3841,4.141.428.571
24/01/2015 14:00,29.2,54984,1403,42,5,2011,2,3463,4.141.428.571
24/01/2015 15:00,29.34,55511,1315,46,7,1861,2,3231,4.141.428.571
24/01/2015 16:00,29.97,57104,1274,51,10,1704,3,3042,4.141.428.571
24/01/2015 17:00,30.67,58208,1287,56,14,1540,2,2899,4.141.428.571
24/01/2015 18:00,30.38,57513,1327,63,19,1426,2,2837,4.141.428.571
24/01/2015 19:00,29.59,55514,1318,67,23,1276,2,2686,4.141.428.571
24/01/2015 20:00,29.22,53668,1323,69,22,1161,2,2577,4.141.428.571
24/01/2015 21:00,28.51,52509,1415,68,21,1099,1,2604,4.141.428.571
24/01/2015 22:00,28.14,50992,1435,66,19,1010,1,2531,4.141.428.571
24/01/2015 23:00,27.68,49329,1436,61,16,954,1,2468,4.141.428.571
25/01/2015 00:00,26.99,47287,1455,74,6,892,0,2427,4.141.428.571
25/01/2015 01:00,26.57,46200,1448,68,4,897,0,2417,4.141.428.571
25/01/2015 02:00,26.41,45696,1391,61,4,870,0,2326,4.141.428.571
25/01/2015 03:00,26.27,45515,1317,54,4,848,0,2223,4.141.428.571
25/01/2015 04:00,26.43,45626,1264,48,5,855,0,2172,4.141.428.571
25/01/2015 05:00,26.82,46181,1193,42,5,969,0,2209,4.141.428.571
25/01/2015 06:00,27.2,47058,1092,37,6,966,0,2101,4.141.428.571
25/01/2015 07:00,27.51,48347,956,30,6,954,0,1946,4.141.428.571
25/01/2015 08:00,27.97,49563,856,23,6,928,0,1813,4.141.428.571
25/01/2015 09:00,28.71,51104,813,16,5,863,0,1697,4.141.428.571
25/01/2015 10:00,29.26,52368,752,10,4,794,0,1560,4.141.428.571
25/01/2015 11:00,29.75,52915,668,5,4,709,0,1386,4.141.428.571
25/01/2015 12:00,29.48,52828,582,4,4,602,0,1192,4.141.428.571
25/01/2015 13:00,29.25,52546,507,4,4,512,0,1027,4.141.428.571
25/01/2015 14:00,29.13,52636,460,4,5,462,0,931,4.141.428.571
25/01/2015 15:00,29.26,53483,436,5,8,436,0,885,4.141.428.571
25/01/2015 16:00,30.19,55141,435,5,11,427,0,878,4.141.428.571
25/01/2015 17:00,32.43,56515,476,5,13,443,0,937,4.141.428.571
25/01/2015 18:00,31.9,56452,550,5,16,493,0,1064,4.141.428.571
25/01/2015 19:00,30.87,55574,641,6,18,659,0,1324,4.141.428.571
25/01/2015 20:00,29.9,54151,747,6,18,902,0,1673,4.141.428.571
25/01/2015 21:00,29.29,53061,879,7,18,1151,0,2055,4.141.428.571
25/01/2015 22:00,29.07,51226,1045,7,16,1358,0,2426,4.141.428.571
25/01/2015 23:00,28.08,49203,1220,8,14,1535,0,2777,4.141.428.571
26/01/2015 00:00,26.93,47280,1083,10,9,1731,0,2833,3.951.071.429
26/01/2015 01:00,26.14,46381,1277,10,7,1874,0,3168,3.951.071.429
26/01/2015 02:00,25.63,46087,1443,9,5,1897,0,3354,3.951.071.429
26/01/2015 03:00,25.47,46288,1582,9,4,2033,0,3628,3.951.071.429
26/01/2015 04:00,25.86,47236,1647,9,4,2036,0,3696,3.951.071.429
26/01/2015 05:00,27.62,49914,1660,10,4,2084,0,3758,3.951.071.429
26/01/2015 06:00,29.18,54429,1704,13,4,2022,0,3743,3.951.071.429
26/01/2015 07:00,30.75,58795,1765,16,5,1993,0,3779,3.951.071.429
26/01/2015 08:00,31.09,59474,1814,22,6,2053,1,3896,3.951.071.429
26/01/2015 09:00,30.86,59644,1821,30,6,2197,1,4055,3.951.071.429
26/01/2015 10:00,30.67,59290,1772,37,7,2142,1,3959,3.951.071.429
26/01/2015 11:00,30.41,58754,1713,45,8,2053,2,3821,3.951.071.429
26/01/2015 12:00,30.23,58021,1679,54,11,2033,2,3779,3.951.071.429
26/01/2015 13:00,30.16,57827,1606,64,16,1987,3,3676,3.951.071.429
26/01/2015 14:00,30.23,57765,1513,72,20,1949,4,3558,3.951.071.429
26/01/2015 15:00,30.65,58060,1514,81,24,1793,6,3418,3.951.071.429
26/01/2015 16:00,31.34,58851,1534,90,29,1717,7,3377,3.951.071.429
26/01/2015 17:00,32.08,59506,1624,100,35,1546,9,3314,3.951.071.429
26/01/2015 18:00,31.58,58562,1815,110,44,1478,10,3457,3.951.071.429
26/01/2015 19:00,30.46,57245,2020,115,54,1368,11,3568,3.951.071.429
26/01/2015 20:00,29.3,55322,2192,117,63,1271,12,3655,3.951.071.429
26/01/2015 21:00,28.68,53654,2366,120,67,1193,15,3761,3.951.071.429
26/01/2015 22:00,27.85,51288,2553,122,71,1218,14,3978,3.951.071.429
26/01/2015 23:00,26.46,48664,2721,123,73,1221,17,4155,3.951.071.429
27/01/2015 00:00,25.96,46543,2564,94,74,1265,19,4016,3.951.071.429
27/01/2015 01:00,25.4,45601,2659,94,77,1345,20,4195,3.951.071.429
27/01/2015 02:00,25.18,45350,2687,90,76,1447,22,4322,3.951.071.429
27/01/2015 03:00,25.27,45658,2688,87,76,1567,19,4437,3.951.071.429
27/01/2015 04:00,25.88,46708,2653,86,76,1636,17,4468,3.951.071.429
27/01/2015 05:00,26.97,49425,2623,86,77,1683,14,4483,3.951.071.429
27/01/2015 06:00,29.05,53901,2591,88,79,1723,14,4495,3.951.071.429
27/01/2015 07:00,30.85,58107,2525,92,80,1669,14,4380,3.951.071.429
27/01/2015 08:00,31.55,58810,2410,94,74,1627,13,4218,3.951.071.429
27/01/2015 09:00,31.32,58421,2246,95,69,1571,12,3993,3.951.071.429
27/01/2015 10:00,31.5,58423,2004,94,64,1476,10,3648,3.951.071.429
27/01/2015 11:00,31.49,58056,1760,93,54,1377,10,3294,3.951.071.429
27/01/2015 12:00,31.12,57595,1586,93,45,1285,9,3018,3.951.071.429
27/01/2015 13:00,30.88,57376,1426,94,38,1276,6,2840,3.951.071.429
27/01/2015 14:00,30.8,57281,1230,96,30,1328,5,2689,3.951.071.429
27/01/2015 15:00,31.07,57572,1008,98,28,1405,3,2542,3.951.071.429
27/01/2015 16:00,32.53,58533,812,100,28,1461,2,2403,3.951.071.429
27/01/2015 17:00,36.12,59380,715,100,28,1537,2,2382,3.951.071.429
27/01/2015 18:00,33.82,58731,707,96,29,1652,2,2486,3.951.071.429
27/01/2015 19:00,31,57514,719,89,29,1685,1,2523,3.951.071.429
27/01/2015 20:00,29.84,55641,760,80,27,1715,1,2583,3.951.071.429
27/01/2015 21:00,29.32,54028,833,72,25,1842,1,2773,3.951.071.429
27/01/2015 22:00,28.88,51574,880,66,22,1927,1,2896,3.951.071.429
27/01/2015 23:00,27.78,48833,928,60,21,2062,1,3072,3.951.071.429
28/01/2015 00:00,26.98,46299,1311,83,11,2444,1,3850,3.951.071.429
28/01/2015 01:00,26.61,45357,1524,79,9,2463,1,4076,3.951.071.429
28/01/2015 02:00,25.95,45012,1724,74,8,2392,1,4199,3.951.071.429
28/01/2015 03:00,25.29,45209,1895,71,7,2598,1,4572,3.951.071.429
28/01/2015 04:00,25.78,46096,2066,69,7,2656,1,4799,3.951.071.429
28/01/2015 05:00,26.8,48802,2267,71,9,2701,1,5049,3.951.071.429
28/01/2015 06:00,28.65,52873,2517,75,11,2763,2,5368,3.951.071.429
28/01/2015 07:00,29.81,57202,2770,83,13,2752,2,5620,3.951.071.429
28/01/2015 08:00,29.96,57986,2997,92,14,2811,3,5917,3.951.071.429
28/01/2015 09:00,29.47,58171,3198,105,16,2780,3,6102,3.951.071.429
28/01/2015 10:00,29.14,58004,3383,119,18,2855,4,6379,3.951.071.429
28/01/2015 11:00,28.87,57461,3565,132,25,2925,5,6652,3.951.071.429
28/01/2015 12:00,28.59,56760,3726,143,35,2970,7,6881,3.951.071.429
28/01/2015 13:00,28.42,56556,3836,151,48,3063,8,7106,3.951.071.429
28/01/2015 14:00,28.26,56969,3909,158,53,3101,10,7231,3.951.071.429
28/01/2015 15:00,28.42,57397,3961,163,64,3119,12,7319,3.951.071.429
28/01/2015 16:00,28.63,58421,3877,169,77,3169,13,7305,3.951.071.429
28/01/2015 17:00,29,59129,3669,179,89,3256,16,7209,3.951.071.429
28/01/2015 18:00,28.83,58204,3510,184,102,3339,18,7153,3.951.071.429
28/01/2015 19:00,28.22,56761,3367,187,115,3373,21,7063,3.951.071.429
28/01/2015 20:00,27.45,54795,3317,187,122,3415,23,7064,3.951.071.429
28/01/2015 21:00,26.99,53087,3396,186,129,3460,24,7195,3.951.071.429
28/01/2015 22:00,26.22,50485,3473,185,134,3422,25,7239,3.951.071.429
28/01/2015 23:00,25,47677,3534,182,145,3354,25,7240,3.951.071.429
29/01/2015 00:00,24.54,46060,3542,195,163,3059,37,6996,3.951.071.429
29/01/2015 01:00,23.53,45100,3566,192,166,3017,37,6978,3.951.071.429
29/01/2015 02:00,23.38,44778,3563,185,180,3009,43,6980,3.951.071.429
29/01/2015 03:00,23.48,44972,3544,180,189,3023,44,6980,3.951.071.429
29/01/2015 04:00,24.71,45587,3458,180,192,3012,45,6887,3.951.071.429
29/01/2015 05:00,25.98,48290,3318,185,190,3014,46,6753,3.951.071.429
29/01/2015 06:00,27.99,52683,3167,192,185,2993,43,6580,3.951.071.429
29/01/2015 07:00,29.09,56869,3013,197,173,2963,44,6390,3.951.071.429
29/01/2015 08:00,29.42,57459,2963,201,179,2970,44,6357,3.951.071.429
29/01/2015 09:00,29.09,57941,2914,207,167,2978,41,6307,3.951.071.429
29/01/2015 10:00,29,57740,2796,209,154,2993,38,6190,3.951.071.429
29/01/2015 11:00,29.02,57288,2651,208,147,3043,37,6086,3.951.071.429
29/01/2015 12:00,28.78,56722,2499,206,140,3064,39,5948,3.951.071.429
29/01/2015 13:00,28.7,56625,2349,201,133,3046,40,5769,3.951.071.429
29/01/2015 14:00,28.96,56545,2184,194,121,2985,38,5522,3.951.071.429
29/01/2015 15:00,29.06,57037,2010,186,115,2946,37,5294,3.951.071.429
29/01/2015 16:00,29.75,57973,1832,176,110,2915,30,5063,3.951.071.429
29/01/2015 17:00,30.3,58798,1673,168,116,2841,27,4825,3.951.071.429
29/01/2015 18:00,30.14,58146,1556,159,121,2802,26,4664,3.951.071.429
29/01/2015 19:00,29.18,56942,1508,152,125,2666,23,4474,3.951.071.429
29/01/2015 20:00,28.67,55102,1426,146,128,2532,22,4254,3.951.071.429
29/01/2015 21:00,28.4,53565,1306,140,129,2342,22,3939,3.951.071.429
29/01/2015 22:00,28.05,51134,1152,134,130,2214,21,3651,3.951.071.429
29/01/2015 23:00,26.64,48513,942,128,127,2093,21,3311,3.951.071.429
30/01/2015 00:00,26.68,46428,849,122,124,2018,15,3128,3.951.071.429
30/01/2015 01:00,26.26,45426,695,120,124,1872,15,2826,3.951.071.429
30/01/2015 02:00,26.44,45135,573,117,126,1780,16,2612,3.951.071.429
30/01/2015 03:00,26.31,45395,502,118,127,1637,17,2401,3.951.071.429
30/01/2015 04:00,26.73,46269,460,123,129,1553,20,2285,3.951.071.429
30/01/2015 05:00,28.43,49106,453,127,131,1486,22,2219,3.951.071.429
30/01/2015 06:00,30.55,53635,403,129,132,1390,21,2075,3.951.071.429
30/01/2015 07:00,34.98,58033,355,129,134,1332,23,1973,3.951.071.429
30/01/2015 08:00,37.31,59063,320,123,137,1325,23,1928,3.951.071.429
30/01/2015 09:00,34.79,59091,297,119,140,1233,25,1814,3.951.071.429
30/01/2015 10:00,32.79,59023,280,115,141,1256,25,1817,3.951.071.429
30/01/2015 11:00,32.6,58610,266,112,142,1217,25,1762,3.951.071.429
30/01/2015 12:00,31.57,57897,288,108,143,1162,24,1725,3.951.071.429
30/01/2015 13:00,30.91,57075,309,101,140,1139,25,1714,3.951.071.429
30/01/2015 14:00,30.89,56685,305,94,145,1114,27,1685,3.951.071.429
30/01/2015 15:00,30.92,56720,316,90,151,1137,30,1724,3.951.071.429
30/01/2015 16:00,31.73,57813,353,90,157,1222,30,1852,3.951.071.429
30/01/2015 17:00,33.01,58764,388,94,160,1265,28,1935,3.951.071.429
30/01/2015 18:00,32.07,57962,424,99,163,1331,28,2045,3.951.071.429
30/01/2015 19:00,30.6,56360,427,107,165,1369,26,2094,3.951.071.429
30/01/2015 20:00,29.53,54166,413,112,161,1340,27,2053,3.951.071.429
30/01/2015 21:00,29.06,52587,432,116,155,1330,27,2060,3.951.071.429
30/01/2015 22:00,28.8,50615,458,119,149,1373,25,2124,3.951.071.429
30/01/2015 23:00,27.69,48442,450,122,137,1385,25,2119,3.951.071.429
31/01/2015 00:00,27.92,46467,329,117,175,1404,32,2057,3.951.071.429
31/01/2015 01:00,27.2,45419,360,126,170,1417,36,2109,3.951.071.429
31/01/2015 02:00,26.95,44954,394,133,146,1452,36,2161,3.951.071.429
31/01/2015 03:00,26.7,44885,429,139,134,1492,33,2227,3.951.071.429
31/01/2015 04:00,26.79,45237,456,145,123,1544,33,2301,3.951.071.429
31/01/2015 05:00,27.01,46067,472,149,106,1579,32,2338,3.951.071.429
31/01/2015 06:00,27.22,47121,510,151,89,1616,27,2393,3.951.071.429
31/01/2015 07:00,27.62,48950,564,152,74,1628,25,2443,3.951.071.429
31/01/2015 08:00,28.32,51017,601,150,60,1691,22,2524,3.951.071.429
31/01/2015 09:00,28.8,52729,659,148,47,1749,18,2621,3.951.071.429
31/01/2015 10:00,29,53554,747,147,36,1779,17,2726,3.951.071.429
31/01/2015 11:00,28.79,53594,829,145,34,1866,11,2885,3.951.071.429
31/01/2015 12:00,28.42,53108,905,142,34,1920,11,3012,3.951.071.429
31/01/2015 13:00,28.27,52574,984,140,36,1971,11,3142,3.951.071.429
31/01/2015 14:00,28.23,52547,1055,137,32,2007,11,3242,3.951.071.429
31/01/2015 15:00,28.47,53116,1117,135,38,2075,10,3375,3.951.071.429
31/01/2015 16:00,29.09,54783,1184,129,44,2125,10,3492,3.951.071.429
31/01/2015 17:00,29.67,56216,1257,120,54,2180,11,3622,3.951.071.429
31/01/2015 18:00,29.38,55595,1351,112,64,2202,11,3740,3.951.071.429
31/01/2015 19:00,28.8,53738,1417,104,75,2182,13,3791,3.951.071.429
31/01/2015 20:00,28.3,51887,1440,98,81,2255,15,3889,3.951.071.429
31/01/2015 21:00,28.06,50889,1489,91,85,2265,19,3949,3.951.071.429
31/01/2015 22:00,27.88,49529,1546,83,90,2287,17,4023,3.951.071.429
31/01/2015 23:00,26.4,47865,1594,76,113,2316,16,4115,3.951.071.429
01/02/2015 00:00,27.22,46055,1095,79,130,2546,5,3855,3.951.071.429
01/02/2015 01:00,26.45,45012,1127,73,137,2609,7,3953,3.951.071.429
01/02/2015 02:00,26.12,44493,1152,65,146,2688,12,4063,3.951.071.429
01/02/2015 03:00,25.86,44373,1190,57,155,2755,14,4171,3.951.071.429
01/02/2015 04:00,25.93,44631,1252,55,163,2816,18,4304,3.951.071.429
01/02/2015 05:00,26.12,45258,1305,60,168,2888,18,4439,3.951.071.429
01/02/2015 06:00,26.27,46126,1350,72,172,2952,24,4570,3.951.071.429
01/02/2015 07:00,26.7,47484,1385,88,165,2958,27,4623,3.951.071.429
01/02/2015 08:00,27.93,48923,1414,114,167,2977,29,4701,3.951.071.429
01/02/2015 09:00,28.4,50593,1468,148,170,2996,32,4814,3.951.071.429
01/02/2015 10:00,28.6,52301,1546,173,175,2975,32,4901,3.951.071.429
01/02/2015 11:00,28.62,52831,1619,187,181,2951,30,4968,3.951.071.429
01/02/2015 12:00,28.5,52641,1667,189,181,2927,29,4993,3.951.071.429
01/02/2015 13:00,28.3,52528,1693,183,179,2901,31,4987,3.951.071.429
01/02/2015 14:00,28.28,52590,1702,172,181,2871,30,4956,3.951.071.429
01/02/2015 15:00,28.5,53298,1684,161,182,2823,34,4884,3.951.071.429
01/02/2015 16:00,29.03,54881,1636,157,179,2750,35,4757,3.951.071.429
01/02/2015 17:00,29.66,56278,1593,158,175,2668,35,4629,3.951.071.429
01/02/2015 18:00,29.69,56150,1567,160,170,2573,38,4508,3.951.071.429
01/02/2015 19:00,29.42,55235,1550,164,165,2495,41,4415,3.951.071.429
01/02/2015 20:00,28.61,53745,1556,164,177,2431,44,4372,3.951.071.429
01/02/2015 21:00,28.4,52716,1565,164,173,2349,47,4298,3.951.071.429
01/02/2015 22:00,28.23,51034,1561,165,170,2300,47,4243,3.951.071.429
01/02/2015 23:00,27.08,49012,1518,168,167,2234,48,4135,3.951.071.429
02/02/2015 00:00,27.45,47622,1075,181,162,1997,28,3443,3.715.654.762
02/02/2015 01:00,26.63,46866,1002,178,159,1901,27,3267,3.715.654.762
02/02/2015 02:00,26.34,46683,955,174,156,1866,30,3181,3.715.654.762
02/02/2015 03:00,26.39,47016,931,169,154,1818,29,3101,3.715.654.762
02/02/2015 04:00,26.97,48150,962,163,152,1793,27,3097,3.715.654.762
02/02/2015 05:00,28.37,50985,990,157,148,1737,24,3056,3.715.654.762
02/02/2015 06:00,30.68,55680,994,150,144,1700,22,3010,3.715.654.762
02/02/2015 07:00,37.18,60118,937,140,140,1648,21,2886,3.715.654.762
02/02/2015 08:00,43.02,61164,882,129,135,1625,21,2792,3.715.654.762
02/02/2015 09:00,41.01,60822,888,121,130,1576,20,2735,3.715.654.762
02/02/2015 10:00,38,60734,864,120,124,1505,19,2632,3.715.654.762
02/02/2015 11:00,32.51,60472,913,123,124,1467,18,2645,3.715.654.762
02/02/2015 12:00,32.04,60050,990,126,124,1415,18,2673,3.715.654.762
02/02/2015 13:00,32.43,59763,1008,122,124,1360,18,2632,3.715.654.762
02/02/2015 14:00,32.38,59650,966,115,107,1355,18,2561,3.715.654.762
02/02/2015 15:00,32.46,59914,979,108,99,1334,18,2538,3.715.654.762
02/02/2015 16:00,35.28,60894,1040,102,93,1346,18,2599,3.715.654.762
02/02/2015 17:00,45.35,61852,1027,104,89,1350,17,2587,3.715.654.762
02/02/2015 18:00,43.62,61164,997,103,86,1339,17,2542,3.715.654.762
02/02/2015 19:00,32.31,59903,924,106,83,1343,17,2473,3.715.654.762
02/02/2015 20:00,30.84,57987,809,108,83,1336,16,2352,3.715.654.762
02/02/2015 21:00,30.44,56446,744,107,82,1312,15,2260,3.715.654.762
02/02/2015 22:00,29.75,53883,742,108,81,1289,15,2235,3.715.654.762
02/02/2015 23:00,29.24,51186,736,110,77,1270,16,2209,3.715.654.762
03/02/2015 00:00,28.74,49513,696,79,71,1097,12,1955,3.715.654.762
03/02/2015 01:00,28.23,48612,697,80,71,1083,13,1944,3.715.654.762
03/02/2015 02:00,28.05,48266,746,81,68,1071,12,1978,3.715.654.762
03/02/2015 03:00,28.08,48582,852,83,67,1068,11,2081,3.715.654.762
03/02/2015 04:00,28.21,49675,953,85,65,1073,10,2186,3.715.654.762
03/02/2015 05:00,29.42,52482,980,86,60,1100,11,2237,3.715.654.762
03/02/2015 06:00,32.04,57573,982,88,56,1118,8,2252,3.715.654.762
03/02/2015 07:00,45.01,61761,976,83,51,1127,8,2245,3.715.654.762
03/02/2015 08:00,49.87,62895,981,75,47,1119,7,2229,3.715.654.762
03/02/2015 09:00,48.85,62236,988,67,42,1092,7,2196,3.715.654.762
03/02/2015 10:00,47.86,61964,995,58,38,1060,5,2156,3.715.654.762
03/02/2015 11:00,39.03,61355,1021,48,34,1023,5,2131,3.715.654.762
03/02/2015 12:00,35.02,60776,1058,42,31,997,5,2133,3.715.654.762
03/02/2015 13:00,35.66,60522,1071,38,28,999,4,2140,3.715.654.762
03/02/2015 14:00,35.04,60306,1043,34,23,1000,2,2102,3.715.654.762
03/02/2015 15:00,36.32,60485,999,31,21,1152,2,2205,3.715.654.762
03/02/2015 16:00,45.63,61363,939,29,20,1141,1,2130,3.715.654.762
03/02/2015 17:00,55.05,62519,868,27,24,1157,1,2077,3.715.654.762
03/02/2015 18:00,54.15,61900,821,22,28,1176,1,2048,3.715.654.762
03/02/2015 19:00,40.31,60575,782,20,32,1196,1,2031,3.715.654.762
03/02/2015 20:00,33.07,58595,714,19,33,1167,1,1934,3.715.654.762
03/02/2015 21:00,31.23,57006,651,19,33,1157,1,1861,3.715.654.762
03/02/2015 22:00,30.3,54466,597,19,32,1119,1,1768,3.715.654.762
03/02/2015 23:00,29.46,51672,555,19,30,1096,1,1701,3.715.654.762
04/02/2015 00:00,29.76,49969,576,17,28,975,1,1597,3.715.654.762
04/02/2015 01:00,29.3,48972,589,17,28,960,1,1595,3.715.654.762
04/02/2015 02:00,29.12,48694,610,15,27,953,1,1606,3.715.654.762
04/02/2015 03:00,29.18,48998,647,14,27,946,1,1635,3.715.654.762
04/02/2015 04:00,29.76,50020,706,13,27,915,1,1662,3.715.654.762
04/02/2015 05:00,31.08,52861,751,13,25,917,1,1707,3.715.654.762
04/02/2015 06:00,35.82,57604,726,12,24,913,1,1676,3.715.654.762
04/02/2015 07:00,49.58,61934,658,12,23,879,1,1573,3.715.654.762
04/02/2015 08:00,61.4,63263,602,10,19,846,1,1478,3.715.654.762
04/02/2015 09:00,61.08,62706,574,9,16,796,1,1396,3.715.654.762
04/02/2015 10:00,59.36,62430,562,9,14,733,1,1319,3.715.654.762
04/02/2015 11:00,50.03,61691,565,8,11,665,1,1250,3.715.654.762
04/02/2015 12:00,46.02,61078,589,8,10,603,1,1211,3.715.654.762
04/02/2015 13:00,49.91,60774,613,8,9,543,0,1173,3.715.654.762
04/02/2015 14:00,47.54,60541,633,9,5,536,0,1183,3.715.654.762
04/02/2015 15:00,48.35,60753,641,12,5,533,1,1192,3.715.654.762
04/02/2015 16:00,48.61,61717,620,15,7,577,1,1220,3.715.654.762
04/02/2015 17:00,59.33,62703,575,18,10,598,1,1202,3.715.654.762
04/02/2015 18:00,61.63,61959,539,21,14,600,1,1175,3.715.654.762
04/02/2015 19:00,45.03,60693,520,22,17,590,1,1150,3.715.654.762
04/02/2015 20:00,38.56,58754,502,23,18,554,1,1098,3.715.654.762
04/02/2015 21:00,34.36,57202,496,22,18,537,1,1074,3.715.654.762
04/02/2015 22:00,31.81,54811,514,20,17,531,1,1083,3.715.654.762
04/02/2015 23:00,30.46,52165,541,20,15,566,1,1143,3.715.654.762
05/02/2015 00:00,30.25,50399,537,13,11,513,0,1074,3.715.654.762
05/02/2015 01:00,29.81,49440,508,11,10,524,0,1053,3.715.654.762
05/02/2015 02:00,29.57,49056,487,9,10,548,0,1054,3.715.654.762
05/02/2015 03:00,29.51,49233,511,7,11,554,0,1083,3.715.654.762
05/02/2015 04:00,29.78,50273,559,7,12,572,0,1150,3.715.654.762
05/02/2015 05:00,30.72,53136,594,7,13,609,0,1223,3.715.654.762
05/02/2015 06:00,35.74,57940,608,6,14,633,0,1261,3.715.654.762
05/02/2015 07:00,46.92,62227,584,5,14,718,1,1322,3.715.654.762
05/02/2015 08:00,55.04,63219,530,3,11,780,1,1325,3.715.654.762
05/02/2015 09:00,50.98,62745,470,2,8,823,1,1304,3.715.654.762
05/02/2015 10:00,48.02,62555,406,1,5,883,1,1296,3.715.654.762
05/02/2015 11:00,39.96,62190,335,1,4,944,1,1285,3.715.654.762
05/02/2015 12:00,35.3,61599,295,1,3,1065,2,1366,3.715.654.762
05/02/2015 13:00,36.96,61233,284,1,3,1232,2,1522,3.715.654.762
05/02/2015 14:00,34.94,60984,279,1,5,1403,1,1689,3.715.654.762
05/02/2015 15:00,35.23,61051,268,2,7,1516,1,1794,3.715.654.762
05/02/2015 16:00,38.97,61889,252,3,11,1628,1,1895,3.715.654.762
05/02/2015 17:00,44.32,63047,240,5,13,1741,0,1999,3.715.654.762
05/02/2015 18:00,40.63,62506,242,9,15,1864,0,2130,3.715.654.762
05/02/2015 19:00,32.35,61267,226,16,17,1948,0,2207,3.715.654.762
05/02/2015 20:00,31.34,59258,205,27,16,2033,0,2281,3.715.654.762
05/02/2015 21:00,30.51,57518,193,43,14,2189,0,2439,3.715.654.762
05/02/2015 22:00,29.7,54905,182,61,12,2334,0,2589,3.715.654.762
05/02/2015 23:00,28.99,52188,179,79,10,2507,0,2775,3.715.654.762
06/02/2015 00:00,28.71,49534,219,124,6,2621,3,2973,3.715.654.762
06/02/2015 01:00,28.12,48509,271,146,5,2702,3,3127,3.715.654.762
06/02/2015 02:00,27.73,48039,327,169,6,2787,5,3294,3.715.654.762
06/02/2015 03:00,27.7,48133,394,191,7,2800,9,3401,3.715.654.762
06/02/2015 04:00,28.22,49103,453,205,8,2780,11,3457,3.715.654.762
06/02/2015 05:00,29.03,51765,507,216,11,2755,14,3503,3.715.654.762
06/02/2015 06:00,30.4,56301,587,223,15,2716,18,3559,3.715.654.762
06/02/2015 07:00,34.6,60521,659,227,20,2637,22,3565,3.715.654.762
06/02/2015 08:00,38.86,61478,705,224,28,2604,27,3588,3.715.654.762
06/02/2015 09:00,38.64,61104,754,215,37,2464,33,3503,3.715.654.762
06/02/2015 10:00,35.7,60747,776,205,48,2281,37,3347,3.715.654.762
06/02/2015 11:00,31.45,60078,773,194,64,2201,36,3268,3.715.654.762
06/02/2015 12:00,30.59,58984,779,182,83,2141,32,3217,3.715.654.762
06/02/2015 13:00,30.42,57978,776,173,110,2028,25,3112,3.715.654.762
06/02/2015 14:00,30.21,57362,749,165,105,2012,18,3049,3.715.654.762
06/02/2015 15:00,30.35,57246,761,158,102,1917,14,2952,3.715.654.762
06/02/2015 16:00,30.81,58267,814,148,99,1957,11,3029,3.715.654.762
06/02/2015 17:00,33.26,59514,862,138,92,1990,9,3091,3.715.654.762
06/02/2015 18:00,32.34,58962,920,126,85,2127,7,3265,3.715.654.762
06/02/2015 19:00,30.01,57259,987,110,76,2218,7,3398,3.715.654.762
06/02/2015 20:00,29.39,55069,1062,91,70,2359,7,3589,3.715.654.762
06/02/2015 21:00,29.12,53498,1167,73,62,2435,6,3743,3.715.654.762
06/02/2015 22:00,28.69,51552,1311,60,55,2499,5,3930,3.715.654.762
06/02/2015 23:00,28.3,49387,1469,51,52,2521,5,4098,3.715.654.762
07/02/2015 00:00,27.79,47736,1642,71,50,2654,3,4420,3.715.654.762
07/02/2015 01:00,27.36,46493,1818,81,47,2758,3,4707,3.715.654.762
07/02/2015 02:00,26.67,45923,1973,83,50,2807,4,4917,3.715.654.762
07/02/2015 03:00,26.32,45810,2169,84,53,2889,5,5200,3.715.654.762
07/02/2015 04:00,26.13,46090,2434,86,57,3022,7,5606,3.715.654.762
07/02/2015 05:00,26.01,46776,2787,91,68,3192,10,6148,3.715.654.762
07/02/2015 06:00,26.12,47992,3060,102,80,3321,14,6577,3.715.654.762
07/02/2015 07:00,26.98,49711,3210,106,91,3480,15,6902,3.715.654.762
07/02/2015 08:00,27.16,51506,3248,103,112,3653,15,7131,3.715.654.762
07/02/2015 09:00,27.58,52623,3315,95,133,3749,18,7310,3.715.654.762
07/02/2015 10:00,27.74,53587,3524,91,152,3878,18,7663,3.715.654.762
07/02/2015 11:00,27.48,53420,3765,84,156,4066,17,8088,3.715.654.762
07/02/2015 12:00,26.89,52727,3925,78,159,4271,20,8453,3.715.654.762
07/02/2015 13:00,26.23,51997,4015,80,162,4392,17,8666,3.715.654.762
07/02/2015 14:00,25.94,51837,4082,88,162,4492,17,8841,3.715.654.762
07/02/2015 15:00,25.99,52395,4112,99,160,4563,21,8955,3.715.654.762
07/02/2015 16:00,26.96,54250,4129,111,159,4621,24,9044,3.715.654.762
07/02/2015 17:00,27.95,56417,4148,118,160,4628,32,9086,3.715.654.762
07/02/2015 18:00,27.98,56354,4182,131,160,4726,40,9239,3.715.654.762
07/02/2015 19:00,27.31,54743,4222,146,159,4728,26,9281,3.715.654.762
07/02/2015 20:00,26.57,53087,4238,163,162,4773,23,9359,3.715.654.762
07/02/2015 21:00,26.23,52206,4225,178,175,4791,31,9400,3.715.654.762
07/02/2015 22:00,25.82,50960,4175,187,183,4738,29,9312,3.715.654.762
07/02/2015 23:00,24.79,49417,4104,188,182,4719,29,9222,3.715.654.762
08/02/2015 00:00,25.23,47280,3801,210,172,4704,47,8934,3.715.654.762
08/02/2015 01:00,24.89,46507,3633,208,169,4662,46,8718,3.715.654.762
08/02/2015 02:00,24.68,46059,3555,209,166,4658,42,8630,3.715.654.762
08/02/2015 03:00,24.71,46029,3449,214,170,4618,46,8497,3.715.654.762
08/02/2015 04:00,24.88,46351,3323,216,177,4543,50,8309,3.715.654.762
08/02/2015 05:00,25.14,47025,3193,218,184,4517,52,8164,3.715.654.762
08/02/2015 06:00,25.42,47934,3057,220,192,4465,51,7985,3.715.654.762
08/02/2015 07:00,25.67,49075,3323,224,200,4316,54,8117,3.715.654.762
08/02/2015 08:00,25.95,50377,3200,225,206,4192,54,7877,3.715.654.762
08/02/2015 09:00,26.39,51693,3090,224,209,4022,55,7600,3.715.654.762
08/02/2015 10:00,26.99,52592,3050,223,213,3724,55,7265,3.715.654.762
08/02/2015 11:00,27.1,52637,3019,220,215,3533,55,7042,3.715.654.762
08/02/2015 12:00,27.05,52143,2925,216,215,3178,55,6589,3.715.654.762
08/02/2015 13:00,27.1,51928,2715,211,215,2873,55,6069,3.715.654.762
08/02/2015 14:00,27.18,51973,2389,209,215,2593,55,5461,3.715.654.762
08/02/2015 15:00,27.39,52583,2007,208,209,2328,54,4806,3.715.654.762
08/02/2015 16:00,28.29,54295,1772,209,203,2192,54,4430,3.715.654.762
08/02/2015 17:00,29.7,56241,1738,213,201,2272,52,4476,3.715.654.762
08/02/2015 18:00,29.81,56392,1846,219,197,2255,50,4567,3.715.654.762
08/02/2015 19:00,29.29,55421,2089,215,190,2267,43,4804,3.715.654.762
08/02/2015 20:00,28.31,53855,2407,200,181,2354,35,5177,3.715.654.762
08/02/2015 21:00,27.8,52724,2719,182,171,2444,32,5548,3.715.654.762
08/02/2015 22:00,27.31,50882,2969,158,135,2553,31,5846,3.715.654.762
08/02/2015 23:00,26.38,48691,3136,135,117,2650,27,6065,3.715.654.762
09/02/2015 00:00,25.87,46460,3576,104,114,2985,21,6800,3.553.630.952
09/02/2015 01:00,25.21,45628,3615,76,99,2965,9,6764,3.553.630.952
09/02/2015 02:00,24.92,45307,3607,53,67,3021,3,6751,3.553.630.952
09/02/2015 03:00,25.08,45524,3586,37,40,3060,2,6725,3.553.630.952
09/02/2015 04:00,25.84,46649,3536,26,22,3041,2,6627,3.553.630.952
09/02/2015 05:00,26.95,49467,3437,23,21,2985,2,6468,3.553.630.952
09/02/2015 06:00,28.03,54118,3306,31,21,2952,3,6313,3.553.630.952
09/02/2015 07:00,29.3,58297,3168,41,20,2902,4,6135,3.553.630.952
09/02/2015 08:00,30.14,59098,3024,47,22,2861,4,5958,3.553.630.952
09/02/2015 09:00,30.29,58959,2897,53,18,2802,4,5774,3.553.630.952
09/02/2015 10:00,30.21,58349,2838,48,20,2697,4,5607,3.553.630.952
09/02/2015 11:00,29.71,57427,2795,43,22,2626,4,5490,3.553.630.952
09/02/2015 12:00,29.41,56318,2742,38,24,2557,4,5365,3.553.630.952
09/02/2015 13:00,29.55,55912,2644,37,26,2556,4,5267,3.553.630.952
09/02/2015 14:00,29.42,55796,2490,37,24,2570,4,5125,3.553.630.952
09/02/2015 15:00,29.37,55714,2310,39,26,2629,4,5008,3.553.630.952
09/02/2015 16:00,29.85,56601,2102,44,28,2658,4,4836,3.553.630.952
09/02/2015 17:00,30.87,57899,1977,53,40,2709,4,4783,3.553.630.952
09/02/2015 18:00,30.61,57655,1984,64,41,2862,6,4957,3.553.630.952
09/02/2015 19:00,29.65,56386,2042,71,42,2919,5,5079,3.553.630.952
09/02/2015 20:00,28.7,54506,2054,77,38,2887,5,5061,3.553.630.952
09/02/2015 21:00,28.36,52931,2074,79,35,2830,4,5022,3.553.630.952
09/02/2015 22:00,27.93,50456,2107,81,33,2759,4,4984,3.553.630.952
09/02/2015 23:00,27.17,47787,2106,82,33,2756,3,4980,3.553.630.952
10/02/2015 00:00,25.62,45522,1870,90,19,2776,2,4757,3.553.630.952
10/02/2015 01:00,25.46,44588,1904,91,22,2736,3,4756,3.553.630.952
10/02/2015 02:00,25.34,44236,1961,94,22,2663,3,4743,3.553.630.952
10/02/2015 03:00,25.69,44523,1950,98,22,2677,3,4750,3.553.630.952
10/02/2015 04:00,26.05,45650,1904,104,23,2625,3,4659,3.553.630.952
10/02/2015 05:00,27.1,48406,1901,109,24,2592,3,4629,3.553.630.952
10/02/2015 06:00,28.46,52817,1938,111,25,2507,3,4584,3.553.630.952
10/02/2015 07:00,30.05,56707,1951,110,26,2448,3,4538,3.553.630.952
10/02/2015 08:00,30.61,57587,1924,102,23,2466,3,4518,3.553.630.952
10/02/2015 09:00,30.38,57021,1886,96,20,2393,3,4398,3.553.630.952
10/02/2015 10:00,30.28,56538,1845,91,17,2278,3,4234,3.553.630.952
10/02/2015 11:00,29.45,55542,1840,90,17,2196,3,4146,3.553.630.952
10/02/2015 12:00,29.16,54485,1837,91,18,2176,3,4125,3.553.630.952
10/02/2015 13:00,29.24,53868,1867,92,19,2170,3,4151,3.553.630.952
10/02/2015 14:00,29.05,53641,1916,93,21,2263,3,4296,3.553.630.952
10/02/2015 15:00,29.12,54001,1892,95,27,2434,3,4451,3.553.630.952
10/02/2015 16:00,29.74,55207,1735,91,34,2573,3,4436,3.553.630.952
10/02/2015 17:00,30.94,56658,1533,89,40,2732,4,4398,3.553.630.952
10/02/2015 18:00,30.83,56614,1418,84,45,2885,4,4436,3.553.630.952
10/02/2015 19:00,29.58,55525,1395,83,50,2902,4,4434,3.553.630.952
10/02/2015 20:00,28.64,53685,1348,84,50,2939,4,4425,3.553.630.952
10/02/2015 21:00,28.47,52270,1265,86,49,2875,4,4279,3.553.630.952
10/02/2015 22:00,28.09,50013,1163,88,49,2857,3,4160,3.553.630.952
10/02/2015 23:00,27.36,47443,1082,89,45,2793,3,4012,3.553.630.952
11/02/2015 00:00,26.7,45274,874,111,14,2859,3,3861,3.553.630.952
11/02/2015 01:00,26.23,44419,822,115,13,2824,3,3777,3.553.630.952
11/02/2015 02:00,26.04,44148,793,110,11,2775,3,3692,3.553.630.952
11/02/2015 03:00,26.13,44444,765,103,10,2746,3,3627,3.553.630.952
11/02/2015 04:00,26.56,45413,738,98,10,2689,3,3538,3.553.630.952
11/02/2015 05:00,27.71,47987,689,95,11,2684,3,3482,3.553.630.952
11/02/2015 06:00,29.19,52225,656,93,12,2626,3,3390,3.553.630.952
11/02/2015 07:00,41.01,55962,653,86,14,2587,3,3343,3.553.630.952
11/02/2015 08:00,43.93,56760,679,74,14,2558,3,3328,3.553.630.952
11/02/2015 09:00,42.07,57003,711,65,14,2485,4,3279,3.553.630.952
11/02/2015 10:00,40.03,56478,684,58,13,2443,4,3202,3.553.630.952
11/02/2015 11:00,32.18,55537,663,57,16,2413,6,3155,3.553.630.952
11/02/2015 12:00,30.82,54492,679,60,19,2346,6,3110,3.553.630.952
11/02/2015 13:00,30.79,54130,676,66,24,2339,7,3112,3.553.630.952
11/02/2015 14:00,30.83,53992,659,76,26,2367,8,3136,3.553.630.952
11/02/2015 15:00,30.73,54358,636,88,32,2415,8,3179,3.553.630.952
11/02/2015 16:00,34.53,55583,612,98,39,2508,7,3264,3.553.630.952
11/02/2015 17:00,43.28,56968,587,109,45,2638,9,3388,3.553.630.952
11/02/2015 18:00,39.22,56728,580,118,52,2764,10,3524,3.553.630.952
11/02/2015 19:00,31.12,55611,599,123,59,2905,11,3697,3.553.630.952
11/02/2015 20:00,29.15,53782,618,129,62,2976,12,3797,3.553.630.952
11/02/2015 21:00,28.78,52310,638,133,65,3000,15,3851,3.553.630.952
11/02/2015 22:00,28.2,50056,658,139,67,3033,18,3915,3.553.630.952
11/02/2015 23:00,27.58,47428,660,144,70,3089,21,3984,3.553.630.952
12/02/2015 00:00,26.8,45323,542,170,59,3134,18,3923,3.553.630.952
12/02/2015 01:00,26.5,44388,525,178,66,3138,20,3927,3.553.630.952
12/02/2015 02:00,26.25,44087,516,187,67,3109,22,3901,3.553.630.952
12/02/2015 03:00,26.3,44230,500,192,69,3103,23,3887,3.553.630.952
12/02/2015 04:00,26.74,45160,482,187,71,3120,25,3885,3.553.630.952
12/02/2015 05:00,27.54,47786,473,178,72,3177,25,3925,3.553.630.952
12/02/2015 06:00,28.85,52007,488,171,74,3170,25,3928,3.553.630.952
12/02/2015 07:00,33.28,55773,520,166,76,3054,26,3842,3.553.630.952
12/02/2015 08:00,39.93,56924,546,164,80,3000,27,3817,3.553.630.952
12/02/2015 09:00,38.44,56547,545,161,83,2913,26,3728,3.553.630.952
12/02/2015 10:00,35.58,56310,513,159,86,2788,26,3572,3.553.630.952
12/02/2015 11:00,31.84,55760,464,156,86,2650,26,3382,3.553.630.952
12/02/2015 12:00,30.24,55191,444,152,86,2504,27,3213,3.553.630.952
12/02/2015 13:00,30.47,54927,421,149,80,2268,28,2946,3.553.630.952
12/02/2015 14:00,30.97,54747,381,140,76,2030,25,2652,3.553.630.952
12/02/2015 15:00,33.57,54972,347,130,73,1758,25,2333,3.553.630.952
12/02/2015 16:00,40.08,55868,330,115,71,1555,20,2091,3.553.630.952
12/02/2015 17:00,44.28,57244,331,99,66,1297,14,1807,3.553.630.952
12/02/2015 18:00,48.97,56951,343,84,60,1130,11,1628,3.553.630.952
12/02/2015 19:00,42.26,55811,343,71,54,983,9,1460,3.553.630.952
12/02/2015 20:00,30.77,54118,327,60,48,910,8,1353,3.553.630.952
12/02/2015 21:00,29.71,52716,308,51,42,836,7,1244,3.553.630.952
12/02/2015 22:00,28.96,50491,298,44,36,871,5,1254,3.553.630.952
12/02/2015 23:00,28.29,48009,297,35,31,1011,5,1379,3.553.630.952
13/02/2015 00:00,27.79,46210,400,17,22,1239,4,1682,3.553.630.952
13/02/2015 01:00,27.43,45348,395,12,18,1274,3,1702,3.553.630.952
13/02/2015 02:00,27.05,45096,391,9,15,1301,3,1719,3.553.630.952
13/02/2015 03:00,27.12,45284,403,8,13,1311,2,1737,3.553.630.952
13/02/2015 04:00,27.51,46348,436,9,11,1291,2,1749,3.553.630.952
13/02/2015 05:00,28.12,49052,487,11,12,1247,2,1759,3.553.630.952
13/02/2015 06:00,30.05,53546,548,17,13,1213,2,1793,3.553.630.952
13/02/2015 07:00,39.98,57369,614,21,15,1088,2,1740,3.553.630.952
13/02/2015 08:00,42.04,59003,679,23,17,926,3,1648,3.553.630.952
13/02/2015 09:00,42.08,58698,760,23,19,822,3,1627,3.553.630.952
13/02/2015 10:00,41.17,58377,811,24,21,633,4,1493,3.553.630.952
13/02/2015 11:00,37.1,57596,810,26,21,521,6,1384,3.553.630.952
13/02/2015 12:00,31.09,56692,810,30,21,456,6,1323,3.553.630.952
13/02/2015 13:00,31.07,55744,772,33,22,431,6,1264,3.553.630.952
13/02/2015 14:00,30.14,55146,709,36,23,412,5,1185,3.553.630.952
13/02/2015 15:00,29.94,54973,675,39,26,405,4,1149,3.553.630.952
13/02/2015 16:00,30.24,55889,662,44,29,417,4,1156,3.553.630.952
13/02/2015 17:00,31.55,57281,690,49,37,461,4,1241,3.553.630.952
13/02/2015 18:00,30.94,57070,784,55,44,500,4,1387,3.553.630.952
13/02/2015 19:00,29.31,55380,887,59,51,546,4,1547,3.553.630.952
13/02/2015 20:00,28.36,53315,937,59,49,557,4,1606,3.553.630.952
13/02/2015 21:00,27.97,51822,930,58,46,567,3,1604,3.553.630.952
13/02/2015 22:00,27.63,49933,868,57,44,569,4,1542,3.553.630.952
13/02/2015 23:00,27.15,47783,816,56,42,552,2,1468,3.553.630.952
14/02/2015 00:00,27.5,45867,618,72,40,569,3,1302,3.553.630.952
14/02/2015 01:00,27.2,44769,596,72,39,586,4,1297,3.553.630.952
14/02/2015 02:00,27.09,44342,599,71,37,614,3,1324,3.553.630.952
14/02/2015 03:00,27.01,44289,623,69,36,634,3,1365,3.553.630.952
14/02/2015 04:00,27.02,44479,644,66,35,670,3,1418,3.553.630.952
14/02/2015 05:00,27.31,45214,671,64,34,699,2,1470,3.553.630.952
14/02/2015 06:00,27.17,46347,705,61,33,707,2,1508,3.553.630.952
14/02/2015 07:00,27.03,47723,708,57,33,706,2,1506,3.553.630.952
14/02/2015 08:00,27.29,49549,697,52,30,691,2,1472,3.553.630.952
14/02/2015 09:00,27.72,51099,710,49,27,653,2,1441,3.553.630.952
14/02/2015 10:00,27.85,51970,732,42,23,575,1,1373,3.553.630.952
14/02/2015 11:00,27.93,51666,752,34,20,524,1,1331,3.553.630.952
14/02/2015 12:00,27.75,51151,777,29,18,516,1,1341,3.553.630.952
14/02/2015 13:00,27.67,50565,825,25,16,503,1,1370,3.553.630.952
14/02/2015 14:00,27.51,50248,885,21,16,544,1,1467,3.553.630.952
14/02/2015 15:00,27.59,50608,956,17,18,642,0,1633,3.553.630.952
14/02/2015 16:00,27.88,52086,1044,15,20,743,0,1822,3.553.630.952
14/02/2015 17:00,28.84,54048,1174,14,23,925,0,2136,3.553.630.952
14/02/2015 18:00,28.68,53989,1362,17,26,1051,0,2456,3.553.630.952
14/02/2015 19:00,27.9,52385,1528,21,29,1237,0,2815,3.553.630.952
14/02/2015 20:00,27.52,50657,1624,26,27,1379,0,3056,3.553.630.952
14/02/2015 21:00,27.19,49587,1689,31,26,1483,1,3230,3.553.630.952
14/02/2015 22:00,26.87,48250,1746,41,25,1579,1,3392,3.553.630.952
14/02/2015 23:00,26.65,46815,1835,58,24,1671,2,3590,3.553.630.952
15/02/2015 00:00,26.87,45740,1604,122,30,1687,1,3444,3.553.630.952
15/02/2015 01:00,26.39,44881,1724,146,37,1800,2,3709,3.553.630.952
15/02/2015 02:00,26.18,44502,1847,159,44,1913,3,3966,3.553.630.952
15/02/2015 03:00,26.1,44459,1999,164,52,2076,4,4295,3.553.630.952
15/02/2015 04:00,26.01,44717,2167,164,60,2212,4,4607,3.553.630.952
15/02/2015 05:00,26.08,45413,2309,164,66,2390,7,4936,3.553.630.952
15/02/2015 06:00,26.17,46183,2456,160,73,2592,8,5289,3.553.630.952
15/02/2015 07:00,26.31,47210,2590,148,79,2730,12,5559,3.553.630.952
15/02/2015 08:00,26.57,48428,2687,132,89,2837,15,5760,3.553.630.952
15/02/2015 09:00,26.69,49943,2747,115,99,2920,20,5901,3.553.630.952
15/02/2015 10:00,26.42,50983,2775,100,108,3033,22,6038,3.553.630.952
15/02/2015 11:00,26.41,51240,2821,85,110,3051,26,6093,3.553.630.952
15/02/2015 12:00,26.05,50812,2933,74,113,3169,26,6315,3.553.630.952
15/02/2015 13:00,25.62,50753,2997,65,116,3215,27,6420,3.553.630.952
15/02/2015 14:00,25.51,50784,2969,57,112,3259,25,6422,3.553.630.952
15/02/2015 15:00,25.82,51375,2923,51,114,3369,25,6482,3.553.630.952
15/02/2015 16:00,26.73,53007,2924,51,117,3412,22,6526,3.553.630.952
15/02/2015 17:00,27.57,54956,2983,54,126,3474,20,6657,3.553.630.952
15/02/2015 18:00,27.64,55393,3064,55,134,3517,21,6791,3.553.630.952
15/02/2015 19:00,27.38,54490,3130,55,142,3596,23,6946,3.553.630.952
15/02/2015 20:00,26.91,53082,3147,55,142,3623,24,6991,3.553.630.952
15/02/2015 21:00,26.73,51978,3110,55,140,3557,24,6886,3.553.630.952
15/02/2015 22:00,26.48,50252,3006,58,139,3528,24,6755,3.553.630.952
15/02/2015 23:00,26.12,48295,2850,58,135,3440,24,6507,3.553.630.952
16/02/2015 00:00,26.08,46659,2788,56,125,3562,12,6543,339.625
16/02/2015 01:00,25.53,46002,2720,59,120,3523,11,6433,339.625
16/02/2015 02:00,25.35,45847,2703,61,116,3502,10,6392,339.625
16/02/2015 03:00,25.63,46148,2675,64,112,3499,9,6359,339.625
16/02/2015 04:00,25.9,47198,2646,70,108,3453,10,6287,339.625
16/02/2015 05:00,26.65,49756,2638,75,109,3452,10,6284,339.625
16/02/2015 06:00,27.76,54232,2656,76,109,3460,11,6312,339.625
16/02/2015 07:00,28.62,58317,2716,74,110,3422,15,6337,339.625
16/02/2015 08:00,29,59450,2814,69,112,3435,20,6450,339.625
16/02/2015 09:00,29.05,59186,2909,67,113,3426,22,6537,339.625
16/02/2015 10:00,29.24,58992,2927,66,113,3342,20,6468,339.625
16/02/2015 11:00,28.69,58564,2848,68,111,3311,18,6356,339.625
16/02/2015 12:00,28.43,57924,2728,72,109,3262,18,6189,339.625
16/02/2015 13:00,28.49,57675,2608,80,108,3254,19,6069,339.625
16/02/2015 14:00,28.43,57548,2495,88,109,3229,19,5940,339.625
16/02/2015 15:00,28.51,57489,2389,97,115,3219,17,5837,339.625
16/02/2015 16:00,28.97,58091,2223,108,120,3240,16,5707,339.625
16/02/2015 17:00,30.39,59676,2044,119,130,3266,18,5577,339.625
16/02/2015 18:00,29.78,59563,1916,129,138,3285,22,5490,339.625
16/02/2015 19:00,28.72,58250,1776,139,146,3205,26,5292,339.625
16/02/2015 20:00,28.02,56463,1609,148,144,3263,26,5190,339.625
16/02/2015 21:00,27.76,54888,1462,157,141,3217,24,5001,339.625
16/02/2015 22:00,27.48,52539,1351,164,138,3210,21,4884,339.625
16/02/2015 23:00,27.21,49953,1253,169,134,3124,20,4700,339.625
17/02/2015 00:00,26.31,47908,1277,188,143,3305,24,4937,339.625
17/02/2015 01:00,26.13,47036,1164,193,140,3220,24,4741,339.625
17/02/2015 02:00,26.05,46731,1047,194,136,3228,24,4629,339.625
17/02/2015 03:00,26.16,46946,978,194,134,3184,26,4516,339.625
17/02/2015 04:00,26.68,47805,936,194,132,3146,27,4435,339.625
17/02/2015 05:00,27.6,50323,908,195,130,3104,30,4367,339.625
17/02/2015 06:00,28.59,54658,882,196,131,3070,28,4307,339.625
17/02/2015 07:00,33.53,58427,834,193,133,3051,29,4240,339.625
17/02/2015 08:00,37.46,59351,788,193,134,3009,30,4154,339.625
17/02/2015 09:00,37.4,59007,752,192,161,2940,31,4076,339.625
17/02/2015 10:00,33.03,58855,661,191,162,2913,34,3961,339.625
17/02/2015 11:00,30.51,58467,570,190,162,2915,35,3872,339.625
17/02/2015 12:00,29.8,57849,560,188,160,2910,37,3855,339.625
17/02/2015 13:00,29.87,57521,601,189,162,2913,37,3902,339.625
17/02/2015 14:00,29.35,57233,693,193,162,2940,37,4025,339.625
17/02/2015 15:00,29.03,57085,837,197,160,3041,37,4272,339.625
17/02/2015 16:00,29.22,57671,1006,206,136,3193,34,4575,339.625
17/02/2015 17:00,30.25,59138,1176,214,137,3370,29,4926,339.625
17/02/2015 18:00,30.27,58936,1377,220,139,3542,30,5308,339.625
17/02/2015 19:00,28.54,57626,1576,225,140,3653,31,5625,339.625
17/02/2015 20:00,27.7,55696,1704,229,142,3773,31,5879,339.625
17/02/2015 21:00,27.31,54114,1815,231,140,3832,33,6051,339.625
17/02/2015 22:00,26.82,51772,1881,234,139,3889,34,6177,339.625
17/02/2015 23:00,26,49018,1877,235,136,3946,32,6226,339.625
18/02/2015 00:00,25.4,46387,2053,229,134,4022,33,6471,339.625
18/02/2015 01:00,24.91,45494,2071,231,132,4069,33,6536,339.625
18/02/2015 02:00,24.65,45135,2044,233,132,4118,32,6559,339.625
18/02/2015 03:00,24.76,45323,2021,233,132,4089,33,6508,339.625
18/02/2015 04:00,25.57,46141,1998,228,132,4068,35,6461,339.625
18/02/2015 05:00,26.74,48647,1972,224,141,3940,38,6315,339.625
18/02/2015 06:00,27.7,52967,1961,221,148,3769,40,6139,339.625
18/02/2015 07:00,28.88,56665,2010,217,155,3613,39,6034,339.625
18/02/2015 08:00,29.8,57295,2128,211,154,3386,40,5919,339.625
18/02/2015 09:00,29.83,57066,2305,205,153,3193,44,5900,339.625
18/02/2015 10:00,29.57,56985,2500,203,150,3056,39,5948,339.625
18/02/2015 11:00,28.56,56516,2710,201,138,2985,37,6071,339.625
18/02/2015 12:00,28.04,55869,2891,191,125,2902,26,6135,339.625
18/02/2015 13:00,27.97,55434,2994,165,111,3030,21,6321,339.625
18/02/2015 14:00,27.9,55086,3018,133,101,3176,16,6444,339.625
18/02/2015 15:00,27.82,54960,3017,105,94,3210,13,6439,339.625
18/02/2015 16:00,27.97,55631,3031,90,87,3329,12,6549,339.625
18/02/2015 17:00,28.73,57135,3058,86,88,3587,11,6830,339.625
18/02/2015 18:00,28.77,56988,3078,95,89,3803,13,7078,339.625
18/02/2015 19:00,27.89,55719,3123,106,90,3832,15,7166,339.625
18/02/2015 20:00,27.27,53859,3203,117,99,3912,17,7348,339.625
18/02/2015 21:00,26.84,52177,3271,123,108,3977,19,7498,339.625
18/02/2015 22:00,26.08,49801,3301,127,116,3949,22,7515,339.625
18/02/2015 23:00,25,47102,3308,129,123,3943,23,7526,339.625
19/02/2015 00:00,23.92,44450,3295,79,163,3846,23,7406,339.625
19/02/2015 01:00,23.15,43562,3209,86,162,3795,20,7272,339.625
19/02/2015 02:00,22.86,43326,3124,93,161,3745,19,7142,339.625
19/02/2015 03:00,23.02,43425,3069,97,159,3697,19,7041,339.625
19/02/2015 04:00,23.95,44396,3068,97,158,3651,18,6992,339.625
19/02/2015 05:00,25.52,47023,3102,99,155,3541,17,6914,339.625
19/02/2015 06:00,26.64,51283,3151,101,152,3531,20,6955,339.625
19/02/2015 07:00,27.4,54949,3207,105,148,3527,20,7007,339.625
19/02/2015 08:00,27.6,56258,3255,110,147,3501,21,7034,339.625
19/02/2015 09:00,27.48,56086,3284,118,145,3501,21,7069,339.625
19/02/2015 10:00,27.44,56077,3313,129,143,3407,19,7011,339.625
19/02/2015 11:00,27.19,55728,3315,142,142,3519,19,7137,339.625
19/02/2015 12:00,27.04,55050,3278,154,140,3534,17,7123,339.625
19/02/2015 13:00,27.09,54796,3231,163,139,3574,18,7125,339.625
19/02/2015 14:00,26.99,54536,3197,164,135,3624,19,7139,339.625
19/02/2015 15:00,26.95,54378,3165,170,131,3646,20,7132,339.625
19/02/2015 16:00,27.11,54969,3156,174,127,3721,18,7196,339.625
19/02/2015 17:00,27.5,56676,3195,180,125,3759,20,7279,339.625
19/02/2015 18:00,27.53,56709,3257,185,122,3768,20,7352,339.625
19/02/2015 19:00,27.17,55473,3305,189,118,3736,19,7367,339.625
19/02/2015 20:00,26.63,53637,3351,190,120,3677,20,7358,339.625
19/02/2015 21:00,26.32,52091,3406,188,120,3572,22,7308,339.625
19/02/2015 22:00,25.8,49702,3400,185,121,3457,21,7184,339.625
19/02/2015 23:00,24.71,47013,3307,178,118,3413,21,7037,339.625
20/02/2015 00:00,22.73,44541,3178,177,113,3317,23,6808,339.625
20/02/2015 01:00,22.26,43681,3036,172,108,3322,24,6662,339.625
20/02/2015 02:00,22.17,43430,2893,172,102,3276,27,6470,339.625
20/02/2015 03:00,22.53,43646,2756,175,97,3277,26,6331,339.625
20/02/2015 04:00,23.44,44581,2611,175,91,3099,27,6003,339.625
20/02/2015 05:00,25.24,47086,2474,172,89,3084,28,5847,339.625
20/02/2015 06:00,26.25,51494,2364,168,88,3030,29,5679,339.625
20/02/2015 07:00,27.14,55377,2278,166,86,2948,31,5509,339.625
20/02/2015 08:00,27.23,56910,2231,167,89,2969,33,5489,339.625
20/02/2015 09:00,27.22,56761,2200,172,93,2918,37,5420,339.625
20/02/2015 10:00,27.21,56553,2188,179,96,2811,40,5314,339.625
20/02/2015 11:00,26.95,55967,2199,183,97,2762,42,5283,339.625
20/02/2015 12:00,26.75,55377,2189,187,98,2650,42,5166,339.625
20/02/2015 13:00,26.54,54527,2126,190,99,2647,41,5103,339.625
20/02/2015 14:00,26.72,53948,2008,194,95,2566,37,4900,339.625
20/02/2015 15:00,26.68,53624,1860,197,92,2565,35,4749,339.625
20/02/2015 16:00,26.91,53993,1730,200,89,2612,37,4668,339.625
20/02/2015 17:00,27.34,55470,1634,206,92,2624,39,4595,339.625
20/02/2015 18:00,27.42,55599,1601,207,96,2812,38,4754,339.625
20/02/2015 19:00,27.01,53980,1509,206,99,2800,37,4651,339.625
20/02/2015 20:00,26.39,51771,1293,204,99,2788,40,4424,339.625
20/02/2015 21:00,26.2,50181,1073,201,98,2664,39,4075,339.625
20/02/2015 22:00,25.98,48335,915,197,97,2551,31,3791,339.625
20/02/2015 23:00,25.55,46501,794,190,87,2390,25,3486,339.625
21/02/2015 00:00,25.46,44272,556,156,99,2040,28,2879,339.625
21/02/2015 01:00,25.11,43261,458,142,92,1899,24,2615,339.625
21/02/2015 02:00,25.09,42846,376,139,86,1739,21,2361,339.625
21/02/2015 03:00,24.94,42748,336,139,81,1670,17,2243,339.625
21/02/2015 04:00,24.96,43010,328,138,75,1545,16,2102,339.625
21/02/2015 05:00,24.88,43839,311,136,78,1516,17,2058,339.625
21/02/2015 06:00,25.08,44946,300,141,80,1422,15,1958,339.625
21/02/2015 07:00,25.69,46390,301,145,83,1417,13,1959,339.625
21/02/2015 08:00,26.06,48255,300,155,88,1464,12,2019,339.625
21/02/2015 09:00,26.38,49915,298,160,92,1325,14,1889,339.625
21/02/2015 10:00,26.7,50762,296,159,96,1254,15,1820,339.625
21/02/2015 11:00,26.67,50680,289,145,98,1093,16,1641,339.625
21/02/2015 12:00,26.17,50197,297,130,101,1026,17,1571,339.625
21/02/2015 13:00,25.98,49760,340,119,105,997,17,1578,339.625
21/02/2015 14:00,25.97,49429,419,115,109,1004,18,1665,339.625
21/02/2015 15:00,26.18,49668,559,114,115,1057,21,1866,339.625
21/02/2015 16:00,26.47,50955,697,122,122,1120,21,2082,339.625
21/02/2015 17:00,26.99,52906,800,130,126,1166,24,2246,339.625
21/02/2015 18:00,27.09,53109,933,139,130,1257,28,2487,339.625
21/02/2015 19:00,26.68,51516,1033,150,134,1349,28,2694,339.625
21/02/2015 20:00,26.25,49669,1054,162,130,1449,28,2823,339.625
21/02/2015 21:00,26.1,48425,1103,172,126,1629,27,3057,339.625
21/02/2015 22:00,25.9,46988,1192,178,122,1698,25,3215,339.625
21/02/2015 23:00,25.35,45587,1312,178,131,1769,23,3413,339.625
22/02/2015 00:00,25.32,43901,1363,170,139,1677,20,3369,339.625
22/02/2015 01:00,25.03,43015,1387,174,149,1740,21,3471,339.625
22/02/2015 02:00,24.81,42543,1422,182,156,1709,26,3495,339.625
22/02/2015 03:00,24.72,42378,1474,196,158,1748,31,3607,339.625
22/02/2015 04:00,24.76,42580,1512,209,160,1819,42,3742,339.625
22/02/2015 05:00,24.98,43302,1581,220,146,1855,45,3847,339.625
22/02/2015 06:00,25.13,44064,1729,229,131,1938,52,4079,339.625
22/02/2015 07:00,25.33,45010,1773,237,115,2052,53,4230,339.625
22/02/2015 08:00,25.88,46813,1696,240,109,2177,52,4274,339.625
22/02/2015 09:00,26.11,48379,1617,235,103,2235,49,4239,339.625
22/02/2015 10:00,26.22,49400,1568,229,98,2262,42,4199,339.625
22/02/2015 11:00,26.18,49633,1557,228,91,2338,37,4251,339.625
22/02/2015 12:00,25.84,49204,1508,234,86,2333,29,4190,339.625
22/02/2015 13:00,25.52,48936,1439,235,81,2344,27,4126,339.625
22/02/2015 14:00,25.31,48646,1400,227,68,2326,22,4043,339.625
22/02/2015 15:00,25.05,48818,1409,215,61,2299,22,4006,339.625
22/02/2015 16:00,25.9,50095,1434,206,55,2319,19,4033,339.625
22/02/2015 17:00,26.59,52158,1479,197,54,2283,17,4030,339.625
22/02/2015 18:00,26.79,53087,1686,192,53,2276,15,4222,339.625
22/02/2015 19:00,26.53,52414,2018,188,52,2191,12,4461,339.625
22/02/2015 20:00,26.05,51146,2439,184,54,2184,12,4873,339.625
22/02/2015 21:00,26.05,50215,2865,179,57,2078,11,5190,339.625
22/02/2015 22:00,25.64,48576,3249,173,60,2089,10,5581,339.625
22/02/2015 23:00,25.08,46529,3543,163,56,2016,11,5789,339.625
23/02/2015 00:00,23.86,44949,3777,161,25,2151,10,6124,3.228.809.524
23/02/2015 01:00,22.67,44306,3914,145,21,2256,10,6346,3.228.809.524
23/02/2015 02:00,22.25,44127,4014,134,18,2385,10,6561,3.228.809.524
23/02/2015 03:00,22.29,44389,4117,124,18,2513,9,6781,3.228.809.524
23/02/2015 04:00,22.67,45394,4200,120,20,2711,9,7060,3.228.809.524
23/02/2015 05:00,23.98,48094,4239,119,26,2987,8,7379,3.228.809.524
23/02/2015 06:00,26,52458,4239,124,33,3346,9,7751,3.228.809.524
23/02/2015 07:00,26.7,56360,4156,135,41,3595,11,7938,3.228.809.524
23/02/2015 08:00,26.82,57536,3872,147,48,3775,12,7854,3.228.809.524
23/02/2015 09:00,26.78,57380,3430,149,54,3900,13,7546,3.228.809.524
23/02/2015 10:00,26.77,57304,3083,143,60,4074,18,7378,3.228.809.524
23/02/2015 11:00,26.72,56932,2847,132,64,4180,22,7245,3.228.809.524
23/02/2015 12:00,26.67,56343,2657,125,71,4236,23,7112,3.228.809.524
23/02/2015 13:00,26.61,55952,2527,120,77,4203,22,6949,3.228.809.524
23/02/2015 14:00,26.63,55640,2401,123,80,4107,18,6729,3.228.809.524
23/02/2015 15:00,26.64,55359,2230,133,82,3925,17,6387,3.228.809.524
23/02/2015 16:00,26.72,55599,2125,145,84,3756,16,6126,3.228.809.524
23/02/2015 17:00,27.22,57277,2050,154,90,3560,13,5867,3.228.809.524
23/02/2015 18:00,27.36,57541,2045,164,94,3377,14,5694,3.228.809.524
23/02/2015 19:00,26.98,56268,2130,172,97,3216,15,5630,3.228.809.524
23/02/2015 20:00,26.55,54317,2225,175,94,3040,14,5548,3.228.809.524
23/02/2015 21:00,26.38,52743,2293,177,92,2805,13,5380,3.228.809.524
23/02/2015 22:00,26.1,50303,2361,177,89,2632,12,5271,3.228.809.524
23/02/2015 23:00,24.93,47526,2436,175,81,2488,12,5192,3.228.809.524
24/02/2015 00:00,24.98,45065,2265,191,72,2365,13,4906,3.228.809.524
24/02/2015 01:00,24.64,44193,2291,193,57,2301,12,4854,3.228.809.524
24/02/2015 02:00,23.9,43853,2317,191,46,2252,11,4817,3.228.809.524
24/02/2015 03:00,24,44081,2363,186,35,2198,10,4792,3.228.809.524
24/02/2015 04:00,24.93,45140,2428,177,26,2157,7,4795,3.228.809.524
24/02/2015 05:00,25.51,47766,2495,163,24,2190,5,4877,3.228.809.524
24/02/2015 06:00,26.5,52093,2588,146,22,2243,4,5003,3.228.809.524
24/02/2015 07:00,27.23,55914,2735,127,20,2254,4,5140,3.228.809.524
24/02/2015 08:00,27.41,57588,2922,108,22,2306,4,5362,3.228.809.524
24/02/2015 09:00,27.1,57177,3128,90,24,2336,4,5582,3.228.809.524
24/02/2015 10:00,26.98,57024,3292,74,27,2344,4,5741,3.228.809.524
24/02/2015 11:00,26.74,56432,3389,60,26,2403,4,5882,3.228.809.524
24/02/2015 12:00,26.5,55821,3458,46,25,2451,4,5984,3.228.809.524
24/02/2015 13:00,26.49,55429,3478,40,26,2535,5,6084,3.228.809.524
24/02/2015 14:00,26.54,55041,3457,35,19,2597,4,6112,3.228.809.524
24/02/2015 15:00,26.46,54780,3429,35,17,2673,5,6159,3.228.809.524
24/02/2015 16:00,26.5,55172,3380,36,15,2712,5,6148,3.228.809.524
24/02/2015 17:00,26.9,56890,3318,40,15,2828,4,6205,3.228.809.524
24/02/2015 18:00,27.07,57124,3269,46,14,2918,3,6250,3.228.809.524
24/02/2015 19:00,26.59,55747,3219,49,14,2959,3,6244,3.228.809.524
24/02/2015 20:00,26.17,53792,3126,50,14,2975,3,6168,3.228.809.524
24/02/2015 21:00,25.92,52129,2986,50,15,2965,3,6019,3.228.809.524
24/02/2015 22:00,25.37,49657,2811,47,15,2928,3,5804,3.228.809.524
24/02/2015 23:00,24.64,46880,2593,41,14,2880,3,5531,3.228.809.524
25/02/2015 00:00,23.66,43681,2843,53,16,2881,4,5797,3.228.809.524
25/02/2015 01:00,23.25,42737,2640,50,16,2829,4,5539,3.228.809.524
25/02/2015 02:00,23.1,42324,2343,51,14,2790,4,5202,3.228.809.524
25/02/2015 03:00,23.39,42478,2110,55,13,2684,4,4866,3.228.809.524
25/02/2015 04:00,24.19,43376,1967,61,12,2595,3,4638,3.228.809.524
25/02/2015 05:00,25.33,46023,1835,61,13,2548,3,4460,3.228.809.524
25/02/2015 06:00,26.31,50078,1682,62,14,2466,3,4227,3.228.809.524
25/02/2015 07:00,27.55,53789,1547,60,14,2390,4,4015,3.228.809.524
25/02/2015 08:00,27.97,54194,1440,57,9,2244,4,3754,3.228.809.524
25/02/2015 09:00,27.91,53901,1348,53,5,2102,3,3511,3.228.809.524
25/02/2015 10:00,27.8,53810,1217,48,3,2109,4,3381,3.228.809.524
25/02/2015 11:00,27.32,53362,1033,43,3,1934,3,3016,3.228.809.524
25/02/2015 12:00,27.22,52644,902,38,3,1790,3,2736,3.228.809.524
25/02/2015 13:00,27.12,52275,812,32,4,1663,2,2513,3.228.809.524
25/02/2015 14:00,27.22,51908,708,26,4,1505,2,2245,3.228.809.524
25/02/2015 15:00,27.21,51739,599,22,4,1403,2,2030,3.228.809.524
25/02/2015 16:00,27.31,51958,463,21,5,1339,2,1830,3.228.809.524
25/02/2015 17:00,28.39,53559,354,22,6,1278,2,1662,3.228.809.524
25/02/2015 18:00,32.94,53994,303,24,8,1280,2,1617,3.228.809.524
25/02/2015 19:00,28.55,52896,292,25,9,1321,2,1649,3.228.809.524
25/02/2015 20:00,27.34,51137,303,25,9,1292,2,1631,3.228.809.524
25/02/2015 21:00,26.83,49614,313,23,8,1239,2,1585,3.228.809.524
25/02/2015 22:00,26.44,47308,297,21,7,1242,2,1569,3.228.809.524
25/02/2015 23:00,25.96,44797,266,18,6,1151,2,1443,3.228.809.524
26/02/2015 00:00,25.64,44442,346,13,4,1053,2,1418,3.228.809.524
26/02/2015 01:00,25.26,43508,384,10,4,989,2,1389,3.228.809.524
26/02/2015 02:00,25.07,43243,457,8,4,944,2,1415,3.228.809.524
26/02/2015 03:00,25.08,43413,568,8,4,923,2,1505,3.228.809.524
26/02/2015 04:00,25.55,44342,668,8,5,927,2,1610,3.228.809.524
26/02/2015 05:00,26.13,47006,807,8,5,945,2,1767,3.228.809.524
26/02/2015 06:00,26.92,50985,995,9,5,1007,2,2018,3.228.809.524
26/02/2015 07:00,28.92,54642,1219,9,5,1124,2,2359,3.228.809.524
26/02/2015 08:00,29.13,55548,1478,8,4,1200,2,2692,3.228.809.524
26/02/2015 09:00,28,55286,1749,7,2,1358,2,3118,3.228.809.524
26/02/2015 10:00,27.42,55056,2071,6,1,1437,2,3517,3.228.809.524
26/02/2015 11:00,26.82,54604,2412,4,1,1665,2,4084,3.228.809.524
26/02/2015 12:00,26.45,53783,2712,4,2,1802,2,4522,3.228.809.524
26/02/2015 13:00,26.34,53421,2904,4,2,1973,2,4885,3.228.809.524
26/02/2015 14:00,26.28,53072,2990,4,3,2216,2,5215,3.228.809.524
26/02/2015 15:00,26.16,52872,3041,4,4,2482,2,5533,3.228.809.524
26/02/2015 16:00,26.22,53256,3115,5,6,2711,2,5839,3.228.809.524
26/02/2015 17:00,26.71,55013,3205,6,9,2977,2,6199,3.228.809.524
26/02/2015 18:00,26.8,55773,3320,7,13,3183,2,6525,3.228.809.524
26/02/2015 19:00,26.29,54853,3422,8,15,3330,2,6777,3.228.809.524
26/02/2015 20:00,25.99,53047,3399,9,16,3479,2,6905,3.228.809.524
26/02/2015 21:00,25.62,51480,3325,10,17,3524,2,6878,3.228.809.524
26/02/2015 22:00,25.14,49027,3032,12,19,3436,2,6501,3.228.809.524
26/02/2015 23:00,24.09,46328,2514,12,19,3401,2,5948,3.228.809.524
27/02/2015 00:00,22.22,44513,2409,12,19,3686,2,6128,3.228.809.524
27/02/2015 01:00,21.95,43665,2000,14,18,3639,2,5673,3.228.809.524
27/02/2015 02:00,22.02,43367,1617,16,17,3587,2,5239,3.228.809.524
27/02/2015 03:00,23,43512,1373,18,16,3527,3,4937,3.228.809.524
27/02/2015 04:00,24.21,44509,1199,19,16,3461,2,4697,3.228.809.524
27/02/2015 05:00,25.3,47260,1059,19,17,3375,3,4473,3.228.809.524
27/02/2015 06:00,26.43,51582,920,20,18,3318,3,4279,3.228.809.524
27/02/2015 07:00,26.97,55264,773,17,19,3195,3,4007,3.228.809.524
27/02/2015 08:00,27.36,56796,653,14,16,3062,4,3749,3.228.809.524
27/02/2015 09:00,27.29,56594,586,12,13,2916,3,3530,3.228.809.524
27/02/2015 10:00,27.24,56394,530,11,11,2780,4,3336,3.228.809.524
27/02/2015 11:00,26.85,55587,493,10,8,2670,4,3185,3.228.809.524
27/02/2015 12:00,26.64,54784,475,9,6,2578,4,3072,3.228.809.524
27/02/2015 13:00,26.54,53958,441,9,6,2430,3,2889,3.228.809.524
27/02/2015 14:00,26.52,53331,411,9,5,2290,2,2717,3.228.809.524
27/02/2015 15:00,26.43,52869,403,9,5,2186,2,2605,3.228.809.524
27/02/2015 16:00,26.56,53115,362,9,5,2097,2,2475,3.228.809.524
27/02/2015 17:00,27,54612,297,10,6,2016,2,2331,3.228.809.524
27/02/2015 18:00,27.6,55129,275,11,7,1931,3,2227,3.228.809.524
27/02/2015 19:00,26.8,53759,299,11,8,1864,3,2185,3.228.809.524
27/02/2015 20:00,26.19,51638,363,9,8,1832,2,2214,3.228.809.524
27/02/2015 21:00,26.07,50149,451,8,8,1766,2,2235,3.228.809.524
27/02/2015 22:00,25.72,48333,493,7,8,1766,2,2276,3.228.809.524
27/02/2015 23:00,25.28,46501,506,6,8,1765,1,2286,3.228.809.524
28/02/2015 00:00,25.91,44373,308,2,4,1559,0,1873,3.228.809.524
28/02/2015 01:00,25.42,43401,339,2,4,1484,0,1829,3.228.809.524
28/02/2015 02:00,25.1,42942,376,2,3,1448,0,1829,3.228.809.524
28/02/2015 03:00,25.1,42818,426,2,3,1350,0,1781,3.228.809.524
28/02/2015 04:00,25.16,43092,476,2,3,1317,0,1798,3.228.809.524
28/02/2015 05:00,25.5,43950,524,2,3,1269,0,1798,3.228.809.524
28/02/2015 06:00,25.53,44899,596,2,4,1247,0,1849,3.228.809.524
28/02/2015 07:00,26.08,46332,731,3,3,1287,0,2024,3.228.809.524
28/02/2015 08:00,26.37,48267,947,4,3,1315,0,2269,3.228.809.524
28/02/2015 09:00,26.41,49727,1234,5,3,1362,0,2604,3.228.809.524
28/02/2015 10:00,26.42,50432,1546,6,3,1467,1,3023,3.228.809.524
28/02/2015 11:00,26.23,50264,1879,8,4,1571,1,3463,3.228.809.524
28/02/2015 12:00,25.65,49662,2231,10,5,1770,1,4017,3.228.809.524
28/02/2015 13:00,24.83,49176,2476,13,7,1973,1,4470,3.228.809.524
28/02/2015 14:00,24.8,48765,2575,16,8,2183,1,4783,3.228.809.524
28/02/2015 15:00,24.91,48539,2623,19,9,2411,1,5063,3.228.809.524
28/02/2015 16:00,25.33,49645,2666,23,9,2581,1,5280,3.228.809.524
28/02/2015 17:00,26.16,51797,2769,28,12,2704,1,5514,3.228.809.524
28/02/2015 18:00,26.31,52780,2934,33,16,2882,1,5866,3.228.809.524
28/02/2015 19:00,25.76,51401,3150,37,21,2980,1,6189,3.228.809.524
28/02/2015 20:00,24.89,49630,3379,43,24,3137,1,6584,3.228.809.524
28/02/2015 21:00,23.9,48623,3572,49,28,3248,1,6898,3.228.809.524
28/02/2015 22:00,23.09,47301,3706,55,32,3341,1,7135,3.228.809.524
28/02/2015 23:00,22.28,45842,3785,61,31,3427,2,7306,3.228.809.524
01/03/2015 00:00,22.53,43483,3890,56,24,3515,7,7492,3.228.809.524
01/03/2015 01:00,21.68,42657,3946,65,22,3579,6,7618,3.228.809.524
01/03/2015 02:00,21.11,42256,3593,73,19,3692,6,7383,3.228.809.524
01/03/2015 03:00,20.87,42167,3614,81,17,3825,6,7543,3.228.809.524
01/03/2015 04:00,20.17,42462,3660,89,15,3945,6,7715,3.228.809.524
01/03/2015 05:00,19.77,43144,3711,96,18,4058,7,7890,3.228.809.524
01/03/2015 06:00,19.78,43778,3749,100,22,4188,7,8066,3.228.809.524
01/03/2015 07:00,19.91,44755,3730,102,26,4294,7,8159,3.228.809.524
01/03/2015 08:00,21.75,46438,4027,100,39,4347,7,8520,3.228.809.524
01/03/2015 09:00,23.07,48038,3830,98,54,4427,9,8418,3.228.809.524
01/03/2015 10:00,23.76,49287,3591,97,72,4490,10,8260,3.228.809.524
01/03/2015 11:00,24.01,49415,3398,97,79,4541,12,8127,3.228.809.524
01/03/2015 12:00,23.33,49053,3325,99,87,4556,21,8088,3.228.809.524
01/03/2015 13:00,23.26,48806,3287,100,96,4502,26,8011,3.228.809.524
01/03/2015 14:00,23.02,48680,3214,102,98,4375,27,7816,3.228.809.524
01/03/2015 15:00,23.32,49035,3159,108,106,4247,27,7647,3.228.809.524
01/03/2015 16:00,24.12,49952,3098,114,113,4047,20,7392,3.228.809.524
01/03/2015 17:00,25.03,51900,3006,123,126,3907,17,7179,3.228.809.524
01/03/2015 18:00,25.7,53081,2951,132,137,3775,17,7012,3.228.809.524
01/03/2015 19:00,25.66,52142,2975,141,148,3673,19,6956,3.228.809.524
01/03/2015 20:00,24.88,50640,3046,148,146,3562,26,6928,3.228.809.524
01/03/2015 21:00,24.35,49671,3108,150,144,3453,29,6884,3.228.809.524
01/03/2015 22:00,23.95,47891,3075,151,142,3340,31,6739,3.228.809.524
01/03/2015 23:00,22.73,45884,2955,150,135,3255,29,6524,3.228.809.524
02/03/2015 00:00,22.02,43568,1942,163,123,3191,25,5444,3.066.547.619
02/03/2015 01:00,20.59,42864,1613,161,111,3032,23,4940,3.066.547.619
02/03/2015 02:00,20.53,42680,1333,161,92,2877,22,4485,3.066.547.619
02/03/2015 03:00,21.54,42966,1150,160,75,2798,17,4200,3.066.547.619
02/03/2015 04:00,22.69,44096,1044,160,60,2651,14,3929,3.066.547.619
02/03/2015 05:00,24.15,46838,1085,157,55,2452,15,3764,3.066.547.619
02/03/2015 06:00,26.5,51151,1222,155,50,2340,12,3779,3.066.547.619
02/03/2015 07:00,27.21,55057,1320,150,46,2194,12,3722,3.066.547.619
02/03/2015 08:00,27.49,56301,1488,140,47,2085,10,3770,3.066.547.619
02/03/2015 09:00,27.24,56113,1772,130,49,1935,9,3895,3.066.547.619
02/03/2015 10:00,27.15,55927,2087,118,51,1830,7,4093,3.066.547.619
02/03/2015 11:00,26.86,55498,2414,105,48,1738,8,4313,3.066.547.619
02/03/2015 12:00,26.28,54903,2742,93,46,1639,7,4527,3.066.547.619
02/03/2015 13:00,26.13,54498,2995,83,45,1642,8,4773,3.066.547.619
02/03/2015 14:00,26.31,54028,3158,74,41,1618,9,4900,3.066.547.619
02/03/2015 15:00,26.5,53712,3280,64,41,1569,6,4960,3.066.547.619
02/03/2015 16:00,26.56,53835,3346,58,41,1592,7,5044,3.066.547.619
02/03/2015 17:00,26.98,55254,3261,54,48,1575,6,4944,3.066.547.619
02/03/2015 18:00,27.23,55964,3127,52,54,1613,7,4853,3.066.547.619
02/03/2015 19:00,26.75,54834,3041,49,58,1645,9,4802,3.066.547.619
02/03/2015 20:00,26.23,52875,3032,46,68,1683,7,4836,3.066.547.619
02/03/2015 21:00,25.86,51307,3053,43,81,1679,9,4865,3.066.547.619
02/03/2015 22:00,24.96,48846,3087,42,94,1692,9,4924,3.066.547.619
02/03/2015 23:00,23.9,46118,3132,41,104,1720,6,5003,3.066.547.619
03/03/2015 00:00,23.51,44152,2629,36,131,1516,6,4318,3.066.547.619
03/03/2015 01:00,22.74,43297,2716,45,142,1448,6,4357,3.066.547.619
03/03/2015 02:00,22.36,42947,2871,55,150,1449,5,4530,3.066.547.619
03/03/2015 03:00,22.35,43231,2995,65,158,1391,7,4616,3.066.547.619
03/03/2015 04:00,23.19,44254,3006,71,166,1411,8,4662,3.066.547.619
03/03/2015 05:00,24.59,46955,2948,77,175,1411,10,4621,3.066.547.619
03/03/2015 06:00,26.36,51089,2852,83,182,1423,13,4553,3.066.547.619
03/03/2015 07:00,27.09,54782,2774,92,169,1471,15,4521,3.066.547.619
03/03/2015 08:00,27.3,55616,2814,94,177,1491,19,4595,3.066.547.619
03/03/2015 09:00,26.89,55299,2942,99,182,1542,25,4790,3.066.547.619
03/03/2015 10:00,26.66,55571,3096,106,189,1597,31,5019,3.066.547.619
03/03/2015 11:00,26.52,54774,3122,108,194,1662,39,5125,3.066.547.619
03/03/2015 12:00,26.18,53993,3024,109,171,1688,41,5033,3.066.547.619
03/03/2015 13:00,26.07,53643,2906,109,172,1687,43,4917,3.066.547.619
03/03/2015 14:00,26.33,53218,2623,114,173,1661,48,4619,3.066.547.619
03/03/2015 15:00,26.59,52907,2253,119,172,1571,50,4165,3.066.547.619
03/03/2015 16:00,26.66,53052,1922,130,165,1485,51,3753,3.066.547.619
03/03/2015 17:00,27.32,54471,1576,141,191,1419,57,3384,3.066.547.619
03/03/2015 18:00,28.21,55349,1364,149,188,1346,60,3107,3.066.547.619
03/03/2015 19:00,27.26,54339,1302,151,185,1339,62,3039,3.066.547.619
03/03/2015 20:00,26.69,52509,1303,154,176,1297,63,2993,3.066.547.619
03/03/2015 21:00,26.3,51043,1371,159,166,1239,62,2997,3.066.547.619
03/03/2015 22:00,26.04,48689,1373,160,154,1185,59,2931,3.066.547.619
03/03/2015 23:00,24.93,46013,1352,155,140,1147,50,2844,3.066.547.619
04/03/2015 00:00,24.41,44486,1210,111,123,909,29,2382,3.066.547.619
04/03/2015 01:00,23.73,43526,1290,114,109,872,21,2406,3.066.547.619
04/03/2015 02:00,23.34,43218,1309,112,91,839,16,2367,3.066.547.619
04/03/2015 03:00,23.56,43519,1304,110,75,840,14,2343,3.066.547.619
04/03/2015 04:00,24.39,44546,1252,109,60,839,13,2273,3.066.547.619
04/03/2015 05:00,25.7,47182,1189,106,48,836,9,2188,3.066.547.619
04/03/2015 06:00,26.91,51316,1202,106,38,834,8,2188,3.066.547.619
04/03/2015 07:00,29.03,55013,1213,103,30,789,6,2141,3.066.547.619
04/03/2015 08:00,29.98,55890,1221,98,22,757,6,2104,3.066.547.619
04/03/2015 09:00,28.9,56343,1294,99,15,673,8,2089,3.066.547.619
04/03/2015 10:00,27.22,55861,1288,101,10,647,8,2054,3.066.547.619
04/03/2015 11:00,26.97,54966,1166,95,7,646,7,1921,3.066.547.619
04/03/2015 12:00,26.84,54279,1014,83,7,661,7,1772,3.066.547.619
04/03/2015 13:00,26.81,53909,825,71,9,666,7,1578,3.066.547.619
04/03/2015 14:00,26.81,53452,720,61,10,664,7,1462,3.066.547.619
04/03/2015 15:00,26.65,53060,762,50,16,641,6,1475,3.066.547.619
04/03/2015 16:00,26.87,53184,836,44,25,614,5,1524,3.066.547.619
04/03/2015 17:00,28.17,54634,865,41,28,622,3,1559,3.066.547.619
04/03/2015 18:00,29.27,55584,935,39,31,735,3,1743,3.066.547.619
04/03/2015 19:00,28.06,54829,990,37,35,876,3,1941,3.066.547.619
04/03/2015 20:00,27.02,53631,1053,33,32,990,3,2111,3.066.547.619
04/03/2015 21:00,26.63,52129,1181,30,29,1037,3,2280,3.066.547.619
04/03/2015 22:00,26.28,49669,1306,25,26,1107,3,2467,3.066.547.619
04/03/2015 23:00,25.23,46998,1393,21,21,1197,3,2635,3.066.547.619
05/03/2015 00:00,25.02,45212,1305,11,24,1151,2,2493,3.066.547.619
05/03/2015 01:00,24.28,44410,1345,8,19,1142,2,2516,3.066.547.619
05/03/2015 02:00,24.02,44148,1352,6,16,1127,2,2503,3.066.547.619
05/03/2015 03:00,24.25,44389,1354,4,13,1112,2,2485,3.066.547.619
05/03/2015 04:00,24.97,45464,1365,2,11,1084,2,2464,3.066.547.619
05/03/2015 05:00,25.78,48054,1322,1,10,1020,2,2355,3.066.547.619
05/03/2015 06:00,26.98,52311,1243,1,8,952,2,2206,3.066.547.619
05/03/2015 07:00,30.44,55918,1137,1,6,859,2,2005,3.066.547.619
05/03/2015 08:00,36.32,56732,990,1,4,685,2,1682,3.066.547.619
05/03/2015 09:00,35.59,56916,871,1,2,506,2,1382,3.066.547.619
05/03/2015 10:00,30.18,56132,808,1,2,349,2,1162,3.066.547.619
05/03/2015 11:00,30.32,55068,760,1,3,254,2,1020,3.066.547.619
05/03/2015 12:00,28.52,54120,703,2,5,233,2,945,3.066.547.619
05/03/2015 13:00,27.79,53655,608,3,9,277,3,900,3.066.547.619
05/03/2015 14:00,28.69,53135,524,4,12,410,2,952,3.066.547.619
05/03/2015 15:00,28.23,52743,492,5,14,565,2,1078,3.066.547.619
05/03/2015 16:00,28.51,52970,474,6,16,834,2,1332,3.066.547.619
05/03/2015 17:00,29.91,54641,464,6,18,967,2,1457,3.066.547.619
05/03/2015 18:00,42.23,55717,494,7,20,1405,2,1928,3.066.547.619
05/03/2015 19:00,30.47,54894,591,7,23,1626,2,2249,3.066.547.619
05/03/2015 20:00,27.24,53179,737,8,19,1934,2,2700,3.066.547.619
05/03/2015 21:00,26.72,51969,902,9,17,2164,2,3094,3.066.547.619
05/03/2015 22:00,26.18,49587,1032,12,14,2347,2,3407,3.066.547.619
05/03/2015 23:00,25.52,46925,1149,15,10,2501,2,3677,3.066.547.619
06/03/2015 00:00,25.04,44473,1519,23,40,3016,4,4602,3.066.547.619
06/03/2015 01:00,24.38,43573,1623,33,40,3071,4,4771,3.066.547.619
06/03/2015 02:00,23.96,43273,1711,46,40,3086,4,4887,3.066.547.619
06/03/2015 03:00,23.94,43346,1754,64,40,3013,5,4876,3.066.547.619
06/03/2015 04:00,24.85,44264,1783,81,40,2930,4,4838,3.066.547.619
06/03/2015 05:00,25.57,46764,1807,95,40,2810,5,4757,3.066.547.619
06/03/2015 06:00,26.36,50731,1796,106,40,2692,7,4641,3.066.547.619
06/03/2015 07:00,27.72,54337,1756,119,40,2530,9,4454,3.066.547.619
06/03/2015 08:00,29.09,55380,1706,130,40,2393,13,4282,3.066.547.619
06/03/2015 09:00,28.82,55647,1670,142,40,2243,19,4114,3.066.547.619
06/03/2015 10:00,28.02,55335,1647,151,40,2140,24,4002,3.066.547.619
06/03/2015 11:00,27.33,54559,1672,161,40,1946,25,3844,3.066.547.619
06/03/2015 12:00,26.85,53556,1715,169,40,1847,28,3799,3.066.547.619
06/03/2015 13:00,26.57,52664,1675,175,40,1616,37,3543,3.066.547.619
06/03/2015 14:00,26.52,51786,1529,178,40,1476,38,3261,3.066.547.619
06/03/2015 15:00,26.39,51281,1387,179,40,1311,37,2954,3.066.547.619
06/03/2015 16:00,26.48,51328,1280,175,40,1160,34,2689,3.066.547.619
06/03/2015 17:00,27.31,52624,1225,163,40,1138,30,2596,3.066.547.619
06/03/2015 18:00,28.12,53567,1214,146,40,1237,25,2662,3.066.547.619
06/03/2015 19:00,26.99,52551,1238,127,40,1253,17,2675,3.066.547.619
06/03/2015 20:00,26.15,50577,1318,108,40,1377,13,2856,3.066.547.619
06/03/2015 21:00,25.8,49252,1471,93,40,1547,11,3162,3.066.547.619
06/03/2015 22:00,25.52,47466,1621,79,40,1755,8,3503,3.066.547.619
06/03/2015 23:00,25.05,45596,1751,63,40,2003,5,3862,3.066.547.619
07/03/2015 00:00,23.62,43105,2337,31,43,2548,2,4961,3.066.547.619
07/03/2015 01:00,22.79,42135,2472,24,34,2821,0,5351,3.066.547.619
07/03/2015 02:00,22,41706,2680,19,31,3089,1,5820,3.066.547.619
07/03/2015 03:00,21.7,41604,2900,15,29,3332,1,6277,3.066.547.619
07/03/2015 04:00,21.39,41878,3054,12,27,3541,1,6635,3.066.547.619
07/03/2015 05:00,21.5,42610,3160,13,28,3716,1,6918,3.066.547.619
07/03/2015 06:00,21.78,43426,3268,20,29,3890,2,7209,3.066.547.619
07/03/2015 07:00,21.95,44851,3374,32,30,4021,3,7460,3.066.547.619
07/03/2015 08:00,22.25,46660,3465,49,34,4145,5,7698,3.066.547.619
07/03/2015 09:00,23.07,47799,3537,71,38,4232,9,7887,3.066.547.619
07/03/2015 10:00,23.31,48429,3584,97,44,4303,17,8045,3.066.547.619
07/03/2015 11:00,23.16,48168,3574,128,52,4374,24,8152,3.066.547.619
07/03/2015 12:00,22.5,47714,3543,159,64,4434,33,8233,3.066.547.619
07/03/2015 13:00,22.26,47136,3487,185,76,4446,37,8231,3.066.547.619
07/03/2015 14:00,22.08,46709,3391,203,80,4430,45,8149,3.066.547.619
07/03/2015 15:00,22.09,46704,3264,218,85,4378,61,8006,3.066.547.619
07/03/2015 16:00,22.73,47445,3167,230,91,4326,60,7874,3.066.547.619
07/03/2015 17:00,23.85,49436,3122,240,102,4313,60,7837,3.066.547.619
07/03/2015 18:00,24.42,50547,3126,245,114,4302,63,7850,3.066.547.619
07/03/2015 19:00,24.24,49187,3177,245,125,4235,62,7844,3.066.547.619
07/03/2015 20:00,23.26,47335,3216,240,131,4104,59,7750,3.066.547.619
07/03/2015 21:00,22.29,46255,3229,232,136,4042,57,7696,3.066.547.619
07/03/2015 22:00,22.12,44850,3218,222,141,3948,57,7586,3.066.547.619
07/03/2015 23:00,21.72,43280,3187,212,141,4041,54,7635,3.066.547.619
08/03/2015 00:00,20.06,41294,3234,188,136,4075,56,7689,3.066.547.619
08/03/2015 01:00,18.21,40395,3150,178,134,4009,56,7527,3.066.547.619
08/03/2015 02:00,18.01,39920,3061,174,133,4024,56,7448,3.066.547.619
08/03/2015 03:00,17.97,39822,2982,176,134,3994,57,7343,3.066.547.619
08/03/2015 04:00,18.15,39991,2965,185,134,3986,55,7325,3.066.547.619
08/03/2015 05:00,18.43,40450,2975,199,137,3978,55,7344,3.066.547.619
08/03/2015 06:00,18.54,40912,2988,212,139,3955,54,7348,3.066.547.619
08/03/2015 07:00,19.18,41806,2994,223,141,3952,51,7361,3.066.547.619
08/03/2015 08:00,20.08,43275,2957,230,136,3901,53,7277,3.066.547.619
08/03/2015 09:00,21.42,44549,2860,234,130,3845,56,7125,3.066.547.619
08/03/2015 10:00,21.42,45291,2729,235,126,3877,58,7025,3.066.547.619
08/03/2015 11:00,21.86,45304,2628,235,125,3743,61,6792,3.066.547.619
08/03/2015 12:00,21.28,44858,2562,236,124,3761,62,6745,3.066.547.619
08/03/2015 13:00,21.09,44365,2499,237,124,3687,64,6611,3.066.547.619
08/03/2015 14:00,21.42,44011,2390,239,124,3708,65,6526,3.066.547.619
08/03/2015 15:00,21.46,44019,2205,239,123,3631,66,6264,3.066.547.619
08/03/2015 16:00,22.03,44890,1977,236,122,3597,62,5994,3.066.547.619
08/03/2015 17:00,24.46,46835,1760,232,127,3627,58,5804,3.066.547.619
08/03/2015 18:00,25.29,48384,1576,226,131,3627,54,5614,3.066.547.619
08/03/2015 19:00,25.3,48026,1420,220,135,3584,48,5407,3.066.547.619
08/03/2015 20:00,25,46739,1307,214,135,3456,46,5158,3.066.547.619
08/03/2015 21:00,24.55,45853,1237,207,133,3311,38,4926,3.066.547.619
08/03/2015 22:00,23.75,44210,1158,197,132,3163,30,4680,3.066.547.619
08/03/2015 23:00,22.69,42231,1098,180,126,3072,27,4503,3.066.547.619
09/03/2015 00:00,22.26,40599,1446,192,112,2970,28,4748,2.911.369.048
09/03/2015 01:00,22.34,39981,1398,184,106,2845,19,4552,2.911.369.048
09/03/2015 02:00,22.4,39895,1318,173,99,2753,13,4356,2.911.369.048
09/03/2015 03:00,22.83,40263,1233,162,93,2736,10,4234,2.911.369.048
09/03/2015 04:00,23.76,41464,1080,151,88,2743,11,4073,2.911.369.048
09/03/2015 05:00,25.05,44255,876,143,84,2826,13,3942,2.911.369.048
09/03/2015 06:00,26.14,48529,650,129,79,2846,11,3715,2.911.369.048
09/03/2015 07:00,26.7,52439,482,109,74,2775,12,3452,2.911.369.048
09/03/2015 08:00,27.4,54146,371,88,70,2644,12,3185,2.911.369.048
09/03/2015 09:00,26.78,53523,301,74,65,2438,13,2891,2.911.369.048
09/03/2015 10:00,26.45,52725,249,70,60,2372,15,2766,2.911.369.048
09/03/2015 11:00,26.23,51633,195,69,55,2342,13,2674,2.911.369.048
09/03/2015 12:00,25.95,50723,151,73,51,2347,10,2632,2.911.369.048
09/03/2015 13:00,25.92,50216,135,77,47,2280,9,2548,2.911.369.048
09/03/2015 14:00,25.95,49907,156,81,38,2184,9,2468,2.911.369.048
09/03/2015 15:00,25.9,49738,238,86,30,2028,8,2390,2.911.369.048
09/03/2015 16:00,25.95,49962,367,88,24,1979,5,2463,2.911.369.048
09/03/2015 17:00,26.33,51570,525,88,20,1983,5,2621,2.911.369.048
09/03/2015 18:00,27.4,53037,741,90,18,1898,4,2751,2.911.369.048
09/03/2015 19:00,26.55,52670,1058,90,17,1912,4,3081,2.911.369.048
09/03/2015 20:00,26.07,51013,1440,85,15,1947,4,3491,2.911.369.048
09/03/2015 21:00,25.51,49609,1850,77,13,2000,5,3945,2.911.369.048
09/03/2015 22:00,24.8,47327,2191,71,10,2118,5,4395,2.911.369.048
09/03/2015 23:00,23.79,44929,2489,64,11,2232,5,4801,2.911.369.048
10/03/2015 00:00,23.29,42962,2868,28,7,2658,2,5563,2.911.369.048
10/03/2015 01:00,22.43,42238,3005,31,8,2912,4,5960,2.911.369.048
10/03/2015 02:00,21.85,42011,3013,43,11,3145,4,6216,2.911.369.048
10/03/2015 03:00,21.68,42303,2960,64,15,3336,5,6380,2.911.369.048
10/03/2015 04:00,22.58,43368,2750,84,21,3503,5,6363,2.911.369.048
10/03/2015 05:00,23.54,45904,2511,99,26,3728,7,6371,2.911.369.048
10/03/2015 06:00,25.01,50053,2373,109,31,3823,9,6345,2.911.369.048
10/03/2015 07:00,25.87,53610,2323,120,36,3809,11,6299,2.911.369.048
10/03/2015 08:00,26.13,54471,2427,129,38,3728,12,6334,2.911.369.048
10/03/2015 09:00,26.03,53846,2615,140,40,3723,15,6533,2.911.369.048
10/03/2015 10:00,25.81,53381,2756,149,43,3622,19,6589,2.911.369.048
10/03/2015 11:00,25.59,52649,2848,162,50,3549,22,6631,2.911.369.048
10/03/2015 12:00,25.15,51811,2958,180,59,3461,37,6695,2.911.369.048
10/03/2015 13:00,25.02,51331,3023,200,68,3267,38,6596,2.911.369.048
10/03/2015 14:00,25.11,50941,3045,220,61,3197,31,6554,2.911.369.048
10/03/2015 15:00,24.95,50505,3069,231,59,3137,36,6532,2.911.369.048
10/03/2015 16:00,25.03,50556,3056,236,56,3176,40,6564,2.911.369.048
10/03/2015 17:00,25.66,51939,2938,237,63,3206,36,6480,2.911.369.048
10/03/2015 18:00,26.11,53152,2780,234,70,3307,32,6423,2.911.369.048
10/03/2015 19:00,25.9,52660,2715,227,78,3446,29,6495,2.911.369.048
10/03/2015 20:00,25.11,50942,2726,219,79,3578,26,6628,2.911.369.048
10/03/2015 21:00,24.67,49480,2763,209,79,3733,19,6803,2.911.369.048
10/03/2015 22:00,23.88,47164,2815,198,78,3786,15,6892,2.911.369.048
10/03/2015 23:00,23.06,44617,2865,185,76,3826,12,6964,2.911.369.048
11/03/2015 00:00,21.9,42679,2905,179,55,3679,15,6833,2.911.369.048
11/03/2015 01:00,21.19,41853,2894,162,52,3597,12,6717,2.911.369.048
11/03/2015 02:00,21.1,41623,2918,148,49,3513,11,6639,2.911.369.048
11/03/2015 03:00,21.44,41934,2924,133,48,3402,9,6516,2.911.369.048
11/03/2015 04:00,23.13,43032,2752,117,47,3284,7,6207,2.911.369.048
11/03/2015 05:00,24.15,45481,2424,102,44,3167,7,5744,2.911.369.048
11/03/2015 06:00,25.1,49528,2122,85,41,3087,7,5342,2.911.369.048
11/03/2015 07:00,26.14,53129,1840,70,37,2845,6,4798,2.911.369.048
11/03/2015 08:00,27.37,53889,1602,63,34,2642,5,4346,2.911.369.048
11/03/2015 09:00,27.03,53295,1424,65,31,2476,4,4000,2.911.369.048
11/03/2015 10:00,26.71,52798,1201,78,29,2228,3,3539,2.911.369.048
11/03/2015 11:00,26.42,51898,980,89,24,1921,3,3017,2.911.369.048
11/03/2015 12:00,25.9,50926,811,92,21,1632,4,2560,2.911.369.048
11/03/2015 13:00,25.88,50435,665,95,18,1432,5,2215,2.911.369.048
11/03/2015 14:00,25.95,50069,565,93,15,1183,6,1862,2.911.369.048
11/03/2015 15:00,26.08,49735,502,94,16,1000,7,1619,2.911.369.048
11/03/2015 16:00,26.16,49929,402,102,17,809,8,1338,2.911.369.048
11/03/2015 17:00,28.61,51343,308,116,23,703,8,1158,2.911.369.048
11/03/2015 18:00,33.33,52765,258,129,29,669,11,1096,2.911.369.048
11/03/2015 19:00,35.22,52688,239,135,38,724,13,1149,2.911.369.048
11/03/2015 20:00,28.65,51232,280,134,43,951,12,1420,2.911.369.048
11/03/2015 21:00,26.95,49967,368,125,48,1264,9,1814,2.911.369.048
11/03/2015 22:00,25.99,47877,386,116,54,1486,7,2049,2.911.369.048
11/03/2015 23:00,25.54,45552,352,105,51,1586,7,2101,2.911.369.048
12/03/2015 00:00,25.05,44082,314,66,48,2045,8,2481,2.911.369.048
12/03/2015 01:00,24.84,43388,309,62,48,2112,2,2533,2.911.369.048
12/03/2015 02:00,24.63,43253,287,57,50,2144,2,2540,2.911.369.048
12/03/2015 03:00,24.75,43501,273,53,52,2163,2,2543,2.911.369.048
12/03/2015 04:00,25.15,44523,221,51,55,2133,2,2462,2.911.369.048
12/03/2015 05:00,25.71,47017,168,52,58,2083,2,2363,2.911.369.048
12/03/2015 06:00,27.92,51075,143,47,60,2061,2,2313,2.911.369.048
12/03/2015 07:00,32.94,54667,136,38,61,1961,2,2198,2.911.369.048
12/03/2015 08:00,32.97,54896,127,27,59,1860,2,2075,2.911.369.048
12/03/2015 09:00,31.54,54114,134,21,58,1609,3,1825,2.911.369.048
12/03/2015 10:00,30.41,53423,162,20,57,1394,3,1636,2.911.369.048
12/03/2015 11:00,28.43,52504,212,23,61,1225,3,1524,2.911.369.048
12/03/2015 12:00,27.91,51463,282,27,65,1102,3,1479,2.911.369.048
12/03/2015 13:00,26.95,50966,334,29,70,1024,3,1460,2.911.369.048
12/03/2015 14:00,27.15,50562,365,32,73,927,3,1400,2.911.369.048
12/03/2015 15:00,26.59,50154,400,36,76,913,3,1428,2.911.369.048
12/03/2015 16:00,26.53,50215,435,46,79,864,3,1427,2.911.369.048
12/03/2015 17:00,27.41,51548,467,59,86,840,2,1454,2.911.369.048
12/03/2015 18:00,29.5,52920,512,74,94,908,2,1590,2.911.369.048
12/03/2015 19:00,28.44,52874,608,78,102,986,3,1777,2.911.369.048
12/03/2015 20:00,26.24,51371,741,77,106,1091,3,2018,2.911.369.048
12/03/2015 21:00,25.47,50174,872,74,109,1192,3,2250,2.911.369.048
12/03/2015 22:00,25.24,48058,956,70,111,1264,2,2403,2.911.369.048
12/03/2015 23:00,24.89,45685,941,60,103,1362,2,2468,2.911.369.048
13/03/2015 00:00,24.52,43874,695,68,111,1308,12,2194,2.911.369.048
13/03/2015 01:00,24.13,43148,709,68,105,1429,12,2323,2.911.369.048
13/03/2015 02:00,24.06,43001,742,69,102,1506,13,2432,2.911.369.048
13/03/2015 03:00,24.16,43345,775,70,99,1631,13,2588,2.911.369.048
13/03/2015 04:00,24.66,44452,797,75,97,1690,13,2672,2.911.369.048
13/03/2015 05:00,25.25,46993,830,78,99,1759,15,2781,2.911.369.048
13/03/2015 06:00,26.12,51096,881,81,101,1790,18,2871,2.911.369.048
13/03/2015 07:00,28.55,54812,935,75,101,1769,22,2902,2.911.369.048
13/03/2015 08:00,29.83,55540,999,67,103,1774,29,2972,2.911.369.048
13/03/2015 09:00,28.3,54981,1106,61,105,1664,30,2966,2.911.369.048
13/03/2015 10:00,27.2,54238,1186,62,107,1857,29,3241,2.911.369.048
13/03/2015 11:00,26.41,53229,1183,68,106,1859,30,3246,2.911.369.048
13/03/2015 12:00,25.55,52015,1183,75,106,1906,29,3299,2.911.369.048
13/03/2015 13:00,25.25,50829,1184,83,105,1971,33,3376,2.911.369.048
13/03/2015 14:00,25.22,49818,1199,92,105,2015,34,3445,2.911.369.048
13/03/2015 15:00,25.15,49194,1243,104,105,2057,38,3547,2.911.369.048
13/03/2015 16:00,25.17,49324,1264,118,105,2091,36,3614,2.911.369.048
13/03/2015 17:00,25.54,50674,1226,129,108,2079,31,3573,2.911.369.048
13/03/2015 18:00,26.19,52091,1186,136,111,2084,24,3541,2.911.369.048
13/03/2015 19:00,26.06,51499,1187,132,115,2066,24,3524,2.911.369.048
13/03/2015 20:00,25.44,49664,1213,123,113,2063,25,3537,2.911.369.048
13/03/2015 21:00,25.3,48475,1258,110,110,2058,25,3561,2.911.369.048
13/03/2015 22:00,25.15,46806,1262,101,107,1963,23,3456,2.911.369.048
13/03/2015 23:00,24.9,44978,1179,88,103,1902,14,3286,2.911.369.048
14/03/2015 00:00,24.13,43329,1028,81,108,1860,9,3086,2.911.369.048
14/03/2015 01:00,23.9,42360,1040,76,102,1737,9,2964,2.911.369.048
14/03/2015 02:00,23.7,42032,1077,68,102,1649,8,2904,2.911.369.048
14/03/2015 03:00,23.76,42098,1165,62,104,1640,10,2981,2.911.369.048
14/03/2015 04:00,23.86,42497,1296,58,106,1704,13,3177,2.911.369.048
14/03/2015 05:00,23.99,43208,1453,55,104,1751,13,3376,2.911.369.048
14/03/2015 06:00,24.08,44028,1606,52,103,1782,12,3555,2.911.369.048
14/03/2015 07:00,24.56,45525,1738,45,101,1873,11,3768,2.911.369.048
14/03/2015 08:00,24.58,47084,1830,38,99,1733,12,3712,2.911.369.048
14/03/2015 09:00,24.75,48265,1905,32,96,1516,11,3560,2.911.369.048
14/03/2015 10:00,24.72,48440,1924,33,94,1407,13,3471,2.911.369.048
14/03/2015 11:00,24.58,47700,1892,35,90,1347,14,3378,2.911.369.048
14/03/2015 12:00,24.39,46673,1867,42,87,1309,18,3323,2.911.369.048
14/03/2015 13:00,24.08,45793,1876,50,85,1293,20,3324,2.911.369.048
14/03/2015 14:00,23.85,45273,1905,59,85,1312,18,3379,2.911.369.048
14/03/2015 15:00,23.86,45273,1937,68,85,1339,18,3447,2.911.369.048
14/03/2015 16:00,24.14,46102,1945,72,86,1377,19,3499,2.911.369.048
14/03/2015 17:00,24.74,48135,1893,77,85,1441,15,3511,2.911.369.048
14/03/2015 18:00,25.18,49827,1867,82,85,1501,9,3544,2.911.369.048
14/03/2015 19:00,25.09,49119,1888,83,85,1557,9,3622,2.911.369.048
14/03/2015 20:00,24.77,47522,1907,79,84,1586,8,3664,2.911.369.048
14/03/2015 21:00,24.62,46672,1911,76,83,1575,7,3652,2.911.369.048
14/03/2015 22:00,24.39,45486,1874,72,81,1520,5,3552,2.911.369.048
14/03/2015 23:00,24.21,44045,1797,67,79,1455,5,3403,2.911.369.048
15/03/2015 00:00,24.17,42498,1581,66,75,1564,6,3292,2.911.369.048
15/03/2015 01:00,23.92,41693,1603,65,73,1533,6,3280,2.911.369.048
15/03/2015 02:00,23.66,41372,1644,64,74,1522,6,3310,2.911.369.048
15/03/2015 03:00,23.56,41389,1689,62,75,1498,6,3330,2.911.369.048
15/03/2015 04:00,23.8,41686,1717,61,77,1518,6,3379,2.911.369.048
15/03/2015 05:00,23.98,42186,1739,61,77,1569,6,3452,2.911.369.048
15/03/2015 06:00,23.87,42543,1763,59,78,1594,6,3500,2.911.369.048
15/03/2015 07:00,24.18,43604,1797,49,79,1568,6,3499,2.911.369.048
15/03/2015 08:00,24.32,44737,1843,38,72,1478,5,3436,2.911.369.048
15/03/2015 09:00,24.56,45937,1890,30,65,1396,6,3387,2.911.369.048
15/03/2015 10:00,24.54,46466,1939,26,59,1397,10,3431,2.911.369.048
15/03/2015 11:00,24.37,46308,2009,23,60,1382,11,3485,2.911.369.048
15/03/2015 12:00,24.08,45692,2095,23,61,1423,12,3614,2.911.369.048
15/03/2015 13:00,23.75,45181,2144,26,62,1459,11,3702,2.911.369.048
15/03/2015 14:00,22.79,44838,2151,29,62,1552,9,3803,2.911.369.048
15/03/2015 15:00,23.42,44726,2176,34,62,1619,8,3899,2.911.369.048
15/03/2015 16:00,24.06,45341,2255,42,62,1663,8,4030,2.911.369.048
15/03/2015 17:00,24.6,47018,2320,56,63,1765,9,4213,2.911.369.048
15/03/2015 18:00,25.06,48891,2370,72,65,1836,8,4351,2.911.369.048
15/03/2015 19:00,25.1,48983,2392,80,68,1917,8,4465,2.911.369.048
15/03/2015 20:00,24.83,47885,2423,83,69,1927,8,4510,2.911.369.048
15/03/2015 21:00,24.66,46992,2439,82,70,1943,8,4542,2.911.369.048
15/03/2015 22:00,24.39,45423,2357,79,69,1870,5,4380,2.911.369.048
15/03/2015 23:00,23.43,43583,2301,70,67,1810,6,4254,2.911.369.048
16/03/2015 00:00,22.63,42421,2210,79,57,1768,10,4124,2.713.869.048
16/03/2015 01:00,22.55,41971,2174,71,53,1723,7,4028,2.713.869.048
16/03/2015 02:00,21.49,41863,2180,63,56,1728,7,4034,2.713.869.048
16/03/2015 03:00,21.7,42221,2254,55,60,1737,7,4113,2.713.869.048
16/03/2015 04:00,23,43303,2371,48,64,1741,7,4231,2.713.869.048
16/03/2015 05:00,24.89,45852,2469,43,66,1763,7,4348,2.713.869.048
16/03/2015 06:00,25.44,49867,2550,37,67,1707,7,4368,2.713.869.048
16/03/2015 07:00,26.75,53680,2656,28,68,1682,8,4442,2.713.869.048
16/03/2015 08:00,27.16,54398,2786,17,61,1673,7,4544,2.713.869.048
16/03/2015 09:00,26.45,53675,2916,14,52,1594,7,4583,2.713.869.048
16/03/2015 10:00,26.11,52946,3043,14,44,1520,7,4628,2.713.869.048
16/03/2015 11:00,25.35,52076,3174,16,48,1574,9,4821,2.713.869.048
16/03/2015 12:00,24.71,51228,3283,19,53,1602,12,4969,2.713.869.048
16/03/2015 13:00,24.61,50637,3357,21,58,1633,13,5082,2.713.869.048
16/03/2015 14:00,24.69,50139,3409,22,61,1717,12,5221,2.713.869.048
16/03/2015 15:00,24.81,49683,3462,24,64,1782,12,5344,2.713.869.048
16/03/2015 16:00,24.77,49684,3491,32,67,1882,11,5483,2.713.869.048
16/03/2015 17:00,25.03,50929,3464,47,77,1983,7,5578,2.713.869.048
16/03/2015 18:00,25.81,52156,3406,64,88,2040,7,5605,2.713.869.048
16/03/2015 19:00,25.57,52081,3321,77,100,2066,6,5570,2.713.869.048
16/03/2015 20:00,24.88,50569,3167,88,103,2101,8,5467,2.713.869.048
16/03/2015 21:00,24.74,49276,2984,93,106,2093,8,5284,2.713.869.048
16/03/2015 22:00,24.53,47008,2825,94,108,2035,7,5069,2.713.869.048
16/03/2015 23:00,23.96,44621,2714,83,101,1962,8,4868,2.713.869.048
17/03/2015 00:00,22.86,42806,2600,83,92,1966,8,4749,2.713.869.048
17/03/2015 01:00,22.64,42003,2513,78,84,1915,9,4599,2.713.869.048
17/03/2015 02:00,22.09,41697,2412,74,82,1861,7,4436,2.713.869.048
17/03/2015 03:00,22.96,41940,2318,72,81,1871,7,4349,2.713.869.048
17/03/2015 04:00,23.41,42910,2236,74,81,1857,8,4256,2.713.869.048
17/03/2015 05:00,24.77,45196,2162,78,81,1861,6,4188,2.713.869.048
17/03/2015 06:00,25.34,48988,2078,76,80,1855,6,4095,2.713.869.048
17/03/2015 07:00,27.38,52439,2043,56,78,1731,8,3916,2.713.869.048
17/03/2015 08:00,27.97,53481,2073,33,69,1648,7,3830,2.713.869.048
17/03/2015 09:00,27.38,52603,2072,20,60,1547,6,3705,2.713.869.048
17/03/2015 10:00,26.87,51915,1991,16,51,1499,5,3562,2.713.869.048
17/03/2015 11:00,26.18,50876,1899,17,55,1379,7,3357,2.713.869.048
17/03/2015 12:00,25.37,49966,1841,18,60,1412,10,3341,2.713.869.048
17/03/2015 13:00,25.19,49392,1788,18,65,1411,9,3291,2.713.869.048
17/03/2015 14:00,25.35,48935,1740,17,63,1436,7,3263,2.713.869.048
17/03/2015 15:00,25.25,48590,1712,17,63,1430,6,3228,2.713.869.048
17/03/2015 16:00,25.34,48694,1686,21,63,1423,7,3200,2.713.869.048
17/03/2015 17:00,26.02,49852,1608,29,72,1492,5,3206,2.713.869.048
17/03/2015 18:00,27.22,51210,1520,39,83,1496,6,3144,2.713.869.048
17/03/2015 19:00,26.6,51253,1465,50,93,1504,6,3118,2.713.869.048
17/03/2015 20:00,25.54,49888,1405,55,94,1483,8,3045,2.713.869.048
17/03/2015 21:00,25.24,48573,1323,61,94,1441,8,2927,2.713.869.048
17/03/2015 22:00,24.92,46485,1257,64,93,1427,7,2848,2.713.869.048
17/03/2015 23:00,24.35,44070,1203,63,82,1366,6,2720,2.713.869.048
18/03/2015 00:00,24.02,42337,1108,58,74,1306,7,2553,2.713.869.048
18/03/2015 01:00,23.91,41536,1081,51,67,1224,5,2428,2.713.869.048
18/03/2015 02:00,23.9,41361,1069,42,58,1232,4,2405,2.713.869.048
18/03/2015 03:00,23.93,41638,1057,35,50,1202,4,2348,2.713.869.048
18/03/2015 04:00,24.5,42621,1024,30,44,1132,3,2233,2.713.869.048
18/03/2015 05:00,25.31,44889,988,24,38,1119,2,2171,2.713.869.048
18/03/2015 06:00,26.57,48696,974,19,32,1092,2,2119,2.713.869.048
18/03/2015 07:00,30.33,52139,960,13,26,981,3,1983,2.713.869.048
18/03/2015 08:00,34.01,53353,936,8,16,865,3,1828,2.713.869.048
18/03/2015 09:00,28.58,52392,889,6,9,755,3,1662,2.713.869.048
18/03/2015 10:00,27.62,51604,833,5,4,689,3,1534,2.713.869.048
18/03/2015 11:00,27.02,50465,793,4,6,671,4,1478,2.713.869.048
18/03/2015 12:00,26.06,49497,776,4,8,672,6,1466,2.713.869.048
18/03/2015 13:00,25.84,49004,763,4,10,679,5,1461,2.713.869.048
18/03/2015 14:00,25.93,48548,742,5,8,657,4,1416,2.713.869.048
18/03/2015 15:00,26.13,48249,680,5,7,648,3,1343,2.713.869.048
18/03/2015 16:00,26.26,48265,616,6,5,673,3,1303,2.713.869.048
18/03/2015 17:00,27.86,49393,567,8,8,695,2,1280,2.713.869.048
18/03/2015 18:00,29.42,50648,505,12,12,740,2,1271,2.713.869.048
18/03/2015 19:00,28.99,50729,457,17,18,891,2,1385,2.713.869.048
18/03/2015 20:00,27.24,49402,434,21,20,1009,3,1487,2.713.869.048
18/03/2015 21:00,26.09,48141,435,26,22,1065,4,1552,2.713.869.048
18/03/2015 22:00,25.41,46049,447,31,23,1047,4,1552,2.713.869.048
18/03/2015 23:00,24.97,43784,429,34,19,1065,5,1552,2.713.869.048
19/03/2015 00:00,24.46,42155,411,58,17,1226,4,1716,2.713.869.048
19/03/2015 01:00,24.22,41492,380,59,13,1265,3,1720,2.713.869.048
19/03/2015 02:00,24.11,41337,319,58,10,1309,2,1698,2.713.869.048
19/03/2015 03:00,24.2,41608,255,55,9,1376,2,1697,2.713.869.048
19/03/2015 04:00,24.56,42642,229,50,8,1409,2,1698,2.713.869.048
19/03/2015 05:00,25.43,44964,213,45,7,1447,2,1714,2.713.869.048
19/03/2015 06:00,26.1,48659,189,40,6,1496,2,1733,2.713.869.048
19/03/2015 07:00,29.54,52137,154,28,3,1486,3,1674,2.713.869.048
19/03/2015 08:00,30.72,52995,116,18,0,1467,3,1604,2.713.869.048
19/03/2015 09:00,27.63,52192,91,13,0,1462,2,1568,2.713.869.048
19/03/2015 10:00,27.14,51503,76,17,0,1482,2,1577,2.713.869.048
19/03/2015 11:00,26.61,50818,72,27,1,1526,3,1629,2.713.869.048
19/03/2015 12:00,26.04,49978,72,41,3,1577,3,1696,2.713.869.048
19/03/2015 13:00,25.92,49461,81,52,5,1645,4,1787,2.713.869.048
19/03/2015 14:00,26,49086,96,61,7,1698,5,1867,2.713.869.048
19/03/2015 15:00,26.08,48767,122,69,7,1662,6,1866,2.713.869.048
19/03/2015 16:00,26.25,48726,164,77,6,1680,5,1932,2.713.869.048
19/03/2015 17:00,27.1,49758,198,88,6,1715,4,2011,2.713.869.048
19/03/2015 18:00,29.3,50975,221,101,7,1662,4,1995,2.713.869.048
19/03/2015 19:00,28.58,51043,245,107,10,1615,4,1981,2.713.869.048
19/03/2015 20:00,26.65,49620,278,109,12,1613,5,2017,2.713.869.048
19/03/2015 21:00,26.37,48416,313,104,15,1548,5,1985,2.713.869.048
19/03/2015 22:00,25.79,46191,354,91,17,1556,6,2024,2.713.869.048
19/03/2015 23:00,25.21,43774,410,70,19,1507,6,2012,2.713.869.048
20/03/2015 00:00,25.02,41848,476,72,18,1437,6,2009,2.713.869.048
20/03/2015 01:00,24.81,41068,553,59,18,1367,5,2002,2.713.869.048
20/03/2015 02:00,24.68,40935,611,48,20,1319,6,2004,2.713.869.048
20/03/2015 03:00,24.71,41221,647,40,23,1231,5,1946,2.713.869.048
20/03/2015 04:00,25.07,42263,671,34,28,1181,5,1919,2.713.869.048
20/03/2015 05:00,25.96,44613,676,32,32,1146,4,1890,2.713.869.048
20/03/2015 06:00,26.59,48366,708,31,34,1072,4,1849,2.713.869.048
20/03/2015 07:00,30.43,52193,771,26,36,962,4,1799,2.713.869.048
20/03/2015 08:00,30.86,53833,821,22,35,860,5,1743,2.713.869.048
20/03/2015 09:00,28.22,53350,871,19,34,746,5,1675,2.713.869.048
20/03/2015 10:00,30.04,52818,978,20,35,675,6,1714,2.713.869.048
20/03/2015 11:00,27.34,52035,1146,21,44,650,7,1868,2.713.869.048
20/03/2015 12:00,25.97,51190,1340,22,57,658,8,2085,2.713.869.048
20/03/2015 13:00,25.77,50237,1487,23,71,741,7,2329,2.713.869.048
20/03/2015 14:00,26,49507,1564,22,73,767,7,2433,2.713.869.048
20/03/2015 15:00,26.02,49021,1590,19,72,812,7,2500,2.713.869.048
20/03/2015 16:00,26.03,49102,1504,18,71,860,6,2459,2.713.869.048
20/03/2015 17:00,26.48,50191,1366,17,70,900,6,2359,2.713.869.048
20/03/2015 18:00,27.1,51485,1302,17,70,937,5,2331,2.713.869.048
20/03/2015 19:00,26.42,51400,1286,16,71,961,4,2338,2.713.869.048
20/03/2015 20:00,25.74,49502,1297,17,75,1014,4,2407,2.713.869.048
20/03/2015 21:00,25.45,48266,1305,20,80,1126,3,2534,2.713.869.048
20/03/2015 22:00,25.01,46651,1206,26,84,1212,3,2531,2.713.869.048
20/03/2015 23:00,24.76,44880,1007,34,78,1328,0,2447,2.713.869.048
21/03/2015 00:00,24.23,43241,629,26,40,1075,0,1770,2.713.869.048
21/03/2015 01:00,24,42293,495,29,40,1200,0,1764,2.713.869.048
21/03/2015 02:00,23.87,41960,406,32,40,1406,1,1885,2.713.869.048
21/03/2015 03:00,23.83,41991,371,35,40,1666,2,2114,2.713.869.048
21/03/2015 04:00,23.92,42399,370,47,40,1872,3,2332,2.713.869.048
21/03/2015 05:00,23.95,42999,488,65,40,2022,6,2621,2.713.869.048
21/03/2015 06:00,23.75,43787,850,89,40,2181,10,3170,2.713.869.048
21/03/2015 07:00,24.05,45392,1346,107,40,2294,12,3799,2.713.869.048
21/03/2015 08:00,24.34,47172,1876,126,40,2406,15,4463,2.713.869.048
21/03/2015 09:00,24.5,48459,2345,139,40,2433,18,4975,2.713.869.048
21/03/2015 10:00,24.42,48748,2670,147,40,2470,23,5350,2.713.869.048
21/03/2015 11:00,24.22,48379,2889,150,40,2559,35,5673,2.713.869.048
21/03/2015 12:00,24.05,47686,3093,151,40,2575,48,5907,2.713.869.048
21/03/2015 13:00,23.8,47112,3263,152,40,2492,54,6001,2.713.869.048
21/03/2015 14:00,23.64,46592,3398,154,40,2383,59,6034,2.713.869.048
21/03/2015 15:00,23.67,46572,3571,159,40,2270,70,6110,2.713.869.048
21/03/2015 16:00,23.99,47350,3460,161,40,2109,71,5841,2.713.869.048
21/03/2015 17:00,24.5,49299,3074,161,40,1897,70,5242,2.713.869.048
21/03/2015 18:00,25.13,51128,2574,156,40,1575,67,4412,2.713.869.048
21/03/2015 19:00,25.27,50946,2186,155,40,1354,66,3801,2.713.869.048
21/03/2015 20:00,24.98,49458,1918,152,40,1200,60,3370,2.713.869.048
21/03/2015 21:00,24.81,48666,1667,149,40,1055,51,2962,2.713.869.048
21/03/2015 22:00,24.65,47474,1434,146,40,971,37,2628,2.713.869.048
21/03/2015 23:00,23.82,46012,1204,140,40,883,27,2294,2.713.869.048
22/03/2015 00:00,24.04,44589,725,116,104,853,9,1807,2.713.869.048
22/03/2015 01:00,23.81,43789,569,104,81,996,7,1757,2.713.869.048
22/03/2015 02:00,23.64,43444,458,94,69,1242,6,1869,2.713.869.048
22/03/2015 03:00,23.73,43466,435,80,59,1520,4,2098,2.713.869.048
22/03/2015 04:00,23.82,43751,471,65,51,1772,5,2364,2.713.869.048
22/03/2015 05:00,23.74,44151,529,51,42,1991,5,2618,2.713.869.048
22/03/2015 06:00,23.13,44427,585,37,34,2128,3,2787,2.713.869.048
22/03/2015 07:00,23.41,45441,656,26,26,2300,3,3011,2.713.869.048
22/03/2015 08:00,24.14,46810,761,16,18,2511,2,3308,2.713.869.048
22/03/2015 09:00,24.44,48171,932,12,12,2716,3,3675,2.713.869.048
22/03/2015 10:00,24.36,48828,1094,10,10,3025,3,4142,2.713.869.048
22/03/2015 11:00,24.75,48771,1209,12,9,3226,2,4458,2.713.869.048
22/03/2015 12:00,24.34,48360,1312,17,12,3344,3,4688,2.713.869.048
22/03/2015 13:00,24.13,48038,1348,29,17,3377,3,4774,2.713.869.048
22/03/2015 14:00,24.07,47678,1309,44,19,3424,4,4800,2.713.869.048
22/03/2015 15:00,24.06,47718,1243,67,22,3368,6,4706,2.713.869.048
22/03/2015 16:00,24.18,48078,1154,87,26,3255,8,4530,2.713.869.048
22/03/2015 17:00,25.16,49394,1069,104,29,3162,11,4375,2.713.869.048
22/03/2015 18:00,25.88,51221,1000,122,33,3153,15,4323,2.713.869.048
22/03/2015 19:00,25.89,51860,1017,141,39,3161,16,4374,2.713.869.048
22/03/2015 20:00,25.38,50993,1117,155,50,3187,19,4528,2.713.869.048
22/03/2015 21:00,25.13,49963,1251,166,62,3187,24,4690,2.713.869.048
22/03/2015 22:00,24.62,48274,1391,174,74,3191,27,4857,2.713.869.048
22/03/2015 23:00,24.06,46199,1522,172,83,3126,32,4935,2.713.869.048
23/03/2015 00:00,23.68,44152,1815,176,92,3254,32,5369,2.526.190.476
23/03/2015 01:00,23.17,43371,1945,173,101,3203,31,5453,2.526.190.476
23/03/2015 02:00,23.3,43074,2000,169,104,3102,35,5410,2.526.190.476
23/03/2015 03:00,23.47,43298,2003,164,107,3127,35,5436,2.526.190.476
23/03/2015 04:00,23.84,44228,1976,164,112,3123,37,5412,2.526.190.476
23/03/2015 05:00,24.5,46636,1952,167,114,3133,37,5403,2.526.190.476
23/03/2015 06:00,25.15,50638,1930,172,116,3068,43,5329,2.526.190.476
23/03/2015 07:00,26.15,54613,1981,175,117,2974,51,5298,2.526.190.476
23/03/2015 08:00,26.64,55866,2164,179,127,2898,57,5425,2.526.190.476
23/03/2015 09:00,26.15,56279,2383,184,164,2877,61,5669,2.526.190.476
23/03/2015 10:00,25.74,55730,2546,190,173,2866,68,5843,2.526.190.476
23/03/2015 11:00,25.54,55053,2677,199,179,2952,74,6081,2.526.190.476
23/03/2015 12:00,25.32,54115,2780,207,182,2969,76,6214,2.526.190.476
23/03/2015 13:00,25.12,53533,2810,212,182,3097,77,6378,2.526.190.476
23/03/2015 14:00,24.97,53014,2732,215,177,3146,77,6347,2.526.190.476
23/03/2015 15:00,24.98,52474,2576,218,169,3205,79,6247,2.526.190.476
23/03/2015 16:00,25.07,52424,2290,220,147,3210,78,5945,2.526.190.476
23/03/2015 17:00,25.41,53215,1904,227,143,3135,77,5486,2.526.190.476
23/03/2015 18:00,26.08,54298,1564,228,141,3181,74,5188,2.526.190.476
23/03/2015 19:00,26.56,54296,1334,229,139,3263,68,5033,2.526.190.476
23/03/2015 20:00,25.61,52828,1136,229,144,3321,65,4895,2.526.190.476
23/03/2015 21:00,25.32,51260,952,227,149,3271,60,4659,2.526.190.476
23/03/2015 22:00,24.78,48752,805,226,152,3216,56,4455,2.526.190.476
23/03/2015 23:00,24.1,45932,691,225,149,3107,57,4229,2.526.190.476
24/03/2015 00:00,24.2,43393,603,222,145,3025,52,4047,2.526.190.476
24/03/2015 01:00,24.04,42508,486,216,137,2869,48,3756,2.526.190.476
24/03/2015 02:00,24.06,42240,392,210,128,2772,41,3543,2.526.190.476
24/03/2015 03:00,24.14,42510,321,204,120,2664,37,3346,2.526.190.476
24/03/2015 04:00,24.48,43542,269,199,112,2570,30,3180,2.526.190.476
24/03/2015 05:00,25.16,45873,229,194,105,2478,28,3034,2.526.190.476
24/03/2015 06:00,26.43,49726,197,191,97,2329,25,2839,2.526.190.476
24/03/2015 07:00,36.02,53226,170,185,88,2120,28,2591,2.526.190.476
24/03/2015 08:00,41.41,53943,158,179,79,1954,28,2398,2.526.190.476
24/03/2015 09:00,35.87,53656,158,176,70,1779,26,2209,2.526.190.476
24/03/2015 10:00,30.24,52905,147,171,64,1648,23,2053,2.526.190.476
24/03/2015 11:00,27.96,51943,123,164,59,1512,23,1881,2.526.190.476
24/03/2015 12:00,26.16,51166,100,155,56,1500,21,1832,2.526.190.476
24/03/2015 13:00,25.99,50739,91,142,53,1428,18,1732,2.526.190.476
24/03/2015 14:00,26.17,50204,93,130,41,1362,16,1642,2.526.190.476
24/03/2015 15:00,26,49824,96,118,32,1263,14,1523,2.526.190.476
24/03/2015 16:00,26,49690,100,106,23,1218,11,1458,2.526.190.476
24/03/2015 17:00,28.32,50450,103,99,16,1142,9,1369,2.526.190.476
24/03/2015 18:00,34.62,51559,108,91,12,1046,8,1265,2.526.190.476
24/03/2015 19:00,34.98,51904,117,85,10,1026,6,1244,2.526.190.476
24/03/2015 20:00,28.76,50680,125,79,10,1006,6,1226,2.526.190.476
24/03/2015 21:00,26.78,49464,137,70,10,1028,5,1250,2.526.190.476
24/03/2015 22:00,25.65,47398,140,61,10,1012,4,1227,2.526.190.476
24/03/2015 23:00,24.85,44991,139,53,10,1000,3,1205,2.526.190.476
25/03/2015 00:00,24.56,42787,74,67,8,1193,3,1345,2.526.190.476
25/03/2015 01:00,24.43,42081,78,70,7,1256,3,1414,2.526.190.476
25/03/2015 02:00,24.38,42059,88,66,7,1337,4,1502,2.526.190.476
25/03/2015 03:00,24.4,42514,110,64,9,1416,4,1603,2.526.190.476
25/03/2015 04:00,24.65,43624,138,66,13,1514,6,1737,2.526.190.476
25/03/2015 05:00,25.33,46108,172,70,14,1620,5,1881,2.526.190.476
25/03/2015 06:00,27.09,50066,223,77,15,1705,6,2026,2.526.190.476
25/03/2015 07:00,35.25,53682,286,82,15,1739,9,2131,2.526.190.476
25/03/2015 08:00,42.08,54779,370,86,10,1781,9,2256,2.526.190.476
25/03/2015 09:00,38.71,54149,483,84,7,1794,9,2377,2.526.190.476
25/03/2015 10:00,33.03,53909,643,84,5,1776,7,2515,2.526.190.476
25/03/2015 11:00,29.08,52784,840,82,6,1769,7,2704,2.526.190.476
25/03/2015 12:00,27.08,52183,1124,81,7,1807,8,3027,2.526.190.476
25/03/2015 13:00,26.47,52160,1418,81,8,1922,10,3439,2.526.190.476
25/03/2015 14:00,26.12,51919,1695,80,12,1993,11,3791,2.526.190.476
25/03/2015 15:00,25.86,51583,1973,85,15,2077,11,4161,2.526.190.476
25/03/2015 16:00,25.51,51634,2212,89,18,2191,9,4519,2.526.190.476
25/03/2015 17:00,25.89,52480,2445,100,29,2276,9,4859,2.526.190.476
25/03/2015 18:00,26.82,53398,2729,105,46,2373,8,5261,2.526.190.476
25/03/2015 19:00,26.14,53478,2966,105,71,2478,6,5626,2.526.190.476
25/03/2015 20:00,25.04,52325,3138,103,76,2638,7,5962,2.526.190.476
25/03/2015 21:00,24.6,51048,3263,96,82,2749,8,6198,2.526.190.476
25/03/2015 22:00,24.27,48829,3247,92,87,2772,5,6203,2.526.190.476
25/03/2015 23:00,23.81,46415,3157,86,92,2855,7,6197,2.526.190.476
26/03/2015 00:00,23.4,44412,2653,93,82,3047,8,5883,2.526.190.476
26/03/2015 01:00,22.92,43613,2511,93,87,3068,9,5768,2.526.190.476
26/03/2015 02:00,22.92,43415,2258,96,93,3112,10,5569,2.526.190.476
26/03/2015 03:00,23.1,43641,1967,99,100,3199,13,5378,2.526.190.476
26/03/2015 04:00,23.77,44715,1648,105,107,3274,16,5150,2.526.190.476
26/03/2015 05:00,24.41,47082,1355,110,116,3312,18,4911,2.526.190.476
26/03/2015 06:00,25.56,50850,1238,114,125,3362,17,4856,2.526.190.476
26/03/2015 07:00,29.53,54339,1167,113,132,3327,21,4760,2.526.190.476
26/03/2015 08:00,30.36,55351,1042,116,128,3253,26,4565,2.526.190.476
26/03/2015 09:00,27.93,55472,1000,120,124,3268,29,4541,2.526.190.476
26/03/2015 10:00,27.67,54885,979,126,122,3149,34,4410,2.526.190.476
26/03/2015 11:00,27.36,54185,919,134,127,3040,38,4258,2.526.190.476
26/03/2015 12:00,26.61,53365,915,143,134,2934,39,4165,2.526.190.476
26/03/2015 13:00,26.42,53209,876,156,163,2827,42,4064,2.526.190.476
26/03/2015 14:00,26.24,52855,794,169,166,2690,44,3863,2.526.190.476
26/03/2015 15:00,25.91,52542,727,179,165,2646,42,3759,2.526.190.476
26/03/2015 16:00,26.24,52563,626,186,163,2605,40,3620,2.526.190.476
26/03/2015 17:00,26.66,53116,507,193,163,2544,39,3446,2.526.190.476
26/03/2015 18:00,27.3,53904,440,198,163,2465,42,3308,2.526.190.476
26/03/2015 19:00,26.73,53943,424,202,162,2448,50,3286,2.526.190.476
26/03/2015 20:00,26.13,52624,450,203,153,2316,50,3172,2.526.190.476
26/03/2015 21:00,25.76,51158,483,203,144,2258,51,3139,2.526.190.476
26/03/2015 22:00,24.9,48835,500,203,135,2135,49,3022,2.526.190.476
26/03/2015 23:00,24.22,46253,519,203,126,2000,41,2889,2.526.190.476
27/03/2015 00:00,24.19,44100,212,193,122,1678,41,2246,2.526.190.476
27/03/2015 01:00,24.05,42866,213,194,109,1510,38,2064,2.526.190.476
27/03/2015 02:00,24.02,42667,212,196,93,1393,28,1922,2.526.190.476
27/03/2015 03:00,24.08,42989,225,197,78,1294,25,1819,2.526.190.476
27/03/2015 04:00,24.39,43911,229,197,65,1188,20,1699,2.526.190.476
27/03/2015 05:00,24.96,46163,219,197,54,1117,19,1606,2.526.190.476
27/03/2015 06:00,26.35,49753,213,195,43,1010,16,1477,2.526.190.476
27/03/2015 07:00,29.87,53331,200,194,33,911,15,1353,2.526.190.476
27/03/2015 08:00,33.77,54697,188,194,24,840,14,1260,2.526.190.476
27/03/2015 09:00,33.75,54447,191,191,16,785,12,1195,2.526.190.476
27/03/2015 10:00,31.71,54643,207,189,12,760,11,1179,2.526.190.476
27/03/2015 11:00,29.52,53783,241,184,10,715,12,1162,2.526.190.476
27/03/2015 12:00,27.41,52613,297,182,11,705,13,1208,2.526.190.476
27/03/2015 13:00,26.55,51634,360,178,11,699,10,1258,2.526.190.476
27/03/2015 14:00,26.45,50827,443,170,10,690,7,1320,2.526.190.476
27/03/2015 15:00,25.97,50199,549,163,8,699,6,1425,2.526.190.476
27/03/2015 16:00,25.65,49943,603,156,6,730,7,1502,2.526.190.476
27/03/2015 17:00,25.76,50487,610,149,6,705,7,1477,2.526.190.476
27/03/2015 18:00,26.89,51305,598,144,7,699,7,1455,2.526.190.476
27/03/2015 19:00,26.55,51128,591,141,11,700,9,1452,2.526.190.476
27/03/2015 20:00,25.49,49488,628,136,15,729,12,1520,2.526.190.476
27/03/2015 21:00,24.83,48137,729,132,20,751,9,1641,2.526.190.476
27/03/2015 22:00,24.42,46370,831,129,24,769,7,1760,2.526.190.476
27/03/2015 23:00,24.08,44403,893,122,23,787,4,1829,2.526.190.476
28/03/2015 00:00,24.54,42338,854,145,40,782,6,1827,2.526.190.476
28/03/2015 01:00,24.38,41294,824,146,42,794,6,1812,2.526.190.476
28/03/2015 02:00,24.34,40818,748,145,35,814,3,1745,2.526.190.476
28/03/2015 03:00,24.4,40778,664,144,30,785,3,1626,2.526.190.476
28/03/2015 04:00,24.54,41087,610,139,27,763,4,1543,2.526.190.476
28/03/2015 05:00,24.8,41565,574,132,24,776,3,1509,2.526.190.476
28/03/2015 06:00,24.91,42294,543,121,20,724,2,1410,2.526.190.476
28/03/2015 07:00,25.31,44027,495,104,16,642,2,1259,2.526.190.476
28/03/2015 08:00,25.23,46149,464,86,13,532,4,1099,2.526.190.476
28/03/2015 09:00,25.73,47449,512,79,11,481,4,1087,2.526.190.476
28/03/2015 10:00,25.66,47900,649,71,10,434,4,1168,2.526.190.476
28/03/2015 11:00,25.2,47627,854,61,12,424,2,1353,2.526.190.476
28/03/2015 12:00,24.61,46975,1131,56,16,413,3,1619,2.526.190.476
28/03/2015 13:00,24.14,46351,1446,52,19,449,3,1969,2.526.190.476
28/03/2015 14:00,23.88,45976,1795,47,18,517,3,2380,2.526.190.476
28/03/2015 15:00,23.82,45714,2135,41,17,588,2,2783,2.526.190.476
28/03/2015 16:00,24.12,46258,2349,32,16,674,2,3073,2.526.190.476
28/03/2015 17:00,24.61,47623,2549,27,14,836,2,3428,2.526.190.476
28/03/2015 18:00,24.84,49094,2845,26,14,1123,2,4010,2.526.190.476
28/03/2015 19:00,24.5,49143,3151,27,16,1471,2,4667,2.526.190.476
28/03/2015 20:00,24.08,47948,3394,29,17,1893,2,5335,2.526.190.476
28/03/2015 21:00,23.37,47066,3536,30,19,2332,2,5919,2.526.190.476
28/03/2015 22:00,22.76,45822,3452,30,19,2684,1,6186,2.526.190.476
28/03/2015 23:00,22.07,44337,3135,28,19,2925,0,6107,2.526.190.476
29/03/2015 00:00,22.64,42050,3042,22,14,2981,3,6062,2.526.190.476
29/03/2015 01:00,22.16,41110,2627,23,11,3155,2,5818,2.526.190.476
29/03/2015 02:00,22.01,40880.5,2455.5,26,15,3113,3,5612.5,2.526.190.476
29/03/2015 03:00,21.86,40651,2284,31,21,3404,4,5744,2.526.190.476
29/03/2015 04:00,21.54,40709,2026,35,27,3400,5,5493,2.526.190.476
29/03/2015 05:00,21.76,40897,1771,39,34,3455,6,5305,2.526.190.476
29/03/2015 06:00,22.21,41113,1528,46,40,3351,8,4973,2.526.190.476
29/03/2015 07:00,21.81,42104,1343,55,49,3230,10,4687,2.526.190.476
29/03/2015 08:00,22.62,43458,1241,63,59,3107,14,4484,2.526.190.476
29/03/2015 09:00,23.33,44934,1215,69,71,2987,16,4358,2.526.190.476
29/03/2015 10:00,23.72,45908,1221,77,89,2883,22,4292,2.526.190.476
29/03/2015 11:00,23.8,46150,1243,83,110,2792,35,4263,2.526.190.476
29/03/2015 12:00,23.62,46041,1333,92,131,2701,43,4300,2.526.190.476
29/03/2015 13:00,23.5,45793,1447,103,132,2586,48,4316,2.526.190.476
29/03/2015 14:00,23.3,45502,1548,117,131,2428,48,4272,2.526.190.476
29/03/2015 15:00,23.24,45336,1647,132,129,2301,47,4256,2.526.190.476
29/03/2015 16:00,23.36,45724,1697,153,124,2133,41,4148,2.526.190.476
29/03/2015 17:00,23.74,46601,1547,170,121,2050,41,3929,2.526.190.476
29/03/2015 18:00,24.22,47741,1246,182,119,1953,40,3540,2.526.190.476
29/03/2015 19:00,24.51,48107,971,192,119,1825,38,3145,2.526.190.476
29/03/2015 20:00,24.57,47576,798,199,119,1705,32,2853,2.526.190.476
29/03/2015 21:00,24.31,46704,706,204,117,1538,26,2591,2.526.190.476
29/03/2015 22:00,24.05,45070,661,204,118,1367,21,2371,2.526.190.476
29/03/2015 23:00,23.54,43141,730,213,120,1234,38,2335,2.526.190.476
30/03/2015 00:00,23.2,41023,1000,206,114,1078,33,2431,2.357.440.476
30/03/2015 01:00,23,40271,1346,200,109,945,27,2627,2.357.440.476
30/03/2015 02:00,22.55,40076,1778,193,110,861,25,2967,2.357.440.476
30/03/2015 03:00,22.6,40395,2052,191,112,809,22,3186,2.357.440.476
30/03/2015 04:00,23.22,41322,2260,189,115,766,20,3350,2.357.440.476
30/03/2015 05:00,23.58,43675,2483,185,121,762,19,3570,2.357.440.476
30/03/2015 06:00,24.91,47599,2654,180,126,718,21,3699,2.357.440.476
30/03/2015 07:00,26.78,51425,2797,172,130,726,24,3849,2.357.440.476
30/03/2015 08:00,27.55,53574,3025,170,133,851,28,4207,2.357.440.476
30/03/2015 09:00,26.61,53408,3363,168,136,987,29,4683,2.357.440.476
30/03/2015 10:00,25.89,53026,3681,167,140,1113,31,5132,2.357.440.476
30/03/2015 11:00,25.25,52454,3942,166,139,1279,33,5559,2.357.440.476
30/03/2015 12:00,24.7,52048,4139,164,138,1413,37,5891,2.357.440.476
30/03/2015 13:00,24.41,51701,4272,162,141,1473,38,6086,2.357.440.476
30/03/2015 14:00,24.31,51235,4361,161,160,1594,37,6313,2.357.440.476
30/03/2015 15:00,24.34,50669,4419,162,167,1726,33,6507,2.357.440.476
30/03/2015 16:00,24.24,50262,4453,172,176,1831,31,6663,2.357.440.476
30/03/2015 17:00,24.24,50629,4447,177,188,1918,33,6763,2.357.440.476
30/03/2015 18:00,24.66,51035,4377,182,197,1956,31,6743,2.357.440.476
30/03/2015 19:00,25.25,51045,4259,186,197,2049,37,6728,2.357.440.476
30/03/2015 20:00,24.95,50328,4057,189,196,2178,43,6663,2.357.440.476
30/03/2015 21:00,24.68,49025,3742,189,197,2249,38,6415,2.357.440.476
30/03/2015 22:00,24.33,46793,3324,187,199,2271,42,6023,2.357.440.476
30/03/2015 23:00,23.3,44188,2894,197,215,2423,51,5780,2.357.440.476
31/03/2015 00:00,23.36,42408,2756,192,215,2413,53,5629,2.357.440.476
31/03/2015 01:00,23.09,41492,2578,187,215,2365,58,5403,2.357.440.476
31/03/2015 02:00,22.72,41336,2347,183,215,2289,59,5093,2.357.440.476
31/03/2015 03:00,22.69,41751,2184,182,212,2084,58,4720,2.357.440.476
31/03/2015 04:00,23.38,42805,2281,197,202,1895,54,4629,2.357.440.476
31/03/2015 05:00,24.1,45169,2462,213,192,1770,50,4687,2.357.440.476
31/03/2015 06:00,25.04,49085,2700,220,182,1647,54,4803,2.357.440.476
31/03/2015 07:00,26,52422,3055,222,167,1536,53,5033,2.357.440.476
31/03/2015 08:00,26.69,53604,3062,216,162,1410,51,4901,2.357.440.476
31/03/2015 09:00,26.95,53398,2797,209,151,1353,41,4551,2.357.440.476
31/03/2015 10:00,26.82,53075,2848,196,142,1290,37,4513,2.357.440.476
31/03/2015 11:00,26.54,52706,2845,187,134,1182,42,4390,2.357.440.476
31/03/2015 12:00,25.87,51976,2689,176,125,1052,40,4082,2.357.440.476
31/03/2015 13:00,25.69,51450,2684,159,115,969,35,3962,2.357.440.476
31/03/2015 14:00,25.52,50802,2787,132,117,917,33,3986,2.357.440.476
31/03/2015 15:00,25.31,50242,2965,109,119,907,31,4131,2.357.440.476
31/03/2015 16:00,25.07,49957,3319,89,120,888,20,4436,2.357.440.476
31/03/2015 17:00,25.18,50223,3454,75,107,929,12,4577,2.357.440.476
31/03/2015 18:00,25.32,50763,3388,63,96,969,6,4522,2.357.440.476
31/03/2015 19:00,25.16,50950,3372,54,86,1055,5,4572,2.357.440.476
31/03/2015 20:00,24.92,50318,3434,48,87,1120,5,4694,2.357.440.476
31/03/2015 21:00,24.76,49233,3537,45,89,1238,5,4914,2.357.440.476
31/03/2015 22:00,24.42,47202,3618,43,89,1263,4,5017,2.357.440.476
31/03/2015 23:00,23.82,44704,3645,34,86,1067,11,4843,2.357.440.476
01/04/2015 00:00,23.97,43155,3204,36,65,1075,12,4392,2.357.440.476
01/04/2015 01:00,23.59,42187,3344,39,46,1046,13,4488,2.357.440.476
01/04/2015 02:00,23.38,42227,3461,45,39,1030,11,4586,2.357.440.476
01/04/2015 03:00,22.98,42234,3491,52,33,1052,12,4640,2.357.440.476
01/04/2015 04:00,23.64,43263,3478,58,30,1088,12,4666,2.357.440.476
01/04/2015 05:00,24.66,45633,3555,63,29,1138,12,4797,2.357.440.476
01/04/2015 06:00,25.6,49380,3715,65,28,1092,13,4913,2.357.440.476
01/04/2015 07:00,26.71,52626,3909,62,28,1110,13,5122,2.357.440.476
01/04/2015 08:00,26.88,53847,4119,56,35,1077,12,5299,2.357.440.476
01/04/2015 09:00,26.45,53618,4281,53,46,1023,11,5414,2.357.440.476
01/04/2015 10:00,26,53308,4379,54,59,1014,11,5517,2.357.440.476
01/04/2015 11:00,25.63,52677,4429,57,80,1026,10,5602,2.357.440.476
01/04/2015 12:00,25.38,51984,4440,61,110,1131,10,5752,2.357.440.476
01/04/2015 13:00,25.29,51296,4416,64,140,1150,10,5780,2.357.440.476
01/04/2015 14:00,24.78,50555,4423,65,150,1237,11,5886,2.357.440.476
01/04/2015 15:00,24.64,50112,4443,69,158,1305,11,5986,2.357.440.476
01/04/2015 16:00,24.67,49783,4410,74,164,1383,12,6043,2.357.440.476
01/04/2015 17:00,25.01,50080,4342,76,153,1460,14,6045,2.357.440.476
01/04/2015 18:00,25.58,50843,4226,80,142,1509,16,5973,2.357.440.476
01/04/2015 19:00,25.89,51056,4038,82,131,1536,20,5807,2.357.440.476
01/04/2015 20:00,25.72,50520,3816,81,123,1587,18,5625,2.357.440.476
01/04/2015 21:00,25.67,49632,3646,77,115,1606,16,5460,2.357.440.476
01/04/2015 22:00,25.25,47719,3524,74,106,1607,16,5327,2.357.440.476
01/04/2015 23:00,24.18,45252,3404,67,83,1655,23,5232,2.357.440.476
02/04/2015 00:00,24.4,43336,2719,68,77,1606,23,4493,2.357.440.476
02/04/2015 01:00,23.78,42352,2627,69,70,1610,25,4401,2.357.440.476
02/04/2015 02:00,23.65,41984,2479,73,71,1544,27,4194,2.357.440.476
02/04/2015 03:00,24.06,42192,2339,80,73,1539,28,4059,2.357.440.476
02/04/2015 04:00,24.37,42806,2228,86,75,1547,29,3965,2.357.440.476
02/04/2015 05:00,25.04,44249,2121,92,79,1575,26,3893,2.357.440.476
02/04/2015 06:00,25.76,46199,2080,91,83,1544,27,3825,2.357.440.476
02/04/2015 07:00,26.12,48179,2109,83,86,1451,27,3756,2.357.440.476
02/04/2015 08:00,26.26,49724,2257,74,92,1410,25,3858,2.357.440.476
02/04/2015 09:00,26.2,50233,2546,66,98,1307,23,4040,2.357.440.476
02/04/2015 10:00,26.02,50306,2857,61,105,1275,23,4321,2.357.440.476
02/04/2015 11:00,25.89,50085,3006,59,104,1282,21,4472,2.357.440.476
02/04/2015 12:00,25.68,49314,3004,58,103,1394,22,4581,2.357.440.476
02/04/2015 13:00,25.48,48423,2960,56,103,1517,23,4659,2.357.440.476
02/04/2015 14:00,25.15,47675,2862,52,104,1635,26,4679,2.357.440.476
02/04/2015 15:00,24.7,46955,2701,48,102,1722,28,4601,2.357.440.476
02/04/2015 16:00,24.22,46711,2550,44,100,1768,30,4492,2.357.440.476
02/04/2015 17:00,24.87,47025,2378,43,86,1799,31,4337,2.357.440.476
02/04/2015 18:00,25.34,47752,2157,42,72,1828,32,4131,2.357.440.476
02/04/2015 19:00,25.61,48160,1864,41,62,1785,35,3787,2.357.440.476
02/04/2015 20:00,25.58,47914,1737,39,62,1840,34,3712,2.357.440.476
02/04/2015 21:00,25.37,47511,1778,39,62,1901,35,3815,2.357.440.476
02/04/2015 22:00,25.05,45985,1845,38,61,1936,29,3909,2.357.440.476
02/04/2015 23:00,24.45,43946,1855,22,67,2130,22,4096,2.357.440.476
03/04/2015 00:00,24.23,41601,1712,19,66,2106,23,3926,2.357.440.476
03/04/2015 01:00,23.76,40632,1662,16,66,2115,21,3880,2.357.440.476
03/04/2015 02:00,23.69,40149,1599,14,65,2097,22,3797,2.357.440.476
03/04/2015 03:00,23.76,40089,1523,11,63,2049,19,3665,2.357.440.476
03/04/2015 04:00,23.93,40408,1458,10,62,1994,17,3541,2.357.440.476
03/04/2015 05:00,24.01,40836,1421,9,62,1916,16,3424,2.357.440.476
03/04/2015 06:00,24.15,41741,1399,9,55,1888,15,3366,2.357.440.476
03/04/2015 07:00,24.64,42890,1354,8,48,1818,14,3242,2.357.440.476
03/04/2015 08:00,24.81,44170,1264,8,41,1662,14,2989,2.357.440.476
03/04/2015 09:00,24.99,44850,1202,8,40,1556,13,2819,2.357.440.476
03/04/2015 10:00,25.05,45225,1155,10,40,1456,16,2677,2.357.440.476
03/04/2015 11:00,25.03,45017,1099,12,43,1455,21,2630,2.357.440.476
03/04/2015 12:00,24.83,44353,1094,16,52,1480,21,2663,2.357.440.476
03/04/2015 13:00,24.63,43732,1123,20,64,1542,22,2771,2.357.440.476
03/04/2015 14:00,24.23,43255,1121,24,76,1581,26,2828,2.357.440.476
03/04/2015 15:00,24.09,42876,1103,27,79,1594,28,2831,2.357.440.476
03/04/2015 16:00,24.38,42887,1073,28,81,1531,28,2741,2.357.440.476
03/04/2015 17:00,25.07,43398,976,29,82,1486,27,2600,2.357.440.476
03/04/2015 18:00,25.62,44064,860,29,72,1439,25,2425,2.357.440.476
03/04/2015 19:00,25.86,44605,735,30,62,1433,21,2281,2.357.440.476
03/04/2015 20:00,25.81,44971,633,30,54,1451,23,2191,2.357.440.476
03/04/2015 21:00,25.8,44952,603,32,51,1538,18,2242,2.357.440.476
03/04/2015 22:00,25.69,44058,599,36,49,1599,17,2300,2.357.440.476
03/04/2015 23:00,25.54,42555,566,33,48,1522,7,2176,2.357.440.476
04/04/2015 00:00,25.67,41264,421,38,47,1534,7,2047,2.357.440.476
04/04/2015 01:00,25.47,40420,425,41,47,1542,7,2062,2.357.440.476
04/04/2015 02:00,25.51,40041,425,44,47,1561,8,2085,2.357.440.476
04/04/2015 03:00,25.38,40015,423,48,49,1633,8,2161,2.357.440.476
04/04/2015 04:00,25.1,40273,419,54,51,1660,7,2191,2.357.440.476
04/04/2015 05:00,25.29,40674,400,61,60,1636,9,2166,2.357.440.476
04/04/2015 06:00,25.4,41320,375,68,69,1559,9,2080,2.357.440.476
04/04/2015 07:00,25.76,42276,359,75,77,1453,11,1975,2.357.440.476
04/04/2015 08:00,25.97,43012,339,78,75,1361,12,1865,2.357.440.476
04/04/2015 09:00,26.32,44100,312,81,74,1280,14,1761,2.357.440.476
04/04/2015 10:00,26.31,44467,305,85,75,1263,12,1740,2.357.440.476
04/04/2015 11:00,25.98,44241,312,90,77,1294,13,1786,2.357.440.476
04/04/2015 12:00,25.58,43766,364,92,80,1333,13,1882,2.357.440.476
04/04/2015 13:00,25.12,43255,432,92,82,1361,15,1982,2.357.440.476
04/04/2015 14:00,24.91,42856,480,89,85,1383,16,2053,2.357.440.476
04/04/2015 15:00,24.81,42573,505,86,87,1399,20,2097,2.357.440.476
04/04/2015 16:00,24.86,42714,543,84,88,1385,22,2122,2.357.440.476
04/04/2015 17:00,25.44,43107,559,83,76,1331,21,2070,2.357.440.476
04/04/2015 18:00,25.72,43499,535,85,66,1270,18,1974,2.357.440.476
04/04/2015 19:00,25.91,43690,504,82,58,1241,15,1900,2.357.440.476
04/04/2015 20:00,25.91,43723,465,76,54,1215,12,1822,2.357.440.476
04/04/2015 21:00,25.9,44052,434,71,49,1245,8,1807,2.357.440.476
04/04/2015 22:00,25.79,43096,404,63,44,1264,6,1781,2.357.440.476
04/04/2015 23:00,25.56,41631,373,54,47,1225,9,1708,2.357.440.476
05/04/2015 00:00,25.84,40179,578,54,45,1193,7,1877,2.357.440.476
05/04/2015 01:00,25.62,39388,561,52,42,1193,6,1854,2.357.440.476
05/04/2015 02:00,25.42,39030,542,50,41,1184,5,1822,2.357.440.476
05/04/2015 03:00,25.08,39003,516,46,41,1156,4,1763,2.357.440.476
05/04/2015 04:00,24.6,39281,490,42,41,1123,4,1700,2.357.440.476
05/04/2015 05:00,24.72,39655,441,37,38,1064,3,1583,2.357.440.476
05/04/2015 06:00,24.62,40058,384,34,34,968,3,1423,2.357.440.476
05/04/2015 07:00,24.72,40615,341,33,31,875,3,1283,2.357.440.476
05/04/2015 08:00,25.41,41616,334,32,23,805,3,1197,2.357.440.476
05/04/2015 09:00,25.33,42714,370,30,18,763,3,1184,2.357.440.476
05/04/2015 10:00,25.33,43487,456,31,16,750,5,1258,2.357.440.476
05/04/2015 11:00,25.34,43585,561,36,18,738,9,1362,2.357.440.476
05/04/2015 12:00,24.82,43153,662,41,23,758,10,1494,2.357.440.476
05/04/2015 13:00,24.56,42638,795,44,29,780,13,1661,2.357.440.476
05/04/2015 14:00,24.41,42140,904,47,32,789,14,1786,2.357.440.476
05/04/2015 15:00,24.36,41740,943,52,34,790,14,1833,2.357.440.476
05/04/2015 16:00,24.41,41919,922,61,35,758,15,1791,2.357.440.476
05/04/2015 17:00,24.61,42469,848,69,30,710,15,1672,2.357.440.476
05/04/2015 18:00,25.59,43218,737,76,27,732,10,1582,2.357.440.476
05/04/2015 19:00,26.04,44066,602,77,26,785,8,1498,2.357.440.476
05/04/2015 20:00,26.4,44358,482,75,30,889,6,1482,2.357.440.476
05/04/2015 21:00,26.4,44376,404,71,35,1023,4,1537,2.357.440.476
05/04/2015 22:00,26.13,43334,344,62,39,1122,3,1570,2.357.440.476
05/04/2015 23:00,25.75,41585,285,68,35,1341,6,1735,2.357.440.476
06/04/2015 00:00,25.94,40208,198,64,34,1456,6,1758,2.244.404.762
06/04/2015 01:00,25.17,39353,199,61,32,1488,6,1786,2.244.404.762
06/04/2015 02:00,24.52,38978,207,58,33,1594,7,1899,2.244.404.762
06/04/2015 03:00,24.4,39041,216,59,35,1613,7,1930,2.244.404.762
06/04/2015 04:00,24.62,39435,232,54,38,1633,6,1963,2.244.404.762
06/04/2015 05:00,24.79,39976,233,46,39,1610,5,1933,2.244.404.762
06/04/2015 06:00,24.98,40766,226,37,40,1584,5,1892,2.244.404.762
06/04/2015 07:00,25.05,42086,221,29,40,1506,4,1800,2.244.404.762
06/04/2015 08:00,25.52,43314,206,23,36,1377,4,1646,2.244.404.762
06/04/2015 09:00,25.75,43996,186,20,34,1330,6,1576,2.244.404.762
06/04/2015 10:00,25.93,44317,169,17,34,1284,8,1512,2.244.404.762
06/04/2015 11:00,26.14,43901,141,14,34,1280,11,1480,2.244.404.762
06/04/2015 12:00,25.98,43312,119,14,34,1362,10,1539,2.244.404.762
06/04/2015 13:00,25.21,42824,124,16,31,1413,10,1594,2.244.404.762
06/04/2015 14:00,24.78,42438,118,19,29,1488,11,1665,2.244.404.762
06/04/2015 15:00,24.63,42059,117,22,25,1588,12,1764,2.244.404.762
06/04/2015 16:00,24.86,42262,143,24,20,1717,10,1914,2.244.404.762
06/04/2015 17:00,25.05,42829,187,26,20,1867,8,2108,2.244.404.762
06/04/2015 18:00,26.06,43540,234,31,23,1986,6,2280,2.244.404.762
06/04/2015 19:00,26.28,44295,296,38,28,2160,4,2526,2.244.404.762
06/04/2015 20:00,26.3,44725,367,45,25,2299,3,2739,2.244.404.762
06/04/2015 21:00,26.11,44782,441,53,22,2448,1,2965,2.244.404.762
06/04/2015 22:00,25.95,43660,533,60,19,2630,3,3245,2.244.404.762
06/04/2015 23:00,25.48,42118,652,82,16,2936,5,3691,2.244.404.762
07/04/2015 00:00,25.2,40630,789,89,13,3043,6,3940,2.244.404.762
07/04/2015 01:00,24.89,39777,958,95,10,3192,6,4261,2.244.404.762
07/04/2015 02:00,24.69,39424,1137,99,13,3329,8,4586,2.244.404.762
07/04/2015 03:00,24.67,39470,1281,102,18,3428,10,4839,2.244.404.762
07/04/2015 04:00,24.71,40416,1422,105,28,3447,12,5014,2.244.404.762
07/04/2015 05:00,25.21,42660,1538,106,35,3486,12,5177,2.244.404.762
07/04/2015 06:00,26.17,46244,1602,103,43,3336,13,5097,2.244.404.762
07/04/2015 07:00,26.78,49822,1660,97,52,3179,17,5005,2.244.404.762
07/04/2015 08:00,27.66,51191,1721,92,68,3005,24,4910,2.244.404.762
07/04/2015 09:00,27.72,50855,1774,86,88,2895,37,4880,2.244.404.762
07/04/2015 10:00,27.32,50428,1815,79,108,2770,41,4813,2.244.404.762
07/04/2015 11:00,27.18,49750,1858,72,121,2674,32,4757,2.244.404.762
07/04/2015 12:00,26.47,48908,1909,64,132,2585,21,4711,2.244.404.762
07/04/2015 13:00,26.35,48105,1937,52,143,2476,16,4624,2.244.404.762
07/04/2015 14:00,26.01,47471,1933,41,130,2452,14,4570,2.244.404.762
07/04/2015 15:00,26.03,46679,1984,37,114,2335,12,4482,2.244.404.762
07/04/2015 16:00,26.06,46276,2058,41,97,2331,8,4535,2.244.404.762
07/04/2015 17:00,26.18,46339,2102,45,74,2327,6,4554,2.244.404.762
07/04/2015 18:00,26.37,46696,2090,50,54,2376,4,4574,2.244.404.762
07/04/2015 19:00,26.55,46957,2017,55,38,2470,4,4584,2.244.404.762
07/04/2015 20:00,26.43,46760,1914,60,31,2653,4,4662,2.244.404.762
07/04/2015 21:00,26.25,45994,1869,65,26,2742,5,4707,2.244.404.762
07/04/2015 22:00,25.71,44071,1871,42,22,2811,4,4750,2.244.404.762
07/04/2015 23:00,25.1,41678,1858,97,19,2956,4,4934,2.244.404.762
08/04/2015 00:00,24.27,39451,2012,115,18,2967,5,5117,2.244.404.762
08/04/2015 01:00,24.02,38441,2051,131,16,2956,7,5161,2.244.404.762
08/04/2015 02:00,23.82,38143,2066,139,18,2982,6,5211,2.244.404.762
08/04/2015 03:00,23.83,38365,2097,143,21,3000,6,5267,2.244.404.762
08/04/2015 04:00,24.12,39311,2129,150,25,3049,6,5359,2.244.404.762
08/04/2015 05:00,24.51,41508,2086,158,29,3015,7,5295,2.244.404.762
08/04/2015 06:00,25.45,45382,2001,176,32,2962,9,5180,2.244.404.762
08/04/2015 07:00,26.37,49029,1931,200,35,2918,10,5094,2.244.404.762
08/04/2015 08:00,26.91,50172,1810,214,42,2962,12,5040,2.244.404.762
08/04/2015 09:00,26.76,49623,1675,226,51,2960,19,4931,2.244.404.762
08/04/2015 10:00,26.64,49049,1547,232,62,2966,22,4829,2.244.404.762
08/04/2015 11:00,26.36,48165,1351,234,74,2962,36,4657,2.244.404.762
08/04/2015 12:00,26.14,47345,1093,234,86,2878,48,4339,2.244.404.762
08/04/2015 13:00,26.04,46762,870,233,97,2794,63,4057,2.244.404.762
08/04/2015 14:00,25.81,46222,710,235,104,2677,67,3793,2.244.404.762
08/04/2015 15:00,25.72,45539,541,234,109,2555,54,3493,2.244.404.762
08/04/2015 16:00,25.84,45327,392,234,114,2432,39,3211,2.244.404.762
08/04/2015 17:00,26.26,45569,304,235,95,2399,30,3063,2.244.404.762
08/04/2015 18:00,26.59,45933,256,235,78,2328,23,2920,2.244.404.762
08/04/2015 19:00,27.27,46216,228,236,63,2257,24,2808,2.244.404.762
08/04/2015 20:00,26.96,46003,199,235,64,2238,27,2763,2.244.404.762
08/04/2015 21:00,26.83,45307,172,234,64,2245,27,2742,2.244.404.762
08/04/2015 22:00,26.16,43557,177,233,63,2197,27,2697,2.244.404.762
08/04/2015 23:00,25.41,41417,190,243,55,2333,21,2842,2.244.404.762
09/04/2015 00:00,25.09,39632,147,241,55,2406,20,2869,2.244.404.762
09/04/2015 01:00,24.83,38773,210,235,55,2516,21,3037,2.244.404.762
09/04/2015 02:00,24.73,38534,293,220,53,2670,17,3253,2.244.404.762
09/04/2015 03:00,24.7,38811,350,194,52,2805,11,3412,2.244.404.762
09/04/2015 04:00,24.87,39779,360,166,52,2909,7,3494,2.244.404.762
09/04/2015 05:00,25.29,42094,369,140,54,3014,6,3583,2.244.404.762
09/04/2015 06:00,26.55,45514,374,123,56,2983,7,3543,2.244.404.762
09/04/2015 07:00,29.41,48520,377,120,57,2932,7,3493,2.244.404.762
09/04/2015 08:00,30.92,50043,391,132,69,2891,14,3497,2.244.404.762
09/04/2015 09:00,30.17,49687,427,148,82,2887,23,3567,2.244.404.762
09/04/2015 10:00,29.06,49194,471,161,96,2918,48,3694,2.244.404.762
09/04/2015 11:00,28.58,48493,497,169,105,2996,58,3825,2.244.404.762
09/04/2015 12:00,27.78,47727,507,174,115,3082,61,3939,2.244.404.762
09/04/2015 13:00,26.62,47154,522,174,129,3175,69,4069,2.244.404.762
09/04/2015 14:00,25.95,46545,542,168,126,3242,68,4146,2.244.404.762
09/04/2015 15:00,25.83,45923,561,159,120,3238,66,4144,2.244.404.762
09/04/2015 16:00,25.93,45615,574,154,112,3138,61,4039,2.244.404.762
09/04/2015 17:00,26.26,45627,551,145,114,3088,58,3956,2.244.404.762
09/04/2015 18:00,26.54,45893,511,138,117,2980,55,3801,2.244.404.762
09/04/2015 19:00,27.39,46195,459,139,121,2865,43,3627,2.244.404.762
09/04/2015 20:00,26.96,46072,410,144,118,2731,33,3436,2.244.404.762
09/04/2015 21:00,26.46,45369,401,146,115,2619,26,3307,2.244.404.762
09/04/2015 22:00,25.72,43573,406,139,111,2444,22,3122,2.244.404.762
09/04/2015 23:00,25.08,41328,411,121,118,2256,13,2919,2.244.404.762
10/04/2015 00:00,25.06,39703,408,119,107,2086,9,2729,2.244.404.762
10/04/2015 01:00,24.88,38850,396,113,95,1855,8,2467,2.244.404.762
10/04/2015 02:00,24.89,38660,382,105,85,1778,7,2357,2.244.404.762
10/04/2015 03:00,24.99,38958,355,92,76,1729,7,2259,2.244.404.762
10/04/2015 04:00,25.11,39936,333,78,68,1838,7,2324,2.244.404.762
10/04/2015 05:00,25.42,42190,307,65,61,1993,6,2432,2.244.404.762
10/04/2015 06:00,26.87,45506,266,49,53,2087,6,2461,2.244.404.762
10/04/2015 07:00,30.28,49084,238,35,45,2137,8,2463,2.244.404.762
10/04/2015 08:00,32.17,50752,228,27,44,2279,8,2586,2.244.404.762
10/04/2015 09:00,30.2,50840,215,26,44,2408,7,2700,2.244.404.762
10/04/2015 10:00,28.78,50318,206,37,46,2558,10,2857,2.244.404.762
10/04/2015 11:00,27.6,49523,214,57,53,2686,12,3022,2.244.404.762
10/04/2015 12:00,26.7,48398,234,82,62,2840,14,3232,2.244.404.762
10/04/2015 13:00,25.93,47254,258,98,73,2890,15,3334,2.244.404.762
10/04/2015 14:00,25.38,46229,263,109,73,2923,16,3384,2.244.404.762
10/04/2015 15:00,25.2,45342,258,121,71,2908,18,3376,2.244.404.762
10/04/2015 16:00,25.24,44365,258,127,69,2847,14,3315,2.244.404.762
10/04/2015 17:00,25.58,44410,248,129,67,2791,13,3248,2.244.404.762
10/04/2015 18:00,25.81,44727,250,131,67,2744,12,3204,2.244.404.762
10/04/2015 19:00,25.98,44645,278,138,68,2656,11,3151,2.244.404.762
10/04/2015 20:00,25.56,44273,334,144,68,2507,11,3064,2.244.404.762
10/04/2015 21:00,25.44,43697,401,143,68,2338,11,2961,2.244.404.762
10/04/2015 22:00,25.01,42319,505,136,66,2180,11,2898,2.244.404.762
10/04/2015 23:00,24.62,40579,601,123,64,1744,7,2539,2.244.404.762
11/04/2015 00:00,25.18,38496,616,114,56,1570,5,2361,2.244.404.762
11/04/2015 01:00,25.04,37690,730,103,48,1418,5,2304,2.244.404.762
11/04/2015 02:00,24.99,37390,818,89,37,1299,4,2247,2.244.404.762
11/04/2015 03:00,24.89,37376,887,76,29,1168,3,2163,2.244.404.762
11/04/2015 04:00,24.88,37676,952,59,22,1088,3,2124,2.244.404.762
11/04/2015 05:00,24.93,38189,1008,44,17,1026,2,2097,2.244.404.762
11/04/2015 06:00,25.03,38915,1049,31,13,932,1,2026,2.244.404.762
11/04/2015 07:00,25.35,40168,1063,21,9,842,0,1935,2.244.404.762
11/04/2015 08:00,25.51,41697,974,14,8,787,1,1784,2.244.404.762
11/04/2015 09:00,25.77,42797,882,10,8,896,2,1798,2.244.404.762
11/04/2015 10:00,25.45,43041,914,10,9,1005,4,1942,2.244.404.762
11/04/2015 11:00,25.07,42543,1062,14,13,1218,10,2317,2.244.404.762
11/04/2015 12:00,24.6,41767,1326,22,18,1432,12,2810,2.244.404.762
11/04/2015 13:00,24.35,41118,1551,25,22,1621,10,3229,2.244.404.762
11/04/2015 14:00,24.04,40576,1709,27,22,1714,10,3482,2.244.404.762
11/04/2015 15:00,23.86,40248,1968,31,20,1898,9,3926,2.244.404.762
11/04/2015 16:00,23.95,40491,2321,35,17,2018,8,4399,2.244.404.762
11/04/2015 17:00,24.01,41333,2532,42,18,2037,7,4636,2.244.404.762
11/04/2015 18:00,24.28,42209,2688,53,22,2174,6,4943,2.244.404.762
11/04/2015 19:00,24.23,42186,2956,70,30,2252,5,5313,2.244.404.762
11/04/2015 20:00,24.6,41931,3239,85,44,2427,8,5803,2.244.404.762
11/04/2015 21:00,24.47,41694,3521,97,61,2603,8,6290,2.244.404.762
11/04/2015 22:00,24.15,40811,3795,104,81,2928,9,6917,2.244.404.762
11/04/2015 23:00,23.12,39465,3848,109,87,2781,10,6835,2.244.404.762
12/04/2015 00:00,20.48,37962,3774,121,97,2860,11,6863,2.244.404.762
12/04/2015 01:00,19.03,37175,3212,127,106,3046,11,6502,2.244.404.762
12/04/2015 02:00,18.27,36789,3485,125,115,3130,12,6867,2.244.404.762
12/04/2015 03:00,20.1,36690,3620,124,125,3192,14,7075,2.244.404.762
12/04/2015 04:00,20.82,36768,3410,124,136,3265,15,6950,2.244.404.762
12/04/2015 05:00,20.28,36980,3241,129,158,3233,16,6777,2.244.404.762
12/04/2015 06:00,20.29,37268,3126,139,188,3238,23,6714,2.244.404.762
12/04/2015 07:00,20.91,38114,3102,145,204,3255,43,6749,2.244.404.762
12/04/2015 08:00,21.54,39595,3267,150,212,3294,55,6978,2.244.404.762
12/04/2015 09:00,22.68,41303,3523,157,215,3297,68,7260,2.244.404.762
12/04/2015 10:00,23.28,42099,3737,171,215,3458,74,7655,2.244.404.762
12/04/2015 11:00,22.99,42191,3884,191,215,3657,77,8024,2.244.404.762
12/04/2015 12:00,22.35,41791,3679,207,215,3822,80,8003,2.244.404.762
12/04/2015 13:00,21.55,41405,3717,216,215,3947,82,8177,2.244.404.762
12/04/2015 14:00,20.92,41092,3735,219,215,3987,82,8238,2.244.404.762
12/04/2015 15:00,20.83,40969,3713,218,215,3952,82,8180,2.244.404.762
12/04/2015 16:00,21.4,41272,3653,216,212,3937,81,8099,2.244.404.762
12/04/2015 17:00,22.72,42067,3873,216,201,3879,79,8248,2.244.404.762
12/04/2015 18:00,23.28,42805,3683,215,187,3841,76,8002,2.244.404.762
12/04/2015 19:00,24.49,43164,3423,213,182,3793,72,7683,2.244.404.762
12/04/2015 20:00,24.7,43433,3063,211,178,3653,70,7175,2.244.404.762
12/04/2015 21:00,24.8,43105,2508,210,172,3609,64,6563,2.244.404.762
12/04/2015 22:00,24.54,41838,1949,210,166,3486,60,5871,2.244.404.762
12/04/2015 23:00,22.49,40291,1630,181,170,2508,40,4529,2.244.404.762
13/04/2015 00:00,20.62,38865,2509,177,165,2391,32,5274,215.952.381
13/04/2015 01:00,20.26,38208,2964,169,158,2334,30,5655,215.952.381
13/04/2015 02:00,18.91,37965,3393,159,152,2334,23,6061,215.952.381
13/04/2015 03:00,18.6,38191,3669,146,144,2427,27,6413,215.952.381
13/04/2015 04:00,20.12,39149,3843,133,135,2540,22,6673,215.952.381
13/04/2015 05:00,22.6,41358,3900,118,135,2716,14,6883,215.952.381
13/04/2015 06:00,25,44697,3890,104,134,2836,14,6978,215.952.381
13/04/2015 07:00,25.89,48029,3885,88,130,2990,16,7109,215.952.381
13/04/2015 08:00,25.99,49511,3977,74,123,3162,13,7349,215.952.381
13/04/2015 09:00,25.81,49492,4116,61,115,3297,5,7594,215.952.381
13/04/2015 10:00,25.54,49230,4210,53,125,3441,11,7840,215.952.381
13/04/2015 11:00,25.24,48700,4221,47,163,3508,19,7958,215.952.381
13/04/2015 12:00,24.95,48017,4179,45,189,3572,22,8007,215.952.381
13/04/2015 13:00,24.84,47513,4138,51,195,3608,31,8023,215.952.381
13/04/2015 14:00,24.59,47055,4078,64,195,3643,40,8020,215.952.381
13/04/2015 15:00,24.54,46458,3995,82,192,4101,41,8411,215.952.381
13/04/2015 16:00,24.73,46287,3922,97,183,4025,36,8263,215.952.381
13/04/2015 17:00,25.05,46383,3801,116,161,3912,33,8023,215.952.381
13/04/2015 18:00,25.23,46555,3571,137,122,3747,19,7596,215.952.381
13/04/2015 19:00,25.59,46759,3193,150,102,3660,14,7119,215.952.381
13/04/2015 20:00,25.92,46757,2745,157,99,3512,13,6526,215.952.381
13/04/2015 21:00,25.9,46212,2341,161,96,3356,9,5963,215.952.381
13/04/2015 22:00,25.42,44491,2013,161,94,3222,9,5499,215.952.381
13/04/2015 23:00,25.06,42345,1743,145,86,3181,13,5168,215.952.381
14/04/2015 00:00,24.83,40513,1435,154,84,3047,12,4732,215.952.381
14/04/2015 01:00,24.68,39733,1299,159,82,2865,13,4418,215.952.381
14/04/2015 02:00,24.66,39552,1179,163,84,2708,12,4146,215.952.381
14/04/2015 03:00,24.79,39859,1110,165,86,2510,12,3883,215.952.381
14/04/2015 04:00,24.95,40746,1109,167,90,2374,9,3749,215.952.381
14/04/2015 05:00,25.33,43005,1126,170,85,2170,9,3560,215.952.381
14/04/2015 06:00,26.71,46600,1201,176,79,1871,13,3340,215.952.381
14/04/2015 07:00,29.92,49897,1369,178,73,1555,20,3195,215.952.381
14/04/2015 08:00,30.94,51330,1570,180,86,1338,26,3200,215.952.381
14/04/2015 09:00,29.68,51056,1771,181,101,1185,29,3267,215.952.381
14/04/2015 10:00,29.05,50632,2015,182,116,1170,33,3516,215.952.381
14/04/2015 11:00,27.88,50036,2242,182,123,1299,32,3878,215.952.381
14/04/2015 12:00,27.37,49526,2432,181,131,1468,31,4243,215.952.381
14/04/2015 13:00,26.89,49202,2623,180,141,1591,27,4562,215.952.381
14/04/2015 14:00,26.05,48798,2693,176,138,1824,28,4859,215.952.381
14/04/2015 15:00,25.88,48194,2689,163,132,1995,23,5002,215.952.381
14/04/2015 16:00,25.57,47864,2750,144,125,2124,22,5165,215.952.381
14/04/2015 17:00,25.71,47752,2757,117,120,2310,24,5328,215.952.381
14/04/2015 18:00,25.89,47641,2741,91,115,2332,31,5310,215.952.381
14/04/2015 19:00,25.93,47586,2721,78,111,2301,35,5246,215.952.381
14/04/2015 20:00,25.89,47244,2617,72,106,2353,31,5179,215.952.381
14/04/2015 21:00,25.71,46401,2460,68,100,2432,27,5087,215.952.381
14/04/2015 22:00,25.23,44603,2318,62,94,2422,29,4925,215.952.381
14/04/2015 23:00,24.51,42204,2207,41,141,2410,18,4817,215.952.381
15/04/2015 00:00,23.97,40008,1847,30,161,2327,18,4383,215.952.381
15/04/2015 01:00,24.26,39009,1730,24,175,2216,22,4167,215.952.381
15/04/2015 02:00,23.94,38764,1632,23,169,2126,26,3976,215.952.381
15/04/2015 03:00,24.22,38945,1540,27,165,2067,28,3827,215.952.381
15/04/2015 04:00,24.71,39741,1471,32,162,1958,28,3651,215.952.381
15/04/2015 05:00,25.14,41868,1423,37,151,1849,28,3488,215.952.381
15/04/2015 06:00,25.97,45339,1453,40,136,1675,26,3330,215.952.381
15/04/2015 07:00,28.09,48622,1596,43,119,1562,22,3342,215.952.381
15/04/2015 08:00,29.64,50796,1842,52,110,1467,27,3498,215.952.381
15/04/2015 09:00,28.87,50497,2146,64,101,1436,28,3775,215.952.381
15/04/2015 10:00,26.91,50091,2508,79,94,1375,28,4084,215.952.381
15/04/2015 11:00,26.36,49338,2879,91,98,1430,26,4524,215.952.381
15/04/2015 12:00,25.99,48695,3175,96,103,1440,24,4838,215.952.381
15/04/2015 13:00,25.87,48241,3431,88,110,1542,27,5198,215.952.381
15/04/2015 14:00,25.61,47789,3588,74,113,1694,26,5495,215.952.381
15/04/2015 15:00,25.39,47261,3672,60,114,1848,23,5717,215.952.381
15/04/2015 16:00,25.41,46913,3724,49,114,1957,19,5863,215.952.381
15/04/2015 17:00,25.36,46786,3709,42,125,2075,18,5969,215.952.381
15/04/2015 18:00,25.68,46782,3633,37,138,2169,13,5990,215.952.381
15/04/2015 19:00,25.69,46748,3522,36,151,2313,12,6034,215.952.381
15/04/2015 20:00,25.66,46447,3375,34,168,2410,10,5997,215.952.381
15/04/2015 21:00,25.53,45780,3195,30,175,2496,9,5905,215.952.381
15/04/2015 22:00,25.24,44142,3039,25,186,2576,14,5840,215.952.381
15/04/2015 23:00,24.7,41880,2883,13,212,2660,60,5828,215.952.381
16/04/2015 00:00,23.49,39887,2916,11,215,2706,66,5914,215.952.381
16/04/2015 01:00,23.14,39043,2857,16,215,2772,59,5919,215.952.381
16/04/2015 02:00,23.06,38849,2813,24,211,2801,49,5898,215.952.381
16/04/2015 03:00,23.3,39140,2757,31,201,2786,35,5810,215.952.381
16/04/2015 04:00,23.81,39968,2676,36,183,2729,33,5657,215.952.381
16/04/2015 05:00,24.58,42132,2598,37,168,2657,36,5496,215.952.381
16/04/2015 06:00,25.43,45473,2545,41,154,2527,30,5297,215.952.381
16/04/2015 07:00,27.72,48540,2547,53,138,2418,36,5192,215.952.381
16/04/2015 08:00,28.78,50130,2689,73,132,2359,35,5288,215.952.381
16/04/2015 09:00,28.1,49793,2894,94,127,2413,38,5566,215.952.381
16/04/2015 10:00,27.45,49358,3047,115,123,2408,37,5730,215.952.381
16/04/2015 11:00,26.77,48689,3136,126,127,2512,33,5934,215.952.381
16/04/2015 12:00,25.91,48025,3167,135,137,2609,32,6080,215.952.381
16/04/2015 13:00,25.65,47496,3191,137,144,2647,38,6157,215.952.381
16/04/2015 14:00,25.39,46923,3236,139,145,2722,41,6283,215.952.381
16/04/2015 15:00,25.34,46373,3266,138,144,2759,37,6344,215.952.381
16/04/2015 16:00,25.24,46188,3278,127,140,2632,32,6209,215.952.381
16/04/2015 17:00,25.39,46213,3193,112,128,2512,26,5971,215.952.381
16/04/2015 18:00,25.51,46166,2978,99,113,2312,19,5521,215.952.381
16/04/2015 19:00,25.66,46167,2690,90,99,2305,19,5203,215.952.381
16/04/2015 20:00,25.99,45936,2381,82,98,2324,18,4903,215.952.381
16/04/2015 21:00,25.82,45490,2136,71,97,2252,16,4572,215.952.381
16/04/2015 22:00,25.32,43783,1963,58,96,2239,15,4371,215.952.381
16/04/2015 23:00,24.93,41545,1840,61,80,2488,13,4482,215.952.381
17/04/2015 00:00,23.96,39788,1682,56,74,2451,13,4276,215.952.381
17/04/2015 01:00,23.82,38957,1562,55,66,2468,16,4167,215.952.381
17/04/2015 02:00,23.8,38791,1434,53,65,2421,16,3989,215.952.381
17/04/2015 03:00,23.89,39001,1314,52,65,2343,13,3787,215.952.381
17/04/2015 04:00,24.07,39802,1218,52,66,2340,12,3688,215.952.381
17/04/2015 05:00,24.86,41870,1148,51,60,2220,8,3487,215.952.381
17/04/2015 06:00,26.23,45135,1106,54,53,2055,8,3276,215.952.381
17/04/2015 07:00,28.93,48288,1042,60,46,1945,8,3101,215.952.381
17/04/2015 08:00,29.98,49557,987,66,49,1897,10,3009,215.952.381
17/04/2015 09:00,29.35,49553,984,72,54,1895,15,3020,215.952.381
17/04/2015 10:00,29.12,49298,1003,80,63,1904,17,3067,215.952.381
17/04/2015 11:00,28.52,48730,1056,84,77,1861,19,3097,215.952.381
17/04/2015 12:00,27.79,47848,1167,87,93,1880,20,3247,215.952.381
17/04/2015 13:00,26.86,46913,1332,82,115,1849,20,3398,215.952.381
17/04/2015 14:00,25.95,46078,1499,78,118,1815,24,3534,215.952.381
17/04/2015 15:00,25.21,45233,1648,71,119,1790,27,3655,215.952.381
17/04/2015 16:00,25.07,44899,1794,65,119,1738,24,3740,215.952.381
17/04/2015 17:00,25.08,44969,1822,62,103,1662,22,3671,215.952.381
17/04/2015 18:00,25.19,45009,1702,63,89,1581,19,3454,215.952.381
17/04/2015 19:00,25.3,44730,1490,67,77,1481,22,3137,215.952.381
17/04/2015 20:00,25.44,44297,1188,73,73,1484,25,2843,215.952.381
17/04/2015 21:00,25.44,43817,935,78,70,1533,26,2642,215.952.381
17/04/2015 22:00,25.02,42540,776,78,67,1612,24,2557,215.952.381
17/04/2015 23:00,24.69,40849,653,83,40,1740,19,2535,215.952.381
18/04/2015 00:00,24.28,39560,584,80,40,1750,16,2470,215.952.381
18/04/2015 01:00,24.1,38648,488,75,40,1780,14,2397,215.952.381
18/04/2015 02:00,24.05,38197,388,67,40,1742,13,2250,215.952.381
18/04/2015 03:00,24.07,38126,330,58,40,1776,12,2216,215.952.381
18/04/2015 04:00,24.12,38252,313,51,40,1712,14,2130,215.952.381
18/04/2015 05:00,24.18,38596,278,44,40,1619,12,1993,215.952.381
18/04/2015 06:00,24.12,39259,229,40,40,1543,13,1865,215.952.381
18/04/2015 07:00,24.3,40596,211,36,40,1393,13,1693,215.952.381
18/04/2015 08:00,24.76,41982,202,35,40,1343,16,1636,215.952.381
18/04/2015 09:00,24.93,43091,221,34,40,1298,15,1608,215.952.381
18/04/2015 10:00,24.69,43322,293,35,40,1335,17,1720,215.952.381
18/04/2015 11:00,24.37,42808,351,36,40,1409,17,1853,215.952.381
18/04/2015 12:00,24.14,42130,403,38,40,1569,20,2070,215.952.381
18/04/2015 13:00,23.98,41436,531,39,40,1673,21,2304,215.952.381
18/04/2015 14:00,23.81,40944,702,42,40,1759,26,2569,215.952.381
18/04/2015 15:00,23.67,40672,833,47,40,1831,29,2780,215.952.381
18/04/2015 16:00,23.7,40865,947,49,40,1855,32,2923,215.952.381
18/04/2015 17:00,23.88,41411,969,48,40,1844,33,2934,215.952.381
18/04/2015 18:00,24.25,41821,869,45,40,1799,27,2780,215.952.381
18/04/2015 19:00,24.29,41561,782,39,40,1892,17,2770,215.952.381
18/04/2015 20:00,24.38,41304,684,34,40,1856,20,2634,215.952.381
18/04/2015 21:00,24.41,41083,572,34,40,2086,19,2751,215.952.381
18/04/2015 22:00,24.27,40295,516,42,40,2180,17,2795,215.952.381
18/04/2015 23:00,24.06,38916,434,54,46,1976,6,2516,215.952.381
19/04/2015 00:00,24.21,37730,390,63,41,2016,5,2515,215.952.381
19/04/2015 01:00,23.89,36870,404,65,36,2031,5,2541,215.952.381
19/04/2015 02:00,23.5,36501,444,58,36,2123,3,2664,215.952.381
19/04/2015 03:00,22.82,36446,501,49,36,2203,3,2792,215.952.381
19/04/2015 04:00,22.75,36474,653,43,36,2241,5,2978,215.952.381
19/04/2015 05:00,22.48,36592,809,38,32,2301,5,3185,215.952.381
19/04/2015 06:00,22.17,36796,943,38,28,2290,5,3304,215.952.381
19/04/2015 07:00,22.85,37622,1006,42,24,2262,6,3340,215.952.381
19/04/2015 08:00,23.74,38634,955,47,28,2276,6,3312,215.952.381
19/04/2015 09:00,24,40002,861,53,35,2365,11,3325,215.952.381
19/04/2015 10:00,24.11,40771,791,58,45,2371,13,3278,215.952.381
19/04/2015 11:00,24.07,40620,748,62,59,2437,15,3321,215.952.381
19/04/2015 12:00,23.99,40156,678,71,77,2526,19,3371,215.952.381
19/04/2015 13:00,23.85,39661,564,78,94,2635,23,3394,215.952.381
19/04/2015 14:00,23.71,39305,461,87,105,2773,31,3457,215.952.381
19/04/2015 15:00,23.57,38966,396,99,113,2931,33,3572,215.952.381
19/04/2015 16:00,23.44,39136,384,106,119,3088,27,3724,215.952.381
19/04/2015 17:00,23.6,39644,389,117,123,3138,19,3786,215.952.381
19/04/2015 18:00,24.11,40163,421,133,128,3210,17,3909,215.952.381
19/04/2015 19:00,24.13,40416,520,146,134,3249,20,4069,215.952.381
19/04/2015 20:00,24.24,40648,626,154,137,3204,29,4150,215.952.381
19/04/2015 21:00,24.22,40725,687,157,140,3189,40,4213,215.952.381
19/04/2015 22:00,23.92,39675,732,152,160,3196,46,4286,215.952.381
19/04/2015 23:00,23.6,37988,721,195,139,3285,22,4362,215.952.381
20/04/2015 00:00,22.91,36605,750,191,130,3185,17,4273,2.163.392.857
20/04/2015 01:00,21.96,35952,822,186,122,3059,20,4209,2.163.392.857
20/04/2015 02:00,21.99,35728,880,180,120,2949,32,4161,2.163.392.857
20/04/2015 03:00,22.91,35975,903,174,119,2804,48,4048,2.163.392.857
20/04/2015 04:00,23.16,36806,911,167,118,2606,56,3858,2.163.392.857
20/04/2015 05:00,24.38,38928,903,160,115,2428,61,3667,2.163.392.857
20/04/2015 06:00,25.62,42227,847,155,112,2124,63,3301,2.163.392.857
20/04/2015 07:00,27.99,45458,746,151,107,1916,66,2986,2.163.392.857
20/04/2015 08:00,29.9,46826,609,146,112,1679,61,2607,2.163.392.857
20/04/2015 09:00,29.56,46563,493,139,119,1460,61,2272,2.163.392.857
20/04/2015 10:00,28.73,46208,419,130,127,1305,58,2039,2.163.392.857
20/04/2015 11:00,28.39,45607,359,123,130,1323,54,1989,2.163.392.857
20/04/2015 12:00,27.69,44898,342,115,134,1306,49,1946,2.163.392.857
20/04/2015 13:00,26.82,44241,353,107,141,1438,46,2085,2.163.392.857
20/04/2015 14:00,26.06,43721,378,97,140,1571,47,2233,2.163.392.857
20/04/2015 15:00,26.09,42985,419,95,137,1686,50,2387,2.163.392.857
20/04/2015 16:00,26.14,42590,495,85,132,1763,46,2521,2.163.392.857
20/04/2015 17:00,26.12,42499,579,73,115,1792,39,2598,2.163.392.857
20/04/2015 18:00,26.08,42523,641,60,99,1836,33,2669,2.163.392.857
20/04/2015 19:00,26.18,42651,667,52,85,1862,22,2688,2.163.392.857
20/04/2015 20:00,26.27,42653,726,49,72,1882,18,2747,2.163.392.857
20/04/2015 21:00,26.21,42472,809,48,61,2015,16,2949,2.163.392.857
20/04/2015 22:00,25.15,40963,927,46,52,2065,12,3102,2.163.392.857
20/04/2015 23:00,24.58,38803,1028,59,43,2322,6,3458,2.163.392.857
21/04/2015 00:00,23.12,37002,1414,63,40,2323,6,3846,2.163.392.857
21/04/2015 01:00,22.35,36163,1500,67,36,2246,7,3856,2.163.392.857
21/04/2015 02:00,22.2,35962,1602,69,34,2195,6,3906,2.163.392.857
21/04/2015 03:00,22.37,36233,1700,69,32,2149,7,3957,2.163.392.857
21/04/2015 04:00,22.74,37030,1748,64,31,2028,7,3878,2.163.392.857
21/04/2015 05:00,23.52,39273,1721,61,26,1812,10,3630,2.163.392.857
21/04/2015 06:00,25.19,42709,1695,56,22,1552,15,3340,2.163.392.857
21/04/2015 07:00,27.02,45986,1715,53,17,1315,18,3118,2.163.392.857
21/04/2015 08:00,27.55,47170,1657,52,19,973,25,2726,2.163.392.857
21/04/2015 09:00,27.4,46886,1574,51,22,774,28,2449,2.163.392.857
21/04/2015 10:00,27.21,46492,1561,44,27,532,26,2190,2.163.392.857
21/04/2015 11:00,26.87,45843,1528,40,32,380,23,2003,2.163.392.857
21/04/2015 12:00,26.11,45087,1494,37,40,329,22,1922,2.163.392.857
21/04/2015 13:00,25.81,44467,1585,41,45,335,21,2027,2.163.392.857
21/04/2015 14:00,25.44,43934,1691,52,50,360,22,2175,2.163.392.857
21/04/2015 15:00,25.24,43393,1753,65,53,410,23,2304,2.163.392.857
21/04/2015 16:00,25.02,42941,1844,70,54,429,21,2418,2.163.392.857
21/04/2015 17:00,25.21,42867,1915,66,50,529,16,2576,2.163.392.857
21/04/2015 18:00,25.18,42916,1966,58,46,641,10,2721,2.163.392.857
21/04/2015 19:00,25.13,43017,2044,53,45,758,7,2907,2.163.392.857
21/04/2015 20:00,25.29,43071,2081,52,37,1005,5,3180,2.163.392.857
21/04/2015 21:00,25.26,42874,2048,52,32,1323,3,3458,2.163.392.857
21/04/2015 22:00,24.56,41410,1965,47,28,1488,2,3530,2.163.392.857
21/04/2015 23:00,23.86,39220,1806,51,24,1601,3,3485,2.163.392.857
22/04/2015 00:00,21.93,36475,2197,47,18,1668,3,3933,2.163.392.857
22/04/2015 01:00,21.09,35598,1938,47,12,1644,3,3644,2.163.392.857
22/04/2015 02:00,21.29,35433,1629,50,9,1731,3,3422,2.163.392.857
22/04/2015 03:00,21.92,35593,1305,55,7,1763,3,3133,2.163.392.857
22/04/2015 04:00,22.64,36395,1082,51,6,1842,3,2984,2.163.392.857
22/04/2015 05:00,23.53,38497,935,42,6,1845,2,2830,2.163.392.857
22/04/2015 06:00,25.02,41930,808,33,5,1816,3,2665,2.163.392.857
22/04/2015 07:00,26.42,45179,669,32,4,1774,3,2482,2.163.392.857
22/04/2015 08:00,27.47,46623,512,39,5,1756,5,2317,2.163.392.857
22/04/2015 09:00,27.15,46230,392,51,7,1743,5,2198,2.163.392.857
22/04/2015 10:00,26.91,45694,329,70,13,1769,8,2189,2.163.392.857
22/04/2015 11:00,25.96,44770,315,90,22,1805,9,2241,2.163.392.857
22/04/2015 12:00,25.55,44077,328,113,36,1837,10,2324,2.163.392.857
22/04/2015 13:00,25.49,43499,371,133,51,1883,12,2450,2.163.392.857
22/04/2015 14:00,25.29,42967,437,157,58,1941,14,2607,2.163.392.857
22/04/2015 15:00,25.21,42258,478,175,64,1973,16,2706,2.163.392.857
22/04/2015 16:00,25.06,41570,504,177,68,1955,17,2721,2.163.392.857
22/04/2015 17:00,25.06,41386,533,172,64,1962,15,2746,2.163.392.857
22/04/2015 18:00,24.96,41327,596,160,60,1974,11,2801,2.163.392.857
22/04/2015 19:00,24.88,41302,689,143,58,2231,9,3130,2.163.392.857
22/04/2015 20:00,24.86,41202,810,121,57,2489,7,3484,2.163.392.857
22/04/2015 21:00,24.86,40926,986,104,57,2848,7,4002,2.163.392.857
22/04/2015 22:00,23.95,39446,1234,93,57,3081,8,4473,2.163.392.857
22/04/2015 23:00,22.89,37198,1388,110,93,3597,11,5199,2.163.392.857
23/04/2015 00:00,18.99,36044,1650,136,111,3728,14,5639,2.163.392.857
23/04/2015 01:00,16.04,35089,1709,147,127,3828,15,5826,2.163.392.857
23/04/2015 02:00,14.67,34832,1803,160,136,3885,17,6001,2.163.392.857
23/04/2015 03:00,14.68,34994,1979,180,146,3860,20,6185,2.163.392.857
23/04/2015 04:00,15.84,35703,2182,192,166,3834,28,6402,2.163.392.857
23/04/2015 05:00,19.96,37890,2315,194,170,3726,32,6437,2.163.392.857
23/04/2015 06:00,23.46,41387,2367,198,174,3597,37,6373,2.163.392.857
23/04/2015 07:00,24.78,44858,2420,197,179,3403,40,6239,2.163.392.857
23/04/2015 08:00,25.05,46069,2488,200,183,3349,39,6259,2.163.392.857
23/04/2015 09:00,24.99,45832,2481,210,180,3232,32,6135,2.163.392.857
23/04/2015 10:00,24.86,45564,2442,218,171,3233,28,6092,2.163.392.857
23/04/2015 11:00,24.54,45124,2424,220,152,3245,30,6071,2.163.392.857
23/04/2015 12:00,24.37,44611,2434,220,140,3328,21,6143,2.163.392.857
23/04/2015 13:00,24.16,44232,2467,218,130,3464,13,6292,2.163.392.857
23/04/2015 14:00,23.86,43801,2530,215,115,3534,13,6407,2.163.392.857
23/04/2015 15:00,23.81,43236,2560,214,97,3628,12,6511,2.163.392.857
23/04/2015 16:00,23.56,43003,2583,201,79,3614,8,6485,2.163.392.857
23/04/2015 17:00,23.66,43016,2541,179,72,3545,6,6343,2.163.392.857
23/04/2015 18:00,23.66,42916,2446,156,66,3338,4,6010,2.163.392.857
23/04/2015 19:00,23.82,42827,2322,146,62,3198,5,5733,2.163.392.857
23/04/2015 20:00,24.15,42748,2158,142,70,3092,6,5468,2.163.392.857
23/04/2015 21:00,24.55,42559,1993,143,79,2968,6,5189,2.163.392.857
23/04/2015 22:00,24.03,41114,1819,135,88,2817,8,4867,2.163.392.857
23/04/2015 23:00,23.19,38930,1634,99,134,2843,6,4716,2.163.392.857
24/04/2015 00:00,22.65,37406,1552,96,134,2677,7,4466,2.163.392.857
24/04/2015 01:00,22.43,36635,1412,89,134,2536,7,4178,2.163.392.857
24/04/2015 02:00,22.55,36438,1293,82,130,2501,8,4014,2.163.392.857
24/04/2015 03:00,22.95,36718,1162,72,126,2394,10,3764,2.163.392.857
24/04/2015 04:00,23.53,37562,1042,60,124,2250,10,3486,2.163.392.857
24/04/2015 05:00,24.16,39757,941,45,125,2063,7,3181,2.163.392.857
24/04/2015 06:00,25.16,43241,849,35,125,1858,9,2876,2.163.392.857
24/04/2015 07:00,28.61,46751,768,35,123,1665,10,2601,2.163.392.857
24/04/2015 08:00,29.46,48214,698,43,122,1540,13,2416,2.163.392.857
24/04/2015 09:00,28.78,48649,631,56,122,1441,11,2261,2.163.392.857
24/04/2015 10:00,28.2,48090,625,69,123,1367,11,2195,2.163.392.857
24/04/2015 11:00,26.8,47391,653,75,125,1346,11,2210,2.163.392.857
24/04/2015 12:00,25.85,46330,702,80,129,1327,9,2247,2.163.392.857
24/04/2015 13:00,25.19,45387,787,84,135,1314,8,2328,2.163.392.857
24/04/2015 14:00,24.79,44620,875,87,132,1376,9,2479,2.163.392.857
24/04/2015 15:00,24.39,43850,947,92,127,1397,9,2572,2.163.392.857
24/04/2015 16:00,24.12,43507,1027,88,120,1313,11,2559,2.163.392.857
24/04/2015 17:00,24.23,43606,1015,77,102,1211,12,2417,2.163.392.857
24/04/2015 18:00,24.37,43614,917,66,85,1069,11,2148,2.163.392.857
24/04/2015 19:00,24.26,43219,851,61,70,1034,12,2028,2.163.392.857
24/04/2015 20:00,24.51,42743,779,64,67,1070,13,1993,2.163.392.857
24/04/2015 21:00,24.4,42402,721,70,64,1116,15,1986,2.163.392.857
24/04/2015 22:00,23.71,41117,736,68,62,1154,14,2034,2.163.392.857
24/04/2015 23:00,23.3,39404,736,61,34,723,3,1557,2.163.392.857
25/04/2015 00:00,23.53,37634,756,52,34,679,3,1524,2.163.392.857
25/04/2015 01:00,23.28,36636,771,47,33,661,2,1514,2.163.392.857
25/04/2015 02:00,23.1,36144,761,43,28,644,2,1478,2.163.392.857
25/04/2015 03:00,22.64,36103,701,38,24,622,2,1387,2.163.392.857
25/04/2015 04:00,22.05,36110,689,31,22,642,3,1387,2.163.392.857
25/04/2015 05:00,21.97,36490,765,22,19,661,3,1470,2.163.392.857
25/04/2015 06:00,21.99,37141,948,15,17,681,4,1665,2.163.392.857
25/04/2015 07:00,22.97,38771,1165,11,14,730,4,1924,2.163.392.857
25/04/2015 08:00,23.66,40182,1328,10,15,824,4,2181,2.163.392.857
25/04/2015 09:00,23.89,41466,1433,13,18,920,5,2389,2.163.392.857
25/04/2015 10:00,23.9,41973,1597,14,22,1133,7,2773,2.163.392.857
25/04/2015 11:00,23.74,41710,1733,16,32,1403,10,3194,2.163.392.857
25/04/2015 12:00,23.49,41126,1742,19,45,1462,12,3280,2.163.392.857
25/04/2015 13:00,23.2,40635,1751,20,59,1688,12,3530,2.163.392.857
25/04/2015 14:00,23.03,40204,1755,19,51,1794,13,3632,2.163.392.857
25/04/2015 15:00,23.1,40040,1718,20,43,1827,16,3624,2.163.392.857
25/04/2015 16:00,23.09,40347,1714,22,34,1929,15,3714,2.163.392.857
25/04/2015 17:00,23.33,41121,1678,28,29,2012,11,3758,2.163.392.857
25/04/2015 18:00,23.43,41501,1612,40,25,2075,7,3759,2.163.392.857
25/04/2015 19:00,23.4,41095,1577,56,23,2109,8,3773,2.163.392.857
25/04/2015 20:00,23.6,40694,1545,68,29,2146,3,3791,2.163.392.857
25/04/2015 21:00,23.51,40704,1527,84,38,2261,3,3913,2.163.392.857
25/04/2015 22:00,23.12,39977,1506,78,47,2274,4,3909,2.163.392.857
25/04/2015 23:00,22.57,38388,1464,89,60,2344,2,3959,2.163.392.857
26/04/2015 00:00,22.47,36779,1133,82,63,2318,4,3600,2.163.392.857
26/04/2015 01:00,21.55,35887,995,77,69,2362,3,3506,2.163.392.857
26/04/2015 02:00,20.95,35437,819,73,62,2401,5,3360,2.163.392.857
26/04/2015 03:00,20.68,35296,648,68,57,2298,6,3077,2.163.392.857
26/04/2015 04:00,20.44,35263,539,63,52,2150,7,2811,2.163.392.857
26/04/2015 05:00,20.44,35299,456,59,41,2099,6,2661,2.163.392.857
26/04/2015 06:00,20.81,35527,385,56,31,1954,4,2430,2.163.392.857
26/04/2015 07:00,20.53,36365,347,54,24,1916,3,2344,2.163.392.857
26/04/2015 08:00,22.07,37829,368,52,22,1917,3,2362,2.163.392.857
26/04/2015 09:00,23.04,39264,404,50,22,1862,5,2343,2.163.392.857
26/04/2015 10:00,23.17,40132,427,46,24,1806,5,2308,2.163.392.857
26/04/2015 11:00,23.23,40158,444,43,29,1752,6,2274,2.163.392.857
26/04/2015 12:00,22.87,39897,456,45,35,1719,6,2261,2.163.392.857
26/04/2015 13:00,22.62,39508,464,49,41,1653,6,2213,2.163.392.857
26/04/2015 14:00,22.47,39246,466,51,38,1553,5,2113,2.163.392.857
26/04/2015 15:00,22.4,39079,466,50,34,1464,6,2020,2.163.392.857
26/04/2015 16:00,22.57,39273,490,44,29,1282,5,1850,2.163.392.857
26/04/2015 17:00,23.13,39745,492,36,18,1095,4,1645,2.163.392.857
26/04/2015 18:00,23.83,40213,476,34,11,929,3,1453,2.163.392.857
26/04/2015 19:00,24.23,40435,438,34,8,817,3,1300,2.163.392.857
26/04/2015 20:00,24.68,40611,348,36,9,725,3,1121,2.163.392.857
26/04/2015 21:00,24.94,40934,280,36,12,679,1,1008,2.163.392.857
26/04/2015 22:00,24.6,40037,224,33,17,671,2,947,2.163.392.857
26/04/2015 23:00,24,38352,203,23,7,615,3,851,2.163.392.857
27/04/2015 00:00,24.28,36747,174,22,8,578,3,785,2.115.059.524
27/04/2015 01:00,24.02,36065,184,20,8,528,3,743,2.115.059.524
27/04/2015 02:00,23.1,35929,201,19,11,494,4,729,2.115.059.524
27/04/2015 03:00,22.99,36139,214,17,16,460,5,712,2.115.059.524
27/04/2015 04:00,23.24,36831,230,16,22,400,6,674,2.115.059.524
27/04/2015 05:00,24.85,38915,239,15,22,336,6,618,2.115.059.524
27/04/2015 06:00,26.78,42539,231,15,22,265,6,539,2.115.059.524
27/04/2015 07:00,36.1,46006,230,18,21,232,7,508,2.115.059.524
27/04/2015 08:00,45.27,48187,237,23,21,266,11,558,2.115.059.524
27/04/2015 09:00,44.79,47703,287,29,21,257,12,606,2.115.059.524
27/04/2015 10:00,42.68,47103,371,32,24,297,19,743,2.115.059.524
27/04/2015 11:00,36.14,46272,462,37,25,329,19,872,2.115.059.524
27/04/2015 12:00,34.29,45645,591,39,28,374,21,1053,2.115.059.524
27/04/2015 13:00,30.11,45152,745,36,30,408,15,1234,2.115.059.524
27/04/2015 14:00,28.9,44774,874,31,28,460,10,1403,2.115.059.524
27/04/2015 15:00,28.12,44154,956,27,25,481,6,1495,2.115.059.524
27/04/2015 16:00,26.74,43750,1013,32,21,510,3,1579,2.115.059.524
27/04/2015 17:00,26.69,43681,992,35,21,497,2,1547,2.115.059.524
27/04/2015 18:00,26.69,43527,889,41,24,500,2,1456,2.115.059.524
27/04/2015 19:00,27.79,43350,815,44,30,508,3,1400,2.115.059.524
27/04/2015 20:00,28.77,43198,725,47,40,528,2,1342,2.115.059.524
27/04/2015 21:00,28.73,43154,590,47,54,606,2,1299,2.115.059.524
27/04/2015 22:00,26,41860,522,46,70,677,3,1318,2.115.059.524
27/04/2015 23:00,24.73,39711,504,63,59,886,13,1525,2.115.059.524
28/04/2015 00:00,24.8,38172,930,58,53,900,5,1946,2.115.059.524
28/04/2015 01:00,24.48,37219,819,52,47,913,3,1834,2.115.059.524
28/04/2015 02:00,24.51,36993,731,50,37,908,2,1728,2.115.059.524
28/04/2015 03:00,24.54,37181,651,51,28,870,3,1603,2.115.059.524
28/04/2015 04:00,24.87,37835,591,49,23,836,3,1502,2.115.059.524
28/04/2015 05:00,25.72,40286,522,45,23,776,3,1369,2.115.059.524
28/04/2015 06:00,27.68,43711,436,37,22,630,6,1131,2.115.059.524
28/04/2015 07:00,43.84,47192,376,28,22,545,7,978,2.115.059.524
28/04/2015 08:00,45.31,48893,350,22,20,453,9,854,2.115.059.524
28/04/2015 09:00,43.86,48559,363,19,19,388,12,801,2.115.059.524
28/04/2015 10:00,37.62,48156,424,19,19,385,9,856,2.115.059.524
28/04/2015 11:00,33.37,47544,514,22,22,437,12,1007,2.115.059.524
28/04/2015 12:00,29.86,46736,638,24,26,454,13,1155,2.115.059.524
28/04/2015 13:00,29.22,46180,791,27,30,479,12,1339,2.115.059.524
28/04/2015 14:00,27.53,45625,902,30,29,525,13,1499,2.115.059.524
28/04/2015 15:00,27.33,45064,941,35,28,587,14,1605,2.115.059.524
28/04/2015 16:00,26.59,44588,997,38,28,608,14,1685,2.115.059.524
28/04/2015 17:00,26.46,44448,1024,39,29,602,15,1709,2.115.059.524
28/04/2015 18:00,26.35,44293,1007,39,33,562,15,1656,2.115.059.524
28/04/2015 19:00,26.29,44047,1023,40,41,503,15,1622,2.115.059.524
28/04/2015 20:00,26.38,43374,994,41,48,549,14,1646,2.115.059.524
28/04/2015 21:00,26.59,43301,1021,41,56,617,15,1750,2.115.059.524
28/04/2015 22:00,25.41,42044,1145,43,64,704,13,1969,2.115.059.524
28/04/2015 23:00,24.36,39887,1264,31,59,679,9,2042,2.115.059.524
29/04/2015 00:00,24.48,37891,1329,35,71,733,6,2174,2.115.059.524
29/04/2015 01:00,24.07,37009,1396,39,83,782,5,2305,2.115.059.524
29/04/2015 02:00,23.97,36868,1450,45,91,806,4,2396,2.115.059.524
29/04/2015 03:00,24.08,37032,1421,51,98,817,5,2392,2.115.059.524
29/04/2015 04:00,24.38,37669,1434,55,107,848,7,2451,2.115.059.524
29/04/2015 05:00,25.17,39660,1352,60,90,837,6,2345,2.115.059.524
29/04/2015 06:00,26.6,43120,1221,69,73,813,7,2183,2.115.059.524
29/04/2015 07:00,31.08,46709,1215,76,57,822,7,2177,2.115.059.524
29/04/2015 08:00,31.07,47729,1273,83,70,903,7,2336,2.115.059.524
29/04/2015 09:00,31.03,47514,1371,83,87,973,8,2522,2.115.059.524
29/04/2015 10:00,28.71,47330,1497,86,106,1116,14,2819,2.115.059.524
29/04/2015 11:00,27.79,46807,1575,95,127,1237,19,3053,2.115.059.524
29/04/2015 12:00,26.98,46216,1635,116,166,1411,23,3351,2.115.059.524
29/04/2015 13:00,26.55,45765,1660,135,168,1506,25,3494,2.115.059.524
29/04/2015 14:00,26.16,45350,1680,145,164,1546,22,3557,2.115.059.524
29/04/2015 15:00,26.26,44895,1678,149,154,1545,24,3550,2.115.059.524
29/04/2015 16:00,25.98,44581,1679,158,144,1520,24,3525,2.115.059.524
29/04/2015 17:00,26.14,44247,1638,167,130,1372,25,3332,2.115.059.524
29/04/2015 18:00,26.3,44041,1469,176,115,1161,26,2947,2.115.059.524
29/04/2015 19:00,26.46,43738,1317,174,101,1101,25,2718,2.115.059.524
29/04/2015 20:00,26.67,43462,1237,174,93,1122,20,2646,2.115.059.524
29/04/2015 21:00,26.38,43335,1295,171,86,1128,18,2698,2.115.059.524
29/04/2015 22:00,25.28,42057,1490,161,79,1169,17,2916,2.115.059.524
29/04/2015 23:00,24.35,40045,1700,178,49,1117,18,3062,2.115.059.524
30/04/2015 00:00,24.07,38378,1884,165,42,1145,11,3247,2.115.059.524
30/04/2015 01:00,23.73,37591,1721,142,35,1248,7,3153,2.115.059.524
30/04/2015 02:00,23.66,37238,1527,114,32,1323,5,3001,2.115.059.524
30/04/2015 03:00,23.8,37398,1320,87,30,1431,5,2873,2.115.059.524
30/04/2015 04:00,24.25,38159,1129,66,29,1490,5,2719,2.115.059.524
30/04/2015 05:00,25.21,39903,976,50,25,1468,4,2523,2.115.059.524
30/04/2015 06:00,26.72,43587,856,37,22,1462,4,2381,2.115.059.524
30/04/2015 07:00,31.94,47317,679,25,18,1444,4,2170,2.115.059.524
30/04/2015 08:00,38.44,48461,579,19,20,1465,4,2087,2.115.059.524
30/04/2015 09:00,33.22,48241,529,16,24,1516,4,2089,2.115.059.524
30/04/2015 10:00,30.44,48049,511,16,30,1608,6,2171,2.115.059.524
30/04/2015 11:00,29.45,47468,513,16,37,1651,7,2224,2.115.059.524
30/04/2015 12:00,28.6,46488,506,18,46,1682,6,2258,2.115.059.524
30/04/2015 13:00,28.01,45832,519,16,55,1653,5,2248,2.115.059.524
30/04/2015 14:00,27.17,45136,521,17,60,1635,5,2238,2.115.059.524
30/04/2015 15:00,26.62,44570,502,16,63,1630,5,2216,2.115.059.524
30/04/2015 16:00,26.59,44031,477,18,65,1534,4,2098,2.115.059.524
30/04/2015 17:00,26.59,43903,425,19,62,1492,3,2001,2.115.059.524
30/04/2015 18:00,26.37,43210,357,30,60,1457,3,1907,2.115.059.524
30/04/2015 19:00,26.89,42533,299,47,59,1407,3,1815,2.115.059.524
30/04/2015 20:00,26.58,42163,248,69,71,1308,3,1699,2.115.059.524
30/04/2015 21:00,26.79,42656,220,91,86,1206,6,1609,2.115.059.524
30/04/2015 22:00,25.9,41572,200,100,101,1120,9,1530,2.115.059.524
30/04/2015 23:00,25.23,39557,189,117,93,1161,6,1566,2.115.059.524
01/05/2015 00:00,24.77,37613,235,116,94,1039,6,1490,2.115.059.524
01/05/2015 01:00,24.21,36625,204,115,95,923,6,1343,2.115.059.524
01/05/2015 02:00,24.01,36045,171,115,90,855,7,1238,2.115.059.524
01/05/2015 03:00,23.75,35937,136,112,88,754,7,1097,2.115.059.524
01/05/2015 04:00,23.68,36025,117,108,85,666,7,983,2.115.059.524
01/05/2015 05:00,23.59,36004,101,103,81,585,8,878,2.115.059.524
01/05/2015 06:00,23.58,36332,80,96,76,515,8,775,2.115.059.524
01/05/2015 07:00,24.06,37310,74,92,70,471,9,716,2.115.059.524
01/05/2015 08:00,24.85,38788,81,89,67,452,10,699,2.115.059.524
01/05/2015 09:00,25.37,40023,90,89,66,544,13,802,2.115.059.524
01/05/2015 10:00,25.57,40634,108,87,67,574,14,850,2.115.059.524
01/05/2015 11:00,25.47,40727,137,86,75,515,16,829,2.115.059.524
01/05/2015 12:00,25.29,40047,170,84,85,567,15,921,2.115.059.524
01/05/2015 13:00,24.99,39678,211,78,96,640,15,1040,2.115.059.524
01/05/2015 14:00,24.71,39325,265,73,85,679,12,1114,2.115.059.524
01/05/2015 15:00,24.6,39086,329,65,73,735,10,1212,2.115.059.524
01/05/2015 16:00,24.53,39163,418,59,61,774,9,1321,2.115.059.524
01/05/2015 17:00,24.7,39623,475,60,49,773,6,1363,2.115.059.524
01/05/2015 18:00,24.98,39815,469,64,39,818,6,1396,2.115.059.524
01/05/2015 19:00,25.36,39768,464,72,33,895,5,1469,2.115.059.524
01/05/2015 20:00,25.67,39868,452,77,42,997,5,1573,2.115.059.524
01/05/2015 21:00,25.72,40729,436,78,54,1122,3,1693,2.115.059.524
01/05/2015 22:00,25.66,40494,465,70,68,1231,4,1838,2.115.059.524
01/05/2015 23:00,24.96,39011,556,73,48,1568,6,2251,2.115.059.524
02/05/2015 00:00,24.12,37476,581,63,55,1743,8,2450,2.115.059.524
02/05/2015 01:00,23.06,36430,730,54,62,1889,9,2744,2.115.059.524
02/05/2015 02:00,21.91,36016,887,50,68,2014,10,3029,2.115.059.524
02/05/2015 03:00,21.66,35904,1005,47,76,2103,11,3242,2.115.059.524
02/05/2015 04:00,21.52,35900,1113,51,84,2173,11,3432,2.115.059.524
02/05/2015 05:00,22.2,36305,1208,53,98,2213,10,3582,2.115.059.524
02/05/2015 06:00,23.23,36743,1270,62,110,2140,14,3596,2.115.059.524
02/05/2015 07:00,23.87,37914,1321,72,122,2084,12,3611,2.115.059.524
02/05/2015 08:00,24.75,39368,1410,86,134,2032,15,3677,2.115.059.524
02/05/2015 09:00,24.9,40900,1468,105,152,1971,18,3714,2.115.059.524
02/05/2015 10:00,24.9,41615,1456,122,166,1909,23,3676,2.115.059.524
02/05/2015 11:00,24.76,41378,1424,128,177,1875,27,3631,2.115.059.524
02/05/2015 12:00,24.42,40821,1375,124,181,1815,30,3525,2.115.059.524
02/05/2015 13:00,24.16,40226,1365,114,181,1763,31,3454,2.115.059.524
02/05/2015 14:00,24.03,39708,1371,101,179,1675,32,3358,2.115.059.524
02/05/2015 15:00,23.86,39423,1384,83,174,1610,29,3280,2.115.059.524
02/05/2015 16:00,24.26,39548,1383,62,164,1505,21,3135,2.115.059.524
02/05/2015 17:00,24.86,40136,1308,46,145,1368,20,2887,2.115.059.524
02/05/2015 18:00,25.14,40365,1158,39,124,1289,21,2631,2.115.059.524
02/05/2015 19:00,25.21,39907,947,40,105,1233,18,2343,2.115.059.524
02/05/2015 20:00,25.72,39491,709,41,93,1191,12,2046,2.115.059.524
02/05/2015 21:00,26.03,39617,514,42,83,1161,9,1809,2.115.059.524
02/05/2015 22:00,25.6,39259,407,48,72,1180,7,1714,2.115.059.524
02/05/2015 23:00,25.21,37847,343,36,57,1119,3,1558,2.115.059.524
03/05/2015 00:00,24.51,36579,88,38,48,1134,4,1312,2.115.059.524
03/05/2015 01:00,24.05,35737,60,39,39,1144,3,1285,2.115.059.524
03/05/2015 02:00,23.7,35381,40,38,31,1085,2,1196,2.115.059.524
03/05/2015 03:00,23.4,35251,28,38,25,1049,2,1142,2.115.059.524
03/05/2015 04:00,23.34,35258,34,40,21,989,1,1085,2.115.059.524
03/05/2015 05:00,23.12,35325,51,41,17,876,1,986,2.115.059.524
03/05/2015 06:00,22.04,35671,89,43,13,712,1,858,2.115.059.524
03/05/2015 07:00,23.6,36556,167,44,9,585,1,806,2.115.059.524
03/05/2015 08:00,24.23,37929,290,47,10,514,1,862,2.115.059.524
03/05/2015 09:00,24.65,39106,450,46,13,454,3,966,2.115.059.524
03/05/2015 10:00,24.82,39785,638,48,17,482,3,1188,2.115.059.524
03/05/2015 11:00,24.71,39760,839,51,21,531,3,1445,2.115.059.524
03/05/2015 12:00,24.48,39436,1119,53,27,564,4,1767,2.115.059.524
03/05/2015 13:00,24.14,38986,1511,51,31,569,4,2166,2.115.059.524
03/05/2015 14:00,23.96,38690,1937,50,30,613,4,2634,2.115.059.524
03/05/2015 15:00,23.83,38555,2354,48,28,687,2,3119,2.115.059.524
03/05/2015 16:00,23.68,38664,2770,42,24,690,3,3529,2.115.059.524
03/05/2015 17:00,23.77,39097,3057,33,16,754,0,3860,2.115.059.524
03/05/2015 18:00,23.92,39519,3222,28,10,852,2,4114,2.115.059.524
03/05/2015 19:00,24.02,39681,3378,30,6,954,2,4370,2.115.059.524
03/05/2015 20:00,24.12,39850,3491,34,8,1119,2,4654,2.115.059.524
03/05/2015 21:00,24.25,40343,3581,38,11,1328,0,4958,2.115.059.524
03/05/2015 22:00,24.1,39785,3699,38,14,1455,0,5206,2.115.059.524
03/05/2015 23:00,23.44,38100,3615,26,16,1588,0,5245,2.115.059.524
04/05/2015 00:00,23.22,36742,3685,22,25,1638,0,5370,2.263.988.095
04/05/2015 01:00,23,36035,3501,18,39,1701,1,5260,2.263.988.095
04/05/2015 02:00,22.85,35866,3065,16,46,1785,1,4913,2.263.988.095
04/05/2015 03:00,22.59,36119,2530,13,56,1891,2,4492,2.263.988.095
04/05/2015 04:00,23.03,36781,2216,10,67,1957,4,4254,2.263.988.095
04/05/2015 05:00,23.91,38642,1972,6,68,1900,4,3950,2.263.988.095
04/05/2015 06:00,25.96,42192,1736,4,68,1836,5,3649,2.263.988.095
04/05/2015 07:00,28.53,45791,1660,5,67,1776,7,3515,2.263.988.095
04/05/2015 08:00,31.44,47193,1653,6,74,1745,9,3487,2.263.988.095
04/05/2015 09:00,30.09,47984,1629,8,83,1769,13,3502,2.263.988.095
04/05/2015 10:00,29.18,47694,1641,10,93,1766,15,3525,2.263.988.095
04/05/2015 11:00,28.82,47145,1710,13,103,1767,15,3608,2.263.988.095
04/05/2015 12:00,28.43,46376,1849,17,113,1741,16,3736,2.263.988.095
04/05/2015 13:00,28.13,45955,2012,18,122,1758,15,3925,2.263.988.095
04/05/2015 14:00,28,45534,2039,19,123,1754,13,3948,2.263.988.095
04/05/2015 15:00,27.67,44855,1909,20,120,1741,9,3799,2.263.988.095
04/05/2015 16:00,27.6,44433,1790,23,115,1733,7,3668,2.263.988.095
04/05/2015 17:00,28.06,44356,1627,31,98,1721,6,3483,2.263.988.095
04/05/2015 18:00,28.62,44132,1372,41,81,1639,9,3142,2.263.988.095
04/05/2015 19:00,29.46,43907,1066,50,66,1635,10,2827,2.263.988.095
04/05/2015 20:00,30.54,43430,736,61,55,1605,10,2467,2.263.988.095
04/05/2015 21:00,30.78,43012,476,73,46,1495,7,2097,2.263.988.095
04/05/2015 22:00,28.03,41724,327,76,39,1433,8,1883,2.263.988.095
04/05/2015 23:00,26.46,39273,231,86,32,1292,6,1647,2.263.988.095
05/05/2015 00:00,24.84,37308,212,86,28,1182,4,1512,2.263.988.095
05/05/2015 01:00,24.08,36276,311,85,24,1120,3,1543,2.263.988.095
05/05/2015 02:00,24.06,35882,485,83,19,1061,3,1651,2.263.988.095
05/05/2015 03:00,23.97,35891,735,78,16,976,3,1808,2.263.988.095
05/05/2015 04:00,23.93,36362,1062,69,14,974,3,2122,2.263.988.095
05/05/2015 05:00,24.39,38117,1459,60,11,971,2,2503,2.263.988.095
05/05/2015 06:00,25.57,41573,1908,53,8,962,3,2934,2.263.988.095
05/05/2015 07:00,29.07,45044,2441,44,5,951,2,3443,2.263.988.095
05/05/2015 08:00,29.95,47244,2937,42,4,1025,3,4011,2.263.988.095
05/05/2015 09:00,28.77,47051,3350,41,5,1147,3,4546,2.263.988.095
05/05/2015 10:00,28.16,46766,3639,40,6,1336,3,5024,2.263.988.095
05/05/2015 11:00,27.66,46208,3753,39,10,1496,3,5301,2.263.988.095
05/05/2015 12:00,27.1,45674,3715,37,15,1667,3,5437,2.263.988.095
05/05/2015 13:00,26.78,45212,3600,33,21,1881,2,5537,2.263.988.095
05/05/2015 14:00,25.34,44740,3390,29,26,2140,2,5587,2.263.988.095
05/05/2015 15:00,24.98,44286,3201,25,29,2348,3,5606,2.263.988.095
05/05/2015 16:00,24.94,43847,3123,24,30,2488,3,5668,2.263.988.095
05/05/2015 17:00,25.04,43618,3026,25,40,2579,3,5673,2.263.988.095
05/05/2015 18:00,25.47,43345,2975,28,55,2613,3,5674,2.263.988.095
05/05/2015 19:00,25.48,42962,3088,34,77,2674,5,5878,2.263.988.095
05/05/2015 20:00,25.23,42526,3241,46,92,2707,6,6092,2.263.988.095
05/05/2015 21:00,25.19,42305,3368,58,108,2737,8,6279,2.263.988.095
05/05/2015 22:00,24.6,40925,3475,69,123,2760,10,6437,2.263.988.095
05/05/2015 23:00,23.68,38337,3365,109,134,2889,15,6512,2.263.988.095
06/05/2015 00:00,22.61,35908,3135,119,139,2927,18,6338,2.263.988.095
06/05/2015 01:00,21.92,34803,2855,128,144,2963,25,6115,2.263.988.095
06/05/2015 02:00,20.65,34428,2568,138,138,2890,33,5767,2.263.988.095
06/05/2015 03:00,19.94,34387,2292,146,132,2834,38,5442,2.263.988.095
06/05/2015 04:00,20.13,34801,2106,151,126,2742,39,5164,2.263.988.095
06/05/2015 05:00,23.07,36474,2038,153,101,2578,37,4907,2.263.988.095
06/05/2015 06:00,24.75,39959,2030,151,74,2399,37,4691,2.263.988.095
06/05/2015 07:00,26.18,43766,2061,158,48,2343,31,4641,2.263.988.095
06/05/2015 08:00,27.07,45023,2185,168,31,2352,23,4759,2.263.988.095
06/05/2015 09:00,26.97,44921,2353,178,19,2300,14,4864,2.263.988.095
06/05/2015 10:00,26.63,44790,2500,186,14,2249,11,4960,2.263.988.095
06/05/2015 11:00,26.25,44308,2597,188,18,2273,10,5086,2.263.988.095
06/05/2015 12:00,24.87,43787,2602,179,25,2288,10,5104,2.263.988.095
06/05/2015 13:00,24.61,43405,2540,172,34,2177,8,4931,2.263.988.095
06/05/2015 14:00,24.47,42997,2476,160,42,2086,9,4773,2.263.988.095
06/05/2015 15:00,24.29,42503,2403,141,52,2011,7,4614,2.263.988.095
06/05/2015 16:00,24.23,42265,2305,117,61,1912,5,4400,2.263.988.095
06/05/2015 17:00,24.6,42113,2122,97,54,1744,2,4019,2.263.988.095
06/05/2015 18:00,25.47,41914,1875,83,48,1570,2,3578,2.263.988.095
06/05/2015 19:00,25.62,41579,1709,73,42,1520,2,3346,2.263.988.095
06/05/2015 20:00,25.5,41230,1642,69,42,1510,2,3265,2.263.988.095
06/05/2015 21:00,25.9,40980,1715,66,42,1528,2,3353,2.263.988.095
06/05/2015 22:00,24.85,39801,1905,62,43,1617,2,3629,2.263.988.095
06/05/2015 23:00,23.02,37490,2259,35,13,1732,2,4041,2.263.988.095
07/05/2015 00:00,20.78,35471,2691,35,15,1738,2,4481,2.263.988.095
07/05/2015 01:00,18.32,34552,3069,32,16,1739,2,4858,2.263.988.095
07/05/2015 02:00,16.74,34253,3315,30,12,1681,2,5040,2.263.988.095
07/05/2015 03:00,16.39,34265,3401,29,10,1641,2,5083,2.263.988.095
07/05/2015 04:00,17.81,34706,3446,28,9,1616,2,5101,2.263.988.095
07/05/2015 05:00,21.04,36357,3435,29,7,1614,2,5087,2.263.988.095
07/05/2015 06:00,23.79,39675,3383,31,6,1578,2,5000,2.263.988.095
07/05/2015 07:00,26.08,43274,3346,31,4,1597,2,4980,2.263.988.095
07/05/2015 08:00,27.25,44637,3345,32,5,1723,3,5108,2.263.988.095
07/05/2015 09:00,26.79,44697,3380,34,8,1864,4,5290,2.263.988.095
07/05/2015 10:00,25.58,44639,3430,38,14,2019,5,5506,2.263.988.095
07/05/2015 11:00,25.16,44426,3430,40,22,2171,7,5670,2.263.988.095
07/05/2015 12:00,24.57,43995,3413,40,33,2269,8,5763,2.263.988.095
07/05/2015 13:00,24.44,43599,3346,38,45,2410,8,5847,2.263.988.095
07/05/2015 14:00,23.91,43305,3271,34,49,2504,9,5867,2.263.988.095
07/05/2015 15:00,24.09,42778,3225,34,51,2520,8,5838,2.263.988.095
07/05/2015 16:00,24.25,42471,3168,37,52,2544,8,5809,2.263.988.095
07/05/2015 17:00,24.65,42372,3004,38,40,2498,8,5588,2.263.988.095
07/05/2015 18:00,24.81,42124,2745,42,30,2386,6,5209,2.263.988.095
07/05/2015 19:00,25.1,41807,2452,47,23,2304,6,4832,2.263.988.095
07/05/2015 20:00,25.3,41454,2176,53,27,2271,6,4533,2.263.988.095
07/05/2015 21:00,25.87,41314,1928,55,32,2247,6,4268,2.263.988.095
07/05/2015 22:00,25.13,40099,1732,54,39,2198,6,4029,2.263.988.095
07/05/2015 23:00,23.91,37841,1621,46,40,2215,7,3929,2.263.988.095
08/05/2015 00:00,22.04,36367.96,1326,44,48,2071,7,3496,2.263.988.095
08/05/2015 01:00,21.56,35740.92,1339,39,56,2085,7,3526,2.263.988.095
08/05/2015 02:00,21.45,35499.88,1253,36,51,2096,6,3442,2.263.988.095
08/05/2015 03:00,21.62,35558.84,1116,33,47,2049,7,3252,2.263.988.095
08/05/2015 04:00,22.02,35970.8,979,30,44,2006,10,3069,2.263.988.095
08/05/2015 05:00,23.1,37212.76,857,28,45,1936,10,2876,2.263.988.095
08/05/2015 06:00,25.28,39264.72,751,25,45,1916,13,2750,2.263.988.095
08/05/2015 07:00,26.79,41331.68,638,26,44,1953,15,2676,2.263.988.095
08/05/2015 08:00,27.89,42121.64,601,32,49,1968,16,2666,2.263.988.095
08/05/2015 09:00,27.69,42128.6,597,40,56,1989,16,2698,2.263.988.095
08/05/2015 10:00,27.1,42002.56,577,54,64,2039,19,2753,2.263.988.095
08/05/2015 11:00,26.71,41627.52,548,66,70,2156,24,2864,2.263.988.095
08/05/2015 12:00,26.37,41047.48,510,75,76,2201,26,2888,2.263.988.095
08/05/2015 13:00,25.57,40413.44,504,76,81,2260,23,2944,2.263.988.095
08/05/2015 14:00,24.27,39930.4,503,74,75,2286,22,2960,2.263.988.095
08/05/2015 15:00,24.01,39432.36,489,71,67,2268,21,2916,2.263.988.095
08/05/2015 16:00,24.06,39236.32,441,63,58,2267,19,2848,2.263.988.095
08/05/2015 17:00,24.45,39354.28,381,56,43,2206,13,2699,2.263.988.095
08/05/2015 18:00,25,39275.24,345,53,31,2082,13,2524,2.263.988.095
08/05/2015 19:00,25.07,38902.2,311,64,23,1981,12,2391,2.263.988.095
08/05/2015 20:00,24.8,38284.16,282,78,21,1936,10,2327,2.263.988.095
08/05/2015 21:00,24.52,38242.12,292,94,20,1875,10,2291,2.263.988.095
08/05/2015 22:00,23.87,37787.08,330,100,18,1767,7,2222,2.263.988.095
08/05/2015 23:00,22.94,36704.04,345,119,14,1759,4,2241,2.263.988.095
09/05/2015 00:00,21.53,35938,435,113,13,1659,4,2224,2.263.988.095
09/05/2015 01:00,21.02,34918,493,106,12,1622,3,2236,2.263.988.095
09/05/2015 02:00,19.57,34481,578,103,10,1582,2,2275,2.263.988.095
09/05/2015 03:00,17.39,34367,688,100,8,1559,1,2356,2.263.988.095
09/05/2015 04:00,17.53,34321,845,98,8,1545,1,2497,2.263.988.095
09/05/2015 05:00,17.21,34556,1057,93,6,1531,1,2688,2.263.988.095
09/05/2015 06:00,17.92,34894,1311,88,4,1430,1,2834,2.263.988.095
09/05/2015 07:00,19.62,36252,1591,82,2,1465,1,3141,2.263.988.095
09/05/2015 08:00,21.27,37926,1868,82,2,1496,1,3449,2.263.988.095
09/05/2015 09:00,21.31,39115,2115,81,3,1554,4,3757,2.263.988.095
09/05/2015 10:00,20.74,39696,2357,80,4,1555,4,4000,2.263.988.095
09/05/2015 11:00,20.45,39507,2390,75,7,1613,4,4089,2.263.988.095
09/05/2015 12:00,20.02,39053,2311,70,11,1661,3,4056,2.263.988.095
09/05/2015 13:00,19.63,38642,2302,60,14,1662,3,4041,2.263.988.095
09/05/2015 14:00,19.87,38403,2184,46,16,1602,3,3851,2.263.988.095
09/05/2015 15:00,19.99,38233,2038,34,16,1551,0,3639,2.263.988.095
09/05/2015 16:00,20.67,38412,2028,25,13,1479,2,3547,2.263.988.095
09/05/2015 17:00,21.11,39006,1966,18,14,1395,0,3393,2.263.988.095
09/05/2015 18:00,21.23,39251,1879,14,17,1363,2,3275,2.263.988.095
09/05/2015 19:00,21.1,38761,1889,13,24,1278,3,3207,2.263.988.095
09/05/2015 20:00,21.16,38212,1779,12,33,1332,4,3160,2.263.988.095
09/05/2015 21:00,21.22,38432,1571,13,45,1349,3,2981,2.263.988.095
09/05/2015 22:00,21.21,37962,1447,15,60,1335,4,2861,2.263.988.095
09/05/2015 23:00,20.2,36579,1322,11,70,1306,3,2712,2.263.988.095
10/05/2015 00:00,17.96,35846,1483,14,78,1190,5,2770,2.263.988.095
10/05/2015 01:00,13.93,35005,1548,23,86,1093,6,2756,2.263.988.095
10/05/2015 02:00,14.85,34591,1640,36,82,994,7,2759,2.263.988.095
10/05/2015 03:00,14.5,34380,1903,53,80,994,8,3038,2.263.988.095
10/05/2015 04:00,12.79,34216,2294,60,78,977,9,3418,2.263.988.095
10/05/2015 05:00,10.84,34237,2608,54,64,883,8,3617,2.263.988.095
10/05/2015 06:00,12,34608,2883,46,50,798,6,3783,2.263.988.095
10/05/2015 07:00,14.71,35592,3292,42,38,762,7,4141,2.263.988.095
10/05/2015 08:00,17.91,37042,3561,44,32,746,8,4391,2.263.988.095
10/05/2015 09:00,19.26,38351,3705,48,28,824,9,4614,2.263.988.095
10/05/2015 10:00,20.33,39225,3747,55,27,930,9,4768,2.263.988.095
10/05/2015 11:00,20.33,39428,3653,62,26,1123,7,4871,2.263.988.095
10/05/2015 12:00,20.1,39057,3468,66,27,1299,6,4866,2.263.988.095
10/05/2015 13:00,19.72,38474,3322,56,30,1440,6,4854,2.263.988.095
10/05/2015 14:00,19.62,38055,3171,55,30,1583,6,4845,2.263.988.095
10/05/2015 15:00,19.16,37908,2968,44,28,1693,3,4736,2.263.988.095
10/05/2015 16:00,19.71,37970,2741,40,26,1740,6,4553,2.263.988.095
10/05/2015 17:00,20.98,38285,2431,35,23,1678,3,4170,2.263.988.095
10/05/2015 18:00,21.71,38579,2030,30,22,1634,4,3720,2.263.988.095
10/05/2015 19:00,23.51,38640,1652,32,21,1511,4,3220,2.263.988.095
10/05/2015 20:00,24.45,38570,1313,33,23,1473,4,2846,2.263.988.095
10/05/2015 21:00,25.32,39050,1040,37,25,1369,3,2474,2.263.988.095
10/05/2015 22:00,24.58,38577,869,39,27,1321,4,2260,2.263.988.095
10/05/2015 23:00,23.26,36891,734,37,22,1155,3,1951,2.263.988.095
11/05/2015 00:00,22.04,35442,739,32,20,1191,2,1984,2.534.464.286
11/05/2015 01:00,20.33,34682,835,27,19,1122,2,2005,2.534.464.286
11/05/2015 02:00,19.46,34480,981,25,24,1058,3,2091,2.534.464.286
11/05/2015 03:00,19.36,34564,1178,25,31,962,3,2199,2.534.464.286
11/05/2015 04:00,19.75,35162,1433,27,39,868,4,2371,2.534.464.286
11/05/2015 05:00,21.43,36970,1687,29,44,772,5,2537,2.534.464.286
11/05/2015 06:00,23.79,40638,1970,31,47,700,7,2755,2.534.464.286
11/05/2015 07:00,26.29,44287,2283,34,50,732,6,3105,2.534.464.286
11/05/2015 08:00,26.61,46705,2526,37,44,949,7,3563,2.534.464.286
11/05/2015 09:00,26.39,46320,2685,37,40,1355,6,4123,2.534.464.286
11/05/2015 10:00,26.08,45805,2768,37,39,1787,6,4637,2.534.464.286
11/05/2015 11:00,25.68,45245,2799,36,39,2225,6,5105,2.534.464.286
11/05/2015 12:00,24.72,44622,2832,35,41,2556,6,5470,2.534.464.286
11/05/2015 13:00,23.91,44126,2897,35,43,2774,6,5755,2.534.464.286
11/05/2015 14:00,23.57,43727,2965,39,42,2970,6,6022,2.534.464.286
11/05/2015 15:00,23.22,43080,2993,37,38,3093,7,6168,2.534.464.286
11/05/2015 16:00,22.99,42647,2998,33,33,3119,6,6189,2.534.464.286
11/05/2015 17:00,22.97,42468,2983,27,24,3129,5,6168,2.534.464.286
11/05/2015 18:00,23.22,42226,2891,22,17,3111,4,6045,2.534.464.286
11/05/2015 19:00,23.24,41996,2659,25,12,3125,4,5825,2.534.464.286
11/05/2015 20:00,23.09,41578,2301,33,12,3132,4,5482,2.534.464.286
11/05/2015 21:00,23.27,41485,1962,48,12,3156,4,5182,2.534.464.286
11/05/2015 22:00,22.52,40382,1718,58,13,3140,4,4933,2.534.464.286
11/05/2015 23:00,21.28,37924,1558,100,14,3139,7,4818,2.534.464.286
12/05/2015 00:00,20.22,35802,1263,116,24,2989,7,4399,2.534.464.286
12/05/2015 01:00,19.57,34793,993,127,39,2763,7,3929,2.534.464.286
12/05/2015 02:00,19.34,34352,779,138,47,2565,7,3536,2.534.464.286
12/05/2015 03:00,19.09,34305,659,145,57,2314,10,3185,2.534.464.286
12/05/2015 04:00,20.07,34642,642,148,67,2037,14,2908,2.534.464.286
12/05/2015 05:00,21.71,36387,645,150,62,1825,13,2695,2.534.464.286
12/05/2015 06:00,23.95,39989,662,153,57,1620,16,2508,2.534.464.286
12/05/2015 07:00,26.15,43753,698,156,52,1457,17,2380,2.534.464.286
12/05/2015 08:00,26.67,44893,704,163,60,1359,19,2305,2.534.464.286
12/05/2015 09:00,26.25,45330,702,172,70,1322,24,2290,2.534.464.286
12/05/2015 10:00,26.13,44972,734,181,82,1326,25,2348,2.534.464.286
12/05/2015 11:00,25.44,44379,827,187,96,1333,28,2471,2.534.464.286
12/05/2015 12:00,25.83,43670,1001,188,110,1400,31,2730,2.534.464.286
12/05/2015 13:00,25.18,43358,1266,183,124,1406,32,3011,2.534.464.286
12/05/2015 14:00,24.44,43018,1497,172,130,1385,33,3217,2.534.464.286
12/05/2015 15:00,23.91,42662,1765,159,133,1392,33,3482,2.534.464.286
12/05/2015 16:00,23.7,42351,2127,142,135,1431,31,3866,2.534.464.286
12/05/2015 17:00,23.68,42248,2447,126,138,1530,28,4269,2.534.464.286
12/05/2015 18:00,23.61,42042,2720,119,142,1631,25,4637,2.534.464.286
12/05/2015 19:00,23.25,41627,2855,122,146,1736,26,4885,2.534.464.286
12/05/2015 20:00,22.92,41009,2824,134,147,1865,27,4997,2.534.464.286
12/05/2015 21:00,22.97,40816,2736,150,149,1977,30,5042,2.534.464.286
12/05/2015 22:00,22.24,39616,2718,164,150,2151,30,5213,2.534.464.286
12/05/2015 23:00,21.32,37242,2748,191,170,2449,37,5595,2.534.464.286
13/05/2015 00:00,18.49,35439,2852,192,151,2539,40,5774,2.534.464.286
13/05/2015 01:00,15.48,34539,2885,186,141,2611,23,5846,2.534.464.286
13/05/2015 02:00,12.87,34296,2911,173,144,2727,19,5974,2.534.464.286
13/05/2015 03:00,12.52,34247,2881,168,148,2824,26,6047,2.534.464.286
13/05/2015 04:00,12.88,34608,2854,174,154,2910,30,6122,2.534.464.286
13/05/2015 05:00,17.85,36305,2901,180,161,2942,32,6216,2.534.464.286
13/05/2015 06:00,21.79,39688,3017,186,166,2958,40,6367,2.534.464.286
13/05/2015 07:00,23.28,43420,3172,189,171,3013,41,6586,2.534.464.286
13/05/2015 08:00,23.81,44162,3349,189,175,3091,44,6848,2.534.464.286
13/05/2015 09:00,23.67,44440,3540,189,182,3184,47,7142,2.534.464.286
13/05/2015 10:00,23.47,44347,3694,195,187,3207,45,7328,2.534.464.286
13/05/2015 11:00,23.16,44063,3755,205,187,3246,46,7439,2.534.464.286
13/05/2015 12:00,22.69,43628,3831,214,189,3243,48,7525,2.534.464.286
13/05/2015 13:00,22.54,43346,3912,217,192,3268,46,7635,2.534.464.286
13/05/2015 14:00,22.32,43086,3944,218,192,3227,45,7626,2.534.464.286
13/05/2015 15:00,22.25,42570,3941,217,185,3125,45,7513,2.534.464.286
13/05/2015 16:00,22.12,42256,3860,216,170,3073,42,7361,2.534.464.286
13/05/2015 17:00,22.2,42055,3745,208,156,3017,36,7162,2.534.464.286
13/05/2015 18:00,22,41768,3598,200,139,2923,31,6891,2.534.464.286
13/05/2015 19:00,22.01,41278,3385,194,122,2839,25,6565,2.534.464.286
13/05/2015 20:00,21.91,40633,3064,189,116,2794,21,6184,2.534.464.286
13/05/2015 21:00,22.08,40271,2692,184,110,2780,19,5785,2.534.464.286
13/05/2015 22:00,21.68,39153,2409,170,105,2753,17,5454,2.534.464.286
13/05/2015 23:00,21.06,36996,2171,151,106,2811,17,5256,2.534.464.286
14/05/2015 00:00,17.74,35888,1744,144,101,2831,13,4833,2.534.464.286
14/05/2015 01:00,16.11,34779,1551,135,95,2859,12,4652,2.534.464.286
14/05/2015 02:00,14.53,34141,1384,122,88,2905,10,4509,2.534.464.286
14/05/2015 03:00,14.08,33796,1225,113,80,2907,9,4334,2.534.464.286
14/05/2015 04:00,13.49,33510,1102,104,73,2889,8,4176,2.534.464.286
14/05/2015 05:00,12.71,33737,1018,95,64,2827,5,4009,2.534.464.286
14/05/2015 06:00,16.57,34542,945,85,54,2746,7,3837,2.534.464.286
14/05/2015 07:00,18.78,35806,880,79,44,2640,7,3650,2.534.464.286
14/05/2015 08:00,19.33,37425,801,74,38,2546,6,3465,2.534.464.286
14/05/2015 09:00,19.98,38873,705,71,34,2471,6,3287,2.534.464.286
14/05/2015 10:00,20.45,39868,621,69,32,2431,7,3160,2.534.464.286
14/05/2015 11:00,20.83,40082,564,71,35,2464,8,3142,2.534.464.286
14/05/2015 12:00,20.01,39930,558,79,39,2512,9,3197,2.534.464.286
14/05/2015 13:00,19.49,39589,573,84,44,2542,9,3252,2.534.464.286
14/05/2015 14:00,18.86,39383,587,83,46,2612,9,3337,2.534.464.286
14/05/2015 15:00,18.54,39075,613,81,46,2632,7,3379,2.534.464.286
14/05/2015 16:00,18.84,39189,633,77,45,2616,8,3379,2.534.464.286
14/05/2015 17:00,19.93,39519,615,67,37,2601,7,3327,2.534.464.286
14/05/2015 18:00,21.84,39731,563,59,31,2529,6,3188,2.534.464.286
14/05/2015 19:00,22.23,39515,488,55,26,2470,4,3043,2.534.464.286
14/05/2015 20:00,22.39,39289,402,56,24,2521,3,3006,2.534.464.286
14/05/2015 21:00,22.52,39359,332,57,23,2582,3,2997,2.534.464.286
14/05/2015 22:00,22.34,39049,302,57,21,2680,2,3062,2.534.464.286
14/05/2015 23:00,21.61,37584,289,64,19,2759,2,3133,2.534.464.286
15/05/2015 00:00,20.58,36033,284,63,16,2802,2,3167,2.534.464.286
15/05/2015 01:00,19.13,35028,292,63,14,2799,2,3170,2.534.464.286
15/05/2015 02:00,18.51,34585,329,61,11,2819,2,3222,2.534.464.286
15/05/2015 03:00,18.4,34490,373,59,9,2813,3,3257,2.534.464.286
15/05/2015 04:00,18.77,34586,407,48,8,2787,3,3253,2.534.464.286
15/05/2015 05:00,20.37,35651,396,36,6,2751,3,3192,2.534.464.286
15/05/2015 06:00,22.41,38453,345,26,5,2649,5,3030,2.534.464.286
15/05/2015 07:00,22.76,41110,280,22,3,2592,6,2903,2.534.464.286
15/05/2015 08:00,23.09,42792,222,24,6,2495,6,2753,2.534.464.286
15/05/2015 09:00,23.33,44204,186,29,14,2400,8,2637,2.534.464.286
15/05/2015 10:00,23.38,44182,161,34,31,2331,13,2570,2.534.464.286
15/05/2015 11:00,23.21,43653,164,35,53,2299,14,2565,2.534.464.286
15/05/2015 12:00,23,42817,198,40,81,2177,16,2512,2.534.464.286
15/05/2015 13:00,22.9,42166,243,46,113,2054,20,2476,2.534.464.286
15/05/2015 14:00,22.74,41693,281,50,119,1878,21,2349,2.534.464.286
15/05/2015 15:00,22.66,41057,325,54,123,1671,21,2194,2.534.464.286
15/05/2015 16:00,22.64,40718,381,56,121,1427,21,2006,2.534.464.286
15/05/2015 17:00,22.79,40652,409,53,105,1144,21,1732,2.534.464.286
15/05/2015 18:00,22.91,40549,404,49,86,933,21,1493,2.534.464.286
15/05/2015 19:00,22.84,40038,393,49,69,671,20,1202,2.534.464.286
15/05/2015 20:00,22.9,39092,363,50,65,568,19,1065,2.534.464.286
15/05/2015 21:00,22.91,38906,385,54,62,502,18,1021,2.534.464.286
15/05/2015 22:00,22.75,38510,477,59,60,493,17,1106,2.534.464.286
15/05/2015 23:00,22.3,37210,537,32,47,547,16,1179,2.534.464.286
16/05/2015 00:00,21.54,36312,684,33,45,536,15,1313,2.534.464.286
16/05/2015 01:00,21.3,35345,716,34,43,525,16,1334,2.534.464.286
16/05/2015 02:00,21.25,34907,748,36,42,522,15,1363,2.534.464.286
16/05/2015 03:00,20.64,34733,783,33,41,519,14,1390,2.534.464.286
16/05/2015 04:00,20.53,34564,822,31,41,511,15,1420,2.534.464.286
16/05/2015 05:00,20.57,34735,891,29,34,483,11,1448,2.534.464.286
16/05/2015 06:00,20.44,35627,986,27,28,461,11,1513,2.534.464.286
16/05/2015 07:00,21.19,36942,1119,28,23,452,9,1631,2.534.464.286
16/05/2015 08:00,21.55,38664,1269,30,28,513,10,1850,2.534.464.286
16/05/2015 09:00,21.67,39979,1407,33,36,587,9,2072,2.534.464.286
16/05/2015 10:00,21.42,40332,1555,37,48,647,9,2296,2.534.464.286
16/05/2015 11:00,21.29,39959,1678,40,50,749,8,2525,2.534.464.286
16/05/2015 12:00,20.29,39651,1801,42,52,877,7,2779,2.534.464.286
16/05/2015 13:00,19.29,39214,2007,44,55,1017,4,3127,2.534.464.286
16/05/2015 14:00,17.82,38793,2144,44,50,1153,4,3395,2.534.464.286
16/05/2015 15:00,17.09,38774,2265,46,43,1216,4,3574,2.534.464.286
16/05/2015 16:00,16.95,38883,2597,44,35,1285,5,3966,2.534.464.286
16/05/2015 17:00,17.96,39450,2947,39,26,1328,5,4345,2.534.464.286
16/05/2015 18:00,20.24,39605,3166,37,18,1369,4,4594,2.534.464.286
16/05/2015 19:00,20.93,39191,3325,37,13,1441,1,4817,2.534.464.286
16/05/2015 20:00,20.06,38539,3366,37,16,1570,3,4992,2.534.464.286
16/05/2015 21:00,20.06,38366,3287,36,20,1697,5,5045,2.534.464.286
16/05/2015 22:00,18.95,37985,3156,33,26,1857,4,5076,2.534.464.286
16/05/2015 23:00,17.05,36570,3097,30,34,2037,5,5203,2.534.464.286
17/05/2015 00:00,15.69,35661,3228,24,38,2149,5,5444,2.534.464.286
17/05/2015 01:00,12.75,34748,3228,20,44,2276,5,5573,2.534.464.286
17/05/2015 02:00,10.09,34364,3227,18,50,2356,6,5657,2.534.464.286
17/05/2015 03:00,8.98,34075,3190,16,57,2420,5,5688,2.534.464.286
17/05/2015 04:00,7.72,33831,3118,13,64,2471,7,5673,2.534.464.286
17/05/2015 05:00,5.33,33815,3065,10,89,2516,6,5686,2.534.464.286
17/05/2015 06:00,5.42,34257,3088,8,125,2593,11,5825,2.534.464.286
17/05/2015 07:00,12.2,35217,3237,9,160,2627,16,6049,2.534.464.286
17/05/2015 08:00,14.34,36627,3453,10,177,2677,23,6340,2.534.464.286
17/05/2015 09:00,16.51,37921,3612,13,187,2717,28,6557,2.534.464.286
17/05/2015 10:00,17.04,38866,3751,16,198,2713,34,6712,2.534.464.286
17/05/2015 11:00,16.15,39193,3845,22,204,2681,41,6793,2.534.464.286
17/05/2015 12:00,13.1,39086,3875,24,209,2635,41,6784,2.534.464.286
17/05/2015 13:00,11.35,38850,3886,28,213,2592,42,6761,2.534.464.286
17/05/2015 14:00,10.32,38598,3879,29,215,2522,44,6689,2.534.464.286
17/05/2015 15:00,11.2,38450,3845,29,215,2430,44,6563,2.534.464.286
17/05/2015 16:00,13.33,38590,3803,28,215,2303,41,6390,2.534.464.286
17/05/2015 17:00,14.72,38940,3697,24,215,2120,36,6092,2.534.464.286
17/05/2015 18:00,17.99,39245,3617,20,211,1922,29,5799,2.534.464.286
17/05/2015 19:00,21.04,39244,3486,17,205,1775,22,5505,2.534.464.286
17/05/2015 20:00,21.06,39148,3269,15,211,1665,21,5181,2.534.464.286
17/05/2015 21:00,21.39,39312,3018,16,215,1598,26,4873,2.534.464.286
17/05/2015 22:00,21.29,38857,2790,16,211,1521,30,4568,2.534.464.286
17/05/2015 23:00,20.41,37253,2572,24,40,1495,20,4151,2.534.464.286
18/05/2015 00:00,18.95,35316,2205,20,40,1438,23,3726,2.699.761.905
18/05/2015 01:00,18.74,34565,1994,17,40,1377,24,3452,2.699.761.905
18/05/2015 02:00,18.57,34306,1758,16,40,1350,23,3187,2.699.761.905
18/05/2015 03:00,18.56,34356,1519,13,40,1263,26,2861,2.699.761.905
18/05/2015 04:00,18.41,34739,1291,14,40,1189,26,2560,2.699.761.905
18/05/2015 05:00,21.49,36231,1057,12,40,1045,28,2182,2.699.761.905
18/05/2015 06:00,24.76,39778,813,11,40,939,30,1833,2.699.761.905
18/05/2015 07:00,31.59,43570,651,10,40,844,30,1575,2.699.761.905
18/05/2015 08:00,39.52,45440,558,12,40,751,31,1392,2.699.761.905
18/05/2015 09:00,36.32,45376,533,13,40,627,32,1245,2.699.761.905
18/05/2015 10:00,34.34,45243,635,16,40,534,35,1260,2.699.761.905
18/05/2015 11:00,33.96,44985,828,21,40,470,35,1394,2.699.761.905
18/05/2015 12:00,31.16,44532,1019,26,40,429,34,1548,2.699.761.905
18/05/2015 13:00,28.86,44131,1260,32,40,371,32,1735,2.699.761.905
18/05/2015 14:00,27.32,43630,1451,41,40,357,30,1919,2.699.761.905
18/05/2015 15:00,26.77,43004,1552,51,40,349,24,2016,2.699.761.905
18/05/2015 16:00,26.51,42578,1654,57,40,361,20,2132,2.699.761.905
18/05/2015 17:00,26.68,42442,1631,55,40,397,14,2137,2.699.761.905
18/05/2015 18:00,26.51,42124,1520,52,40,423,11,2046,2.699.761.905
18/05/2015 19:00,26.11,41789,1428,54,40,482,5,2009,2.699.761.905
18/05/2015 20:00,25.19,41107,1289,57,40,590,4,1980,2.699.761.905
18/05/2015 21:00,24.76,40731,1152,63,40,713,4,1972,2.699.761.905
18/05/2015 22:00,23.56,39786,1092,65,40,833,3,2033,2.699.761.905
18/05/2015 23:00,22.46,37720,1000,61,10,1089,3,2163,2.699.761.905
19/05/2015 00:00,19.99,35926,2466,62,9,1256,2,3795,2.699.761.905
19/05/2015 01:00,18.6,35118,2799,62,9,1363,2,4235,2.699.761.905
19/05/2015 02:00,18.16,34750,2815,63,13,1452,2,4345,2.699.761.905
19/05/2015 03:00,17.3,34768,2466,62,21,1514,3,4066,2.699.761.905
19/05/2015 04:00,18.99,35146,2216,53,32,1506,3,3810,2.699.761.905
19/05/2015 05:00,21.41,36803,2025,43,37,1486,3,3594,2.699.761.905
19/05/2015 06:00,24.13,40282,1832,34,42,1397,6,3311,2.699.761.905
19/05/2015 07:00,28.11,43938,1710,29,46,1272,7,3064,2.699.761.905
19/05/2015 08:00,31.68,45392,1688,27,50,1180,8,2953,2.699.761.905
19/05/2015 09:00,32.04,45394,1705,27,55,1154,9,2950,2.699.761.905
19/05/2015 10:00,30.82,45455,1729,29,62,1096,10,2926,2.699.761.905
19/05/2015 11:00,30.78,45321,1739,30,68,1065,13,2915,2.699.761.905
19/05/2015 12:00,29.12,44912,1758,30,74,1093,16,2971,2.699.761.905
19/05/2015 13:00,27.24,44629,1764,27,80,1146,16,3033,2.699.761.905
19/05/2015 14:00,25.96,44296,1838,23,69,1209,17,3156,2.699.761.905
19/05/2015 15:00,25.33,43834,1873,18,59,1239,15,3204,2.699.761.905
19/05/2015 16:00,25.31,43390,1807,15,49,1254,14,3139,2.699.761.905
19/05/2015 17:00,26.35,43091,1724,16,40,1196,15,2991,2.699.761.905
19/05/2015 18:00,26.47,42666,1644,22,32,1132,13,2843,2.699.761.905
19/05/2015 19:00,25.98,42035,1565,33,26,1112,9,2745,2.699.761.905
19/05/2015 20:00,25.59,41337,1467,48,27,1130,5,2677,2.699.761.905
19/05/2015 21:00,25.62,40856,1394,62,31,1162,4,2653,2.699.761.905
19/05/2015 22:00,24.59,39876,1337,68,38,1091,5,2539,2.699.761.905
19/05/2015 23:00,22.57,37784,1316,85,15,1039,6,2461,2.699.761.905
20/05/2015 00:00,21.38,35754,1052,81,12,1002,4,2151,2.699.761.905
20/05/2015 01:00,21.14,34739,1007,77,10,1036,4,2134,2.699.761.905
20/05/2015 02:00,21.13,34374,931,66,8,973,6,1984,2.699.761.905
20/05/2015 03:00,21.08,34275,825,53,8,920,6,1812,2.699.761.905
20/05/2015 04:00,21.26,34620,722,42,7,875,5,1651,2.699.761.905
20/05/2015 05:00,22.31,36193,661,32,7,760,3,1463,2.699.761.905
20/05/2015 06:00,26.27,39518,583,22,5,651,6,1267,2.699.761.905
20/05/2015 07:00,33.96,43168,515,17,3,581,5,1121,2.699.761.905
20/05/2015 08:00,37.05,44763,527,14,3,559,5,1108,2.699.761.905
20/05/2015 09:00,33.89,44607,553,13,3,580,5,1154,2.699.761.905
20/05/2015 10:00,33.33,44470,610,12,5,625,6,1258,2.699.761.905
20/05/2015 11:00,32.86,44069,711,13,9,680,6,1419,2.699.761.905
20/05/2015 12:00,30.79,43652,857,15,14,730,5,1621,2.699.761.905
20/05/2015 13:00,30.76,43327,985,12,19,765,5,1786,2.699.761.905
20/05/2015 14:00,30.8,42912,952,7,25,802,6,1792,2.699.761.905
20/05/2015 15:00,27.86,42328,807,4,32,792,5,1640,2.699.761.905
20/05/2015 16:00,26.95,41891,753,4,41,799,6,1603,2.699.761.905
20/05/2015 17:00,29.51,41725,660,4,46,754,6,1470,2.699.761.905
20/05/2015 18:00,30.41,41444,498,5,53,726,5,1287,2.699.761.905
20/05/2015 19:00,30.78,41010,419,5,61,682,4,1171,2.699.761.905
20/05/2015 20:00,30.57,40318,395,7,59,723,4,1188,2.699.761.905
20/05/2015 21:00,29.21,39934,358,10,58,762,5,1193,2.699.761.905
20/05/2015 22:00,26.69,39185,321,14,58,808,4,1205,2.699.761.905
20/05/2015 23:00,24.09,37260,313,25,66,977,3,1384,2.699.761.905
21/05/2015 00:00,22.73,35658,254,34,67,984,5,1344,2.699.761.905
21/05/2015 01:00,21.85,34711,272,45,68,990,8,1383,2.699.761.905
21/05/2015 02:00,21.65,34307,258,54,64,981,11,1368,2.699.761.905
21/05/2015 03:00,21.61,34250,231,56,61,925,13,1286,2.699.761.905
21/05/2015 04:00,21.68,34508,223,56,59,870,12,1220,2.699.761.905
21/05/2015 05:00,23.8,36036,221,53,49,724,11,1058,2.699.761.905
21/05/2015 06:00,29.57,39174,216,51,40,598,14,919,2.699.761.905
21/05/2015 07:00,37.93,42351,223,45,32,502,14,816,2.699.761.905
21/05/2015 08:00,40.63,44409,245,38,28,488,14,813,2.699.761.905
21/05/2015 09:00,38.32,44354,261,31,26,481,13,812,2.699.761.905
21/05/2015 10:00,35.79,44144,293,26,27,529,12,887,2.699.761.905
21/05/2015 11:00,36.58,43677,343,26,29,590,11,999,2.699.761.905
21/05/2015 12:00,33.5,43227,401,30,32,647,9,1119,2.699.761.905
21/05/2015 13:00,32.47,42839,479,35,35,714,8,1271,2.699.761.905
21/05/2015 14:00,30.28,42456,576,36,36,752,7,1407,2.699.761.905
21/05/2015 15:00,27.39,41895,669,32,35,777,5,1518,2.699.761.905
21/05/2015 16:00,27.26,41532,752,28,32,773,5,1590,2.699.761.905
21/05/2015 17:00,27.3,41370,793,24,25,770,5,1617,2.699.761.905
21/05/2015 18:00,29.16,41043,751,25,20,789,4,1589,2.699.761.905
21/05/2015 19:00,29.59,40653,720,25,16,770,3,1534,2.699.761.905
21/05/2015 20:00,28.02,40091,649,28,14,832,3,1526,2.699.761.905
21/05/2015 21:00,28.11,39811,556,33,14,925,3,1531,2.699.761.905
21/05/2015 22:00,26.57,39120,544,37,14,1020,3,1618,2.699.761.905
21/05/2015 23:00,23.72,37277,534,41,15,1277,3,1870,2.699.761.905
22/05/2015 00:00,22.33,35456,665,37,13,1416,3,2134,2.699.761.905
22/05/2015 01:00,21.31,34519,710,35,12,1490,3,2250,2.699.761.905
22/05/2015 02:00,20.89,34148,757,33,12,1586,3,2391,2.699.761.905
22/05/2015 03:00,20.54,34102,792,30,11,1636,4,2473,2.699.761.905
22/05/2015 04:00,20.64,34397,845,24,11,1672,4,2556,2.699.761.905
22/05/2015 05:00,21.85,35917,913,18,9,1658,3,2601,2.699.761.905
22/05/2015 06:00,25.35,38955,972,15,7,1632,6,2632,2.699.761.905
22/05/2015 07:00,27.75,42605,1032,16,5,1745,6,2804,2.699.761.905
22/05/2015 08:00,28.25,44659,1098,22,6,1952,6,3084,2.699.761.905
22/05/2015 09:00,26.97,44456,1201,28,9,2257,6,3501,2.699.761.905
22/05/2015 10:00,26.52,44781,1352,35,15,2531,7,3940,2.699.761.905
22/05/2015 11:00,25.97,44305,1519,43,21,2802,8,4393,2.699.761.905
22/05/2015 12:00,24.85,43440,1693,49,29,2903,9,4683,2.699.761.905
22/05/2015 13:00,23.71,42795,1891,52,36,2913,9,4901,2.699.761.905
22/05/2015 14:00,22.95,42171,2026,53,36,2907,9,5031,2.699.761.905
22/05/2015 15:00,22.12,41437,2114,53,33,2895,9,5104,2.699.761.905
22/05/2015 16:00,21.89,40962,2137,53,29,2904,10,5133,2.699.761.905
22/05/2015 17:00,22.12,40861,2042,53,23,2859,9,4986,2.699.761.905
22/05/2015 18:00,22.04,40635,1976,57,17,2844,7,4901,2.699.761.905
22/05/2015 19:00,21.81,39987,1931,67,12,2889,6,4905,2.699.761.905
22/05/2015 20:00,21.51,38970,1856,81,12,2924,6,4879,2.699.761.905
22/05/2015 21:00,21.47,38514,1845,98,13,2784,7,4747,2.699.761.905
22/05/2015 22:00,21.13,38017,1900,106,15,2768,5,4794,2.699.761.905
22/05/2015 23:00,20.09,36663,1837,125,18,2854,8,4842,2.699.761.905
23/05/2015 00:00,17.56,35039,1375,132,25,2691,9,4232,2.699.761.905
23/05/2015 01:00,14.53,34042,1445,134,33,2647,9,4268,2.699.761.905
23/05/2015 02:00,12.74,33497,1478,135,39,2560,10,4222,2.699.761.905
23/05/2015 03:00,12.13,33162,1454,139,47,2537,11,4188,2.699.761.905
23/05/2015 04:00,11.67,33020,1394,145,55,2473,15,4082,2.699.761.905
23/05/2015 05:00,11.91,33258,1371,151,51,2434,13,4020,2.699.761.905
23/05/2015 06:00,14.97,34101,1463,157,47,2460,16,4143,2.699.761.905
23/05/2015 07:00,18,35520,1612,161,42,2334,18,4167,2.699.761.905
23/05/2015 08:00,19.92,36985,1720,157,46,2314,20,4257,2.699.761.905
23/05/2015 09:00,21.01,38574,1760,149,52,2320,18,4299,2.699.761.905
23/05/2015 10:00,21.26,39407,1766,144,60,2355,14,4339,2.699.761.905
23/05/2015 11:00,21.16,39470,1726,138,55,2371,10,4300,2.699.761.905
23/05/2015 12:00,20.48,39105,1691,128,47,2317,9,4192,2.699.761.905
23/05/2015 13:00,19.69,38587,1655,117,44,2429,6,4251,2.699.761.905
23/05/2015 14:00,19.2,38157,1627,102,39,2448,5,4221,2.699.761.905
23/05/2015 15:00,19,37903,1632,80,33,2415,5,4165,2.699.761.905
23/05/2015 16:00,18.96,37913,1622,60,26,2330,6,4044,2.699.761.905
23/05/2015 17:00,19.76,38313,1612,44,20,2288,5,3969,2.699.761.905
23/05/2015 18:00,20.36,38349,1548,35,15,2163,4,3765,2.699.761.905
23/05/2015 19:00,20.46,37927,1448,33,12,2060,1,3554,2.699.761.905
23/05/2015 20:00,20.47,37231,1327,33,11,1982,1,3354,2.699.761.905
23/05/2015 21:00,20.74,36886,1179,37,11,1971,3,3201,2.699.761.905
23/05/2015 22:00,21.1,36713,1093,39,12,2012,1,3157,2.699.761.905
23/05/2015 23:00,20.39,35821,1045,38,11,2107,1,3202,2.699.761.905
24/05/2015 00:00,20.62,34126,947,38,11,2043,1,3040,2.699.761.905
24/05/2015 01:00,19.84,33270,887,42,11,2055,1,2996,2.699.761.905
24/05/2015 02:00,19.06,32751,829,45,9,1955,1,2839,2.699.761.905
24/05/2015 03:00,17.88,32425,776,48,9,1873,1,2707,2.699.761.905
24/05/2015 04:00,17.55,32145,760,42,8,1766,3,2579,2.699.761.905
24/05/2015 05:00,15.96,32137,749,32,7,1597,1,2386,2.699.761.905
24/05/2015 06:00,14.94,32651,739,28,5,1438,1,2211,2.699.761.905
24/05/2015 07:00,16.15,33752,724,32,4,1257,3,2020,2.699.761.905
24/05/2015 08:00,18.64,35196,692,45,4,1168,7,1916,2.699.761.905
24/05/2015 09:00,20.22,36295,684,66,5,1119,8,1882,2.699.761.905
24/05/2015 10:00,20.8,37175,716,82,8,1061,9,1876,2.699.761.905
24/05/2015 11:00,21.01,37313,767,88,12,1050,10,1927,2.699.761.905
24/05/2015 12:00,20.71,37155,840,89,18,1116,9,2072,2.699.761.905
24/05/2015 13:00,20.22,36825,940,83,25,1227,6,2281,2.699.761.905
24/05/2015 14:00,19.41,36555,1019,73,25,1241,7,2365,2.699.761.905
24/05/2015 15:00,19.05,36484,1060,58,23,1249,7,2397,2.699.761.905
24/05/2015 16:00,19,36640,1132,46,21,1224,7,2430,2.699.761.905
24/05/2015 17:00,20.41,36950,1197,37,16,1187,6,2443,2.699.761.905
24/05/2015 18:00,20.86,37407,1186,31,12,1175,6,2410,2.699.761.905
24/05/2015 19:00,22.52,37579,1154,29,9,1105,3,2300,2.699.761.905
24/05/2015 20:00,22.79,37475,1108,33,8,1121,4,2274,2.699.761.905
24/05/2015 21:00,22.99,37538,1063,42,7,1143,6,2261,2.699.761.905
24/05/2015 22:00,22.63,37222,1067,50,9,1208,7,2341,2.699.761.905
24/05/2015 23:00,21.5,35711,988,35,12,1279,5,2319,2.699.761.905
25/05/2015 00:00,21.09,33635,797,39,14,1264,6,2120,2.948.809.524
25/05/2015 01:00,19.3,32753,755,42,15,1224,5,2041,2.948.809.524
25/05/2015 02:00,17.92,32289,730,46,16,1181,6,1979,2.948.809.524
25/05/2015 03:00,16.09,32030,663,48,17,1125,6,1859,2.948.809.524
25/05/2015 04:00,15.91,31967,625,47,17,1035,6,1730,2.948.809.524
25/05/2015 05:00,18.66,33105,608,43,15,922,5,1593,2.948.809.524
25/05/2015 06:00,21.29,35159,588,41,12,850,8,1499,2.948.809.524
25/05/2015 07:00,22.83,37470,611,42,9,802,8,1472,2.948.809.524
25/05/2015 08:00,23.96,39142,644,48,10,791,8,1501,2.948.809.524
25/05/2015 09:00,25.06,40160,643,54,14,832,7,1550,2.948.809.524
25/05/2015 10:00,25.1,40656,649,59,19,878,8,1613,2.948.809.524
25/05/2015 11:00,25.21,40693,674,59,22,917,9,1681,2.948.809.524
25/05/2015 12:00,25.11,40510,714,54,27,941,8,1744,2.948.809.524
25/05/2015 13:00,23.64,40233,773,50,31,945,7,1806,2.948.809.524
25/05/2015 14:00,23.1,39990,820,47,26,917,7,1817,2.948.809.524
25/05/2015 15:00,22.56,39574,858,42,22,913,5,1840,2.948.809.524
25/05/2015 16:00,22.35,39453,901,34,16,883,5,1839,2.948.809.524
25/05/2015 17:00,22.89,39416,922,25,12,841,5,1805,2.948.809.524
25/05/2015 18:00,23.95,39356,930,18,9,772,3,1732,2.948.809.524
25/05/2015 19:00,24.06,39014,924,14,6,679,3,1626,2.948.809.524
25/05/2015 20:00,23.68,38412,892,13,9,661,3,1578,2.948.809.524
25/05/2015 21:00,24.52,37947,812,15,14,593,3,1437,2.948.809.524
25/05/2015 22:00,23.92,37345,739,16,21,602,3,1381,2.948.809.524
25/05/2015 23:00,22.37,35575,745,17,24,613,2,1401,2.948.809.524
26/05/2015 00:00,22.29,33418,619,25,28,593,2,1267,2.948.809.524
26/05/2015 01:00,21.4,32418,684,33,32,575,2,1326,2.948.809.524
26/05/2015 02:00,21.04,31910,750,40,29,566,2,1387,2.948.809.524
26/05/2015 03:00,20.9,31627,823,44,27,539,3,1436,2.948.809.524
26/05/2015 04:00,20.95,31910,909,39,25,503,3,1479,2.948.809.524
26/05/2015 05:00,22.57,33255,1030,28,20,431,3,1512,2.948.809.524
26/05/2015 06:00,25.04,37829,1176,19,16,383,6,1600,2.948.809.524
26/05/2015 07:00,30.1,41416,1386,15,13,375,5,1794,2.948.809.524
26/05/2015 08:00,31.45,43546,1592,15,9,387,5,2008,2.948.809.524
26/05/2015 09:00,29.66,43659,1758,18,7,400,5,2188,2.948.809.524
26/05/2015 10:00,28,43673,1962,22,8,462,6,2460,2.948.809.524
26/05/2015 11:00,26.56,43565,2159,27,10,556,6,2758,2.948.809.524
26/05/2015 12:00,26.05,43087,2308,33,13,640,6,3000,2.948.809.524
26/05/2015 13:00,25.68,42586,2404,33,17,710,6,3170,2.948.809.524
26/05/2015 14:00,24.98,42096,2535,25,23,802,6,3391,2.948.809.524
26/05/2015 15:00,24.04,41584,2679,17,30,862,5,3593,2.948.809.524
26/05/2015 16:00,23.68,41141,2796,14,38,895,5,3748,2.948.809.524
26/05/2015 17:00,23.58,40968,2889,15,41,968,5,3918,2.948.809.524
26/05/2015 18:00,23.88,40593,2900,19,46,957,4,3926,2.948.809.524
26/05/2015 19:00,23.77,40065,2847,22,54,919,3,3845,2.948.809.524
26/05/2015 20:00,23.38,39072,2766,22,51,936,4,3779,2.948.809.524
26/05/2015 21:00,23.55,38510,2624,20,49,969,5,3667,2.948.809.524
26/05/2015 22:00,23.16,37582,2522,21,48,1066,5,3662,2.948.809.524
26/05/2015 23:00,21.27,35655,2517,15,46,1123,3,3704,2.948.809.524
27/05/2015 00:00,20.03,33893,2539,19,42,1171,3,3774,2.948.809.524
27/05/2015 01:00,18.82,32926,2570,24,39,1164,2,3799,2.948.809.524
27/05/2015 02:00,17.78,32531,2571,25,36,1200,2,3834,2.948.809.524
27/05/2015 03:00,17.04,32322,2588,24,33,1188,3,3836,2.948.809.524
27/05/2015 04:00,17.09,32996,2609,22,31,1197,3,3862,2.948.809.524
27/05/2015 05:00,20.08,34846,2621,19,27,1158,3,3828,2.948.809.524
27/05/2015 06:00,22.08,38700,2701,16,23,1183,6,3929,2.948.809.524
27/05/2015 07:00,25.09,42597,2821,16,19,1242,6,4104,2.948.809.524
27/05/2015 08:00,26.13,44876,2903,19,26,1319,7,4274,2.948.809.524
27/05/2015 09:00,25.96,44304,2908,23,35,1395,7,4368,2.948.809.524
27/05/2015 10:00,25.65,44043,2850,29,49,1476,8,4412,2.948.809.524
27/05/2015 11:00,25.25,43438,2805,35,59,1595,9,4503,2.948.809.524
27/05/2015 12:00,25.14,43129,2756,39,70,1720,9,4594,2.948.809.524
27/05/2015 13:00,24.69,42714,2657,38,84,1835,9,4623,2.948.809.524
27/05/2015 14:00,23.9,42282,2541,35,82,1924,9,4591,2.948.809.524
27/05/2015 15:00,23.14,41671,2360,35,79,1996,7,4477,2.948.809.524
27/05/2015 16:00,22.88,41600,2176,31,74,2019,7,4307,2.948.809.524
27/05/2015 17:00,22.95,41329,1956,30,61,1956,6,4009,2.948.809.524
27/05/2015 18:00,23.95,40901,1641,32,50,1875,5,3603,2.948.809.524
27/05/2015 19:00,24.11,40348,1332,36,40,1739,3,3150,2.948.809.524
27/05/2015 20:00,24.29,39558,1058,40,37,1660,3,2798,2.948.809.524
27/05/2015 21:00,23.4,38850,807,43,34,1647,3,2534,2.948.809.524
27/05/2015 22:00,23.02,38159,661,43,32,1640,3,2379,2.948.809.524
27/05/2015 23:00,21.82,36328,599,39,21,1565,3,2227,2.948.809.524
28/05/2015 00:00,20.72,34294,573,36,17,1500,3,2129,2.948.809.524
28/05/2015 01:00,19.9,33350,655,32,15,1478,3,2183,2.948.809.524
28/05/2015 02:00,19.2,32921,776,30,16,1426,3,2251,2.948.809.524
28/05/2015 03:00,18.84,32825,911,26,16,1367,4,2324,2.948.809.524
28/05/2015 04:00,18.8,33528,1130,22,17,1233,4,2406,2.948.809.524
28/05/2015 05:00,20.71,35262,1438,17,14,1083,3,2555,2.948.809.524
28/05/2015 06:00,22.98,38827,1795,13,11,968,5,2792,2.948.809.524
28/05/2015 07:00,25.81,42284,2145,12,8,869,5,3039,2.948.809.524
28/05/2015 08:00,26.62,44948,2363,12,10,918,5,3308,2.948.809.524
28/05/2015 09:00,26.28,44586,2455,13,15,1028,5,3516,2.948.809.524
28/05/2015 10:00,25.98,44372,2606,14,24,1196,6,3846,2.948.809.524
28/05/2015 11:00,25.49,43966,2713,14,30,1393,7,4157,2.948.809.524
28/05/2015 12:00,25.38,43682,2763,18,38,1575,6,4400,2.948.809.524
28/05/2015 13:00,24.93,43325,2840,17,47,1706,6,4616,2.948.809.524
28/05/2015 14:00,24.44,43010,2916,18,44,1812,7,4797,2.948.809.524
28/05/2015 15:00,23.95,42471,2946,16,40,1907,5,4914,2.948.809.524
28/05/2015 16:00,23.17,42380,2974,14,34,1904,7,4933,2.948.809.524
28/05/2015 17:00,23.23,42214,2933,11,23,1858,8,4833,2.948.809.524
28/05/2015 18:00,23.23,41785,2871,10,15,1801,4,4701,2.948.809.524
28/05/2015 19:00,22.76,41317,2820,10,9,1759,4,4602,2.948.809.524
28/05/2015 20:00,22.28,40479,2632,11,10,1754,4,4411,2.948.809.524
28/05/2015 21:00,22.39,39750,2370,13,13,1734,4,4134,2.948.809.524
28/05/2015 22:00,21.56,38964,2200,17,20,1818,4,4059,2.948.809.524
28/05/2015 23:00,20.41,37115,2077,29,45,1862,8,4021,2.948.809.524
29/05/2015 00:00,18.02,34945,1732,33,62,1916,9,3752,2.948.809.524
29/05/2015 01:00,16.96,33880,1706,40,82,1934,10,3772,2.948.809.524
29/05/2015 02:00,15.33,33395,1672,49,79,1937,10,3747,2.948.809.524
29/05/2015 03:00,14.71,33220,1642,58,76,1928,12,3716,2.948.809.524
29/05/2015 04:00,15.28,33821,1631,60,72,1858,12,3633,2.948.809.524
29/05/2015 05:00,18.46,35559,1581,59,59,1793,9,3501,2.948.809.524
29/05/2015 06:00,21.27,39034,1520,57,46,1812,8,3443,2.948.809.524
29/05/2015 07:00,25.07,42567,1520,58,35,1841,8,3462,2.948.809.524
29/05/2015 08:00,26.78,43561,1552,59,34,1904,7,3556,2.948.809.524
29/05/2015 09:00,25.01,44206,1571,62,34,1967,6,3640,2.948.809.524
29/05/2015 10:00,24.07,44248,1578,66,37,2100,8,3789,2.948.809.524
29/05/2015 11:00,23.34,44001,1582,67,39,2235,9,3932,2.948.809.524
29/05/2015 12:00,22.81,43365,1550,64,42,2315,10,3981,2.948.809.524
29/05/2015 13:00,22.22,42749,1516,59,44,2381,10,4010,2.948.809.524
29/05/2015 14:00,21.79,42133,1384,53,38,2409,10,3894,2.948.809.524
29/05/2015 15:00,21.54,41351,1190,45,31,2345,8,3619,2.948.809.524
29/05/2015 16:00,21.52,41224,1043,34,24,2165,8,3274,2.948.809.524
29/05/2015 17:00,21.86,41125,914,24,15,2044,7,3004,2.948.809.524
29/05/2015 18:00,22.33,40819,838,19,9,1839,6,2711,2.948.809.524
29/05/2015 19:00,22.44,40177,749,18,5,1635,3,2410,2.948.809.524
29/05/2015 20:00,22.32,39074,620,20,5,1484,3,2132,2.948.809.524
29/05/2015 21:00,22.24,38266,592,22,8,1457,3,2082,2.948.809.524
29/05/2015 22:00,22.23,37796,579,23,12,1462,1,2077,2.948.809.524
29/05/2015 23:00,20.91,36426,461,19,14,1608,1,2103,2.948.809.524
30/05/2015 00:00,18.59,34416,1081,16,25,1615,1,2738,2.948.809.524
30/05/2015 01:00,16.8,33282,1139,15,42,1616,2,2814,2.948.809.524
30/05/2015 02:00,15.32,32682,1228,17,55,1606,2,2908,2.948.809.524
30/05/2015 03:00,14.24,32282,1378,19,68,1586,2,3053,2.948.809.524
30/05/2015 04:00,12.91,31990,1596,19,82,1514,4,3215,2.948.809.524
30/05/2015 05:00,13.09,32221,1764,16,83,1395,3,3261,2.948.809.524
30/05/2015 06:00,14.53,33092,1854,14,83,1294,6,3251,2.948.809.524
30/05/2015 07:00,16.4,34458,2015,15,82,1282,11,3405,2.948.809.524
30/05/2015 08:00,19,36361,2181,18,92,1322,20,3633,2.948.809.524
30/05/2015 09:00,19.7,37746,2444,23,105,1383,25,3980,2.948.809.524
30/05/2015 10:00,19.06,38474,2842,30,119,1458,32,4481,2.948.809.524
30/05/2015 11:00,18.67,38415,3131,38,123,1617,42,4951,2.948.809.524
30/05/2015 12:00,16.94,38066,3294,48,125,1808,47,5322,2.948.809.524
30/05/2015 13:00,15.37,37714,3425,55,125,1962,44,5611,2.948.809.524
30/05/2015 14:00,15.16,37381,3523,62,124,2094,40,5843,2.948.809.524
30/05/2015 15:00,15.04,37184,3551,68,121,2238,32,6010,2.948.809.524
30/05/2015 16:00,14.92,37319,3543,78,115,2414,30,6180,2.948.809.524
30/05/2015 17:00,18.38,37653,3493,89,107,2494,26,6209,2.948.809.524
30/05/2015 18:00,19.18,37763,3402,92,98,2530,30,6152,2.948.809.524
30/05/2015 19:00,18.69,37336,3271,92,89,2554,31,6037,2.948.809.524
30/05/2015 20:00,17.85,36639,3099,90,82,2576,34,5881,2.948.809.524
30/05/2015 21:00,17.74,36386,2931,94,76,2624,34,5759,2.948.809.524
30/05/2015 22:00,18.17,36238,2825,100,73,2706,30,5734,2.948.809.524
30/05/2015 23:00,16.67,35228,2830,108,60,2727,17,5742,2.948.809.524
31/05/2015 00:00,14.53,33807,2958,111,62,2788,17,5936,2.948.809.524
31/05/2015 01:00,12.52,32842,2996,102,64,2786,15,5963,2.948.809.524
31/05/2015 02:00,11.18,32210,2990,92,66,2851,15,6014,2.948.809.524
31/05/2015 03:00,10,31811,2880,86,68,2936,11,5981,2.948.809.524
31/05/2015 04:00,8.94,31514,2702,86,69,3069,12,5938,2.948.809.524
31/05/2015 05:00,9.92,31496,2482,89,72,3106,13,5762,2.948.809.524
31/05/2015 06:00,11.72,31947,2304,90,74,3143,17,5628,2.948.809.524
31/05/2015 07:00,11.12,32893,2168,88,75,3168,22,5521,2.948.809.524
31/05/2015 08:00,13.89,34470,2047,90,84,3186,27,5434,2.948.809.524
31/05/2015 09:00,15.92,35773,1979,91,95,3228,28,5421,2.948.809.524
31/05/2015 10:00,15.55,36643,1992,96,108,3271,33,5500,2.948.809.524
31/05/2015 11:00,16.01,36877,1983,99,113,3359,34,5588,2.948.809.524
31/05/2015 12:00,14.66,36686,1953,100,120,3403,36,5612,2.948.809.524
31/05/2015 13:00,13.24,36407,1940,105,125,3412,35,5617,2.948.809.524
31/05/2015 14:00,11.15,36246,1946,111,104,3377,36,5574,2.948.809.524
31/05/2015 15:00,10.36,36145,1960,113,83,3256,35,5447,2.948.809.524
31/05/2015 16:00,10.69,36277,1965,111,63,3082,34,5255,2.948.809.524
31/05/2015 17:00,13.58,36671,2004,103,40,2865,28,5040,2.948.809.524
31/05/2015 18:00,16.22,36926,2193,98,23,2626,22,4962,2.948.809.524
31/05/2015 19:00,17.7,36901,2485,95,12,2466,14,5072,2.948.809.524
31/05/2015 20:00,17.4,36612,2776,100,14,2373,9,5272,2.948.809.524
31/05/2015 21:00,17.31,36472,3026,109,19,2403,10,5567,2.948.809.524
31/05/2015 22:00,17.01,36191,3315,108,28,2465,8,5924,2.948.809.524
31/05/2015 23:00,13.64,34881,3380,138,57,2517,11,6103,2.948.809.524
01/06/2015 00:00,12.97,33775,3126,132,76,2604,11,5949,3.312.083.333
01/06/2015 01:00,11.56,32867,3174,121,96,2679,11,6081,3.312.083.333
01/06/2015 02:00,9.83,32502,3122,109,106,2656,12,6005,3.312.083.333
01/06/2015 03:00,9.82,32425,2921,100,116,2630,15,5782,3.312.083.333
01/06/2015 04:00,10.54,32677,2798,102,125,2596,20,5641,3.312.083.333
01/06/2015 05:00,15.17,34202,2742,110,124,2569,22,5567,3.312.083.333
01/06/2015 06:00,20.26,37449,2709,123,123,2600,24,5579,3.312.083.333
01/06/2015 07:00,24.96,40831,2735,138,120,2743,27,5763,3.312.083.333
01/06/2015 08:00,25.43,42503,2814,159,121,2886,29,6009,3.312.083.333
01/06/2015 09:00,24.16,43126,2877,182,122,3090,32,6303,3.312.083.333
01/06/2015 10:00,23.34,43229,2923,200,126,3265,36,6550,3.312.083.333
01/06/2015 11:00,22.17,43175,2898,211,117,3446,35,6707,3.312.083.333
01/06/2015 12:00,21.84,42764,2806,213,109,3531,30,6689,3.312.083.333
01/06/2015 13:00,21.44,42381,2679,207,100,3538,25,6549,3.312.083.333
01/06/2015 14:00,21.66,42005,2590,184,74,3575,20,6443,3.312.083.333
01/06/2015 15:00,21.73,41408,2525,148,52,3589,12,6326,3.312.083.333
01/06/2015 16:00,21.26,40921,2350,116,35,3582,9,6092,3.312.083.333
01/06/2015 17:00,21.18,40766,1968,89,23,3454,6,5540,3.312.083.333
01/06/2015 18:00,21.47,40466,1517,67,13,3298,4,4899,3.312.083.333
01/06/2015 19:00,22.84,40033,1119,53,7,3110,3,4292,3.312.083.333
01/06/2015 20:00,21.8,39241,849,46,4,2961,0,3860,3.312.083.333
01/06/2015 21:00,21.39,38736,771,40,4,2830,0,3645,3.312.083.333
01/06/2015 22:00,21.01,38031,761,32,5,2710,0,3508,3.312.083.333
01/06/2015 23:00,19.42,36297,892,27,40,2756,4,3719,3.312.083.333
02/06/2015 00:00,16.9,34774,1322,23,40,2679,4,4068,3.312.083.333
02/06/2015 01:00,12.14,33837,1599,20,40,2594,2,4255,3.312.083.333
02/06/2015 02:00,9.99,33386,1901,18,40,2558,2,4519,3.312.083.333
02/06/2015 03:00,8.51,33220,2272,16,40,2521,3,4852,3.312.083.333
02/06/2015 04:00,8,33408,2644,14,40,2468,3,5169,3.312.083.333
02/06/2015 05:00,11.15,35062,2952,12,40,2383,3,5390,3.312.083.333
02/06/2015 06:00,18.87,38567,3240,12,40,2301,5,5598,3.312.083.333
02/06/2015 07:00,20.78,42187,3496,13,40,2317,5,5871,3.312.083.333
02/06/2015 08:00,21.58,44739,3676,16,40,2400,6,6138,3.312.083.333
02/06/2015 09:00,21.21,44621,3807,18,40,2569,5,6439,3.312.083.333
02/06/2015 10:00,21,44501,3897,19,40,2739,6,6701,3.312.083.333
02/06/2015 11:00,20.64,44027,3934,18,40,2976,6,6974,3.312.083.333
02/06/2015 12:00,19.48,43742,3933,17,40,3212,5,7207,3.312.083.333
02/06/2015 13:00,18.65,43461,3960,16,40,3428,5,7449,3.312.083.333
02/06/2015 14:00,17.95,43154,4032,15,40,3540,6,7633,3.312.083.333
02/06/2015 15:00,17.57,42644,4109,15,40,3653,4,7821,3.312.083.333
02/06/2015 16:00,17.48,42243,4133,16,40,3734,5,7928,3.312.083.333
02/06/2015 17:00,17.61,42018,4096,21,40,3823,5,7985,3.312.083.333
02/06/2015 18:00,18.45,41708,4053,28,40,3892,4,8017,3.312.083.333
02/06/2015 19:00,18.16,41133,4053,38,40,3897,3,8031,3.312.083.333
02/06/2015 20:00,17.57,40307,4084,54,40,3875,6,8059,3.312.083.333
02/06/2015 21:00,17.12,39706,4110,79,40,3831,9,8069,3.312.083.333
02/06/2015 22:00,15.48,38752,4133,98,40,3768,14,8053,3.312.083.333
02/06/2015 23:00,9.06,36870,4138,172,70,3819,24,8223,3.312.083.333
03/06/2015 00:00,9.15,34724,4049,185,92,3674,29,8029,3.312.083.333
03/06/2015 01:00,6.56,33696,4096,193,115,3520,33,7957,3.312.083.333
03/06/2015 02:00,5.62,33239,4053,198,125,3398,32,7806,3.312.083.333
03/06/2015 03:00,4.93,32971,3968,205,134,3343,32,7682,3.312.083.333
03/06/2015 04:00,5.85,33168,3851,212,142,3311,31,7547,3.312.083.333
03/06/2015 05:00,9.9,34840,3737,216,143,3299,35,7430,3.312.083.333
03/06/2015 06:00,17.54,38354,3696,220,143,3262,38,7359,3.312.083.333
03/06/2015 07:00,19.4,42089,3746,224,142,3266,40,7418,3.312.083.333
03/06/2015 08:00,20.15,44037,3798,226,144,3315,40,7523,3.312.083.333
03/06/2015 09:00,20.31,44014,3799,227,149,3334,47,7556,3.312.083.333
03/06/2015 10:00,20.27,43852,3783,228,156,3368,47,7582,3.312.083.333
03/06/2015 11:00,19.97,43617,3795,227,157,3452,47,7678,3.312.083.333
03/06/2015 12:00,19.88,43273,3798,223,159,3520,47,7747,3.312.083.333
03/06/2015 13:00,19.85,43009,3796,220,161,3638,47,7862,3.312.083.333
03/06/2015 14:00,19.67,42700,3789,216,164,3670,47,7886,3.312.083.333
03/06/2015 15:00,19.31,42087,3790,209,165,3744,45,7953,3.312.083.333
03/06/2015 16:00,18.73,41642,3753,201,164,3768,46,7932,3.312.083.333
03/06/2015 17:00,18.51,41290,3654,194,160,3761,46,7815,3.312.083.333
03/06/2015 18:00,18.4,40867,3479,186,156,3801,44,7666,3.312.083.333
03/06/2015 19:00,18.42,40312,3285,179,153,3874,43,7534,3.312.083.333
03/06/2015 20:00,18.28,39461,3089,172,150,3880,42,7333,3.312.083.333
03/06/2015 21:00,17.88,38908,2837,169,149,3936,39,7130,3.312.083.333
03/06/2015 22:00,17.15,38213,2605,169,147,3948,39,6908,3.312.083.333
03/06/2015 23:00,12.78,36481,2444,188,158,3971,36,6797,3.312.083.333
04/06/2015 00:00,13.17,34888,2070,188,154,3884,35,6331,3.312.083.333
04/06/2015 01:00,11.33,33783,1905,187,151,3795,35,6073,3.312.083.333
04/06/2015 02:00,10.81,33284,1729,183,150,3642,35,5739,3.312.083.333
04/06/2015 03:00,11.16,33081,1567,179,149,3513,37,5445,3.312.083.333
04/06/2015 04:00,14.82,33279,1433,169,147,3407,38,5194,3.312.083.333
04/06/2015 05:00,16.56,34874,1342,160,150,3215,38,4905,3.312.083.333
04/06/2015 06:00,18.78,38143,1278,150,151,3065,39,4683,3.312.083.333
04/06/2015 07:00,23.69,41620,1252,144,163,2953,36,4548,3.312.083.333
04/06/2015 08:00,24.41,43549,1238,143,160,2889,33,4463,3.312.083.333
04/06/2015 09:00,23.89,43552,1182,145,148,2886,31,4392,3.312.083.333
04/06/2015 10:00,23.36,43575,1076,151,133,2919,31,4310,3.312.083.333
04/06/2015 11:00,22.11,43459,988,161,130,3035,32,4346,3.312.083.333
04/06/2015 12:00,20.87,43065,919,169,128,3064,32,4312,3.312.083.333
04/06/2015 13:00,19.48,42727,874,173,126,3099,31,4303,3.312.083.333
04/06/2015 14:00,18.59,42347,823,173,115,3049,31,4191,3.312.083.333
04/06/2015 15:00,18.74,41733,748,168,101,2997,29,4043,3.312.083.333
04/06/2015 16:00,18.85,41263,679,155,86,2849,28,3797,3.312.083.333
04/06/2015 17:00,18.89,40956,589,134,69,2600,20,3412,3.312.083.333
04/06/2015 18:00,20.79,40595,473,114,53,2307,18,2965,3.312.083.333
04/06/2015 19:00,21.12,40149,361,101,39,2088,13,2602,3.312.083.333
04/06/2015 20:00,20.13,39374,265,89,38,2018,9,2419,3.312.083.333
04/06/2015 21:00,20.55,38830,197,84,39,1955,7,2282,3.312.083.333
04/06/2015 22:00,19.94,38153,172,80,40,1889,7,2188,3.312.083.333
04/06/2015 23:00,18.06,36432,162,74,34,1904,6,2180,3.312.083.333
05/06/2015 00:00,15.7,34733,141,70,33,1849,4,2097,3.312.083.333
05/06/2015 01:00,13.71,33677,146,66,33,1851,4,2100,3.312.083.333
05/06/2015 02:00,12.43,33222,168,61,32,1814,4,2079,3.312.083.333
05/06/2015 03:00,11.9,33036,221,54,30,1738,5,2048,3.312.083.333
05/06/2015 04:00,12.06,33200,313,44,27,1610,4,1998,3.312.083.333
05/06/2015 05:00,13.03,34667,405,32,22,1468,3,1930,3.312.083.333
05/06/2015 06:00,16.89,37615,490,25,16,1345,6,1882,3.312.083.333
05/06/2015 07:00,20.34,40806,579,26,11,1241,6,1863,3.312.083.333
05/06/2015 08:00,22.3,42784,675,34,13,1207,6,1935,3.312.083.333
05/06/2015 09:00,23.13,42844,761,49,18,1211,6,2045,3.312.083.333
05/06/2015 10:00,23.42,42693,859,64,27,1334,9,2293,3.312.083.333
05/06/2015 11:00,21.91,42214,986,75,33,1382,10,2486,3.312.083.333
05/06/2015 12:00,20.36,41667,1150,81,40,1419,9,2699,3.312.083.333
05/06/2015 13:00,19.39,41111,1359,83,47,1441,9,2939,3.312.083.333
05/06/2015 14:00,18.73,40576,1535,83,42,1422,9,3091,3.312.083.333
05/06/2015 15:00,17.84,39782,1608,78,37,1355,7,3085,3.312.083.333
05/06/2015 16:00,17.19,39359,1605,69,30,1269,7,2980,3.312.083.333
05/06/2015 17:00,17.14,39245,1623,57,21,1197,6,2904,3.312.083.333
05/06/2015 18:00,17.34,38944,1678,45,13,1121,4,2861,3.312.083.333
05/06/2015 19:00,16.71,38247,1760,40,7,1000,3,2810,3.312.083.333
05/06/2015 20:00,16.33,37254,1887,37,5,938,4,2871,3.312.083.333
05/06/2015 21:00,15.68,36668,2049,36,5,939,3,3032,3.312.083.333
05/06/2015 22:00,15.26,36289,2149,32,4,976,1,3162,3.312.083.333
05/06/2015 23:00,13.22,35156,2166,28,7,1146,1,3348,3.312.083.333
06/06/2015 00:00,9.94,34024,1800,25,13,1247,1,3086,3.312.083.333
06/06/2015 01:00,8.28,32857,1778,21,24,1321,1,3145,3.312.083.333
06/06/2015 02:00,7.36,32250,1737,18,31,1384,1,3171,3.312.083.333
06/06/2015 03:00,6.38,31876,1696,14,40,1435,1,3186,3.312.083.333
06/06/2015 04:00,5.39,31557,1709,10,48,1511,2,3280,3.312.083.333
06/06/2015 05:00,6.98,31686,1620,9,44,1567,2,3242,3.312.083.333
06/06/2015 06:00,8.04,32581,1439,11,38,1552,4,3044,3.312.083.333
06/06/2015 07:00,9.92,33996,1317,15,33,1476,4,2845,3.312.083.333
06/06/2015 08:00,12.84,35751,1239,21,36,1450,6,2752,3.312.083.333
06/06/2015 09:00,14.81,37093,1218,29,41,1552,10,2850,3.312.083.333
06/06/2015 10:00,15.46,38002,1320,39,48,1698,14,3119,3.312.083.333
06/06/2015 11:00,14.67,38123,1498,48,60,1868,18,3492,3.312.083.333
06/06/2015 12:00,13.73,37948,1746,59,73,2064,24,3966,3.312.083.333
06/06/2015 13:00,12.14,37651,1991,70,87,2235,27,4410,3.312.083.333
06/06/2015 14:00,11.14,37361,2246,83,93,2398,28,4848,3.312.083.333
06/06/2015 15:00,9.85,37038,2532,102,97,2498,27,5256,3.312.083.333
06/06/2015 16:00,9.14,37057,2706,112,99,2678,31,5626,3.312.083.333
06/06/2015 17:00,9.41,37336,2694,124,99,2736,28,5681,3.312.083.333
06/06/2015 18:00,9.94,37294,2614,141,99,2703,27,5584,3.312.083.333
06/06/2015 19:00,9.9,36811,2530,162,99,2676,25,5492,3.312.083.333
06/06/2015 20:00,9.78,36110,2415,178,99,2723,23,5438,3.312.083.333
06/06/2015 21:00,9.77,35821,2287,189,100,2749,17,5342,3.312.083.333
06/06/2015 22:00,9.7,35669,2253,192,101,2790,13,5349,3.312.083.333
06/06/2015 23:00,7.7,34766,2331,184,75,3158,8,5756,3.312.083.333
07/06/2015 00:00,4.94,33509,2702,166,59,3178,5,6110,3.312.083.333
07/06/2015 01:00,4.43,32751,2685,163,46,3165,3,6062,3.312.083.333
07/06/2015 02:00,4.17,32243,2641,161,44,3102,3,5951,3.312.083.333
07/06/2015 03:00,3.95,31888,2602,149,42,3119,2,5914,3.312.083.333
07/06/2015 04:00,3.83,31642,2606,141,39,3150,3,5939,3.312.083.333
07/06/2015 05:00,4.07,31548,2660,141,33,3206,4,6044,3.312.083.333
07/06/2015 06:00,4.31,31872,2781,145,26,3254,5,6211,3.312.083.333
07/06/2015 07:00,4.89,32715,2936,150,19,3321,13,6439,3.312.083.333
07/06/2015 08:00,8.44,34100,3027,157,26,3379,17,6606,3.312.083.333
07/06/2015 09:00,9.19,35272,3068,162,37,3470,20,6757,3.312.083.333
07/06/2015 10:00,10.1,36218,3089,168,52,3543,21,6873,3.312.083.333
07/06/2015 11:00,10.77,36545,3081,172,64,3615,23,6955,3.312.083.333
07/06/2015 12:00,9.9,36436,3062,175,78,3539,26,6880,3.312.083.333
07/06/2015 13:00,9.66,36140,3024,174,92,3508,28,6826,3.312.083.333
07/06/2015 14:00,8.36,35950,2965,171,94,3519,29,6778,3.312.083.333
07/06/2015 15:00,8.21,35831,2919,166,94,3408,27,6614,3.312.083.333
07/06/2015 16:00,8.71,35953,2815,159,92,3404,29,6499,3.312.083.333
07/06/2015 17:00,9.14,36313,2634,151,83,3279,26,6173,3.312.083.333
07/06/2015 18:00,10.6,36628,2432,146,74,3151,25,5828,3.312.083.333
07/06/2015 19:00,11.84,36698,2210,143,67,3052,21,5493,3.312.083.333
07/06/2015 20:00,12.66,36495,1939,144,69,2955,21,5128,3.312.083.333
07/06/2015 21:00,13.45,36333,1681,143,72,2791,16,4703,3.312.083.333
07/06/2015 22:00,13.79,36139,1522,137,76,2648,4,4387,3.312.083.333
07/06/2015 23:00,11.9,35046,1494,125,67,2533,14,4233,3.312.083.333
08/06/2015 00:00,10.44,33905,1466,112,63,2461,14,4116,3.584.404.762
08/06/2015 01:00,8.94,33115,1507,101,60,2445,14,4127,3.584.404.762
08/06/2015 02:00,8.37,32768,1554,90,56,2441,13,4154,3.584.404.762
08/06/2015 03:00,8.29,32654,1580,80,51,2392,13,4116,3.584.404.762
08/06/2015 04:00,9.19,32794,1553,71,44,2271,12,3951,3.584.404.762
08/06/2015 05:00,11.61,33966,1517,63,41,2088,10,3719,3.584.404.762
08/06/2015 06:00,19.09,36974,1511,57,36,1962,15,3581,3.584.404.762
08/06/2015 07:00,23.48,40373,1522,58,31,1908,15,3534,3.584.404.762
08/06/2015 08:00,25,41960,1536,61,35,1809,14,3455,3.584.404.762
08/06/2015 09:00,23.83,42264,1518,66,42,1687,14,3327,3.584.404.762
08/06/2015 10:00,23.84,42440,1482,70,52,1597,16,3217,3.584.404.762
08/06/2015 11:00,23.81,42477,1444,74,59,1527,17,3121,3.584.404.762
08/06/2015 12:00,23.51,42118,1405,78,66,1463,17,3029,3.584.404.762
08/06/2015 13:00,23.11,41885,1421,80,73,1406,16,2996,3.584.404.762
08/06/2015 14:00,21.21,41650,1455,77,67,1316,16,2931,3.584.404.762
08/06/2015 15:00,20.15,41153,1491,79,59,1267,13,2909,3.584.404.762
08/06/2015 16:00,19.5,40652,1503,75,49,1245,11,2883,3.584.404.762
08/06/2015 17:00,19.58,40432,1445,68,39,1166,10,2728,3.584.404.762
08/06/2015 18:00,19.21,40127,1343,60,30,1093,6,2532,3.584.404.762
08/06/2015 19:00,18.49,39660,1236,57,22,1046,6,2367,3.584.404.762
08/06/2015 20:00,17,39015,1084,56,18,923,6,2087,3.584.404.762
08/06/2015 21:00,16.09,38338,885,60,16,956,4,1921,3.584.404.762
08/06/2015 22:00,15.98,37597,727,61,16,920,4,1728,3.584.404.762
08/06/2015 23:00,14.38,36208,639,87,13,928,2,1669,3.584.404.762
09/06/2015 00:00,13.74,34537,465,81,14,962,2,1524,3.584.404.762
09/06/2015 01:00,12.62,33692,393,74,15,992,3,1477,3.584.404.762
09/06/2015 02:00,12.54,33256,337,68,19,937,3,1364,3.584.404.762
09/06/2015 03:00,12.46,33061,314,61,22,914,4,1315,3.584.404.762
09/06/2015 04:00,12.57,33113,308,51,25,834,3,1221,3.584.404.762
09/06/2015 05:00,14.46,34413,275,42,23,738,4,1082,3.584.404.762
09/06/2015 06:00,19.98,37657,214,36,20,548,7,825,3.584.404.762
09/06/2015 07:00,25.95,41110,161,33,16,557,8,775,3.584.404.762
09/06/2015 08:00,26.28,43068,141,33,14,562,9,759,3.584.404.762
09/06/2015 09:00,25.98,43021,134,34,15,607,9,799,3.584.404.762
09/06/2015 10:00,25.5,42902,141,37,18,654,10,860,3.584.404.762
09/06/2015 11:00,25.22,42717,164,43,23,772,10,1012,3.584.404.762
09/06/2015 12:00,23.86,42446,207,49,28,903,10,1197,3.584.404.762
09/06/2015 13:00,22.21,42194,272,55,33,1025,11,1396,3.584.404.762
09/06/2015 14:00,21.57,41897,322,58,36,1087,11,1514,3.584.404.762
09/06/2015 15:00,20.04,41351,353,58,37,1152,9,1609,3.584.404.762
09/06/2015 16:00,19.29,40855,383,56,37,1169,9,1654,3.584.404.762
09/06/2015 17:00,18.69,40472,385,51,37,1166,8,1647,3.584.404.762
09/06/2015 18:00,18.48,39997,375,46,38,1134,5,1598,3.584.404.762
09/06/2015 19:00,16.4,39372,366,45,40,1091,4,1546,3.584.404.762
09/06/2015 20:00,15.57,38757,320,46,39,1148,3,1556,3.584.404.762
09/06/2015 21:00,15.09,38146,262,50,40,1245,3,1600,3.584.404.762
09/06/2015 22:00,13.97,37390,247,53,42,1364,2,1708,3.584.404.762
09/06/2015 23:00,12.67,35995,248,53,39,1390,2,1732,3.584.404.762
10/06/2015 00:00,14.97,34350,238,50,35,1533,2,1858,3.584.404.762
10/06/2015 01:00,14.16,33295,242,45,31,1723,2,2043,3.584.404.762
10/06/2015 02:00,13.23,32790,265,43,29,1902,2,2241,3.584.404.762
10/06/2015 03:00,12.73,32559,298,42,27,1995,3,2365,3.584.404.762
10/06/2015 04:00,12.85,32724,335,40,24,1967,3,2369,3.584.404.762
10/06/2015 05:00,14.29,34253,363,39,15,1883,3,2303,3.584.404.762
10/06/2015 06:00,16.8,37882,396,41,7,1809,5,2258,3.584.404.762
10/06/2015 07:00,23.07,41585,477,52,2,1867,6,2404,3.584.404.762
10/06/2015 08:00,24.77,43365,573,65,1,1925,6,2570,3.584.404.762
10/06/2015 09:00,24.17,43173,664,82,1,2077,8,2832,3.584.404.762
10/06/2015 10:00,23.87,42947,779,97,3,2166,10,3055,3.584.404.762
10/06/2015 11:00,23.34,42565,881,110,8,2373,14,3386,3.584.404.762
10/06/2015 12:00,21.63,42294,959,121,16,2517,19,3632,3.584.404.762
10/06/2015 13:00,20.1,42065,1043,127,25,2666,23,3884,3.584.404.762
10/06/2015 14:00,19.07,41706,1127,130,28,2773,25,4083,3.584.404.762
10/06/2015 15:00,17.46,41092,1201,130,30,2901,26,4288,3.584.404.762
10/06/2015 16:00,15.36,40680,1268,129,30,2866,26,4319,3.584.404.762
10/06/2015 17:00,15.05,40323,1314,127,24,2800,24,4289,3.584.404.762
10/06/2015 18:00,15.09,39855,1339,126,19,2693,20,4197,3.584.404.762
10/06/2015 19:00,14.89,39366,1361,124,15,2602,20,4122,3.584.404.762
10/06/2015 20:00,14.64,38687,1349,125,13,2485,17,3989,3.584.404.762
10/06/2015 21:00,14.55,38135,1311,121,12,2460,17,3921,3.584.404.762
10/06/2015 22:00,14.29,37509,1282,107,13,2356,16,3774,3.584.404.762
10/06/2015 23:00,12.95,36010,1261,83,32,2423,16,3815,3.584.404.762
11/06/2015 00:00,9.07,34075,1394,69,41,2281,16,3801,3.584.404.762
11/06/2015 01:00,8.13,32971,1328,59,51,2170,14,3622,3.584.404.762
11/06/2015 02:00,7.4,32394,1262,51,57,2023,11,3404,3.584.404.762
11/06/2015 03:00,8.38,32224,1192,44,63,1864,11,3174,3.584.404.762
11/06/2015 04:00,9.1,32461,1126,34,67,1687,10,2924,3.584.404.762
11/06/2015 05:00,11.58,34058,1057,24,64,1488,8,2641,3.584.404.762
11/06/2015 06:00,15.85,37643,990,19,60,1321,11,2401,3.584.404.762
11/06/2015 07:00,21.63,41269,941,18,55,1204,11,2229,3.584.404.762
11/06/2015 08:00,23.24,43122,888,23,58,1204,10,2183,3.584.404.762
11/06/2015 09:00,22.63,42940,822,34,61,1230,10,2157,3.584.404.762
11/06/2015 10:00,20.59,42795,753,51,67,1262,11,2144,3.584.404.762
11/06/2015 11:00,20.43,42540,679,69,69,1333,13,2163,3.584.404.762
11/06/2015 12:00,19.8,42233,615,86,72,1444,12,2229,3.584.404.762
11/06/2015 13:00,18.75,42025,563,99,74,1561,11,2308,3.584.404.762
11/06/2015 14:00,19.87,41624,515,108,67,1614,10,2314,3.584.404.762
11/06/2015 15:00,19.81,41064,485,112,58,1633,8,2296,3.584.404.762
11/06/2015 16:00,18.96,40529,469,105,47,1597,8,2226,3.584.404.762
11/06/2015 17:00,18.76,40156,445,92,34,1531,6,2108,3.584.404.762
11/06/2015 18:00,18.75,39748,399,78,24,1401,5,1907,3.584.404.762
11/06/2015 19:00,17.99,39428,358,71,15,1300,4,1748,3.584.404.762
11/06/2015 20:00,17.5,38744,343,67,13,1277,5,1705,3.584.404.762
11/06/2015 21:00,17.34,37770,351,62,12,1254,5,1684,3.584.404.762
11/06/2015 22:00,15.73,36950,387,58,11,1219,5,1680,3.584.404.762
11/06/2015 23:00,14.05,35323,386,62,8,1195,3,1654,3.584.404.762
12/06/2015 00:00,13.1,33476,352,62,10,1176,3,1603,3.584.404.762
12/06/2015 01:00,11.57,32398,323,57,11,1137,3,1531,3.584.404.762
12/06/2015 02:00,10.69,31868,263,55,13,1061,4,1396,3.584.404.762
12/06/2015 03:00,9.45,31710,218,55,14,993,6,1286,3.584.404.762
12/06/2015 04:00,9.89,31823,188,52,15,884,5,1144,3.584.404.762
12/06/2015 05:00,12.93,33479,159,44,15,754,5,977,3.584.404.762
12/06/2015 06:00,14.83,36962,130,39,14,648,7,838,3.584.404.762
12/06/2015 07:00,19.91,40397,108,38,13,606,8,773,3.584.404.762
12/06/2015 08:00,21.24,42215,89,40,13,681,9,832,3.584.404.762
12/06/2015 09:00,20.97,42295,82,46,13,792,9,942,3.584.404.762
12/06/2015 10:00,20.74,42255,78,53,15,862,12,1020,3.584.404.762
12/06/2015 11:00,19.98,42007,75,64,17,980,11,1147,3.584.404.762
12/06/2015 12:00,19.03,41388,78,73,18,1177,10,1356,3.584.404.762
12/06/2015 13:00,17.08,40804,84,80,19,1308,9,1500,3.584.404.762
12/06/2015 14:00,15.83,40076,99,83,18,1344,9,1553,3.584.404.762
12/06/2015 15:00,14.62,39128,130,83,17,1404,6,1640,3.584.404.762
12/06/2015 16:00,14.53,38597,163,76,15,1454,6,1714,3.584.404.762
12/06/2015 17:00,14.49,38377,175,70,12,1398,6,1661,3.584.404.762
12/06/2015 18:00,14.39,37969,169,65,8,1250,4,1496,3.584.404.762
12/06/2015 19:00,14.37,37276,166,63,5,1153,3,1390,3.584.404.762
12/06/2015 20:00,14.13,36209,161,67,8,1129,3,1368,3.584.404.762
12/06/2015 21:00,13.41,35516,154,68,15,1110,3,1350,3.584.404.762
12/06/2015 22:00,13.29,35031,159,66,27,1097,1,1350,3.584.404.762
12/06/2015 23:00,11.49,34065,161,69,32,1189,1,1452,3.584.404.762
13/06/2015 00:00,8.54,32519,126,65,38,1192,1,1422,3.584.404.762
13/06/2015 01:00,6.81,31384,137,61,45,1210,1,1454,3.584.404.762
13/06/2015 02:00,5.79,30738,141,60,37,1220,1,1459,3.584.404.762
13/06/2015 03:00,5.27,30332,139,59,31,1184,1,1414,3.584.404.762
13/06/2015 04:00,4.99,29981,143,54,24,1115,1,1337,3.584.404.762
13/06/2015 05:00,5.6,30176,151,47,18,1041,1,1258,3.584.404.762
13/06/2015 06:00,7.47,30999,151,42,10,916,3,1122,3.584.404.762
13/06/2015 07:00,9.52,32448,152,40,6,868,3,1069,3.584.404.762
13/06/2015 08:00,11.49,34712,159,43,5,869,3,1079,3.584.404.762
13/06/2015 09:00,12.73,36084,165,48,4,901,5,1123,3.584.404.762
13/06/2015 10:00,13.23,36954,184,52,7,912,5,1160,3.584.404.762
13/06/2015 11:00,13.16,36977,215,54,15,948,6,1238,3.584.404.762
13/06/2015 12:00,12.67,36685,260,55,24,1021,6,1366,3.584.404.762
13/06/2015 13:00,11.96,36267,320,52,36,1043,6,1457,3.584.404.762
13/06/2015 14:00,11.39,35929,363,48,34,1049,6,1500,3.584.404.762
13/06/2015 15:00,11.03,35713,397,46,30,1065,5,1543,3.584.404.762
13/06/2015 16:00,11.1,35754,479,40,26,1043,7,1595,3.584.404.762
13/06/2015 17:00,11.7,36082,591,32,19,974,3,1619,3.584.404.762
13/06/2015 18:00,11.74,36278,728,25,12,906,4,1675,3.584.404.762
13/06/2015 19:00,11.19,35865,967,20,7,837,3,1834,3.584.404.762
13/06/2015 20:00,11.02,35165,1149,20,5,798,3,1975,3.584.404.762
13/06/2015 21:00,10.66,34744,1204,22,5,739,1,1971,3.584.404.762
13/06/2015 22:00,10.63,34553,1292,25,6,714,1,2038,3.584.404.762
13/06/2015 23:00,8.87,33741,1370,31,10,653,1,2065,3.584.404.762
14/06/2015 00:00,8.51,32429,879,31,18,651,1,1580,3.584.404.762
14/06/2015 01:00,7.46,31375,865,28,29,660,1,1583,3.584.404.762
14/06/2015 02:00,6.38,30734,1021,27,40,662,1,1751,3.584.404.762
14/06/2015 03:00,5.45,30270,1258,26,52,672,1,2009,3.584.404.762
14/06/2015 04:00,4.78,29930,1524,21,65,662,1,2273,3.584.404.762
14/06/2015 05:00,4.71,29993,1699,17,62,669,1,2448,3.584.404.762
14/06/2015 06:00,5.68,30486,1863,15,59,671,2,2610,3.584.404.762
14/06/2015 07:00,7,31549,2087,20,55,699,3,2864,3.584.404.762
14/06/2015 08:00,8.53,33127,2243,30,54,776,4,3107,3.584.404.762
14/06/2015 09:00,9.81,34791,2354,44,56,914,6,3374,3.584.404.762
14/06/2015 10:00,10.91,35842,2420,59,60,1085,7,3631,3.584.404.762
14/06/2015 11:00,10.91,36237,2506,77,69,1263,6,3921,3.584.404.762
14/06/2015 12:00,9.89,36137,2618,93,80,1468,10,4269,3.584.404.762
14/06/2015 13:00,8.92,35991,2741,98,91,1652,23,4605,3.584.404.762
14/06/2015 14:00,8.46,35862,2861,98,93,1811,23,4886,3.584.404.762
14/06/2015 15:00,8.02,35824,2981,94,92,1943,22,5132,3.584.404.762
14/06/2015 16:00,7.46,35926,3063,93,90,2044,22,5312,3.584.404.762
14/06/2015 17:00,8.26,36314,3111,86,80,2120,15,5412,3.584.404.762
14/06/2015 18:00,9.13,36586,3149,81,71,2179,12,5492,3.584.404.762
14/06/2015 19:00,8.97,36557,3157,81,63,2207,11,5519,3.584.404.762
14/06/2015 20:00,8.69,36172,3120,78,67,2208,10,5483,3.584.404.762
14/06/2015 21:00,8.7,35891,2995,77,74,2230,8,5384,3.584.404.762
14/06/2015 22:00,8.58,35625,2848,75,81,2223,4,5231,3.584.404.762
14/06/2015 23:00,7.12,34495,2741,88,71,2184,15,5099,3.584.404.762
15/06/2015 00:00,6.1,33401,2625,93,75,2221,5,5019,3.783.154.762
15/06/2015 01:00,4.6,32441,2569,88,80,2203,4,4944,3.783.154.762
15/06/2015 02:00,4.23,31988,2481,84,78,2205,5,4853,3.783.154.762
15/06/2015 03:00,4.12,31797,2373,86,74,2143,6,4682,3.783.154.762
15/06/2015 04:00,4.42,32053,2224,100,70,2021,17,4432,3.783.154.762
15/06/2015 05:00,7.9,33761,2083,116,74,1895,21,4189,3.783.154.762
15/06/2015 06:00,12.63,37309,2000,127,78,1765,27,3997,3.783.154.762
15/06/2015 07:00,14.66,40967,1900,132,81,1718,26,3857,3.783.154.762
15/06/2015 08:00,19.3,43677,1829,132,80,1710,25,3776,3.783.154.762
15/06/2015 09:00,19.93,43711,1759,137,80,1749,23,3748,3.783.154.762
15/06/2015 10:00,20.42,43679,1673,143,83,1839,20,3758,3.783.154.762
15/06/2015 11:00,19.38,43385,1625,147,81,1946,19,3818,3.783.154.762
15/06/2015 12:00,16.84,43064,1593,151,80,2038,18,3880,3.783.154.762
15/06/2015 13:00,16.16,42805,1597,155,79,2117,17,3965,3.783.154.762
15/06/2015 14:00,15.42,42440,1641,152,76,2143,17,4029,3.783.154.762
15/06/2015 15:00,14.53,41851,1715,145,71,2168,15,4114,3.783.154.762
15/06/2015 16:00,13.67,41256,1827,135,64,2177,10,4213,3.783.154.762
15/06/2015 17:00,13.6,41027,1945,124,52,2170,7,4298,3.783.154.762
15/06/2015 18:00,13.39,40603,2004,112,42,2147,5,4310,3.783.154.762
15/06/2015 19:00,13.15,40038,1981,104,34,2070,3,4192,3.783.154.762
15/06/2015 20:00,13.06,39147,1871,99,28,2054,3,4055,3.783.154.762
15/06/2015 21:00,13.14,38442,1688,97,24,2038,3,3850,3.783.154.762
15/06/2015 22:00,12.81,37657,1527,96,21,2087,3,3734,3.783.154.762
15/06/2015 23:00,11.4,35726,1449,87,21,2113,4,3674,3.783.154.762
16/06/2015 00:00,11,34053,1550,84,18,2156,4,3812,3.783.154.762
16/06/2015 01:00,9.24,33078,1550,77,17,2166,5,3815,3.783.154.762
16/06/2015 02:00,8.13,32555,1530,70,15,2135,5,3755,3.783.154.762
16/06/2015 03:00,7.68,32331,1518,65,14,2136,6,3739,3.783.154.762
16/06/2015 04:00,7.94,32528,1493,57,12,2105,6,3673,3.783.154.762
16/06/2015 05:00,10.64,34307,1483,55,8,2053,5,3604,3.783.154.762
16/06/2015 06:00,13.84,37925,1536,56,4,2009,6,3611,3.783.154.762
16/06/2015 07:00,21.41,41570,1637,65,2,1998,7,3709,3.783.154.762
16/06/2015 08:00,21.79,43159,1679,85,1,2003,7,3775,3.783.154.762
16/06/2015 09:00,21.14,43285,1631,103,2,1974,7,3717,3.783.154.762
16/06/2015 10:00,20.43,43305,1581,115,5,1976,8,3685,3.783.154.762
16/06/2015 11:00,18.38,43095,1516,124,10,1984,8,3642,3.783.154.762
16/06/2015 12:00,16.68,42802,1407,129,19,2032,8,3595,3.783.154.762
16/06/2015 13:00,16.38,42559,1307,130,28,2053,7,3525,3.783.154.762
16/06/2015 14:00,15.4,42179,1240,128,30,2046,8,3452,3.783.154.762
16/06/2015 15:00,14.5,41601,1214,122,31,2025,8,3400,3.783.154.762
16/06/2015 16:00,14.22,41007,1171,116,30,2031,8,3356,3.783.154.762
16/06/2015 17:00,13.98,40541,1089,104,26,1979,7,3205,3.783.154.762
16/06/2015 18:00,13.97,40066,985,93,22,1876,5,2981,3.783.154.762
16/06/2015 19:00,14.5,39430,863,88,19,1739,3,2712,3.783.154.762
16/06/2015 20:00,14.34,38608,757,85,16,1627,3,2488,3.783.154.762
16/06/2015 21:00,13.98,37807,677,82,14,1575,3,2351,3.783.154.762
16/06/2015 22:00,14.06,37015,631,78,14,1531,2,2256,3.783.154.762
16/06/2015 23:00,13.18,35470,627,85,14,1481,2,2209,3.783.154.762
17/06/2015 00:00,10.96,33696,780,82,14,1440,2,2318,3.783.154.762
17/06/2015 01:00,9.88,32548,737,77,15,1435,2,2266,3.783.154.762
17/06/2015 02:00,8.88,31989,701,72,15,1385,3,2176,3.783.154.762
17/06/2015 03:00,8.42,31711,704,67,13,1284,3,2071,3.783.154.762
17/06/2015 04:00,8.3,31910,761,58,12,1155,3,1989,3.783.154.762
17/06/2015 05:00,10.38,33539,819,51,9,945,3,1827,3.783.154.762
17/06/2015 06:00,13.59,36946,875,53,6,731,5,1670,3.783.154.762
17/06/2015 07:00,22.15,40605,1004,56,3,640,5,1708,3.783.154.762
17/06/2015 08:00,24.39,42526,1198,61,2,634,6,1901,3.783.154.762
17/06/2015 09:00,23.91,42541,1437,67,3,670,6,2183,3.783.154.762
17/06/2015 10:00,23.32,42471,1709,67,6,730,9,2521,3.783.154.762
17/06/2015 11:00,21.06,42432,1989,62,11,813,9,2884,3.783.154.762
17/06/2015 12:00,17.54,42248,2283,57,19,888,10,3257,3.783.154.762
17/06/2015 13:00,15.47,41985,2541,52,27,986,12,3618,3.783.154.762
17/06/2015 14:00,14.61,41683,2669,40,30,1093,12,3844,3.783.154.762
17/06/2015 15:00,14.04,41126,2677,35,31,1228,11,3982,3.783.154.762
17/06/2015 16:00,13.67,40683,2651,31,30,1334,11,4057,3.783.154.762
17/06/2015 17:00,13.17,40453,2524,28,25,1415,13,4005,3.783.154.762
17/06/2015 18:00,13.02,40015,2302,25,20,1436,10,3793,3.783.154.762
17/06/2015 19:00,12.86,39454,2146,27,16,1433,12,3634,3.783.154.762
17/06/2015 20:00,12.56,38580,2048,32,16,1437,11,3544,3.783.154.762
17/06/2015 21:00,12.11,37856,1950,41,18,1433,11,3453,3.783.154.762
17/06/2015 22:00,11.47,37104,1877,46,23,1443,12,3401,3.783.154.762
17/06/2015 23:00,9.79,35506,1816,56,24,1429,9,3334,3.783.154.762
18/06/2015 00:00,9.29,33934,1801,54,28,1396,9,3288,3.783.154.762
18/06/2015 01:00,7.21,32724,1762,55,34,1341,10,3202,3.783.154.762
18/06/2015 02:00,5.99,32031,1755,55,49,1286,12,3157,3.783.154.762
18/06/2015 03:00,5.26,31795,1736,56,65,1207,18,3082,3.783.154.762
18/06/2015 04:00,5.33,31736,1798,63,82,1134,21,3098,3.783.154.762
18/06/2015 05:00,7.25,33096,1902,73,94,1114,27,3210,3.783.154.762
18/06/2015 06:00,11.72,36721,1994,93,104,1079,28,3298,3.783.154.762
18/06/2015 07:00,13.77,40347,2132,111,115,1085,28,3471,3.783.154.762
18/06/2015 08:00,17.07,42001,2258,126,117,1092,26,3619,3.783.154.762
18/06/2015 09:00,15.92,42478,2415,143,122,1028,24,3732,3.783.154.762
18/06/2015 10:00,14.98,42778,2598,151,128,1109,23,4009,3.783.154.762
18/06/2015 11:00,13.87,42780,2741,155,132,1128,20,4176,3.783.154.762
18/06/2015 12:00,12.94,42314,2831,153,136,1137,18,4275,3.783.154.762
18/06/2015 13:00,12.73,42020,2918,144,139,1164,16,4381,3.783.154.762
18/06/2015 14:00,12.39,41550,3003,133,125,1225,15,4501,3.783.154.762
18/06/2015 15:00,12.12,40914,3063,122,108,1229,16,4538,3.783.154.762
18/06/2015 16:00,11.75,40340,3104,118,90,1160,15,4487,3.783.154.762
18/06/2015 17:00,11.96,40116,3072,115,72,1102,14,4375,3.783.154.762
18/06/2015 18:00,11.88,39706,2975,113,55,1022,13,4178,3.783.154.762
18/06/2015 19:00,11.62,38977,2865,110,41,947,12,3975,3.783.154.762
18/06/2015 20:00,11.18,38063,2747,101,39,936,9,3832,3.783.154.762
18/06/2015 21:00,10.74,37326,2609,93,38,908,9,3657,3.783.154.762
18/06/2015 22:00,10.25,36521,2479,87,38,912,10,3526,3.783.154.762
18/06/2015 23:00,9.16,35123,2401,63,25,904,6,3399,3.783.154.762
19/06/2015 00:00,8.17,33161,2578,60,25,917,4,3584,3.783.154.762
19/06/2015 01:00,6.39,31914,2533,56,26,903,5,3523,3.783.154.762
19/06/2015 02:00,4.89,31091,2489,53,27,901,5,3475,3.783.154.762
19/06/2015 03:00,4.44,30714,2423,48,27,896,5,3399,3.783.154.762
19/06/2015 04:00,4.24,30507,2318,44,27,862,5,3256,3.783.154.762
19/06/2015 05:00,4.66,31083,2209,41,26,780,5,3061,3.783.154.762
19/06/2015 06:00,10.19,33130,2146,38,24,734,7,2949,3.783.154.762
19/06/2015 07:00,12.01,35925,2150,36,22,713,8,2929,3.783.154.762
19/06/2015 08:00,12.7,37856,2113,37,23,706,8,2887,3.783.154.762
19/06/2015 09:00,12.99,38553,2001,40,25,729,8,2803,3.783.154.762
19/06/2015 10:00,13.58,38991,1923,40,28,739,9,2739,3.783.154.762
19/06/2015 11:00,13.21,39077,1842,37,33,760,9,2681,3.783.154.762
19/06/2015 12:00,12.98,38595,1753,35,40,765,9,2602,3.783.154.762
19/06/2015 13:00,12.73,37957,1671,30,46,742,8,2497,3.783.154.762
19/06/2015 14:00,12.5,37176,1616,26,43,715,8,2408,3.783.154.762
19/06/2015 15:00,12.15,36569,1604,21,39,704,7,2375,3.783.154.762
19/06/2015 16:00,12.04,36215,1587,16,33,692,7,2335,3.783.154.762
19/06/2015 17:00,12.1,36197,1529,11,24,638,7,2209,3.783.154.762
19/06/2015 18:00,12.09,35804,1438,9,16,609,5,2077,3.783.154.762
19/06/2015 19:00,11.81,35103,1329,9,10,577,6,1931,3.783.154.762
19/06/2015 20:00,11.52,34291,1220,10,8,598,4,1840,3.783.154.762
19/06/2015 21:00,11.84,33930,1103,12,8,630,3,1756,3.783.154.762
19/06/2015 22:00,11.97,33759,1070,11,10,662,2,1755,3.783.154.762
19/06/2015 23:00,11.67,33178,1083,5,9,783,1,1881,3.783.154.762
20/06/2015 00:00,9.61,32178,1032,5,12,852,1,1902,3.783.154.762
20/06/2015 01:00,8.84,31247,991,6,16,900,1,1914,3.783.154.762
20/06/2015 02:00,8.18,30438,948,8,19,909,1,1885,3.783.154.762
20/06/2015 03:00,7.19,30002,927,10,22,853,3,1815,3.783.154.762
20/06/2015 04:00,5.84,29571,920,9,23,797,3,1752,3.783.154.762
20/06/2015 05:00,5.82,29538,900,7,21,704,2,1634,3.783.154.762
20/06/2015 06:00,8.11,30060,884,6,18,583,3,1494,3.783.154.762
20/06/2015 07:00,8.92,31079,881,6,16,509,6,1418,3.783.154.762
20/06/2015 08:00,9.75,32234,872,6,15,454,6,1353,3.783.154.762
20/06/2015 09:00,10.4,33734,865,7,17,433,6,1328,3.783.154.762
20/06/2015 10:00,10.97,34722,879,8,20,453,5,1365,3.783.154.762
20/06/2015 11:00,10.98,35014,911,8,22,467,3,1411,3.783.154.762
20/06/2015 12:00,10.44,34865,953,9,25,476,3,1466,3.783.154.762
20/06/2015 13:00,10.05,34582,998,9,27,478,3,1515,3.783.154.762
20/06/2015 14:00,9.62,34269,1046,8,25,476,5,1560,3.783.154.762
20/06/2015 15:00,9.46,33960,1095,7,22,455,5,1584,3.783.154.762
20/06/2015 16:00,9.48,33963,1125,6,18,428,3,1580,3.783.154.762
20/06/2015 17:00,9.9,34348,1138,5,14,389,2,1548,3.783.154.762
20/06/2015 18:00,10.22,34480,1134,5,9,371,1,1520,3.783.154.762
20/06/2015 19:00,10.09,34177,1105,5,5,351,3,1469,3.783.154.762
20/06/2015 20:00,9.79,33678,1039,6,3,343,1,1392,3.783.154.762
20/06/2015 21:00,10.02,33396,978,8,2,365,1,1354,3.783.154.762
20/06/2015 22:00,10.08,33217,941,6,3,374,0,1324,3.783.154.762
20/06/2015 23:00,9.71,32743,946,4,5,374,1,1330,3.783.154.762
21/06/2015 00:00,9.8,31875,777,5,4,352,1,1139,3.783.154.762
21/06/2015 01:00,9.52,30915,838,5,3,363,1,1210,3.783.154.762
21/06/2015 02:00,9.17,30091,830,6,4,362,1,1203,3.783.154.762
21/06/2015 03:00,8.76,29813,730,6,5,355,3,1099,3.783.154.762
21/06/2015 04:00,8.4,29439,619,5,5,309,3,941,3.783.154.762
21/06/2015 05:00,8.6,29538,525,4,4,242,1,776,3.783.154.762
21/06/2015 06:00,9.01,29973,451,4,2,198,1,656,3.783.154.762
21/06/2015 07:00,9.74,30897,399,3,2,179,5,588,3.783.154.762
21/06/2015 08:00,10.9,32067,354,4,2,160,5,525,3.783.154.762
21/06/2015 09:00,11.31,33515,316,5,2,143,5,471,3.783.154.762
21/06/2015 10:00,12.02,34640,296,6,4,151,5,462,3.783.154.762
21/06/2015 11:00,12.84,35154,285,8,5,186,3,487,3.783.154.762
21/06/2015 12:00,12.92,35035,274,10,9,237,3,533,3.783.154.762
21/06/2015 13:00,12.53,34827,277,11,13,258,3,562,3.783.154.762
21/06/2015 14:00,12.25,34616,293,11,15,268,5,592,3.783.154.762
21/06/2015 15:00,12.27,34466,329,10,15,262,5,621,3.783.154.762
21/06/2015 16:00,12.41,34638,389,10,14,271,2,686,3.783.154.762
21/06/2015 17:00,12.96,35059,408,10,11,242,1,672,3.783.154.762
21/06/2015 18:00,13.37,35315,397,11,8,237,1,654,3.783.154.762
21/06/2015 19:00,13.63,35352,382,11,5,208,3,609,3.783.154.762
21/06/2015 20:00,13.73,34993,362,12,4,221,1,600,3.783.154.762
21/06/2015 21:00,13.84,34711,369,13,4,240,1,627,3.783.154.762
21/06/2015 22:00,12.91,34514,422,15,6,238,0,681,3.783.154.762
21/06/2015 23:00,11.21,33409,483,15,5,261,2,766,3.783.154.762
22/06/2015 00:00,11.47,32158,481,13,6,238,2,740,4.115.059.524
22/06/2015 01:00,11,31195,518,11,6,226,2,763,4.115.059.524
22/06/2015 02:00,10.51,30657,501,11,6,206,2,726,4.115.059.524
22/06/2015 03:00,10.44,30482,432,10,6,203,3,654,4.115.059.524
22/06/2015 04:00,10.48,30750,399,8,5,195,3,610,4.115.059.524
22/06/2015 05:00,11.25,32567,367,5,4,159,3,538,4.115.059.524
22/06/2015 06:00,16,36260,348,3,3,161,4,519,4.115.059.524
22/06/2015 07:00,19.35,39958,402,3,2,173,5,585,4.115.059.524
22/06/2015 08:00,22.69,41604,457,3,3,208,5,676,4.115.059.524
22/06/2015 09:00,24.1,41863,467,3,5,248,6,729,4.115.059.524
22/06/2015 10:00,24.6,41965,480,3,6,276,7,772,4.115.059.524
22/06/2015 11:00,24.25,41739,467,5,6,333,7,818,4.115.059.524
22/06/2015 12:00,20.96,41407,421,6,7,420,7,861,4.115.059.524
22/06/2015 13:00,20.71,41151,311,8,7,460,6,792,4.115.059.524
22/06/2015 14:00,19.82,41061,226,8,6,484,6,730,4.115.059.524
22/06/2015 15:00,19.3,40324,238,7,7,511,5,768,4.115.059.524
22/06/2015 16:00,18.89,39780,250,6,6,491,4,757,4.115.059.524
22/06/2015 17:00,18.22,39516,212,6,7,462,5,692,4.115.059.524
22/06/2015 18:00,17.85,39058,165,7,10,423,4,609,4.115.059.524
22/06/2015 19:00,17.44,38544,135,8,11,429,4,587,4.115.059.524
22/06/2015 20:00,17.53,37748,112,8,15,432,3,570,4.115.059.524
22/06/2015 21:00,17.09,37162,95,8,29,471,3,606,4.115.059.524
22/06/2015 22:00,16.76,36465,96,9,48,404,0,557,4.115.059.524
22/06/2015 23:00,13.69,34944,102,7,47,388,1,545,4.115.059.524
23/06/2015 00:00,12.76,33105,185,10,47,367,2,611,4.115.059.524
23/06/2015 01:00,12.32,32082,171,13,48,358,2,592,4.115.059.524
23/06/2015 02:00,12.08,31552,165,17,51,369,2,604,4.115.059.524
23/06/2015 03:00,11.93,31272,171,21,53,337,7,589,4.115.059.524
23/06/2015 04:00,11.89,31466,180,18,54,330,9,591,4.115.059.524
23/06/2015 05:00,12.17,33112,196,13,50,306,10,575,4.115.059.524
23/06/2015 06:00,14.89,36649,205,9,46,300,12,572,4.115.059.524
23/06/2015 07:00,20.78,40238,201,11,42,301,14,569,4.115.059.524
23/06/2015 08:00,22.36,42310,199,15,44,315,15,588,4.115.059.524
23/06/2015 09:00,21.15,42482,194,25,47,327,15,608,4.115.059.524
23/06/2015 10:00,21,42696,196,34,52,353,17,652,4.115.059.524
23/06/2015 11:00,21.11,42661,222,42,53,400,14,731,4.115.059.524
23/06/2015 12:00,19.94,42538,292,45,56,444,16,853,4.115.059.524
23/06/2015 13:00,19.97,42314,411,50,56,483,18,1018,4.115.059.524
23/06/2015 14:00,19.41,42039,544,55,52,524,22,1197,4.115.059.524
23/06/2015 15:00,18.28,41497,670,59,47,541,17,1334,4.115.059.524
23/06/2015 16:00,17.63,40932,802,58,42,551,8,1461,4.115.059.524
23/06/2015 17:00,16.96,40580,908,59,37,501,3,1508,4.115.059.524
23/06/2015 18:00,16.69,39996,981,58,31,501,1,1572,4.115.059.524
23/06/2015 19:00,16.23,39271,1060,61,27,513,3,1664,4.115.059.524
23/06/2015 20:00,13.89,38401,1123,64,27,526,1,1741,4.115.059.524
23/06/2015 21:00,12.97,37756,1214,64,29,537,1,1845,4.115.059.524
23/06/2015 22:00,12.8,37008,1377,60,33,546,2,2018,4.115.059.524
23/06/2015 23:00,12.13,35550,1584,66,50,541,3,2244,4.115.059.524
24/06/2015 00:00,9.91,33405,1720,63,53,557,2,2395,4.115.059.524
24/06/2015 01:00,6.5,32246,2084,61,56,582,2,2785,4.115.059.524
24/06/2015 02:00,5.63,31671,2370,59,66,624,3,3122,4.115.059.524
24/06/2015 03:00,4.96,31410,2564,61,75,690,5,3395,4.115.059.524
24/06/2015 04:00,4.61,31500,2715,61,83,702,2,3563,4.115.059.524
24/06/2015 05:00,5.7,33046,2871,64,101,690,6,3732,4.115.059.524
24/06/2015 06:00,11.27,36364,3067,67,119,692,10,3955,4.115.059.524
24/06/2015 07:00,13.56,39912,3265,70,136,736,20,4227,4.115.059.524
24/06/2015 08:00,15.46,42053,3434,78,157,802,24,4495,4.115.059.524
24/06/2015 09:00,15.97,42290,3584,86,174,887,24,4755,4.115.059.524
24/06/2015 10:00,15.69,42474,3678,100,182,993,26,4979,4.115.059.524
24/06/2015 11:00,15.39,42332,3702,116,181,1096,29,5124,4.115.059.524
24/06/2015 12:00,16.06,42119,3698,130,170,1211,36,5245,4.115.059.524
24/06/2015 13:00,15.1,41933,3693,138,155,1251,39,5276,4.115.059.524
24/06/2015 14:00,13.84,41620,3674,142,144,1336,47,5343,4.115.059.524
24/06/2015 15:00,13.54,40959,3643,144,135,1423,44,5389,4.115.059.524
24/06/2015 16:00,13.14,40466,3586,143,132,1569,38,5468,4.115.059.524
24/06/2015 17:00,12.93,40171,3461,145,121,1762,36,5525,4.115.059.524
24/06/2015 18:00,13.17,39763,3263,146,110,1760,33,5312,4.115.059.524
24/06/2015 19:00,13.23,39150,3024,151,98,1843,31,5147,4.115.059.524
24/06/2015 20:00,12.83,38252,2791,151,92,1976,27,5037,4.115.059.524
24/06/2015 21:00,12.67,37634,2545,149,87,2032,28,4841,4.115.059.524
24/06/2015 22:00,11.78,36912,2306,141,84,2103,15,4649,4.115.059.524
24/06/2015 23:00,11.04,35484,2162,133,68,2270,24,4657,4.115.059.524
25/06/2015 00:00,8.25,33744,1996,126,71,2308,21,4522,4.115.059.524
25/06/2015 01:00,6.61,32702,2011,116,72,2315,20,4534,4.115.059.524
25/06/2015 02:00,5.32,32133,1943,109,74,2277,20,4423,4.115.059.524
25/06/2015 03:00,4.99,31863,1872,102,75,2222,18,4289,4.115.059.524
25/06/2015 04:00,5.32,31907,1793,98,76,2172,18,4157,4.115.059.524
25/06/2015 05:00,6.88,33306,1729,95,82,2116,14,4036,4.115.059.524
25/06/2015 06:00,11.77,36452,1702,96,88,2027,10,3923,4.115.059.524
25/06/2015 07:00,14.1,39875,1710,98,94,1949,13,3864,4.115.059.524
25/06/2015 08:00,15.95,41756,1700,97,93,1927,12,3829,4.115.059.524
25/06/2015 09:00,17.18,42191,1615,101,93,1914,17,3740,4.115.059.524
25/06/2015 10:00,19.82,42487,1515,98,94,1866,19,3592,4.115.059.524
25/06/2015 11:00,18.79,42507,1451,96,94,1880,22,3543,4.115.059.524
25/06/2015 12:00,17.95,42244,1416,93,95,1886,25,3515,4.115.059.524
25/06/2015 13:00,18.05,41992,1402,87,95,1895,24,3503,4.115.059.524
25/06/2015 14:00,16.66,41685,1363,80,90,1956,23,3512,4.115.059.524
25/06/2015 15:00,15.92,41123,1338,70,83,1968,21,3480,4.115.059.524
25/06/2015 16:00,15.06,40580,1317,61,75,1936,20,3409,4.115.059.524
25/06/2015 17:00,14.84,40327,1275,50,64,1893,18,3300,4.115.059.524
25/06/2015 18:00,15.74,39874,1262,42,57,1714,13,3088,4.115.059.524
25/06/2015 19:00,15.05,39338,1253,39,46,1634,16,2988,4.115.059.524
25/06/2015 20:00,14.09,38497,1198,38,41,1554,14,2845,4.115.059.524
25/06/2015 21:00,13.81,37839,1071,38,38,1494,12,2653,4.115.059.524
25/06/2015 22:00,12.68,37020,948,39,36,1464,1,2488,4.115.059.524
25/06/2015 23:00,11.28,35581,902,42,42,1424,7,2417,4.115.059.524
26/06/2015 00:00,12.61,34163,901,43,47,1385,6,2382,4.115.059.524
26/06/2015 01:00,12.36,33054,852,42,51,1388,6,2339,4.115.059.524
26/06/2015 02:00,12.08,32446,797,42,51,1353,5,2248,4.115.059.524
26/06/2015 03:00,11.93,32160,751,40,50,1293,4,2138,4.115.059.524
26/06/2015 04:00,11.92,32233,714,37,49,1209,4,2013,4.115.059.524
26/06/2015 05:00,12.41,33656,668,34,48,1185,5,1940,4.115.059.524
26/06/2015 06:00,17.3,36891,625,32,49,1132,7,1845,4.115.059.524
26/06/2015 07:00,20.88,40330,587,30,49,1111,8,1785,4.115.059.524
26/06/2015 08:00,23.16,41998,537,29,52,1023,9,1650,4.115.059.524
26/06/2015 09:00,23.51,42306,477,29,55,997,10,1568,4.115.059.524
26/06/2015 10:00,24.44,42493,428,29,60,969,11,1497,4.115.059.524
26/06/2015 11:00,24.3,42382,392,29,63,1009,12,1505,4.115.059.524
26/06/2015 12:00,23.34,41913,366,29,67,1044,12,1518,4.115.059.524
26/06/2015 13:00,21.16,41306,352,26,72,1064,10,1524,4.115.059.524
26/06/2015 14:00,19.11,40708,332,21,70,1031,10,1464,4.115.059.524
26/06/2015 15:00,17.47,39966,308,18,67,1023,8,1424,4.115.059.524
26/06/2015 16:00,17.18,39523,282,16,63,936,7,1304,4.115.059.524
26/06/2015 17:00,16.62,39293,237,14,53,886,7,1197,4.115.059.524
26/06/2015 18:00,17.29,38837,189,14,43,838,6,1090,4.115.059.524
26/06/2015 19:00,16.65,38095,159,11,34,806,6,1016,4.115.059.524
26/06/2015 20:00,16.7,36977,144,12,31,781,4,972,4.115.059.524
26/06/2015 21:00,14.89,36278,135,12,31,801,2,981,4.115.059.524
26/06/2015 22:00,14,35744,150,12,32,807,0,1001,4.115.059.524
26/06/2015 23:00,12.87,34729,178,23,21,899,1,1122,4.115.059.524
27/06/2015 00:00,16.09,33272,214,24,23,993,1,1255,4.115.059.524
27/06/2015 01:00,14.94,32233,253,24,24,984,1,1286,4.115.059.524
27/06/2015 02:00,14.17,31585,279,21,25,926,1,1252,4.115.059.524
27/06/2015 03:00,13.72,31071,286,18,25,868,3,1200,4.115.059.524
27/06/2015 04:00,13.16,30718,296,16,24,828,3,1167,4.115.059.524
27/06/2015 05:00,13.44,30896,291,13,18,760,1,1083,4.115.059.524
27/06/2015 06:00,12.28,31715,264,12,14,638,3,931,4.115.059.524
27/06/2015 07:00,13.43,33097,235,12,9,536,5,797,4.115.059.524
27/06/2015 08:00,14.4,34972,208,16,10,459,5,698,4.115.059.524
27/06/2015 09:00,16.67,36490,190,23,12,427,5,657,4.115.059.524
27/06/2015 10:00,17.27,37432,193,30,16,417,5,661,4.115.059.524
27/06/2015 11:00,17.31,37655,198,36,20,404,4,662,4.115.059.524
27/06/2015 12:00,16.71,37286,192,42,25,400,4,663,4.115.059.524
27/06/2015 13:00,15.93,36843,217,44,29,388,4,682,4.115.059.524
27/06/2015 14:00,15.25,36399,269,42,28,366,7,712,4.115.059.524
27/06/2015 15:00,15.22,36025,343,38,26,355,6,768,4.115.059.524
27/06/2015 16:00,14.92,36034,417,35,22,340,4,818,4.115.059.524
27/06/2015 17:00,16.56,36331,491,32,18,327,2,870,4.115.059.524
27/06/2015 18:00,17.23,36403,579,29,13,307,3,931,4.115.059.524
27/06/2015 19:00,16.99,35837,697,30,9,299,3,1038,4.115.059.524
27/06/2015 20:00,16.22,35118,762,32,7,295,1,1097,4.115.059.524
27/06/2015 21:00,15.84,34671,780,37,7,318,1,1143,4.115.059.524
27/06/2015 22:00,15.81,34471,802,38,8,355,0,1203,4.115.059.524
27/06/2015 23:00,14.41,33721,809,40,8,397,1,1255,4.115.059.524
28/06/2015 00:00,14.19,32194,989,39,8,439,1,1476,4.115.059.524
28/06/2015 01:00,13.47,31194,1041,36,8,428,1,1514,4.115.059.524
28/06/2015 02:00,13.12,30541,1043,31,9,420,1,1504,4.115.059.524
28/06/2015 03:00,12.71,30005,994,27,9,470,3,1503,4.115.059.524
28/06/2015 04:00,12.12,29589,928,21,9,510,3,1471,4.115.059.524
28/06/2015 05:00,12.13,29624,829,18,8,476,1,1332,4.115.059.524
28/06/2015 06:00,12.74,30200,733,17,4,383,1,1138,4.115.059.524
28/06/2015 07:00,13.4,31253,670,15,2,306,5,998,4.115.059.524
28/06/2015 08:00,14.37,32817,623,15,2,269,5,914,4.115.059.524
28/06/2015 09:00,15.3,34317,577,14,3,275,5,874,4.115.059.524
28/06/2015 10:00,15.13,35391,567,15,4,325,5,916,4.115.059.524
28/06/2015 11:00,16.16,35878,551,15,6,408,3,983,4.115.059.524
28/06/2015 12:00,15.26,35827,537,16,10,469,3,1035,4.115.059.524
28/06/2015 13:00,15.03,35629,544,17,12,538,3,1114,4.115.059.524
28/06/2015 14:00,14.37,35372,583,16,15,580,5,1199,4.115.059.524
28/06/2015 15:00,14.77,35263,632,16,17,631,5,1301,4.115.059.524
28/06/2015 16:00,15.86,35408,674,15,18,665,2,1374,4.115.059.524
28/06/2015 17:00,17.06,35794,667,14,16,667,1,1365,4.115.059.524
28/06/2015 18:00,17.68,36027,618,13,15,679,1,1326,4.115.059.524
28/06/2015 19:00,18.75,36063,557,13,14,673,3,1260,4.115.059.524
28/06/2015 20:00,18.32,35698,498,14,13,694,1,1220,4.115.059.524
28/06/2015 21:00,17.86,35438,454,16,13,740,1,1224,4.115.059.524
28/06/2015 22:00,17.48,35190,469,17,14,749,0,1249,4.115.059.524
28/06/2015 23:00,15.61,34041,500,22,13,926,2,1463,4.115.059.524
29/06/2015 00:00,13.6,32860,879,24,9,912,2,1826,454.452.381
29/06/2015 01:00,12.76,31839,916,24,8,884,2,1834,454.452.381
29/06/2015 02:00,11.62,31371,906,25,8,865,2,1806,454.452.381
29/06/2015 03:00,11.28,31124,847,23,8,845,3,1726,454.452.381
29/06/2015 04:00,11.28,31304,798,20,6,781,3,1608,454.452.381
29/06/2015 05:00,13.88,33000,746,16,3,759,3,1527,454.452.381
29/06/2015 06:00,16.66,36463,696,14,3,733,4,1450,454.452.381
29/06/2015 07:00,18.83,39818,684,13,3,723,5,1428,454.452.381
29/06/2015 08:00,21.92,41341,644,15,6,740,5,1410,454.452.381
29/06/2015 09:00,21.86,41826,595,17,9,763,5,1389,454.452.381
29/06/2015 10:00,22.52,42081,580,20,13,769,6,1388,454.452.381
29/06/2015 11:00,22.13,42164,587,22,16,829,6,1460,454.452.381
29/06/2015 12:00,20.79,41970,596,25,18,862,7,1508,454.452.381
29/06/2015 13:00,20.58,41790,635,24,19,922,6,1606,454.452.381
29/06/2015 14:00,19.54,41411,677,23,19,920,6,1645,454.452.381
29/06/2015 15:00,18.96,40888,681,21,20,912,6,1640,454.452.381
29/06/2015 16:00,18.11,40411,697,19,20,953,5,1694,454.452.381
29/06/2015 17:00,18.42,40094,714,17,19,1004,6,1760,454.452.381
29/06/2015 18:00,17.97,39637,727,15,19,1044,5,1810,454.452.381
29/06/2015 19:00,17.21,39099,742,13,17,1073,4,1849,454.452.381
29/06/2015 20:00,16.62,38222,729,13,15,1115,3,1875,454.452.381
29/06/2015 21:00,15.95,37554,702,14,14,1146,2,1878,454.452.381
29/06/2015 22:00,15.08,36809,706,13,13,1211,1,1944,454.452.381
29/06/2015 23:00,14,35311,760,26,15,1197,3,2001,454.452.381
30/06/2015 00:00,13.66,33289,853,26,15,1181,3,2078,454.452.381
30/06/2015 01:00,12.18,32184,861,25,16,1204,3,2109,454.452.381
30/06/2015 02:00,11.61,31571,839,23,17,1224,4,2107,454.452.381
30/06/2015 03:00,11.39,31278,804,21,16,1234,5,2080,454.452.381
30/06/2015 04:00,11.49,31395,756,19,15,1170,5,1965,454.452.381
30/06/2015 05:00,13.64,32944,690,18,15,1017,3,1743,454.452.381
30/06/2015 06:00,16.04,36506,633,17,14,904,5,1573,454.452.381
30/06/2015 07:00,18.78,40101,605,19,17,846,6,1493,454.452.381
30/06/2015 08:00,20.3,41701,603,23,21,779,6,1432,454.452.381
30/06/2015 09:00,20.17,42114,606,27,25,794,6,1458,454.452.381
30/06/2015 10:00,19.32,42305,606,31,29,780,8,1454,454.452.381
30/06/2015 11:00,19,42094,599,33,32,773,7,1444,454.452.381
30/06/2015 12:00,19.38,41908,589,35,33,754,8,1419,454.452.381
30/06/2015 13:00,19.71,41700,581,32,36,717,7,1373,454.452.381
30/06/2015 14:00,18.88,41271,569,31,39,715,7,1361,454.452.381
30/06/2015 15:00,17.43,40670,540,31,37,716,6,1330,454.452.381
30/06/2015 16:00,17.34,40147,494,30,35,716,5,1280,454.452.381
30/06/2015 17:00,17.62,39793,429,31,31,650,5,1146,454.452.381
30/06/2015 18:00,17.95,39369,359,31,29,595,4,1018,454.452.381
30/06/2015 19:00,17.78,38736,300,35,25,522,4,886,454.452.381
30/06/2015 20:00,17.02,37799,232,41,21,508,4,806,454.452.381
30/06/2015 21:00,16.43,37116,173,48,19,470,3,713,454.452.381
30/06/2015 22:00,15.68,36449,144,51,16,479,3,693,454.452.381
30/06/2015 23:00,14.83,34972,130,49,18,406,2,605,454.452.381
01/07/2015 00:00,13.34,33317,94,51,14,430,2,591,454.452.381
01/07/2015 01:00,12.71,32152,92,54,11,427,2,586,454.452.381
01/07/2015 02:00,12.15,31496,98,56,10,391,3,558,454.452.381
01/07/2015 03:00,11.76,31166,115,58,11,346,3,533,454.452.381
01/07/2015 04:00,11.84,31254,149,60,11,328,3,551,454.452.381
01/07/2015 05:00,13.14,32657,180,63,11,257,4,515,454.452.381
01/07/2015 06:00,15.18,35853,191,66,14,188,6,465,454.452.381
01/07/2015 07:00,18.33,39169,177,68,18,151,8,422,454.452.381
01/07/2015 08:00,19.96,40641,171,72,20,143,9,415,454.452.381
01/07/2015 09:00,20.18,41149,171,76,26,185,9,467,454.452.381
01/07/2015 10:00,21.5,41395,180,78,34,222,12,526,454.452.381
01/07/2015 11:00,20,41435,212,80,45,248,13,598,454.452.381
01/07/2015 12:00,19.25,41208,262,84,55,276,15,692,454.452.381
01/07/2015 13:00,18.87,40953,339,84,61,298,14,796,454.452.381
01/07/2015 14:00,18.52,40574,442,87,63,315,14,921,454.452.381
01/07/2015 15:00,17.78,39935,566,87,64,309,11,1037,454.452.381
01/07/2015 16:00,16.69,39398,707,82,69,294,9,1161,454.452.381
01/07/2015 17:00,16.04,39007,825,71,64,275,8,1243,454.452.381
01/07/2015 18:00,15.84,38517,899,61,59,273,7,1299,454.452.381
01/07/2015 19:00,15.24,37935,926,56,55,300,5,1342,454.452.381
01/07/2015 20:00,14.47,37069,933,54,48,345,4,1384,454.452.381
01/07/2015 21:00,14.05,36507,992,53,44,413,3,1505,454.452.381
01/07/2015 22:00,13.38,35865,1112,50,41,480,0,1683,454.452.381
01/07/2015 23:00,12.35,34390,1255,51,34,533,2,1875,454.452.381
02/07/2015 00:00,10.57,32697,1436,44,29,577,2,2088,454.452.381
02/07/2015 01:00,9.03,31601,1523,38,24,637,2,2224,454.452.381
02/07/2015 02:00,7.77,30988,1633,35,20,660,3,2351,454.452.381
02/07/2015 03:00,6.94,30666,1698,29,18,675,3,2423,454.452.381
02/07/2015 04:00,6.8,30678,1698,20,17,668,3,2406,454.452.381
02/07/2015 05:00,9.23,32096,1646,11,14,615,3,2289,454.452.381
02/07/2015 06:00,12.47,35373,1579,7,8,490,4,2088,454.452.381
02/07/2015 07:00,13.76,38699,1572,7,7,382,5,1973,454.452.381
02/07/2015 08:00,14.53,39905,1636,9,9,339,5,1998,454.452.381
02/07/2015 09:00,14.6,40537,1771,10,11,403,5,2200,454.452.381
02/07/2015 10:00,14.59,40942,2016,10,12,510,7,2555,454.452.381
02/07/2015 11:00,14.37,41036,2332,11,14,631,7,2995,454.452.381
02/07/2015 12:00,13.8,40813,2626,12,17,751,8,3414,454.452.381
02/07/2015 13:00,13.49,40509,2883,12,23,851,8,3777,454.452.381
02/07/2015 14:00,13.32,40154,3030,13,28,949,8,4028,454.452.381
02/07/2015 15:00,12.6,39591,3029,14,30,1016,7,4096,454.452.381
02/07/2015 16:00,12.09,39036,2990,14,27,1035,6,4072,454.452.381
02/07/2015 17:00,12.37,38644,2915,14,22,1005,6,3962,454.452.381
02/07/2015 18:00,12.83,38111,2776,13,21,999,4,3813,454.452.381
02/07/2015 19:00,12.89,37492,2609,14,17,1023,5,3668,454.452.381
02/07/2015 20:00,12.6,36603,2485,17,15,1120,3,3640,454.452.381
02/07/2015 21:00,11.58,35986,2436,22,14,1196,3,3671,454.452.381
02/07/2015 22:00,10.8,35223,2420,28,13,1273,4,3738,454.452.381
02/07/2015 23:00,8.78,33752,2380,37,16,1482,2,3917,454.452.381
03/07/2015 00:00,4.95,32195,2323,49,18,1619,2,4011,454.452.381
03/07/2015 01:00,4.79,31068,2142,58,18,1737,2,3957,454.452.381
03/07/2015 02:00,4.41,30413,1973,63,17,1806,2,3861,454.452.381
03/07/2015 03:00,4.27,30084,1735,65,16,1830,3,3649,454.452.381
03/07/2015 04:00,4.34,30116,1520,60,14,1703,3,3300,454.452.381
03/07/2015 05:00,5.1,31503,1422,56,10,1487,3,2978,454.452.381
03/07/2015 06:00,10.14,34561,1316,55,5,1171,4,2551,454.452.381
03/07/2015 07:00,13.25,37827,1212,60,4,1088,5,2369,454.452.381
03/07/2015 08:00,14.23,40213,1044,70,3,1004,5,2126,454.452.381
03/07/2015 09:00,14.72,40560,810,83,3,969,5,1870,454.452.381
03/07/2015 10:00,15.06,41137,705,99,3,1062,6,1875,454.452.381
03/07/2015 11:00,14.92,40683,677,113,4,1123,6,1923,454.452.381
03/07/2015 12:00,14.47,39822,606,121,7,1231,6,1971,454.452.381
03/07/2015 13:00,13.85,39197,526,122,8,1361,5,2022,454.452.381
03/07/2015 14:00,13.82,38577,461,115,7,1410,4,1997,454.452.381
03/07/2015 15:00,13.58,37888,397,109,6,1525,5,2042,454.452.381
03/07/2015 16:00,13.47,37391,354,101,5,1577,5,2042,454.452.381
03/07/2015 17:00,13.36,37095,337,93,5,1555,5,1995,454.452.381
03/07/2015 18:00,13.51,36612,338,91,6,1473,4,1912,454.452.381
03/07/2015 19:00,13.53,35858,348,92,7,1447,4,1898,454.452.381
03/07/2015 20:00,12.74,34729,304,95,9,1441,3,1852,454.452.381
03/07/2015 21:00,12.26,33980,221,99,11,1449,4,1784,454.452.381
03/07/2015 22:00,11.95,33581,201,99,15,1554,2,1871,454.452.381
03/07/2015 23:00,10.71,32560,189,113,27,1703,3,2035,454.452.381
04/07/2015 00:00,9.55,31592,65,111,38,1591,3,1808,454.452.381
04/07/2015 01:00,9.16,30428,62,110,43,1552,3,1770,454.452.381
04/07/2015 02:00,8.94,29611,64,110,42,1483,3,1702,454.452.381
04/07/2015 03:00,8.56,29047,74,106,40,1396,2,1618,454.452.381
04/07/2015 04:00,8.22,28662,93,96,32,1296,3,1520,454.452.381
04/07/2015 05:00,8.39,28877,105,84,20,1267,3,1479,454.452.381
04/07/2015 06:00,8.22,29659,97,71,14,1181,4,1367,454.452.381
04/07/2015 07:00,9.23,31221,82,65,14,1071,6,1238,454.452.381
04/07/2015 08:00,9.3,33190,79,64,17,988,6,1154,454.452.381
04/07/2015 09:00,10.68,34805,84,65,19,946,6,1120,454.452.381
04/07/2015 10:00,11.41,35660,92,66,21,901,7,1087,454.452.381
04/07/2015 11:00,11.51,35825,114,66,21,858,6,1065,454.452.381
04/07/2015 12:00,11.12,35511,139,70,18,790,7,1024,454.452.381
04/07/2015 13:00,10.24,35089,171,72,15,763,7,1028,454.452.381
04/07/2015 14:00,9.53,34746,197,71,13,774,8,1063,454.452.381
04/07/2015 15:00,9.39,34454,212,70,12,763,8,1065,454.452.381
04/07/2015 16:00,9.99,34498,221,73,11,746,5,1056,454.452.381
04/07/2015 17:00,11.13,34741,217,75,10,719,4,1025,454.452.381
04/07/2015 18:00,11.72,34771,249,71,9,666,3,998,454.452.381
04/07/2015 19:00,11.26,34357,297,69,6,675,3,1050,454.452.381
04/07/2015 20:00,10.21,33584,324,68,6,656,1,1055,454.452.381
04/07/2015 21:00,9.95,33256,399,68,6,644,1,1118,454.452.381
04/07/2015 22:00,10.62,33082,471,65,5,628,1,1170,454.452.381
04/07/2015 23:00,9.57,32266,485,82,2,621,1,1191,454.452.381
05/07/2015 00:00,10.28,30747,292,81,1,614,1,989,454.452.381
05/07/2015 01:00,10.05,29850,295,80,1,607,1,984,454.452.381
05/07/2015 02:00,9.53,29198,284,75,1,598,1,959,454.452.381
05/07/2015 03:00,9.14,28664,267,69,2,546,1,885,454.452.381
05/07/2015 04:00,8.95,28232,253,57,2,475,1,788,454.452.381
05/07/2015 05:00,8.83,28235,219,46,2,351,1,619,454.452.381
05/07/2015 06:00,9.48,28794,183,39,3,256,1,482,454.452.381
05/07/2015 07:00,9.98,29948,160,34,2,208,5,409,454.452.381
05/07/2015 08:00,9.55,31466,142,31,2,177,5,357,454.452.381
05/07/2015 09:00,11.31,32965,131,28,2,164,5,330,454.452.381
05/07/2015 10:00,12.29,34155,136,26,4,165,5,336,454.452.381
05/07/2015 11:00,12.54,34607,151,27,7,195,3,383,454.452.381
05/07/2015 12:00,12.66,34473,138,27,10,210,3,388,454.452.381
05/07/2015 13:00,12.35,34243,133,28,13,213,3,390,454.452.381
05/07/2015 14:00,12.07,34086,121,28,14,246,5,414,454.452.381
05/07/2015 15:00,11.8,34060,96,28,14,309,5,452,454.452.381
05/07/2015 16:00,12.19,34282,98,25,12,371,2,508,454.452.381
05/07/2015 17:00,12.68,34606,120,20,9,460,1,610,454.452.381
05/07/2015 18:00,13.26,34759,161,16,10,595,1,783,454.452.381
05/07/2015 19:00,13.47,34765,218,13,9,717,3,960,454.452.381
05/07/2015 20:00,13.06,34455,293,12,9,851,1,1166,454.452.381
05/07/2015 21:00,12.24,34221,342,12,10,987,1,1352,454.452.381
05/07/2015 22:00,12,33964,319,11,12,1137,1,1480,454.452.381
05/07/2015 23:00,10.86,32730,335,12,38,1326,2,1713,454.452.381
06/07/2015 00:00,10.77,31072,629,14,45,1406,3,2097,5.070.535.714
06/07/2015 01:00,9.41,30103,886,16,53,1436,3,2394,5.070.535.714
06/07/2015 02:00,8.64,29579,1188,18,61,1483,3,2753,5.070.535.714
06/07/2015 03:00,7.19,29308,1601,19,68,1560,2,3250,5.070.535.714
06/07/2015 04:00,6.1,29513,2113,18,64,1577,7,3779,5.070.535.714
06/07/2015 05:00,8.74,31238,2462,14,55,1611,6,4148,5.070.535.714
06/07/2015 06:00,11.12,34593,2692,12,51,1732,7,4494,5.070.535.714
06/07/2015 07:00,12.44,37941,2990,12,46,1907,8,4963,5.070.535.714
06/07/2015 08:00,13.49,39987,3190,16,44,2022,9,5281,5.070.535.714
06/07/2015 09:00,13.85,40688,3312,21,48,2263,14,5658,5.070.535.714
06/07/2015 10:00,13.93,41122,3491,28,49,2478,17,6063,5.070.535.714
06/07/2015 11:00,13.58,41202,3635,36,50,2750,17,6488,5.070.535.714
06/07/2015 12:00,13.01,40979,3662,43,59,2958,26,6748,5.070.535.714
06/07/2015 13:00,12.5,40841,3661,51,64,3163,27,6966,5.070.535.714
06/07/2015 14:00,11.94,40588,3685,60,86,3280,31,7142,5.070.535.714
06/07/2015 15:00,11.44,40081,3710,67,113,3324,34,7248,5.070.535.714
06/07/2015 16:00,10.67,39597,3700,77,139,3306,35,7257,5.070.535.714
06/07/2015 17:00,10.97,39367,3578,84,151,3263,32,7108,5.070.535.714
06/07/2015 18:00,11.13,38866,3375,88,152,3189,35,6839,5.070.535.714
06/07/2015 19:00,11.18,38190,3146,92,159,3104,38,6539,5.070.535.714
06/07/2015 20:00,11,37303,2832,97,158,3060,37,6184,5.070.535.714
06/07/2015 21:00,11.1,36711,2493,112,159,3006,36,5806,5.070.535.714
06/07/2015 22:00,10.92,36013,2217,116,161,2986,17,5497,5.070.535.714
06/07/2015 23:00,9.55,34449,2086,137,155,3016,16,5410,5.070.535.714
07/07/2015 00:00,5.75,32534,1839,159,148,3007,12,5165,5.070.535.714
07/07/2015 01:00,5.93,31384,1732,169,144,2970,13,5028,5.070.535.714
07/07/2015 02:00,5.16,30798,1582,160,141,2961,13,4857,5.070.535.714
07/07/2015 03:00,5.1,30452,1421,160,137,2938,0,4656,5.070.535.714
07/07/2015 04:00,4.77,30484,1274,160,132,2880,20,4466,5.070.535.714
07/07/2015 05:00,7.78,31953,1210,159,140,2896,22,4427,5.070.535.714
07/07/2015 06:00,10.29,34954,1234,161,147,2866,24,4432,5.070.535.714
07/07/2015 07:00,12.21,38291,1278,163,154,2832,24,4451,5.070.535.714
07/07/2015 08:00,12.58,39493,1278,171,160,2748,24,4381,5.070.535.714
07/07/2015 09:00,12.99,40267,1228,182,179,2679,25,4293,5.070.535.714
07/07/2015 10:00,13.75,40796,1196,192,186,2657,26,4257,5.070.535.714
07/07/2015 11:00,13.8,40855,1155,196,189,2591,26,4157,5.070.535.714
07/07/2015 12:00,13.45,40694,1061,199,191,2545,26,4022,5.070.535.714
07/07/2015 13:00,12.85,40604,993,196,191,2491,25,3896,5.070.535.714
07/07/2015 14:00,12.56,40353,925,191,182,2413,25,3736,5.070.535.714
07/07/2015 15:00,12.39,39835,837,184,164,2262,24,3471,5.070.535.714
07/07/2015 16:00,12.47,39385,765,179,150,2089,24,3207,5.070.535.714
07/07/2015 17:00,12.79,39112,642,169,122,1849,24,2806,5.070.535.714
07/07/2015 18:00,12.91,38779,590,159,92,1671,19,2531,5.070.535.714
07/07/2015 19:00,12.88,38193,634,149,63,1414,20,2280,5.070.535.714
07/07/2015 20:00,12.28,37276,691,139,46,1211,15,2102,5.070.535.714
07/07/2015 21:00,12.01,36683,782,129,32,1078,13,2034,5.070.535.714
07/07/2015 22:00,11.57,36067,950,112,23,1010,11,2106,5.070.535.714
07/07/2015 23:00,10.67,34596,1137,106,11,1068,5,2327,5.070.535.714
08/07/2015 00:00,8.12,32908,1184,89,9,1058,3,2343,5.070.535.714
08/07/2015 01:00,6.88,31913,1510,72,15,1014,1,2612,5.070.535.714
08/07/2015 02:00,6.11,31354,1773,57,24,1005,1,2860,5.070.535.714
08/07/2015 03:00,5.28,30990,1909,46,36,1034,0,3025,5.070.535.714
08/07/2015 04:00,4.93,30993,2125,33,49,1074,1,3282,5.070.535.714
08/07/2015 05:00,6.85,32228,2359,26,61,1139,4,3589,5.070.535.714
08/07/2015 06:00,8.81,34899,2571,25,60,1179,6,3841,5.070.535.714
08/07/2015 07:00,10.13,38023,2827,25,57,1248,8,4165,5.070.535.714
08/07/2015 08:00,11.38,40049,3055,30,52,1328,9,4474,5.070.535.714
08/07/2015 09:00,11.63,40656,3201,32,49,1444,9,4735,5.070.535.714
08/07/2015 10:00,11.84,40942,3285,33,52,1590,11,4971,5.070.535.714
08/07/2015 11:00,11.49,40973,3345,37,66,1734,15,5197,5.070.535.714
08/07/2015 12:00,10.98,40884,3372,40,85,1869,19,5385,5.070.535.714
08/07/2015 13:00,10.72,40727,3337,43,116,1990,26,5512,5.070.535.714
08/07/2015 14:00,10.32,40522,3274,49,107,2036,28,5494,5.070.535.714
08/07/2015 15:00,9.81,39972,3239,57,97,2059,32,5484,5.070.535.714
08/07/2015 16:00,9.52,39514,3189,63,86,2024,38,5400,5.070.535.714
08/07/2015 17:00,9.36,39268,3100,70,79,1960,40,5249,5.070.535.714
08/07/2015 18:00,9.5,38921,3028,81,71,1937,37,5154,5.070.535.714
08/07/2015 19:00,8.97,38313,3079,89,65,1885,29,5147,5.070.535.714
08/07/2015 20:00,8.2,37445,3258,94,73,1868,25,5318,5.070.535.714
08/07/2015 21:00,7.86,36886,3449,100,83,1829,20,5481,5.070.535.714
08/07/2015 22:00,7.76,36285,3591,99,94,1842,19,5645,5.070.535.714
08/07/2015 23:00,5.49,34899,3659,122,89,1801,10,5681,5.070.535.714
09/07/2015 00:00,4.35,32944,3712,121,94,1831,13,5771,5.070.535.714
09/07/2015 01:00,3.96,31843,3757,118,100,1863,14,5852,5.070.535.714
09/07/2015 02:00,3.58,31286,3778,112,104,1886,15,5895,5.070.535.714
09/07/2015 03:00,3.31,31033,3780,109,107,1932,14,5942,5.070.535.714
09/07/2015 04:00,3.3,31049,3756,107,110,2019,12,6004,5.070.535.714
09/07/2015 05:00,4,32287,3753,111,122,2083,16,6085,5.070.535.714
09/07/2015 06:00,5.43,34986,3788,116,134,2197,17,6252,5.070.535.714
09/07/2015 07:00,7.18,37985,3827,118,144,2275,22,6386,5.070.535.714
09/07/2015 08:00,7.76,39378,3829,121,145,2380,26,6501,5.070.535.714
09/07/2015 09:00,8.39,40315,3770,126,146,2519,28,6589,5.070.535.714
09/07/2015 10:00,8.6,40958,3733,126,149,2577,29,6614,5.070.535.714
09/07/2015 11:00,8.58,41154,3774,122,153,2665,26,6740,5.070.535.714
09/07/2015 12:00,8.39,41064,3851,121,159,2701,31,6863,5.070.535.714
09/07/2015 13:00,8.15,40844,3925,122,160,2762,32,7001,5.070.535.714
09/07/2015 14:00,7.91,40501,3965,120,161,2784,31,7061,5.070.535.714
09/07/2015 15:00,7.17,39950,4003,118,160,2846,30,7157,5.070.535.714
09/07/2015 16:00,7.03,39471,4039,115,157,2806,29,7146,5.070.535.714
09/07/2015 17:00,7.19,39255,4112,112,153,2803,27,7207,5.070.535.714
09/07/2015 18:00,7.02,38889,4196,110,148,2781,21,7256,5.070.535.714
09/07/2015 19:00,6.57,38290,4229,105,144,2744,17,7239,5.070.535.714
09/07/2015 20:00,6.07,37425,4223,101,148,2792,12,7276,5.070.535.714
09/07/2015 21:00,5.71,36893,4205,97,152,2841,12,7307,5.070.535.714
09/07/2015 22:00,5.46,36209,4174,92,157,2895,7,7325,5.070.535.714
09/07/2015 23:00,4.5,34894,4142,70,155,3005,8,7380,5.070.535.714
10/07/2015 00:00,3.86,32898,4164,66,157,3017,6,7410,5.070.535.714
10/07/2015 01:00,3.54,31847,4130,60,148,3055,4,7397,5.070.535.714
10/07/2015 02:00,3.27,31305,4086,54,152,3058,7,7357,5.070.535.714
10/07/2015 03:00,3.06,30961,4050,49,158,3108,9,7374,5.070.535.714
10/07/2015 04:00,3.06,30916,4018,43,164,3079,9,7313,5.070.535.714
10/07/2015 05:00,3.71,32111,3974,32,162,3067,20,7255,5.070.535.714
10/07/2015 06:00,5,34810,3936,22,160,3103,27,7248,5.070.535.714
10/07/2015 07:00,6.54,37837,3925,17,157,3136,29,7264,5.070.535.714
10/07/2015 08:00,7.47,39540,3936,13,150,3174,27,7300,5.070.535.714
10/07/2015 09:00,7.97,40336,3942,13,143,3196,27,7321,5.070.535.714
10/07/2015 10:00,8.12,41272,3912,15,145,3193,28,7293,5.070.535.714
10/07/2015 11:00,8,41030,3856,18,146,3253,28,7301,5.070.535.714
10/07/2015 12:00,7.66,40393,3775,18,138,3174,28,7133,5.070.535.714
10/07/2015 13:00,7.43,39871,3646,18,141,3080,29,6914,5.070.535.714
10/07/2015 14:00,7.1,39322,3503,18,152,2947,29,6649,5.070.535.714
10/07/2015 15:00,6.74,38626,3370,19,152,2847,29,6417,5.070.535.714
10/07/2015 16:00,6.97,38170,3218,22,149,2692,27,6108,5.070.535.714
10/07/2015 17:00,7.21,37931,3006,23,137,2457,26,5649,5.070.535.714
10/07/2015 18:00,6.95,37634,2722,25,121,2311,26,5205,5.070.535.714
10/07/2015 19:00,7,36930,2397,26,107,2198,20,4748,5.070.535.714
10/07/2015 20:00,7.24,35894,2017,30,98,2075,16,4236,5.070.535.714
10/07/2015 21:00,7.37,35225,1617,35,92,2020,14,3778,5.070.535.714
10/07/2015 22:00,8.08,34834,1291,37,88,1950,12,3378,5.070.535.714
10/07/2015 23:00,7.9,33822,1075,36,86,1925,9,3131,5.070.535.714
11/07/2015 00:00,7.4,32579,918,35,96,1894,9,2952,5.070.535.714
11/07/2015 01:00,6.98,31473,795,35,105,1836,6,2777,5.070.535.714
11/07/2015 02:00,6.76,30751,692,35,104,1733,5,2569,5.070.535.714
11/07/2015 03:00,6.57,30214,633,36,103,1679,5,2456,5.070.535.714
11/07/2015 04:00,6.18,29814,576,33,102,1550,9,2270,5.070.535.714
11/07/2015 05:00,6.48,29913,492,32,102,1372,13,2011,5.070.535.714
11/07/2015 06:00,6.77,30635,397,32,103,1115,19,1666,5.070.535.714
11/07/2015 07:00,8.12,31887,333,32,104,907,22,1398,5.070.535.714
11/07/2015 08:00,8.95,33206,290,34,105,740,20,1189,5.070.535.714
11/07/2015 09:00,10.18,34909,239,38,106,623,18,1024,5.070.535.714
11/07/2015 10:00,11.32,36033,187,42,110,551,14,904,5.070.535.714
11/07/2015 11:00,11.75,36237,167,49,121,496,11,844,5.070.535.714
11/07/2015 12:00,11.42,35991,166,54,131,427,13,791,5.070.535.714
11/07/2015 13:00,10.29,35590,177,56,137,405,13,788,5.070.535.714
11/07/2015 14:00,9.42,35273,181,58,140,377,16,772,5.070.535.714
11/07/2015 15:00,9.24,35024,181,58,139,366,15,759,5.070.535.714
11/07/2015 16:00,9.24,35005,190,53,136,360,13,752,5.070.535.714
11/07/2015 17:00,10.38,35192,183,46,113,378,12,732,5.070.535.714
11/07/2015 18:00,10.78,35184,165,39,91,361,10,666,5.070.535.714
11/07/2015 19:00,11.03,34704,152,36,74,379,7,648,5.070.535.714
11/07/2015 20:00,10.48,34054,150,35,58,366,5,614,5.070.535.714
11/07/2015 21:00,9.6,33703,142,36,50,384,5,617,5.070.535.714
11/07/2015 22:00,9.47,33506,149,35,49,438,5,676,5.070.535.714
11/07/2015 23:00,8.69,32695,176,34,53,425,3,691,5.070.535.714
12/07/2015 00:00,8.21,31320,237,31,53,434,3,758,5.070.535.714
12/07/2015 01:00,7.5,30484,248,30,52,437,4,771,5.070.535.714
12/07/2015 02:00,6.64,29926,266,31,49,427,4,777,5.070.535.714
12/07/2015 03:00,6.18,29351,270,33,46,406,4,759,5.070.535.714
12/07/2015 04:00,5.71,28941,267,35,43,381,3,729,5.070.535.714
12/07/2015 05:00,5.71,28887,254,35,40,327,2,658,5.070.535.714
12/07/2015 06:00,6.15,29344,241,37,39,290,4,611,5.070.535.714
12/07/2015 07:00,7.03,30361,251,40,40,245,10,586,5.070.535.714
12/07/2015 08:00,8.08,31735,250,45,47,236,8,586,5.070.535.714
12/07/2015 09:00,8.84,32831,239,53,54,219,7,572,5.070.535.714
12/07/2015 10:00,9.55,33881,269,56,59,217,7,608,5.070.535.714
12/07/2015 11:00,10.19,34337,312,55,63,242,5,677,5.070.535.714
12/07/2015 12:00,9.53,34290,338,55,69,272,6,740,5.070.535.714
12/07/2015 13:00,9.11,34062,400,54,79,255,7,795,5.070.535.714
12/07/2015 14:00,8.9,33904,484,49,75,254,9,871,5.070.535.714
12/07/2015 15:00,8.83,33807,539,42,68,257,9,915,5.070.535.714
12/07/2015 16:00,8.94,33953,573,32,53,273,8,939,5.070.535.714
12/07/2015 17:00,9.41,34266,591,24,43,261,8,927,5.070.535.714
12/07/2015 18:00,9.86,34460,581,18,33,261,6,899,5.070.535.714
12/07/2015 19:00,10.16,34381,573,15,27,258,5,878,5.070.535.714
12/07/2015 20:00,9.93,34095,566,14,22,256,1,859,5.070.535.714
12/07/2015 21:00,9.77,33924,571,14,18,254,1,858,5.070.535.714
12/07/2015 22:00,9.43,33674,590,13,16,257,1,877,5.070.535.714
12/07/2015 23:00,8.67,32576,613,8,12,296,1,930,5.070.535.714
13/07/2015 00:00,8.41,30957,467,7,10,309,0,793,5.342.738.095
13/07/2015 01:00,7.82,29947,454,7,8,324,0,793,5.342.738.095
13/07/2015 02:00,7.4,29428,447,6,8,319,0,780,5.342.738.095
13/07/2015 03:00,7.11,29163,433,6,7,315,0,761,5.342.738.095
13/07/2015 04:00,7.02,29241,426,5,5,280,3,719,5.342.738.095
13/07/2015 05:00,8.25,30492,432,4,5,234,3,678,5.342.738.095
13/07/2015 06:00,10.87,33243,446,2,4,198,4,654,5.342.738.095
13/07/2015 07:00,12.4,36373,468,2,4,179,5,658,5.342.738.095
13/07/2015 08:00,13.89,38316,498,2,5,183,5,693,5.342.738.095
13/07/2015 09:00,15.08,39165,554,3,7,191,5,760,5.342.738.095
13/07/2015 10:00,15.38,39963,619,4,10,223,6,862,5.342.738.095
13/07/2015 11:00,15.31,39866,678,5,14,255,6,958,5.342.738.095
13/07/2015 12:00,14.7,39450,729,5,17,267,6,1024,5.342.738.095
13/07/2015 13:00,14.27,39250,786,6,17,296,6,1111,5.342.738.095
13/07/2015 14:00,13.86,38952,846,8,17,319,6,1196,5.342.738.095
13/07/2015 15:00,13.33,38567,930,10,18,328,5,1291,5.342.738.095
13/07/2015 16:00,12.43,38161,1022,11,18,328,5,1384,5.342.738.095
13/07/2015 17:00,12.26,37928,1070,11,16,338,5,1440,5.342.738.095
13/07/2015 18:00,12.22,37599,1032,10,16,350,4,1412,5.342.738.095
13/07/2015 19:00,11.97,37055,966,10,14,334,4,1328,5.342.738.095
13/07/2015 20:00,11.21,36228,885,11,13,341,3,1253,5.342.738.095
13/07/2015 21:00,11.2,35690,789,12,11,394,2,1208,5.342.738.095
13/07/2015 22:00,10.7,35037,746,11,10,431,1,1199,5.342.738.095
13/07/2015 23:00,9.22,33606,775,12,11,423,0,1221,5.342.738.095
14/07/2015 00:00,8.79,31437,446,11,11,460,0,928,5.342.738.095
14/07/2015 01:00,8.2,30522,491,10,9,453,0,963,5.342.738.095
14/07/2015 02:00,7.7,29977,510,9,7,427,0,953,5.342.738.095
14/07/2015 03:00,7.39,29658,518,9,6,396,0,929,5.342.738.095
14/07/2015 04:00,7.75,29629,538,7,4,345,3,897,5.342.738.095
14/07/2015 05:00,8.79,30862,558,5,3,289,3,858,5.342.738.095
14/07/2015 06:00,12.28,33460,588,4,3,232,4,831,5.342.738.095
14/07/2015 07:00,13.81,36512,637,3,3,200,5,848,5.342.738.095
14/07/2015 08:00,14.83,38053,703,4,3,194,5,909,5.342.738.095
14/07/2015 09:00,15.25,38971,771,5,4,210,5,995,5.342.738.095
14/07/2015 10:00,15.56,39437,830,6,5,226,6,1073,5.342.738.095
14/07/2015 11:00,15.42,39335,876,8,9,261,6,1160,5.342.738.095
14/07/2015 12:00,15.33,39165,910,9,13,301,6,1239,5.342.738.095
14/07/2015 13:00,14.93,39025,958,10,17,340,6,1331,5.342.738.095
14/07/2015 14:00,14.55,38730,1020,11,20,378,6,1435,5.342.738.095
14/07/2015 15:00,13.66,38318,1122,11,25,388,6,1552,5.342.738.095
14/07/2015 16:00,13.53,37993,1224,11,27,398,6,1666,5.342.738.095
14/07/2015 17:00,13.33,37720,1267,9,30,441,6,1753,5.342.738.095
14/07/2015 18:00,13.06,37313,1275,8,29,451,5,1768,5.342.738.095
14/07/2015 19:00,12.89,36732,1293,7,28,441,4,1773,5.342.738.095
14/07/2015 20:00,12.06,35950,1341,7,25,463,3,1839,5.342.738.095
14/07/2015 21:00,11.57,35434,1389,7,22,548,2,1968,5.342.738.095
14/07/2015 22:00,11.01,34916,1443,7,19,664,1,2134,5.342.738.095
14/07/2015 23:00,9.18,33589,1535,13,20,772,1,2341,5.342.738.095
15/07/2015 00:00,7.81,31285,1558,14,16,854,1,2443,5.342.738.095
15/07/2015 01:00,6.19,30308,1640,16,12,914,1,2583,5.342.738.095
15/07/2015 02:00,5.75,29794,1709,18,9,933,0,2669,5.342.738.095
15/07/2015 03:00,5.43,29450,1775,19,8,904,1,2707,5.342.738.095
15/07/2015 04:00,5.3,29446,1832,15,7,862,2,2718,5.342.738.095
15/07/2015 05:00,5.97,30446,1861,9,6,811,3,2690,5.342.738.095
15/07/2015 06:00,8.67,32817,1908,5,5,742,4,2664,5.342.738.095
15/07/2015 07:00,11.12,35842,2029,4,6,679,6,2724,5.342.738.095
15/07/2015 08:00,12.23,37507,2153,5,9,606,6,2779,5.342.738.095
15/07/2015 09:00,12.84,38308,2219,7,12,584,6,2828,5.342.738.095
15/07/2015 10:00,12.72,38709,2272,10,17,584,5,2888,5.342.738.095
15/07/2015 11:00,12.74,38750,2301,15,27,588,4,2935,5.342.738.095
15/07/2015 12:00,12.39,38611,2305,19,40,634,4,3002,5.342.738.095
15/07/2015 13:00,11.91,38340,2294,23,49,679,5,3050,5.342.738.095
15/07/2015 14:00,11.46,38085,2285,24,54,754,5,3122,5.342.738.095
15/07/2015 15:00,11.08,37622,2275,24,55,819,5,3178,5.342.738.095
15/07/2015 16:00,11.41,37202,2241,23,52,856,6,3178,5.342.738.095
15/07/2015 17:00,11.81,36991,2165,19,47,899,6,3136,5.342.738.095
15/07/2015 18:00,12.26,36621,2053,15,35,925,4,3032,5.342.738.095
15/07/2015 19:00,11.88,36092,1911,13,29,919,5,2877,5.342.738.095
15/07/2015 20:00,11.77,35295,1711,12,24,949,4,2700,5.342.738.095
15/07/2015 21:00,11.58,34767,1508,11,19,1018,3,2559,5.342.738.095
15/07/2015 22:00,11.1,34261,1351,9,16,1070,1,2447,5.342.738.095
15/07/2015 23:00,10.04,32978,1247,10,15,1117,1,2390,5.342.738.095
16/07/2015 00:00,9.67,31275,1000,10,13,1147,0,2170,5.342.738.095
16/07/2015 01:00,8.7,30251,952,10,14,1193,0,2169,5.342.738.095
16/07/2015 02:00,8.18,29725,928,10,17,1197,1,2153,5.342.738.095
16/07/2015 03:00,7.89,29437,920,10,22,1176,1,2129,5.342.738.095
16/07/2015 04:00,7.37,29390,910,9,25,1138,3,2085,5.342.738.095
16/07/2015 05:00,8.57,30428,896,8,26,1035,3,1968,5.342.738.095
16/07/2015 06:00,10.82,32854,896,6,26,918,5,1851,5.342.738.095
16/07/2015 07:00,12.91,35713,933,6,32,874,7,1852,5.342.738.095
16/07/2015 08:00,14.23,37300,965,7,47,899,8,1926,5.342.738.095
16/07/2015 09:00,15.14,38273,950,9,55,959,10,1983,5.342.738.095
16/07/2015 10:00,15.36,38772,916,13,65,1024,11,2029,5.342.738.095
16/07/2015 11:00,15.32,38939,882,17,70,1119,11,2099,5.342.738.095
16/07/2015 12:00,15.29,38800,849,20,76,1197,15,2157,5.342.738.095
16/07/2015 13:00,14.93,38597,830,21,83,1280,18,2232,5.342.738.095
16/07/2015 14:00,14.45,38329,827,20,81,1347,18,2293,5.342.738.095
16/07/2015 15:00,14.1,37846,826,18,77,1431,17,2369,5.342.738.095
16/07/2015 16:00,14.01,37436,816,16,72,1494,15,2413,5.342.738.095
16/07/2015 17:00,14.24,37205,757,13,56,1487,14,2327,5.342.738.095
16/07/2015 18:00,14.2,36843,649,13,41,1490,11,2204,5.342.738.095
16/07/2015 19:00,13.4,36291,523,15,33,1482,8,2061,5.342.738.095
16/07/2015 20:00,12.46,35466,417,18,29,1547,7,2018,5.342.738.095
16/07/2015 21:00,11.64,34962,351,23,28,1618,6,2026,5.342.738.095
16/07/2015 22:00,12.34,34406,321,27,29,1692,4,2073,5.342.738.095
16/07/2015 23:00,10.76,33154,292,35,42,1729,3,2101,5.342.738.095
17/07/2015 00:00,9.27,31556,417,36,48,1767,2,2270,5.342.738.095
17/07/2015 01:00,8.31,30594,359,36,55,1779,2,2231,5.342.738.095
17/07/2015 02:00,7.08,30119,289,36,58,1755,2,2140,5.342.738.095
17/07/2015 03:00,6.44,29799,219,34,59,1749,2,2063,5.342.738.095
17/07/2015 04:00,6.04,29762,176,28,56,1655,4,1919,5.342.738.095
17/07/2015 05:00,8.28,30799,160,24,59,1517,7,1767,5.342.738.095
17/07/2015 06:00,10.6,33183,179,23,58,1364,13,1637,5.342.738.095
17/07/2015 07:00,12.47,35949,270,24,60,1184,22,1560,5.342.738.095
17/07/2015 08:00,13.31,37675,379,20,68,1001,24,1492,5.342.738.095
17/07/2015 09:00,13.89,38520,475,19,77,865,28,1464,5.342.738.095
17/07/2015 10:00,13.98,39009,634,23,87,730,30,1504,5.342.738.095
17/07/2015 11:00,13.54,38976,871,25,93,606,16,1611,5.342.738.095
17/07/2015 12:00,12.62,38587,1149,30,102,483,18,1782,5.342.738.095
17/07/2015 13:00,11.99,38105,1432,36,112,396,17,1993,5.342.738.095
17/07/2015 14:00,11.59,37644,1574,42,101,345,18,2080,5.342.738.095
17/07/2015 15:00,10.82,37014,1612,47,91,315,29,2094,5.342.738.095
17/07/2015 16:00,10.95,36591,1648,48,79,294,25,2094,5.342.738.095
17/07/2015 17:00,10.93,36428,1594,46,59,317,21,2037,5.342.738.095
17/07/2015 18:00,10.73,36085,1567,41,46,368,18,2040,5.342.738.095
17/07/2015 19:00,10.09,35419,1710,38,36,409,13,2206,5.342.738.095
17/07/2015 20:00,9.68,34451,1756,36,26,512,9,2339,5.342.738.095
17/07/2015 21:00,9.01,33904,1808,35,18,662,7,2530,5.342.738.095
17/07/2015 22:00,8.91,33591,1979,32,13,797,2,2823,5.342.738.095
17/07/2015 23:00,8.41,32565,2000,24,8,1109,1,3142,5.342.738.095
18/07/2015 00:00,7.6,30842,1854,19,5,1233,0,3111,5.342.738.095
18/07/2015 01:00,7.05,29856,1742,15,3,1323,0,3083,5.342.738.095
18/07/2015 02:00,6.64,29237,1627,12,3,1458,0,3100,5.342.738.095
18/07/2015 03:00,6.2,28790,1436,9,5,1607,0,3057,5.342.738.095
18/07/2015 04:00,5.29,28411,1265,6,10,1704,0,2985,5.342.738.095
18/07/2015 05:00,5.82,28456,1205,4,15,1734,1,2959,5.342.738.095
18/07/2015 06:00,6.67,29056,1307,4,17,1738,3,3069,5.342.738.095
18/07/2015 07:00,7.25,30593,1463,6,24,1768,5,3266,5.342.738.095
18/07/2015 08:00,8.1,32154,1638,10,37,1896,6,3587,5.342.738.095
18/07/2015 09:00,8.36,33473,1867,18,49,2044,11,3989,5.342.738.095
18/07/2015 10:00,8.37,34443,2110,25,58,2224,12,4429,5.342.738.095
18/07/2015 11:00,7.95,34639,2421,35,58,2396,15,4925,5.342.738.095
18/07/2015 12:00,7.08,34421,2689,42,58,2639,17,5445,5.342.738.095
18/07/2015 13:00,6.58,34050,2863,48,59,2808,24,5802,5.342.738.095
18/07/2015 14:00,5.85,33777,3008,52,59,2988,25,6132,5.342.738.095
18/07/2015 15:00,5.62,33579,3104,54,58,3039,23,6278,5.342.738.095
18/07/2015 16:00,5.67,33638,3161,57,54,2993,19,6284,5.342.738.095
18/07/2015 17:00,6.24,33881,3134,61,49,2939,17,6200,5.342.738.095
18/07/2015 18:00,6.87,33926,2964,64,41,2798,15,5882,5.342.738.095
18/07/2015 19:00,6.96,33534,2719,63,31,2676,10,5499,5.342.738.095
18/07/2015 20:00,7.18,32992,2449,62,23,2524,9,5067,5.342.738.095
18/07/2015 21:00,7.47,32700,2189,64,21,2533,7,4814,5.342.738.095
18/07/2015 22:00,8.12,32589,2015,65,23,2485,5,4593,5.342.738.095
18/07/2015 23:00,7.85,31765,1925,68,58,2509,7,4567,5.342.738.095
19/07/2015 00:00,7.4,30443,1888,66,68,2386,6,4414,5.342.738.095
19/07/2015 01:00,6.64,29629,1825,68,74,2269,5,4241,5.342.738.095
19/07/2015 02:00,6.09,29121,1725,67,68,2155,4,4019,5.342.738.095
19/07/2015 03:00,5.41,28625,1538,65,59,2064,4,3730,5.342.738.095
19/07/2015 04:00,4.99,28248,1331,67,48,2015,3,3464,5.342.738.095
19/07/2015 05:00,5.6,28192,1115,70,40,1959,9,3193,5.342.738.095
19/07/2015 06:00,7.01,28612,907,78,40,1943,14,2982,5.342.738.095
19/07/2015 07:00,7.81,29476,744,89,46,1900,18,2797,5.342.738.095
19/07/2015 08:00,8.96,30801,676,106,58,1813,21,2674,5.342.738.095
19/07/2015 09:00,9.79,32028,677,118,65,1758,24,2642,5.342.738.095
19/07/2015 10:00,10.68,32948,637,129,75,1698,25,2564,5.342.738.095
19/07/2015 11:00,10.81,33339,556,136,72,1614,27,2405,5.342.738.095
19/07/2015 12:00,10.4,33316,480,140,71,1525,28,2244,5.342.738.095
19/07/2015 13:00,10.23,33159,424,141,49,1444,26,2084,5.342.738.095
19/07/2015 14:00,10.16,33060,381,138,38,1350,26,1933,5.342.738.095
19/07/2015 15:00,10.76,33032,327,130,25,1228,20,1730,5.342.738.095
19/07/2015 16:00,11.04,33228,280,111,15,1094,16,1516,5.342.738.095
19/07/2015 17:00,11.05,33519,241,86,9,960,11,1307,5.342.738.095
19/07/2015 18:00,11.62,33671,217,67,11,854,6,1155,5.342.738.095
19/07/2015 19:00,11.53,33594,220,53,13,769,5,1060,5.342.738.095
19/07/2015 20:00,11.39,33370,233,45,22,731,3,1034,5.342.738.095
19/07/2015 21:00,11.24,33256,277,43,34,740,1,1095,5.342.738.095
19/07/2015 22:00,11.05,32973,386,42,49,730,0,1207,5.342.738.095
19/07/2015 23:00,9.87,31866,548,32,63,710,1,1354,5.342.738.095
20/07/2015 00:00,9.19,30440,857,27,57,751,1,1693,5.593.809.524
20/07/2015 01:00,8.48,29517,883,23,51,798,0,1755,5.593.809.524
20/07/2015 02:00,8.05,29036,924,18,60,815,2,1819,5.593.809.524
20/07/2015 03:00,7.55,28800,925,14,60,824,2,1825,5.593.809.524
20/07/2015 04:00,7.27,28853,958,10,59,840,3,1870,5.593.809.524
20/07/2015 05:00,8.42,29919,976,7,71,797,3,1854,5.593.809.524
20/07/2015 06:00,9.59,32412,993,6,89,757,5,1850,5.593.809.524
20/07/2015 07:00,10.66,35259,1021,6,110,753,6,1896,5.593.809.524
20/07/2015 08:00,11.94,37164,1025,8,121,775,6,1935,5.593.809.524
20/07/2015 09:00,11.93,38015,1038,9,133,848,7,2035,5.593.809.524
20/07/2015 10:00,12,38483,1086,11,148,901,7,2153,5.593.809.524
20/07/2015 11:00,11.93,38611,1134,15,147,925,10,2231,5.593.809.524
20/07/2015 12:00,11.61,38392,1159,19,153,997,16,2344,5.593.809.524
20/07/2015 13:00,11.3,38201,1197,22,193,1131,19,2562,5.593.809.524
20/07/2015 14:00,10.98,37885,1213,23,192,1186,21,2635,5.593.809.524
20/07/2015 15:00,10.78,37472,1170,28,185,1204,23,2610,5.593.809.524
20/07/2015 16:00,10.85,37080,1100,34,155,1162,26,2477,5.593.809.524
20/07/2015 17:00,11.55,36789,983,41,140,1105,25,2294,5.593.809.524
20/07/2015 18:00,11.98,36400,836,51,131,1065,22,2105,5.593.809.524
20/07/2015 19:00,12.03,35858,712,58,112,947,17,1846,5.593.809.524
20/07/2015 20:00,12,35060,556,64,97,914,10,1641,5.593.809.524
20/07/2015 21:00,11.75,34611,406,70,88,926,8,1498,5.593.809.524
20/07/2015 22:00,11.53,34074,336,69,81,920,5,1411,5.593.809.524
20/07/2015 23:00,10.66,32688,350,60,63,1011,4,1488,5.593.809.524
21/07/2015 00:00,9.54,30955,338,59,59,997,3,1456,5.593.809.524
21/07/2015 01:00,8.74,29959,515,58,49,963,3,1588,5.593.809.524
21/07/2015 02:00,8.01,29416,735,57,43,916,2,1753,5.593.809.524
21/07/2015 03:00,7.34,29134,1027,53,39,855,2,1976,5.593.809.524
21/07/2015 04:00,6.37,29125,1429,42,35,784,1,2291,5.593.809.524
21/07/2015 05:00,7.48,30132,1737,32,28,715,3,2515,5.593.809.524
21/07/2015 06:00,8.98,32389,1924,27,21,641,5,2618,5.593.809.524
21/07/2015 07:00,9.51,35075,2218,25,17,624,6,2890,5.593.809.524
21/07/2015 08:00,9.85,37071,2292,28,20,662,6,3008,5.593.809.524
21/07/2015 09:00,10.33,38072,2241,32,24,757,7,3061,5.593.809.524
21/07/2015 10:00,10.38,38652,2473,37,30,887,8,3435,5.593.809.524
21/07/2015 11:00,10.19,38687,2674,43,31,1037,9,3794,5.593.809.524
21/07/2015 12:00,9.94,38514,2734,50,30,1251,12,4077,5.593.809.524
21/07/2015 13:00,9.75,38285,2690,54,27,1421,12,4204,5.593.809.524
21/07/2015 14:00,9.53,37981,2609,55,24,1560,12,4260,5.593.809.524
21/07/2015 15:00,9.15,37595,2553,51,22,1616,11,4253,5.593.809.524
21/07/2015 16:00,9.3,37203,2468,48,20,1630,8,4174,5.593.809.524
21/07/2015 17:00,9.65,36916,2310,42,28,1594,7,3981,5.593.809.524
21/07/2015 18:00,9.94,36563,2048,34,42,1532,7,3663,5.593.809.524
21/07/2015 19:00,9.97,36004,1787,28,53,1470,10,3348,5.593.809.524
21/07/2015 20:00,9.96,35232,1557,25,56,1440,11,3089,5.593.809.524
21/07/2015 21:00,9.97,34697,1360,26,62,1445,10,2903,5.593.809.524
21/07/2015 22:00,10,34186,1265,32,70,1424,7,2798,5.593.809.524
21/07/2015 23:00,9.62,32822,1218,48,70,1386,6,2728,5.593.809.524
22/07/2015 00:00,8.87,31234,950,60,77,1350,4,2441,5.593.809.524
22/07/2015 01:00,8.3,30207,900,61,83,1312,4,2360,5.593.809.524
22/07/2015 02:00,7.88,29678,874,55,79,1295,4,2307,5.593.809.524
22/07/2015 03:00,7.58,29331,849,55,74,1251,5,2234,5.593.809.524
22/07/2015 04:00,7.18,29300,801,62,67,1189,6,2125,5.593.809.524
22/07/2015 05:00,8.12,30209,750,75,66,1078,15,1984,5.593.809.524
22/07/2015 06:00,9.78,32318,688,86,66,1006,17,1863,5.593.809.524
22/07/2015 07:00,10.44,34998,639,99,55,963,19,1775,5.593.809.524
22/07/2015 08:00,10.95,37189,609,109,64,973,21,1776,5.593.809.524
22/07/2015 09:00,11.58,37888,574,118,74,987,25,1778,5.593.809.524
22/07/2015 10:00,11.93,38263,546,124,86,1020,27,1803,5.593.809.524
22/07/2015 11:00,11.67,38272,551,126,93,1084,28,1882,5.593.809.524
22/07/2015 12:00,11.24,38098,581,129,101,1131,29,1971,5.593.809.524
22/07/2015 13:00,10.96,37797,626,128,107,1139,28,2028,5.593.809.524
22/07/2015 14:00,10.8,37530,663,125,95,1137,25,2045,5.593.809.524
22/07/2015 15:00,10.72,37072,667,122,81,1127,22,2019,5.593.809.524
22/07/2015 16:00,10.75,36640,663,115,69,1097,23,1967,5.593.809.524
22/07/2015 17:00,11.12,36342,640,104,63,973,17,1797,5.593.809.524
22/07/2015 18:00,11.44,36010,599,88,41,865,11,1604,5.593.809.524
22/07/2015 19:00,11.6,35507,560,75,30,788,10,1463,5.593.809.524
22/07/2015 20:00,11.27,34769,552,65,23,749,9,1398,5.593.809.524
22/07/2015 21:00,11.19,34389,588,58,19,739,8,1412,5.593.809.524
22/07/2015 22:00,11.15,33929,650,42,17,748,5,1462,5.593.809.524
22/07/2015 23:00,10.34,32595,756,52,16,808,5,1637,5.593.809.524
23/07/2015 00:00,8.96,31085,1441,48,16,872,5,2382,5.593.809.524
23/07/2015 01:00,8.38,30055,1774,44,15,905,3,2741,5.593.809.524
23/07/2015 02:00,7.76,29512,1861,41,18,957,4,2881,5.593.809.524
23/07/2015 03:00,7.2,29255,1772,36,28,975,3,2814,5.593.809.524
23/07/2015 04:00,7.04,29220,1668,29,35,991,5,2728,5.593.809.524
23/07/2015 05:00,8.37,30131,1580,23,29,1037,4,2673,5.593.809.524
23/07/2015 06:00,9.54,32315,1552,19,21,1086,5,2683,5.593.809.524
23/07/2015 07:00,9.94,34889,1609,21,16,1171,7,2824,5.593.809.524
23/07/2015 08:00,10.57,36633,1705,26,12,1280,8,3031,5.593.809.524
23/07/2015 09:00,10.76,37507,1744,34,13,1379,9,3179,5.593.809.524
23/07/2015 10:00,10.98,38035,1761,41,18,1532,10,3362,5.593.809.524
23/07/2015 11:00,10.89,38101,1775,48,28,1652,12,3515,5.593.809.524
23/07/2015 12:00,10.71,37940,1816,57,41,1725,14,3653,5.593.809.524
23/07/2015 13:00,10.38,37671,1844,60,57,1813,17,3791,5.593.809.524
23/07/2015 14:00,10.16,37297,1814,60,67,1854,22,3817,5.593.809.524
23/07/2015 15:00,9.97,36837,1804,58,76,1888,23,3849,5.593.809.524
23/07/2015 16:00,9.98,36409,1751,57,83,1920,24,3835,5.593.809.524
23/07/2015 17:00,10.1,36192,1662,57,83,1883,23,3708,5.593.809.524
23/07/2015 18:00,10.37,35914,1539,60,76,1833,16,3524,5.593.809.524
23/07/2015 19:00,10.46,35417,1401,63,58,1753,15,3290,5.593.809.524
23/07/2015 20:00,10.22,34694,1233,64,51,1727,13,3088,5.593.809.524
23/07/2015 21:00,10.48,34327,1036,67,49,1709,11,2872,5.593.809.524
23/07/2015 22:00,10.5,33805,913,72,49,1686,9,2729,5.593.809.524
23/07/2015 23:00,9.79,32502,836,86,75,1778,7,2782,5.593.809.524
24/07/2015 00:00,9.19,31104,682,92,79,1763,5,2621,5.593.809.524
24/07/2015 01:00,8.69,30076,640,95,83,1711,5,2534,5.593.809.524
24/07/2015 02:00,8.27,29558,597,98,76,1667,4,2442,5.593.809.524
24/07/2015 03:00,8.07,29249,571,104,68,1629,4,2376,5.593.809.524
24/07/2015 04:00,7.99,29194,514,111,61,1555,4,2245,5.593.809.524
24/07/2015 05:00,8.91,30149,464,117,57,1423,8,2069,5.593.809.524
24/07/2015 06:00,9.92,32351,433,121,51,1302,20,1927,5.593.809.524
24/07/2015 07:00,10.52,35000,418,127,50,1220,23,1838,5.593.809.524
24/07/2015 08:00,11.43,36744,413,134,53,1195,22,1817,5.593.809.524
24/07/2015 09:00,11.9,37668,419,141,55,1159,21,1795,5.593.809.524
24/07/2015 10:00,12.38,38182,437,147,58,1152,22,1816,5.593.809.524
24/07/2015 11:00,11.9,38148,446,152,59,1168,22,1847,5.593.809.524
24/07/2015 12:00,11.73,37730,416,155,55,1225,25,1876,5.593.809.524
24/07/2015 13:00,11.24,37262,374,155,48,1255,26,1858,5.593.809.524
24/07/2015 14:00,10.97,36786,317,149,39,1268,26,1799,5.593.809.524
24/07/2015 15:00,10.67,36199,250,138,31,1240,22,1681,5.593.809.524
24/07/2015 16:00,10.62,35804,202,127,24,1204,19,1576,5.593.809.524
24/07/2015 17:00,10.68,35629,161,109,18,1112,16,1416,5.593.809.524
24/07/2015 18:00,10.85,35391,143,91,14,1012,13,1273,5.593.809.524
24/07/2015 19:00,10.68,34797,166,80,9,908,9,1172,5.593.809.524
24/07/2015 20:00,10.37,33877,189,71,7,866,7,1140,5.593.809.524
24/07/2015 21:00,10.1,33438,223,69,7,876,6,1181,5.593.809.524
24/07/2015 22:00,10.01,33127,300,66,7,861,1,1235,5.593.809.524
24/07/2015 23:00,9.54,32024,421,65,6,852,2,1346,5.593.809.524
25/07/2015 00:00,8.2,30803,769,64,7,817,2,1659,5.593.809.524
25/07/2015 01:00,7.48,29800,988,61,11,800,2,1862,5.593.809.524
25/07/2015 02:00,6.34,29213,1205,56,18,818,1,2098,5.593.809.524
25/07/2015 03:00,5.63,28807,1464,48,29,843,1,2385,5.593.809.524
25/07/2015 04:00,4.91,28441,1734,37,40,855,1,2667,5.593.809.524
25/07/2015 05:00,4.66,28530,2037,25,44,887,1,2994,5.593.809.524
25/07/2015 06:00,4.52,29101,2385,16,41,870,3,3315,5.593.809.524
25/07/2015 07:00,5.8,30107,2713,12,40,914,4,3683,5.593.809.524
25/07/2015 08:00,7.14,31697,2882,13,44,1034,4,3977,5.593.809.524
25/07/2015 09:00,7.66,33208,2927,15,50,1160,4,4156,5.593.809.524
25/07/2015 10:00,7.91,34166,2943,14,58,1293,5,4313,5.593.809.524
25/07/2015 11:00,7.9,34403,2776,14,72,1434,9,4305,5.593.809.524
25/07/2015 12:00,7.69,34239,2548,13,89,1546,12,4208,5.593.809.524
25/07/2015 13:00,7.42,33899,2386,11,109,1683,13,4202,5.593.809.524
25/07/2015 14:00,7.09,33630,2226,10,126,1697,14,4073,5.593.809.524
25/07/2015 15:00,6.45,33492,2051,11,140,1646,21,3869,5.593.809.524
25/07/2015 16:00,7.79,33559,1938,14,143,1584,29,3708,5.593.809.524
25/07/2015 17:00,8.17,33895,1886,22,144,1577,33,3662,5.593.809.524
25/07/2015 18:00,8.53,33904,1912,35,145,1527,29,3648,5.593.809.524
25/07/2015 19:00,8.26,33515,1977,49,140,1443,26,3635,5.593.809.524
25/07/2015 20:00,7.9,32912,2075,66,135,1387,26,3689,5.593.809.524
25/07/2015 21:00,7.91,32772,2206,82,119,1406,24,3837,5.593.809.524
25/07/2015 22:00,7.77,32539,2422,90,105,1402,16,4035,5.593.809.524
25/07/2015 23:00,6.84,31646,2636,116,132,1412,13,4309,5.593.809.524
26/07/2015 00:00,3.76,30529,2439,125,114,1460,10,4148,5.593.809.524
26/07/2015 01:00,2.78,29684,2671,128,93,1493,10,4395,5.593.809.524
26/07/2015 02:00,2.07,29170,3073,129,90,1565,8,4865,5.593.809.524
26/07/2015 03:00,1.52,28772,3373,133,85,1685,6,5282,5.593.809.524
26/07/2015 04:00,1.18,28387,3585,133,81,1749,11,5559,5.593.809.524
26/07/2015 05:00,1.15,28255,3647,126,89,1858,10,5730,5.593.809.524
26/07/2015 06:00,1.39,28660,3682,121,97,1971,13,5884,5.593.809.524
26/07/2015 07:00,1.93,29538,3703,118,105,2125,20,6071,5.593.809.524
26/07/2015 08:00,2.58,30850,3741,116,119,2258,29,6263,5.593.809.524
26/07/2015 09:00,2.71,32460,3817,115,132,2381,36,6481,5.593.809.524
26/07/2015 10:00,2.86,33407,3893,114,136,2680,37,6860,5.593.809.524
26/07/2015 11:00,2.92,33770,3934,109,146,2908,40,7137,5.593.809.524
26/07/2015 12:00,2.77,33827,3938,101,157,3195,40,7431,5.593.809.524
26/07/2015 13:00,2.32,33655,3911,101,165,3369,43,7589,5.593.809.524
26/07/2015 14:00,2.11,33545,3856,105,168,3519,45,7693,5.593.809.524
26/07/2015 15:00,2.96,33416,3724,107,168,3569,42,7610,5.593.809.524
26/07/2015 16:00,3.99,33608,3491,111,177,3548,41,7368,5.593.809.524
26/07/2015 17:00,5.02,33829,3140,116,167,3422,42,6887,5.593.809.524
26/07/2015 18:00,6.84,33948,2705,123,154,3197,38,6217,5.593.809.524
26/07/2015 19:00,7.75,33852,2217,130,140,3071,36,5594,5.593.809.524
26/07/2015 20:00,7.9,33549,1744,136,127,2974,31,5012,5.593.809.524
26/07/2015 21:00,8.38,33462,1371,142,116,2875,27,4531,5.593.809.524
26/07/2015 22:00,8.49,33157,1156,147,106,2710,27,4146,5.593.809.524
26/07/2015 23:00,7.84,31994,1031,125,97,2359,15,3627,5.593.809.524
27/07/2015 00:00,7.64,30680,835,121,90,2268,12,3326,5.851.071.429
27/07/2015 01:00,7.07,29704,778,119,83,2157,10,3147,5.851.071.429
27/07/2015 02:00,6.74,29162,709,120,76,2028,9,2942,5.851.071.429
27/07/2015 03:00,6.66,28932,632,121,68,1910,9,2740,5.851.071.429
27/07/2015 04:00,6.81,28981,637,124,60,1790,8,2619,5.851.071.429
27/07/2015 05:00,7.97,29953,692,127,52,1671,16,2558,5.851.071.429
27/07/2015 06:00,9.06,32368,768,131,41,1545,16,2501,5.851.071.429
27/07/2015 07:00,9.95,35220,858,126,34,1451,19,2488,5.851.071.429
27/07/2015 08:00,10.86,37113,950,122,34,1366,20,2492,5.851.071.429
27/07/2015 09:00,11.43,38237,1037,115,34,1333,21,2540,5.851.071.429
27/07/2015 10:00,11.87,38767,1188,106,31,1329,20,2674,5.851.071.429
27/07/2015 11:00,11.88,38933,1294,100,28,1297,19,2738,5.851.071.429
27/07/2015 12:00,11.45,38744,1318,91,23,1317,18,2767,5.851.071.429
27/07/2015 13:00,11.17,38505,1353,80,17,1319,15,2784,5.851.071.429
27/07/2015 14:00,10.89,38200,1325,64,12,1233,11,2645,5.851.071.429
27/07/2015 15:00,10.48,37833,1214,48,9,1132,7,2410,5.851.071.429
27/07/2015 16:00,10.31,37478,1098,34,7,1039,4,2182,5.851.071.429
27/07/2015 17:00,10.47,37239,1006,22,7,936,2,1973,5.851.071.429
27/07/2015 18:00,10.57,36874,972,13,11,895,2,1893,5.851.071.429
27/07/2015 19:00,10.15,36399,959,10,13,850,3,1835,5.851.071.429
27/07/2015 20:00,9.88,35640,945,9,16,875,3,1848,5.851.071.429
27/07/2015 21:00,9.9,35266,948,9,19,899,3,1878,5.851.071.429
27/07/2015 22:00,9.64,34613,984,9,23,928,1,1945,5.851.071.429
27/07/2015 23:00,8.89,33060,990,5,58,1015,1,2069,5.851.071.429
28/07/2015 00:00,8.57,31450,862,6,59,1059,1,1987,5.851.071.429
28/07/2015 01:00,7.8,30461,871,9,59,1073,1,2013,5.851.071.429
28/07/2015 02:00,7.52,29942,858,11,58,1028,1,1956,5.851.071.429
28/07/2015 03:00,7.18,29678,835,14,54,919,1,1823,5.851.071.429
28/07/2015 04:00,7.16,29655,800,13,46,815,6,1680,5.851.071.429
28/07/2015 05:00,8.07,30588,780,10,39,725,11,1565,5.851.071.429
28/07/2015 06:00,9.19,32952,815,8,34,677,11,1545,5.851.071.429
28/07/2015 07:00,9.89,35608,880,6,31,665,13,1595,5.851.071.429
28/07/2015 08:00,11.23,37450,856,7,27,679,16,1585,5.851.071.429
28/07/2015 09:00,12.57,38826,798,7,26,691,16,1538,5.851.071.429
28/07/2015 10:00,12.94,39330,806,8,27,695,16,1552,5.851.071.429
28/07/2015 11:00,12.76,39323,853,9,28,736,14,1640,5.851.071.429
28/07/2015 12:00,12.49,39167,921,10,28,775,14,1748,5.851.071.429
28/07/2015 13:00,11.33,38930,1004,12,25,792,14,1847,5.851.071.429
28/07/2015 14:00,10.77,38671,1075,15,24,863,9,1986,5.851.071.429
28/07/2015 15:00,10.09,38150,1152,16,22,865,6,2061,5.851.071.429
28/07/2015 16:00,9.94,37613,1254,19,18,827,5,2123,5.851.071.429
28/07/2015 17:00,9.96,37318,1306,20,17,783,5,2131,5.851.071.429
28/07/2015 18:00,9.94,37048,1284,20,19,811,4,2138,5.851.071.429
28/07/2015 19:00,9.87,36494,1260,24,21,806,5,2116,5.851.071.429
28/07/2015 20:00,9.66,35730,1237,26,36,807,4,2110,5.851.071.429
28/07/2015 21:00,9.64,35344,1239,30,44,810,4,2127,5.851.071.429
28/07/2015 22:00,9.59,34787,1277,26,35,822,4,2164,5.851.071.429
28/07/2015 23:00,8.97,33276,1344,35,36,863,3,2281,5.851.071.429
29/07/2015 00:00,7.53,31462,1241,28,36,866,1,2172,5.851.071.429
29/07/2015 01:00,6.19,30385,1349,21,38,856,2,2266,5.851.071.429
29/07/2015 02:00,5.09,29866,1399,16,41,846,2,2304,5.851.071.429
29/07/2015 03:00,4.9,29566,1403,13,46,837,2,2301,5.851.071.429
29/07/2015 04:00,4.86,29513,1414,10,53,844,3,2324,5.851.071.429
29/07/2015 05:00,5.62,30394,1463,7,59,846,5,2380,5.851.071.429
29/07/2015 06:00,7.72,32567,1541,5,78,851,7,2482,5.851.071.429
29/07/2015 07:00,8.32,35353,1640,5,87,857,10,2599,5.851.071.429
29/07/2015 08:00,9.45,37475,1749,7,91,861,11,2719,5.851.071.429
29/07/2015 09:00,9.74,38399,1836,10,98,866,16,2826,5.851.071.429
29/07/2015 10:00,9.9,39036,1941,13,105,913,19,2991,5.851.071.429
29/07/2015 11:00,9.88,39235,2024,16,106,938,21,3105,5.851.071.429
29/07/2015 12:00,9.72,39117,2095,19,107,1014,24,3259,5.851.071.429
29/07/2015 13:00,9.51,38845,2172,26,106,1036,25,3365,5.851.071.429
29/07/2015 14:00,8.95,38450,2144,34,93,1067,25,3363,5.851.071.429
29/07/2015 15:00,8.56,37945,2045,39,79,1060,27,3250,5.851.071.429
29/07/2015 16:00,8.21,37476,1932,42,65,1089,24,3152,5.851.071.429
29/07/2015 17:00,8.17,37220,1851,50,47,1018,23,2989,5.851.071.429
29/07/2015 18:00,8.57,36921,1768,55,37,968,16,2844,5.851.071.429
29/07/2015 19:00,8.57,36406,1684,66,30,915,12,2707,5.851.071.429
29/07/2015 20:00,8.38,35629,1610,72,26,888,10,2606,5.851.071.429
29/07/2015 21:00,8.48,35275,1594,80,24,863,9,2570,5.851.071.429
29/07/2015 22:00,8.21,34697,1598,84,30,833,8,2553,5.851.071.429
29/07/2015 23:00,6.87,33142,1603,74,50,751,8,2486,5.851.071.429
30/07/2015 00:00,7.03,31583,1230,74,43,729,7,2083,5.851.071.429
30/07/2015 01:00,5.56,30475,1236,69,46,721,7,2079,5.851.071.429
30/07/2015 02:00,4.89,29889,1251,64,53,706,5,2079,5.851.071.429
30/07/2015 03:00,4.81,29649,1262,59,59,705,1,2086,5.851.071.429
30/07/2015 04:00,4.78,29615,1293,57,64,721,1,2136,5.851.071.429
30/07/2015 05:00,4.92,30540,1321,53,68,703,5,2150,5.851.071.429
30/07/2015 06:00,6.35,32750,1330,45,75,654,6,2110,5.851.071.429
30/07/2015 07:00,7.68,35649,1328,45,81,629,9,2092,5.851.071.429
30/07/2015 08:00,9.22,37554,1293,42,93,642,12,2082,5.851.071.429
30/07/2015 09:00,9.75,38608,1260,41,111,636,15,2063,5.851.071.429
30/07/2015 10:00,10.07,39159,1264,42,128,670,18,2122,5.851.071.429
30/07/2015 11:00,10.04,39321,1323,44,137,737,20,2261,5.851.071.429
30/07/2015 12:00,9.81,39200,1422,44,146,827,23,2462,5.851.071.429
30/07/2015 13:00,9.58,38909,1517,42,153,893,21,2626,5.851.071.429
30/07/2015 14:00,9.27,38595,1629,41,156,936,20,2782,5.851.071.429
30/07/2015 15:00,8.53,38155,1772,34,157,1041,20,3024,5.851.071.429
30/07/2015 16:00,7.75,37699,1935,26,157,1109,24,3251,5.851.071.429
30/07/2015 17:00,7.61,37471,2084,19,145,1161,24,3433,5.851.071.429
30/07/2015 18:00,7.64,37111,2162,16,123,1232,18,3551,5.851.071.429
30/07/2015 19:00,7.37,36563,2240,16,109,1265,17,3647,5.851.071.429
30/07/2015 20:00,7.14,35776,2359,19,104,1259,18,3759,5.851.071.429
30/07/2015 21:00,7.18,35421,2482,22,101,1274,12,3891,5.851.071.429
30/07/2015 22:00,6.9,34767,2610,25,99,1327,8,4069,5.851.071.429
30/07/2015 23:00,5.63,33234,2716,53,74,1305,6,4154,5.851.071.429
31/07/2015 00:00,4.09,31342,3108,48,79,1333,7,4575,5.851.071.429
31/07/2015 01:00,3.47,30305,3085,53,84,1369,5,4596,5.851.071.429
31/07/2015 02:00,3.14,29806,3045,54,87,1377,6,4569,5.851.071.429
31/07/2015 03:00,2.98,29540,3034,56,88,1386,6,4570,5.851.071.429
31/07/2015 04:00,2.98,29524,3032,51,89,1386,6,4564,5.851.071.429
31/07/2015 05:00,3.66,30511,3005,44,83,1385,10,4527,5.851.071.429
31/07/2015 06:00,4.86,32928,2995,39,79,1372,9,4494,5.851.071.429
31/07/2015 07:00,6.98,35856,3026,38,75,1364,11,4514,5.851.071.429
31/07/2015 08:00,7.98,37714,3069,43,74,1322,10,4518,5.851.071.429
31/07/2015 09:00,8.72,38679,3128,58,75,1314,10,4585,5.851.071.429
31/07/2015 10:00,8.89,39394,3188,74,74,1310,9,4655,5.851.071.429
31/07/2015 11:00,8.41,39437,3169,83,75,1329,8,4664,5.851.071.429
31/07/2015 12:00,8.01,39117,3056,91,73,1356,8,4584,5.851.071.429
31/07/2015 13:00,7.63,38549,2950,94,70,1388,7,4509,5.851.071.429
31/07/2015 14:00,7.33,38007,2845,95,57,1401,7,4405,5.851.071.429
31/07/2015 15:00,6.81,37320,2651,94,59,1398,7,4209,5.851.071.429
31/07/2015 16:00,6.62,36911,2475,92,71,1366,7,4011,5.851.071.429
31/07/2015 17:00,6.85,36944,2303,89,72,1331,6,3801,5.851.071.429
31/07/2015 18:00,7.42,36588,2070,85,70,1354,5,3584,5.851.071.429
31/07/2015 19:00,7.41,35905,1779,83,69,1343,5,3279,5.851.071.429
31/07/2015 20:00,7.32,34975,1481,82,66,1410,6,3045,5.851.071.429
31/07/2015 21:00,7.74,34451,1233,83,63,1495,6,2880,5.851.071.429
31/07/2015 22:00,7.76,34048,1051,80,63,1502,1,2697,5.851.071.429
31/07/2015 23:00,7.3,32630,928,56,56,1593,5,2638,5.851.071.429
01/08/2015 00:00,6.32,31116,876,51,54,1615,3,2599,5.851.071.429
01/08/2015 01:00,5.02,30010,779,46,51,1637,3,2516,5.851.071.429
01/08/2015 02:00,4.86,29384,669,47,53,1604,3,2376,5.851.071.429
01/08/2015 03:00,4.78,28900,567,43,61,1574,4,2249,5.851.071.429
01/08/2015 04:00,4.52,28542,515,38,59,1525,3,2140,5.851.071.429
01/08/2015 05:00,4.51,28532,473,32,54,1424,6,1989,5.851.071.429
01/08/2015 06:00,4.87,29316,442,29,56,1309,7,1843,5.851.071.429
01/08/2015 07:00,5.23,30539,432,27,64,1228,7,1758,5.851.071.429
01/08/2015 08:00,6.24,32174,431,25,68,1143,7,1674,5.851.071.429
01/08/2015 09:00,7.39,33653,448,27,74,1022,9,1580,5.851.071.429
01/08/2015 10:00,7.86,34355,480,32,80,1008,9,1609,5.851.071.429
01/08/2015 11:00,7.91,34521,508,34,80,986,10,1618,5.851.071.429
01/08/2015 12:00,7.73,34296,518,40,80,944,9,1591,5.851.071.429
01/08/2015 13:00,7.39,33968,514,46,80,925,8,1573,5.851.071.429
01/08/2015 14:00,7.2,33717,496,49,71,936,7,1559,5.851.071.429
01/08/2015 15:00,7.37,33540,483,53,62,876,7,1481,5.851.071.429
01/08/2015 16:00,7.41,33621,489,54,45,840,6,1434,5.851.071.429
01/08/2015 17:00,7.7,33837,477,54,33,811,5,1380,5.851.071.429
01/08/2015 18:00,7.94,33910,431,53,22,770,4,1280,5.851.071.429
01/08/2015 19:00,8,33473,401,55,14,734,4,1208,5.851.071.429
01/08/2015 20:00,7.86,32998,384,57,11,729,4,1185,5.851.071.429
01/08/2015 21:00,7.93,32973,386,61,10,740,2,1199,5.851.071.429
01/08/2015 22:00,7.7,32744,413,59,9,738,2,1221,5.851.071.429
01/08/2015 23:00,7.22,31700,450,84,8,866,2,1410,5.851.071.429
02/08/2015 00:00,7.55,31028,617,85,9,861,2,1574,5.851.071.429
02/08/2015 01:00,6.21,30074,664,85,13,834,1,1597,5.851.071.429
02/08/2015 02:00,5.65,29513,673,81,18,814,1,1587,5.851.071.429
02/08/2015 03:00,4.95,29079,650,75,22,802,1,1550,5.851.071.429
02/08/2015 04:00,4.87,28692,638,65,24,768,1,1496,5.851.071.429
02/08/2015 05:00,4.83,28538,638,56,22,720,3,1439,5.851.071.429
02/08/2015 06:00,4.91,28926,650,52,19,630,4,1355,5.851.071.429
02/08/2015 07:00,5.97,29844,643,54,17,603,7,1324,5.851.071.429
02/08/2015 08:00,7.11,31439,575,62,19,640,9,1305,5.851.071.429
02/08/2015 09:00,8.17,32679,510,73,23,730,11,1347,5.851.071.429
02/08/2015 10:00,8.86,33617,482,84,25,825,12,1428,5.851.071.429
02/08/2015 11:00,9.15,34012,465,90,24,940,17,1536,5.851.071.429
02/08/2015 12:00,8.92,34060,445,95,21,1064,19,1644,5.851.071.429
02/08/2015 13:00,8.39,33933,461,100,19,1165,18,1763,5.851.071.429
02/08/2015 14:00,7.73,33741,458,103,15,1220,15,1811,5.851.071.429
02/08/2015 15:00,7.75,33642,458,101,13,1265,12,1849,5.851.071.429
02/08/2015 16:00,7.72,33741,456,94,12,1264,8,1834,5.851.071.429
02/08/2015 17:00,7.86,33967,366,85,11,1244,5,1711,5.851.071.429
02/08/2015 18:00,8.21,34135,268,75,16,1212,3,1574,5.851.071.429
02/08/2015 19:00,9.11,34143,201,70,20,1154,3,1448,5.851.071.429
02/08/2015 20:00,9.51,33912,151,67,23,1130,3,1374,5.851.071.429
02/08/2015 21:00,9.68,33974,118,66,25,1159,1,1369,5.851.071.429
02/08/2015 22:00,9.24,33630,108,68,24,1221,1,1422,5.851.071.429
02/08/2015 23:00,8.18,32307,102,73,39,1257,0,1471,5.851.071.429
03/08/2015 00:00,7.84,31205,57,74,45,1256,0,1432,6.034.166.667
03/08/2015 01:00,6.6,30292,58,72,46,1262,0,1438,6.034.166.667
03/08/2015 02:00,5.66,29845,75,68,43,1247,0,1433,6.034.166.667
03/08/2015 03:00,5.28,29662,106,61,36,1175,0,1378,6.034.166.667
03/08/2015 04:00,5.22,29784,182,53,29,1093,1,1358,6.034.166.667
03/08/2015 05:00,6.52,30842,307,44,21,1008,3,1383,6.034.166.667
03/08/2015 06:00,8.86,33364,402,40,12,841,4,1299,6.034.166.667
03/08/2015 07:00,10.27,36323,426,39,6,709,6,1186,6.034.166.667
03/08/2015 08:00,11.83,38208,476,38,5,574,6,1099,6.034.166.667
03/08/2015 09:00,12.85,39537,594,38,4,482,6,1124,6.034.166.667
03/08/2015 10:00,13.23,39902,752,39,4,391,6,1192,6.034.166.667
03/08/2015 11:00,13.02,39792,921,40,5,343,5,1314,6.034.166.667
03/08/2015 12:00,12.14,39463,1107,42,8,295,5,1457,6.034.166.667
03/08/2015 13:00,11.6,39299,1315,42,10,264,5,1636,6.034.166.667
03/08/2015 14:00,10.73,38907,1490,39,11,252,5,1797,6.034.166.667
03/08/2015 15:00,10.31,38390,1621,35,11,267,5,1939,6.034.166.667
03/08/2015 16:00,9.92,37870,1714,28,10,277,5,2034,6.034.166.667
03/08/2015 17:00,9.88,37645,1749,22,11,287,4,2073,6.034.166.667
03/08/2015 18:00,9.8,37293,1755,18,16,314,3,2106,6.034.166.667
03/08/2015 19:00,9.52,36752,1754,17,17,333,4,2125,6.034.166.667
03/08/2015 20:00,8.49,36065,1793,19,17,411,4,2244,6.034.166.667
03/08/2015 21:00,8.35,35738,1922,22,17,507,3,2471,6.034.166.667
03/08/2015 22:00,7.72,35117,2080,23,17,626,1,2747,6.034.166.667
03/08/2015 23:00,6.47,33492,2114,26,27,761,1,2929,6.034.166.667
04/08/2015 00:00,4.42,31906,1815,24,28,816,1,2684,6.034.166.667
04/08/2015 01:00,3.82,30979,1707,21,30,860,1,2619,6.034.166.667
04/08/2015 02:00,3.59,30428,1601,18,33,886,1,2539,6.034.166.667
04/08/2015 03:00,3.63,30160,1483,13,36,923,1,2456,6.034.166.667
04/08/2015 04:00,3.89,30164,1406,9,39,945,1,2400,6.034.166.667
04/08/2015 05:00,4.83,31165,1320,5,36,945,3,2309,6.034.166.667
04/08/2015 06:00,7.79,33701,1196,3,23,901,4,2127,6.034.166.667
04/08/2015 07:00,10.15,36726,1100,2,14,866,6,1988,6.034.166.667
04/08/2015 08:00,11.04,38983,1037,2,11,860,6,1916,6.034.166.667
04/08/2015 09:00,11.87,39699,998,3,10,900,6,1917,6.034.166.667
04/08/2015 10:00,11.98,39964,980,4,9,952,6,1951,6.034.166.667
04/08/2015 11:00,11.91,39811,992,5,7,1038,5,2047,6.034.166.667
04/08/2015 12:00,11.22,39600,1017,6,6,1134,5,2168,6.034.166.667
04/08/2015 13:00,10.69,39362,1040,5,5,1216,5,2271,6.034.166.667
04/08/2015 14:00,10.38,38979,970,5,6,1316,5,2302,6.034.166.667
04/08/2015 15:00,10.16,38461,850,4,7,1389,5,2255,6.034.166.667
04/08/2015 16:00,9.95,37991,778,4,10,1456,5,2253,6.034.166.667
04/08/2015 17:00,9.98,37791,678,4,14,1467,5,2168,6.034.166.667
04/08/2015 18:00,9.92,37419,645,6,24,1554,5,2234,6.034.166.667
04/08/2015 19:00,9.83,36892,735,10,35,1683,6,2469,6.034.166.667
04/08/2015 20:00,9.01,36258,831,15,49,1778,7,2680,6.034.166.667
04/08/2015 21:00,9.23,35907,877,22,52,1787,7,2745,6.034.166.667
04/08/2015 22:00,8.69,35115,863,30,64,1758,5,2720,6.034.166.667
04/08/2015 23:00,7.61,33333,832,39,68,1748,2,2689,6.034.166.667
05/08/2015 00:00,4.41,31978,674,47,74,1666,3,2464,6.034.166.667
05/08/2015 01:00,3.55,30846,684,51,79,1589,2,2405,6.034.166.667
05/08/2015 02:00,3.38,30318,709,55,78,1485,2,2329,6.034.166.667
05/08/2015 03:00,3.57,30014,735,54,76,1392,2,2259,6.034.166.667
05/08/2015 04:00,3.69,30030,758,48,72,1336,2,2216,6.034.166.667
05/08/2015 05:00,4.91,31123,739,39,58,1281,7,2124,6.034.166.667
05/08/2015 06:00,8.02,33569,658,31,35,1157,7,1888,6.034.166.667
05/08/2015 07:00,10.14,36634,605,27,25,1096,7,1760,6.034.166.667
05/08/2015 08:00,11.17,39278,517,26,23,1014,7,1587,6.034.166.667
05/08/2015 09:00,12.85,39896,447,27,22,968,7,1471,6.034.166.667
05/08/2015 10:00,12.86,40348,408,28,24,984,7,1451,6.034.166.667
05/08/2015 11:00,12.56,40300,395,31,28,983,6,1443,6.034.166.667
05/08/2015 12:00,12.11,40155,432,32,29,960,6,1459,6.034.166.667
05/08/2015 13:00,11.27,39881,491,33,26,955,6,1511,6.034.166.667
05/08/2015 14:00,10.94,39530,487,33,21,940,6,1487,6.034.166.667
05/08/2015 15:00,10.69,39006,431,35,14,905,6,1391,6.034.166.667
05/08/2015 16:00,10.39,38496,373,37,10,891,5,1316,6.034.166.667
05/08/2015 17:00,10.41,38254,309,42,11,758,5,1125,6.034.166.667
05/08/2015 18:00,10.72,37844,241,49,18,677,4,989,6.034.166.667
05/08/2015 19:00,10.62,37300,182,60,22,655,4,923,6.034.166.667
05/08/2015 20:00,10.22,36601,139,70,22,661,4,896,6.034.166.667
05/08/2015 21:00,10.05,36264,121,81,22,661,3,888,6.034.166.667
05/08/2015 22:00,9.53,35387,131,79,22,624,0,856,6.034.166.667
05/08/2015 23:00,8.02,33586,152,79,14,613,1,859,6.034.166.667
06/08/2015 00:00,6.18,31952,213,74,11,595,0,893,6.034.166.667
06/08/2015 01:00,5.23,30856,250,68,8,566,0,892,6.034.166.667
06/08/2015 02:00,4.85,30271,293,59,8,520,0,880,6.034.166.667
06/08/2015 03:00,4.64,29996,354,49,8,472,0,883,6.034.166.667
06/08/2015 04:00,4.63,30048,410,40,6,435,1,892,6.034.166.667
06/08/2015 05:00,5.25,31119,482,31,4,391,3,911,6.034.166.667
06/08/2015 06:00,7.79,33498,552,24,2,320,4,902,6.034.166.667
06/08/2015 07:00,9.76,36623,582,18,3,270,6,879,6.034.166.667
06/08/2015 08:00,10.67,38708,614,16,4,246,6,886,6.034.166.667
06/08/2015 09:00,11.45,39601,691,15,5,239,6,956,6.034.166.667
06/08/2015 10:00,11.48,40200,813,14,6,279,5,1117,6.034.166.667
06/08/2015 11:00,11.19,40325,930,13,7,318,4,1272,6.034.166.667
06/08/2015 12:00,10.88,40122,1017,12,9,345,4,1387,6.034.166.667
06/08/2015 13:00,10.52,39912,1093,12,10,372,5,1492,6.034.166.667
06/08/2015 14:00,10.34,39559,1125,13,11,388,5,1542,6.034.166.667
06/08/2015 15:00,9.96,39026,1122,13,11,387,5,1538,6.034.166.667
06/08/2015 16:00,9.82,38560,1142,13,11,379,4,1549,6.034.166.667
06/08/2015 17:00,9.83,38345,1163,12,10,368,4,1557,6.034.166.667
06/08/2015 18:00,9.82,37858,1178,12,13,371,3,1577,6.034.166.667
06/08/2015 19:00,9.64,37328,1192,14,13,400,4,1623,6.034.166.667
06/08/2015 20:00,9.13,36561,1223,16,11,441,4,1695,6.034.166.667
06/08/2015 21:00,9.04,36208,1304,16,9,515,3,1847,6.034.166.667
06/08/2015 22:00,8.53,35331,1385,15,8,598,0,2006,6.034.166.667
06/08/2015 23:00,6.91,33549,1362,9,6,663,2,2042,6.034.166.667
07/08/2015 00:00,5.38,32313,756,7,4,727,1,1495,6.034.166.667
07/08/2015 01:00,5.44,31218,741,6,3,808,0,1558,6.034.166.667
07/08/2015 02:00,4.97,30627,703,5,3,858,0,1569,6.034.166.667
07/08/2015 03:00,4.89,30331,646,5,3,858,0,1512,6.034.166.667
07/08/2015 04:00,4.92,30385,592,4,4,831,0,1431,6.034.166.667
07/08/2015 05:00,5.79,31460,531,2,4,793,3,1333,6.034.166.667
07/08/2015 06:00,7.93,34188,495,1,5,704,4,1209,6.034.166.667
07/08/2015 07:00,9.3,37340,473,1,4,629,6,1113,6.034.166.667
07/08/2015 08:00,10.11,39901,404,1,2,574,6,987,6.034.166.667
07/08/2015 09:00,10.39,40661,335,2,2,601,6,946,6.034.166.667
07/08/2015 10:00,10.46,41010,303,2,3,723,5,1036,6.034.166.667
07/08/2015 11:00,10.39,40820,290,3,3,783,4,1083,6.034.166.667
07/08/2015 12:00,10.15,40397,274,4,3,886,4,1171,6.034.166.667
07/08/2015 13:00,9.83,39909,267,4,3,983,4,1261,6.034.166.667
07/08/2015 14:00,9.44,39332,231,4,3,1085,4,1327,6.034.166.667
07/08/2015 15:00,9.16,38605,189,4,4,1184,5,1386,6.034.166.667
07/08/2015 16:00,8.83,37891,153,4,4,1205,5,1371,6.034.166.667
07/08/2015 17:00,8.88,37717,129,5,5,1172,5,1316,6.034.166.667
07/08/2015 18:00,9.43,37305,117,6,11,1079,4,1217,6.034.166.667
07/08/2015 19:00,9.37,36525,119,8,15,1078,5,1225,6.034.166.667
07/08/2015 20:00,8.88,35691,134,12,21,1106,6,1279,6.034.166.667
07/08/2015 21:00,8.91,35254,164,17,27,1149,5,1362,6.034.166.667
07/08/2015 22:00,8.72,34721,199,26,34,1120,1,1380,6.034.166.667
07/08/2015 23:00,7.53,33196,240,30,55,901,2,1228,6.034.166.667
08/08/2015 00:00,6,31526,116,39,58,869,2,1084,6.034.166.667
08/08/2015 01:00,5.64,30451,140,42,63,874,2,1121,6.034.166.667
08/08/2015 02:00,5.37,29824,183,51,65,881,1,1181,6.034.166.667
08/08/2015 03:00,5.06,29371,249,63,66,861,2,1241,6.034.166.667
08/08/2015 04:00,4.53,29058,296,65,65,808,2,1236,6.034.166.667
08/08/2015 05:00,4.49,29092,320,61,58,732,2,1173,6.034.166.667
08/08/2015 06:00,5.36,29731,367,57,41,630,4,1099,6.034.166.667
08/08/2015 07:00,5.77,30990,429,52,30,576,4,1091,6.034.166.667
08/08/2015 08:00,6.31,32656,448,52,26,529,6,1061,6.034.166.667
08/08/2015 09:00,7.23,34261,444,54,23,504,7,1032,6.034.166.667
08/08/2015 10:00,7.9,35288,485,55,24,544,7,1115,6.034.166.667
08/08/2015 11:00,7.8,35561,593,58,32,606,9,1298,6.034.166.667
08/08/2015 12:00,7.29,35449,691,57,41,673,10,1472,6.034.166.667
08/08/2015 13:00,6.82,35138,733,52,43,750,10,1588,6.034.166.667
08/08/2015 14:00,6.45,34736,772,48,39,846,7,1712,6.034.166.667
08/08/2015 15:00,6.35,34477,824,43,32,906,7,1812,6.034.166.667
08/08/2015 16:00,6.34,34591,891,31,23,989,4,1938,6.034.166.667
08/08/2015 17:00,6.79,34764,927,26,16,1039,3,2011,6.034.166.667
08/08/2015 18:00,6.99,34808,892,27,13,1065,2,1999,6.034.166.667
08/08/2015 19:00,6.88,34347,801,34,10,1155,2,2002,6.034.166.667
08/08/2015 20:00,6.94,33896,689,35,10,1199,3,1936,6.034.166.667
08/08/2015 21:00,7.07,33896,632,39,10,1242,2,1925,6.034.166.667
08/08/2015 22:00,6.6,33512,605,43,11,1288,1,1948,6.034.166.667
08/08/2015 23:00,6.08,32296,575,23,28,1327,1,1954,6.034.166.667
09/08/2015 00:00,6.14,31088,600,21,26,1254,2,1903,6.034.166.667
09/08/2015 01:00,5.7,30159,576,19,27,1143,2,1767,6.034.166.667
09/08/2015 02:00,5.51,29613,519,17,30,1113,2,1681,6.034.166.667
09/08/2015 03:00,5.51,29215,463,14,27,984,3,1491,6.034.166.667
09/08/2015 04:00,5.2,28813,423,11,26,879,3,1342,6.034.166.667
09/08/2015 05:00,5.45,28621,350,7,27,725,3,1112,6.034.166.667
09/08/2015 06:00,5.58,28969,272,5,25,535,2,839,6.034.166.667
09/08/2015 07:00,6.02,30023,231,3,22,368,2,626,6.034.166.667
09/08/2015 08:00,6.78,31402,234,3,18,324,2,581,6.034.166.667
09/08/2015 09:00,8.05,32895,260,3,15,309,2,589,6.034.166.667
09/08/2015 10:00,8.6,33975,302,4,11,330,1,648,6.034.166.667
09/08/2015 11:00,8.87,34355,316,4,11,371,3,705,6.034.166.667
09/08/2015 12:00,8.6,34299,287,5,20,424,4,740,6.034.166.667
09/08/2015 13:00,8.41,34168,252,6,27,468,4,757,6.034.166.667
09/08/2015 14:00,8.26,34000,214,7,26,528,4,779,6.034.166.667
09/08/2015 15:00,8.18,33946,179,8,26,553,7,773,6.034.166.667
09/08/2015 16:00,8.36,34131,162,10,28,559,7,766,6.034.166.667
09/08/2015 17:00,9.34,34433,140,13,27,530,6,716,6.034.166.667
09/08/2015 18:00,9.98,34649,118,14,30,517,3,682,6.034.166.667
09/08/2015 19:00,10.12,34642,105,15,30,481,5,636,6.034.166.667
09/08/2015 20:00,10.27,34533,94,16,29,474,4,617,6.034.166.667
09/08/2015 21:00,10.39,34707,90,18,29,522,1,660,6.034.166.667
09/08/2015 22:00,10.05,34165,102,18,28,542,1,691,6.034.166.667
09/08/2015 23:00,8.8,32585,107,12,18,575,2,714,6.034.166.667
10/08/2015 00:00,8.13,31179,269,9,14,595,1,888,6.164.642.857
10/08/2015 01:00,7.9,30151,327,6,13,607,1,954,6.164.642.857
10/08/2015 02:00,7.79,29633,346,6,13,570,0,935,6.164.642.857
10/08/2015 03:00,7.65,29464,337,6,13,510,0,866,6.164.642.857
10/08/2015 04:00,7.81,29659,320,5,13,461,2,801,6.164.642.857
10/08/2015 05:00,7.94,30892,306,5,12,425,2,750,6.164.642.857
10/08/2015 06:00,9.98,33759,299,3,10,392,2,706,6.164.642.857
10/08/2015 07:00,11.45,37067,278,3,8,333,3,625,6.164.642.857
10/08/2015 08:00,14.19,39374,240,3,8,303,4,558,6.164.642.857
10/08/2015 09:00,15.09,40191,221,2,8,315,4,550,6.164.642.857
10/08/2015 10:00,15.25,40651,230,3,7,359,4,603,6.164.642.857
10/08/2015 11:00,15,40687,240,4,7,417,3,671,6.164.642.857
10/08/2015 12:00,14.77,40376,242,5,8,452,3,710,6.164.642.857
10/08/2015 13:00,14.08,40183,248,6,9,474,3,740,6.164.642.857
10/08/2015 14:00,13.84,39837,262,7,11,480,2,762,6.164.642.857
10/08/2015 15:00,12.96,39370,278,7,14,468,4,771,6.164.642.857
10/08/2015 16:00,11.45,38879,290,8,16,458,4,776,6.164.642.857
10/08/2015 17:00,14,38686,302,8,17,446,4,777,6.164.642.857
10/08/2015 18:00,13.92,38232,314,9,20,425,2,770,6.164.642.857
10/08/2015 19:00,13.96,37705,318,9,21,445,5,798,6.164.642.857
10/08/2015 20:00,12.3,37052,321,11,21,500,4,857,6.164.642.857
10/08/2015 21:00,11.44,36709,317,12,22,548,3,902,6.164.642.857
10/08/2015 22:00,10.29,35682,317,12,22,574,1,926,6.164.642.857
10/08/2015 23:00,8.64,33681,317,9,20,605,6,957,6.164.642.857
11/08/2015 00:00,8.05,32035,361,9,22,636,6,1034,6.164.642.857
11/08/2015 01:00,7.51,30963,380,10,24,644,6,1064,6.164.642.857
11/08/2015 02:00,6.84,30411,382,11,25,633,1,1052,6.164.642.857
11/08/2015 03:00,6.41,30164,390,10,25,615,0,1040,6.164.642.857
11/08/2015 04:00,6.68,30248,392,8,26,601,1,1028,6.164.642.857
11/08/2015 05:00,7.26,31536,370,6,24,605,2,1007,6.164.642.857
11/08/2015 06:00,8.82,34382,356,4,18,607,2,987,6.164.642.857
11/08/2015 07:00,10.83,37776,367,3,13,585,4,972,6.164.642.857
11/08/2015 08:00,13.27,40307,333,3,12,612,4,964,6.164.642.857
11/08/2015 09:00,13.78,40962,272,3,12,620,3,910,6.164.642.857
11/08/2015 10:00,14.48,41249,266,4,12,666,3,951,6.164.642.857
11/08/2015 11:00,14.14,41145,252,5,10,760,2,1029,6.164.642.857
11/08/2015 12:00,13.7,40917,219,6,9,880,2,1116,6.164.642.857
11/08/2015 13:00,13.4,40699,246,6,7,943,2,1204,6.164.642.857
11/08/2015 14:00,12.97,40265,292,7,6,1007,0,1312,6.164.642.857
11/08/2015 15:00,12.35,39742,339,8,7,1071,2,1427,6.164.642.857
11/08/2015 16:00,11.35,39257,394,8,9,1140,2,1553,6.164.642.857
11/08/2015 17:00,10.76,38998,392,9,11,1175,2,1589,6.164.642.857
11/08/2015 18:00,10.58,38491,364,12,15,1192,1,1584,6.164.642.857
11/08/2015 19:00,10.51,37900,343,15,15,1209,4,1586,6.164.642.857
11/08/2015 20:00,9.71,37232,326,18,16,1220,3,1583,6.164.642.857
11/08/2015 21:00,9.93,36888,330,22,17,1225,3,1597,6.164.642.857
11/08/2015 22:00,9.54,35829,365,24,17,1225,0,1631,6.164.642.857
11/08/2015 23:00,8.12,33717,380,24,16,1313,2,1735,6.164.642.857
12/08/2015 00:00,7.42,31862,268,26,12,1198,2,1506,6.164.642.857
12/08/2015 01:00,6.45,30713,296,25,9,1040,2,1372,6.164.642.857
12/08/2015 02:00,6.53,30213,342,22,7,955,2,1328,6.164.642.857
12/08/2015 03:00,6.65,30094,376,17,5,884,0,1282,6.164.642.857
12/08/2015 04:00,6.86,30323,387,12,4,868,2,1273,6.164.642.857
12/08/2015 05:00,8.12,31535,406,6,4,867,2,1285,6.164.642.857
12/08/2015 06:00,10.16,34424,444,4,3,801,2,1254,6.164.642.857
12/08/2015 07:00,12.24,37731,487,2,2,730,3,1224,6.164.642.857
12/08/2015 08:00,13.96,39910,538,2,2,683,3,1228,6.164.642.857
12/08/2015 09:00,14.69,40625,586,2,3,613,3,1207,6.164.642.857
12/08/2015 10:00,15.44,41113,618,3,3,613,3,1240,6.164.642.857
12/08/2015 11:00,15.55,41253,637,4,5,622,2,1270,6.164.642.857
12/08/2015 12:00,15,41053,643,7,9,651,2,1312,6.164.642.857
12/08/2015 13:00,14.72,40789,659,9,14,673,2,1357,6.164.642.857
12/08/2015 14:00,14.18,40339,688,12,18,726,1,1445,6.164.642.857
12/08/2015 15:00,13.67,39854,732,16,20,759,2,1529,6.164.642.857
12/08/2015 16:00,13.18,39330,763,17,21,785,2,1588,6.164.642.857
12/08/2015 17:00,13.65,38988,791,19,22,861,2,1695,6.164.642.857
12/08/2015 18:00,13.73,38488,808,20,32,876,0,1736,6.164.642.857
12/08/2015 19:00,13.61,38042,785,19,36,932,4,1776,6.164.642.857
12/08/2015 20:00,12.08,37379,726,16,39,1066,5,1852,6.164.642.857
12/08/2015 21:00,11.78,37037,712,15,39,1090,4,1860,6.164.642.857
12/08/2015 22:00,10.79,35907,721,15,37,1145,1,1919,6.164.642.857
12/08/2015 23:00,9.37,33803,684,37,28,1279,2,2030,6.164.642.857
13/08/2015 00:00,9.33,32398,442,39,27,1330,2,1840,6.164.642.857
13/08/2015 01:00,8.89,31367,423,37,25,1298,2,1785,6.164.642.857
13/08/2015 02:00,8.81,30940,403,38,24,1243,2,1710,6.164.642.857
13/08/2015 03:00,8.71,30856,370,40,23,1113,0,1546,6.164.642.857
13/08/2015 04:00,8.86,31021,335,41,20,1016,0,1412,6.164.642.857
13/08/2015 05:00,9.67,32353,284,42,17,976,2,1321,6.164.642.857
13/08/2015 06:00,11.01,35512,228,45,12,860,2,1147,6.164.642.857
13/08/2015 07:00,12.89,38751,173,49,11,750,3,986,6.164.642.857
13/08/2015 08:00,14.06,41434,119,52,11,670,4,856,6.164.642.857
13/08/2015 09:00,15.46,41416,86,55,15,573,4,733,6.164.642.857
13/08/2015 10:00,16.12,41612,66,56,22,589,4,737,6.164.642.857
13/08/2015 11:00,16.1,41378,64,59,25,607,3,758,6.164.642.857
13/08/2015 12:00,15.55,41072,80,63,24,655,4,826,6.164.642.857
13/08/2015 13:00,15.14,40823,108,70,22,641,6,847,6.164.642.857
13/08/2015 14:00,14.83,40416,150,79,22,667,5,923,6.164.642.857
13/08/2015 15:00,14.28,39888,210,84,23,679,8,1004,6.164.642.857
13/08/2015 16:00,13.61,39358,282,83,24,680,8,1077,6.164.642.857
13/08/2015 17:00,14.28,39163,342,78,23,675,8,1126,6.164.642.857
13/08/2015 18:00,14.45,38748,384,72,23,685,5,1169,6.164.642.857
13/08/2015 19:00,14.29,38204,425,65,26,736,6,1258,6.164.642.857
13/08/2015 20:00,13.25,37579,495,57,35,807,5,1399,6.164.642.857
13/08/2015 21:00,12.65,37247,625,52,50,886,5,1618,6.164.642.857
13/08/2015 22:00,11.35,36228,796,48,58,977,2,1881,6.164.642.857
13/08/2015 23:00,9.94,34098,999,56,48,1151,2,2256,6.164.642.857
14/08/2015 00:00,9.36,32654,1554,49,40,1189,2,2834,6.164.642.857
14/08/2015 01:00,8.89,31645,1678,41,36,1184,2,2941,6.164.642.857
14/08/2015 02:00,8.22,31206,1833,35,35,1213,2,3118,6.164.642.857
14/08/2015 03:00,7.79,31090,1999,29,36,1193,0,3257,6.164.642.857
14/08/2015 04:00,7.93,31232,2187,22,36,1169,0,3414,6.164.642.857
14/08/2015 05:00,8.81,32575,2382,15,28,1123,2,3550,6.164.642.857
14/08/2015 06:00,10.68,35693,2563,11,21,1031,2,3628,6.164.642.857
14/08/2015 07:00,12.68,38996,2761,9,18,945,3,3736,6.164.642.857
14/08/2015 08:00,13.66,40911,2966,10,17,926,3,3922,6.164.642.857
14/08/2015 09:00,14.01,41358,3139,11,16,962,3,4131,6.164.642.857
14/08/2015 10:00,13.83,41540,3254,12,15,1002,3,4286,6.164.642.857
14/08/2015 11:00,13.47,41226,3367,14,16,1065,2,4464,6.164.642.857
14/08/2015 12:00,13.15,40777,3503,16,17,1108,2,4646,6.164.642.857
14/08/2015 13:00,12.77,40231,3623,19,18,1153,2,4815,6.164.642.857
14/08/2015 14:00,12.16,39554,3704,20,20,1177,1,4922,6.164.642.857
14/08/2015 15:00,11.54,38818,3740,19,22,1178,3,4962,6.164.642.857
14/08/2015 16:00,10.74,38303,3740,18,25,1197,4,4984,6.164.642.857
14/08/2015 17:00,10.63,38130,3689,18,28,1201,3,4939,6.164.642.857
14/08/2015 18:00,10.72,37779,3571,19,29,1229,1,4849,6.164.642.857
14/08/2015 19:00,10.71,37000,3431,21,33,1294,4,4783,6.164.642.857
14/08/2015 20:00,9.91,36246,3292,24,38,1401,4,4759,6.164.642.857
14/08/2015 21:00,10.01,35988,3179,26,42,1472,4,4723,6.164.642.857
14/08/2015 22:00,9.3,35199,3081,27,44,1565,2,4719,6.164.642.857
14/08/2015 23:00,8.63,33453,2967,28,67,1727,1,4790,6.164.642.857
15/08/2015 00:00,9.36,31558,2170,24,59,1790,2,4045,6.164.642.857
15/08/2015 01:00,8.72,30482,2037,20,55,1836,2,3950,6.164.642.857
15/08/2015 02:00,8.49,29887,1894,17,54,1806,2,3773,6.164.642.857
15/08/2015 03:00,8.42,29500,1756,15,52,1783,2,3608,6.164.642.857
15/08/2015 04:00,8.56,29202,1648,11,50,1752,2,3463,6.164.642.857
15/08/2015 05:00,9.22,29238,1497,8,49,1745,2,3301,6.164.642.857
15/08/2015 06:00,9.36,29837,1362,7,38,1680,1,3088,6.164.642.857
15/08/2015 07:00,10.25,31256,1309,7,28,1643,1,2988,6.164.642.857
15/08/2015 08:00,11.57,33027,1266,9,25,1640,1,2941,6.164.642.857
15/08/2015 09:00,12.43,34416,1191,12,28,1722,2,2955,6.164.642.857
15/08/2015 10:00,12.71,35386,1094,15,33,1815,2,2959,6.164.642.857
15/08/2015 11:00,12.61,35622,901,19,32,1914,4,2870,6.164.642.857
15/08/2015 12:00,12.24,35414,694,21,30,2016,4,2765,6.164.642.857
15/08/2015 13:00,12.08,35045,584,23,28,2099,3,2737,6.164.642.857
15/08/2015 14:00,11.68,34754,467,25,28,2127,1,2648,6.164.642.857
15/08/2015 15:00,11.5,34551,456,24,29,2144,3,2656,6.164.642.857
15/08/2015 16:00,11.62,34711,530,24,30,2183,3,2770,6.164.642.857
15/08/2015 17:00,11.74,34860,528,25,33,2145,3,2734,6.164.642.857
15/08/2015 18:00,12.02,34899,501,28,35,2142,3,2709,6.164.642.857
15/08/2015 19:00,11.98,34496,488,32,40,2129,3,2692,6.164.642.857
15/08/2015 20:00,11.84,34204,501,36,48,2133,4,2722,6.164.642.857
15/08/2015 21:00,11.94,34258,500,41,56,2112,2,2711,6.164.642.857
15/08/2015 22:00,11.94,33651,451,43,58,2103,2,2657,6.164.642.857
15/08/2015 23:00,10.67,32289,448,38,57,2171,2,2716,6.164.642.857
16/08/2015 00:00,10.24,30916,557,35,52,2059,2,2705,6.164.642.857
16/08/2015 01:00,9.85,29941,544,37,52,1939,2,2574,6.164.642.857
16/08/2015 02:00,9.79,29388,506,41,54,1845,2,2448,6.164.642.857
16/08/2015 03:00,9.73,29061,469,43,55,1724,1,2292,6.164.642.857
16/08/2015 04:00,9.63,28759,473,44,56,1645,1,2219,6.164.642.857
16/08/2015 05:00,9.61,28624,478,41,54,1559,1,2133,6.164.642.857
16/08/2015 06:00,9.93,28903,460,39,41,1460,1,2001,6.164.642.857
16/08/2015 07:00,10.34,30121,455,40,28,1361,1,1885,6.164.642.857
16/08/2015 08:00,11.11,31503,466,43,30,1355,1,1895,6.164.642.857
16/08/2015 09:00,12.05,33102,478,48,38,1388,2,1954,6.164.642.857
16/08/2015 10:00,12.43,34114,505,53,45,1481,3,2087,6.164.642.857
16/08/2015 11:00,12.57,34550,535,59,46,1585,5,2230,6.164.642.857
16/08/2015 12:00,12.24,34493,556,63,48,1689,6,2362,6.164.642.857
16/08/2015 13:00,12.07,34325,584,68,50,1757,6,2465,6.164.642.857
16/08/2015 14:00,11.5,34173,619,73,53,1798,7,2550,6.164.642.857
16/08/2015 15:00,11.14,34137,696,75,56,1802,7,2636,6.164.642.857
16/08/2015 16:00,11.26,34269,831,75,58,1814,7,2785,6.164.642.857
16/08/2015 17:00,11.5,34656,953,75,59,1849,8,2944,6.164.642.857
16/08/2015 18:00,11.67,34872,1000,73,62,1903,6,3044,6.164.642.857
16/08/2015 19:00,12.03,34836,1022,68,66,1981,5,3142,6.164.642.857
16/08/2015 20:00,11.99,34816,1060,65,73,2035,5,3238,6.164.642.857
16/08/2015 21:00,12.15,35086,1185,62,80,2082,2,3411,6.164.642.857
16/08/2015 22:00,11.67,34283,1359,56,89,2101,3,3608,6.164.642.857
16/08/2015 23:00,10.7,32529,1543,47,97,2209,2,3898,6.164.642.857
17/08/2015 00:00,9.63,31101,1583,44,95,2176,2,3900,6.236.964.286
17/08/2015 01:00,8.4,30232,1740,42,92,2165,2,4041,6.236.964.286
17/08/2015 02:00,8.03,29813,1857,43,92,2124,3,4119,6.236.964.286
17/08/2015 03:00,7.93,29952,1936,43,92,2124,3,4198,6.236.964.286
17/08/2015 04:00,8.19,30456,2023,38,90,2083,2,4236,6.236.964.286
17/08/2015 05:00,9.94,31970,2125,29,85,2004,4,4247,6.236.964.286
17/08/2015 06:00,11.3,34869,2199,24,78,1893,5,4199,6.236.964.286
17/08/2015 07:00,13.96,38152,2282,23,72,1838,7,4222,6.236.964.286
17/08/2015 08:00,14.59,41018,2426,27,71,1805,6,4335,6.236.964.286
17/08/2015 09:00,14.65,41439,2582,34,71,1820,6,4513,6.236.964.286
17/08/2015 10:00,14.72,41556,2724,39,73,1879,6,4721,6.236.964.286
17/08/2015 11:00,14.51,41338,2842,42,73,1939,5,4901,6.236.964.286
17/08/2015 12:00,14.04,41021,2962,42,73,2019,5,5101,6.236.964.286
17/08/2015 13:00,13.55,40854,3130,42,72,2071,6,5321,6.236.964.286
17/08/2015 14:00,13.31,40501,3262,43,75,2096,5,5481,6.236.964.286
17/08/2015 15:00,12.92,40043,3324,44,76,2092,7,5543,6.236.964.286
17/08/2015 16:00,12.6,39505,3346,45,76,2073,8,5548,6.236.964.286
17/08/2015 17:00,13.06,39285,3313,46,73,2029,8,5469,6.236.964.286
17/08/2015 18:00,12.97,38905,3258,48,72,2021,5,5404,6.236.964.286
17/08/2015 19:00,12.91,38435,3211,47,73,2013,6,5350,6.236.964.286
17/08/2015 20:00,11.88,37858,3197,47,70,2041,5,5360,6.236.964.286
17/08/2015 21:00,12.07,37639,3223,49,64,2035,4,5375,6.236.964.286
17/08/2015 22:00,10.87,36457,3269,46,58,2026,1,5400,6.236.964.286
17/08/2015 23:00,8.97,34296,3250,50,88,2061,2,5451,6.236.964.286
18/08/2015 00:00,9.38,32038,3273,44,92,1973,2,5384,6.236.964.286
18/08/2015 01:00,8.96,31062,3219,39,94,1894,1,5247,6.236.964.286
18/08/2015 02:00,8.46,30616,3128,38,91,1799,2,5058,6.236.964.286
18/08/2015 03:00,8.4,30650,3040,37,87,1737,2,4903,6.236.964.286
18/08/2015 04:00,8.9,31050,3001,32,82,1742,2,4859,6.236.964.286
18/08/2015 05:00,9.4,32560,3018,25,72,1696,3,4814,6.236.964.286
18/08/2015 06:00,12.42,35347,3057,21,62,1592,3,4735,6.236.964.286
18/08/2015 07:00,15.01,38644,3120,20,39,1549,4,4732,6.236.964.286
18/08/2015 08:00,15.44,40586,3234,24,37,1557,4,4856,6.236.964.286
18/08/2015 09:00,15.51,41148,3358,29,44,1607,5,5043,6.236.964.286
18/08/2015 10:00,16.39,41449,3464,34,48,1688,5,5239,6.236.964.286
18/08/2015 11:00,15.93,41532,3545,40,51,1751,10,5397,6.236.964.286
18/08/2015 12:00,15.35,41275,3609,45,54,1807,12,5527,6.236.964.286
18/08/2015 13:00,14.94,40999,3684,51,57,1859,13,5664,6.236.964.286
18/08/2015 14:00,14.61,40574,3750,54,60,1827,11,5702,6.236.964.286
18/08/2015 15:00,13.42,40034,3755,57,61,1829,14,5716,6.236.964.286
18/08/2015 16:00,13.52,39510,3688,54,61,1798,14,5615,6.236.964.286
18/08/2015 17:00,14.21,39199,3545,49,61,1785,13,5453,6.236.964.286
18/08/2015 18:00,13.94,38769,3277,45,62,1745,5,5134,6.236.964.286
18/08/2015 19:00,13.88,38296,2985,41,64,1792,6,4888,6.236.964.286
18/08/2015 20:00,13.22,37775,2774,41,67,1845,6,4733,6.236.964.286
18/08/2015 21:00,13.4,37545,2665,41,70,1938,5,4719,6.236.964.286
18/08/2015 22:00,12.83,36367,2616,38,74,1939,2,4669,6.236.964.286
18/08/2015 23:00,11.23,34243,2563,37,77,1956,3,4636,6.236.964.286
19/08/2015 00:00,12.49,32290,1886,31,75,1915,1,3908,6.236.964.286
19/08/2015 01:00,11.89,31191,1790,27,73,1809,1,3700,6.236.964.286
19/08/2015 02:00,11.48,30724,1725,22,75,1724,1,3547,6.236.964.286
19/08/2015 03:00,11.53,30602,1666,19,76,1644,1,3406,6.236.964.286
19/08/2015 04:00,11.85,31117,1590,16,76,1576,2,3260,6.236.964.286
19/08/2015 05:00,12.75,32367,1512,11,66,1491,2,3082,6.236.964.286
19/08/2015 06:00,17.31,35129,1434,7,48,1270,2,2761,6.236.964.286
19/08/2015 07:00,21.39,38523,1379,5,41,1097,4,2526,6.236.964.286
19/08/2015 08:00,22.16,40890,1362,6,38,979,4,2389,6.236.964.286
19/08/2015 09:00,24.21,41232,1342,7,36,996,5,2386,6.236.964.286
19/08/2015 10:00,25.66,41408,1302,8,34,1038,5,2387,6.236.964.286
19/08/2015 11:00,21.82,41255,1295,8,31,1093,3,2430,6.236.964.286
19/08/2015 12:00,20.92,40696,1357,8,29,1136,3,2533,6.236.964.286
19/08/2015 13:00,21.04,40366,1451,9,28,1148,2,2638,6.236.964.286
19/08/2015 14:00,20.48,40033,1461,10,28,1137,1,2637,6.236.964.286
19/08/2015 15:00,19.74,39634,1400,13,28,1112,3,2556,6.236.964.286
19/08/2015 16:00,19.62,39131,1317,14,28,1102,3,2464,6.236.964.286
19/08/2015 17:00,19.97,38887,1216,15,28,1090,3,2352,6.236.964.286
19/08/2015 18:00,19.88,38497,1084,15,27,1096,1,2223,6.236.964.286
19/08/2015 19:00,18.66,38051,948,16,28,1144,4,2140,6.236.964.286
19/08/2015 20:00,16.16,37591,867,17,32,1274,4,2194,6.236.964.286
19/08/2015 21:00,16.43,37452,868,18,38,1381,3,2308,6.236.964.286
19/08/2015 22:00,14.54,36224,938,16,43,1415,4,2416,6.236.964.286
19/08/2015 23:00,13.47,34000,937,10,42,1505,3,2497,6.236.964.286
20/08/2015 00:00,16.63,32349,800,6,38,1417,2,2263,6.236.964.286
20/08/2015 01:00,15.72,31304,747,4,35,1403,1,2190,6.236.964.286
20/08/2015 02:00,15.52,30839,656,3,32,1294,2,1987,6.236.964.286
20/08/2015 03:00,15.75,30684,548,3,30,1185,0,1766,6.236.964.286
20/08/2015 04:00,16.31,31177,476,3,28,1118,2,1627,6.236.964.286
20/08/2015 05:00,18.11,32486,438,2,26,1010,2,1478,6.236.964.286
20/08/2015 06:00,21.11,35543,415,1,22,799,2,1239,6.236.964.286
20/08/2015 07:00,24.5,38759,368,1,17,675,3,1064,6.236.964.286
20/08/2015 08:00,24.86,41291,321,1,15,587,3,927,6.236.964.286
20/08/2015 09:00,25,41670,309,1,16,514,4,844,6.236.964.286
20/08/2015 10:00,24.95,41739,319,1,16,494,3,833,6.236.964.286
20/08/2015 11:00,24.72,41504,344,2,14,493,2,855,6.236.964.286
20/08/2015 12:00,24.03,41110,377,3,14,508,2,904,6.236.964.286
20/08/2015 13:00,23.73,40920,393,4,14,514,2,927,6.236.964.286
20/08/2015 14:00,23.18,40578,407,5,14,520,0,946,6.236.964.286
20/08/2015 15:00,22.5,40144,438,5,14,526,2,985,6.236.964.286
20/08/2015 16:00,22.16,39661,519,5,14,540,2,1080,6.236.964.286
20/08/2015 17:00,23.55,39497,569,4,14,574,3,1164,6.236.964.286
20/08/2015 18:00,23.55,39018,534,4,14,657,1,1210,6.236.964.286
20/08/2015 19:00,23.71,38561,537,4,15,765,4,1325,6.236.964.286
20/08/2015 20:00,21.82,38089,583,4,16,889,4,1496,6.236.964.286
20/08/2015 21:00,23,37868,597,4,16,1012,3,1632,6.236.964.286
20/08/2015 22:00,21.03,36401,615,4,15,1152,0,1786,6.236.964.286
20/08/2015 23:00,18.45,34141,658,4,20,1272,2,1956,6.236.964.286
21/08/2015 00:00,17,32492,767,4,19,1283,2,2075,6.236.964.286
21/08/2015 01:00,16.09,31458,750,4,17,1182,1,1954,6.236.964.286
21/08/2015 02:00,15.72,31030,735,5,15,1099,1,1855,6.236.964.286
21/08/2015 03:00,15.76,30910,732,6,14,993,1,1746,6.236.964.286
21/08/2015 04:00,16.37,31442,730,6,14,938,1,1689,6.236.964.286
21/08/2015 05:00,18.05,32773,719,5,14,844,2,1584,6.236.964.286
21/08/2015 06:00,20.71,35808,702,3,12,687,2,1406,6.236.964.286
21/08/2015 07:00,24.67,39159,646,2,9,607,3,1267,6.236.964.286
21/08/2015 08:00,24.55,41256,581,1,7,517,3,1109,6.236.964.286
21/08/2015 09:00,24.28,41486,563,1,8,486,3,1061,6.236.964.286
21/08/2015 10:00,23.77,41685,561,1,9,490,3,1064,6.236.964.286
21/08/2015 11:00,22.97,41415,589,2,8,491,2,1092,6.236.964.286
21/08/2015 12:00,21.71,40563,662,3,7,525,2,1199,6.236.964.286
21/08/2015 13:00,21.43,39953,721,5,6,561,2,1295,6.236.964.286
21/08/2015 14:00,21.02,39263,702,6,6,576,0,1290,6.236.964.286
21/08/2015 15:00,20.24,38494,629,7,8,592,2,1238,6.236.964.286
21/08/2015 16:00,19.92,37936,570,7,9,583,3,1172,6.236.964.286
21/08/2015 17:00,20.09,37826,518,7,10,554,4,1093,6.236.964.286
21/08/2015 18:00,20.27,37458,459,8,12,576,2,1057,6.236.964.286
21/08/2015 19:00,20,36840,437,9,14,634,5,1099,6.236.964.286
21/08/2015 20:00,19.13,36213,483,10,16,703,4,1216,6.236.964.286
21/08/2015 21:00,19.53,36060,565,10,19,761,4,1359,6.236.964.286
21/08/2015 22:00,18.57,35031,671,9,20,805,1,1506,6.236.964.286
21/08/2015 23:00,16.56,33232,767,13,28,883,0,1691,6.236.964.286
22/08/2015 00:00,16.68,31629,758,12,27,868,1,1666,6.236.964.286
22/08/2015 01:00,16.33,30678,752,11,26,821,1,1611,6.236.964.286
22/08/2015 02:00,16.14,30117,715,11,24,779,1,1530,6.236.964.286
22/08/2015 03:00,16.08,29760,686,10,23,711,1,1431,6.236.964.286
22/08/2015 04:00,15.99,29531,658,10,21,669,1,1359,6.236.964.286
22/08/2015 05:00,16.17,29653,642,9,18,624,0,1293,6.236.964.286
22/08/2015 06:00,16.39,30316,643,7,15,544,0,1209,6.236.964.286
22/08/2015 07:00,16.84,31769,604,5,12,472,0,1093,6.236.964.286
22/08/2015 08:00,18.02,33546,515,4,9,411,0,939,6.236.964.286
22/08/2015 09:00,18.97,35151,476,3,9,395,0,883,6.236.964.286
22/08/2015 10:00,19.45,36043,518,4,10,346,0,878,6.236.964.286
22/08/2015 11:00,18.75,36110,607,5,11,354,3,980,6.236.964.286
22/08/2015 12:00,17.57,35818,705,6,12,372,3,1098,6.236.964.286
22/08/2015 13:00,16.36,35484,783,7,12,367,3,1172,6.236.964.286
22/08/2015 14:00,15.92,35078,813,8,12,377,2,1212,6.236.964.286
22/08/2015 15:00,16.37,34854,780,9,12,375,5,1181,6.236.964.286
22/08/2015 16:00,16.86,35037,728,11,14,362,6,1121,6.236.964.286
22/08/2015 17:00,18.69,35381,676,14,16,352,6,1064,6.236.964.286
22/08/2015 18:00,19.06,35377,632,18,18,369,5,1042,6.236.964.286
22/08/2015 19:00,18.88,34945,609,20,21,381,4,1035,6.236.964.286
22/08/2015 20:00,18.83,34729,670,22,26,422,4,1144,6.236.964.286
22/08/2015 21:00,18.91,34723,782,24,30,524,1,1361,6.236.964.286
22/08/2015 22:00,18.33,33969,820,21,32,567,2,1442,6.236.964.286
22/08/2015 23:00,16.97,32526,801,23,75,605,2,1506,6.236.964.286
23/08/2015 00:00,16.13,31033,869,23,74,575,1,1542,6.236.964.286
23/08/2015 01:00,15.58,30149,833,22,73,530,1,1459,6.236.964.286
23/08/2015 02:00,15.29,29622,817,20,72,495,2,1406,6.236.964.286
23/08/2015 03:00,15.11,29399,854,19,70,522,1,1466,6.236.964.286
23/08/2015 04:00,14.9,29158,943,17,67,488,1,1516,6.236.964.286
23/08/2015 05:00,14.6,28987,1025,15,58,480,1,1579,6.236.964.286
23/08/2015 06:00,15.01,29196,1104,11,35,470,1,1621,6.236.964.286
23/08/2015 07:00,15.53,30262,1158,9,26,434,0,1627,6.236.964.286
23/08/2015 08:00,16.57,31745,1165,6,21,404,0,1596,6.236.964.286
23/08/2015 09:00,17.1,33193,1211,5,22,422,1,1661,6.236.964.286
23/08/2015 10:00,17.11,34158,1340,6,26,484,2,1858,6.236.964.286
23/08/2015 11:00,16.71,34467,1491,9,28,574,4,2106,6.236.964.286
23/08/2015 12:00,16.03,34389,1631,13,29,678,3,2354,6.236.964.286
23/08/2015 13:00,15.31,34258,1756,20,30,765,4,2575,6.236.964.286
23/08/2015 14:00,15.01,34157,1815,26,33,822,3,2699,6.236.964.286
23/08/2015 15:00,14.81,34101,1834,32,34,867,5,2772,6.236.964.286
23/08/2015 16:00,15.25,34265,1919,39,35,892,7,2892,6.236.964.286
23/08/2015 17:00,16.17,34713,2033,47,36,909,6,3031,6.236.964.286
23/08/2015 18:00,17.22,34946,2004,52,38,954,1,3049,6.236.964.286
23/08/2015 19:00,17.92,35023,1935,52,42,1051,3,3083,6.236.964.286
23/08/2015 20:00,17.96,35139,1962,52,51,1124,3,3192,6.236.964.286
23/08/2015 21:00,18.25,35308,2015,52,61,1202,1,3331,6.236.964.286
23/08/2015 22:00,17.21,34348,2047,54,71,1262,2,3436,6.236.964.286
23/08/2015 23:00,15.17,32588,2085,65,76,1311,4,3541,6.236.964.286
24/08/2015 00:00,15.07,31466,2134,64,75,1277,2,3552,6.398.452.381
24/08/2015 01:00,14.24,30554,2148,61,74,1241,2,3526,6.398.452.381
24/08/2015 02:00,13.79,30149,2159,60,74,1203,2,3498,6.398.452.381
24/08/2015 03:00,13.9,30102,2182,57,73,1188,2,3502,6.398.452.381
24/08/2015 04:00,14.59,30442,2233,50,70,1180,3,3536,6.398.452.381
24/08/2015 05:00,17.05,31954,2254,38,61,1160,3,3516,6.398.452.381
24/08/2015 06:00,20.03,34989,2245,25,51,1135,3,3459,6.398.452.381
24/08/2015 07:00,22.34,38342,2269,18,38,1090,4,3419,6.398.452.381
24/08/2015 08:00,24.76,40488,2334,14,30,1089,4,3471,6.398.452.381
24/08/2015 09:00,25.04,40842,2419,13,28,1164,5,3629,6.398.452.381
24/08/2015 10:00,24.4,40918,2504,15,31,1252,6,3808,6.398.452.381
24/08/2015 11:00,23.42,40870,2553,17,39,1370,5,3984,6.398.452.381
24/08/2015 12:00,22.57,40517,2512,18,52,1523,6,4111,6.398.452.381
24/08/2015 13:00,22.39,40261,2564,17,59,1664,5,4309,6.398.452.381
24/08/2015 14:00,21.9,40007,2599,15,60,1742,3,4419,6.398.452.381
24/08/2015 15:00,21.37,39575,2479,12,58,1750,3,4302,6.398.452.381
24/08/2015 16:00,21.09,39192,2286,13,54,1752,3,4108,6.398.452.381
24/08/2015 17:00,21.56,39086,2104,15,53,1743,3,3918,6.398.452.381
24/08/2015 18:00,21.37,38804,1985,19,54,1764,0,3822,6.398.452.381
24/08/2015 19:00,21.73,38426,1910,25,59,1765,5,3764,6.398.452.381
24/08/2015 20:00,20.48,38116,1873,33,66,1762,5,3739,6.398.452.381
24/08/2015 21:00,20.41,37753,1879,44,74,1762,5,3764,6.398.452.381
24/08/2015 22:00,19.08,36219,1904,52,79,1835,2,3872,6.398.452.381
24/08/2015 23:00,16.13,33941,1870,62,101,1741,3,3777,6.398.452.381
25/08/2015 00:00,14.16,32104,1872,63,100,1649,3,3687,6.398.452.381
25/08/2015 01:00,13.4,31127,1826,61,99,1553,3,3542,6.398.452.381
25/08/2015 02:00,13.02,30683,1674,59,101,1510,3,3347,6.398.452.381
25/08/2015 03:00,12.21,30664,1552,56,101,1502,3,3214,6.398.452.381
25/08/2015 04:00,12.62,30936,1527,49,101,1479,4,3160,6.398.452.381
25/08/2015 05:00,15.15,32348,1475,42,96,1442,4,3059,6.398.452.381
25/08/2015 06:00,18.72,35441,1384,33,89,1360,5,2871,6.398.452.381
25/08/2015 07:00,22.21,39362,1352,26,84,1261,5,2728,6.398.452.381
25/08/2015 08:00,23.18,41251,1342,22,79,1186,5,2634,6.398.452.381
25/08/2015 09:00,22.8,41757,1415,20,77,1130,11,2653,6.398.452.381
25/08/2015 10:00,21.37,42093,1622,21,78,1132,17,2870,6.398.452.381
25/08/2015 11:00,21.01,42041,1681,24,88,1186,21,3000,6.398.452.381
25/08/2015 12:00,20.27,41834,1737,26,98,1284,22,3167,6.398.452.381
25/08/2015 13:00,20.11,41659,2030,28,105,1374,20,3557,6.398.452.381
25/08/2015 14:00,20.13,41289,2323,29,97,1406,15,3870,6.398.452.381
25/08/2015 15:00,19.95,40896,2590,31,84,1519,11,4235,6.398.452.381
25/08/2015 16:00,19.87,40486,2880,36,69,1587,7,4579,6.398.452.381
25/08/2015 17:00,19.46,40194,3051,47,59,1595,4,4756,6.398.452.381
25/08/2015 18:00,18.93,39850,3092,61,54,1650,2,4859,6.398.452.381
25/08/2015 19:00,19.09,39662,3179,70,54,1724,5,5032,6.398.452.381
25/08/2015 20:00,18.16,39410,3244,77,56,1815,7,5199,6.398.452.381
25/08/2015 21:00,18.56,38699,3192,79,52,1896,6,5225,6.398.452.381
25/08/2015 22:00,16.9,37037,3076,73,39,1974,2,5164,6.398.452.381
25/08/2015 23:00,15.05,34635,2887,62,35,2094,6,5084,6.398.452.381
26/08/2015 00:00,13.21,32467,2151,58,46,2051,5,4311,6.398.452.381
26/08/2015 01:00,12.1,31345,1946,52,53,2045,5,4101,6.398.452.381
26/08/2015 02:00,11.67,30892,1756,45,59,2017,5,3882,6.398.452.381
26/08/2015 03:00,11.8,30774,1620,49,63,1896,5,3633,6.398.452.381
26/08/2015 04:00,12.47,31131,1571,49,65,1821,7,3513,6.398.452.381
26/08/2015 05:00,13.92,32533,1615,43,66,1728,7,3459,6.398.452.381
26/08/2015 06:00,17.29,35724,1748,38,65,1631,9,3491,6.398.452.381
26/08/2015 07:00,20.41,39520,1907,39,59,1580,14,3599,6.398.452.381
26/08/2015 08:00,23.83,41018,2012,43,57,1618,18,3748,6.398.452.381
26/08/2015 09:00,24.13,41666,2083,49,57,1629,18,3836,6.398.452.381
26/08/2015 10:00,22.41,41935,2204,64,60,1629,18,3975,6.398.452.381
26/08/2015 11:00,21.57,42021,2226,77,61,1589,17,3970,6.398.452.381
26/08/2015 12:00,21.33,41787,2108,89,60,1523,16,3796,6.398.452.381
26/08/2015 13:00,20.7,41506,1973,93,57,1476,15,3614,6.398.452.381
26/08/2015 14:00,20.41,41136,1875,90,48,1420,13,3446,6.398.452.381
26/08/2015 15:00,19.93,40735,1810,85,32,1397,15,3339,6.398.452.381
26/08/2015 16:00,20.42,40291,1781,78,22,1324,14,3219,6.398.452.381
26/08/2015 17:00,20.25,40181,1709,71,15,1251,10,3056,6.398.452.381
26/08/2015 18:00,20.68,39781,1630,66,11,1267,5,2979,6.398.452.381
26/08/2015 19:00,21.08,39463,1596,60,10,1294,6,2966,6.398.452.381
26/08/2015 20:00,19.43,39202,1631,60,11,1333,6,3041,6.398.452.381
26/08/2015 21:00,19.12,38453,1738,63,14,1414,5,3234,6.398.452.381
26/08/2015 22:00,16.89,36860,1898,59,19,1484,1,3461,6.398.452.381
26/08/2015 23:00,14.31,34396,2009,51,35,1610,4,3709,6.398.452.381
27/08/2015 00:00,11.94,32269,2332,49,34,1614,4,4033,6.398.452.381
27/08/2015 01:00,10.59,31183,2418,46,34,1691,4,4193,6.398.452.381
27/08/2015 02:00,9.28,30780,2483,43,36,1756,2,4320,6.398.452.381
27/08/2015 03:00,9.15,30705,2536,39,38,1769,2,4384,6.398.452.381
27/08/2015 04:00,10.24,31025,2549,35,41,1828,3,4456,6.398.452.381
27/08/2015 05:00,12.07,32469,2438,31,43,1875,3,4390,6.398.452.381
27/08/2015 06:00,15.96,35695,2275,26,37,1759,3,4100,6.398.452.381
27/08/2015 07:00,19.26,39544,2165,23,32,1782,6,4008,6.398.452.381
27/08/2015 08:00,19.92,41803,2098,23,32,1750,9,3912,6.398.452.381
27/08/2015 09:00,19.77,42047,2165,24,35,1751,11,3986,6.398.452.381
27/08/2015 10:00,19.47,42206,2307,25,41,1821,15,4209,6.398.452.381
27/08/2015 11:00,19.41,41978,2442,25,50,1907,17,4441,6.398.452.381
27/08/2015 12:00,19.03,41653,2576,24,59,2034,20,4713,6.398.452.381
27/08/2015 13:00,18.98,41455,2668,25,66,2140,22,4921,6.398.452.381
27/08/2015 14:00,18.75,41153,2645,27,66,2276,21,5035,6.398.452.381
27/08/2015 15:00,18.56,40650,2570,31,62,2401,21,5085,6.398.452.381
27/08/2015 16:00,17.76,40253,2534,37,57,2493,17,5138,6.398.452.381
27/08/2015 17:00,17.81,40213,2523,49,57,2537,13,5179,6.398.452.381
27/08/2015 18:00,17.6,39793,2412,63,59,2610,10,5154,6.398.452.381
27/08/2015 19:00,17.4,39436,2241,74,63,2606,14,4998,6.398.452.381
27/08/2015 20:00,16.58,39165,2038,84,65,2648,13,4848,6.398.452.381
27/08/2015 21:00,16.4,38462,1789,95,64,2656,9,4613,6.398.452.381
27/08/2015 22:00,15.33,36812,1578,97,58,2585,4,4322,6.398.452.381
27/08/2015 23:00,13.35,34389,1421,108,49,2518,2,4098,6.398.452.381
28/08/2015 00:00,11.58,32541,1352,109,36,2370,1,3868,6.398.452.381
28/08/2015 01:00,11.27,31511,1391,109,29,2267,1,3797,6.398.452.381
28/08/2015 02:00,11.13,31060,1430,107,28,2212,1,3778,6.398.452.381
28/08/2015 03:00,11.11,30911,1412,102,30,2216,1,3761,6.398.452.381
28/08/2015 04:00,11.32,31236,1363,96,30,2247,1,3737,6.398.452.381
28/08/2015 05:00,12.52,32731,1322,91,32,2222,4,3671,6.398.452.381
28/08/2015 06:00,16.38,35946,1288,86,36,2136,3,3549,6.398.452.381
28/08/2015 07:00,19.08,39862,1269,78,36,2001,5,3389,6.398.452.381
28/08/2015 08:00,20.67,42385,1274,70,36,2028,5,3413,6.398.452.381
28/08/2015 09:00,20.64,42608,1336,64,38,2063,5,3506,6.398.452.381
28/08/2015 10:00,20.07,42602,1451,65,40,2108,4,3668,6.398.452.381
28/08/2015 11:00,19.64,42152,1550,65,45,2195,4,3859,6.398.452.381
28/08/2015 12:00,19.2,41596,1610,69,50,2290,9,4028,6.398.452.381
28/08/2015 13:00,18.52,40926,1669,70,58,2356,12,4165,6.398.452.381
28/08/2015 14:00,17.82,40268,1713,72,66,2430,14,4295,6.398.452.381
28/08/2015 15:00,16.83,39518,1678,78,69,2437,20,4282,6.398.452.381
28/08/2015 16:00,16.26,39022,1616,85,59,2316,18,4094,6.398.452.381
28/08/2015 17:00,16.28,38937,1470,93,55,2260,17,3895,6.398.452.381
28/08/2015 18:00,16.87,38672,1323,98,50,2240,11,3722,6.398.452.381
28/08/2015 19:00,17.44,38176,1260,104,50,2238,13,3665,6.398.452.381
28/08/2015 20:00,17.2,37684,1167,112,54,2250,11,3594,6.398.452.381
28/08/2015 21:00,17.27,37000,1149,117,59,2276,10,3611,6.398.452.381
28/08/2015 22:00,15.11,35707,1203,114,64,2308,6,3695,6.398.452.381
28/08/2015 23:00,12.79,33764,1229,113,89,2404,13,3848,6.398.452.381
29/08/2015 00:00,12.51,31779,1466,108,90,2411,14,4089,6.398.452.381
29/08/2015 01:00,11.38,30823,1399,114,90,2350,14,3967,6.398.452.381
29/08/2015 02:00,11.43,30275,1304,113,86,2360,14,3877,6.398.452.381
29/08/2015 03:00,11.42,29963,1213,113,81,2321,13,3741,6.398.452.381
29/08/2015 04:00,11.68,29819,1128,109,75,2321,12,3645,6.398.452.381
29/08/2015 05:00,12.07,29904,1049,103,70,2313,13,3548,6.398.452.381
29/08/2015 06:00,12.74,30663,976,101,63,2234,15,3389,6.398.452.381
29/08/2015 07:00,13.47,32303,918,100,55,2172,20,3265,6.398.452.381
29/08/2015 08:00,13.64,34286,901,105,60,2111,24,3201,6.398.452.381
29/08/2015 09:00,14.52,35853,950,115,68,2015,26,3174,6.398.452.381
29/08/2015 10:00,15.12,36649,1018,125,81,1996,27,3247,6.398.452.381
29/08/2015 11:00,15.14,36656,1019,135,90,2039,30,3313,6.398.452.381
29/08/2015 12:00,14.68,36164,1000,142,100,2011,31,3284,6.398.452.381
29/08/2015 13:00,13.99,35787,997,145,111,1976,31,3260,6.398.452.381
29/08/2015 14:00,13.77,35479,965,144,103,1991,27,3230,6.398.452.381
29/08/2015 15:00,13.9,35320,920,139,92,1893,26,3070,6.398.452.381
29/08/2015 16:00,14.35,35660,838,126,80,1739,23,2806,6.398.452.381
29/08/2015 17:00,14.78,35922,699,110,61,1602,17,2489,6.398.452.381
29/08/2015 18:00,15.93,35950,564,95,39,1484,12,2194,6.398.452.381
29/08/2015 19:00,16.11,35684,468,85,30,1378,10,1971,6.398.452.381
29/08/2015 20:00,16.41,35637,422,80,26,1423,9,1960,6.398.452.381
29/08/2015 21:00,16.26,35257,435,78,24,1393,7,1937,6.398.452.381
29/08/2015 22:00,14.94,34353,471,72,22,1345,6,1916,6.398.452.381
29/08/2015 23:00,13.87,32854,465,73,36,1385,2,1961,6.398.452.381
30/08/2015 00:00,13.87,31319,506,68,36,1322,2,1934,6.398.452.381
30/08/2015 01:00,13.74,30386,475,62,35,1279,2,1853,6.398.452.381
30/08/2015 02:00,13.65,29873,426,58,33,1220,2,1739,6.398.452.381
30/08/2015 03:00,13.61,29655,358,53,29,1156,1,1597,6.398.452.381
30/08/2015 04:00,13.61,29512,296,46,27,1084,1,1454,6.398.452.381
30/08/2015 05:00,13.6,29400,223,39,25,997,1,1285,6.398.452.381
30/08/2015 06:00,13.62,29613,155,37,22,912,2,1128,6.398.452.381
30/08/2015 07:00,13.86,30643,114,39,19,805,2,979,6.398.452.381
30/08/2015 08:00,14.71,32165,80,44,17,710,8,859,6.398.452.381
30/08/2015 09:00,15.68,33611,54,51,16,607,8,736,6.398.452.381
30/08/2015 10:00,16.1,34624,46,57,16,588,7,714,6.398.452.381
30/08/2015 11:00,16.42,35007,43,50,17,540,12,662,6.398.452.381
30/08/2015 12:00,14.76,35027,50,44,20,575,13,702,6.398.452.381
30/08/2015 13:00,14.34,34859,63,41,21,546,12,683,6.398.452.381
30/08/2015 14:00,14.32,34710,79,38,16,504,9,646,6.398.452.381
30/08/2015 15:00,15.29,34666,96,34,12,480,8,630,6.398.452.381
30/08/2015 16:00,15.78,34935,128,32,11,518,7,696,6.398.452.381
30/08/2015 17:00,16.21,35519,159,30,9,443,5,646,6.398.452.381
30/08/2015 18:00,16.89,35875,181,29,8,477,0,695,6.398.452.381
30/08/2015 19:00,17.77,36105,191,27,9,491,2,720,6.398.452.381
30/08/2015 20:00,18.16,36339,213,27,11,502,2,755,6.398.452.381
30/08/2015 21:00,18.3,36199,262,28,15,547,0,852,6.398.452.381
30/08/2015 22:00,17.11,34922,311,26,18,557,1,913,6.398.452.381
30/08/2015 23:00,14.87,33026,299,25,15,622,1,962,6.398.452.381
31/08/2015 00:00,13.67,31991,240,20,16,586,1,863,6.459.107.143
31/08/2015 01:00,13.26,31089,256,16,18,568,1,859,6.459.107.143
31/08/2015 02:00,13.12,30748,289,14,22,559,1,885,6.459.107.143
31/08/2015 03:00,13.15,30773,305,12,28,537,1,883,6.459.107.143
31/08/2015 04:00,13.33,31278,348,10,32,505,2,897,6.459.107.143
31/08/2015 05:00,14.27,33015,400,7,39,463,3,912,6.459.107.143
31/08/2015 06:00,19.14,36595,446,5,34,427,2,914,6.459.107.143
31/08/2015 07:00,23.43,40069,502,4,25,384,3,918,6.459.107.143
31/08/2015 08:00,22.66,42117,565,3,21,345,3,937,6.459.107.143
31/08/2015 09:00,22.96,42592,614,3,21,290,3,931,6.459.107.143
31/08/2015 10:00,21.83,42829,661,3,23,289,3,979,6.459.107.143
31/08/2015 11:00,20.75,42769,743,4,25,310,2,1084,6.459.107.143
31/08/2015 12:00,20.09,42160,915,4,27,324,2,1272,6.459.107.143
31/08/2015 13:00,19.91,41956,1162,4,28,358,2,1554,6.459.107.143
31/08/2015 14:00,19.43,41626,1403,3,28,396,0,1830,6.459.107.143
31/08/2015 15:00,19.1,41242,1602,3,27,459,2,2093,6.459.107.143
31/08/2015 16:00,19.03,40859,1807,3,26,518,3,2357,6.459.107.143
31/08/2015 17:00,19.24,40844,1941,3,28,588,3,2563,6.459.107.143
31/08/2015 18:00,19.44,40465,1969,2,31,708,1,2711,6.459.107.143
31/08/2015 19:00,19.29,40264,1987,3,38,792,4,2824,6.459.107.143
31/08/2015 20:00,18.84,40093,1961,4,45,878,5,2893,6.459.107.143
31/08/2015 21:00,18.22,39267,1887,5,52,1025,5,2974,6.459.107.143
31/08/2015 22:00,15.67,37331,1860,6,60,1179,0,3105,6.459.107.143
31/08/2015 23:00,13.27,34867,1718,4,94,1427,3,3246,6.459.107.143
01/09/2015 00:00,13.05,33192,1929,4,98,1598,3,3632,6.459.107.143
01/09/2015 01:00,11.29,32247,1808,5,101,1772,3,3689,6.459.107.143
01/09/2015 02:00,10.64,31788,1673,6,105,1886,5,3675,6.459.107.143
01/09/2015 03:00,10.63,31701,1512,8,108,1927,7,3562,6.459.107.143
01/09/2015 04:00,10.86,32131,1414,11,110,1996,11,3542,6.459.107.143
01/09/2015 05:00,12.07,33753,1343,14,103,2012,11,3483,6.459.107.143
01/09/2015 06:00,15.31,37244,1225,15,92,1920,13,3265,6.459.107.143
01/09/2015 07:00,19.23,40572,1165,14,83,1803,16,3081,6.459.107.143
01/09/2015 08:00,19.92,42119,1106,14,62,1657,17,2856,6.459.107.143
01/09/2015 09:00,19.76,42771,1084,14,39,1557,18,2712,6.459.107.143
01/09/2015 10:00,19.67,42906,1116,18,30,1521,20,2705,6.459.107.143
01/09/2015 11:00,19.59,42869,1171,23,22,1463,15,2694,6.459.107.143
01/09/2015 12:00,19.57,42445,1237,29,19,1493,14,2792,6.459.107.143
01/09/2015 13:00,19.26,42257,1360,34,17,1528,11,2950,6.459.107.143
01/09/2015 14:00,18.93,42017,1495,37,16,1555,10,3113,6.459.107.143
01/09/2015 15:00,18.85,41641,1606,50,16,1507,6,3185,6.459.107.143
01/09/2015 16:00,18.78,41290,1786,57,15,1569,3,3430,6.459.107.143
01/09/2015 17:00,18.61,41369,1979,60,15,1592,4,3650,6.459.107.143
01/09/2015 18:00,18.23,41012,2096,66,14,1608,2,3786,6.459.107.143
01/09/2015 19:00,18.25,40788,2204,74,14,1654,6,3952,6.459.107.143
01/09/2015 20:00,17.74,40566,2301,76,13,1676,6,4072,6.459.107.143
01/09/2015 21:00,17.32,39801,2370,75,12,1707,6,4170,6.459.107.143
01/09/2015 22:00,14.81,37816,2451,70,12,1710,2,4245,6.459.107.143
01/09/2015 23:00,12.6,35331,2531,78,20,1847,1,4477,6.459.107.143
02/09/2015 00:00,11.33,33398,2751,80,16,1899,2,4748,6.459.107.143
02/09/2015 01:00,9.81,32292,2901,83,17,1934,2,4937,6.459.107.143
02/09/2015 02:00,9.32,31874,2963,84,17,1949,2,5015,6.459.107.143
02/09/2015 03:00,9.26,31756,2922,88,19,1964,1,4994,6.459.107.143
02/09/2015 04:00,9.53,32189,2833,87,25,1957,1,4903,6.459.107.143
02/09/2015 05:00,11.55,33681,2762,88,33,1993,3,4879,6.459.107.143
02/09/2015 06:00,15.33,37142,2721,84,35,1957,4,4801,6.459.107.143
02/09/2015 07:00,19.1,41023,2735,80,37,1919,5,4776,6.459.107.143
02/09/2015 08:00,19.56,42914,2844,80,43,1938,6,4911,6.459.107.143
02/09/2015 09:00,19.5,42904,2987,78,46,1834,6,4951,6.459.107.143
02/09/2015 10:00,19.37,42758,3139,78,49,1849,8,5123,6.459.107.143
02/09/2015 11:00,19.23,42862,3239,76,56,1851,10,5232,6.459.107.143
02/09/2015 12:00,18.89,42625,3286,71,62,1905,17,5341,6.459.107.143
02/09/2015 13:00,18.94,42398,3344,68,67,1851,20,5350,6.459.107.143
02/09/2015 14:00,18.52,42131,3372,64,68,1822,19,5345,6.459.107.143
02/09/2015 15:00,18.42,41835,3359,62,66,1725,19,5231,6.459.107.143
02/09/2015 16:00,18.14,41567,3259,62,58,1658,17,5054,6.459.107.143
02/09/2015 17:00,18.59,41588,3100,64,46,1547,11,4768,6.459.107.143
02/09/2015 18:00,18.48,41044,2985,67,38,1527,8,4625,6.459.107.143
02/09/2015 19:00,18.72,40749,2879,66,36,1516,9,4506,6.459.107.143
02/09/2015 20:00,18.5,40532,2759,64,35,1435,8,4301,6.459.107.143
02/09/2015 21:00,18.21,39731,2658,61,33,1409,6,4167,6.459.107.143
02/09/2015 22:00,15.26,37801,2560,59,31,1321,3,3974,6.459.107.143
02/09/2015 23:00,12.8,35274,2486,45,39,1320,3,3893,6.459.107.143
03/09/2015 00:00,12.7,33307,2434,42,34,1194,3,3707,6.459.107.143
03/09/2015 01:00,11.82,32283,2332,38,31,1108,2,3511,6.459.107.143
03/09/2015 02:00,11.51,31901,2229,36,27,1024,2,3318,6.459.107.143
03/09/2015 03:00,11.69,31838,2158,34,23,947,1,3163,6.459.107.143
03/09/2015 04:00,12.12,32277,2102,30,20,868,3,3023,6.459.107.143
03/09/2015 05:00,15.15,33863,2051,28,16,787,3,2885,6.459.107.143
03/09/2015 06:00,18.31,37559,2042,24,13,718,4,2801,6.459.107.143
03/09/2015 07:00,20.87,41297,2041,20,11,647,6,2725,6.459.107.143
03/09/2015 08:00,20.71,43334,2076,19,10,574,7,2686,6.459.107.143
03/09/2015 09:00,20.51,43462,2150,18,12,554,8,2742,6.459.107.143
03/09/2015 10:00,20.78,43245,2236,18,15,548,9,2826,6.459.107.143
03/09/2015 11:00,20.24,42806,2271,17,19,539,7,2853,6.459.107.143
03/09/2015 12:00,20.16,42448,2267,17,22,520,7,2833,6.459.107.143
03/09/2015 13:00,20.08,42282,2230,16,23,475,6,2750,6.459.107.143
03/09/2015 14:00,19.62,41962,2145,16,23,443,4,2631,6.459.107.143
03/09/2015 15:00,19.78,41475,2027,15,21,409,6,2478,6.459.107.143
03/09/2015 16:00,19.49,41399,1859,15,16,382,6,2278,6.459.107.143
03/09/2015 17:00,19.37,41434,1687,15,12,319,5,2038,6.459.107.143
03/09/2015 18:00,19.16,40908,1544,14,10,301,2,1871,6.459.107.143
03/09/2015 19:00,19.5,40576,1443,15,10,299,4,1771,6.459.107.143
03/09/2015 20:00,19.13,40307,1363,16,10,329,4,1722,6.459.107.143
03/09/2015 21:00,19.28,39516,1319,17,11,421,3,1771,6.459.107.143
03/09/2015 22:00,17.99,37721,1312,16,14,421,1,1764,6.459.107.143
03/09/2015 23:00,15.93,35236,1309,11,10,567,1,1898,6.459.107.143
04/09/2015 00:00,16.35,33533,1224,11,11,539,1,1786,6.459.107.143
04/09/2015 01:00,16.13,32596,1171,12,13,538,1,1735,6.459.107.143
04/09/2015 02:00,16.08,32181,1106,12,15,478,1,1612,6.459.107.143
04/09/2015 03:00,16.16,32120,1042,13,19,478,1,1553,6.459.107.143
04/09/2015 04:00,16.36,32593,980,14,23,463,2,1482,6.459.107.143
04/09/2015 05:00,16.99,34167,926,14,24,464,2,1430,6.459.107.143
04/09/2015 06:00,18.77,37589,875,14,22,409,2,1322,6.459.107.143
04/09/2015 07:00,22.65,41362,830,12,16,339,3,1200,6.459.107.143
04/09/2015 08:00,22.85,43596,793,11,13,316,4,1137,6.459.107.143
04/09/2015 09:00,22.63,43551,787,10,11,310,4,1122,6.459.107.143
04/09/2015 10:00,22.68,43198,813,10,11,318,4,1156,6.459.107.143
04/09/2015 11:00,21.57,42701,814,11,15,340,3,1183,6.459.107.143
04/09/2015 12:00,21.14,42191,768,12,16,383,3,1182,6.459.107.143
04/09/2015 13:00,20.19,41488,727,11,16,424,3,1181,6.459.107.143
04/09/2015 14:00,19.38,40892,676,11,19,459,1,1166,6.459.107.143
04/09/2015 15:00,19.11,40195,616,11,19,471,3,1120,6.459.107.143
04/09/2015 16:00,19.04,39921,570,10,17,506,2,1105,6.459.107.143
04/09/2015 17:00,19.06,39886,505,12,18,517,2,1054,6.459.107.143
04/09/2015 18:00,20.18,39591,430,15,20,566,0,1031,6.459.107.143
04/09/2015 19:00,20.77,39042,390,18,21,596,4,1029,6.459.107.143
04/09/2015 20:00,20.26,38728,377,23,25,640,5,1070,6.459.107.143
04/09/2015 21:00,20.08,37994,391,27,27,679,7,1131,6.459.107.143
04/09/2015 22:00,18.82,36516,447,30,34,753,3,1267,6.459.107.143
04/09/2015 23:00,16.85,34506,500,45,24,817,7,1393,6.459.107.143
05/09/2015 00:00,16.51,33120,649,49,28,816,6,1548,6.459.107.143
05/09/2015 01:00,16.25,32150,716,51,31,802,5,1605,6.459.107.143
05/09/2015 02:00,14.59,31629,794,55,33,783,4,1669,6.459.107.143
05/09/2015 03:00,13.98,31420,906,59,35,760,4,1764,6.459.107.143
05/09/2015 04:00,13.59,31390,1059,58,39,754,4,1914,6.459.107.143
05/09/2015 05:00,13.94,31599,1255,53,46,720,5,2079,6.459.107.143
05/09/2015 06:00,13.79,32378,1528,57,51,659,5,2300,6.459.107.143
05/09/2015 07:00,15.04,34234,1878,43,51,611,5,2588,6.459.107.143
05/09/2015 08:00,16.48,36094,2241,41,52,675,8,3017,6.459.107.143
05/09/2015 09:00,17.04,37619,2558,43,55,729,9,3394,6.459.107.143
05/09/2015 10:00,16.91,38014,2903,43,61,779,12,3798,6.459.107.143
05/09/2015 11:00,16.4,37898,3183,47,75,819,16,4140,6.459.107.143
05/09/2015 12:00,15.87,37765,3333,44,89,918,19,4403,6.459.107.143
05/09/2015 13:00,14.69,37400,3467,42,104,997,23,4633,6.459.107.143
05/09/2015 14:00,14.23,37122,3580,35,109,1064,23,4811,6.459.107.143
05/09/2015 15:00,13.18,36940,3587,29,111,1124,27,4878,6.459.107.143
05/09/2015 16:00,14.01,37160,3535,27,112,1194,22,4890,6.459.107.143
05/09/2015 17:00,16.26,37602,3466,27,97,1248,15,4853,6.459.107.143
05/09/2015 18:00,16.7,37991,3356,30,85,1420,15,4906,6.459.107.143
05/09/2015 19:00,16.7,37879,3211,37,74,1514,15,4851,6.459.107.143
05/09/2015 20:00,16.9,37677,3126,42,77,1752,18,5015,6.459.107.143
05/09/2015 21:00,16.68,36985,3129,49,80,1969,16,5243,6.459.107.143
05/09/2015 22:00,13.91,35852,3166,53,82,2054,15,5370,6.459.107.143
05/09/2015 23:00,10.61,34328,3184,35,73,1865,8,5165,6.459.107.143
06/09/2015 00:00,10.22,32940,3308,34,69,2046,9,5466,6.459.107.143
06/09/2015 01:00,4.63,32011,3398,31,63,1977,6,5475,6.459.107.143
06/09/2015 02:00,4.01,31511,3115,29,60,2169,5,5378,6.459.107.143
06/09/2015 03:00,3.76,31252,3180,25,63,2291,5,5564,6.459.107.143
06/09/2015 04:00,3.68,31156,3234,21,63,2403,4,5725,6.459.107.143
06/09/2015 05:00,3.38,31098,3217,20,64,2520,5,5826,6.459.107.143
06/09/2015 06:00,3.62,31350,3107,21,61,2557,4,5750,6.459.107.143
06/09/2015 07:00,5.77,32223,3289,22,53,2653,4,6021,6.459.107.143
06/09/2015 08:00,10.38,33736,3299,21,53,2648,4,6025,6.459.107.143
06/09/2015 09:00,12.1,35190,3275,21,57,2636,5,5994,6.459.107.143
06/09/2015 10:00,12.15,36253,3273,19,60,2625,8,5985,6.459.107.143
06/09/2015 11:00,12.89,36663,3211,17,61,2608,10,5907,6.459.107.143
06/09/2015 12:00,12.12,36555,3106,14,61,2632,8,5821,6.459.107.143
06/09/2015 13:00,11.86,36355,3034,11,59,2633,6,5743,6.459.107.143
06/09/2015 14:00,11.65,36261,2987,8,53,2595,2,5645,6.459.107.143
06/09/2015 15:00,11.94,36273,2925,7,39,2569,3,5543,6.459.107.143
06/09/2015 16:00,13.37,36578,2860,7,30,2527,2,5426,6.459.107.143
06/09/2015 17:00,14.82,37054,2730,9,22,2444,2,5207,6.459.107.143
06/09/2015 18:00,16.2,37457,2499,12,19,2394,0,4924,6.459.107.143
06/09/2015 19:00,17.55,37789,2207,14,16,2392,2,4631,6.459.107.143
06/09/2015 20:00,18.19,38088,1966,14,17,2428,3,4428,6.459.107.143
06/09/2015 21:00,17.99,37654,1794,14,18,2432,1,4259,6.459.107.143
06/09/2015 22:00,17.01,36398,1650,16,20,2542,1,4229,6.459.107.143
06/09/2015 23:00,15.92,34520,1516,8,10,2568,1,4103,6.459.107.143
07/09/2015 00:00,15.95,33274,1205,9,10,2510,1,3735,6.378.571.429
07/09/2015 01:00,14.89,32413,1083,11,12,2458,1,3565,6.378.571.429
07/09/2015 02:00,14.76,32024,1011,13,14,2426,1,3465,6.378.571.429
07/09/2015 03:00,15.03,32080,968,18,16,2354,1,3357,6.378.571.429
07/09/2015 04:00,13.83,32584,912,25,18,2287,2,3244,6.378.571.429
07/09/2015 05:00,16.84,34593,877,30,20,2113,2,3042,6.378.571.429
07/09/2015 06:00,20.08,38215,852,35,17,1937,3,2844,6.378.571.429
07/09/2015 07:00,23.74,42080,820,36,14,1703,5,2578,6.378.571.429
07/09/2015 08:00,25.97,44618,756,40,15,1534,7,2352,6.378.571.429
07/09/2015 09:00,25.28,44706,732,44,21,1433,9,2239,6.378.571.429
07/09/2015 10:00,24.98,44416,794,49,31,1422,15,2311,6.378.571.429
07/09/2015 11:00,24.7,43743,862,60,40,1529,20,2511,6.378.571.429
07/09/2015 12:00,24.77,43322,889,76,52,1657,33,2707,6.378.571.429
07/09/2015 13:00,23.71,43110,950,85,63,1786,43,2927,6.378.571.429
07/09/2015 14:00,22.66,42784,1059,93,74,1925,45,3196,6.378.571.429
07/09/2015 15:00,21.85,42231,1136,105,84,2070,46,3441,6.378.571.429
07/09/2015 16:00,21.41,41875,1189,110,93,2173,43,3608,6.378.571.429
07/09/2015 17:00,21.51,41772,1152,111,101,2172,39,3575,6.378.571.429
07/09/2015 18:00,21.95,41568,1009,112,108,2303,35,3567,6.378.571.429
07/09/2015 19:00,21.95,41565,860,114,111,2388,36,3509,6.378.571.429
07/09/2015 20:00,21.5,41445,797,115,111,2435,32,3490,6.378.571.429
07/09/2015 21:00,21.1,40289,843,116,108,2507,26,3600,6.378.571.429
07/09/2015 22:00,19.48,38435,917,116,100,2554,20,3707,6.378.571.429
07/09/2015 23:00,16.99,35926,944,117,75,2759,11,3906,6.378.571.429
08/09/2015 00:00,16.25,33839,824,115,63,2742,9,3753,6.378.571.429
08/09/2015 01:00,15.91,32934,870,116,53,2659,8,3706,6.378.571.429
08/09/2015 02:00,15.58,32516,886,115,48,2575,9,3633,6.378.571.429
08/09/2015 03:00,15.88,32571,921,116,44,2525,9,3615,6.378.571.429
08/09/2015 04:00,16.06,33113,985,115,41,2402,10,3553,6.378.571.429
08/09/2015 05:00,16.99,34988,1015,112,37,2277,13,3454,6.378.571.429
08/09/2015 06:00,20.38,38431,991,108,35,2024,14,3172,6.378.571.429
08/09/2015 07:00,24.16,42325,964,104,28,1887,22,3005,6.378.571.429
08/09/2015 08:00,25.58,43576,874,95,28,1747,26,2770,6.378.571.429
08/09/2015 09:00,25.93,43760,839,88,31,1572,28,2558,6.378.571.429
08/09/2015 10:00,25.8,43744,902,83,34,1490,28,2537,6.378.571.429
08/09/2015 11:00,24.64,43729,889,79,37,1470,24,2499,6.378.571.429
08/09/2015 12:00,23.97,43398,828,78,39,1400,24,2369,6.378.571.429
08/09/2015 13:00,23.84,43062,819,76,41,1395,25,2356,6.378.571.429
08/09/2015 14:00,22.9,42682,851,73,41,1341,23,2329,6.378.571.429
08/09/2015 15:00,22.86,42253,873,73,39,1293,23,2301,6.378.571.429
08/09/2015 16:00,22.57,41907,879,76,37,1211,21,2224,6.378.571.429
08/09/2015 17:00,22.85,41821,846,79,36,1036,12,2009,6.378.571.429
08/09/2015 18:00,22.8,41509,768,85,34,962,7,1856,6.378.571.429
08/09/2015 19:00,23.55,41550,671,89,32,935,10,1737,6.378.571.429
08/09/2015 20:00,23.45,41410,564,91,29,985,8,1677,6.378.571.429
08/09/2015 21:00,23.13,40252,489,90,26,1068,7,1680,6.378.571.429
08/09/2015 22:00,21.06,38317,431,81,24,1152,6,1694,6.378.571.429
08/09/2015 23:00,19.73,35846,376,69,28,1211,1,1685,6.378.571.429
09/09/2015 00:00,16.18,34145,260,64,25,1216,1,1566,6.378.571.429
09/09/2015 01:00,15.91,33182,243,59,24,1213,1,1540,6.378.571.429
09/09/2015 02:00,15.81,32850,234,52,23,1194,1,1504,6.378.571.429
09/09/2015 03:00,15.86,32866,208,45,23,1197,2,1475,6.378.571.429
09/09/2015 04:00,16.06,33670,191,38,22,1204,3,1458,6.378.571.429
09/09/2015 05:00,18.57,35583,179,32,21,1157,3,1392,6.378.571.429
09/09/2015 06:00,21.88,39348,167,26,17,1021,5,1236,6.378.571.429
09/09/2015 07:00,25.31,42913,157,22,13,944,6,1142,6.378.571.429
09/09/2015 08:00,26.01,44724,144,20,10,759,7,940,6.378.571.429
09/09/2015 09:00,26.52,44199,129,17,11,604,7,768,6.378.571.429
09/09/2015 10:00,26.21,43967,133,16,13,510,6,678,6.378.571.429
09/09/2015 11:00,25.22,43849,143,15,13,467,5,643,6.378.571.429
09/09/2015 12:00,24.09,43457,138,14,10,444,5,611,6.378.571.429
09/09/2015 13:00,23.62,43072,136,15,11,468,6,636,6.378.571.429
09/09/2015 14:00,22.57,42666,144,15,15,478,4,656,6.378.571.429
09/09/2015 15:00,22.94,42252,153,16,17,484,6,676,6.378.571.429
09/09/2015 16:00,22.72,41881,164,16,16,476,6,678,6.378.571.429
09/09/2015 17:00,22.71,41774,162,15,17,511,5,710,6.378.571.429
09/09/2015 18:00,22.76,41505,147,15,19,591,2,774,6.378.571.429
09/09/2015 19:00,22.99,41607,139,13,21,650,4,827,6.378.571.429
09/09/2015 20:00,22.84,41486,137,11,23,709,4,884,6.378.571.429
09/09/2015 21:00,22.05,40329,145,9,23,755,3,935,6.378.571.429
09/09/2015 22:00,20.77,38434,169,7,22,763,1,962,6.378.571.429
09/09/2015 23:00,18,35803,194,6,31,766,1,998,6.378.571.429
10/09/2015 00:00,16.41,34342,128,5,29,746,1,909,6.378.571.429
10/09/2015 01:00,15.86,33380,132,4,24,680,1,841,6.378.571.429
10/09/2015 02:00,15.62,33053,146,5,18,663,1,833,6.378.571.429
10/09/2015 03:00,15.84,33067,148,6,15,640,1,810,6.378.571.429
10/09/2015 04:00,16.25,33836,156,6,13,609,2,786,6.378.571.429
10/09/2015 05:00,19.86,35895,170,5,12,568,2,757,6.378.571.429
10/09/2015 06:00,22.71,39354,189,5,10,523,2,729,6.378.571.429
10/09/2015 07:00,25.11,42808,208,4,7,463,3,685,6.378.571.429
10/09/2015 08:00,26.64,44725,215,3,6,364,3,591,6.378.571.429
10/09/2015 09:00,26.18,44652,209,3,6,287,3,508,6.378.571.429
10/09/2015 10:00,25.67,44344,241,4,7,223,3,478,6.378.571.429
10/09/2015 11:00,24.59,43775,280,4,9,175,2,470,6.378.571.429
10/09/2015 12:00,24.3,43174,309,5,11,181,2,508,6.378.571.429
10/09/2015 13:00,24,42826,354,5,11,171,2,543,6.378.571.429
10/09/2015 14:00,23.11,42456,399,5,11,177,0,592,6.378.571.429
10/09/2015 15:00,23.57,41942,425,5,12,185,2,629,6.378.571.429
10/09/2015 16:00,23.47,41578,454,5,13,195,3,670,6.378.571.429
10/09/2015 17:00,23.76,41537,488,5,13,226,2,734,6.378.571.429
10/09/2015 18:00,23.11,41254,533,6,16,234,1,790,6.378.571.429
10/09/2015 19:00,23.78,41290,600,8,20,278,4,910,6.378.571.429
10/09/2015 20:00,23.35,41249,647,8,26,328,3,1012,6.378.571.429
10/09/2015 21:00,22.72,40201,684,7,30,378,3,1102,6.378.571.429
10/09/2015 22:00,21.02,38271,725,6,34,415,1,1181,6.378.571.429
10/09/2015 23:00,17,35688,756,8,53,535,1,1353,6.378.571.429
11/09/2015 00:00,16.28,34479,858,6,54,560,1,1479,6.378.571.429
11/09/2015 01:00,15.48,33550,859,4,37,592,1,1493,6.378.571.429
11/09/2015 02:00,15.17,33176,875,3,36,621,1,1536,6.378.571.429
11/09/2015 03:00,15.14,33160,906,2,37,645,1,1591,6.378.571.429
11/09/2015 04:00,15.79,33963,971,2,35,673,2,1683,6.378.571.429
11/09/2015 05:00,18.6,35948,1079,2,31,685,2,1799,6.378.571.429
11/09/2015 06:00,21.77,39310,1191,2,28,678,2,1901,6.378.571.429
11/09/2015 07:00,24.59,42739,1279,2,22,656,4,1963,6.378.571.429
11/09/2015 08:00,26.79,43980,1393,2,19,645,3,2062,6.378.571.429
11/09/2015 09:00,26.27,43910,1580,2,20,654,3,2259,6.378.571.429
11/09/2015 10:00,24.97,43743,1788,3,27,708,3,2529,6.378.571.429
11/09/2015 11:00,23.76,43342,1941,3,35,804,3,2786,6.378.571.429
11/09/2015 12:00,22.86,42575,2108,4,46,935,3,3096,6.378.571.429
11/09/2015 13:00,21.88,41788,2270,5,56,1046,3,3380,6.378.571.429
11/09/2015 14:00,20.97,41108,2360,7,57,1118,2,3544,6.378.571.429
11/09/2015 15:00,20.11,40457,2431,8,56,1210,6,3711,6.378.571.429
11/09/2015 16:00,19.71,40024,2500,10,53,1264,7,3834,6.378.571.429
11/09/2015 17:00,20.26,39958,2507,14,56,1364,7,3948,6.378.571.429
11/09/2015 18:00,20.33,39872,2429,21,60,1502,4,4016,6.378.571.429
11/09/2015 19:00,20.88,39772,2340,28,67,1604,7,4046,6.378.571.429
11/09/2015 20:00,20.53,39538,2253,35,71,1661,7,4027,6.378.571.429
11/09/2015 21:00,19.09,38434,2189,41,75,1697,7,4009,6.378.571.429
11/09/2015 22:00,16.83,36812,2138,44,78,1629,4,3893,6.378.571.429
11/09/2015 23:00,15.07,34884,2056,64,82,1600,3,3805,6.378.571.429
12/09/2015 00:00,15,33451,1723,59,80,1500,3,3365,6.378.571.429
12/09/2015 01:00,14.61,32494,1614,56,78,1382,3,3133,6.378.571.429
12/09/2015 02:00,14.48,32116,1553,54,82,1322,3,3014,6.378.571.429
12/09/2015 03:00,14.53,31901,1504,51,85,1298,3,2941,6.378.571.429
12/09/2015 04:00,14.6,31943,1464,48,87,1319,3,2921,6.378.571.429
12/09/2015 05:00,14.99,32237,1455,46,87,1327,3,2918,6.378.571.429
12/09/2015 06:00,15.74,32782,1479,38,85,1362,3,2967,6.378.571.429
12/09/2015 07:00,16.38,34007,1539,31,82,1383,3,3038,6.378.571.429
12/09/2015 08:00,17,35820,1653,26,80,1406,4,3169,6.378.571.429
12/09/2015 09:00,18.78,37170,1825,23,79,1536,7,3470,6.378.571.429
12/09/2015 10:00,19.03,37942,1983,24,80,1659,10,3756,6.378.571.429
12/09/2015 11:00,18.26,37883,2101,25,88,1713,13,3940,6.378.571.429
12/09/2015 12:00,16.91,37544,2224,28,97,1788,13,4150,6.378.571.429
12/09/2015 13:00,16.49,37190,2328,29,107,1843,12,4319,6.378.571.429
12/09/2015 14:00,15.43,36923,2396,31,93,1874,8,4402,6.378.571.429
12/09/2015 15:00,16.29,36783,2443,32,77,1853,9,4414,6.378.571.429
12/09/2015 16:00,16.74,36997,2483,36,61,1845,7,4432,6.378.571.429
12/09/2015 17:00,17.44,37482,2498,41,57,1868,3,4467,6.378.571.429
12/09/2015 18:00,17.95,37679,2535,48,54,1950,3,4590,6.378.571.429
12/09/2015 19:00,17.99,37765,2555,53,54,2016,3,4681,6.378.571.429
12/09/2015 20:00,17.78,37616,2571,57,58,2083,4,4773,6.378.571.429
12/09/2015 21:00,16.6,36907,2603,62,63,2114,3,4845,6.378.571.429
12/09/2015 22:00,15.47,35720,2637,61,67,2102,3,4870,6.378.571.429
12/09/2015 23:00,14.41,34207,2624,61,66,2125,7,4883,6.378.571.429
13/09/2015 00:00,13.18,32756,2277,59,68,2017,7,4428,6.378.571.429
13/09/2015 01:00,13.18,31872,2223,56,71,1931,7,4288,6.378.571.429
13/09/2015 02:00,12.88,31410,2185,54,72,1875,7,4193,6.378.571.429
13/09/2015 03:00,12.92,31192,2145,53,73,1861,8,4140,6.378.571.429
13/09/2015 04:00,13.1,31161,2141,50,73,1894,6,4164,6.378.571.429
13/09/2015 05:00,13.6,31180,2141,47,70,1981,6,4245,6.378.571.429
13/09/2015 06:00,14.66,31377,2132,44,65,1962,6,4209,6.378.571.429
13/09/2015 07:00,14.93,32186,2120,40,59,1961,8,4188,6.378.571.429
13/09/2015 08:00,15.73,33627,2084,38,54,1992,7,4175,6.378.571.429
13/09/2015 09:00,17.19,35059,2022,38,54,2015,7,4136,6.378.571.429
13/09/2015 10:00,18.99,36001,1948,36,59,2065,8,4116,6.378.571.429
13/09/2015 11:00,20,36348,1858,37,68,2086,11,4060,6.378.571.429
13/09/2015 12:00,18.95,36345,1734,37,77,2086,12,3946,6.378.571.429
13/09/2015 13:00,18.86,36129,1635,35,82,2096,12,3860,6.378.571.429
13/09/2015 14:00,17.34,36031,1589,31,78,2104,10,3812,6.378.571.429
13/09/2015 15:00,17.4,36041,1534,28,72,2116,13,3763,6.378.571.429
13/09/2015 16:00,18.95,36329,1457,31,67,2074,12,3641,6.378.571.429
13/09/2015 17:00,19.67,37008,1387,38,66,2139,11,3641,6.378.571.429
13/09/2015 18:00,21.17,37607,1339,48,68,2255,8,3718,6.378.571.429
13/09/2015 19:00,21.27,38167,1331,56,73,2319,12,3791,6.378.571.429
13/09/2015 20:00,21.44,38292,1337,60,79,2345,13,3834,6.378.571.429
13/09/2015 21:00,21.01,37550,1334,64,85,2311,12,3806,6.378.571.429
13/09/2015 22:00,17.44,36096,1361,63,90,2253,4,3771,6.378.571.429
13/09/2015 23:00,15.45,34174,1387,55,94,2142,5,3683,6.378.571.429
14/09/2015 00:00,13.53,32465,1622,54,94,2110,6,3886,6.503.869.048
14/09/2015 01:00,12.47,31634,1698,53,95,2132,7,3985,6.503.869.048
14/09/2015 02:00,12.12,31256,1815,52,99,2217,7,4190,6.503.869.048
14/09/2015 03:00,11.98,31349,1968,53,104,2273,8,4406,6.503.869.048
14/09/2015 04:00,12.59,31867,2160,50,108,2382,11,4711,6.503.869.048
14/09/2015 05:00,14.33,33684,2362,46,110,2478,13,5009,6.503.869.048
14/09/2015 06:00,18.55,37006,2519,41,111,2565,13,5249,6.503.869.048
14/09/2015 07:00,22,40583,2658,36,112,2572,17,5395,6.503.869.048
14/09/2015 08:00,22.95,42200,2704,32,117,2607,20,5480,6.503.869.048
14/09/2015 09:00,22.99,43522,2635,31,118,2629,28,5441,6.503.869.048
14/09/2015 10:00,22.96,43364,2543,32,121,2637,32,5365,6.503.869.048
14/09/2015 11:00,22.9,42587,2418,37,126,2675,34,5290,6.503.869.048
14/09/2015 12:00,22.91,42216,2297,43,130,2802,34,5306,6.503.869.048
14/09/2015 13:00,23.07,42045,2195,44,132,2822,34,5227,6.503.869.048
14/09/2015 14:00,22.28,41729,1982,45,132,2851,31,5041,6.503.869.048
14/09/2015 15:00,22.29,41377,1709,45,130,2903,33,4820,6.503.869.048
14/09/2015 16:00,21.59,41230,1475,51,127,2949,32,4634,6.503.869.048
14/09/2015 17:00,21.93,41294,1317,61,128,2952,26,4484,6.503.869.048
14/09/2015 18:00,21.89,41170,1242,73,131,3031,18,4495,6.503.869.048
14/09/2015 19:00,22.44,41348,1219,83,137,3067,21,4527,6.503.869.048
14/09/2015 20:00,21.55,40946,1231,89,141,3050,18,4529,6.503.869.048
14/09/2015 21:00,20.37,39670,1264,93,144,3052,19,4572,6.503.869.048
14/09/2015 22:00,17.15,37514,1317,91,147,3042,9,4606,6.503.869.048
14/09/2015 23:00,15.14,35114,1337,100,158,2987,19,4601,6.503.869.048
15/09/2015 00:00,12.74,33669,1275,102,158,2854,20,4409,6.503.869.048
15/09/2015 01:00,11.64,32718,1435,105,157,2839,23,4559,6.503.869.048
15/09/2015 02:00,11.49,32254,1615,108,153,2725,26,4627,6.503.869.048
15/09/2015 03:00,11.18,32214,1905,113,147,2708,25,4898,6.503.869.048
15/09/2015 04:00,11.77,32718,2271,116,140,2684,26,5237,6.503.869.048
15/09/2015 05:00,13.34,34625,2501,119,128,2673,28,5449,6.503.869.048
15/09/2015 06:00,17.86,38033,2571,122,114,2552,26,5385,6.503.869.048
15/09/2015 07:00,21.48,41738,2632,124,100,2548,26,5430,6.503.869.048
15/09/2015 08:00,22.17,43656,2736,129,80,2532,24,5501,6.503.869.048
15/09/2015 09:00,22.2,43110,2821,130,62,2596,18,5627,6.503.869.048
15/09/2015 10:00,21.88,42937,2871,130,45,2532,14,5592,6.503.869.048
15/09/2015 11:00,21.61,42588,2861,129,39,2633,12,5674,6.503.869.048
15/09/2015 12:00,21.57,42297,2789,128,37,2702,10,5666,6.503.869.048
15/09/2015 13:00,21.55,41998,2711,126,35,2677,8,5557,6.503.869.048
15/09/2015 14:00,20.77,41680,2642,121,29,2635,7,5434,6.503.869.048
15/09/2015 15:00,21.13,41412,2566,111,22,2637,5,5341,6.503.869.048
15/09/2015 16:00,21.13,41440,2459,100,14,2532,3,5108,6.503.869.048
15/09/2015 17:00,21.62,41630,2356,88,12,2415,2,4873,6.503.869.048
15/09/2015 18:00,21.85,41642,2256,79,11,2356,0,4702,6.503.869.048
15/09/2015 19:00,22.23,41461,2181,68,13,2371,3,4636,6.503.869.048
15/09/2015 20:00,21.91,41275,2183,58,19,2293,4,4557,6.503.869.048
15/09/2015 21:00,20.55,40080,2281,49,25,2249,3,4607,6.503.869.048
15/09/2015 22:00,17.87,38016,2403,44,28,2169,1,4645,6.503.869.048
15/09/2015 23:00,14.94,35533,2465,41,32,1965,1,4504,6.503.869.048
16/09/2015 00:00,13.8,34006,2114,38,29,1805,1,3987,6.503.869.048
16/09/2015 01:00,13.36,32939,2127,35,25,1612,2,3801,6.503.869.048
16/09/2015 02:00,13.49,32567,2073,31,21,1492,2,3619,6.503.869.048
16/09/2015 03:00,14.01,32496,2003,28,20,1410,1,3462,6.503.869.048
16/09/2015 04:00,14.52,32979,1987,26,23,1327,3,3366,6.503.869.048
16/09/2015 05:00,15.9,34870,1934,26,25,1296,3,3284,6.503.869.048
16/09/2015 06:00,20.73,38544,1827,28,23,1223,4,3105,6.503.869.048
16/09/2015 07:00,23.71,41998,1764,25,18,1152,5,2964,6.503.869.048
16/09/2015 08:00,25.04,43906,1679,23,13,1090,5,2810,6.503.869.048
16/09/2015 09:00,25.59,43633,1575,20,10,1010,5,2620,6.503.869.048
16/09/2015 10:00,25.44,43365,1459,20,8,1021,4,2512,6.503.869.048
16/09/2015 11:00,24.95,42974,1309,21,7,991,3,2331,6.503.869.048
16/09/2015 12:00,24.39,42676,1247,23,7,1005,3,2285,6.503.869.048
16/09/2015 13:00,24.36,42501,1349,23,8,954,3,2337,6.503.869.048
16/09/2015 14:00,23.22,42164,1517,25,9,913,2,2466,6.503.869.048
16/09/2015 15:00,23.16,41831,1686,25,11,930,2,2654,6.503.869.048
16/09/2015 16:00,22.57,41611,1840,26,14,1006,2,2888,6.503.869.048
16/09/2015 17:00,22.55,41919,1941,30,16,1130,2,3119,6.503.869.048
16/09/2015 18:00,22.35,41633,2032,31,20,1307,0,3390,6.503.869.048
16/09/2015 19:00,22.47,41841,2141,32,30,1448,3,3654,6.503.869.048
16/09/2015 20:00,21.45,41547,2247,32,36,1537,3,3855,6.503.869.048
16/09/2015 21:00,20.26,40329,2342,31,43,1604,1,4021,6.503.869.048
16/09/2015 22:00,16.65,38291,2434,27,50,1669,0,4180,6.503.869.048
16/09/2015 23:00,14.06,35712,2454,13,54,1817,1,4339,6.503.869.048
17/09/2015 00:00,14.02,33835,2687,13,56,1891,1,4648,6.503.869.048
17/09/2015 01:00,12.54,32861,2934,13,57,2002,1,5007,6.503.869.048
17/09/2015 02:00,12.15,32442,3011,14,59,2139,2,5225,6.503.869.048
17/09/2015 03:00,12.08,32393,2975,15,60,2193,3,5246,6.503.869.048
17/09/2015 04:00,12.18,32907,2910,17,61,2213,5,5206,6.503.869.048
17/09/2015 05:00,15.06,34616,2854,18,59,2249,5,5185,6.503.869.048
17/09/2015 06:00,20.25,38234,2883,23,56,2300,7,5269,6.503.869.048
17/09/2015 07:00,22.53,41978,2968,21,53,2291,8,5341,6.503.869.048
17/09/2015 08:00,23.57,43157,3101,23,44,2316,8,5492,6.503.869.048
17/09/2015 09:00,23.18,42879,3207,29,39,2426,8,5709,6.503.869.048
17/09/2015 10:00,22.71,42951,3293,36,38,2545,9,5921,6.503.869.048
17/09/2015 11:00,21.95,42710,3383,42,41,2794,10,6270,6.503.869.048
17/09/2015 12:00,21.75,42370,3455,48,46,2840,14,6403,6.503.869.048
17/09/2015 13:00,21.48,42136,3500,51,50,2874,16,6491,6.503.869.048
17/09/2015 14:00,20.8,41908,3494,55,49,2913,15,6526,6.503.869.048
17/09/2015 15:00,20.83,41461,3405,60,45,2918,13,6441,6.503.869.048
17/09/2015 16:00,20.82,41278,3231,67,39,2855,12,6204,6.503.869.048
17/09/2015 17:00,20.86,41698,3011,76,37,2784,8,5916,6.503.869.048
17/09/2015 18:00,20.81,41683,2806,82,39,2627,4,5558,6.503.869.048
17/09/2015 19:00,21.16,41736,2643,84,44,2566,6,5343,6.503.869.048
17/09/2015 20:00,20.45,41345,2499,83,46,2445,6,5079,6.503.869.048
17/09/2015 21:00,19.02,40007,2388,76,45,2375,6,4890,6.503.869.048
17/09/2015 22:00,15.88,37871,2385,66,39,2337,4,4831,6.503.869.048
17/09/2015 23:00,13.87,35306,2445,88,67,2237,2,4839,6.503.869.048
18/09/2015 00:00,10.01,33540,3404,82,63,2198,2,5749,6.503.869.048
18/09/2015 01:00,5.49,32523,3541,83,60,2299,1,5984,6.503.869.048
18/09/2015 02:00,4.29,32094,3633,85,74,2374,2,6168,6.503.869.048
18/09/2015 03:00,4.03,32015,3672,88,91,2417,3,6271,6.503.869.048
18/09/2015 04:00,4.86,32576,3682,91,107,2580,11,6471,6.503.869.048
18/09/2015 05:00,9.08,34534,3612,99,108,2664,10,6493,6.503.869.048
18/09/2015 06:00,15.93,38371,3456,107,102,2686,15,6366,6.503.869.048
18/09/2015 07:00,19,41991,3268,107,97,2684,20,6176,6.503.869.048
18/09/2015 08:00,20.29,43652,3131,105,105,2685,27,6053,6.503.869.048
18/09/2015 09:00,20.27,43293,3080,117,112,2679,40,6028,6.503.869.048
18/09/2015 10:00,20.21,43209,3074,131,125,2669,50,6049,6.503.869.048
18/09/2015 11:00,19.69,42814,3076,147,126,2691,52,6092,6.503.869.048
18/09/2015 12:00,18.53,42301,3050,166,129,2700,50,6095,6.503.869.048
18/09/2015 13:00,17.6,41601,3007,182,129,2739,49,6106,6.503.869.048
18/09/2015 14:00,16.1,40965,2926,189,125,2815,47,6102,6.503.869.048
18/09/2015 15:00,16.11,40291,2792,193,113,2881,46,6025,6.503.869.048
18/09/2015 16:00,16.03,40007,2622,196,100,2955,41,5914,6.503.869.048
18/09/2015 17:00,16.97,40232,2377,202,83,3050,38,5750,6.503.869.048
18/09/2015 18:00,17.88,40532,2061,206,71,3074,31,5443,6.503.869.048
18/09/2015 19:00,18.92,40669,1767,205,62,3113,33,5180,6.503.869.048
18/09/2015 20:00,17.48,39718,1575,200,58,3148,29,5010,6.503.869.048
18/09/2015 21:00,15.79,38462,1469,193,56,3158,23,4899,6.503.869.048
18/09/2015 22:00,15.1,36815,1348,184,55,3109,16,4712,6.503.869.048
18/09/2015 23:00,12.33,34436,1243,197,61,3277,25,4803,6.503.869.048
19/09/2015 00:00,8.23,32577,917,187,61,3182,24,4371,6.503.869.048
19/09/2015 01:00,6.63,31651,874,179,59,3122,23,4257,6.503.869.048
19/09/2015 02:00,6.01,31204,816,171,60,3050,22,4119,6.503.869.048
19/09/2015 03:00,6.02,31021,782,165,61,2965,24,3997,6.503.869.048
19/09/2015 04:00,6.44,31095,777,160,61,2886,23,3907,6.503.869.048
19/09/2015 05:00,8.52,31497,780,157,58,2798,21,3814,6.503.869.048
19/09/2015 06:00,12.17,32137,777,158,53,2715,24,3727,6.503.869.048
19/09/2015 07:00,14.06,33361,770,162,46,2561,30,3569,6.503.869.048
19/09/2015 08:00,15.47,35204,779,169,46,2460,37,3491,6.503.869.048
19/09/2015 09:00,15.85,36747,831,175,49,2442,39,3536,6.503.869.048
19/09/2015 10:00,16.49,37528,882,179,56,2434,38,3589,6.503.869.048
19/09/2015 11:00,16.47,37528,912,181,60,2419,37,3609,6.503.869.048
19/09/2015 12:00,16.02,37173,937,180,70,2478,36,3701,6.503.869.048
19/09/2015 13:00,15.78,36748,1000,175,76,2457,37,3745,6.503.869.048
19/09/2015 14:00,15.56,36467,1038,167,68,2451,37,3761,6.503.869.048
19/09/2015 15:00,15.48,36320,1054,155,59,2441,33,3742,6.503.869.048
19/09/2015 16:00,15.43,36579,1112,142,48,2380,27,3709,6.503.869.048
19/09/2015 17:00,15.45,37247,1125,131,40,2304,21,3621,6.503.869.048
19/09/2015 18:00,15.77,37726,1082,120,34,2207,16,3459,6.503.869.048
19/09/2015 19:00,16.33,38067,1054,110,31,2165,11,3371,6.503.869.048
19/09/2015 20:00,15.96,37686,1058,102,30,2147,10,3347,6.503.869.048
19/09/2015 21:00,15.4,36740,1106,94,31,2118,10,3359,6.503.869.048
19/09/2015 22:00,15.12,35424,1150,81,29,2089,7,3356,6.503.869.048
19/09/2015 23:00,12.4,33531,1221,65,21,1875,3,3185,6.503.869.048
20/09/2015 00:00,11.92,32281,1709,59,20,1845,3,3636,6.503.869.048
20/09/2015 01:00,9.96,31343,1704,55,19,1813,2,3593,6.503.869.048
20/09/2015 02:00,9.41,30883,1691,51,17,1788,2,3549,6.503.869.048
20/09/2015 03:00,9.37,30735,1652,46,15,1737,1,3451,6.503.869.048
20/09/2015 04:00,9.81,30854,1638,43,13,1694,1,3389,6.503.869.048
20/09/2015 05:00,10.19,31001,1588,39,14,1666,1,3308,6.503.869.048
20/09/2015 06:00,12.67,31342,1507,34,13,1618,4,3176,6.503.869.048
20/09/2015 07:00,14.05,32186,1447,29,13,1520,4,3013,6.503.869.048
20/09/2015 08:00,15.23,33682,1374,23,13,1427,4,2841,6.503.869.048
20/09/2015 09:00,15.58,35208,1307,20,11,1340,4,2682,6.503.869.048
20/09/2015 10:00,15.64,36250,1283,18,10,1287,4,2602,6.503.869.048
20/09/2015 11:00,15.76,36653,1223,17,10,1227,4,2481,6.503.869.048
20/09/2015 12:00,15.55,36517,1148,16,11,1136,4,2315,6.503.869.048
20/09/2015 13:00,15.4,36252,1141,13,10,1079,5,2248,6.503.869.048
20/09/2015 14:00,15.35,36093,1141,10,9,1041,5,2206,6.503.869.048
20/09/2015 15:00,15.3,36081,1110,8,10,1020,5,2153,6.503.869.048
20/09/2015 16:00,15.25,36373,1054,6,10,1010,3,2083,6.503.869.048
20/09/2015 17:00,16.72,37139,940,6,9,998,3,1956,6.503.869.048
20/09/2015 18:00,18.9,38030,792,7,7,997,1,1804,6.503.869.048
20/09/2015 19:00,20.89,38875,667,9,7,997,1,1681,6.503.869.048
20/09/2015 20:00,21.48,38883,585,10,9,978,3,1585,6.503.869.048
20/09/2015 21:00,19.82,37961,532,9,9,955,3,1508,6.503.869.048
20/09/2015 22:00,17.56,36437,478,8,10,897,2,1395,6.503.869.048
20/09/2015 23:00,15.7,34449,436,6,10,767,1,1220,6.503.869.048
21/09/2015 00:00,15.29,32619,542,6,11,690,1,1250,6.560.238.095
21/09/2015 01:00,14.67,31747,531,7,12,647,1,1198,6.560.238.095
21/09/2015 02:00,14.49,31356,506,7,12,609,1,1135,6.560.238.095
21/09/2015 03:00,14.73,31584,469,9,13,576,1,1068,6.560.238.095
21/09/2015 04:00,15.38,32405,433,11,15,567,3,1029,6.560.238.095
21/09/2015 05:00,16.85,35000,370,12,17,547,4,950,6.560.238.095
21/09/2015 06:00,21.35,38942,306,12,20,501,5,844,6.560.238.095
21/09/2015 07:00,24.66,42770,252,11,22,446,7,738,6.560.238.095
21/09/2015 08:00,25.38,44168,216,9,22,409,7,663,6.560.238.095
21/09/2015 09:00,24.99,44036,210,8,25,348,7,598,6.560.238.095
21/09/2015 10:00,24.8,43932,232,9,31,317,7,596,6.560.238.095
21/09/2015 11:00,24.33,43585,250,13,37,385,6,691,6.560.238.095
21/09/2015 12:00,23.64,43103,254,18,40,370,7,689,6.560.238.095
21/09/2015 13:00,23.62,42842,265,22,42,375,7,711,6.560.238.095
21/09/2015 14:00,22.85,42468,267,26,43,382,5,723,6.560.238.095
21/09/2015 15:00,23.2,42040,256,28,40,371,6,701,6.560.238.095
21/09/2015 16:00,22.99,41985,264,26,38,401,6,735,6.560.238.095
21/09/2015 17:00,23.38,42401,278,25,34,394,5,736,6.560.238.095
21/09/2015 18:00,23.72,42649,295,25,32,396,3,751,6.560.238.095
21/09/2015 19:00,24.28,42813,355,27,31,450,5,868,6.560.238.095
21/09/2015 20:00,22.9,42097,429,29,31,444,4,937,6.560.238.095
21/09/2015 21:00,21.01,40559,540,35,32,440,4,1051,6.560.238.095
21/09/2015 22:00,17.26,38296,651,39,32,450,1,1173,6.560.238.095
21/09/2015 23:00,15.25,35635,749,38,16,454,2,1259,6.560.238.095
22/09/2015 00:00,13.66,33322,1003,40,17,468,2,1530,6.560.238.095
22/09/2015 01:00,12.32,32356,1112,40,19,489,2,1662,6.560.238.095
22/09/2015 02:00,12.05,31949,1204,42,20,541,2,1809,6.560.238.095
22/09/2015 03:00,11.94,31904,1311,43,21,590,2,1967,6.560.238.095
22/09/2015 04:00,12.26,32510,1426,45,23,644,3,2141,6.560.238.095
22/09/2015 05:00,14.95,34516,1507,45,24,677,4,2257,6.560.238.095
22/09/2015 06:00,17.86,38557,1570,44,27,710,5,2356,6.560.238.095
22/09/2015 07:00,21.03,42284,1651,44,29,724,7,2455,6.560.238.095
22/09/2015 08:00,22.08,43980,1734,44,29,741,7,2555,6.560.238.095
22/09/2015 09:00,21.94,43944,1787,45,33,768,7,2640,6.560.238.095
22/09/2015 10:00,21.83,43891,1793,48,35,775,8,2659,6.560.238.095
22/09/2015 11:00,21.33,43682,1750,49,35,803,7,2644,6.560.238.095
22/09/2015 12:00,21.05,43307,1633,48,36,826,8,2551,6.560.238.095
22/09/2015 13:00,21.09,43045,1537,46,37,828,9,2457,6.560.238.095
22/09/2015 14:00,20.25,42671,1408,42,36,840,8,2334,6.560.238.095
22/09/2015 15:00,20.93,42324,1250,40,34,836,8,2168,6.560.238.095
22/09/2015 16:00,21.32,42097,1136,37,34,870,7,2084,6.560.238.095
22/09/2015 17:00,21.81,42246,1021,40,42,941,6,2050,6.560.238.095
22/09/2015 18:00,21.81,42416,872,44,50,1013,6,1985,6.560.238.095
22/09/2015 19:00,22.57,42873,728,47,62,1127,10,1974,6.560.238.095
22/09/2015 20:00,20.96,42258,603,51,69,1194,12,1929,6.560.238.095
22/09/2015 21:00,18.67,40758,447,51,75,1199,12,1784,6.560.238.095
22/09/2015 22:00,16.3,38454,334,49,79,1225,10,1697,6.560.238.095
22/09/2015 23:00,14.72,35750,267,48,81,1189,9,1594,6.560.238.095
23/09/2015 00:00,13.94,33959,302,50,80,1144,9,1585,6.560.238.095
23/09/2015 01:00,12.86,32847,270,53,79,1115,9,1526,6.560.238.095
23/09/2015 02:00,12.96,32447,244,54,80,1045,11,1434,6.560.238.095
23/09/2015 03:00,13.05,32405,197,55,81,1003,12,1348,6.560.238.095
23/09/2015 04:00,13.23,33079,143,57,81,1021,14,1316,6.560.238.095
23/09/2015 05:00,15.09,35140,111,58,80,1071,16,1336,6.560.238.095
23/09/2015 06:00,18.88,38806,103,59,75,1097,17,1351,6.560.238.095
23/09/2015 07:00,21.9,42472,132,56,70,1059,18,1335,6.560.238.095
23/09/2015 08:00,23.06,43872,135,56,65,1034,19,1309,6.560.238.095
23/09/2015 09:00,22.96,44102,100,53,62,980,19,1214,6.560.238.095
23/09/2015 10:00,22.78,43933,89,53,60,965,17,1184,6.560.238.095
23/09/2015 11:00,22.77,43806,103,57,59,931,14,1164,6.560.238.095
23/09/2015 12:00,22.93,43297,125,58,57,946,13,1199,6.560.238.095
23/09/2015 13:00,22.79,42967,130,53,53,924,11,1171,6.560.238.095
23/09/2015 14:00,21.6,42657,143,47,45,882,7,1124,6.560.238.095
23/09/2015 15:00,20.76,42235,158,44,38,827,6,1073,6.560.238.095
23/09/2015 16:00,20.31,41999,194,45,33,822,5,1099,6.560.238.095
23/09/2015 17:00,20.42,42185,217,49,32,842,5,1145,6.560.238.095
23/09/2015 18:00,21.33,42453,186,53,35,847,3,1124,6.560.238.095
23/09/2015 19:00,22.38,42952,183,57,37,934,6,1217,6.560.238.095
23/09/2015 20:00,20.55,42199,199,56,38,1016,5,1314,6.560.238.095
23/09/2015 21:00,18.19,40620,233,54,38,1067,4,1396,6.560.238.095
23/09/2015 22:00,15.6,38317,274,51,37,1032,2,1396,6.560.238.095
23/09/2015 23:00,13.81,35509,313,48,25,1078,1,1465,6.560.238.095
24/09/2015 00:00,13.95,33790,428,47,25,1015,1,1516,6.560.238.095
24/09/2015 01:00,12.78,32737,448,46,26,993,1,1514,6.560.238.095
24/09/2015 02:00,12.46,32336,485,43,26,945,1,1500,6.560.238.095
24/09/2015 03:00,12.15,32337,522,39,25,890,2,1478,6.560.238.095
24/09/2015 04:00,12.76,32945,553,36,24,827,3,1443,6.560.238.095
24/09/2015 05:00,15.25,34913,611,34,22,824,3,1494,6.560.238.095
24/09/2015 06:00,17.77,38893,721,30,18,864,5,1638,6.560.238.095
24/09/2015 07:00,19.93,42556,889,25,14,845,7,1780,6.560.238.095
24/09/2015 08:00,20.54,43807,1112,21,13,804,7,1957,6.560.238.095
24/09/2015 09:00,20.3,44484,1364,20,14,732,7,2137,6.560.238.095
24/09/2015 10:00,19.44,44068,1639,21,17,802,6,2485,6.560.238.095
24/09/2015 11:00,18.86,43556,1925,23,20,943,6,2917,6.560.238.095
24/09/2015 12:00,18.39,43128,2177,26,21,1054,7,3285,6.560.238.095
24/09/2015 13:00,18.02,42786,2377,27,21,1159,10,3594,6.560.238.095
24/09/2015 14:00,17.66,42514,2472,26,21,1195,11,3725,6.560.238.095
24/09/2015 15:00,17.61,41962,2489,27,19,1274,7,3816,6.560.238.095
24/09/2015 16:00,17.36,41713,2518,31,18,1322,8,3897,6.560.238.095
24/09/2015 17:00,17.62,41916,2433,36,15,1449,7,3940,6.560.238.095
24/09/2015 18:00,17.79,42222,2187,44,13,1607,3,3854,6.560.238.095
24/09/2015 19:00,18.32,42677,2005,49,12,1744,5,3815,6.560.238.095
24/09/2015 20:00,17.49,41988,1918,52,11,1860,4,3845,6.560.238.095
24/09/2015 21:00,16.64,40286,1894,52,12,1942,4,3904,6.560.238.095
24/09/2015 22:00,15.28,38059,1837,49,13,1950,1,3850,6.560.238.095
24/09/2015 23:00,12.7,35344,1736,38,7,1872,1,3654,6.560.238.095
25/09/2015 00:00,12.05,33141,1506,32,7,1829,1,3375,6.560.238.095
25/09/2015 01:00,11.64,32219,1413,26,7,1807,1,3254,6.560.238.095
25/09/2015 02:00,11.35,31863,1312,22,7,1744,1,3086,6.560.238.095
25/09/2015 03:00,11.32,31890,1263,19,6,1684,3,2975,6.560.238.095
25/09/2015 04:00,11.87,32568,1257,19,6,1722,3,3007,6.560.238.095
25/09/2015 05:00,13.6,34608,1290,20,6,1754,3,3073,6.560.238.095
25/09/2015 06:00,16.68,37878,1349,21,5,1808,3,3186,6.560.238.095
25/09/2015 07:00,17.77,41450,1367,21,4,1813,4,3209,6.560.238.095
25/09/2015 08:00,18.42,43463,1369,21,3,1936,4,3333,6.560.238.095
25/09/2015 09:00,18.33,43872,1429,22,3,2012,4,3470,6.560.238.095
25/09/2015 10:00,17.96,43333,1552,23,4,2125,3,3707,6.560.238.095
25/09/2015 11:00,17.78,43021,1643,23,7,2205,3,3881,6.560.238.095
25/09/2015 12:00,16.68,42416,1675,21,9,2258,4,3967,6.560.238.095
25/09/2015 13:00,16.12,41778,1713,19,13,2296,4,4045,6.560.238.095
25/09/2015 14:00,15.37,41228,1677,17,16,2296,2,4008,6.560.238.095
25/09/2015 15:00,14.68,40337,1607,16,18,2191,4,3836,6.560.238.095
25/09/2015 16:00,15.2,39754,1557,16,19,2063,4,3659,6.560.238.095
25/09/2015 17:00,15.67,39945,1430,18,20,1895,3,3366,6.560.238.095
25/09/2015 18:00,16.53,40314,1278,21,19,1853,1,3172,6.560.238.095
25/09/2015 19:00,17.38,40451,1187,26,16,1870,4,3103,6.560.238.095
25/09/2015 20:00,16.92,39429,1153,28,14,1850,4,3049,6.560.238.095
25/09/2015 21:00,16.06,37853,1154,27,15,1833,4,3033,6.560.238.095
25/09/2015 22:00,14.47,36292,1157,24,17,1794,2,2994,6.560.238.095
25/09/2015 23:00,12.31,34387,1140,13,24,1727,2,2906,6.560.238.095
26/09/2015 00:00,13.42,33650,812,13,24,1700,1,2550,6.560.238.095
26/09/2015 01:00,12.6,32596,821,12,24,1675,1,2533,6.560.238.095
26/09/2015 02:00,12.29,32136,804,11,25,1709,1,2550,6.560.238.095
26/09/2015 03:00,12.12,31999,806,10,25,1669,1,2511,6.560.238.095
26/09/2015 04:00,12.3,32154,832,9,25,1638,1,2505,6.560.238.095
26/09/2015 05:00,12.94,32781,826,9,23,1666,1,2525,6.560.238.095
26/09/2015 06:00,14.5,33083,779,11,19,1604,2,2415,6.560.238.095
26/09/2015 07:00,15.32,33980,732,13,14,1559,3,2321,6.560.238.095
26/09/2015 08:00,15.69,35752,748,17,13,1471,3,2252,6.560.238.095
26/09/2015 09:00,16.36,37154,802,24,17,1409,5,2257,6.560.238.095
26/09/2015 10:00,16.34,37833,859,32,25,1376,5,2297,6.560.238.095
26/09/2015 11:00,16.22,37853,934,36,32,1384,5,2391,6.560.238.095
26/09/2015 12:00,15.44,37741,1025,38,39,1475,5,2582,6.560.238.095
26/09/2015 13:00,14.95,37430,1104,36,49,1547,5,2741,6.560.238.095
26/09/2015 14:00,14.22,37152,1137,34,48,1627,5,2851,6.560.238.095
26/09/2015 15:00,13.48,37057,1157,33,45,1679,5,2919,6.560.238.095
26/09/2015 16:00,14.11,37424,1193,32,39,1717,4,2985,6.560.238.095
26/09/2015 17:00,15.23,38268,1173,31,36,1773,3,3016,6.560.238.095
26/09/2015 18:00,16,39043,1081,30,30,1820,0,2961,6.560.238.095
26/09/2015 19:00,16.43,39559,986,32,27,1891,0,2936,6.560.238.095
26/09/2015 20:00,16.12,38719,929,34,25,1957,2,2947,6.560.238.095
26/09/2015 21:00,15.54,37707,889,36,22,1954,2,2903,6.560.238.095
26/09/2015 22:00,14.77,36483,833,37,19,2013,1,2903,6.560.238.095
26/09/2015 23:00,13.49,35001,774,25,19,1846,1,2665,6.560.238.095
27/09/2015 00:00,14.01,33877,814,23,16,1837,1,2691,6.560.238.095
27/09/2015 01:00,12.71,33042,772,19,14,1841,1,2647,6.560.238.095
27/09/2015 02:00,12.25,32637,731,18,13,1928,2,2692,6.560.238.095
27/09/2015 03:00,12.2,32532,699,17,13,1955,2,2686,6.560.238.095
27/09/2015 04:00,12.34,32717,666,16,15,1990,2,2689,6.560.238.095
27/09/2015 05:00,12.83,33059,628,17,17,1993,2,2657,6.560.238.095
27/09/2015 06:00,13.43,33510,600,17,19,1956,5,2597,6.560.238.095
27/09/2015 07:00,14.18,34378,577,18,21,1931,5,2552,6.560.238.095
27/09/2015 08:00,14.43,35941,533,19,23,1844,6,2425,6.560.238.095
27/09/2015 09:00,15.63,37380,445,22,27,1774,7,2275,6.560.238.095
27/09/2015 10:00,16.1,38251,407,25,31,1745,7,2215,6.560.238.095
27/09/2015 11:00,16.04,38513,405,29,37,1726,8,2205,6.560.238.095
27/09/2015 12:00,15.72,38173,384,32,43,1772,10,2241,6.560.238.095
27/09/2015 13:00,15.14,37852,360,35,53,1755,13,2216,6.560.238.095
27/09/2015 14:00,14.34,37540,353,35,54,1744,17,2203,6.560.238.095
27/09/2015 15:00,14.48,37479,376,35,52,1705,17,2185,6.560.238.095
27/09/2015 16:00,15.08,37767,409,33,49,1703,16,2210,6.560.238.095
27/09/2015 17:00,15.62,38601,406,31,45,1724,14,2220,6.560.238.095
27/09/2015 18:00,16.38,39639,375,31,41,1743,11,2201,6.560.238.095
27/09/2015 19:00,16.9,40604,354,35,38,1748,9,2184,6.560.238.095
27/09/2015 20:00,16.74,40370,352,38,35,1753,11,2189,6.560.238.095
27/09/2015 21:00,16.29,39361,340,43,34,1697,11,2125,6.560.238.095
27/09/2015 22:00,15.32,37836,308,46,33,1634,2,2023,6.560.238.095
27/09/2015 23:00,14.37,35927,269,56,39,1657,7,2028,6.560.238.095
28/09/2015 00:00,13.59,34413,219,59,37,1582,7,1904,6.607.142.857
28/09/2015 01:00,12.58,33692,207,67,35,1454,9,1772,6.607.142.857
28/09/2015 02:00,12.44,33438,204,77,34,1363,10,1688,6.607.142.857
28/09/2015 03:00,13.08,33607,197,84,36,1288,9,1614,6.607.142.857
28/09/2015 04:00,14.36,34325,184,90,38,1231,9,1552,6.607.142.857
28/09/2015 05:00,16.05,36652,172,92,39,1162,11,1476,6.607.142.857
28/09/2015 06:00,17.87,40472,158,90,38,1124,11,1421,6.607.142.857
28/09/2015 07:00,20.25,44239,151,91,33,995,15,1285,6.607.142.857
28/09/2015 08:00,20.99,45658,138,91,31,765,18,1043,6.607.142.857
28/09/2015 09:00,20.97,45772,116,89,35,535,18,793,6.607.142.857
28/09/2015 10:00,20.35,45603,108,88,38,412,17,663,6.607.142.857
28/09/2015 11:00,20.01,45176,103,88,40,364,17,612,6.607.142.857
28/09/2015 12:00,19.41,44584,97,90,48,347,17,599,6.607.142.857
28/09/2015 13:00,18.94,44279,106,91,54,345,17,613,6.607.142.857
28/09/2015 14:00,18.04,43878,130,93,56,320,15,614,6.607.142.857
28/09/2015 15:00,18.62,43399,156,96,55,310,16,633,6.607.142.857
28/09/2015 16:00,18.36,43105,175,100,54,279,12,620,6.607.142.857
28/09/2015 17:00,19.56,43433,187,99,49,281,9,625,6.607.142.857
28/09/2015 18:00,20.25,43879,186,99,47,331,8,671,6.607.142.857
28/09/2015 19:00,21.53,44485,190,96,48,359,11,704,6.607.142.857
28/09/2015 20:00,19.13,43677,217,93,47,375,10,742,6.607.142.857
28/09/2015 21:00,17.58,42200,230,89,47,417,8,791,6.607.142.857
28/09/2015 22:00,16.3,40125,239,82,47,469,2,839,6.607.142.857
28/09/2015 23:00,15.08,37761,245,82,39,597,2,965,6.607.142.857
29/09/2015 00:00,14.57,35591,160,75,36,624,2,897,6.607.142.857
29/09/2015 01:00,14.22,34705,153,68,33,738,2,994,6.607.142.857
29/09/2015 02:00,14.03,34453,140,62,30,778,1,1011,6.607.142.857
29/09/2015 03:00,14.06,34537,124,58,26,854,1,1063,6.607.142.857
29/09/2015 04:00,14.37,35225,110,54,25,952,3,1144,6.607.142.857
29/09/2015 05:00,15.31,37327,99,49,22,1005,3,1178,6.607.142.857
29/09/2015 06:00,16.96,41270,88,41,21,1077,3,1230,6.607.142.857
29/09/2015 07:00,19.98,44752,81,30,18,997,5,1131,6.607.142.857
29/09/2015 08:00,20.68,46735,68,24,17,952,6,1067,6.607.142.857
29/09/2015 09:00,20.32,46421,53,20,17,973,7,1070,6.607.142.857
29/09/2015 10:00,19.53,45899,44,17,18,1028,7,1114,6.607.142.857
29/09/2015 11:00,18.9,45190,41,13,20,1064,6,1144,6.607.142.857
29/09/2015 12:00,17.77,44598,43,12,23,1150,6,1234,6.607.142.857
29/09/2015 13:00,16.97,44230,50,10,29,1225,6,1320,6.607.142.857
29/09/2015 14:00,16.19,43701,57,9,29,1393,4,1492,6.607.142.857
29/09/2015 15:00,16.17,43270,64,8,26,1513,4,1615,6.607.142.857
29/09/2015 16:00,15.93,43012,75,6,24,1668,3,1776,6.607.142.857
29/09/2015 17:00,16.38,43163,81,4,23,1871,2,1981,6.607.142.857
29/09/2015 18:00,17.07,43613,91,4,24,2032,0,2151,6.607.142.857
29/09/2015 19:00,18.19,44469,107,3,23,2242,3,2378,6.607.142.857
29/09/2015 20:00,16.26,43417,125,4,22,2374,3,2528,6.607.142.857
29/09/2015 21:00,14.99,41918,148,8,21,2403,3,2583,6.607.142.857
29/09/2015 22:00,14.02,39789,177,14,19,2406,0,2616,6.607.142.857
29/09/2015 23:00,12.99,37242,196,36,20,2599,1,2852,6.607.142.857
30/09/2015 00:00,11.5,34996,163,50,17,2548,1,2779,6.607.142.857
30/09/2015 01:00,10.76,34098,197,62,15,2513,1,2788,6.607.142.857
30/09/2015 02:00,10.57,33799,228,73,13,2418,1,2733,6.607.142.857
30/09/2015 03:00,10.69,33815,256,81,11,2264,3,2615,6.607.142.857
30/09/2015 04:00,12.13,34430,294,88,9,2103,4,2498,6.607.142.857
30/09/2015 05:00,13.36,36388,328,92,7,1996,4,2427,6.607.142.857
30/09/2015 06:00,15.33,40496,365,93,7,1889,4,2358,6.607.142.857
30/09/2015 07:00,17.07,43976,412,86,7,1723,5,2233,6.607.142.857
30/09/2015 08:00,18.17,44983,445,88,8,1670,7,2218,6.607.142.857
30/09/2015 09:00,18.87,44805,469,91,10,1566,10,2146,6.607.142.857
30/09/2015 10:00,18.18,44625,511,90,14,1495,14,2124,6.607.142.857
30/09/2015 11:00,16.96,44324,537,83,19,1452,16,2107,6.607.142.857
30/09/2015 12:00,16.86,43819,523,75,23,1512,18,2151,6.607.142.857
30/09/2015 13:00,16.68,43455,500,65,26,1461,18,2070,6.607.142.857
30/09/2015 14:00,15.96,43072,493,59,28,1454,16,2050,6.607.142.857
30/09/2015 15:00,16.19,42672,508,54,28,1459,15,2064,6.607.142.857
30/09/2015 16:00,16.15,42438,540,50,28,1484,11,2113,6.607.142.857
30/09/2015 17:00,16.55,42804,550,49,31,1615,7,2252,6.607.142.857
30/09/2015 18:00,16.82,43215,520,50,35,1766,5,2376,6.607.142.857
30/09/2015 19:00,17.27,43909,521,49,39,1838,7,2454,6.607.142.857
30/09/2015 20:00,16.09,42842,544,49,44,2001,6,2644,6.607.142.857
30/09/2015 21:00,14.98,41347,556,48,46,2093,4,2747,6.607.142.857
30/09/2015 22:00,14.09,39340,580,46,45,2033,0,2704,6.607.142.857
30/09/2015 23:00,12.49,36825,617,48,64,2156,1,2886,6.607.142.857
01/10/2015 00:00,11.96,34767,905,48,67,2286,1,3307,6.607.142.857
01/10/2015 01:00,10.9,33787,956,52,70,2416,1,3495,6.607.142.857
01/10/2015 02:00,9.95,33407,1023,59,74,2446,1,3603,6.607.142.857
01/10/2015 03:00,10.02,33461,1089,67,79,2513,2,3750,6.607.142.857
01/10/2015 04:00,10.87,34091,1148,76,83,2597,4,3908,6.607.142.857
01/10/2015 05:00,12.58,36045,1180,85,84,2608,4,3961,6.607.142.857
01/10/2015 06:00,14.19,40008,1171,97,84,2534,5,3891,6.607.142.857
01/10/2015 07:00,15.01,43477,1170,106,82,2546,8,3912,6.607.142.857
01/10/2015 08:00,15.69,44891,1206,114,84,2496,13,3913,6.607.142.857
01/10/2015 09:00,15.71,44692,1266,122,89,2407,20,3904,6.607.142.857
01/10/2015 10:00,15.46,44463,1354,125,98,2308,23,3908,6.607.142.857
01/10/2015 11:00,15.06,43947,1412,125,107,2282,29,3955,6.607.142.857
01/10/2015 12:00,14.99,43553,1436,122,119,2210,26,3913,6.607.142.857
01/10/2015 13:00,14.93,43229,1413,118,129,2188,24,3872,6.607.142.857
01/10/2015 14:00,14.65,42910,1404,115,127,2123,19,3788,6.607.142.857
01/10/2015 15:00,14.51,42166,1455,110,123,2115,17,3820,6.607.142.857
01/10/2015 16:00,14.19,41734,1515,109,117,2190,18,3949,6.607.142.857
01/10/2015 17:00,14.33,42023,1498,108,106,2363,17,4092,6.607.142.857
01/10/2015 18:00,14.69,42501,1472,104,98,2480,15,4169,6.607.142.857
01/10/2015 19:00,14.91,43145,1503,102,93,2652,16,4366,6.607.142.857
01/10/2015 20:00,14.14,41905,1514,100,93,2858,16,4581,6.607.142.857
01/10/2015 21:00,13.11,40475,1507,100,93,2993,15,4708,6.607.142.857
01/10/2015 22:00,12,38515,1483,97,92,3076,13,4761,6.607.142.857
01/10/2015 23:00,11.07,36176,1437,101,101,3252,7,4898,6.607.142.857
02/10/2015 00:00,8.92,34476,1345,105,107,3351,8,4916,6.607.142.857
02/10/2015 01:00,9.54,33604,1311,117,113,3443,9,4993,6.607.142.857
02/10/2015 02:00,8.49,33314,1310,130,118,3571,9,5138,6.607.142.857
02/10/2015 03:00,6.89,33396,1361,144,120,3683,12,5320,6.607.142.857
02/10/2015 04:00,7.94,34020,1435,151,120,3762,16,5484,6.607.142.857
02/10/2015 05:00,10.42,36042,1466,150,122,3837,16,5591,6.607.142.857
02/10/2015 06:00,12.99,39535,1463,151,124,3881,15,5634,6.607.142.857
02/10/2015 07:00,14.23,42677,1447,154,127,3902,18,5648,6.607.142.857
02/10/2015 08:00,14.97,43750,1435,158,132,3912,26,5663,6.607.142.857
02/10/2015 09:00,14.84,43824,1436,162,137,3884,29,5648,6.607.142.857
02/10/2015 10:00,14.45,43540,1434,167,142,3900,28,5671,6.607.142.857
02/10/2015 11:00,14.03,43267,1396,173,148,3921,28,5666,6.607.142.857
02/10/2015 12:00,13.49,42852,1368,180,154,3899,29,5630,6.607.142.857
02/10/2015 13:00,12.7,42239,1382,188,159,4018,31,5778,6.607.142.857
02/10/2015 14:00,12.04,41569,1401,193,159,4031,31,5815,6.607.142.857
02/10/2015 15:00,11.34,40890,1386,197,156,4080,32,5851,6.607.142.857
02/10/2015 16:00,11.06,40587,1319,200,152,4024,29,5724,6.607.142.857
02/10/2015 17:00,11.3,40890,1161,202,148,4076,24,5611,6.607.142.857
02/10/2015 18:00,12.22,41504,971,202,144,3939,19,5275,6.607.142.857
02/10/2015 19:00,13.13,42023,859,200,139,3853,23,5074,6.607.142.857
02/10/2015 20:00,12.37,40586,767,199,132,3619,21,4738,6.607.142.857
02/10/2015 21:00,12.28,39163,645,198,123,3376,22,4364,6.607.142.857
02/10/2015 22:00,11.54,37633,528,196,113,3037,19,3893,6.607.142.857
02/10/2015 23:00,10.85,35806,425,191,96,2547,17,3276,6.607.142.857
03/10/2015 00:00,11.05,34181,429,191,80,2266,14,2980,6.607.142.857
03/10/2015 01:00,11.01,33139,346,186,65,1894,11,2502,6.607.142.857
03/10/2015 02:00,11.03,32715,272,175,50,1775,9,2281,6.607.142.857
03/10/2015 03:00,11.1,32638,223,155,33,1650,4,2065,6.607.142.857
03/10/2015 04:00,11.17,32848,190,132,23,1419,2,1766,6.607.142.857
03/10/2015 05:00,11.52,33485,142,109,16,1218,1,1486,6.607.142.857
03/10/2015 06:00,11.79,34283,102,87,10,1044,2,1245,6.607.142.857
03/10/2015 07:00,12.29,35461,86,69,6,950,3,1114,6.607.142.857
03/10/2015 08:00,12.87,37552,69,55,4,819,3,950,6.607.142.857
03/10/2015 09:00,13.44,38948,67,45,3,683,3,801,6.607.142.857
03/10/2015 10:00,13.8,39534,78,36,3,569,3,689,6.607.142.857
03/10/2015 11:00,13.79,39425,93,30,3,523,3,652,6.607.142.857
03/10/2015 12:00,13.37,38980,104,24,3,488,3,622,6.607.142.857
03/10/2015 13:00,12.92,38479,124,20,4,476,3,627,6.607.142.857
03/10/2015 14:00,12.84,38046,132,17,4,486,3,642,6.607.142.857
03/10/2015 15:00,12.91,37917,127,13,4,540,3,687,6.607.142.857
03/10/2015 16:00,13.2,38394,120,10,4,601,3,738,6.607.142.857
03/10/2015 17:00,14.02,39358,113,9,6,752,3,883,6.607.142.857
03/10/2015 18:00,14.56,40249,112,9,9,910,1,1041,6.607.142.857
03/10/2015 19:00,14.75,40618,130,12,12,1079,1,1234,6.607.142.857
03/10/2015 20:00,14.06,39757,152,16,17,1210,2,1397,6.607.142.857
03/10/2015 21:00,13.66,38666,163,22,21,1332,0,1538,6.607.142.857
03/10/2015 22:00,12.56,37457,166,27,25,1462,0,1680,6.607.142.857
03/10/2015 23:00,11.45,35996,154,35,34,1401,1,1625,6.607.142.857
04/10/2015 00:00,12.75,34579,132,44,38,1283,2,1499,6.607.142.857
04/10/2015 01:00,12.49,33731,94,52,40,1281,2,1469,6.607.142.857
04/10/2015 02:00,12.39,33325,67,59,43,1220,2,1391,6.607.142.857
04/10/2015 03:00,12.35,33190,47,66,44,1164,2,1323,6.607.142.857
04/10/2015 04:00,12.41,33280,34,70,45,1203,1,1353,6.607.142.857
04/10/2015 05:00,12.6,33664,33,71,44,1258,2,1408,6.607.142.857
04/10/2015 06:00,12.72,34119,29,68,41,1322,1,1461,6.607.142.857
04/10/2015 07:00,12.73,34944,28,61,30,1304,3,1426,6.607.142.857
04/10/2015 08:00,13.2,36360,27,55,22,1231,3,1338,6.607.142.857
04/10/2015 09:00,13.54,37782,29,49,18,1164,3,1263,6.607.142.857
04/10/2015 10:00,14.13,38716,36,47,14,1092,3,1192,6.607.142.857
04/10/2015 11:00,14.19,38978,43,47,12,1153,3,1258,6.607.142.857
04/10/2015 12:00,13.91,38748,54,48,13,1296,3,1414,6.607.142.857
04/10/2015 13:00,13.53,38423,71,46,15,1390,3,1525,6.607.142.857
04/10/2015 14:00,13.29,38119,86,43,15,1387,3,1534,6.607.142.857
04/10/2015 15:00,13.35,38094,98,39,13,1281,3,1434,6.607.142.857
04/10/2015 16:00,13.5,38459,104,35,11,1256,2,1408,6.607.142.857
04/10/2015 17:00,14.21,39406,97,31,10,1241,2,1381,6.607.142.857
04/10/2015 18:00,15.44,40586,82,31,10,1191,0,1314,6.607.142.857
04/10/2015 19:00,16.14,41450,84,33,11,1167,0,1295,6.607.142.857
04/10/2015 20:00,15.48,40933,96,35,11,1148,2,1292,6.607.142.857
04/10/2015 21:00,15.01,39958,113,38,12,1148,0,1311,6.607.142.857
04/10/2015 22:00,14.32,38508,137,39,14,1105,0,1295,6.607.142.857
04/10/2015 23:00,13.03,36715,143,35,12,1060,1,1251,6.607.142.857
05/10/2015 00:00,13.21,35398,82,34,11,986,1,1114,6.523.511.905
05/10/2015 01:00,12.89,34747,91,31,10,901,1,1034,6.523.511.905
05/10/2015 02:00,12.72,34536,98,30,9,861,1,999,6.523.511.905
05/10/2015 03:00,12.83,34796,99,29,9,801,1,939,6.523.511.905
05/10/2015 04:00,13.22,35518,108,31,8,808,2,957,6.523.511.905
05/10/2015 05:00,14.21,37749,112,32,7,819,2,972,6.523.511.905
05/10/2015 06:00,16.37,41461,109,33,6,863,2,1013,6.523.511.905
05/10/2015 07:00,19.75,45249,110,32,6,818,4,970,6.523.511.905
05/10/2015 08:00,21.99,46627,122,31,6,696,6,861,6.523.511.905
05/10/2015 09:00,20.26,47706,162,31,6,582,7,788,6.523.511.905
05/10/2015 10:00,20.18,47187,204,31,8,512,7,762,6.523.511.905
05/10/2015 11:00,18.8,46288,233,34,10,459,8,744,6.523.511.905
05/10/2015 12:00,17.71,45650,263,36,14,498,10,821,6.523.511.905
05/10/2015 13:00,17.01,45349,307,39,18,499,12,875,6.523.511.905
05/10/2015 14:00,16.85,44918,357,41,22,562,10,992,6.523.511.905
05/10/2015 15:00,16.67,44426,417,46,25,645,9,1142,6.523.511.905
05/10/2015 16:00,16.25,44215,475,52,29,753,7,1316,6.523.511.905
05/10/2015 17:00,16.61,44568,540,61,35,931,4,1571,6.523.511.905
05/10/2015 18:00,16.86,45231,670,71,42,1138,3,1924,6.523.511.905
05/10/2015 19:00,17.01,45834,914,73,49,1324,6,2366,6.523.511.905
05/10/2015 20:00,15.98,44850,1179,72,53,1476,6,2786,6.523.511.905
05/10/2015 21:00,15,43357,1386,66,58,1557,5,3072,6.523.511.905
05/10/2015 22:00,13.67,41257,1589,59,61,1640,3,3352,6.523.511.905
05/10/2015 23:00,12.16,38909,1763,73,67,1696,6,3605,6.523.511.905
06/10/2015 00:00,12.32,36727,1933,70,67,1712,6,3788,6.523.511.905
06/10/2015 01:00,11.5,35885,2080,69,67,1790,5,4011,6.523.511.905
06/10/2015 02:00,11.18,35575,2222,68,71,1799,4,4164,6.523.511.905
06/10/2015 03:00,11.17,35679,2358,67,76,1841,5,4347,6.523.511.905
06/10/2015 04:00,11.68,36365,2500,66,80,1894,7,4547,6.523.511.905
06/10/2015 05:00,12.79,38449,2671,65,82,1948,7,4773,6.523.511.905
06/10/2015 06:00,13.76,42219,2859,60,83,1994,7,5003,6.523.511.905
06/10/2015 07:00,16.29,45837,3052,49,82,2001,9,5193,6.523.511.905
06/10/2015 08:00,16.72,48361,3268,42,77,2070,11,5468,6.523.511.905
06/10/2015 09:00,16.41,48113,3506,37,74,2113,16,5746,6.523.511.905
06/10/2015 10:00,15.95,47709,3707,35,74,2198,20,6034,6.523.511.905
06/10/2015 11:00,15.12,47131,3830,35,77,2363,17,6322,6.523.511.905
06/10/2015 12:00,14.87,46645,3888,36,82,2448,17,6471,6.523.511.905
06/10/2015 13:00,14.58,46251,3917,38,86,2517,17,6575,6.523.511.905
06/10/2015 14:00,14.27,45934,3929,40,91,2510,15,6585,6.523.511.905
06/10/2015 15:00,14.16,45610,3938,44,94,2545,17,6638,6.523.511.905
06/10/2015 16:00,14.02,45563,3944,50,95,2576,13,6678,6.523.511.905
06/10/2015 17:00,14.45,45956,3980,55,99,2670,10,6814,6.523.511.905
06/10/2015 18:00,14.93,46604,4036,58,105,2786,7,6992,6.523.511.905
06/10/2015 19:00,15.3,46972,4081,56,113,2884,10,7144,6.523.511.905
06/10/2015 20:00,14.15,45894,4102,50,115,2943,10,7220,6.523.511.905
06/10/2015 21:00,13.56,44349,4091,44,117,2937,9,7198,6.523.511.905
06/10/2015 22:00,12.79,42285,4067,38,118,2927,7,7157,6.523.511.905
06/10/2015 23:00,10.16,39787,4031,43,103,2992,6,7175,6.523.511.905
07/10/2015 00:00,11.33,37716,3962,36,94,2947,5,7044,6.523.511.905
07/10/2015 01:00,11.28,36856,3905,27,88,3017,4,7041,6.523.511.905
07/10/2015 02:00,11.55,36600,3869,21,84,2992,4,6970,6.523.511.905
07/10/2015 03:00,11.78,36671,3864,17,83,2989,4,6957,6.523.511.905
07/10/2015 04:00,12.3,37302,3868,15,82,3007,5,6977,6.523.511.905
07/10/2015 05:00,13.58,39347,3879,14,82,3023,9,7007,6.523.511.905
07/10/2015 06:00,15.45,43258,3888,13,80,3006,6,6993,6.523.511.905
07/10/2015 07:00,17.3,46850,3888,11,76,2931,7,6913,6.523.511.905
07/10/2015 08:00,17.76,48124,3884,10,67,2990,7,6958,6.523.511.905
07/10/2015 09:00,17.66,48639,3873,9,61,2833,11,6787,6.523.511.905
07/10/2015 10:00,17.43,48299,3851,10,57,2833,7,6758,6.523.511.905
07/10/2015 11:00,17.1,47696,3806,11,57,2794,7,6675,6.523.511.905
07/10/2015 12:00,17.17,47208,3743,13,58,2773,7,6594,6.523.511.905
07/10/2015 13:00,17.09,46860,3679,14,59,2768,6,6526,6.523.511.905
07/10/2015 14:00,16.94,46586,3625,15,59,2795,5,6499,6.523.511.905
07/10/2015 15:00,16.66,46272,3583,16,56,2678,6,6339,6.523.511.905
07/10/2015 16:00,16.55,46169,3537,19,54,2600,7,6217,6.523.511.905
07/10/2015 17:00,17.32,46660,3476,24,55,2591,10,6156,6.523.511.905
07/10/2015 18:00,18.03,47282,3400,29,59,2567,8,6063,6.523.511.905
07/10/2015 19:00,18.37,47479,3323,28,63,2600,6,6020,6.523.511.905
07/10/2015 20:00,17.02,46330,3261,25,64,2614,5,5969,6.523.511.905
07/10/2015 21:00,15.94,44676,3196,23,64,2567,5,5855,6.523.511.905
07/10/2015 22:00,14.93,42648,3114,18,63,2514,2,5711,6.523.511.905
07/10/2015 23:00,14.07,40181,2999,21,53,2439,1,5513,6.523.511.905
08/10/2015 00:00,15.26,38524,2842,17,50,2303,1,5213,6.523.511.905
08/10/2015 01:00,15.13,37608,2713,13,49,2235,1,5011,6.523.511.905
08/10/2015 02:00,15.28,37262,2626,10,48,2215,1,4900,6.523.511.905
08/10/2015 03:00,15.53,37361,2560,8,42,2113,1,4724,6.523.511.905
08/10/2015 04:00,15.94,37996,2477,7,33,2099,2,4618,6.523.511.905
08/10/2015 05:00,17.55,40015,2377,7,30,2048,2,4464,6.523.511.905
08/10/2015 06:00,19.74,43922,2266,8,29,1977,2,4282,6.523.511.905
08/10/2015 07:00,21.69,47504,2146,9,26,1951,7,4139,6.523.511.905
08/10/2015 08:00,22.25,48736,2047,9,23,1894,3,3976,6.523.511.905
08/10/2015 09:00,21.99,48626,1982,10,22,1820,3,3837,6.523.511.905
08/10/2015 10:00,22.02,48525,1943,11,23,1790,7,3774,6.523.511.905
08/10/2015 11:00,21.86,48198,1902,12,26,1787,6,3733,6.523.511.905
08/10/2015 12:00,21.48,47810,1864,13,28,1721,6,3632,6.523.511.905
08/10/2015 13:00,21.72,47488,1823,14,25,1685,6,3553,6.523.511.905
08/10/2015 14:00,21.7,47211,1782,16,23,1606,4,3431,6.523.511.905
08/10/2015 15:00,21.36,46653,1738,20,22,1517,5,3302,6.523.511.905
08/10/2015 16:00,21.09,46429,1683,26,22,1463,6,3200,6.523.511.905
08/10/2015 17:00,21.64,46846,1638,35,24,1431,6,3134,6.523.511.905
08/10/2015 18:00,22.43,47499,1609,44,28,1417,4,3102,6.523.511.905
08/10/2015 19:00,22.58,47673,1574,46,29,1371,7,3027,6.523.511.905
08/10/2015 20:00,20.96,46424,1533,42,28,1368,3,2974,6.523.511.905
08/10/2015 21:00,19.39,44863,1488,36,26,1338,3,2891,6.523.511.905
08/10/2015 22:00,18.02,42858,1445,33,23,1264,3,2768,6.523.511.905
08/10/2015 23:00,17.12,40600,1407,27,38,1187,2,2661,6.523.511.905
09/10/2015 00:00,18.93,38963,1123,29,35,1123,1,2311,6.523.511.905
09/10/2015 01:00,18.69,38025,1041,32,31,1076,1,2181,6.523.511.905
09/10/2015 02:00,18.71,37707,999,35,29,1055,1,2119,6.523.511.905
09/10/2015 03:00,18.63,37657,987,39,27,1035,2,2090,6.523.511.905
09/10/2015 04:00,19.01,38225,987,43,24,989,2,2045,6.523.511.905
09/10/2015 05:00,20.23,40297,996,47,20,984,3,2050,6.523.511.905
09/10/2015 06:00,21.66,43914,1005,49,15,995,4,2068,6.523.511.905
09/10/2015 07:00,24.69,47299,1021,48,11,980,5,2065,6.523.511.905
09/10/2015 08:00,25.5,49652,1037,44,6,953,5,2045,6.523.511.905
09/10/2015 09:00,25.41,49227,1046,43,4,868,5,1966,6.523.511.905
09/10/2015 10:00,24.64,48680,1057,42,4,854,5,1962,6.523.511.905
09/10/2015 11:00,23.72,47996,1066,42,5,842,4,1959,6.523.511.905
09/10/2015 12:00,23.15,47608,1063,43,6,818,4,1934,6.523.511.905
09/10/2015 13:00,22.86,47072,1053,41,9,732,4,1839,6.523.511.905
09/10/2015 14:00,22.38,46468,1017,40,12,663,2,1734,6.523.511.905
09/10/2015 15:00,21.81,45871,955,39,13,617,4,1628,6.523.511.905
09/10/2015 16:00,21.8,45701,898,42,12,581,4,1537,6.523.511.905
09/10/2015 17:00,22.68,46171,874,46,12,623,3,1558,6.523.511.905
09/10/2015 18:00,23.57,46883,879,47,13,699,2,1640,6.523.511.905
09/10/2015 19:00,22.85,46809,916,46,15,755,4,1736,6.523.511.905
09/10/2015 20:00,21.59,45334,956,40,16,755,4,1771,6.523.511.905
09/10/2015 21:00,20.9,43791,975,34,18,781,4,1812,6.523.511.905
09/10/2015 22:00,20.16,42173,992,26,19,731,2,1770,6.523.511.905
09/10/2015 23:00,19.21,40277,976,27,13,724,2,1742,6.523.511.905
10/10/2015 00:00,19.84,38220,802,28,14,668,1,1513,6.523.511.905
10/10/2015 01:00,19.8,37177,723,34,14,608,1,1380,6.523.511.905
10/10/2015 02:00,19.65,36673,664,41,12,579,1,1297,6.523.511.905
10/10/2015 03:00,19.7,36531,610,48,10,560,1,1229,6.523.511.905
10/10/2015 04:00,19.73,36679,563,54,9,527,1,1154,6.523.511.905
10/10/2015 05:00,19.9,37309,533,56,7,486,0,1082,6.523.511.905
10/10/2015 06:00,20,38203,533,57,6,462,2,1060,6.523.511.905
10/10/2015 07:00,20.51,39465,573,56,5,409,2,1045,6.523.511.905
10/10/2015 08:00,21.03,41388,611,54,5,347,2,1019,6.523.511.905
10/10/2015 09:00,21.44,42724,651,53,5,285,2,996,6.523.511.905
10/10/2015 10:00,21.57,43247,738,52,4,244,3,1041,6.523.511.905
10/10/2015 11:00,21.43,43093,779,51,4,205,3,1042,6.523.511.905
10/10/2015 12:00,21.31,42543,761,49,4,192,3,1009,6.523.511.905
10/10/2015 13:00,21.15,41981,740,49,5,184,4,982,6.523.511.905
10/10/2015 14:00,21.03,41671,730,47,5,172,4,958,6.523.511.905
10/10/2015 15:00,21.01,41678,755,47,6,181,4,993,6.523.511.905
10/10/2015 16:00,21.16,42206,804,49,6,193,4,1056,6.523.511.905
10/10/2015 17:00,21.69,43288,828,50,6,248,3,1135,6.523.511.905
10/10/2015 18:00,22.11,44346,840,50,7,279,2,1178,6.523.511.905
10/10/2015 19:00,21.96,44312,889,46,7,344,2,1288,6.523.511.905
10/10/2015 20:00,21.45,43095,943,38,7,366,3,1357,6.523.511.905
10/10/2015 21:00,20.99,41808,983,31,6,400,3,1423,6.523.511.905
10/10/2015 22:00,20.61,40552,1025,23,6,393,2,1449,6.523.511.905
10/10/2015 23:00,19.91,38996,1021,14,10,350,2,1397,6.523.511.905
11/10/2015 00:00,19.71,37570,989,13,10,359,1,1372,6.523.511.905
11/10/2015 01:00,18.94,36647,930,13,11,376,1,1331,6.523.511.905
11/10/2015 02:00,19.03,36046,871,14,12,396,1,1294,6.523.511.905
11/10/2015 03:00,19.21,35947,809,15,14,438,1,1277,6.523.511.905
11/10/2015 04:00,19.45,36020,761,15,17,493,1,1287,6.523.511.905
11/10/2015 05:00,19.01,36358,708,15,19,536,1,1279,6.523.511.905
11/10/2015 06:00,19.03,36906,674,14,18,566,3,1275,6.523.511.905
11/10/2015 07:00,19.52,37826,661,12,13,568,3,1257,6.523.511.905
11/10/2015 08:00,20.36,39043,681,10,10,508,3,1212,6.523.511.905
11/10/2015 09:00,20.76,40529,718,8,9,487,3,1225,6.523.511.905
11/10/2015 10:00,20.38,41414,750,7,9,480,3,1249,6.523.511.905
11/10/2015 11:00,20.15,41623,792,6,11,432,3,1244,6.523.511.905
11/10/2015 12:00,19.97,41371,815,6,13,387,3,1224,6.523.511.905
11/10/2015 13:00,19.89,41050,806,7,14,350,3,1180,6.523.511.905
11/10/2015 14:00,19.74,40798,782,7,15,340,3,1147,6.523.511.905
11/10/2015 15:00,19.8,40810,753,8,16,349,2,1128,6.523.511.905
11/10/2015 16:00,19.96,41314,749,10,17,388,2,1166,6.523.511.905
11/10/2015 17:00,21.3,42447,757,11,19,457,2,1246,6.523.511.905
11/10/2015 18:00,22.12,43783,766,12,21,515,1,1315,6.523.511.905
11/10/2015 19:00,22.6,44347,830,12,23,534,1,1400,6.523.511.905
11/10/2015 20:00,21.86,43626,958,10,24,568,3,1563,6.523.511.905
11/10/2015 21:00,21.43,42596,1051,10,24,605,3,1693,6.523.511.905
11/10/2015 22:00,20.87,41043,1090,9,23,584,0,1706,6.523.511.905
11/10/2015 23:00,20.03,39110,1044,18,28,571,1,1662,6.523.511.905
12/10/2015 00:00,20.21,37338,1010,16,24,564,1,1615,6.407.440.476
12/10/2015 01:00,19.6,36507,933,13,22,550,1,1519,6.407.440.476
12/10/2015 02:00,19.78,36168,877,11,21,576,1,1486,6.407.440.476
12/10/2015 03:00,19.47,36284,856,10,21,596,2,1485,6.407.440.476
12/10/2015 04:00,19.69,36943,818,10,21,610,2,1461,6.407.440.476
12/10/2015 05:00,21.09,39040,772,9,21,604,2,1408,6.407.440.476
12/10/2015 06:00,22.5,42759,801,9,21,610,2,1443,6.407.440.476
12/10/2015 07:00,24.74,46597,843,7,20,610,3,1483,6.407.440.476
12/10/2015 08:00,27.78,48105,869,6,22,583,3,1483,6.407.440.476
12/10/2015 09:00,27.19,49746,906,5,26,570,3,1510,6.407.440.476
12/10/2015 10:00,25.27,49190,951,5,28,494,3,1481,6.407.440.476
12/10/2015 11:00,24.84,48337,971,5,29,468,2,1475,6.407.440.476
12/10/2015 12:00,24.17,47296,973,5,32,467,2,1479,6.407.440.476
12/10/2015 13:00,24,47079,1024,4,34,469,2,1533,6.407.440.476
12/10/2015 14:00,23.82,46708,1047,4,35,487,1,1574,6.407.440.476
12/10/2015 15:00,23.8,46298,1028,3,34,497,3,1565,6.407.440.476
12/10/2015 16:00,23.72,46178,1048,4,34,533,3,1622,6.407.440.476
12/10/2015 17:00,24.23,46725,1027,4,36,564,3,1634,6.407.440.476
12/10/2015 18:00,25.52,47481,1042,4,37,605,2,1690,6.407.440.476
12/10/2015 19:00,24.92,47588,1130,5,38,654,5,1832,6.407.440.476
12/10/2015 20:00,23.24,46335,1153,5,39,700,5,1902,6.407.440.476
12/10/2015 21:00,21.94,44668,1104,5,67,670,5,1851,6.407.440.476
12/10/2015 22:00,21.52,42523,1081,6,71,669,1,1828,6.407.440.476
12/10/2015 23:00,20.83,40025,1016,5,76,717,1,1815,6.407.440.476
13/10/2015 00:00,20.7,38104,1030,4,73,680,2,1789,6.407.440.476
13/10/2015 01:00,20.37,37197,942,4,70,677,1,1694,6.407.440.476
13/10/2015 02:00,20.31,37187,922,5,69,675,1,1672,6.407.440.476
13/10/2015 03:00,20.36,37273,961,6,69,696,1,1733,6.407.440.476
13/10/2015 04:00,20.72,37927,994,6,68,734,2,1804,6.407.440.476
13/10/2015 05:00,21.34,40180,1013,6,69,790,2,1880,6.407.440.476
13/10/2015 06:00,22.78,44493,1019,5,68,860,2,1954,6.407.440.476
13/10/2015 07:00,25.07,48087,1045,4,66,927,4,2046,6.407.440.476
13/10/2015 08:00,27.38,49590,1065,4,61,965,4,2099,6.407.440.476
13/10/2015 09:00,25.9,48880,1072,4,58,948,5,2087,6.407.440.476
13/10/2015 10:00,25.28,48417,1094,3,57,960,5,2119,6.407.440.476
13/10/2015 11:00,24.69,48164,1119,3,62,982,4,2170,6.407.440.476
13/10/2015 12:00,23.87,47677,1140,3,67,1030,5,2245,6.407.440.476
13/10/2015 13:00,23.69,47333,1180,3,73,1102,5,2363,6.407.440.476
13/10/2015 14:00,23.24,46932,1249,3,74,1155,3,2484,6.407.440.476
13/10/2015 15:00,22.98,46664,1280,4,73,1266,4,2627,6.407.440.476
13/10/2015 16:00,22.94,46577,1325,4,70,1349,3,2751,6.407.440.476
13/10/2015 17:00,23.42,47112,1425,6,68,1433,3,2935,6.407.440.476
13/10/2015 18:00,23.89,47867,1517,8,68,1510,1,3104,6.407.440.476
13/10/2015 19:00,23.78,47895,1590,11,71,1652,4,3328,6.407.440.476
13/10/2015 20:00,22.58,46639,1609,14,68,1640,4,3335,6.407.440.476
13/10/2015 21:00,21.99,45008,1573,16,66,1584,3,3242,6.407.440.476
13/10/2015 22:00,21.41,42896,1527,18,62,1537,1,3145,6.407.440.476
13/10/2015 23:00,20.6,40353,1483,14,65,1494,2,3058,6.407.440.476
14/10/2015 00:00,20.69,38318,1483,16,61,1398,2,2960,6.407.440.476
14/10/2015 01:00,20.45,37359,1471,16,57,1309,1,2854,6.407.440.476
14/10/2015 02:00,20.42,37051,1451,17,57,1248,1,2774,6.407.440.476
14/10/2015 03:00,20.47,37131,1433,18,59,1163,1,2674,6.407.440.476
14/10/2015 04:00,20.81,37757,1437,19,60,1162,3,2681,6.407.440.476
14/10/2015 05:00,21.58,39787,1468,19,59,1134,3,2683,6.407.440.476
14/10/2015 06:00,23.03,44127,1508,18,57,1125,12,2720,6.407.440.476
14/10/2015 07:00,26.11,47840,1549,16,54,1082,13,2714,6.407.440.476
14/10/2015 08:00,29.52,48800,1570,13,34,1010,13,2640,6.407.440.476
14/10/2015 09:00,27.75,48422,1602,11,25,937,10,2585,6.407.440.476
14/10/2015 10:00,25.94,48406,1709,10,24,898,13,2654,6.407.440.476
14/10/2015 11:00,24.97,48387,1848,11,27,844,12,2742,6.407.440.476
14/10/2015 12:00,24.1,47705,1986,13,33,838,12,2882,6.407.440.476
14/10/2015 13:00,23.91,47143,2187,14,35,841,3,3080,6.407.440.476
14/10/2015 14:00,23.3,46616,2291,13,40,858,2,3204,6.407.440.476
14/10/2015 15:00,22.77,46296,2247,11,43,898,11,3210,6.407.440.476
14/10/2015 16:00,22.92,46500,2172,10,47,997,10,3236,6.407.440.476
14/10/2015 17:00,23.57,47256,2073,10,53,1091,12,3239,6.407.440.476
14/10/2015 18:00,24.52,47963,2025,10,61,1194,9,3299,6.407.440.476
14/10/2015 19:00,24.37,47622,2028,9,71,1250,5,3363,6.407.440.476
14/10/2015 20:00,22.88,46432,2042,7,74,1273,5,3401,6.407.440.476
14/10/2015 21:00,22.16,44870,2041,6,77,1371,5,3500,6.407.440.476
14/10/2015 22:00,21.57,42924,2004,6,78,1467,2,3557,6.407.440.476
14/10/2015 23:00,20.78,40559,1946,14,81,1625,3,3669,6.407.440.476
15/10/2015 00:00,21.29,38621,1716,15,79,1660,3,3473,6.407.440.476
15/10/2015 01:00,21.09,37687,1663,16,77,1735,3,3494,6.407.440.476
15/10/2015 02:00,20.95,37362,1657,17,77,1750,3,3504,6.407.440.476
15/10/2015 03:00,20.94,37513,1658,17,78,1886,3,3642,6.407.440.476
15/10/2015 04:00,21.23,38255,1664,18,79,2029,4,3794,6.407.440.476
15/10/2015 05:00,22.01,40440,1676,17,82,2038,11,3824,6.407.440.476
15/10/2015 06:00,24.14,44712,1703,16,82,2063,5,3869,6.407.440.476
15/10/2015 07:00,25.54,48568,1727,14,82,2014,6,3843,6.407.440.476
15/10/2015 08:00,25.97,49673,1778,13,76,1927,8,3802,6.407.440.476
15/10/2015 09:00,25.95,50131,1836,12,71,1914,7,3840,6.407.440.476
15/10/2015 10:00,25.57,49473,1880,12,71,1819,7,3789,6.407.440.476
15/10/2015 11:00,25.09,48645,1947,12,77,1656,7,3699,6.407.440.476
15/10/2015 12:00,24.73,47975,2041,11,86,1676,9,3823,6.407.440.476
15/10/2015 13:00,24.51,47467,2131,10,95,1706,9,3951,6.407.440.476
15/10/2015 14:00,24.26,46986,2172,10,99,1786,8,4075,6.407.440.476
15/10/2015 15:00,24.05,46365,2165,10,101,1933,9,4218,6.407.440.476
15/10/2015 16:00,24.17,46139,2176,13,102,2067,8,4366,6.407.440.476
15/10/2015 17:00,24.56,46833,2197,16,105,2181,9,4508,6.407.440.476
15/10/2015 18:00,24.95,47685,2220,23,110,2342,9,4704,6.407.440.476
15/10/2015 19:00,24.85,47691,2238,30,118,2440,13,4839,6.407.440.476
15/10/2015 20:00,23.91,46355,2231,36,119,2450,14,4850,6.407.440.476
15/10/2015 21:00,23.03,44854,2177,43,121,2455,12,4808,6.407.440.476
15/10/2015 22:00,22.11,42980,2077,47,120,2395,13,4652,6.407.440.476
15/10/2015 23:00,21.24,40733,1944,44,116,2389,12,4505,6.407.440.476
16/10/2015 00:00,21.7,39350,1732,50,113,2278,11,4184,6.407.440.476
16/10/2015 01:00,21.64,38507,1644,52,111,2188,9,4004,6.407.440.476
16/10/2015 02:00,21.58,38207,1626,50,112,2154,10,3952,6.407.440.476
16/10/2015 03:00,21.66,38323,1654,46,113,2093,10,3916,6.407.440.476
16/10/2015 04:00,22.16,39042,1705,43,115,2023,11,3897,6.407.440.476
16/10/2015 05:00,23.3,41309,1755,42,116,2020,12,3945,6.407.440.476
16/10/2015 06:00,24.33,45088,1785,40,116,2076,13,4030,6.407.440.476
16/10/2015 07:00,25.99,48641,1829,35,115,2032,13,4024,6.407.440.476
16/10/2015 08:00,26.01,50104,1910,28,112,2016,14,4080,6.407.440.476
16/10/2015 09:00,25.85,51141,2029,24,110,1919,12,4094,6.407.440.476
16/10/2015 10:00,24.91,50521,2159,22,108,1822,13,4124,6.407.440.476
16/10/2015 11:00,24.71,49339,2188,21,105,1705,12,4031,6.407.440.476
16/10/2015 12:00,24.63,48167,2107,20,103,1573,15,3818,6.407.440.476
16/10/2015 13:00,24.34,47219,2014,18,101,1581,16,3730,6.407.440.476
16/10/2015 14:00,24.24,46389,1904,17,99,1618,15,3653,6.407.440.476
16/10/2015 15:00,23.96,45791,1775,17,96,1638,14,3540,6.407.440.476
16/10/2015 16:00,23.93,45563,1653,20,92,1613,12,3390,6.407.440.476
16/10/2015 17:00,24.59,46330,1529,26,88,1677,18,3338,6.407.440.476
16/10/2015 18:00,25.47,47396,1413,36,85,1694,13,3241,6.407.440.476
16/10/2015 19:00,25.28,47111,1311,40,80,1687,10,3128,6.407.440.476
16/10/2015 20:00,24.04,45452,1226,40,74,1611,10,2961,6.407.440.476
16/10/2015 21:00,23.71,44005,1157,38,68,1711,9,2983,6.407.440.476
16/10/2015 22:00,23.29,42494,1096,34,62,1689,8,2889,6.407.440.476
16/10/2015 23:00,22.79,40664,1015,25,32,1719,5,2796,6.407.440.476
17/10/2015 00:00,22.77,38897,1031,20,30,1674,3,2758,6.407.440.476
17/10/2015 01:00,22.47,37999,1006,16,28,1686,2,2738,6.407.440.476
17/10/2015 02:00,22.38,37537,1000,13,28,1630,2,2673,6.407.440.476
17/10/2015 03:00,22.37,37476,978,10,29,1627,2,2646,6.407.440.476
17/10/2015 04:00,22.47,37727,930,8,30,1631,2,2601,6.407.440.476
17/10/2015 05:00,22.81,38415,874,7,31,1593,2,2507,6.407.440.476
17/10/2015 06:00,23.04,39826,830,7,30,1621,4,2492,6.407.440.476
17/10/2015 07:00,23.37,41369,795,6,27,1570,3,2401,6.407.440.476
17/10/2015 08:00,23.57,43326,763,5,23,1566,4,2361,6.407.440.476
17/10/2015 09:00,23.84,44537,750,5,19,1498,4,2276,6.407.440.476
17/10/2015 10:00,23.8,44486,741,5,17,1439,4,2206,6.407.440.476
17/10/2015 11:00,23.73,44166,718,4,16,1320,4,2062,6.407.440.476
17/10/2015 12:00,23.51,43515,693,3,17,1287,4,2004,6.407.440.476
17/10/2015 13:00,23.29,42803,680,3,17,1310,5,2015,6.407.440.476
17/10/2015 14:00,23.18,42383,687,4,16,1378,5,2090,6.407.440.476
17/10/2015 15:00,23.14,42264,715,5,16,1433,5,2174,6.407.440.476
17/10/2015 16:00,23.32,42773,756,8,19,1419,5,2207,6.407.440.476
17/10/2015 17:00,23.83,44097,791,11,23,1427,5,2257,6.407.440.476
17/10/2015 18:00,24.67,45298,795,15,25,1405,3,2243,6.407.440.476
17/10/2015 19:00,24.48,44983,790,17,24,1512,2,2345,6.407.440.476
17/10/2015 20:00,23.82,43561,756,19,21,1551,5,2352,6.407.440.476
17/10/2015 21:00,23.69,42397,705,21,18,1533,5,2282,6.407.440.476
17/10/2015 22:00,23.46,41298,657,22,17,1527,4,2227,6.407.440.476
17/10/2015 23:00,23.09,39925,615,24,18,1413,4,2074,6.407.440.476
18/10/2015 00:00,23.12,38136,449,22,18,1340,4,1833,6.407.440.476
18/10/2015 01:00,22.87,37252,489,20,20,1353,4,1886,6.407.440.476
18/10/2015 02:00,22.74,36484,533,19,22,1341,4,1919,6.407.440.476
18/10/2015 03:00,22.73,36703,559,19,24,1267,4,1873,6.407.440.476
18/10/2015 04:00,22.85,36868,571,18,25,1254,4,1872,6.407.440.476
18/10/2015 05:00,23.06,37342,580,17,25,1266,4,1892,6.407.440.476
18/10/2015 06:00,23.23,38023,582,15,24,1278,6,1905,6.407.440.476
18/10/2015 07:00,23.48,39047,608,12,21,1190,4,1835,6.407.440.476
18/10/2015 08:00,23.63,40067,629,10,20,1106,4,1769,6.407.440.476
18/10/2015 09:00,23.91,41644,657,8,19,992,3,1679,6.407.440.476
18/10/2015 10:00,24.09,42543,692,7,18,837,3,1557,6.407.440.476
18/10/2015 11:00,24.08,42758,686,7,15,651,4,1363,6.407.440.476
18/10/2015 12:00,23.95,42360,652,8,14,553,5,1232,6.407.440.476
18/10/2015 13:00,23.89,41926,610,9,14,466,7,1106,6.407.440.476
18/10/2015 14:00,23.76,41626,576,11,14,461,6,1068,6.407.440.476
18/10/2015 15:00,23.68,41563,563,13,13,403,6,998,6.407.440.476
18/10/2015 16:00,23.8,42181,545,16,13,444,4,1022,6.407.440.476
18/10/2015 17:00,24.35,43414,525,20,13,494,10,1062,6.407.440.476
18/10/2015 18:00,25.52,44667,529,26,15,559,2,1131,6.407.440.476
18/10/2015 19:00,25.49,44888,560,29,16,602,1,1208,6.407.440.476
18/10/2015 20:00,24.72,43940,574,31,16,589,3,1213,6.407.440.476
18/10/2015 21:00,24.16,42915,556,31,16,589,2,1194,6.407.440.476
18/10/2015 22:00,23.91,41362,530,27,16,537,0,1110,6.407.440.476
18/10/2015 23:00,23.46,39338,483,29,16,620,1,1149,6.407.440.476
19/10/2015 00:00,23.13,37794,307,27,14,578,1,927,6.355.952.381
19/10/2015 01:00,23.11,37008,278,26,14,509,1,828,6.355.952.381
19/10/2015 02:00,23.12,36796,251,25,15,467,1,759,6.355.952.381
19/10/2015 03:00,23.22,36992,226,25,15,423,2,691,6.355.952.381
19/10/2015 04:00,23.48,37698,202,25,15,381,3,626,6.355.952.381
19/10/2015 05:00,24.16,39836,193,26,14,358,3,594,6.355.952.381
19/10/2015 06:00,25.88,43871,195,26,13,335,3,572,6.355.952.381
19/10/2015 07:00,34.92,47790,199,23,12,304,7,545,6.355.952.381
19/10/2015 08:00,44.78,50401,189,19,10,253,7,478,6.355.952.381
19/10/2015 09:00,39.07,50083,170,14,9,203,7,403,6.355.952.381
19/10/2015 10:00,44.87,49694,152,13,9,160,6,340,6.355.952.381
19/10/2015 11:00,35.93,48947,138,12,10,147,5,312,6.355.952.381
19/10/2015 12:00,32.24,48299,121,12,11,148,6,298,6.355.952.381
19/10/2015 13:00,29.84,47976,102,13,12,138,6,271,6.355.952.381
19/10/2015 14:00,30.03,47541,89,15,13,149,3,269,6.355.952.381
19/10/2015 15:00,28.22,47110,84,17,14,165,6,286,6.355.952.381
19/10/2015 16:00,28.03,47215,84,21,15,180,6,306,6.355.952.381
19/10/2015 17:00,34.96,47946,75,25,17,189,6,312,6.355.952.381
19/10/2015 18:00,46.31,48657,69,30,20,226,3,348,6.355.952.381
19/10/2015 19:00,35.96,48536,69,34,23,300,6,432,6.355.952.381
19/10/2015 20:00,27.89,46947,62,35,25,351,7,480,6.355.952.381
19/10/2015 21:00,25.79,45276,57,34,24,325,4,444,6.355.952.381
19/10/2015 22:00,24.8,43114,58,31,24,306,4,423,6.355.952.381
19/10/2015 23:00,23.96,40617,55,29,32,306,2,424,6.355.952.381
20/10/2015 00:00,24.28,38606,55,26,30,294,2,407,6.355.952.381
20/10/2015 01:00,24.08,37657,61,24,29,255,2,371,6.355.952.381
20/10/2015 02:00,24.05,37301,70,21,29,244,2,366,6.355.952.381
20/10/2015 03:00,24.08,37348,76,19,29,238,2,364,6.355.952.381
20/10/2015 04:00,24.51,37999,87,20,30,230,3,370,6.355.952.381
20/10/2015 05:00,25.24,40385,100,21,31,228,3,383,6.355.952.381
20/10/2015 06:00,27.13,44792,119,23,32,235,5,414,6.355.952.381
20/10/2015 07:00,35.77,48654,140,20,30,253,6,449,6.355.952.381
20/10/2015 08:00,49.05,49500,164,17,30,246,8,465,6.355.952.381
20/10/2015 09:00,49.94,48904,181,14,31,239,9,474,6.355.952.381
20/10/2015 10:00,48.96,48821,194,15,30,224,11,474,6.355.952.381
20/10/2015 11:00,39.76,48543,199,15,30,281,10,535,6.355.952.381
20/10/2015 12:00,29.95,48083,214,17,30,338,8,607,6.355.952.381
20/10/2015 13:00,28.72,47728,259,18,29,369,8,683,6.355.952.381
20/10/2015 14:00,27.89,47399,298,22,27,388,8,743,6.355.952.381
20/10/2015 15:00,27.69,47149,313,28,26,465,7,839,6.355.952.381
20/10/2015 16:00,27.63,47266,323,36,26,578,7,970,6.355.952.381
20/10/2015 17:00,29.76,48090,322,43,27,655,6,1053,6.355.952.381
20/10/2015 18:00,32.49,49058,317,50,28,736,6,1137,6.355.952.381
20/10/2015 19:00,29.77,48655,320,53,28,781,9,1191,6.355.952.381
20/10/2015 20:00,26.58,46993,345,54,28,761,10,1198,6.355.952.381
20/10/2015 21:00,25.18,45333,372,53,27,799,7,1258,6.355.952.381
20/10/2015 22:00,24.59,43213,377,52,26,784,7,1246,6.355.952.381
20/10/2015 23:00,24.06,40722,376,59,37,767,2,1241,6.355.952.381
21/10/2015 00:00,23.47,38812,324,58,34,756,2,1174,6.355.952.381
21/10/2015 01:00,23.32,37788,335,57,33,755,2,1182,6.355.952.381
21/10/2015 02:00,23.22,37430,326,57,33,709,2,1127,6.355.952.381
21/10/2015 03:00,23.25,37483,289,56,35,702,3,1085,6.355.952.381
21/10/2015 04:00,23.7,38112,273,55,36,667,3,1034,6.355.952.381
21/10/2015 05:00,24.53,40512,278,54,36,635,4,1007,6.355.952.381
21/10/2015 06:00,25.23,44693,307,53,33,613,4,1010,6.355.952.381
21/10/2015 07:00,27.96,48366,401,47,32,672,4,1156,6.355.952.381
21/10/2015 08:00,29.35,49233,523,42,28,722,4,1319,6.355.952.381
21/10/2015 09:00,28.59,48719,619,38,23,804,4,1488,6.355.952.381
21/10/2015 10:00,27.99,48595,708,36,21,1075,4,1844,6.355.952.381
21/10/2015 11:00,27.09,48343,849,36,20,1364,5,2274,6.355.952.381
21/10/2015 12:00,26.24,47957,1028,37,20,1610,4,2699,6.355.952.381
21/10/2015 13:00,25.86,47595,1218,38,21,1849,4,3130,6.355.952.381
21/10/2015 14:00,25.45,47263,1375,43,21,2101,4,3544,6.355.952.381
21/10/2015 15:00,25.08,47155,1510,49,19,2358,3,3939,6.355.952.381
21/10/2015 16:00,24.95,47433,1635,63,16,2521,3,4238,6.355.952.381
21/10/2015 17:00,25.37,48338,1760,76,13,2705,2,4556,6.355.952.381
21/10/2015 18:00,25.74,49283,1895,91,13,2864,3,4866,6.355.952.381
21/10/2015 19:00,25.18,48521,2050,102,16,3036,5,5209,6.355.952.381
21/10/2015 20:00,24.14,46903,2187,110,17,3155,5,5474,6.355.952.381
21/10/2015 21:00,23.34,45174,2257,115,17,3226,6,5621,6.355.952.381
21/10/2015 22:00,22.45,42943,2257,115,18,3197,2,5589,6.355.952.381
21/10/2015 23:00,21.25,40214,2192,119,6,3228,5,5550,6.355.952.381
22/10/2015 00:00,21.6,37894,1650,124,7,3182,5,4968,6.355.952.381
22/10/2015 01:00,21.41,36841,1539,128,7,3076,4,4754,6.355.952.381
22/10/2015 02:00,21.23,36420,1476,132,8,3027,5,4648,6.355.952.381
22/10/2015 03:00,21.41,36444,1450,138,11,2966,5,4570,6.355.952.381
22/10/2015 04:00,22.07,37086,1427,140,13,2895,5,4480,6.355.952.381
22/10/2015 05:00,22.95,39365,1499,143,15,2877,5,4539,6.355.952.381
22/10/2015 06:00,24.43,43790,1693,146,19,2869,16,4743,6.355.952.381
22/10/2015 07:00,25.48,47689,1884,147,20,2791,18,4860,6.355.952.381
22/10/2015 08:00,25.93,49143,2051,154,22,2803,20,5050,6.355.952.381
22/10/2015 09:00,25.72,48484,2255,161,24,2880,23,5343,6.355.952.381
22/10/2015 10:00,25.44,48271,2427,168,29,3004,19,5647,6.355.952.381
22/10/2015 11:00,25.18,47783,2503,173,35,3089,22,5822,6.355.952.381
22/10/2015 12:00,24.89,47382,2564,179,49,3101,24,5917,6.355.952.381
22/10/2015 13:00,24.87,47094,2656,186,60,3147,33,6082,6.355.952.381
22/10/2015 14:00,24.75,46835,2760,193,64,3301,38,6356,6.355.952.381
22/10/2015 15:00,24.6,46393,2876,201,65,3334,37,6513,6.355.952.381
22/10/2015 16:00,24.51,46545,2979,212,66,3249,38,6544,6.355.952.381
22/10/2015 17:00,24.86,47500,3040,218,73,3210,38,6579,6.355.952.381
22/10/2015 18:00,25.01,48216,3097,222,84,3183,41,6627,6.355.952.381
22/10/2015 19:00,24.81,47648,3206,225,99,3136,45,6711,6.355.952.381
22/10/2015 20:00,23.79,45737,3342,227,112,3072,47,6800,6.355.952.381
22/10/2015 21:00,23.29,44058,3507,227,124,3017,46,6921,6.355.952.381
22/10/2015 22:00,22.56,41863,3653,227,135,3037,47,7099,6.355.952.381
22/10/2015 23:00,21.62,39240,3738,236,134,3211,49,7368,6.355.952.381
23/10/2015 00:00,20.82,37026,3727,232,138,3246,48,7391,6.355.952.381
23/10/2015 01:00,20.1,36005,3756,221,141,3334,44,7496,6.355.952.381
23/10/2015 02:00,19.36,35643,3750,199,138,3413,35,7535,6.355.952.381
23/10/2015 03:00,19.64,35761,3685,172,135,3484,33,7509,6.355.952.381
23/10/2015 04:00,21.24,36555,3590,147,132,3575,36,7480,6.355.952.381
23/10/2015 05:00,22.81,38906,3471,126,133,3664,35,7429,6.355.952.381
23/10/2015 06:00,23.84,43211,3317,110,132,3702,39,7300,6.355.952.381
23/10/2015 07:00,25,47132,3129,91,130,3759,35,7144,6.355.952.381
23/10/2015 08:00,25.28,49350,2982,78,120,3740,37,6957,6.355.952.381
23/10/2015 09:00,25.29,48719,2886,67,109,3764,36,6862,6.355.952.381
23/10/2015 10:00,25.27,48153,2843,52,105,3761,40,6801,6.355.952.381
23/10/2015 11:00,25.03,47216,2758,44,108,3685,40,6635,6.355.952.381
23/10/2015 12:00,24.78,46407,2582,38,115,3551,40,6326,6.355.952.381
23/10/2015 13:00,24.61,45575,2325,40,118,3311,39,5833,6.355.952.381
23/10/2015 14:00,24.53,44857,1980,51,114,2999,43,5187,6.355.952.381
23/10/2015 15:00,24.66,44416,1575,64,113,2694,43,4489,6.355.952.381
23/10/2015 16:00,24.95,44642,1174,74,108,2337,44,3737,6.355.952.381
23/10/2015 17:00,25.44,46076,846,89,103,1942,49,3029,6.355.952.381
23/10/2015 18:00,26.21,47180,650,100,100,1828,40,2718,6.355.952.381
23/10/2015 19:00,25.96,46657,580,106,100,1632,42,2460,6.355.952.381
23/10/2015 20:00,25.25,44645,593,105,98,1445,43,2284,6.355.952.381
23/10/2015 21:00,25.01,43168,641,101,97,1211,36,2086,6.355.952.381
23/10/2015 22:00,24.52,41596,701,93,91,1112,27,2024,6.355.952.381
23/10/2015 23:00,23.72,39701,726,109,92,1061,23,2011,6.355.952.381
24/10/2015 00:00,23.76,37524,579,108,81,1052,21,1841,6.355.952.381
24/10/2015 01:00,23.45,36540,619,107,73,1086,15,1900,6.355.952.381
24/10/2015 02:00,23.22,36034,689,103,65,1214,10,2081,6.355.952.381
24/10/2015 03:00,23.15,35913,762,97,58,1404,7,2328,6.355.952.381
24/10/2015 04:00,23.2,36210,859,87,51,1566,6,2569,6.355.952.381
24/10/2015 05:00,23.49,36981,936,70,42,1735,6,2789,6.355.952.381
24/10/2015 06:00,23.7,38145,993,54,32,1830,5,2914,6.355.952.381
24/10/2015 07:00,23.7,39593,1038,41,26,1893,7,3005,6.355.952.381
24/10/2015 08:00,23.91,41209,1116,28,18,1940,7,3109,6.355.952.381
24/10/2015 09:00,24.38,42695,1231,19,11,1858,8,3127,6.355.952.381
24/10/2015 10:00,24.6,43618,1363,13,9,1815,8,3208,6.355.952.381
24/10/2015 11:00,24.58,43489,1453,9,11,1905,7,3385,6.355.952.381
24/10/2015 12:00,24.43,42789,1483,7,12,1892,6,3400,6.355.952.381
24/10/2015 13:00,24.12,42142,1495,5,11,1915,6,3432,6.355.952.381
24/10/2015 14:00,23.91,41912,1524,4,12,1978,6,3524,6.355.952.381
24/10/2015 15:00,23.87,41985,1515,6,12,2107,6,3646,6.355.952.381
24/10/2015 16:00,24.11,42737,1456,9,12,2245,5,3727,6.355.952.381
24/10/2015 17:00,24.69,44362,1453,16,11,2323,3,3806,6.355.952.381
24/10/2015 18:00,24.92,45873,1528,26,11,2452,3,4020,6.355.952.381
24/10/2015 19:00,24.58,45143,1635,36,11,2659,4,4345,6.355.952.381
24/10/2015 20:00,23.79,43305,1726,46,12,2820,5,4609,6.355.952.381
24/10/2015 21:00,23.38,42011,1794,53,13,2949,6,4815,6.355.952.381
24/10/2015 22:00,22.92,40649,1827,60,16,3018,0,4921,6.355.952.381
24/10/2015 23:00,22.38,39119,1754,69,20,3124,8,4975,6.355.952.381
25/10/2015 00:00,22.39,36345,1942,70,25,3140,7,5184,6.355.952.381
25/10/2015 01:00,21.85,35334,1960,72,30,2962,7,5031,6.355.952.381
25/10/2015 02:00,21.32,34344,1745,74,30,2854,8,4711,6.355.952.381
25/10/2015 03:00,21,34523,1507,78,38,3069,8,4700,6.355.952.381
25/10/2015 04:00,21.28,34638,1538,84,43,3014,8,4687,6.355.952.381
25/10/2015 05:00,22.03,35104,1626,90,48,2937,7,4708,6.355.952.381
25/10/2015 06:00,22.11,35761,1701,94,51,2844,9,4699,6.355.952.381
25/10/2015 07:00,22.39,36643,1769,102,52,2685,11,4619,6.355.952.381
25/10/2015 08:00,22.88,37739,1867,110,52,2736,12,4777,6.355.952.381
25/10/2015 09:00,23.25,39207,2029,119,48,2726,14,4936,6.355.952.381
25/10/2015 10:00,23.41,40121,2242,122,43,2758,18,5183,6.355.952.381
25/10/2015 11:00,23.29,40432,2522,125,43,2813,20,5523,6.355.952.381
25/10/2015 12:00,23.08,40291,2709,128,47,2896,19,5799,6.355.952.381
25/10/2015 13:00,22.95,40181,2699,132,49,2908,18,5806,6.355.952.381
25/10/2015 14:00,23.01,40317,2518,133,50,2966,15,5682,6.355.952.381
25/10/2015 15:00,23.29,40844,2247,128,62,3069,16,5522,6.355.952.381
25/10/2015 16:00,24.05,42053,1851,118,74,3199,19,5261,6.355.952.381
25/10/2015 17:00,24.94,43805,1473,109,91,3280,17,4970,6.355.952.381
25/10/2015 18:00,25.07,44556,1227,110,120,3331,24,4812,6.355.952.381
25/10/2015 19:00,25,44341,1044,120,133,3444,34,4775,6.355.952.381
25/10/2015 20:00,24.76,43170,903,126,141,3446,37,4653,6.355.952.381
25/10/2015 21:00,24.43,42103,795,128,148,3391,40,4502,6.355.952.381
25/10/2015 22:00,24.16,40492,672,126,151,3304,48,4301,6.355.952.381
25/10/2015 23:00,24.01,38541,546,127,155,3166,42,4036,6.355.952.381
26/10/2015 00:00,24.19,37704,412,135,163,2974,35,3719,626.952.381
26/10/2015 01:00,23.88,36916,355,150,164,2827,37,3533,626.952.381
26/10/2015 02:00,23.92,36516,317,157,163,2651,39,3327,626.952.381
26/10/2015 03:00,24.21,36671,305,168,156,2403,39,3071,626.952.381
26/10/2015 04:00,25.02,37472,298,174,146,2167,40,2825,626.952.381
26/10/2015 05:00,25.36,39922,296,181,137,1917,39,2570,626.952.381
26/10/2015 06:00,26.72,44528,319,186,126,1701,39,2371,626.952.381
26/10/2015 07:00,29.46,48576,368,192,107,1540,35,2242,626.952.381
26/10/2015 08:00,29.51,50318,401,191,96,1331,35,2054,626.952.381
26/10/2015 09:00,28.76,49551,357,186,90,1142,43,1818,626.952.381
26/10/2015 10:00,28.57,49075,326,179,87,974,45,1611,626.952.381
26/10/2015 11:00,28.07,48349,353,173,84,909,47,1566,626.952.381
26/10/2015 12:00,27.6,47681,394,165,82,876,42,1559,626.952.381
26/10/2015 13:00,27.17,47394,401,157,79,907,40,1584,626.952.381
26/10/2015 14:00,27.41,47209,376,147,70,1065,37,1695,626.952.381
26/10/2015 15:00,27.43,47213,332,133,61,1238,30,1794,626.952.381
26/10/2015 16:00,27.74,48029,310,116,54,1408,22,1910,626.952.381
26/10/2015 17:00,28.65,49345,363,100,44,1736,16,2259,626.952.381
26/10/2015 18:00,28.71,49533,472,82,34,2004,13,2605,626.952.381
26/10/2015 19:00,27.09,48809,588,70,31,2077,10,2776,626.952.381
26/10/2015 20:00,25.79,47039,681,61,30,2164,10,2946,626.952.381
26/10/2015 21:00,25.36,45372,755,58,26,2135,11,2985,626.952.381
26/10/2015 22:00,25.03,43129,770,57,19,2137,7,2990,626.952.381
26/10/2015 23:00,24.1,40528,744,61,17,2182,8,3012,626.952.381
27/10/2015 00:00,23.91,38482,657,59,17,2150,3,2886,626.952.381
27/10/2015 01:00,23.45,37555,647,65,12,2096,3,2823,626.952.381
27/10/2015 02:00,23.32,37219,624,76,10,2005,3,2718,626.952.381
27/10/2015 03:00,23.6,37304,609,87,10,1887,4,2597,626.952.381
27/10/2015 04:00,24.29,38131,591,94,12,1762,5,2464,626.952.381
27/10/2015 05:00,25.01,40451,550,105,15,1710,5,2385,626.952.381
27/10/2015 06:00,26.11,44642,511,118,17,1574,6,2226,626.952.381
27/10/2015 07:00,28.76,48360,502,124,19,1450,8,2103,626.952.381
27/10/2015 08:00,29.58,49274,504,121,20,1221,10,1876,626.952.381
27/10/2015 09:00,29.14,49547,527,117,20,987,16,1667,626.952.381
27/10/2015 10:00,29.29,49161,641,112,24,947,23,1747,626.952.381
27/10/2015 11:00,28.79,48498,849,113,29,745,26,1762,626.952.381
27/10/2015 12:00,28.17,48012,1065,116,32,573,29,1815,626.952.381
27/10/2015 13:00,27.77,47876,1216,121,31,442,25,1835,626.952.381
27/10/2015 14:00,27.77,47688,1298,127,27,391,24,1867,626.952.381
27/10/2015 15:00,27.83,47684,1348,133,22,389,19,1911,626.952.381
27/10/2015 16:00,28.41,48323,1406,136,17,412,12,1983,626.952.381
27/10/2015 17:00,29.54,49575,1499,134,13,483,10,2139,626.952.381
27/10/2015 18:00,29.46,49843,1589,129,10,580,7,2315,626.952.381
27/10/2015 19:00,27.99,49179,1603,116,8,677,6,2410,626.952.381
27/10/2015 20:00,26.39,47509,1542,102,6,779,7,2436,626.952.381
27/10/2015 21:00,25.83,45930,1471,85,5,884,6,2451,626.952.381
27/10/2015 22:00,25.37,43734,1438,69,4,1020,2,2533,626.952.381
27/10/2015 23:00,24.78,41217,1460,53,5,1223,1,2742,626.952.381
28/10/2015 00:00,24.8,39487,1289,57,16,1371,4,2737,626.952.381
28/10/2015 01:00,24.45,38560,1363,44,20,1486,4,2917,626.952.381
28/10/2015 02:00,24,38224,1497,34,25,1627,5,3188,626.952.381
28/10/2015 03:00,24.11,38364,1656,26,31,1750,5,3468,626.952.381
28/10/2015 04:00,24.75,39078,1792,22,37,1889,4,3744,626.952.381
28/10/2015 05:00,25.2,41363,1925,18,43,1914,5,3905,626.952.381
28/10/2015 06:00,25.85,45463,2051,16,46,1928,6,4047,626.952.381
28/10/2015 07:00,27.93,49052,2173,12,49,1840,6,4080,626.952.381
28/10/2015 08:00,28.65,50926,2283,7,48,1826,6,4170,626.952.381
28/10/2015 09:00,28.16,50303,2381,4,44,1804,8,4241,626.952.381
28/10/2015 10:00,27.91,49729,2428,4,42,1705,9,4188,626.952.381
28/10/2015 11:00,27.75,49022,2422,3,44,1562,10,4041,626.952.381
28/10/2015 12:00,27.7,48522,2383,4,47,1356,11,3801,626.952.381
28/10/2015 13:00,27.33,48330,2342,5,49,1260,11,3667,626.952.381
28/10/2015 14:00,27.11,48262,2331,6,53,1300,11,3701,626.952.381
28/10/2015 15:00,27.43,48401,2301,7,55,1288,10,3661,626.952.381
28/10/2015 16:00,28.26,49152,2273,9,56,1312,7,3657,626.952.381
28/10/2015 17:00,29.41,50438,2299,11,62,1388,8,3768,626.952.381
28/10/2015 18:00,29.02,50501,2342,15,72,1427,7,3863,626.952.381
28/10/2015 19:00,27.76,49719,2301,20,84,1433,9,3847,626.952.381
28/10/2015 20:00,26.26,48015,2141,26,88,1422,11,3688,626.952.381
28/10/2015 21:00,25.81,46397,1929,33,90,1380,12,3444,626.952.381
28/10/2015 22:00,25.36,44175,1730,40,90,1339,12,3211,626.952.381
28/10/2015 23:00,24.9,41664,1589,49,88,1235,11,2972,626.952.381
29/10/2015 00:00,24.94,40036,1364,65,94,1183,14,2720,626.952.381
29/10/2015 01:00,24.84,38987,1217,66,92,1089,12,2476,626.952.381
29/10/2015 02:00,24.82,38565,1091,65,90,999,11,2256,626.952.381
29/10/2015 03:00,24.97,38651,942,62,89,894,11,1998,626.952.381
29/10/2015 04:00,25.46,39373,805,60,87,816,12,1780,626.952.381
29/10/2015 05:00,26.37,41675,719,60,87,801,15,1682,626.952.381
29/10/2015 06:00,28.3,46194,643,58,86,764,16,1567,626.952.381
29/10/2015 07:00,30.12,49747,570,54,84,733,15,1456,626.952.381
29/10/2015 08:00,33.89,51236,508,46,71,660,14,1299,626.952.381
29/10/2015 09:00,32.27,50857,454,38,61,563,15,1131,626.952.381
29/10/2015 10:00,31.95,50492,406,31,54,495,14,1000,626.952.381
29/10/2015 11:00,29.93,49879,349,25,51,428,12,865,626.952.381
29/10/2015 12:00,29.9,49408,298,20,50,368,10,746,626.952.381
29/10/2015 13:00,29.41,49148,256,17,49,312,8,642,626.952.381
29/10/2015 14:00,29.74,48921,208,17,50,311,6,592,626.952.381
29/10/2015 15:00,29.96,48979,167,18,52,314,6,557,626.952.381
29/10/2015 16:00,31,49668,150,21,53,366,5,595,626.952.381
29/10/2015 17:00,36.04,50814,154,23,52,441,5,675,626.952.381
29/10/2015 18:00,43.15,50909,167,22,51,492,5,737,626.952.381
29/10/2015 19:00,31.04,50151,165,21,52,543,5,786,626.952.381
29/10/2015 20:00,28.13,48417,152,17,47,550,7,773,626.952.381
29/10/2015 21:00,27.28,46846,142,14,38,558,6,758,626.952.381
29/10/2015 22:00,26.01,44570,137,11,32,546,5,731,626.952.381
29/10/2015 23:00,25.45,42022,138,42,28,520,4,732,626.952.381
30/10/2015 00:00,25.43,40317,160,6,17,510,2,695,626.952.381
30/10/2015 01:00,25.21,39397,159,5,16,483,1,664,626.952.381
30/10/2015 02:00,25.07,38982,180,5,14,448,1,648,626.952.381
30/10/2015 03:00,25.25,39080,209,6,14,518,2,749,626.952.381
30/10/2015 04:00,25.64,39803,252,8,15,585,2,862,626.952.381
30/10/2015 05:00,26.18,41972,315,10,16,620,2,963,626.952.381
30/10/2015 06:00,28.1,45859,383,13,18,685,2,1101,626.952.381
30/10/2015 07:00,29.53,49202,445,13,18,731,2,1209,626.952.381
30/10/2015 08:00,30.56,50256,503,10,17,748,2,1280,626.952.381
30/10/2015 09:00,29.81,50128,562,8,13,734,4,1321,626.952.381
30/10/2015 10:00,28.88,50019,610,8,11,734,3,1366,626.952.381
30/10/2015 11:00,28.47,49453,622,7,11,701,3,1344,626.952.381
30/10/2015 12:00,28.24,48773,632,7,12,702,4,1357,626.952.381
30/10/2015 13:00,28.15,48094,632,7,12,738,3,1392,626.952.381
30/10/2015 14:00,27.97,47660,611,7,14,811,3,1446,626.952.381
30/10/2015 15:00,27.6,47897,596,9,17,927,4,1553,626.952.381
30/10/2015 16:00,28.58,49085,614,14,21,991,5,1645,626.952.381
30/10/2015 17:00,29.38,50043,697,17,23,1057,4,1798,626.952.381
30/10/2015 18:00,28.61,49694,830,24,25,1149,3,2031,626.952.381
30/10/2015 19:00,26.86,48320,972,27,25,1331,4,2359,626.952.381
30/10/2015 20:00,25.83,46293,1112,29,25,1449,6,2621,626.952.381
30/10/2015 21:00,25.62,44850,1236,31,26,1562,6,2861,626.952.381
30/10/2015 22:00,25.23,43086,1254,33,27,1664,7,2985,626.952.381
30/10/2015 23:00,24.79,40994,1153,33,27,1704,4,2921,626.952.381
31/10/2015 00:00,24.56,39006,1020,36,34,1820,3,2913,626.952.381
31/10/2015 01:00,24.36,37988,875,37,30,1839,3,2784,626.952.381
31/10/2015 02:00,24.16,37387,776,37,28,1914,2,2757,626.952.381
31/10/2015 03:00,24.05,37268,746,38,27,1920,2,2733,626.952.381
31/10/2015 04:00,24.17,37447,780,39,27,1892,2,2740,626.952.381
31/10/2015 05:00,24.32,37969,847,41,28,1860,2,2778,626.952.381
31/10/2015 06:00,24.1,38950,934,45,30,1821,2,2832,626.952.381
31/10/2015 07:00,24.31,40112,1046,51,32,1772,6,2907,626.952.381
31/10/2015 08:00,24.58,41325,1163,57,27,1729,6,2982,626.952.381
31/10/2015 09:00,24.9,42867,1272,62,20,1635,6,2995,626.952.381
31/10/2015 10:00,25.16,43639,1362,63,19,1528,7,2979,626.952.381
31/10/2015 11:00,25.21,43539,1342,64,21,1490,7,2924,626.952.381
31/10/2015 12:00,25.14,43059,1267,64,21,1351,8,2711,626.952.381
31/10/2015 13:00,25.03,42746,1140,69,21,1288,9,2527,626.952.381
31/10/2015 14:00,25.02,42612,1000,75,23,1357,9,2464,626.952.381
31/10/2015 15:00,25.25,43310,855,81,28,1500,7,2471,626.952.381
31/10/2015 16:00,25.73,45017,762,85,35,1643,6,2531,626.952.381
31/10/2015 17:00,26.22,46415,817,88,41,1805,6,2757,626.952.381
31/10/2015 18:00,26.01,46108,941,91,46,1958,6,3042,626.952.381
31/10/2015 19:00,25.58,44826,956,94,53,2290,9,3402,626.952.381
31/10/2015 20:00,25.05,43194,887,99,58,2495,11,3550,626.952.381
31/10/2015 21:00,24.69,42144,840,100,62,2705,14,3721,626.952.381
31/10/2015 22:00,24.51,40814,771,105,65,2828,13,3782,626.952.381
31/10/2015 23:00,24.15,39220,663,99,66,2907,14,3749,626.952.381
01/11/2015 00:00,23.58,37541,567,126,64,3136,10,3903,626.952.381
01/11/2015 01:00,23.27,36436,499,129,66,3119,10,3823,626.952.381
01/11/2015 02:00,23.14,35250,428,135,66,3075,10,3714,626.952.381
01/11/2015 03:00,23.12,35646,363,140,68,3020,10,3601,626.952.381
01/11/2015 04:00,23.2,35789,310,144,70,2952,10,3486,626.952.381
01/11/2015 05:00,23.54,36223,272,147,68,2904,10,3401,626.952.381
01/11/2015 06:00,23.66,36891,257,149,65,2812,12,3295,626.952.381
01/11/2015 07:00,23.79,37905,260,153,61,2699,14,3187,626.952.381
01/11/2015 08:00,24.35,39048,261,156,60,2683,14,3174,626.952.381
01/11/2015 09:00,24.67,40490,265,156,57,2707,17,3202,626.952.381
01/11/2015 10:00,25.02,41393,276,150,57,2724,18,3225,626.952.381
01/11/2015 11:00,25.07,41877,286,138,58,2717,18,3217,626.952.381
01/11/2015 12:00,25.03,41792,290,128,60,2757,17,3252,626.952.381
01/11/2015 13:00,24.93,41698,276,119,61,2740,17,3213,626.952.381
01/11/2015 14:00,24.93,41812,249,105,65,2758,14,3191,626.952.381
01/11/2015 15:00,25.05,42392,232,91,68,2728,10,3129,626.952.381
01/11/2015 16:00,25.48,43765,223,80,69,2715,9,3096,626.952.381
01/11/2015 17:00,25.92,45232,222,73,68,2742,9,3114,626.952.381
01/11/2015 18:00,25.89,45272,226,72,69,2759,10,3136,626.952.381
01/11/2015 19:00,25.63,44732,233,71,71,2817,10,3202,626.952.381
01/11/2015 20:00,25.21,43458,255,70,73,2840,11,3249,626.952.381
01/11/2015 21:00,25.01,42296,292,70,75,2830,12,3279,626.952.381
01/11/2015 22:00,24.71,40551,317,67,75,2852,10,3321,626.952.381
01/11/2015 23:00,24.21,38560,332,63,68,2965,10,3438,626.952.381
02/11/2015 00:00,23.65,36944,488,73,47,3033,8,3649,6.232.857.143
02/11/2015 01:00,23.29,36202,529,73,45,3103,7,3757,6.232.857.143
02/11/2015 02:00,23.17,35891,540,76,47,3143,9,3815,6.232.857.143
02/11/2015 03:00,22.18,35997,535,80,50,3202,9,3876,6.232.857.143
02/11/2015 04:00,23.78,36873,529,85,53,3254,12,3933,6.232.857.143
02/11/2015 05:00,24.61,39264,533,91,56,3242,15,3937,6.232.857.143
02/11/2015 06:00,25.29,43977,529,94,61,3215,18,3917,6.232.857.143
02/11/2015 07:00,26.17,48056,504,97,67,3084,18,3770,6.232.857.143
02/11/2015 08:00,26.82,48929,477,101,67,3001,19,3665,6.232.857.143
02/11/2015 09:00,26.28,48291,458,103,68,2924,26,3579,6.232.857.143
02/11/2015 10:00,26.47,48045,434,104,73,2986,29,3626,6.232.857.143
02/11/2015 11:00,26.22,47559,407,105,76,2885,29,3502,6.232.857.143
02/11/2015 12:00,26.03,47051,375,106,75,2915,29,3500,6.232.857.143
02/11/2015 13:00,25.96,46954,334,106,73,2925,27,3465,6.232.857.143
02/11/2015 14:00,25.96,47000,283,108,74,2915,24,3404,6.232.857.143
02/11/2015 15:00,26.1,47275,236,110,75,2891,22,3334,6.232.857.143
02/11/2015 16:00,26.68,48473,199,111,74,2941,17,3342,6.232.857.143
02/11/2015 17:00,27.62,49852,170,110,72,2921,17,3290,6.232.857.143
02/11/2015 18:00,27.45,49237,155,110,67,2809,17,3158,6.232.857.143
02/11/2015 19:00,25.97,48096,150,107,61,2768,13,3099,6.232.857.143
02/11/2015 20:00,25.54,46277,157,105,55,2600,12,2929,6.232.857.143
02/11/2015 21:00,25.31,44720,178,101,48,2465,10,2802,6.232.857.143
02/11/2015 22:00,24.99,42340,208,100,40,2339,9,2696,6.232.857.143
02/11/2015 23:00,24.32,39631,228,91,35,2125,9,2488,6.232.857.143
03/11/2015 00:00,23.34,37283,269,99,37,2182,9,2596,6.232.857.143
03/11/2015 01:00,23.02,36320,281,93,32,2122,9,2537,6.232.857.143
03/11/2015 02:00,22.96,35968,277,87,30,2019,9,2422,6.232.857.143
03/11/2015 03:00,23.26,36079,279,82,28,1923,9,2321,6.232.857.143
03/11/2015 04:00,23.91,36865,285,76,25,1883,8,2277,6.232.857.143
03/11/2015 05:00,24.49,39235,292,71,21,1750,6,2140,6.232.857.143
03/11/2015 06:00,25.42,43687,311,67,18,1587,6,1989,6.232.857.143
03/11/2015 07:00,27.18,47488,331,59,17,1540,7,1954,6.232.857.143
03/11/2015 08:00,28.41,48552,348,49,18,1452,7,1874,6.232.857.143
03/11/2015 09:00,26.93,48024,362,42,17,1299,5,1725,6.232.857.143
03/11/2015 10:00,27.47,47732,348,37,15,1209,5,1614,6.232.857.143
03/11/2015 11:00,26.98,47285,315,34,13,1293,6,1661,6.232.857.143
03/11/2015 12:00,26.67,46848,287,35,13,1265,6,1606,6.232.857.143
03/11/2015 13:00,26.56,46693,249,38,14,1284,10,1595,6.232.857.143
03/11/2015 14:00,26.6,46680,194,44,15,1291,13,1557,6.232.857.143
03/11/2015 15:00,26.8,46996,144,54,15,1325,15,1553,6.232.857.143
03/11/2015 16:00,28,48131,117,65,15,1355,14,1566,6.232.857.143
03/11/2015 17:00,28.75,49157,105,75,17,1445,18,1660,6.232.857.143
03/11/2015 18:00,28.12,48801,107,84,21,1590,18,1820,6.232.857.143
03/11/2015 19:00,26.76,47712,110,93,26,1691,20,1940,6.232.857.143
03/11/2015 20:00,25.62,45932,117,98,28,1712,24,1979,6.232.857.143
03/11/2015 21:00,25.4,44356,125,100,29,1748,24,2026,6.232.857.143
03/11/2015 22:00,24.95,42001,124,100,26,1801,22,2073,6.232.857.143
03/11/2015 23:00,24.31,39336,117,97,23,1809,17,2063,6.232.857.143
04/11/2015 00:00,23.51,37528,102,96,23,1915,13,2149,6.232.857.143
04/11/2015 01:00,23.16,36506,108,93,23,1883,12,2119,6.232.857.143
04/11/2015 02:00,23.08,36108,116,91,20,1870,11,2108,6.232.857.143
04/11/2015 03:00,23.2,36226,122,85,16,1841,12,2076,6.232.857.143
04/11/2015 04:00,23.67,36964,124,81,13,1779,10,2007,6.232.857.143
04/11/2015 05:00,24.55,39348,117,74,11,1624,9,1835,6.232.857.143
04/11/2015 06:00,25.26,43744,107,68,10,1564,7,1756,6.232.857.143
04/11/2015 07:00,26.99,47497,105,67,8,1411,8,1599,6.232.857.143
04/11/2015 08:00,28.13,49291,99,63,7,1460,6,1635,6.232.857.143
04/11/2015 09:00,27.49,48834,106,63,6,1397,9,1581,6.232.857.143
04/11/2015 10:00,27.14,48526,115,62,6,1360,7,1550,6.232.857.143
04/11/2015 11:00,26.92,48061,125,62,6,1267,7,1467,6.232.857.143
04/11/2015 12:00,26.42,47634,147,63,7,1218,8,1443,6.232.857.143
04/11/2015 13:00,26.42,47469,186,65,7,1191,8,1457,6.232.857.143
04/11/2015 14:00,26.54,47525,232,66,8,1277,9,1592,6.232.857.143
04/11/2015 15:00,26.6,47890,270,62,8,1233,9,1582,6.232.857.143
04/11/2015 16:00,27.42,48833,319,60,7,1244,7,1637,6.232.857.143
04/11/2015 17:00,28.61,49827,387,57,6,1217,4,1671,6.232.857.143
04/11/2015 18:00,28.45,49402,453,56,5,1171,3,1688,6.232.857.143
04/11/2015 19:00,26.8,48305,491,55,4,1102,2,1654,6.232.857.143
04/11/2015 20:00,25.7,46514,495,55,4,1051,4,1609,6.232.857.143
04/11/2015 21:00,25.1,44973,487,54,3,961,4,1509,6.232.857.143
04/11/2015 22:00,24.7,42696,486,54,3,845,4,1392,6.232.857.143
04/11/2015 23:00,24.05,40094,480,50,3,698,3,1234,6.232.857.143
05/11/2015 00:00,23.42,38902,422,51,2,641,2,1118,6.232.857.143
05/11/2015 01:00,22.99,37892,419,44,2,601,2,1068,6.232.857.143
05/11/2015 02:00,22.89,37560,424,39,3,610,2,1078,6.232.857.143
05/11/2015 03:00,23.26,37721,432,33,3,530,2,1000,6.232.857.143
05/11/2015 04:00,24.07,38568,432,26,4,479,2,943,6.232.857.143
05/11/2015 05:00,24.74,41037,441,19,4,506,2,972,6.232.857.143
05/11/2015 06:00,25.83,45637,446,14,4,527,3,994,6.232.857.143
05/11/2015 07:00,27.7,49470,445,8,6,568,4,1031,6.232.857.143
05/11/2015 08:00,28.49,51327,459,4,7,645,4,1119,6.232.857.143
05/11/2015 09:00,27.05,50921,484,2,7,673,6,1172,6.232.857.143
05/11/2015 10:00,27.6,50684,484,2,6,653,5,1150,6.232.857.143
05/11/2015 11:00,27.19,50126,475,2,6,670,6,1159,6.232.857.143
05/11/2015 12:00,26.82,49784,470,2,7,709,6,1194,6.232.857.143
05/11/2015 13:00,26.45,49637,455,3,7,675,5,1145,6.232.857.143
05/11/2015 14:00,26.47,49562,437,3,7,599,6,1052,6.232.857.143
05/11/2015 15:00,27,49827,438,4,8,534,6,990,6.232.857.143
05/11/2015 16:00,28.53,50811,442,4,8,458,5,917,6.232.857.143
05/11/2015 17:00,30.02,51695,440,6,9,439,5,899,6.232.857.143
05/11/2015 18:00,28.6,51250,455,7,10,424,5,901,6.232.857.143
05/11/2015 19:00,26.47,50215,478,9,11,393,4,895,6.232.857.143
05/11/2015 20:00,25.63,48233,484,11,12,380,6,893,6.232.857.143
05/11/2015 21:00,25.24,46402,483,14,13,362,5,877,6.232.857.143
05/11/2015 22:00,24.81,44008,480,17,14,346,5,862,6.232.857.143
05/11/2015 23:00,24.11,41254,477,18,15,321,3,834,6.232.857.143
06/11/2015 00:00,23.33,39006,477,13,24,291,4,809,6.232.857.143
06/11/2015 01:00,22.94,37999,484,14,23,290,4,815,6.232.857.143
06/11/2015 02:00,22.73,37487,514,16,23,358,4,915,6.232.857.143
06/11/2015 03:00,22.95,37541,575,15,23,356,5,974,6.232.857.143
06/11/2015 04:00,23.77,38294,601,16,23,316,4,960,6.232.857.143
06/11/2015 05:00,24.67,40676,615,16,23,331,5,990,6.232.857.143
06/11/2015 06:00,26.03,45250,643,17,23,358,6,1047,6.232.857.143
06/11/2015 07:00,27.88,48964,640,17,22,368,6,1053,6.232.857.143
06/11/2015 08:00,28.51,50218,623,16,20,401,7,1067,6.232.857.143
06/11/2015 09:00,27.57,50208,611,16,17,373,9,1026,6.232.857.143
06/11/2015 10:00,27.81,50194,590,16,16,363,9,994,6.232.857.143
06/11/2015 11:00,27.52,49787,580,16,16,350,9,971,6.232.857.143
06/11/2015 12:00,26.94,49270,581,16,17,383,9,1006,6.232.857.143
06/11/2015 13:00,26.66,48765,580,16,18,406,8,1028,6.232.857.143
06/11/2015 14:00,26.12,48417,591,16,18,420,7,1052,6.232.857.143
06/11/2015 15:00,26.23,48514,636,17,18,511,5,1187,6.232.857.143
06/11/2015 16:00,27.01,49274,688,19,19,578,5,1309,6.232.857.143
06/11/2015 17:00,28.01,50101,741,21,20,634,5,1421,6.232.857.143
06/11/2015 18:00,27.88,49609,807,24,21,727,4,1583,6.232.857.143
06/11/2015 19:00,26,48118,860,26,23,847,4,1760,6.232.857.143
06/11/2015 20:00,25.02,45864,884,28,25,1023,7,1967,6.232.857.143
06/11/2015 21:00,24.68,44068,923,32,27,1059,6,2047,6.232.857.143
06/11/2015 22:00,24.18,42173,946,34,27,1154,6,2167,6.232.857.143
06/11/2015 23:00,23.33,39885,952,35,27,1250,5,2269,6.232.857.143
07/11/2015 00:00,22.73,37679,1231,41,34,1385,4,2695,6.232.857.143
07/11/2015 01:00,22.08,36546,1301,45,36,1410,4,2796,6.232.857.143
07/11/2015 02:00,21.66,35973,1366,48,39,1524,4,2981,6.232.857.143
07/11/2015 03:00,20.43,35801,1462,53,43,1635,5,3198,6.232.857.143
07/11/2015 04:00,21.29,35895,1463,56,46,1695,5,3265,6.232.857.143
07/11/2015 05:00,22.07,36413,1331,63,49,1777,6,3226,6.232.857.143
07/11/2015 06:00,22.25,37596,1226,71,52,1948,5,3302,6.232.857.143
07/11/2015 07:00,22.85,39171,1216,84,55,2066,9,3430,6.232.857.143
07/11/2015 08:00,23.17,40873,1204,97,56,2097,12,3466,6.232.857.143
07/11/2015 09:00,23.84,42356,1217,112,56,2041,14,3440,6.232.857.143
07/11/2015 10:00,24.17,43173,1157,122,54,2081,13,3427,6.232.857.143
07/11/2015 11:00,24.3,43338,936,132,52,2032,19,3171,6.232.857.143
07/11/2015 12:00,24.22,43097,752,141,50,1941,19,2903,6.232.857.143
07/11/2015 13:00,24.12,42789,670,149,49,1806,22,2696,6.232.857.143
07/11/2015 14:00,23.98,42892,670,157,48,1774,26,2675,6.232.857.143
07/11/2015 15:00,24.47,43663,704,165,48,1648,26,2591,6.232.857.143
07/11/2015 16:00,25.03,44973,798,175,49,1550,27,2599,6.232.857.143
07/11/2015 17:00,25.41,45978,1082,182,50,1451,22,2787,6.232.857.143
07/11/2015 18:00,25.04,45525,1587,178,51,1297,18,3131,6.232.857.143
07/11/2015 19:00,24.51,44203,2143,172,51,1375,15,3756,6.232.857.143
07/11/2015 20:00,23.38,42408,2639,162,52,1407,12,4272,6.232.857.143
07/11/2015 21:00,22.41,41211,3107,149,54,1435,9,4754,6.232.857.143
07/11/2015 22:00,22.02,39848,3413,139,57,1532,8,5149,6.232.857.143
07/11/2015 23:00,20.26,37996,3586,123,59,1610,9,5387,6.232.857.143
08/11/2015 00:00,19.04,36459,3541,124,70,1894,17,5646,6.232.857.143
08/11/2015 01:00,18.29,35444,2811,108,69,2134,16,5138,6.232.857.143
08/11/2015 02:00,17.24,34466,2954,94,78,2256,18,5400,6.232.857.143
08/11/2015 03:00,18,34682,3485,88,90,2343,22,6028,6.232.857.143
08/11/2015 04:00,18.37,34827,3980,81,106,2463,26,6656,6.232.857.143
08/11/2015 05:00,19.02,35369,3916,75,132,2644,31,6798,6.232.857.143
08/11/2015 06:00,19.72,36153,3687,74,158,2853,40,6812,6.232.857.143
08/11/2015 07:00,20.1,37150,3309,64,174,2931,40,6518,6.232.857.143
08/11/2015 08:00,21.95,38548,2869,57,182,3000,41,6149,6.232.857.143
08/11/2015 09:00,22.87,40230,2482,49,189,2999,39,5758,6.232.857.143
08/11/2015 10:00,23.54,41240,2200,42,194,2860,42,5338,6.232.857.143
08/11/2015 11:00,23.85,41592,1927,35,194,2702,43,4901,6.232.857.143
08/11/2015 12:00,23.94,41531,1593,34,190,2550,48,4415,6.232.857.143
08/11/2015 13:00,24.21,41505,1111,46,185,2331,52,3725,6.232.857.143
08/11/2015 14:00,24.45,41719,674,58,194,2098,54,3078,6.232.857.143
08/11/2015 15:00,24.88,42787,479,80,200,1781,60,2600,6.232.857.143
08/11/2015 16:00,25.54,44618,478,99,204,1620,60,2461,6.232.857.143
08/11/2015 17:00,26.56,46182,683,115,206,1291,60,2355,6.232.857.143
08/11/2015 18:00,26.32,46059,979,126,200,1110,58,2473,6.232.857.143
08/11/2015 19:00,25.41,45464,1328,130,195,924,54,2631,6.232.857.143
08/11/2015 20:00,24.83,44244,1809,131,179,856,41,3016,6.232.857.143
08/11/2015 21:00,24.44,43241,2368,126,145,890,33,3562,6.232.857.143
08/11/2015 22:00,23.56,41427,2808,110,120,1009,16,4063,6.232.857.143
08/11/2015 23:00,22.48,39274,3158,86,91,1285,12,4632,6.232.857.143
09/11/2015 00:00,20.52,37839,3264,45,84,1825,15,5233,6.219.404.762
09/11/2015 01:00,18.12,37024,3154,30,62,2313,7,5566,6.219.404.762
09/11/2015 02:00,17.06,36680,2935,21,37,2779,4,5776,6.219.404.762
09/11/2015 03:00,16.75,36802,2926,16,20,3220,2,6184,6.219.404.762
09/11/2015 04:00,18.57,37628,2867,10,10,3458,2,6347,6.219.404.762
09/11/2015 05:00,21.75,40067,2615,6,10,3580,1,6212,6.219.404.762
09/11/2015 06:00,24.18,44518,2466,5,13,3578,3,6065,6.219.404.762
09/11/2015 07:00,25.33,48358,2400,8,19,3537,5,5969,6.219.404.762
09/11/2015 08:00,26.4,49312,2374,13,27,3526,6,5946,6.219.404.762
09/11/2015 09:00,25.2,49086,2467,24,33,3473,9,6006,6.219.404.762
09/11/2015 10:00,25.46,48959,2692,34,38,3323,12,6099,6.219.404.762
09/11/2015 11:00,24.97,48702,2981,45,46,3253,16,6341,6.219.404.762
09/11/2015 12:00,24.66,48342,3280,56,54,3217,20,6627,6.219.404.762
09/11/2015 13:00,24.54,48264,3516,75,60,3106,24,6781,6.219.404.762
09/11/2015 14:00,24.37,48373,3685,93,60,3065,29,6932,6.219.404.762
09/11/2015 15:00,24.48,48872,3841,111,57,3025,27,7061,6.219.404.762
09/11/2015 16:00,25.03,49947,3965,130,67,3040,27,7229,6.219.404.762
09/11/2015 17:00,25.46,50706,4042,141,84,3019,17,7303,6.219.404.762
09/11/2015 18:00,24.88,50054,4082,139,102,3020,15,7358,6.219.404.762
09/11/2015 19:00,24.11,49028,4099,132,126,3066,17,7440,6.219.404.762
09/11/2015 20:00,23.67,47110,4057,124,143,3084,20,7428,6.219.404.762
09/11/2015 21:00,23.58,45547,3958,123,140,3051,21,7293,6.219.404.762
09/11/2015 22:00,21.57,43134,3809,122,137,2980,26,7074,6.219.404.762
09/11/2015 23:00,19.28,40499,3590,114,142,2952,16,6814,6.219.404.762
10/11/2015 00:00,17.41,38530,3304,91,193,2968,33,6589,6.219.404.762
10/11/2015 01:00,16.04,37687,3019,81,211,2907,41,6259,6.219.404.762
10/11/2015 02:00,15.29,37309,2769,69,216,2791,46,5891,6.219.404.762
10/11/2015 03:00,16.12,37410,2579,67,215,2667,54,5582,6.219.404.762
10/11/2015 04:00,19.42,38176,2504,57,215,2548,54,5378,6.219.404.762
10/11/2015 05:00,21.12,40544,2524,56,214,2400,54,5248,6.219.404.762
10/11/2015 06:00,23.94,44755,2594,61,209,2306,49,5219,6.219.404.762
10/11/2015 07:00,24.99,48582,2705,66,206,2233,45,5255,6.219.404.762
10/11/2015 08:00,25.04,49181,2862,61,200,2174,41,5338,6.219.404.762
10/11/2015 09:00,24.59,49185,3084,51,188,2187,40,5550,6.219.404.762
10/11/2015 10:00,24.93,49174,3391,46,181,2202,37,5857,6.219.404.762
10/11/2015 11:00,24.56,49140,3638,43,177,2162,36,6056,6.219.404.762
10/11/2015 12:00,24.38,48724,3775,44,167,2129,37,6152,6.219.404.762
10/11/2015 13:00,24.29,48584,3781,42,157,2033,34,6047,6.219.404.762
10/11/2015 14:00,24.35,48471,3735,42,155,2067,29,6028,6.219.404.762
10/11/2015 15:00,24.53,49016,3658,44,146,2214,29,6091,6.219.404.762
10/11/2015 16:00,25.1,50113,3489,45,145,2362,23,6064,6.219.404.762
10/11/2015 17:00,26.79,50803,3221,50,133,2468,19,5891,6.219.404.762
10/11/2015 18:00,26.1,50085,2920,56,122,2632,17,5747,6.219.404.762
10/11/2015 19:00,24.45,48897,2663,56,112,2712,15,5558,6.219.404.762
10/11/2015 20:00,23.92,47108,2509,57,115,2662,15,5358,6.219.404.762
10/11/2015 21:00,23.66,45401,2413,58,117,2639,16,5243,6.219.404.762
10/11/2015 22:00,22.66,42942,2440,59,120,2666,14,5299,6.219.404.762
10/11/2015 23:00,21.34,40257,2595,59,141,2714,15,5524,6.219.404.762
11/11/2015 00:00,21.03,38728,2846,29,180,2859,6,5920,6.219.404.762
11/11/2015 01:00,20.65,37826,2828,30,183,2826,13,5880,6.219.404.762
11/11/2015 02:00,20.55,37466,2851,33,183,2776,25,5868,6.219.404.762
11/11/2015 03:00,20.84,37566,2911,32,180,2784,29,5936,6.219.404.762
11/11/2015 04:00,21.41,38329,2924,34,173,2794,32,5957,6.219.404.762
11/11/2015 05:00,22.76,40778,2838,40,166,2742,35,5821,6.219.404.762
11/11/2015 06:00,23.88,45151,2695,53,156,2749,41,5694,6.219.404.762
11/11/2015 07:00,24.81,49079,2495,56,146,2705,42,5444,6.219.404.762
11/11/2015 08:00,25.97,49732,2232,62,138,2749,36,5217,6.219.404.762
11/11/2015 09:00,24.98,50011,1975,71,131,2737,37,4951,6.219.404.762
11/11/2015 10:00,26.36,49887,1790,79,130,2606,37,4642,6.219.404.762
11/11/2015 11:00,25.97,49505,1678,88,129,2541,36,4472,6.219.404.762
11/11/2015 12:00,25.02,48891,1620,93,136,2470,29,4348,6.219.404.762
11/11/2015 13:00,25.11,48700,1561,95,134,2318,21,4129,6.219.404.762
11/11/2015 14:00,25.28,48879,1530,91,126,2196,12,3955,6.219.404.762
11/11/2015 15:00,25.84,49678,1521,84,115,2066,12,3798,6.219.404.762
11/11/2015 16:00,27,50794,1511,86,104,1949,22,3672,6.219.404.762
11/11/2015 17:00,28.35,51659,1535,86,98,1870,22,3611,6.219.404.762
11/11/2015 18:00,27.22,51006,1613,94,94,1803,17,3621,6.219.404.762
11/11/2015 19:00,25.06,49928,1781,94,92,1738,18,3723,6.219.404.762
11/11/2015 20:00,24.19,48114,2039,90,87,1636,18,3870,6.219.404.762
11/11/2015 21:00,24,46391,2324,81,84,1627,13,4129,6.219.404.762
11/11/2015 22:00,23.18,43923,2681,76,80,1654,9,4500,6.219.404.762
11/11/2015 23:00,21.97,41204,3029,65,73,1636,6,4809,6.219.404.762
12/11/2015 00:00,21.62,39526,2815,45,25,1522,4,4411,6.219.404.762
12/11/2015 01:00,21.23,38520,2971,40,21,1528,4,4564,6.219.404.762
12/11/2015 02:00,21.06,38141,3118,34,19,1537,4,4712,6.219.404.762
12/11/2015 03:00,21.02,38235,3229,30,20,1560,4,4843,6.219.404.762
12/11/2015 04:00,21.92,39021,3247,29,21,1647,4,4948,6.219.404.762
12/11/2015 05:00,22.58,41421,3228,30,29,1804,4,5095,6.219.404.762
12/11/2015 06:00,23.71,45757,3250,35,50,1952,4,5291,6.219.404.762
12/11/2015 07:00,24.75,49660,3237,39,83,2066,5,5430,6.219.404.762
12/11/2015 08:00,25.18,50314,3109,42,112,2159,5,5427,6.219.404.762
12/11/2015 09:00,24.49,50119,3098,46,138,2248,8,5538,6.219.404.762
12/11/2015 10:00,24.65,50681,3264,50,161,2336,10,5821,6.219.404.762
12/11/2015 11:00,24.48,50155,3334,45,175,2395,12,5961,6.219.404.762
12/11/2015 12:00,24.19,49502,3280,43,185,2453,13,5974,6.219.404.762
12/11/2015 13:00,24.41,49527,3002,36,191,2496,13,5738,6.219.404.762
12/11/2015 14:00,24.79,49586,2520,30,196,2536,18,5300,6.219.404.762
12/11/2015 15:00,25.67,50096,1960,35,195,2549,24,4763,6.219.404.762
12/11/2015 16:00,26.93,51229,1423,39,194,2477,27,4160,6.219.404.762
12/11/2015 17:00,28.56,52141,1053,45,207,2308,39,3652,6.219.404.762
12/11/2015 18:00,28.36,51679,925,51,212,2083,46,3317,6.219.404.762
12/11/2015 19:00,26.28,50602,960,59,207,1886,46,3158,6.219.404.762
12/11/2015 20:00,25.14,48884,1019,65,192,1684,48,3008,6.219.404.762
12/11/2015 21:00,24.67,47304,1113,71,174,1496,44,2898,6.219.404.762
12/11/2015 22:00,23.82,44712,1244,74,146,1306,37,2807,6.219.404.762
12/11/2015 23:00,23.1,42074,1404,73,126,1133,30,2766,6.219.404.762
13/11/2015 00:00,22.84,40581,2009,75,142,1004,20,3250,6.219.404.762
13/11/2015 01:00,22.03,39647,2309,58,119,992,17,3495,6.219.404.762
13/11/2015 02:00,21.8,39215,2553,39,96,1053,11,3752,6.219.404.762
13/11/2015 03:00,21.79,39305,2749,25,70,1181,6,4031,6.219.404.762
13/11/2015 04:00,22.09,40095,2912,15,49,1386,2,4364,6.219.404.762
13/11/2015 05:00,22.91,42536,3057,9,33,1727,2,4828,6.219.404.762
13/11/2015 06:00,23.77,46864,3190,5,24,2140,1,5360,6.219.404.762
13/11/2015 07:00,24.7,50750,3210,5,17,2515,1,5748,6.219.404.762
13/11/2015 08:00,24.87,51568,3029,7,16,2832,2,5886,6.219.404.762
13/11/2015 09:00,24.05,51466,2799,12,19,3095,4,5929,6.219.404.762
13/11/2015 10:00,24.13,51795,2811,20,27,3340,5,6203,6.219.404.762
13/11/2015 11:00,23.96,51177,2978,31,38,3495,10,6552,6.219.404.762
13/11/2015 12:00,23.91,50258,3088,42,51,3612,16,6809,6.219.404.762
13/11/2015 13:00,23.77,49668,3056,56,61,3610,18,6801,6.219.404.762
13/11/2015 14:00,23.79,49378,2751,72,72,3506,20,6421,6.219.404.762
13/11/2015 15:00,23.93,49757,2274,94,87,3366,21,5842,6.219.404.762
13/11/2015 16:00,24.29,50548,1914,112,98,3261,25,5410,6.219.404.762
13/11/2015 17:00,24.81,51230,1931,128,110,3172,31,5372,6.219.404.762
13/11/2015 18:00,24.46,50653,2177,145,125,2952,36,5435,6.219.404.762
13/11/2015 19:00,23.75,49216,2517,162,134,2675,39,5527,6.219.404.762
13/11/2015 20:00,23.09,47203,2902,178,134,2498,43,5755,6.219.404.762
13/11/2015 21:00,22.81,45768,3283,190,128,2396,42,6039,6.219.404.762
13/11/2015 22:00,21.5,43976,3475,198,117,2338,38,6166,6.219.404.762
13/11/2015 23:00,19.58,41681,3470,201,107,2294,31,6103,6.219.404.762
14/11/2015 00:00,18.46,39421,3511,209,91,2240,24,6075,6.219.404.762
14/11/2015 01:00,16.92,38427,3387,195,75,2214,16,5887,6.219.404.762
14/11/2015 02:00,15.92,37875,3287,169,72,2250,14,5792,6.219.404.762
14/11/2015 03:00,15.89,37784,3248,133,71,2241,8,5701,6.219.404.762
14/11/2015 04:00,16.39,38038,3242,111,69,2194,5,5621,6.219.404.762
14/11/2015 05:00,18.38,38714,3236,92,88,2123,6,5545,6.219.404.762
14/11/2015 06:00,19.51,39972,3235,77,111,2099,7,5529,6.219.404.762
14/11/2015 07:00,20.55,41717,3275,65,122,2068,13,5543,6.219.404.762
14/11/2015 08:00,21.07,43437,3325,55,140,2076,11,5607,6.219.404.762
14/11/2015 09:00,21.28,45088,3396,46,161,2135,13,5751,6.219.404.762
14/11/2015 10:00,21.59,45908,3487,39,176,2158,17,5877,6.219.404.762
14/11/2015 11:00,21.51,45861,3590,36,180,2230,18,6054,6.219.404.762
14/11/2015 12:00,21.34,45497,3691,30,167,2301,20,6209,6.219.404.762
14/11/2015 13:00,21.08,45215,3680,25,161,2406,26,6298,6.219.404.762
14/11/2015 14:00,21.11,45425,3588,22,157,2523,17,6307,6.219.404.762
14/11/2015 15:00,22.66,46607,3474,21,144,2604,14,6257,6.219.404.762
14/11/2015 16:00,23.56,48097,3297,21,137,2645,15,6115,6.219.404.762
14/11/2015 17:00,23.83,48948,3086,24,141,2681,21,5953,6.219.404.762
14/11/2015 18:00,23.64,48382,2856,29,142,2700,20,5747,6.219.404.762
14/11/2015 19:00,23.21,46976,2641,32,139,2716,19,5547,6.219.404.762
14/11/2015 20:00,22.64,45203,2465,33,134,2719,18,5369,6.219.404.762
14/11/2015 21:00,22.47,44132,2279,33,132,2637,14,5095,6.219.404.762
14/11/2015 22:00,21.63,42701,2043,32,135,2536,11,4757,6.219.404.762
14/11/2015 23:00,21.49,40951,1806,30,136,2413,16,4401,6.219.404.762
15/11/2015 00:00,21.92,39363,1757,26,158,2348,11,4300,6.219.404.762
15/11/2015 01:00,21.18,38429,1534,22,158,2253,12,3979,6.219.404.762
15/11/2015 02:00,20.72,37678,1328,18,153,2142,13,3654,6.219.404.762
15/11/2015 03:00,20.03,37609,1128,16,144,1994,15,3297,6.219.404.762
15/11/2015 04:00,20.15,37735,896,15,136,1856,15,2918,6.219.404.762
15/11/2015 05:00,20.63,38248,697,16,128,1654,14,2509,6.219.404.762
15/11/2015 06:00,21.12,39069,565,16,116,1452,12,2161,6.219.404.762
15/11/2015 07:00,21.37,40103,486,14,102,1277,13,1892,6.219.404.762
15/11/2015 08:00,21.64,41655,431,16,92,1124,11,1674,6.219.404.762
15/11/2015 09:00,22.62,43129,375,20,85,995,10,1485,6.219.404.762
15/11/2015 10:00,23.03,44124,294,21,81,891,11,1298,6.219.404.762
15/11/2015 11:00,23.11,44457,229,19,74,793,12,1127,6.219.404.762
15/11/2015 12:00,23.16,44382,186,17,69,691,11,974,6.219.404.762
15/11/2015 13:00,22.92,44344,167,16,63,614,9,869,6.219.404.762
15/11/2015 14:00,23.11,44691,168,18,53,578,7,824,6.219.404.762
15/11/2015 15:00,23.48,45756,175,20,40,552,4,791,6.219.404.762
15/11/2015 16:00,24.06,47457,184,21,31,545,4,785,6.219.404.762
15/11/2015 17:00,25.32,48719,184,22,26,566,3,801,6.219.404.762
15/11/2015 18:00,24.98,48457,196,20,24,588,2,830,6.219.404.762
15/11/2015 19:00,24.51,47731,212,20,21,581,1,835,6.219.404.762
15/11/2015 20:00,23.95,46403,228,17,18,546,3,812,6.219.404.762
15/11/2015 21:00,23.81,45427,251,17,18,514,3,803,6.219.404.762
15/11/2015 22:00,23.62,43608,280,17,17,453,3,770,6.219.404.762
15/11/2015 23:00,23.18,41587,342,16,15,405,1,779,6.219.404.762
16/11/2015 00:00,23.1,39938,318,14,16,459,2,809,6.066.190.476
16/11/2015 01:00,22.39,39228,435,13,16,411,1,876,6.066.190.476
16/11/2015 02:00,21.48,38885,618,13,16,365,1,1013,6.066.190.476
16/11/2015 03:00,20.87,39089,947,12,18,331,1,1309,6.066.190.476
16/11/2015 04:00,21.7,40045,1285,11,16,320,2,1634,6.066.190.476
16/11/2015 05:00,23.23,42826,1573,10,15,367,2,1967,6.066.190.476
16/11/2015 06:00,24.52,47640,1973,10,15,474,2,2474,6.066.190.476
16/11/2015 07:00,25.62,52016,2263,9,15,612,2,2901,6.066.190.476
16/11/2015 08:00,25.98,52543,2476,8,14,795,2,3295,6.066.190.476
16/11/2015 09:00,25.19,52408,2703,8,15,1044,4,3774,6.066.190.476
16/11/2015 10:00,25.28,52300,2861,7,15,1263,3,4149,6.066.190.476
16/11/2015 11:00,24.93,52069,2990,8,16,1435,4,4453,6.066.190.476
16/11/2015 12:00,24.77,51648,3175,8,18,1619,5,4825,6.066.190.476
16/11/2015 13:00,24.45,51352,3253,10,22,1796,4,5085,6.066.190.476
16/11/2015 14:00,24.39,51682,3178,16,29,1983,5,5211,6.066.190.476
16/11/2015 15:00,24.76,52385,3074,24,38,2238,5,5379,6.066.190.476
16/11/2015 16:00,25.21,53422,2942,34,41,2362,5,5384,6.066.190.476
16/11/2015 17:00,25.66,53970,2780,40,51,2660,6,5537,6.066.190.476
16/11/2015 18:00,25.13,53044,2640,49,65,2760,7,5521,6.066.190.476
16/11/2015 19:00,24.2,51800,2579,53,82,2828,10,5552,6.066.190.476
16/11/2015 20:00,23.67,49720,2562,65,97,3026,15,5765,6.066.190.476
16/11/2015 21:00,23.43,48078,2518,77,109,2858,20,5582,6.066.190.476
16/11/2015 22:00,22.74,45510,2448,91,121,2782,24,5466,6.066.190.476
16/11/2015 23:00,21.35,42757,2408,106,120,2712,28,5374,6.066.190.476
17/11/2015 00:00,21.89,40657,1693,127,116,2496,39,4471,6.066.190.476
17/11/2015 01:00,21.52,39797,1584,139,112,2486,37,4358,6.066.190.476
17/11/2015 02:00,21.4,39434,1511,151,105,2466,29,4262,6.066.190.476
17/11/2015 03:00,21.37,39565,1480,161,97,2412,22,4172,6.066.190.476
17/11/2015 04:00,22.43,40418,1449,165,85,2309,18,4026,6.066.190.476
17/11/2015 05:00,23.17,42986,1481,162,79,2277,12,4011,6.066.190.476
17/11/2015 06:00,24.52,47493,1567,150,74,2226,11,4028,6.066.190.476
17/11/2015 07:00,26.69,51621,1640,135,69,2111,6,3961,6.066.190.476
17/11/2015 08:00,27.84,52192,1733,113,39,2037,5,3927,6.066.190.476
17/11/2015 09:00,26.07,52472,1869,97,28,1900,7,3901,6.066.190.476
17/11/2015 10:00,26.35,52161,1955,84,24,1854,6,3923,6.066.190.476
17/11/2015 11:00,25.88,51495,2050,74,21,1795,7,3947,6.066.190.476
17/11/2015 12:00,25.49,51048,2170,68,20,1745,8,4011,6.066.190.476
17/11/2015 13:00,25.39,51033,2181,62,18,1772,10,4043,6.066.190.476
17/11/2015 14:00,25.34,51138,2069,58,18,1755,7,3907,6.066.190.476
17/11/2015 15:00,25.99,51852,1924,54,18,1729,6,3731,6.066.190.476
17/11/2015 16:00,27.02,52884,1779,55,18,1709,5,3566,6.066.190.476
17/11/2015 17:00,28.47,53388,1615,56,18,1716,6,3411,6.066.190.476
17/11/2015 18:00,27.83,52544,1412,58,20,1706,5,3201,6.066.190.476
17/11/2015 19:00,25.53,51397,1171,60,22,1736,4,2993,6.066.190.476
17/11/2015 20:00,24.49,49589,937,65,23,1687,7,2719,6.066.190.476
17/11/2015 21:00,24.31,48058,849,66,24,1571,7,2517,6.066.190.476
17/11/2015 22:00,23.29,45605,826,64,30,1442,7,2369,6.066.190.476
17/11/2015 23:00,21.88,42935,760,62,35,1294,7,2158,6.066.190.476
18/11/2015 00:00,21.76,40846,1518,36,65,1110,11,2740,6.066.190.476
18/11/2015 01:00,21.38,39895,1609,37,69,998,13,2726,6.066.190.476
18/11/2015 02:00,21.21,39538,1650,38,71,897,14,2670,6.066.190.476
18/11/2015 03:00,21.45,39700,1747,45,73,842,11,2718,6.066.190.476
18/11/2015 04:00,21.97,40558,1752,51,76,815,8,2702,6.066.190.476
18/11/2015 05:00,22.8,43017,1776,52,80,788,7,2703,6.066.190.476
18/11/2015 06:00,24.37,47410,1956,54,83,785,6,2884,6.066.190.476
18/11/2015 07:00,26.01,51557,2191,52,83,765,5,3096,6.066.190.476
18/11/2015 08:00,27.18,52992,2335,44,81,802,6,3268,6.066.190.476
18/11/2015 09:00,25.5,52394,2535,41,80,872,10,3538,6.066.190.476
18/11/2015 10:00,25.58,52125,2746,35,80,960,11,3832,6.066.190.476
18/11/2015 11:00,25.69,51592,2885,29,89,1028,9,4040,6.066.190.476
18/11/2015 12:00,24.96,51211,3049,25,98,1188,8,4368,6.066.190.476
18/11/2015 13:00,24.98,51043,3107,19,105,1316,7,4554,6.066.190.476
18/11/2015 14:00,25.09,51269,3018,20,107,1429,10,4584,6.066.190.476
18/11/2015 15:00,25.63,52101,2892,19,103,1547,11,4572,6.066.190.476
18/11/2015 16:00,26.07,53127,2670,20,103,1637,24,4454,6.066.190.476
18/11/2015 17:00,27.09,53742,2400,24,120,1627,25,4196,6.066.190.476
18/11/2015 18:00,26.59,52944,2180,24,140,1575,25,3944,6.066.190.476
18/11/2015 19:00,25.14,51836,2151,29,158,1492,27,3857,6.066.190.476
18/11/2015 20:00,24.7,49980,2385,37,155,1372,29,3978,6.066.190.476
18/11/2015 21:00,24.02,48354,2718,46,146,1281,29,4220,6.066.190.476
18/11/2015 22:00,22.91,45940,2814,47,135,1233,25,4254,6.066.190.476
18/11/2015 23:00,21.97,43168,2774,45,124,1246,19,4208,6.066.190.476
19/11/2015 00:00,21.48,41539,3495,42,116,1301,8,4962,6.066.190.476
19/11/2015 01:00,21.06,40543,3557,36,120,1352,9,5074,6.066.190.476
19/11/2015 02:00,20.99,40135,3442,35,120,1486,9,5092,6.066.190.476
19/11/2015 03:00,21.25,40235,3290,34,125,1537,11,4997,6.066.190.476
19/11/2015 04:00,21.91,41120,3090,30,132,1582,11,4845,6.066.190.476
19/11/2015 05:00,22.77,43717,2914,27,136,1649,10,4736,6.066.190.476
19/11/2015 06:00,24.8,48271,2796,21,148,1674,12,4651,6.066.190.476
19/11/2015 07:00,26.49,52511,2731,19,164,1697,16,4627,6.066.190.476
19/11/2015 08:00,27.05,52994,2712,18,181,1712,16,4639,6.066.190.476
19/11/2015 09:00,25.8,52705,2733,18,193,1716,22,4682,6.066.190.476
19/11/2015 10:00,25.36,52733,2789,17,197,1642,18,4663,6.066.190.476
19/11/2015 11:00,25.38,52521,2879,18,189,1509,29,4624,6.066.190.476
19/11/2015 12:00,25.2,52263,2979,17,180,1399,39,4614,6.066.190.476
19/11/2015 13:00,25.41,52240,2981,17,182,1373,44,4597,6.066.190.476
19/11/2015 14:00,26.01,52436,2889,18,178,1348,42,4475,6.066.190.476
19/11/2015 15:00,26.72,53216,2754,22,167,1314,37,4294,6.066.190.476
19/11/2015 16:00,27.83,54325,2616,23,159,1453,34,4285,6.066.190.476
19/11/2015 17:00,28.62,54838,2499,25,156,1460,28,4168,6.066.190.476
19/11/2015 18:00,27.92,54137,2398,29,147,1413,20,4007,6.066.190.476
19/11/2015 19:00,26.13,53027,2322,34,146,1359,14,3875,6.066.190.476
19/11/2015 20:00,25.34,51255,2201,36,144,1305,13,3699,6.066.190.476
19/11/2015 21:00,25.02,49659,1959,37,143,1239,10,3388,6.066.190.476
19/11/2015 22:00,24.3,47207,1719,33,138,1196,8,3094,6.066.190.476
19/11/2015 23:00,23.08,44459,1567,29,132,1168,5,2901,6.066.190.476
20/11/2015 00:00,23.51,42909,1164,34,131,1334,2,2665,6.066.190.476
20/11/2015 01:00,23.51,42013,1146,33,127,1293,2,2601,6.066.190.476
20/11/2015 02:00,22.66,41632,1120,33,125,1181,1,2460,6.066.190.476
20/11/2015 03:00,23.03,41718,1078,33,123,1135,1,2370,6.066.190.476
20/11/2015 04:00,23.81,42583,1018,32,116,1085,2,2253,6.066.190.476
20/11/2015 05:00,25.01,45157,976,31,112,1024,3,2146,6.066.190.476
20/11/2015 06:00,26.35,49690,950,30,104,948,5,2037,6.066.190.476
20/11/2015 07:00,30.11,53983,872,30,96,894,7,1899,6.066.190.476
20/11/2015 08:00,32.32,55649,786,29,86,882,8,1791,6.066.190.476
20/11/2015 09:00,30.13,55284,768,29,77,855,11,1740,6.066.190.476
20/11/2015 10:00,32.06,55042,719,29,68,832,16,1664,6.066.190.476
20/11/2015 11:00,31.18,54466,650,29,64,795,19,1557,6.066.190.476
20/11/2015 12:00,29.73,53865,611,31,60,838,21,1561,6.066.190.476
20/11/2015 13:00,28.5,53277,559,34,57,851,20,1521,6.066.190.476
20/11/2015 14:00,27.92,53273,507,38,46,892,19,1502,6.066.190.476
20/11/2015 15:00,28.71,53987,499,43,36,964,15,1557,6.066.190.476
20/11/2015 16:00,31.12,55030,537,47,31,1049,13,1677,6.066.190.476
20/11/2015 17:00,34.41,55585,593,49,28,1140,11,1821,6.066.190.476
20/11/2015 18:00,30.09,54899,635,53,27,1250,10,1975,6.066.190.476
20/11/2015 19:00,26.78,53358,650,52,25,1318,9,2054,6.066.190.476
20/11/2015 20:00,25.41,51352,655,53,21,1455,9,2193,6.066.190.476
20/11/2015 21:00,25.03,49950,696,56,19,1535,10,2316,6.066.190.476
20/11/2015 22:00,24.6,48112,758,57,18,1625,11,2469,6.066.190.476
20/11/2015 23:00,24.13,46030,846,63,19,1715,9,2652,6.066.190.476
21/11/2015 00:00,24.33,44453,948,112,8,1819,2,2889,6.066.190.476
21/11/2015 01:00,23.97,43445,1000,114,8,1896,3,3021,6.066.190.476
21/11/2015 02:00,23.04,42796,1033,115,9,1962,3,3122,6.066.190.476
21/11/2015 03:00,22.38,42656,1071,119,11,2028,6,3235,6.066.190.476
21/11/2015 04:00,22.25,42959,1136,119,12,2097,4,3368,6.066.190.476
21/11/2015 05:00,22.61,43760,1212,115,12,2129,3,3471,6.066.190.476
21/11/2015 06:00,23.18,45199,1273,109,11,2144,5,3542,6.066.190.476
21/11/2015 07:00,24.54,47092,1304,112,11,2206,4,3637,6.066.190.476
21/11/2015 08:00,24.96,48488,1288,115,10,2181,3,3597,6.066.190.476
21/11/2015 09:00,25.2,50239,1260,125,11,2131,2,3529,6.066.190.476
21/11/2015 10:00,25.37,51211,1222,136,11,2156,6,3531,6.066.190.476
21/11/2015 11:00,25.37,51223,1187,139,12,2124,6,3468,6.066.190.476
21/11/2015 12:00,25.3,50796,1156,142,13,2070,6,3387,6.066.190.476
21/11/2015 13:00,25.18,50470,1112,144,13,2057,6,3332,6.066.190.476
21/11/2015 14:00,25.24,50792,1037,145,13,2142,3,3340,6.066.190.476
21/11/2015 15:00,26.03,52167,973,142,12,2243,1,3371,6.066.190.476
21/11/2015 16:00,27.38,53868,970,141,12,2302,1,3426,6.066.190.476
21/11/2015 17:00,28.13,54755,995,139,13,2370,1,3518,6.066.190.476
21/11/2015 18:00,27.34,54037,1027,136,15,2376,1,3555,6.066.190.476
21/11/2015 19:00,25.94,52584,1064,132,18,2468,4,3686,6.066.190.476
21/11/2015 20:00,25.45,50788,1106,130,21,2475,4,3736,6.066.190.476
21/11/2015 21:00,25.27,49680,1148,130,23,2481,2,3784,6.066.190.476
21/11/2015 22:00,24.92,48189,1200,130,26,2505,1,3862,6.066.190.476
21/11/2015 23:00,24.34,46533,1276,130,26,2586,1,4019,6.066.190.476
22/11/2015 00:00,24.46,45376,1377,192,15,2824,1,4409,6.066.190.476
22/11/2015 01:00,23.93,44378,1592,186,17,2900,1,4696,6.066.190.476
22/11/2015 02:00,23.87,43670,1820,177,20,2942,1,4960,6.066.190.476
22/11/2015 03:00,22.7,43400,2092,168,22,2968,3,5253,6.066.190.476
22/11/2015 04:00,22.35,43575,2326,160,26,2969,1,5482,6.066.190.476
22/11/2015 05:00,22.59,44178,2506,150,30,2967,2,5655,6.066.190.476
22/11/2015 06:00,22.67,45006,2667,138,34,2924,3,5766,6.066.190.476
22/11/2015 07:00,22.87,46264,2852,125,40,2932,3,5952,6.066.190.476
22/11/2015 08:00,23.15,47202,3014,110,45,2908,2,6079,6.066.190.476
22/11/2015 09:00,24.02,48888,3140,96,46,2813,2,6097,6.066.190.476
22/11/2015 10:00,24.77,50253,3207,80,44,2693,4,6028,6.066.190.476
22/11/2015 11:00,24.89,50750,3206,67,41,2548,4,5866,6.066.190.476
22/11/2015 12:00,24.79,50599,3202,56,40,2395,4,5697,6.066.190.476
22/11/2015 13:00,24.07,50545,3159,48,37,2336,6,5586,6.066.190.476
22/11/2015 14:00,23.87,50970,3040,39,37,2230,6,5352,6.066.190.476
22/11/2015 15:00,24.5,52266,2908,33,37,2117,4,5099,6.066.190.476
22/11/2015 16:00,25.77,53917,2802,29,38,2052,4,4925,6.066.190.476
22/11/2015 17:00,26.96,55002,2709,27,37,1971,4,4748,6.066.190.476
22/11/2015 18:00,26.43,54762,2620,27,36,1812,4,4499,6.066.190.476
22/11/2015 19:00,25.9,54029,2503,28,35,1724,6,4296,6.066.190.476
22/11/2015 20:00,25.39,52735,2376,27,33,1570,6,4012,6.066.190.476
22/11/2015 21:00,25.18,51857,2242,26,29,1464,5,3766,6.066.190.476
22/11/2015 22:00,24.93,50035,1990,26,24,1393,4,3437,6.066.190.476
22/11/2015 23:00,24.57,48079,1723,27,21,1319,4,3094,6.066.190.476
23/11/2015 00:00,23.99,46978,1093,20,21,1139,1,2274,5.950.714.286
23/11/2015 01:00,24.49,46183,956,20,17,1112,1,2106,5.950.714.286
23/11/2015 02:00,24.66,45899,853,21,14,1021,2,1911,5.950.714.286
23/11/2015 03:00,24.9,46161,755,21,13,988,1,1778,5.950.714.286
23/11/2015 04:00,25.36,47212,647,20,12,950,2,1631,5.950.714.286
23/11/2015 05:00,26.84,50239,546,18,11,885,2,1462,5.950.714.286
23/11/2015 06:00,30.19,55383,472,16,9,838,2,1337,5.950.714.286
23/11/2015 07:00,52.33,59870,409,13,9,825,2,1258,5.950.714.286
23/11/2015 08:00,69.92,61803,362,11,8,726,11,1118,5.950.714.286
23/11/2015 09:00,55.09,60904,352,10,8,633,3,1006,5.950.714.286
23/11/2015 10:00,60.05,60245,356,10,8,587,3,964,5.950.714.286
23/11/2015 11:00,54.8,59123,349,9,8,556,3,925,5.950.714.286
23/11/2015 12:00,43.98,58575,359,10,9,565,3,946,5.950.714.286
23/11/2015 13:00,38.91,58334,391,11,10,613,2,1027,5.950.714.286
23/11/2015 14:00,46.65,58629,431,13,10,710,3,1167,5.950.714.286
23/11/2015 15:00,59.96,59553,514,15,11,831,3,1374,5.950.714.286
23/11/2015 16:00,69.91,60815,602,18,12,993,12,1637,5.950.714.286
23/11/2015 17:00,69.94,61239,683,24,13,1171,11,1902,5.950.714.286
23/11/2015 18:00,53.14,60304,806,30,15,1326,1,2178,5.950.714.286
23/11/2015 19:00,29.38,59099,959,32,16,1502,3,2512,5.950.714.286
23/11/2015 20:00,27.64,57008,1157,31,18,1736,3,2945,5.950.714.286
23/11/2015 21:00,25.93,55442,1372,29,19,1918,3,3341,5.950.714.286
23/11/2015 22:00,25.01,52781,1597,30,20,2121,4,3772,5.950.714.286
23/11/2015 23:00,24.34,49888,1828,33,20,2335,1,4217,5.950.714.286
24/11/2015 00:00,23.93,46629,2198,47,10,2625,4,4884,5.950.714.286
24/11/2015 01:00,23.56,45594,2379,53,12,2785,3,5232,5.950.714.286
24/11/2015 02:00,23.24,45119,2549,52,15,2910,3,5529,5.950.714.286
24/11/2015 03:00,23.25,45132,2703,50,19,2996,3,5771,5.950.714.286
24/11/2015 04:00,23.68,45938,2823,51,23,3089,5,5991,5.950.714.286
24/11/2015 05:00,24.54,48475,2904,58,26,3168,5,6161,5.950.714.286
24/11/2015 06:00,25.21,53088,3017,62,29,3190,4,6302,5.950.714.286
24/11/2015 07:00,27.12,57365,3145,67,35,3192,6,6445,5.950.714.286
24/11/2015 08:00,27.76,58523,3266,67,43,3194,6,6576,5.950.714.286
24/11/2015 09:00,27.15,57822,3382,70,54,3214,8,6728,5.950.714.286
24/11/2015 10:00,27.44,57570,3482,79,66,3191,11,6829,5.950.714.286
24/11/2015 11:00,26.7,57030,3549,88,75,3174,16,6902,5.950.714.286
24/11/2015 12:00,26.34,56553,3587,95,86,3154,20,6942,5.950.714.286
24/11/2015 13:00,26.2,56426,3571,103,95,3140,20,6929,5.950.714.286
24/11/2015 14:00,26.28,56553,3479,111,98,3129,22,6839,5.950.714.286
24/11/2015 15:00,26.89,57277,3326,120,99,3123,23,6691,5.950.714.286
24/11/2015 16:00,27.87,58192,3117,133,102,3119,28,6499,5.950.714.286
24/11/2015 17:00,28.52,58547,2866,146,104,3087,30,6233,5.950.714.286
24/11/2015 18:00,27.72,57469,2592,157,108,3048,33,5938,5.950.714.286
24/11/2015 19:00,25.94,56171,2373,160,112,3044,32,5721,5.950.714.286
24/11/2015 20:00,25.19,54213,2194,162,116,3029,30,5531,5.950.714.286
24/11/2015 21:00,24.85,52437,2025,162,117,2979,28,5311,5.950.714.286
24/11/2015 22:00,24.25,49756,1857,161,118,2966,21,5123,5.950.714.286
24/11/2015 23:00,23.65,46804,1709,162,116,2954,21,4962,5.950.714.286
25/11/2015 00:00,23.72,43727,1758,159,110,2803,24,4854,5.950.714.286
25/11/2015 01:00,23.2,42527,1620,165,106,2723,29,4643,5.950.714.286
25/11/2015 02:00,23.14,42136,1493,172,106,2607,29,4407,5.950.714.286
25/11/2015 03:00,23.54,42243,1363,177,104,2489,29,4162,5.950.714.286
25/11/2015 04:00,24.22,43075,1238,180,105,2349,29,3901,5.950.714.286
25/11/2015 05:00,25.26,45584,1108,182,107,2243,33,3673,5.950.714.286
25/11/2015 06:00,26.39,50157,972,176,108,2138,33,3427,5.950.714.286
25/11/2015 07:00,34.05,54603,845,169,107,2042,32,3195,5.950.714.286
25/11/2015 08:00,35.95,56074,727,168,107,1968,31,3001,5.950.714.286
25/11/2015 09:00,33.28,55356,599,167,110,1810,32,2718,5.950.714.286
25/11/2015 10:00,34.46,55141,502,165,111,1696,34,2508,5.950.714.286
25/11/2015 11:00,34.41,54646,447,164,109,1579,33,2332,5.950.714.286
25/11/2015 12:00,34.17,54259,427,162,107,1441,31,2168,5.950.714.286
25/11/2015 13:00,33.99,54130,396,159,104,1364,28,2051,5.950.714.286
25/11/2015 14:00,35.02,54293,390,162,105,1239,26,1922,5.950.714.286
25/11/2015 15:00,35.38,55139,445,166,106,1165,24,1906,5.950.714.286
25/11/2015 16:00,45.09,56126,576,166,114,1111,23,1990,5.950.714.286
25/11/2015 17:00,51,56393,762,167,118,1079,22,2148,5.950.714.286
25/11/2015 18:00,36.64,55355,887,165,118,1047,22,2239,5.950.714.286
25/11/2015 19:00,28.6,54071,981,165,115,1056,24,2341,5.950.714.286
25/11/2015 20:00,26.96,52123,1048,166,109,1052,25,2400,5.950.714.286
25/11/2015 21:00,25.95,50333,1108,167,107,1163,26,2571,5.950.714.286
25/11/2015 22:00,25.18,47715,1148,168,103,1263,25,2707,5.950.714.286
25/11/2015 23:00,24.31,44673,1145,168,96,1361,21,2791,5.950.714.286
26/11/2015 00:00,23.43,43613,1099,165,92,1379,19,2754,5.950.714.286
26/11/2015 01:00,23.2,42461,1102,160,87,1421,17,2787,5.950.714.286
26/11/2015 02:00,23.08,42079,1114,156,83,1398,18,2769,5.950.714.286
26/11/2015 03:00,23.21,42192,1162,152,81,1400,17,2812,5.950.714.286
26/11/2015 04:00,23.56,43143,1146,149,78,1420,18,2811,5.950.714.286
26/11/2015 05:00,24.37,45845,1040,148,76,1458,19,2741,5.950.714.286
26/11/2015 06:00,26.02,50883,939,146,73,1512,19,2689,5.950.714.286
26/11/2015 07:00,34.47,55335,853,147,70,1494,20,2584,5.950.714.286
26/11/2015 08:00,34.44,56299,761,146,68,1508,19,2502,5.950.714.286
26/11/2015 09:00,31.27,55425,654,149,66,1526,20,2415,5.950.714.286
26/11/2015 10:00,35.93,55200,547,151,63,1557,21,2339,5.950.714.286
26/11/2015 11:00,34.5,55007,470,150,59,1503,21,2203,5.950.714.286
26/11/2015 12:00,29.25,54778,436,148,54,1502,21,2161,5.950.714.286
26/11/2015 13:00,28.73,54716,399,142,49,1449,20,2059,5.950.714.286
26/11/2015 14:00,29.27,55017,350,135,48,1607,22,2162,5.950.714.286
26/11/2015 15:00,32.39,55979,358,130,45,1800,20,2353,5.950.714.286
26/11/2015 16:00,33.97,56741,422,125,45,2085,18,2695,5.950.714.286
26/11/2015 17:00,34.5,57095,515,118,46,2391,13,3083,5.950.714.286
26/11/2015 18:00,29.38,56398,615,114,47,2707,9,3492,5.950.714.286
26/11/2015 19:00,26.68,55287,738,113,45,3022,10,3928,5.950.714.286
26/11/2015 20:00,25.25,53500,909,114,44,3298,9,4374,5.950.714.286
26/11/2015 21:00,24.53,51867,1144,116,45,3544,8,4857,5.950.714.286
26/11/2015 22:00,23.55,49319,1351,121,46,3775,8,5301,5.950.714.286
26/11/2015 23:00,22.81,46348,1514,127,46,3871,6,5564,5.950.714.286
27/11/2015 00:00,21.67,43318,1741,178,54,4047,15,6035,5.950.714.286
27/11/2015 01:00,20.91,42285,1915,189,59,4213,15,6391,5.950.714.286
27/11/2015 02:00,20.25,41798,2069,197,64,4237,16,6583,5.950.714.286
27/11/2015 03:00,20.38,41907,2208,205,70,4282,15,6780,5.950.714.286
27/11/2015 04:00,21.07,42705,2320,212,75,4297,19,6923,5.950.714.286
27/11/2015 05:00,22.16,45098,2416,221,80,4280,19,7016,5.950.714.286
27/11/2015 06:00,23.18,49531,2509,227,84,4256,17,7093,5.950.714.286
27/11/2015 07:00,24.34,53696,2594,231,87,4205,19,7136,5.950.714.286
27/11/2015 08:00,24.9,54167,2693,230,90,4159,19,7191,5.950.714.286
27/11/2015 09:00,24.36,53801,2796,231,91,4168,21,7307,5.950.714.286
27/11/2015 10:00,24.19,53649,2907,230,89,4175,26,7427,5.950.714.286
27/11/2015 11:00,23.87,53141,3020,229,89,4212,32,7582,5.950.714.286
27/11/2015 12:00,23.75,52398,3119,228,94,4235,36,7712,5.950.714.286
27/11/2015 13:00,23.61,51816,3184,228,98,4224,35,7769,5.950.714.286
27/11/2015 14:00,23.47,51704,3234,228,100,4250,35,7847,5.950.714.286
27/11/2015 15:00,23.6,52216,3299,231,101,4286,34,7951,5.950.714.286
27/11/2015 16:00,23.84,52911,3368,233,101,4293,32,8027,5.950.714.286
27/11/2015 17:00,23.83,53046,3438,237,101,4362,35,8173,5.950.714.286
27/11/2015 18:00,23.51,52053,3517,237,103,4433,36,8326,5.950.714.286
27/11/2015 19:00,23.08,50442,3588,237,106,4503,38,8472,5.950.714.286
27/11/2015 20:00,22.43,48262,3648,239,109,4533,39,8568,5.950.714.286
27/11/2015 21:00,22.1,46722,3691,240,112,4559,40,8642,5.950.714.286
27/11/2015 22:00,20.95,44817,3714,240,114,4563,38,8669,5.950.714.286
27/11/2015 23:00,19.73,42609,3748,239,116,4511,41,8655,5.950.714.286
28/11/2015 00:00,18.43,40624,3698,239,115,4560,42,8654,5.950.714.286
28/11/2015 01:00,17.28,39500,3605,239,113,4487,41,8485,5.950.714.286
28/11/2015 02:00,16.9,38896,3459,236,107,4376,42,8220,5.950.714.286
28/11/2015 03:00,16.93,38752,3538,234,107,4222,42,8143,5.950.714.286
28/11/2015 04:00,17.52,39053,3366,231,107,4036,42,7782,5.950.714.286
28/11/2015 05:00,18.76,39853,2963,228,107,3860,42,7200,5.950.714.286
28/11/2015 06:00,19.61,41230,2785,226,106,3711,44,6872,5.950.714.286
28/11/2015 07:00,20.67,43182,2610,224,104,3549,41,6528,5.950.714.286
28/11/2015 08:00,21.48,44727,2309,222,102,3302,39,5974,5.950.714.286
28/11/2015 09:00,21.85,46530,2192,219,100,3078,40,5629,5.950.714.286
28/11/2015 10:00,22.09,47537,2198,216,100,2840,42,5396,5.950.714.286
28/11/2015 11:00,22.14,47789,2171,212,101,2582,40,5106,5.950.714.286
28/11/2015 12:00,22.12,47568,2160,209,101,2445,39,4954,5.950.714.286
28/11/2015 13:00,22.09,47416,2140,206,100,2308,36,4790,5.950.714.286
28/11/2015 14:00,22.15,47761,2026,204,99,2249,35,4613,5.950.714.286
28/11/2015 15:00,22.42,49004,1913,203,100,2205,33,4454,5.950.714.286
28/11/2015 16:00,23.11,50522,1920,204,102,2210,31,4467,5.950.714.286
28/11/2015 17:00,23.36,51291,2045,204,95,2206,31,4581,5.950.714.286
28/11/2015 18:00,22.91,50589,2273,204,92,2191,30,4790,5.950.714.286
28/11/2015 19:00,22.26,49178,2616,205,90,2314,33,5258,5.950.714.286
28/11/2015 20:00,21.87,47530,3047,205,83,2502,29,5866,5.950.714.286
28/11/2015 21:00,21.02,46502,3492,203,77,2671,27,6470,5.950.714.286
28/11/2015 22:00,20.21,45020,3827,197,69,2868,20,6981,5.950.714.286
28/11/2015 23:00,19.21,43187,4055,186,58,3078,15,7392,5.950.714.286
29/11/2015 00:00,19.18,41545,3983,198,51,3284,18,7534,5.950.714.286
29/11/2015 01:00,17.95,40546,3841,191,45,3464,15,7556,5.950.714.286
29/11/2015 02:00,17.05,39953,3753,178,42,3699,9,7681,5.950.714.286
29/11/2015 03:00,16.61,39873,3720,152,36,3934,7,7849,5.950.714.286
29/11/2015 04:00,16.29,40057,4029,132,36,4173,5,8375,5.950.714.286
29/11/2015 05:00,16.89,40707,3998,115,39,4395,6,8553,5.950.714.286
29/11/2015 06:00,17.77,41581,3947,101,55,4510,8,8621,5.950.714.286
29/11/2015 07:00,18.39,42827,3866,95,65,4618,8,8652,5.950.714.286
29/11/2015 08:00,18.84,44321,3771,90,81,4674,8,8624,5.950.714.286
29/11/2015 09:00,19.62,45774,3683,89,103,4718,10,8603,5.950.714.286
29/11/2015 10:00,20.38,46891,3660,97,122,4675,15,8569,5.950.714.286
29/11/2015 11:00,20.76,47341,3662,111,128,4638,16,8555,5.950.714.286
29/11/2015 12:00,20.79,47078,3614,129,133,4585,22,8483,5.950.714.286
29/11/2015 13:00,20.39,47005,3468,147,144,4467,35,8261,5.950.714.286
29/11/2015 14:00,20.49,47578,3275,165,146,4343,43,7972,5.950.714.286
29/11/2015 15:00,21.1,48952,3112,180,141,4200,43,7676,5.950.714.286
29/11/2015 16:00,21.58,50541,3227,191,139,4066,45,7668,5.950.714.286
29/11/2015 17:00,21.84,51361,3623,199,137,3875,44,7878,5.950.714.286
29/11/2015 18:00,21.75,50975,3580,203,133,3607,44,7567,5.950.714.286
29/11/2015 19:00,21.38,50312,3388,200,133,3451,36,7208,5.950.714.286
29/11/2015 20:00,20.97,48981,3270,196,134,3377,24,7001,5.950.714.286
29/11/2015 21:00,20.76,47959,2940,189,134,3331,15,6609,5.950.714.286
29/11/2015 22:00,20.1,46063,2972,185,137,3206,11,6511,5.950.714.286
29/11/2015 23:00,19.29,43890,3432,183,148,3199,5,6967,5.950.714.286
30/11/2015 00:00,19.69,42451,4172,198,196,3281,39,7886,5.941.785.714
30/11/2015 01:00,18.22,41633,3840,198,207,3200,47,7492,5.941.785.714
30/11/2015 02:00,17.65,41406,3871,200,208,3179,50,7508,5.941.785.714
30/11/2015 03:00,18.96,41671,3880,201,199,3212,51,7543,5.941.785.714
30/11/2015 04:00,19.95,42757,3888,204,185,3220,52,7549,5.941.785.714
30/11/2015 05:00,21.24,45576,4216,207,178,3236,48,7885,5.941.785.714
30/11/2015 06:00,22.18,50324,4213,209,180,3228,51,7881,5.941.785.714
30/11/2015 07:00,23.88,54735,4265,211,183,3202,52,7913,5.941.785.714
30/11/2015 08:00,23.99,56501,4298,210,190,3188,47,7933,5.941.785.714
30/11/2015 09:00,23.75,55746,4290,206,199,3163,44,7902,5.941.785.714
30/11/2015 10:00,23.86,55123,4275,198,204,3213,48,7938,5.941.785.714
30/11/2015 11:00,23.65,54484,4243,187,211,3296,45,7982,5.941.785.714
30/11/2015 12:00,23.6,54309,4192,171,215,3249,40,7867,5.941.785.714
30/11/2015 13:00,23.68,54337,4042,168,214,3291,39,7754,5.941.785.714
30/11/2015 14:00,23.89,54660,3789,160,214,3392,39,7594,5.941.785.714
30/11/2015 15:00,24.63,55523,3450,160,214,3415,32,7271,5.941.785.714
30/11/2015 16:00,25.51,56670,3097,159,214,3442,28,6940,5.941.785.714
30/11/2015 17:00,27.35,56971,2761,162,211,3561,31,6726,5.941.785.714
30/11/2015 18:00,25.43,56413,2442,168,207,3544,38,6399,5.941.785.714
30/11/2015 19:00,24.08,55200,2186,167,208,3485,43,6089,5.941.785.714
30/11/2015 20:00,23.51,53371,2011,164,206,3410,42,5833,5.941.785.714
30/11/2015 21:00,23.34,51587,1906,156,197,3327,42,5628,5.941.785.714
30/11/2015 22:00,22.68,49086,1934,158,194,3311,41,5638,5.941.785.714
30/11/2015 23:00,20.8,46276,2089,146,193,3312,40,5780,5.941.785.714
01/12/2015 00:00,20.61,44286,3000,121,188,3536,35,6880,5.941.785.714
01/12/2015 01:00,19.49,43491,3257,118,177,3549,34,7135,5.941.785.714
01/12/2015 02:00,19.24,43158,3430,118,167,3703,33,7451,5.941.785.714
01/12/2015 03:00,19.4,43278,3540,120,164,3790,31,7645,5.941.785.714
01/12/2015 04:00,20.53,44194,3561,121,158,3888,29,7757,5.941.785.714
01/12/2015 05:00,22.02,46691,3546,122,151,3957,31,7807,5.941.785.714
01/12/2015 06:00,23.17,51468,3523,126,147,4040,34,7870,5.941.785.714
01/12/2015 07:00,24.27,55999,3474,134,146,4069,33,7856,5.941.785.714
01/12/2015 08:00,25.09,57625,3408,138,155,4047,35,7783,5.941.785.714
01/12/2015 09:00,24.95,56831,3312,145,165,4067,38,7727,5.941.785.714
01/12/2015 10:00,25.02,56277,3169,150,169,4087,40,7615,5.941.785.714
01/12/2015 11:00,25.07,55568,2960,153,177,4095,42,7427,5.941.785.714
01/12/2015 12:00,24.74,54939,2717,155,188,4086,43,7189,5.941.785.714
01/12/2015 13:00,24.86,54856,2416,156,190,4029,43,6834,5.941.785.714
01/12/2015 14:00,25.41,55180,2056,157,187,3946,44,6390,5.941.785.714
01/12/2015 15:00,26.35,56395,1726,161,182,3891,43,6003,5.941.785.714
01/12/2015 16:00,27.94,57300,1427,165,178,3779,41,5590,5.941.785.714
01/12/2015 17:00,28.64,57587,1170,171,178,3733,40,5292,5.941.785.714
01/12/2015 18:00,27.25,56720,931,175,176,3612,40,4934,5.941.785.714
01/12/2015 19:00,25.21,55655,766,177,172,3549,40,4704,5.941.785.714
01/12/2015 20:00,24.08,53893,644,178,166,3427,35,4450,5.941.785.714
01/12/2015 21:00,23.48,52188,604,179,159,3298,32,4272,5.941.785.714
01/12/2015 22:00,22.87,49710,617,180,147,3148,29,4121,5.941.785.714
01/12/2015 23:00,22.23,46954,640,183,141,2985,26,3975,5.941.785.714
02/12/2015 00:00,22.86,44955,611,185,142,2946,23,3907,5.941.785.714
02/12/2015 01:00,22.45,44022,700,188,136,2769,21,3814,5.941.785.714
02/12/2015 02:00,21.71,43606,836,188,132,2537,20,3713,5.941.785.714
02/12/2015 03:00,21.77,43675,1041,186,128,2352,21,3728,5.941.785.714
02/12/2015 04:00,22.96,44640,1224,184,122,2132,24,3686,5.941.785.714
02/12/2015 05:00,23.31,47192,1366,179,112,1907,22,3586,5.941.785.714
02/12/2015 06:00,24.38,51876,1624,172,97,1666,19,3578,5.941.785.714
02/12/2015 07:00,30,56229,1876,162,86,1546,17,3687,5.941.785.714
02/12/2015 08:00,35.32,56933,1977,148,75,1368,15,3583,5.941.785.714
02/12/2015 09:00,31.64,56348,2068,134,65,1219,15,3501,5.941.785.714
02/12/2015 10:00,28.55,55914,2238,121,58,1152,13,3582,5.941.785.714
02/12/2015 11:00,28.03,55620,2365,112,53,1216,12,3758,5.941.785.714
02/12/2015 12:00,26.1,55076,2427,98,48,1493,10,4076,5.941.785.714
02/12/2015 13:00,25.73,54806,2440,83,42,1715,5,4285,5.941.785.714
02/12/2015 14:00,25.59,55135,2464,64,37,2047,6,4618,5.941.785.714
02/12/2015 15:00,26.16,56175,2493,45,29,2554,6,5127,5.941.785.714
02/12/2015 16:00,26.15,56846,2516,34,24,2890,5,5469,5.941.785.714
02/12/2015 17:00,26.04,56873,2539,27,21,3124,4,5715,5.941.785.714
02/12/2015 18:00,25.32,55894,2544,23,19,3262,4,5852,5.941.785.714
02/12/2015 19:00,23.92,54662,2539,23,21,3435,6,6024,5.941.785.714
02/12/2015 20:00,23.26,52656,2550,26,27,3564,7,6174,5.941.785.714
02/12/2015 21:00,22.99,50784,2565,36,36,3621,10,6268,5.941.785.714
02/12/2015 22:00,22.17,48239,2489,50,47,3596,12,6194,5.941.785.714
02/12/2015 23:00,21.19,45269,2306,63,52,3662,14,6097,5.941.785.714
03/12/2015 00:00,20.72,43057,2368,87,53,3485,7,6000,5.941.785.714
03/12/2015 01:00,20.28,41984,2078,105,52,3454,10,5699,5.941.785.714
03/12/2015 02:00,20.22,41501,1734,123,50,3272,13,5192,5.941.785.714
03/12/2015 03:00,20.54,41599,1452,138,47,3079,9,4725,5.941.785.714
03/12/2015 04:00,21.43,42507,1205,144,46,2931,7,4333,5.941.785.714
03/12/2015 05:00,22.2,45076,991,143,48,2808,6,3996,5.941.785.714
03/12/2015 06:00,23.32,49904,829,139,51,2711,5,3735,5.941.785.714
03/12/2015 07:00,26.82,54323,722,136,54,2597,4,3513,5.941.785.714
03/12/2015 08:00,30.03,55341,668,134,57,2406,6,3271,5.941.785.714
03/12/2015 09:00,28.59,54630,648,133,60,2406,9,3256,5.941.785.714
03/12/2015 10:00,25.88,54530,670,123,62,2506,10,3371,5.941.785.714
03/12/2015 11:00,25.97,54430,743,116,63,2578,9,3509,5.941.785.714
03/12/2015 12:00,25.38,54217,879,109,63,2545,9,3605,5.941.785.714
03/12/2015 13:00,25.25,54189,1038,103,63,2520,9,3733,5.941.785.714
03/12/2015 14:00,25.39,54516,1217,96,62,2475,10,3860,5.941.785.714
03/12/2015 15:00,27.07,55552,1497,90,62,2484,11,4144,5.941.785.714
03/12/2015 16:00,29.57,56233,1738,86,65,2438,9,4336,5.941.785.714
03/12/2015 17:00,32.08,56300,1907,81,67,2455,10,4520,5.941.785.714
03/12/2015 18:00,25.94,55504,2096,81,70,2460,12,4719,5.941.785.714
03/12/2015 19:00,24.4,54326,2283,82,74,2519,17,4975,5.941.785.714
03/12/2015 20:00,23.08,52469,2441,81,80,2518,23,5143,5.941.785.714
03/12/2015 21:00,22.81,50875,2625,81,86,2507,22,5321,5.941.785.714
03/12/2015 22:00,22.18,48377,2766,77,89,2567,16,5515,5.941.785.714
03/12/2015 23:00,21.2,45484,2862,76,89,2667,14,5708,5.941.785.714
04/12/2015 00:00,19.49,43239,3145,35,69,2953,4,6206,5.941.785.714
04/12/2015 01:00,18.69,42185,3340,37,74,3188,4,6643,5.941.785.714
04/12/2015 02:00,17.93,41753,3568,39,79,3320,7,7013,5.941.785.714
04/12/2015 03:00,17.36,41882,3787,43,85,3442,9,7366,5.941.785.714
04/12/2015 04:00,17.9,42840,3942,49,92,3474,17,7574,5.941.785.714
04/12/2015 05:00,19.5,45383,4040,66,105,3651,24,7886,5.941.785.714
04/12/2015 06:00,21.17,49876,4164,90,119,3729,29,8131,5.941.785.714
04/12/2015 07:00,22.01,54239,4177,108,136,3750,34,8205,5.941.785.714
04/12/2015 08:00,22.44,55177,4114,118,156,3684,38,8110,5.941.785.714
04/12/2015 09:00,22.25,55449,4059,135,178,3612,44,8028,5.941.785.714
04/12/2015 10:00,21.95,55178,4045,150,198,3610,48,8051,5.941.785.714
04/12/2015 11:00,21.99,54505,4069,180,208,3439,51,7947,5.941.785.714
04/12/2015 12:00,21.9,53884,4176,205,212,3542,53,8188,5.941.785.714
04/12/2015 13:00,21.82,53410,4228,216,214,3586,52,8296,5.941.785.714
04/12/2015 14:00,21.84,53503,4175,226,214,3569,54,8238,5.941.785.714
04/12/2015 15:00,21.91,54189,4077,239,217,3702,56,8291,5.941.785.714
04/12/2015 16:00,21.99,55049,3912,240,217,3919,56,8344,5.941.785.714
04/12/2015 17:00,22,55340,3686,243,214,4059,56,8258,5.941.785.714
04/12/2015 18:00,21.92,54496,3472,246,210,4140,56,8124,5.941.785.714
04/12/2015 19:00,21.45,52915,3335,232,207,4222,58,8054,5.941.785.714
04/12/2015 20:00,20.8,50814,3299,227,204,4243,58,8031,5.941.785.714
04/12/2015 21:00,20.45,49297,3350,222,202,4275,58,8107,5.941.785.714
04/12/2015 22:00,19.71,47482,3541,215,203,4097,55,8111,5.941.785.714
04/12/2015 23:00,18.58,45222,3781,215,199,3885,54,8134,5.941.785.714
05/12/2015 00:00,17.06,42302,4199,216,218,3806,16,8455,5.941.785.714
05/12/2015 01:00,16.04,41337,4278,219,217,3621,13,8348,5.941.785.714
05/12/2015 02:00,14.8,40614,4320,220,217,3731,10,8498,5.941.785.714
05/12/2015 03:00,14.43,40414,4345,225,215,3863,19,8667,5.941.785.714
05/12/2015 04:00,14.55,40564,4357,228,209,4190,21,9005,5.941.785.714
05/12/2015 05:00,15.31,41193,4366,225,203,4366,31,9191,5.941.785.714
05/12/2015 06:00,16.05,42349,4374,209,202,4553,38,9376,5.941.785.714
05/12/2015 07:00,16.01,44414,4374,188,202,4862,38,9664,5.941.785.714
05/12/2015 08:00,15.95,45851,4372,167,203,4972,31,9745,5.941.785.714
05/12/2015 09:00,15.96,47510,4358,158,207,5127,30,9880,5.941.785.714
05/12/2015 10:00,16.38,48473,4344,161,211,5162,29,9907,5.941.785.714
05/12/2015 11:00,16.47,48591,4296,169,215,5179,30,9889,5.941.785.714
05/12/2015 12:00,16.29,48293,4261,180,219,5160,29,9849,5.941.785.714
05/12/2015 13:00,16.04,48149,4232,192,220,5156,30,9830,5.941.785.714
05/12/2015 14:00,16.03,48369,4221,203,221,5099,25,9769,5.941.785.714
05/12/2015 15:00,16.61,49458,4210,215,222,5015,21,9683,5.941.785.714
05/12/2015 16:00,17.68,50601,4203,226,223,4967,17,9636,5.941.785.714
05/12/2015 17:00,18.03,50773,4202,238,223,4953,15,9631,5.941.785.714
05/12/2015 18:00,17.27,49699,4195,244,223,4949,18,9629,5.941.785.714
05/12/2015 19:00,16.64,48132,4157,248,222,4843,21,9491,5.941.785.714
05/12/2015 20:00,16.5,46481,4101,250,222,4819,23,9415,5.941.785.714
05/12/2015 21:00,15.81,45600,4047,250,222,4854,21,9394,5.941.785.714
05/12/2015 22:00,15.1,44371,4026,249,222,4900,21,9418,5.941.785.714
05/12/2015 23:00,14.47,42786,4037,247,222,4917,17,9440,5.941.785.714
06/12/2015 00:00,10.47,40860,4168,241,216,4928,49,9602,5.941.785.714
06/12/2015 01:00,8.05,39847,4195,239,214,4917,50,9615,5.941.785.714
06/12/2015 02:00,5.53,39288,4209,236,213,4879,51,9588,5.941.785.714
06/12/2015 03:00,4.62,39153,4219,234,211,4865,52,9581,5.941.785.714
06/12/2015 04:00,4.93,39345,4235,233,209,4937,53,9667,5.941.785.714
06/12/2015 05:00,7.28,39900,4250,232,209,4877,52,9620,5.941.785.714
06/12/2015 06:00,6.52,40717,4262,231,210,4848,52,9603,5.941.785.714
06/12/2015 07:00,11.5,42006,4284,231,210,4829,52,9606,5.941.785.714
06/12/2015 08:00,13.22,43266,4294,230,210,4829,51,9614,5.941.785.714
06/12/2015 09:00,13.41,44776,4308,229,211,4799,52,9599,5.941.785.714
06/12/2015 10:00,14.02,45955,4289,226,211,4826,54,9606,5.941.785.714
06/12/2015 11:00,14.44,46616,4233,222,211,4855,53,9574,5.941.785.714
06/12/2015 12:00,14.25,46643,4130,216,210,4793,53,9402,5.941.785.714
06/12/2015 13:00,14.42,46721,4253,214,209,4782,53,9511,5.941.785.714
06/12/2015 14:00,15.03,47392,4367,214,209,4789,53,9632,5.941.785.714
06/12/2015 15:00,17.26,48683,4312,214,210,4908,51,9695,5.941.785.714
06/12/2015 16:00,17.99,49885,4227,214,210,4890,52,9593,5.941.785.714
06/12/2015 17:00,18.36,50327,4156,214,211,4916,53,9550,5.941.785.714
06/12/2015 18:00,17.94,49904,4069,214,211,4969,54,9517,5.941.785.714
06/12/2015 19:00,17.38,49270,3985,214,212,5100,57,9568,5.941.785.714
06/12/2015 20:00,16.32,48285,3914,218,212,5077,58,9479,5.941.785.714
06/12/2015 21:00,15.84,47483,3856,217,212,5046,56,9387,5.941.785.714
06/12/2015 22:00,14.64,45787,3813,211,213,5048,56,9341,5.941.785.714
06/12/2015 23:00,13.25,43502,3769,210,213,5028,55,9275,5.941.785.714
07/12/2015 00:00,15.2,41776,3551,194,214,4975,55,8989,5.881.607.143
07/12/2015 01:00,14.31,40888,3420,201,215,5024,51,8911,5.881.607.143
07/12/2015 02:00,14.18,40577,3251,202,215,5093,52,8813,5.881.607.143
07/12/2015 03:00,14.34,40844,3029,198,215,5133,51,8626,5.881.607.143
07/12/2015 04:00,15.18,41869,2645,198,215,5135,52,8245,5.881.607.143
07/12/2015 05:00,16.99,44547,2122,197,215,5069,55,7658,5.881.607.143
07/12/2015 06:00,19.94,49337,1646,196,216,4963,55,7076,5.881.607.143
07/12/2015 07:00,21.96,53837,1311,202,216,4780,54,6563,5.881.607.143
07/12/2015 08:00,22.4,54940,1107,205,215,4492,53,6072,5.881.607.143
07/12/2015 09:00,22.29,54449,951,208,213,4283,52,5707,5.881.607.143
07/12/2015 10:00,22.32,54350,802,212,208,4057,51,5330,5.881.607.143
07/12/2015 11:00,22.5,53983,653,218,204,3821,48,4944,5.881.607.143
07/12/2015 12:00,22.59,53660,518,220,195,3537,46,4516,5.881.607.143
07/12/2015 13:00,22.88,53621,369,218,181,3319,43,4130,5.881.607.143
07/12/2015 14:00,23.86,53984,258,217,164,3133,39,3811,5.881.607.143
07/12/2015 15:00,26.15,54938,205,217,144,2964,33,3563,5.881.607.143
07/12/2015 16:00,27.91,55824,230,217,124,2821,28,3420,5.881.607.143
07/12/2015 17:00,28.55,56074,309,216,114,2686,18,3343,5.881.607.143
07/12/2015 18:00,26.6,55260,426,214,97,2545,11,3293,5.881.607.143
07/12/2015 19:00,23.39,54230,555,208,81,2493,10,3347,5.881.607.143
07/12/2015 20:00,22.23,52475,643,203,72,2415,9,3342,5.881.607.143
07/12/2015 21:00,21.69,51036,713,200,64,2342,9,3328,5.881.607.143
07/12/2015 22:00,20.43,48533,792,196,55,2312,9,3364,5.881.607.143
07/12/2015 23:00,19.51,45617,925,189,44,2333,6,3497,5.881.607.143
08/12/2015 00:00,19.55,43090,1128,166,37,2298,6,3635,5.881.607.143
08/12/2015 01:00,19.2,42169,1244,158,32,2257,4,3695,5.881.607.143
08/12/2015 02:00,19.07,41726,1324,154,26,2230,4,3738,5.881.607.143
08/12/2015 03:00,19.08,41849,1381,151,18,2230,4,3784,5.881.607.143
08/12/2015 04:00,19.4,42740,1444,148,13,2125,5,3735,5.881.607.143
08/12/2015 05:00,19.95,45329,1526,143,9,1993,4,3675,5.881.607.143
08/12/2015 06:00,21.94,50091,1599,135,8,1883,4,3629,5.881.607.143
08/12/2015 07:00,24.84,54389,1676,124,7,1837,4,3648,5.881.607.143
08/12/2015 08:00,25.93,55154,1778,113,5,1839,3,3738,5.881.607.143
08/12/2015 09:00,24.55,55695,1908,102,5,1837,4,3856,5.881.607.143
08/12/2015 10:00,23.4,55192,2013,91,6,1956,4,4070,5.881.607.143
08/12/2015 11:00,23.5,54558,2085,79,7,2000,4,4175,5.881.607.143
08/12/2015 12:00,22.93,53735,2131,66,10,2049,4,4260,5.881.607.143
08/12/2015 13:00,22.85,53759,2165,55,12,2149,3,4384,5.881.607.143
08/12/2015 14:00,22.87,54163,2195,48,16,2255,5,4519,5.881.607.143
08/12/2015 15:00,23.55,55076,2235,47,21,2394,6,4703,5.881.607.143
08/12/2015 16:00,23.92,55862,2307,52,27,2656,7,5049,5.881.607.143
08/12/2015 17:00,23.58,56056,2377,62,32,2805,6,5282,5.881.607.143
08/12/2015 18:00,22.88,55073,2429,73,38,2910,7,5457,5.881.607.143
08/12/2015 19:00,22.03,53803,2431,83,45,3030,9,5598,5.881.607.143
08/12/2015 20:00,20.94,51795,2362,94,51,3082,12,5601,5.881.607.143
08/12/2015 21:00,20.49,49977,2270,107,58,3142,13,5590,5.881.607.143
08/12/2015 22:00,19.67,47328,2149,119,63,3165,11,5507,5.881.607.143
08/12/2015 23:00,18.5,44434,1980,129,67,3149,11,5336,5.881.607.143
09/12/2015 00:00,17.33,41802,2220,147,78,3235,13,5693,5.881.607.143
09/12/2015 01:00,16.18,40778,2081,154,83,3192,15,5525,5.881.607.143
09/12/2015 02:00,15.86,40346,1905,157,90,3144,18,5314,5.881.607.143
09/12/2015 03:00,15.86,40432,1775,162,96,3117,18,5168,5.881.607.143
09/12/2015 04:00,17.15,41313,1770,167,102,3058,20,5117,5.881.607.143
09/12/2015 05:00,18.32,43893,1854,172,104,3027,23,5180,5.881.607.143
09/12/2015 06:00,19.86,48474,2017,177,106,3035,26,5361,5.881.607.143
09/12/2015 07:00,21.39,52973,2235,182,107,3076,25,5625,5.881.607.143
09/12/2015 08:00,21.88,53803,2456,186,107,3084,23,5856,5.881.607.143
09/12/2015 09:00,21.33,53417,2662,189,107,3053,25,6036,5.881.607.143
09/12/2015 10:00,21.07,53246,2769,190,107,3112,28,6206,5.881.607.143
09/12/2015 11:00,21.03,52858,2801,189,104,3187,28,6309,5.881.607.143
09/12/2015 12:00,21.15,52522,2865,184,102,3366,29,6546,5.881.607.143
09/12/2015 13:00,21.05,52432,2846,180,98,3534,29,6687,5.881.607.143
09/12/2015 14:00,20.96,52969,2683,175,96,3633,31,6618,5.881.607.143
09/12/2015 15:00,21.45,53916,2466,174,94,3835,29,6598,5.881.607.143
09/12/2015 16:00,21.7,54731,2336,172,91,3935,23,6557,5.881.607.143
09/12/2015 17:00,21.88,54875,2377,169,92,3860,17,6515,5.881.607.143
09/12/2015 18:00,21.44,54104,2565,170,94,3896,19,6744,5.881.607.143
09/12/2015 19:00,20.44,53145,2854,171,97,3910,19,7051,5.881.607.143
09/12/2015 20:00,20.03,51440,3146,168,100,3899,19,7332,5.881.607.143
09/12/2015 21:00,19.65,49927,3379,167,102,3910,18,7576,5.881.607.143
09/12/2015 22:00,18.74,47545,3535,163,103,3965,23,7789,5.881.607.143
09/12/2015 23:00,16.57,44777,3652,154,100,4043,21,7970,5.881.607.143
10/12/2015 00:00,15.34,42368,3921,165,101,4222,15,8424,5.881.607.143
10/12/2015 01:00,13.92,41376,3984,160,91,4257,21,8513,5.881.607.143
10/12/2015 02:00,13.03,40960,4024,151,81,4296,16,8568,5.881.607.143
10/12/2015 03:00,13.03,41096,4059,139,75,4351,8,8632,5.881.607.143
10/12/2015 04:00,14.71,41917,4080,134,78,4394,8,8694,5.881.607.143
10/12/2015 05:00,16.44,44529,4080,140,90,4492,10,8812,5.881.607.143
10/12/2015 06:00,19.38,49075,4077,150,102,4489,16,8834,5.881.607.143
10/12/2015 07:00,20.4,53495,4082,164,115,4496,24,8881,5.881.607.143
10/12/2015 08:00,20.46,54204,4103,175,124,4463,31,8896,5.881.607.143
10/12/2015 09:00,20.51,53603,4135,185,135,4492,37,8984,5.881.607.143
10/12/2015 10:00,20.32,53497,4176,196,141,4489,45,9047,5.881.607.143
10/12/2015 11:00,20.24,53088,4214,204,144,4473,46,9081,5.881.607.143
10/12/2015 12:00,20.24,52643,4215,209,148,4460,46,9078,5.881.607.143
10/12/2015 13:00,20.2,52635,4154,213,152,4425,45,8989,5.881.607.143
10/12/2015 14:00,20.24,53110,3974,220,153,4348,48,8743,5.881.607.143
10/12/2015 15:00,20.5,53975,3732,223,155,4366,49,8525,5.881.607.143
10/12/2015 16:00,20.73,54621,3488,227,158,4412,50,8335,5.881.607.143
10/12/2015 17:00,20.86,54593,3267,228,162,4420,48,8125,5.881.607.143
10/12/2015 18:00,20.64,53948,2998,230,164,4349,52,7793,5.881.607.143
10/12/2015 19:00,20.21,52795,2748,231,166,4268,54,7467,5.881.607.143
10/12/2015 20:00,19.78,51009,2573,231,169,4159,53,7185,5.881.607.143
10/12/2015 21:00,19.52,49539,2450,227,171,4050,53,6951,5.881.607.143
10/12/2015 22:00,18.86,47142,2312,226,172,3927,52,6689,5.881.607.143
10/12/2015 23:00,17.34,44428,2266,229,174,3846,51,6566,5.881.607.143
11/12/2015 00:00,16.91,42303,2355,232,179,3804,50,6620,5.881.607.143
11/12/2015 01:00,16.09,41368,2283,227,178,3715,48,6451,5.881.607.143
11/12/2015 02:00,16.06,41066,2271,219,177,3574,46,6287,5.881.607.143
11/12/2015 03:00,16.36,41264,2247,207,176,3572,43,6245,5.881.607.143
11/12/2015 04:00,17.4,42183,2259,193,173,3478,41,6144,5.881.607.143
11/12/2015 05:00,18.81,44751,2300,177,167,3414,40,6098,5.881.607.143
11/12/2015 06:00,20.83,49303,2359,159,164,3253,34,5969,5.881.607.143
11/12/2015 07:00,21.62,53742,2370,144,158,3094,31,5797,5.881.607.143
11/12/2015 08:00,22,55012,2367,130,152,3001,27,5677,5.881.607.143
11/12/2015 09:00,21.92,54599,2436,120,146,2885,26,5613,5.881.607.143
11/12/2015 10:00,21.69,54365,2518,114,141,2819,20,5612,5.881.607.143
11/12/2015 11:00,21.67,53851,2613,115,136,2743,16,5623,5.881.607.143
11/12/2015 12:00,21.52,53273,2715,105,136,2614,16,5586,5.881.607.143
11/12/2015 13:00,21.37,52849,2701,102,138,2541,16,5498,5.881.607.143
11/12/2015 14:00,21.41,53096,2573,97,139,2578,16,5403,5.881.607.143
11/12/2015 15:00,21.65,53913,2421,97,141,2572,16,5247,5.881.607.143
11/12/2015 16:00,22.09,54741,2217,87,145,2619,16,5084,5.881.607.143
11/12/2015 17:00,22.4,55022,2008,82,145,2761,16,5012,5.881.607.143
11/12/2015 18:00,22.1,54122,1867,85,145,2837,23,4957,5.881.607.143
11/12/2015 19:00,21.09,52583,1802,83,149,2841,19,4894,5.881.607.143
11/12/2015 20:00,20.48,50592,1798,82,155,2787,18,4840,5.881.607.143
11/12/2015 21:00,20.1,49116,1771,78,155,2804,34,4842,5.881.607.143
11/12/2015 22:00,19.32,47442,1792,80,161,2826,38,4897,5.881.607.143
11/12/2015 23:00,16.94,45201,1846,71,167,2852,34,4970,5.881.607.143
12/12/2015 00:00,17.99,43620,2267,44,174,2980,16,5481,5.881.607.143
12/12/2015 01:00,17.18,42602,2292,49,180,2901,13,5435,5.881.607.143
12/12/2015 02:00,16.79,42031,2270,46,189,2957,10,5472,5.881.607.143
12/12/2015 03:00,16.37,41826,2174,43,202,2912,19,5350,5.881.607.143
12/12/2015 04:00,16.79,42014,2071,35,203,2800,21,5130,5.881.607.143
12/12/2015 05:00,17.84,42834,2008,30,196,2698,31,4963,5.881.607.143
12/12/2015 06:00,18.75,44151,2037,32,198,2633,38,4938,5.881.607.143
12/12/2015 07:00,19.25,46191,2078,35,196,2759,38,5106,5.881.607.143
12/12/2015 08:00,20.04,47905,2120,36,187,2773,31,5147,5.881.607.143
12/12/2015 09:00,20.35,49500,2195,33,181,2828,30,5267,5.881.607.143
12/12/2015 10:00,20.52,50407,2225,35,177,2848,29,5314,5.881.607.143
12/12/2015 11:00,20.54,50445,2200,39,173,2972,30,5414,5.881.607.143
12/12/2015 12:00,20.46,50167,2130,39,164,3045,29,5407,5.881.607.143
12/12/2015 13:00,20.37,49960,2004,43,154,3077,30,5308,5.881.607.143
12/12/2015 14:00,20.47,50537,1817,40,143,3096,25,5121,5.881.607.143
12/12/2015 15:00,21,51780,1672,37,129,3123,21,4982,5.881.607.143
12/12/2015 16:00,21.7,53167,1513,34,121,3174,17,4859,5.881.607.143
12/12/2015 17:00,22.18,53731,1340,33,109,2989,15,4486,5.881.607.143
12/12/2015 18:00,22,52971,1207,34,110,2724,18,4093,5.881.607.143
12/12/2015 19:00,21.52,51558,1089,39,111,2665,21,3925,5.881.607.143
12/12/2015 20:00,20.97,49986,976,39,112,2451,23,3601,5.881.607.143
12/12/2015 21:00,20.74,48948,876,41,112,2264,21,3314,5.881.607.143
12/12/2015 22:00,20.73,47555,774,42,112,2145,21,3094,5.881.607.143
12/12/2015 23:00,20.35,45979,667,36,109,1975,17,2804,5.881.607.143
13/12/2015 00:00,20.04,44614,309,43,95,1563,11,2021,5.881.607.143
13/12/2015 01:00,19.17,43532,323,43,90,1392,11,1859,5.881.607.143
13/12/2015 02:00,18.94,42878,391,45,81,1221,10,1748,5.881.607.143
13/12/2015 03:00,18.99,42702,510,44,63,1056,9,1682,5.881.607.143
13/12/2015 04:00,18.98,42918,559,44,55,965,7,1630,5.881.607.143
13/12/2015 05:00,19.28,43485,634,42,33,894,5,1608,5.881.607.143
13/12/2015 06:00,19.38,44429,909,40,28,854,6,1837,5.881.607.143
13/12/2015 07:00,19.36,45921,1159,37,26,848,3,2073,5.881.607.143
13/12/2015 08:00,19.94,47565,1218,34,24,887,2,2165,5.881.607.143
13/12/2015 09:00,21.18,49085,1229,32,19,862,3,2145,5.881.607.143
13/12/2015 10:00,21.74,50174,1237,31,16,797,5,2086,5.881.607.143
13/12/2015 11:00,22.2,50502,1239,29,10,766,5,2049,5.881.607.143
13/12/2015 12:00,22.14,50417,1261,27,6,746,4,2044,5.881.607.143
13/12/2015 13:00,22.13,50389,1205,26,7,746,4,1988,5.881.607.143
13/12/2015 14:00,22.43,51001,1038,24,9,799,3,1873,5.881.607.143
13/12/2015 15:00,23,52335,903,22,14,835,2,1776,5.881.607.143
13/12/2015 16:00,25.43,53686,776,21,20,918,3,1738,5.881.607.143
13/12/2015 17:00,28.95,54347,626,23,28,933,3,1613,5.881.607.143
13/12/2015 18:00,27.92,54102,488,24,38,977,4,1531,5.881.607.143
13/12/2015 19:00,25.27,53416,378,27,41,1010,7,1463,5.881.607.143
13/12/2015 20:00,24.17,52216,296,29,43,1033,8,1409,5.881.607.143
13/12/2015 21:00,22.8,51289,241,32,51,1075,7,1406,5.881.607.143
13/12/2015 22:00,22.1,49510,209,31,60,1084,6,1390,5.881.607.143
13/12/2015 23:00,21.38,47634,194,30,66,1110,8,1408,5.881.607.143
14/12/2015 00:00,21.91,46055,171,53,82,1280,11,1597,5.808.214.286
14/12/2015 01:00,21.3,45267,167,60,89,1365,14,1695,5.808.214.286
14/12/2015 02:00,21.13,44948,155,66,90,1420,16,1747,5.808.214.286
14/12/2015 03:00,20.95,45178,153,71,92,1494,18,1828,5.808.214.286
14/12/2015 04:00,21.58,46205,155,73,95,1525,22,1870,5.808.214.286
14/12/2015 05:00,22.81,48893,175,73,86,1562,18,1914,5.808.214.286
14/12/2015 06:00,28.06,53714,217,73,77,1559,17,1943,5.808.214.286
14/12/2015 07:00,38.93,58266,287,70,69,1589,18,2033,5.808.214.286
14/12/2015 08:00,50.2,59371,374,67,60,1456,17,1974,5.808.214.286
14/12/2015 09:00,45.36,59832,458,63,51,1332,18,1922,5.808.214.286
14/12/2015 10:00,40.27,59526,533,60,43,1193,16,1845,5.808.214.286
14/12/2015 11:00,39.77,58906,601,56,39,1118,15,1829,5.808.214.286
14/12/2015 12:00,37.34,58446,659,53,39,896,14,1661,5.808.214.286
14/12/2015 13:00,38.42,58376,717,50,35,724,10,1536,5.808.214.286
14/12/2015 14:00,38.6,58833,727,48,29,610,9,1423,5.808.214.286
14/12/2015 15:00,51.39,59853,720,44,24,533,7,1328,5.808.214.286
14/12/2015 16:00,50.76,60641,730,42,21,524,5,1322,5.808.214.286
14/12/2015 17:00,51.49,60707,823,39,19,607,4,1492,5.808.214.286
14/12/2015 18:00,46.88,59832,911,36,14,783,3,1747,5.808.214.286
14/12/2015 19:00,33.94,58778,917,33,12,941,4,1907,5.808.214.286
14/12/2015 20:00,27.64,57074,785,32,12,1167,4,2000,5.808.214.286
14/12/2015 21:00,24.55,55553,692,31,11,1457,4,2195,5.808.214.286
14/12/2015 22:00,21.79,52934,625,32,10,1678,4,2349,5.808.214.286
14/12/2015 23:00,20.89,50050,545,33,11,1870,3,2462,5.808.214.286
15/12/2015 00:00,20.33,47737,848,21,9,1926,1,2805,5.808.214.286
15/12/2015 01:00,20.04,46781,731,20,9,2029,0,2789,5.808.214.286
15/12/2015 02:00,19.87,46291,624,22,8,2067,0,2721,5.808.214.286
15/12/2015 03:00,20.03,46308,560,24,8,2253,1,2846,5.808.214.286
15/12/2015 04:00,20.43,47186,514,27,9,2234,1,2785,5.808.214.286
15/12/2015 05:00,21.07,49959,506,30,8,2231,2,2777,5.808.214.286
15/12/2015 06:00,24.25,54795,532,35,9,2214,2,2792,5.808.214.286
15/12/2015 07:00,31.25,59396,548,44,9,2114,2,2717,5.808.214.286
15/12/2015 08:00,38.72,61081,543,56,10,2047,3,2659,5.808.214.286
15/12/2015 09:00,44.36,59927,551,69,9,1988,5,2622,5.808.214.286
15/12/2015 10:00,33.96,59494,551,86,9,1851,6,2503,5.808.214.286
15/12/2015 11:00,35.03,59144,542,101,8,1690,5,2346,5.808.214.286
15/12/2015 12:00,30.7,58586,530,114,7,1600,5,2256,5.808.214.286
15/12/2015 13:00,29.32,58619,516,119,7,1560,5,2207,5.808.214.286
15/12/2015 14:00,30.73,59236,510,118,7,1512,7,2154,5.808.214.286
15/12/2015 15:00,28.2,60059,502,113,7,1471,9,2102,5.808.214.286
15/12/2015 16:00,28.27,60806,515,112,8,1521,9,2165,5.808.214.286
15/12/2015 17:00,43,60942,565,110,8,1463,8,2154,5.808.214.286
15/12/2015 18:00,33.68,60019,635,109,8,1420,8,2180,5.808.214.286
15/12/2015 19:00,28.09,58962,698,107,8,1487,12,2312,5.808.214.286
15/12/2015 20:00,22.91,57175,747,107,10,1528,12,2404,5.808.214.286
15/12/2015 21:00,22.03,55485,813,105,11,1473,12,2414,5.808.214.286
15/12/2015 22:00,20.95,52971,876,105,14,1587,14,2596,5.808.214.286
15/12/2015 23:00,20.27,50197,937,60,16,1738,13,2764,5.808.214.286
16/12/2015 00:00,20.38,47739,896,86,15,1979,14,2990,5.808.214.286
16/12/2015 01:00,19.92,46916,939,89,17,2161,17,3223,5.808.214.286
16/12/2015 02:00,19.69,46523,984,90,18,2252,17,3361,5.808.214.286
16/12/2015 03:00,19.78,46603,1045,93,20,2353,16,3527,5.808.214.286
16/12/2015 04:00,20.23,47468,1124,99,21,2378,16,3638,5.808.214.286
16/12/2015 05:00,21.35,50231,1204,112,24,2333,17,3690,5.808.214.286
16/12/2015 06:00,26.16,55074,1316,127,25,2333,18,3819,5.808.214.286
16/12/2015 07:00,34.23,59650,1458,146,26,2179,17,3826,5.808.214.286
16/12/2015 08:00,40.19,60690,1596,164,28,2009,18,3815,5.808.214.286
16/12/2015 09:00,38.8,59779,1722,177,31,1885,20,3835,5.808.214.286
16/12/2015 10:00,35.67,59548,1812,188,33,1756,20,3809,5.808.214.286
16/12/2015 11:00,37.15,59321,1881,195,33,1604,24,3737,5.808.214.286
16/12/2015 12:00,38.74,58933,1927,196,34,1505,25,3687,5.808.214.286
16/12/2015 13:00,38.8,58884,1910,195,34,1352,23,3514,5.808.214.286
16/12/2015 14:00,36.54,59318,1849,194,33,1191,20,3287,5.808.214.286
16/12/2015 15:00,35.03,60163,1765,185,32,1081,15,3078,5.808.214.286
16/12/2015 16:00,38.83,60805,1695,167,30,988,11,2891,5.808.214.286
16/12/2015 17:00,41.66,60706,1640,142,30,983,8,2803,5.808.214.286
16/12/2015 18:00,38.76,59755,1557,117,31,995,7,2707,5.808.214.286
16/12/2015 19:00,30.44,58499,1438,95,31,1010,7,2581,5.808.214.286
16/12/2015 20:00,25.89,56670,1284,70,30,1085,7,2476,5.808.214.286
16/12/2015 21:00,23.19,55074,1165,52,28,1166,6,2417,5.808.214.286
16/12/2015 22:00,21.79,52606,1060,38,29,1124,6,2257,5.808.214.286
16/12/2015 23:00,20.65,49792,962,30,30,1166,3,2191,5.808.214.286
17/12/2015 00:00,19.47,47600,1579,27,35,1392,4,3037,5.808.214.286
17/12/2015 01:00,19.01,46551,1575,24,35,1422,4,3060,5.808.214.286
17/12/2015 02:00,18.85,46094,1594,25,38,1451,4,3112,5.808.214.286
17/12/2015 03:00,18.81,46121,1616,25,42,1499,4,3186,5.808.214.286
17/12/2015 04:00,19.53,46864,1611,23,46,1441,5,3126,5.808.214.286
17/12/2015 05:00,20.55,49407,1569,25,52,1392,8,3046,5.808.214.286
17/12/2015 06:00,24.85,54142,1602,29,59,1345,10,3045,5.808.214.286
17/12/2015 07:00,35.96,58246,1652,38,65,1323,11,3089,5.808.214.286
17/12/2015 08:00,39.24,58745,1649,49,70,1286,12,3066,5.808.214.286
17/12/2015 09:00,38.26,57984,1631,59,76,1289,17,3072,5.808.214.286
17/12/2015 10:00,33.74,57855,1595,67,77,1292,18,3049,5.808.214.286
17/12/2015 11:00,34.09,57652,1573,72,75,1275,17,3012,5.808.214.286
17/12/2015 12:00,30.34,57153,1594,73,73,1282,18,3040,5.808.214.286
17/12/2015 13:00,29.92,57116,1621,73,71,1282,16,3063,5.808.214.286
17/12/2015 14:00,29.95,57337,1653,76,72,1290,14,3105,5.808.214.286
17/12/2015 15:00,30.12,57925,1704,76,70,1292,13,3155,5.808.214.286
17/12/2015 16:00,31.83,58529,1738,73,68,1298,13,3190,5.808.214.286
17/12/2015 17:00,31.96,58285,1731,76,66,1271,14,3158,5.808.214.286
17/12/2015 18:00,29.94,57449,1709,71,65,1235,16,3096,5.808.214.286
17/12/2015 19:00,24.61,55940,1748,66,66,1227,16,3123,5.808.214.286
17/12/2015 20:00,20.92,54146,1841,60,67,1305,13,3286,5.808.214.286
17/12/2015 21:00,20.31,52417,1950,54,68,1402,13,3487,5.808.214.286
17/12/2015 22:00,19.54,49851,2066,49,67,1517,13,3712,5.808.214.286
17/12/2015 23:00,18.69,46988,2145,42,65,1669,11,3932,5.808.214.286
18/12/2015 00:00,17.38,44895,2752,41,70,2033,8,4904,5.808.214.286
18/12/2015 01:00,16.82,43718,2695,37,67,2238,5,5042,5.808.214.286
18/12/2015 02:00,16.39,43306,2607,35,59,2507,3,5211,5.808.214.286
18/12/2015 03:00,16.43,43390,2534,35,46,2759,2,5376,5.808.214.286
18/12/2015 04:00,17.01,44191,2477,35,41,2892,4,5449,5.808.214.286
18/12/2015 05:00,17.93,46632,2425,37,45,2921,5,5433,5.808.214.286
18/12/2015 06:00,18.91,50922,2356,43,52,2847,7,5305,5.808.214.286
18/12/2015 07:00,20.22,55022,2307,56,60,2782,8,5213,5.808.214.286
18/12/2015 08:00,20.66,56434,2244,72,71,2767,14,5168,5.808.214.286
18/12/2015 09:00,20.56,55905,2214,95,84,2775,21,5189,5.808.214.286
18/12/2015 10:00,20.11,55629,2293,116,99,2771,31,5310,5.808.214.286
18/12/2015 11:00,20.08,55064,2459,139,109,2846,33,5586,5.808.214.286
18/12/2015 12:00,19.77,54388,2611,150,120,2897,30,5808,5.808.214.286
18/12/2015 13:00,19.41,53840,2663,164,125,3034,31,6017,5.808.214.286
18/12/2015 14:00,19.14,53983,2628,170,128,3261,32,6219,5.808.214.286
18/12/2015 15:00,19.27,54673,2612,176,127,3416,32,6363,5.808.214.286
18/12/2015 16:00,19.56,55221,2632,183,125,3649,26,6615,5.808.214.286
18/12/2015 17:00,19.66,55199,2654,187,125,3622,27,6615,5.808.214.286
18/12/2015 18:00,19.15,54137,2708,191,125,3797,36,6857,5.808.214.286
18/12/2015 19:00,18.43,52498,2787,194,130,3865,35,7011,5.808.214.286
18/12/2015 20:00,17.66,50421,2848,193,133,3964,34,7172,5.808.214.286
18/12/2015 21:00,17.61,48795,2853,190,136,4046,31,7256,5.808.214.286
18/12/2015 22:00,16.65,46922,2840,185,135,4216,34,7410,5.808.214.286
18/12/2015 23:00,15.46,44600,2837,181,140,4378,38,7574,5.808.214.286
19/12/2015 00:00,14.57,41911,3069,198,161,4475,41,7944,5.808.214.286
19/12/2015 01:00,13.82,40851,3047,197,173,4497,34,7948,5.808.214.286
19/12/2015 02:00,13.37,40175,3008,199,179,4471,38,7895,5.808.214.286
19/12/2015 03:00,13.2,39969,2949,200,179,4400,45,7773,5.808.214.286
19/12/2015 04:00,13.6,40185,2839,199,175,4295,46,7554,5.808.214.286
19/12/2015 05:00,14.08,40897,2714,196,172,4184,46,7312,5.808.214.286
19/12/2015 06:00,14.89,42058,2610,193,176,4051,49,7079,5.808.214.286
19/12/2015 07:00,15.51,43832,2517,189,174,3914,49,6843,5.808.214.286
19/12/2015 08:00,15.53,45633,2403,184,173,3724,42,6526,5.808.214.286
19/12/2015 09:00,15.92,46936,2279,181,174,3601,40,6275,5.808.214.286
19/12/2015 10:00,16.24,47895,2251,177,177,3344,48,5997,5.808.214.286
19/12/2015 11:00,16.2,48041,2305,171,176,3137,46,5835,5.808.214.286
19/12/2015 12:00,16.01,47880,2363,161,173,2967,44,5708,5.808.214.286
19/12/2015 13:00,15.97,47726,2395,151,166,2729,38,5479,5.808.214.286
19/12/2015 14:00,16.22,48219,2421,137,153,2452,33,5196,5.808.214.286
19/12/2015 15:00,16.83,49361,2419,124,141,2239,29,4952,5.808.214.286
19/12/2015 16:00,17.4,50574,2428,109,132,2178,26,4873,5.808.214.286
19/12/2015 17:00,17.58,51016,2517,91,123,2269,16,5016,5.808.214.286
19/12/2015 18:00,17.46,50179,2662,78,120,2386,16,5262,5.808.214.286
19/12/2015 19:00,16.72,48645,2818,71,113,2664,19,5685,5.808.214.286
19/12/2015 20:00,15.99,46950,2948,68,109,3035,15,6175,5.808.214.286
19/12/2015 21:00,15.56,45741,3003,71,107,3398,18,6597,5.808.214.286
19/12/2015 22:00,15.35,44084,2978,71,104,3627,11,6791,5.808.214.286
19/12/2015 23:00,14.78,42194,2945,74,102,3794,17,6932,5.808.214.286
20/12/2015 00:00,12.53,39909,3146,84,82,3925,13,7250,5.808.214.286
20/12/2015 01:00,10.92,38705,3194,101,88,4072,17,7472,5.808.214.286
20/12/2015 02:00,10.06,37948,3218,116,92,4077,25,7528,5.808.214.286
20/12/2015 03:00,9.26,37683,3202,133,94,4098,32,7559,5.808.214.286
20/12/2015 04:00,9.4,37743,3144,145,99,4120,38,7546,5.808.214.286
20/12/2015 05:00,7.75,38169,3092,157,103,4156,39,7547,5.808.214.286
20/12/2015 06:00,9.64,38893,3078,170,100,4043,43,7434,5.808.214.286
20/12/2015 07:00,10.85,40114,3115,182,94,4121,43,7555,5.808.214.286
20/12/2015 08:00,12.72,41674,3159,192,92,4096,40,7579,5.808.214.286
20/12/2015 09:00,13.88,43067,3183,198,92,4060,38,7571,5.808.214.286
20/12/2015 10:00,14.34,44280,3198,203,91,4068,40,7600,5.808.214.286
20/12/2015 11:00,14.39,44763,3198,207,88,4076,40,7609,5.808.214.286
20/12/2015 12:00,14.29,44775,3171,209,87,4021,38,7526,5.808.214.286
20/12/2015 13:00,14.31,44772,3085,210,89,4003,34,7421,5.808.214.286
20/12/2015 14:00,14.47,45343,2991,209,97,3963,32,7292,5.808.214.286
20/12/2015 15:00,14.84,46515,2943,207,100,3932,29,7211,5.808.214.286
20/12/2015 16:00,15.51,47650,2980,203,104,3953,31,7271,5.808.214.286
20/12/2015 17:00,15.62,48077,3090,201,112,3842,36,7281,5.808.214.286
20/12/2015 18:00,15.41,47641,3182,201,120,3754,39,7296,5.808.214.286
20/12/2015 19:00,14.79,46848,3266,204,127,3733,40,7370,5.808.214.286
20/12/2015 20:00,14.36,45620,3360,207,133,3763,45,7508,5.808.214.286
20/12/2015 21:00,14.16,44593,3438,211,137,3751,45,7582,5.808.214.286
20/12/2015 22:00,13.36,42944,3494,214,137,3784,45,7674,5.808.214.286
20/12/2015 23:00,10.77,41064,3564,216,134,3993,43,7950,5.808.214.286
21/12/2015 00:00,9.44,39058,3219,223,129,4097,45,7713,5.847.202.381
21/12/2015 01:00,6.78,38202,3193,223,126,4297,45,7884,5.847.202.381
21/12/2015 02:00,6,37957,3225,227,124,4328,44,7948,5.847.202.381
21/12/2015 03:00,6.64,38244,3252,231,124,4244,43,7894,5.847.202.381
21/12/2015 04:00,10.01,39311,3251,234,125,4225,39,7874,5.847.202.381
21/12/2015 05:00,13.44,41987,3255,235,126,4362,37,8015,5.847.202.381
21/12/2015 06:00,14.54,46568,3256,237,129,4394,36,8052,5.847.202.381
21/12/2015 07:00,16.61,50775,3273,238,131,4387,39,8068,5.847.202.381
21/12/2015 08:00,16.61,51970,3311,238,132,4305,40,8026,5.847.202.381
21/12/2015 09:00,16.54,51836,3344,238,134,4331,40,8087,5.847.202.381
21/12/2015 10:00,16.28,51900,3361,237,136,4293,41,8068,5.847.202.381
21/12/2015 11:00,16.15,51808,3368,235,135,4329,41,8108,5.847.202.381
21/12/2015 12:00,15.97,51490,3365,233,134,4345,38,8115,5.847.202.381
21/12/2015 13:00,15.9,51537,3335,229,133,4286,36,8019,5.847.202.381
21/12/2015 14:00,16,51965,3277,223,130,4329,32,7991,5.847.202.381
21/12/2015 15:00,16.33,52783,3221,220,127,4373,30,7971,5.847.202.381
21/12/2015 16:00,16.47,53410,3270,218,126,4472,29,8115,5.847.202.381
21/12/2015 17:00,16.42,53425,3405,214,128,4499,30,8276,5.847.202.381
21/12/2015 18:00,16.35,52576,3550,210,139,4517,31,8447,5.847.202.381
21/12/2015 19:00,15.41,51598,3745,208,150,4563,32,8698,5.847.202.381
21/12/2015 20:00,14.22,49876,3936,206,162,4550,29,8883,5.847.202.381
21/12/2015 21:00,13.86,48405,4089,205,171,4549,23,9037,5.847.202.381
21/12/2015 22:00,12.12,45985,4197,204,179,4448,26,9054,5.847.202.381
21/12/2015 23:00,4.96,42763,3913,203,184,4403,28,8731,5.847.202.381
22/12/2015 00:00,4.79,40140,3932,186,182,4069,40,8409,5.847.202.381
22/12/2015 01:00,3.23,39249,3880,182,172,4021,33,8288,5.847.202.381
22/12/2015 02:00,3.23,39015,3975,178,171,3998,28,8350,5.847.202.381
22/12/2015 03:00,4.04,39120,4279,174,173,3997,28,8651,5.847.202.381
22/12/2015 04:00,7.9,39842,4210,164,183,4104,33,8694,5.847.202.381
22/12/2015 05:00,12.44,41948,3876,148,200,4219,37,8480,5.847.202.381
22/12/2015 06:00,14.82,46056,3444,130,201,4360,40,8175,5.847.202.381
22/12/2015 07:00,15.87,50288,3140,113,194,4401,31,7879,5.847.202.381
22/12/2015 08:00,15.94,52092,2943,98,203,4239,18,7501,5.847.202.381
22/12/2015 09:00,15.42,51683,2777,88,214,4011,28,7118,5.847.202.381
22/12/2015 10:00,15.69,51668,2760,88,221,3855,38,6962,5.847.202.381
22/12/2015 11:00,15.65,51205,2967,99,223,3508,42,6839,5.847.202.381
22/12/2015 12:00,15.55,50851,3314,116,220,3197,49,6896,5.847.202.381
22/12/2015 13:00,15.41,50899,3647,131,217,2926,54,6975,5.847.202.381
22/12/2015 14:00,15.57,51567,3819,139,204,2798,44,7004,5.847.202.381
22/12/2015 15:00,16.04,52390,3972,142,185,2774,35,7108,5.847.202.381
22/12/2015 16:00,16.25,53112,4109,138,171,2811,35,7264,5.847.202.381
22/12/2015 17:00,16.35,53163,4195,134,150,2908,29,7416,5.847.202.381
22/12/2015 18:00,15.95,52306,4247,128,132,2863,33,7403,5.847.202.381
22/12/2015 19:00,15.33,51151,4246,123,124,3046,34,7573,5.847.202.381
22/12/2015 20:00,14.74,49404,4181,123,121,3311,36,7772,5.847.202.381
22/12/2015 21:00,14.73,47809,4062,120,123,3438,30,7773,5.847.202.381
22/12/2015 22:00,14.11,45439,3886,114,125,3579,43,7747,5.847.202.381
22/12/2015 23:00,11.4,42688,3624,111,136,3666,48,7585,5.847.202.381
23/12/2015 00:00,10.02,40140,3089,118,186,3604,48,7045,5.847.202.381
23/12/2015 01:00,7.93,39178,2778,128,195,3542,44,6687,5.847.202.381
23/12/2015 02:00,3.46,38692,2588,141,197,3406,44,6376,5.847.202.381
23/12/2015 03:00,4.26,38814,2450,158,197,3361,45,6211,5.847.202.381
23/12/2015 04:00,5.64,39595,2448,175,193,3259,44,6119,5.847.202.381
23/12/2015 05:00,9.23,41735,2639,185,189,3155,43,6211,5.847.202.381
23/12/2015 06:00,12.61,45570,2937,193,188,3123,46,6487,5.847.202.381
23/12/2015 07:00,13.92,49615,3187,192,190,3086,46,6701,5.847.202.381
23/12/2015 08:00,14.28,50876,3405,184,193,3119,46,6947,5.847.202.381
23/12/2015 09:00,14.21,50647,3617,173,196,3153,49,7188,5.847.202.381
23/12/2015 10:00,14.13,50740,3856,162,203,3199,52,7472,5.847.202.381
23/12/2015 11:00,14.05,50497,4089,152,208,3400,53,7902,5.847.202.381
23/12/2015 12:00,13.76,50032,4257,146,210,3494,57,8164,5.847.202.381
23/12/2015 13:00,13.6,49963,4319,142,213,3452,58,8184,5.847.202.381
23/12/2015 14:00,13.64,50567,4298,151,215,3534,56,8254,5.847.202.381
23/12/2015 15:00,13.94,51475,4240,160,216,3611,47,8274,5.847.202.381
23/12/2015 16:00,14.24,52032,4182,172,216,3779,37,8386,5.847.202.381
23/12/2015 17:00,14.28,52024,4142,185,212,3768,42,8349,5.847.202.381
23/12/2015 18:00,14.01,51292,4082,192,207,3958,36,8475,5.847.202.381
23/12/2015 19:00,13.6,50177,3970,195,202,3984,39,8390,5.847.202.381
23/12/2015 20:00,13.38,48683,3787,193,206,4020,44,8250,5.847.202.381
23/12/2015 21:00,13.31,47442,3527,192,209,4086,46,8060,5.847.202.381
23/12/2015 22:00,12.75,45417,3222,194,207,4176,54,7853,5.847.202.381
23/12/2015 23:00,11.14,43000,2881,198,206,4214,52,7551,5.847.202.381
24/12/2015 00:00,9.92,40280,2358,160,220,4314,57,7109,5.847.202.381
24/12/2015 01:00,9.14,39072,2048,163,218,4333,56,6818,5.847.202.381
24/12/2015 02:00,8.73,38490,1890,171,216,4269,55,6601,5.847.202.381
24/12/2015 03:00,8.57,38415,1966,178,208,4158,56,6566,5.847.202.381
24/12/2015 04:00,8.72,38578,2103,183,192,3995,54,6527,5.847.202.381
24/12/2015 05:00,9.6,39444,2269,183,180,3787,52,6471,5.847.202.381
24/12/2015 06:00,10.07,40867,2437,180,165,3714,50,6546,5.847.202.381
24/12/2015 07:00,10.53,42941,2600,173,152,3645,43,6613,5.847.202.381
24/12/2015 08:00,11.62,44960,2771,164,141,3555,38,6669,5.847.202.381
24/12/2015 09:00,13,46623,2937,155,123,3543,29,6787,5.847.202.381
24/12/2015 10:00,13.71,47471,3073,147,111,3591,24,6946,5.847.202.381
24/12/2015 11:00,13.49,47471,3169,137,96,3709,29,7140,5.847.202.381
24/12/2015 12:00,12.83,47028,3245,130,84,3779,23,7261,5.847.202.381
24/12/2015 13:00,12.58,46505,3317,118,73,3892,16,7416,5.847.202.381
24/12/2015 14:00,12.54,46576,3387,106,67,4030,16,7606,5.847.202.381
24/12/2015 15:00,12.99,47132,3494,98,62,4137,14,7805,5.847.202.381
24/12/2015 16:00,13.24,47433,3655,94,59,4199,14,8021,5.847.202.381
24/12/2015 17:00,12.11,46462,3837,102,68,4364,14,8385,5.847.202.381
24/12/2015 18:00,11.05,44703,4000,116,79,4527,17,8739,5.847.202.381
24/12/2015 19:00,10.41,43475,4099,131,88,4662,19,8999,5.847.202.381
24/12/2015 20:00,8.55,42588,4147,144,99,4826,22,9238,5.847.202.381
24/12/2015 21:00,7.86,42244,4211,155,109,4917,21,9413,5.847.202.381
24/12/2015 22:00,7.32,41611,4240,165,119,4958,24,9506,5.847.202.381
24/12/2015 23:00,3.76,40794,4221,171,126,5067,24,9609,5.847.202.381
25/12/2015 00:00,2.7,38051,4248,185,125,5118,33,9709,5.847.202.381
25/12/2015 01:00,1.72,37107,3821,190,127,5148,37,9323,5.847.202.381
25/12/2015 02:00,1.14,36762,4201,196,136,5141,40,9714,5.847.202.381
25/12/2015 03:00,1.27,36711,4194,203,144,5125,40,9706,5.847.202.381
25/12/2015 04:00,3.04,36951,4176,212,147,5103,41,9679,5.847.202.381
25/12/2015 05:00,4.08,37498,4157,219,147,5093,44,9660,5.847.202.381
25/12/2015 06:00,4.01,38331,4149,225,150,5022,47,9593,5.847.202.381
25/12/2015 07:00,5.03,39526,4142,230,158,4938,49,9517,5.847.202.381
25/12/2015 08:00,9.56,40692,4159,231,169,4857,48,9464,5.847.202.381
25/12/2015 09:00,10.09,41765,4225,231,182,4902,46,9586,5.847.202.381
25/12/2015 10:00,10.51,42845,4327,230,198,4856,50,9661,5.847.202.381
25/12/2015 11:00,10.76,43387,4391,227,205,4784,52,9659,5.847.202.381
25/12/2015 12:00,10.85,43472,4405,224,205,4870,53,9757,5.847.202.381
25/12/2015 13:00,10.85,43392,4398,222,204,4927,52,9803,5.847.202.381
25/12/2015 14:00,11.27,43882,4323,222,203,4911,53,9712,5.847.202.381
25/12/2015 15:00,12.26,44928,4167,224,203,4885,53,9532,5.847.202.381
25/12/2015 16:00,13.07,45728,3947,226,203,4866,54,9296,5.847.202.381
25/12/2015 17:00,13.3,45856,3669,229,203,4791,55,8947,5.847.202.381
25/12/2015 18:00,13.03,45476,3315,231,201,4745,57,8549,5.847.202.381
25/12/2015 19:00,12.79,44666,2946,234,202,4664,56,8102,5.847.202.381
25/12/2015 20:00,12.43,43567,2656,235,207,4665,57,7820,5.847.202.381
25/12/2015 21:00,12.42,42980,2407,236,210,4667,55,7575,5.847.202.381
25/12/2015 22:00,12.11,41878,2150,237,210,4705,55,7357,5.847.202.381
25/12/2015 23:00,11.45,40206,1886,238,208,4631,55,7018,5.847.202.381
26/12/2015 00:00,10.11,38968,713,227,220,4401,54,5615,5.847.202.381
26/12/2015 01:00,7.54,38084,603,226,217,4115,53,5214,5.847.202.381
26/12/2015 02:00,6.39,37721,629,226,212,3856,53,4976,5.847.202.381
26/12/2015 03:00,5.77,37573,784,227,205,3596,51,4863,5.847.202.381
26/12/2015 04:00,7.09,37904,893,228,191,3297,47,4656,5.847.202.381
26/12/2015 05:00,8.61,38715,935,229,173,3067,44,4448,5.847.202.381
26/12/2015 06:00,10.1,39722,1000,231,157,2851,36,4275,5.847.202.381
26/12/2015 07:00,10.59,41447,979,231,139,2717,30,4096,5.847.202.381
26/12/2015 08:00,11.42,43224,881,228,127,2640,24,3900,5.847.202.381
26/12/2015 09:00,12.06,44650,815,223,119,2568,22,3747,5.847.202.381
26/12/2015 10:00,12.93,45845,783,217,101,2583,22,3706,5.847.202.381
26/12/2015 11:00,13.33,46150,798,212,80,2630,21,3741,5.847.202.381
26/12/2015 12:00,13.48,45961,831,206,64,2643,20,3764,5.847.202.381
26/12/2015 13:00,13.27,45781,844,203,44,2657,17,3765,5.847.202.381
26/12/2015 14:00,13.5,46260,918,201,29,2692,15,3855,5.847.202.381
26/12/2015 15:00,14.43,47474,1069,199,22,2759,15,4064,5.847.202.381
26/12/2015 16:00,15.49,48735,1173,200,21,2755,16,4165,5.847.202.381
26/12/2015 17:00,16.06,49128,1378,201,23,2732,16,4350,5.847.202.381
26/12/2015 18:00,15.55,48827,1713,202,27,2635,14,4591,5.847.202.381
26/12/2015 19:00,15.08,48112,1922,204,31,2624,13,4794,5.847.202.381
26/12/2015 20:00,14.58,47106,2042,206,30,2590,17,4885,5.847.202.381
26/12/2015 21:00,14.14,46640,2256,207,30,2563,17,5073,5.847.202.381
26/12/2015 22:00,13.58,45647,2437,205,28,2584,14,5268,5.847.202.381
26/12/2015 23:00,12.22,44297,2531,199,26,2559,13,5328,5.847.202.381
27/12/2015 00:00,11.92,42879,2782,204,23,2549,16,5574,5.847.202.381
27/12/2015 01:00,10.95,42326,2952,189,18,2559,13,5731,5.847.202.381
27/12/2015 02:00,10.74,42111,3074,179,14,2473,13,5753,5.847.202.381
27/12/2015 03:00,10.71,42229,3273,168,11,2452,12,5916,5.847.202.381
27/12/2015 04:00,10.76,42599,3411,155,11,2492,8,6077,5.847.202.381
27/12/2015 05:00,10.93,43239,3475,140,13,2631,7,6266,5.847.202.381
27/12/2015 06:00,11.02,44204,3602,120,15,2755,6,6498,5.847.202.381
27/12/2015 07:00,11.39,45562,3620,97,19,3042,5,6783,5.847.202.381
27/12/2015 08:00,11.54,47033,3496,77,23,3141,1,6738,5.847.202.381
27/12/2015 09:00,12.28,48747,3384,57,27,3186,1,6655,5.847.202.381
27/12/2015 10:00,13.4,50245,3364,44,35,3193,0,6636,5.847.202.381
27/12/2015 11:00,14.23,50883,3388,34,51,3259,0,6732,5.847.202.381
27/12/2015 12:00,14.13,50928,3372,26,68,3121,0,6587,5.847.202.381
27/12/2015 13:00,14.32,51028,3351,22,86,2948,1,6408,5.847.202.381
27/12/2015 14:00,15.04,51574,3333,18,101,2782,2,6236,5.847.202.381
27/12/2015 15:00,16.08,52610,3332,17,135,2564,3,6051,5.847.202.381
27/12/2015 16:00,17.12,53739,3320,19,142,2393,8,5882,5.847.202.381
27/12/2015 17:00,17.52,54255,3239,23,128,2210,15,5615,5.847.202.381
27/12/2015 18:00,17.39,53902,3186,30,100,2300,24,5640,5.847.202.381
27/12/2015 19:00,17.07,53186,3095,36,93,2416,25,5665,5.847.202.381
27/12/2015 20:00,16.38,52073,2821,41,94,2435,28,5419,5.847.202.381
27/12/2015 21:00,16.03,51386,2441,45,96,2501,28,5111,5.847.202.381
27/12/2015 22:00,15.7,49369,2052,49,97,2433,29,4660,5.847.202.381
27/12/2015 23:00,15.29,47152,1640,55,108,2353,28,4184,5.847.202.381
28/12/2015 00:00,15.12,45259,1845,38,62,2124,21,4090,5.706.666.667
28/12/2015 01:00,15.05,44567,1588,38,71,1926,16,3639,5.706.666.667
28/12/2015 02:00,15.16,44297,1288,37,69,1698,12,3104,5.706.666.667
28/12/2015 03:00,15.28,44458,1087,36,62,1575,12,2772,5.706.666.667
28/12/2015 04:00,15.97,45332,926,38,58,1481,16,2519,5.706.666.667
28/12/2015 05:00,17.97,47488,737,41,64,1319,20,2181,5.706.666.667
28/12/2015 06:00,19.27,50972,594,42,73,1192,23,1924,5.706.666.667
28/12/2015 07:00,24.25,54706,480,43,87,1167,19,1796,5.706.666.667
28/12/2015 08:00,27.25,56111,428,40,101,1118,18,1705,5.706.666.667
28/12/2015 09:00,29.89,56393,412,38,114,1046,14,1624,5.706.666.667
28/12/2015 10:00,28.06,56755,426,34,121,999,12,1592,5.706.666.667
28/12/2015 11:00,27.94,56708,495,31,120,955,14,1615,5.706.666.667
28/12/2015 12:00,26.27,56315,633,29,117,903,17,1699,5.706.666.667
28/12/2015 13:00,24.83,56265,851,30,114,927,16,1938,5.706.666.667
28/12/2015 14:00,24.07,56640,1152,32,111,958,11,2264,5.706.666.667
28/12/2015 15:00,26.43,57552,1479,34,108,1004,8,2633,5.706.666.667
28/12/2015 16:00,26.28,58437,1797,37,105,1017,6,2962,5.706.666.667
28/12/2015 17:00,25.34,58546,2110,39,100,1075,7,3331,5.706.666.667
28/12/2015 18:00,20.21,57782,2412,41,95,1182,5,3735,5.706.666.667
28/12/2015 19:00,18.63,56790,2640,43,88,1338,5,4114,5.706.666.667
28/12/2015 20:00,17.6,55079,2783,45,79,1496,5,4408,5.706.666.667
28/12/2015 21:00,16.88,53877,2933,45,71,1553,3,4605,5.706.666.667
28/12/2015 22:00,15.87,51844,3133,45,65,1687,4,4934,5.706.666.667
28/12/2015 23:00,14.98,49424,3320,43,61,1811,2,5237,5.706.666.667
29/12/2015 00:00,15.7,45963,3483,53,53,1816,1,5406,5.706.666.667
29/12/2015 01:00,15.16,45094,3556,51,49,2015,1,5672,5.706.666.667
29/12/2015 02:00,14.88,44627,3652,47,40,2291,0,6030,5.706.666.667
29/12/2015 03:00,14.36,44637,3769,42,32,2701,1,6545,5.706.666.667
29/12/2015 04:00,14.72,45251,3856,38,29,2854,1,6778,5.706.666.667
29/12/2015 05:00,15.65,47100,3913,33,27,2983,2,6958,5.706.666.667
29/12/2015 06:00,16.51,50240,3970,28,23,3077,2,7100,5.706.666.667
29/12/2015 07:00,17.16,54031,4024,21,18,3155,2,7220,5.706.666.667
29/12/2015 08:00,17.48,55825,4066,15,11,3205,3,7300,5.706.666.667
29/12/2015 09:00,17.43,56078,4096,13,10,3292,5,7416,5.706.666.667
29/12/2015 10:00,17.06,56384,4101,12,13,3421,4,7551,5.706.666.667
29/12/2015 11:00,17.15,56120,4071,10,20,3475,2,7578,5.706.666.667
29/12/2015 12:00,17.03,55598,4021,9,23,3508,5,7566,5.706.666.667
29/12/2015 13:00,16.99,55475,3933,10,23,3545,4,7515,5.706.666.667
29/12/2015 14:00,17.11,55713,3797,12,24,3589,4,7426,5.706.666.667
29/12/2015 15:00,17.31,56549,3655,13,27,3657,4,7356,5.706.666.667
29/12/2015 16:00,17.73,57246,3570,14,32,3766,4,7386,5.706.666.667
29/12/2015 17:00,17.89,57197,3542,13,33,3854,5,7447,5.706.666.667
29/12/2015 18:00,17.42,56307,3504,14,34,3909,7,7468,5.706.666.667
29/12/2015 19:00,16.92,55207,3444,15,36,3930,7,7432,5.706.666.667
29/12/2015 20:00,16.58,53657,3350,18,37,3937,8,7350,5.706.666.667
29/12/2015 21:00,16.25,52238,3231,19,36,3949,7,7242,5.706.666.667
29/12/2015 22:00,15.48,50323,3146,18,36,3931,8,7139,5.706.666.667
29/12/2015 23:00,14.66,48039,3130,18,38,3855,4,7045,5.706.666.667
30/12/2015 00:00,15.04,45616,3177,17,43,4004,5,7246,5.706.666.667
30/12/2015 01:00,14.38,44674,3179,16,39,3970,5,7209,5.706.666.667
30/12/2015 02:00,14.02,44230,3145,15,35,3983,5,7183,5.706.666.667
30/12/2015 03:00,14.02,44301,3114,16,32,3949,5,7116,5.706.666.667
30/12/2015 04:00,14.72,45124,3108,17,29,3921,3,7078,5.706.666.667
30/12/2015 05:00,15.25,47038,3122,18,27,3919,4,7090,5.706.666.667
30/12/2015 06:00,15.94,50120,3140,21,27,3924,6,7118,5.706.666.667
30/12/2015 07:00,16.57,53435,3166,24,29,3923,6,7148,5.706.666.667
30/12/2015 08:00,16.99,55058,3180,27,30,3939,6,7182,5.706.666.667
30/12/2015 09:00,16.99,55637,3198,30,33,3949,7,7217,5.706.666.667
30/12/2015 10:00,16.85,55898,3242,34,33,3967,8,7284,5.706.666.667
30/12/2015 11:00,17,55598,3288,32,32,3964,7,7323,5.706.666.667
30/12/2015 12:00,16.84,55025,3332,32,30,3931,8,7333,5.706.666.667
30/12/2015 13:00,16.81,54713,3374,32,31,3887,8,7332,5.706.666.667
30/12/2015 14:00,16.85,55076,3418,33,31,3823,5,7310,5.706.666.667
30/12/2015 15:00,17.23,55926,3474,35,31,3845,6,7391,5.706.666.667
30/12/2015 16:00,17.68,56646,3551,35,32,3864,5,7487,5.706.666.667
30/12/2015 17:00,17.64,56570,3620,35,34,3881,7,7577,5.706.666.667
30/12/2015 18:00,17,55642,3642,33,35,3871,9,7590,5.706.666.667
30/12/2015 19:00,16.38,54331,3619,32,37,3874,10,7572,5.706.666.667
30/12/2015 20:00,15.77,52673,3582,34,39,3911,9,7575,5.706.666.667
30/12/2015 21:00,15.55,51182,3572,35,39,3938,8,7592,5.706.666.667
30/12/2015 22:00,15.09,49286,3566,34,39,3907,4,7550,5.706.666.667
30/12/2015 23:00,13.6,47028,3529,31,38,3879,5,7482,5.706.666.667
31/12/2015 00:00,13.73,44210,3732,46,70,3854,12,7714,5.706.666.667
31/12/2015 01:00,12.56,42934,3760,45,69,3807,11,7692,5.706.666.667
31/12/2015 02:00,12.31,42454,3769,45,69,3822,10,7715,5.706.666.667
31/12/2015 03:00,12.32,42448,3774,47,69,3751,11,7652,5.706.666.667
31/12/2015 04:00,12.58,42965,3794,47,69,3701,10,7621,5.706.666.667
31/12/2015 05:00,13.43,44365,3826,46,68,3705,10,7655,5.706.666.667
31/12/2015 06:00,13.77,46085,3849,45,63,3610,10,7577,5.706.666.667
31/12/2015 07:00,14.03,47972,3831,43,61,3630,10,7575,5.706.666.667
31/12/2015 08:00,15.49,49565,3762,41,62,3651,10,7526,5.706.666.667
31/12/2015 09:00,15.87,50990,3645,41,66,3652,9,7413,5.706.666.667
31/12/2015 10:00,15.94,52215,3491,38,68,3674,9,7280,5.706.666.667
31/12/2015 11:00,16.3,52453,3311,35,62,3568,10,6986,5.706.666.667
31/12/2015 12:00,16.35,52248,3134,34,59,3543,11,6781,5.706.666.667
31/12/2015 13:00,16.42,51972,2945,34,56,3514,12,6561,5.706.666.667
31/12/2015 14:00,16.77,52525,2723,38,61,3592,10,6424,5.706.666.667
31/12/2015 15:00,17.42,53939,2482,43,66,3563,10,6164,5.706.666.667
31/12/2015 16:00,18.27,54980,2248,47,72,3532,11,5910,5.706.666.667
31/12/2015 17:00,18.37,54892,2000,52,74,3501,12,5639,5.706.666.667
31/12/2015 18:00,17.92,53235,1800,56,78,3356,12,5302,5.706.666.667
31/12/2015 19:00,16.8,51016,1668,58,82,3206,11,5025,5.706.666.667
31/12/2015 20:00,16.31,49230,1454,61,84,3157,12,4768,5.706.666.667
31/12/2015 21:00,16.29,48588,1240,65,85,2998,12,4400,5.706.666.667
31/12/2015 22:00,16.19,47648,1098,67,85,2836,13,4099,5.706.666.667
31/12/2015 23:00,15.91,46208,1013,60,83,2672,13,3841,5.706.666.667
01/01/2016 00:00,16.39,44702,997,71,93,2508,15,3684,5.706.666.667
01/01/2016 01:00,16.04,43891,1004,69,91,2369,13,3546,5.706.666.667
01/01/2016 02:00,15.74,43214,995,65,87,2256,12,3415,5.706.666.667
01/01/2016 03:00,15.57,42662,982,63,84,2162,11,3302,5.706.666.667
01/01/2016 04:00,15.47,42562,917,61,82,2109,12,3181,5.706.666.667
01/01/2016 05:00,15.75,42927,785,58,81,2032,11,2967,5.706.666.667
01/01/2016 06:00,15.36,43503,724,54,80,2072,11,2941,5.706.666.667
01/01/2016 07:00,15.37,44191,668,52,79,2046,12,2857,5.706.666.667
01/01/2016 08:00,15.19,44539,584,51,77,2101,16,2829,5.706.666.667
01/01/2016 09:00,15.39,45540,532,49,75,2086,15,2757,5.706.666.667
01/01/2016 10:00,15.78,46993,471,49,73,2059,13,2665,5.706.666.667
01/01/2016 11:00,16.15,47759,382,46,66,2009,11,2514,5.706.666.667
01/01/2016 12:00,16.5,48082,338,47,62,2035,11,2493,5.706.666.667
01/01/2016 13:00,16.72,48349,306,49,56,2042,13,2466,5.706.666.667
01/01/2016 14:00,17.17,48997,251,55,63,2018,10,2397,5.706.666.667
01/01/2016 15:00,18,50149,205,65,69,2023,6,2368,5.706.666.667
01/01/2016 16:00,18.49,51322,187,72,74,2031,4,2368,5.706.666.667
01/01/2016 17:00,18.8,51899,182,76,78,1978,4,2318,5.706.666.667
01/01/2016 18:00,18.62,51614,183,80,84,2066,5,2418,5.706.666.667
01/01/2016 19:00,17.92,50832,176,82,89,2084,4,2435,5.706.666.667
01/01/2016 20:00,17.67,49692,177,82,91,2126,7,2483,5.706.666.667
01/01/2016 21:00,17.37,48986,232,81,92,2183,10,2598,5.706.666.667
01/01/2016 22:00,16.84,47655,291,79,92,2202,11,2675,5.706.666.667
01/01/2016 23:00,16.23,46049,403,73,92,2187,10,2765,5.706.666.667
02/01/2016 00:00,16.28,44689,1234,65,90,2097,5,3491,5.706.666.667
02/01/2016 01:00,15.85,43793,1482,63,95,2048,7,3695,5.706.666.667
02/01/2016 02:00,15.02,43327,1839,61,99,2088,8,4095,5.706.666.667
02/01/2016 03:00,13.18,43267,2291,60,102,2130,9,4592,5.706.666.667
02/01/2016 04:00,12.69,43542,2672,58,105,2228,12,5075,5.706.666.667
02/01/2016 05:00,12.94,44259,2955,54,107,2388,11,5515,5.706.666.667
02/01/2016 06:00,13.58,45374,3238,50,107,2512,10,5917,5.706.666.667
02/01/2016 07:00,14.37,46846,3494,45,107,2604,10,6260,5.706.666.667
02/01/2016 08:00,15.74,48491,3698,39,106,2628,8,6479,5.706.666.667
02/01/2016 09:00,15.74,50120,3872,34,105,2665,7,6683,5.706.666.667
02/01/2016 10:00,15.99,51499,3997,29,104,2681,7,6818,5.706.666.667
02/01/2016 11:00,16.07,52051,4088,23,101,2625,6,6843,5.706.666.667
02/01/2016 12:00,15.89,52065,4158,20,95,2619,6,6898,5.706.666.667
02/01/2016 13:00,16.01,52047,4200,18,89,2563,5,6875,5.706.666.667
02/01/2016 14:00,16.2,52732,4231,17,85,2564,4,6901,5.706.666.667
02/01/2016 15:00,16.78,53961,4268,19,82,2527,3,6899,5.706.666.667
02/01/2016 16:00,17.54,55353,4300,19,81,2507,3,6910,5.706.666.667
02/01/2016 17:00,17.92,56093,4331,19,78,2505,4,6937,5.706.666.667
02/01/2016 18:00,17.61,55513,4354,19,73,2463,5,6914,5.706.666.667
02/01/2016 19:00,16.96,54143,4354,17,70,2415,3,6859,5.706.666.667
02/01/2016 20:00,16.7,52719,4338,15,64,2349,3,6769,5.706.666.667
02/01/2016 21:00,16.14,51757,4313,13,57,2291,2,6676,5.706.666.667
02/01/2016 22:00,16.03,50535,4297,11,50,2191,1,6550,5.706.666.667
02/01/2016 23:00,15.46,48965,4297,12,42,2094,1,6446,5.706.666.667
03/01/2016 00:00,16.01,47507,4292,18,33,1909,1,6253,5.706.666.667
03/01/2016 01:00,15.59,46573,3914,29,26,1830,0,5799,5.706.666.667
03/01/2016 02:00,15.68,46018,4326,45,23,1704,0,6098,5.706.666.667
03/01/2016 03:00,15.55,45808,4354,65,19,1615,0,6053,5.706.666.667
03/01/2016 04:00,15.29,45961,4358,86,14,1512,0,5970,5.706.666.667
03/01/2016 05:00,15.58,46407,4344,101,11,1412,0,5868,5.706.666.667
03/01/2016 06:00,15.06,47135,4329,111,8,1405,0,5853,5.706.666.667
03/01/2016 07:00,15.52,48419,4316,114,4,1326,2,5762,5.706.666.667
03/01/2016 08:00,15.78,50132,4306,114,3,1343,1,5767,5.706.666.667
03/01/2016 09:00,16.23,51631,4300,112,3,1282,0,5697,5.706.666.667
03/01/2016 10:00,16.88,52974,4299,103,4,1269,1,5676,5.706.666.667
03/01/2016 11:00,17.58,53749,4294,93,6,1289,2,5684,5.706.666.667
03/01/2016 12:00,17.55,53850,4279,78,8,1310,4,5679,5.706.666.667
03/01/2016 13:00,17.18,53863,4255,63,11,1328,5,5662,5.706.666.667
03/01/2016 14:00,17.41,54588,4232,52,14,1399,8,5705,5.706.666.667
03/01/2016 15:00,17.47,55567,4217,45,15,1400,11,5688,5.706.666.667
03/01/2016 16:00,18.62,56869,4206,41,20,1403,11,5681,5.706.666.667
03/01/2016 17:00,19.17,57645,4198,38,24,1451,8,5719,5.706.666.667
03/01/2016 18:00,18.84,57341,4179,39,33,1522,6,5779,5.706.666.667
03/01/2016 19:00,18.34,56658,4140,39,40,1578,6,5803,5.706.666.667
03/01/2016 20:00,17.9,55457,4088,37,52,1642,7,5826,5.706.666.667
03/01/2016 21:00,17.52,54782,4031,37,62,1677,6,5813,5.706.666.667
03/01/2016 22:00,16.79,53198,3970,41,66,1699,7,5783,5.706.666.667
03/01/2016 23:00,15.67,51396,3908,46,65,1758,5,5782,5.706.666.667
04/01/2016 00:00,15.83,50382,3916,30,23,1625,3,5597,5.438.244.048
04/01/2016 01:00,15.56,49547,3872,32,25,1732,2,5663,5.438.244.048
04/01/2016 02:00,15.41,49226,3858,33,24,1761,2,5678,5.438.244.048
04/01/2016 03:00,15.44,49410,3860,35,21,1794,3,5713,5.438.244.048
04/01/2016 04:00,15.73,50195,3868,36,20,1846,7,5777,5.438.244.048
04/01/2016 05:00,16.22,52346,3879,36,20,1877,6,5818,5.438.244.048
04/01/2016 06:00,18.1,56552,3889,35,19,1917,7,5867,5.438.244.048
04/01/2016 07:00,20.2,60907,3885,35,20,2040,7,5987,5.438.244.048
04/01/2016 08:00,21.66,63292,3870,33,22,2103,8,6036,5.438.244.048
04/01/2016 09:00,20.97,63210,3856,31,25,2115,10,6037,5.438.244.048
04/01/2016 10:00,21.02,63469,3854,27,30,2076,10,5997,5.438.244.048
04/01/2016 11:00,20.74,63257,3859,22,33,2113,8,6035,5.438.244.048
04/01/2016 12:00,20.43,62964,3847,18,36,2188,9,6098,5.438.244.048
04/01/2016 13:00,20.42,62920,3798,18,41,2295,8,6160,5.438.244.048
04/01/2016 14:00,20.61,63258,3728,19,40,2341,6,6134,5.438.244.048
04/01/2016 15:00,20.95,64152,3660,21,45,2381,4,6111,5.438.244.048
04/01/2016 16:00,22.61,64935,3631,21,54,2292,5,6003,5.438.244.048
04/01/2016 17:00,23.63,65226,3649,19,59,2274,6,6007,5.438.244.048
04/01/2016 18:00,21.75,64278,3665,18,66,2327,6,6082,5.438.244.048
04/01/2016 19:00,20.42,62843,3646,16,73,2278,7,6020,5.438.244.048
04/01/2016 20:00,19.44,61003,3597,16,73,2210,6,5902,5.438.244.048
04/01/2016 21:00,18.85,59572,3546,14,72,2139,5,5776,5.438.244.048
04/01/2016 22:00,17.91,57351,3514,14,69,2013,6,5616,5.438.244.048
04/01/2016 23:00,17.08,54583,3501,13,66,1954,5,5539,5.438.244.048
05/01/2016 00:00,17.68,52234,3151,16,30,1735,2,4934,5.438.244.048
05/01/2016 01:00,17.33,51360,3126,13,28,1594,1,4762,5.438.244.048
05/01/2016 02:00,17.24,50886,3134,11,26,1599,2,4772,5.438.244.048
05/01/2016 03:00,17.32,51104,3171,9,26,1561,3,4770,5.438.244.048
05/01/2016 04:00,17.66,52017,3225,10,29,1538,3,4805,5.438.244.048
05/01/2016 05:00,18.22,54169,3252,14,29,1566,2,4863,5.438.244.048
05/01/2016 06:00,19.44,57840,3246,16,29,1578,1,4870,5.438.244.048
05/01/2016 07:00,22.72,61923,3244,14,30,1543,1,4832,5.438.244.048
05/01/2016 08:00,26.55,64313,3254,10,29,1573,2,4868,5.438.244.048
05/01/2016 09:00,26.73,64237,3267,9,28,1620,3,4927,5.438.244.048
05/01/2016 10:00,27.15,64461,3272,9,25,1592,3,4901,5.438.244.048
05/01/2016 11:00,26.11,64523,3275,8,24,1562,3,4872,5.438.244.048
05/01/2016 12:00,23.81,64211,3285,7,25,1475,5,4797,5.438.244.048
05/01/2016 13:00,22.58,64143,3266,8,26,1396,5,4701,5.438.244.048
05/01/2016 14:00,23.52,64122,3198,9,26,1398,3,4634,5.438.244.048
05/01/2016 15:00,27.1,65013,3099,11,26,1385,4,4525,5.438.244.048
05/01/2016 16:00,33.83,66160,3039,13,25,1367,3,4447,5.438.244.048
05/01/2016 17:00,34.09,66416,3010,17,28,1336,4,4395,5.438.244.048
05/01/2016 18:00,27.93,65319,2991,20,32,1381,5,4429,5.438.244.048
05/01/2016 19:00,23.79,64047,2963,22,33,1377,5,4400,5.438.244.048
05/01/2016 20:00,20.74,62337,2897,25,32,1333,4,4291,5.438.244.048
05/01/2016 21:00,20.18,60938,2820,26,31,1258,4,4139,5.438.244.048
05/01/2016 22:00,19.24,59189,2723,26,33,1243,4,4029,5.438.244.048
05/01/2016 23:00,18.24,56649,2600,26,33,1190,5,3854,5.438.244.048
06/01/2016 00:00,20.15,54769,1829,34,26,1111,3,3003,5.438.244.048
06/01/2016 01:00,19.74,53758,1802,38,28,1112,3,2983,5.438.244.048
06/01/2016 02:00,19.43,53306,1787,40,31,1183,2,3043,5.438.244.048
06/01/2016 03:00,19.47,53256,1784,40,33,1144,3,3004,5.438.244.048
06/01/2016 04:00,19.76,53672,1811,38,33,1109,4,2995,5.438.244.048
06/01/2016 05:00,20.21,54790,1820,37,36,1074,2,2969,5.438.244.048
06/01/2016 06:00,21.13,57524,1806,35,41,1052,2,2936,5.438.244.048
06/01/2016 07:00,24.84,60859,1778,33,43,1061,2,2917,5.438.244.048
06/01/2016 08:00,28.21,63240,1775,32,43,1009,2,2861,5.438.244.048
06/01/2016 09:00,34.01,63810,1791,30,43,1015,3,2882,5.438.244.048
06/01/2016 10:00,35.78,64075,1792,27,43,952,2,2816,5.438.244.048
06/01/2016 11:00,39.26,64401,1789,22,35,953,1,2800,5.438.244.048
06/01/2016 12:00,38.52,64191,1781,18,30,926,3,2758,5.438.244.048
06/01/2016 13:00,38.72,64219,1768,19,30,911,3,2731,5.438.244.048
06/01/2016 14:00,34.91,64554,1815,23,35,924,2,2799,5.438.244.048
06/01/2016 15:00,38.43,65707,1869,25,42,957,2,2895,5.438.244.048
06/01/2016 16:00,42.45,67072,1921,27,50,1013,2,3013,5.438.244.048
06/01/2016 17:00,46.41,67581,1984,28,55,1023,4,3094,5.438.244.048
06/01/2016 18:00,45.35,66704,2041,29,62,1054,5,3191,5.438.244.048
06/01/2016 19:00,36.25,65237,2015,30,66,1064,5,3180,5.438.244.048
06/01/2016 20:00,30.68,63317,1916,33,67,1054,6,3076,5.438.244.048
06/01/2016 21:00,26.89,61904,1827,35,67,1053,5,2987,5.438.244.048
06/01/2016 22:00,21.52,59940,1829,35,66,1039,6,2975,5.438.244.048
06/01/2016 23:00,20.08,58040,1920,32,65,1030,6,3053,5.438.244.048
07/01/2016 00:00,22.74,57049,1958,16,30,947,3,2954,5.438.244.048
07/01/2016 01:00,21.88,56775,1965,13,31,956,3,2968,5.438.244.048
07/01/2016 02:00,21.64,56286,1977,12,33,944,4,2970,5.438.244.048
07/01/2016 03:00,21.76,56380,2004,13,34,937,5,2993,5.438.244.048
07/01/2016 04:00,22.39,57157,2097,15,36,933,6,3087,5.438.244.048
07/01/2016 05:00,26.45,59488,2269,16,40,937,5,3267,5.438.244.048
07/01/2016 06:00,33.44,64042,2457,17,41,950,5,3470,5.438.244.048
07/01/2016 07:00,54.97,67736,2612,18,42,972,5,3649,5.438.244.048
07/01/2016 08:00,59.7,68891,2731,18,42,1043,7,3841,5.438.244.048
07/01/2016 09:00,58.03,68430,2874,20,41,1081,8,4024,5.438.244.048
07/01/2016 10:00,57.04,68536,3074,18,39,1112,8,4251,5.438.244.048
07/01/2016 11:00,54.94,68621,3283,15,33,1137,6,4474,5.438.244.048
07/01/2016 12:00,47.74,68253,3456,15,32,1219,6,4728,5.438.244.048
07/01/2016 13:00,42.9,68300,3568,16,35,1313,6,4938,5.438.244.048
07/01/2016 14:00,43.71,68422,3647,17,43,1384,4,5095,5.438.244.048
07/01/2016 15:00,49.73,69046,3734,19,50,1476,5,5284,5.438.244.048
07/01/2016 16:00,59.6,69818,3828,18,56,1575,5,5482,5.438.244.048
07/01/2016 17:00,58.09,69895,3923,17,64,1652,6,5662,5.438.244.048
07/01/2016 18:00,41.63,68787,4000,15,72,1731,6,5824,5.438.244.048
07/01/2016 19:00,34.45,67409,4036,16,80,1821,6,5959,5.438.244.048
07/01/2016 20:00,30.52,65456,4035,15,83,1881,6,6020,5.438.244.048
07/01/2016 21:00,27.17,63866,4015,16,84,1925,6,6046,5.438.244.048
07/01/2016 22:00,23.25,61395,3950,16,84,1966,8,6024,5.438.244.048
07/01/2016 23:00,20.84,58768,3791,15,80,1996,6,5888,5.438.244.048
08/01/2016 00:00,21.36,56953,4095,11,46,2041,4,6197,5.438.244.048
08/01/2016 01:00,20.71,55870,4098,12,51,2101,6,6268,5.438.244.048
08/01/2016 02:00,20.23,55284,4051,15,58,2248,6,6378,5.438.244.048
08/01/2016 03:00,20.17,55362,3963,19,59,2313,6,6360,5.438.244.048
08/01/2016 04:00,20.26,56115,3805,23,60,2310,10,6208,5.438.244.048
08/01/2016 05:00,21.65,58540,3585,28,57,2337,9,6016,5.438.244.048
08/01/2016 06:00,25.63,62525,3386,34,48,2341,10,5819,5.438.244.048
08/01/2016 07:00,35.55,66580,3156,41,45,2328,12,5582,5.438.244.048
08/01/2016 08:00,46.11,68283,2948,43,46,2330,15,5382,5.438.244.048
08/01/2016 09:00,37.84,67949,2888,44,46,2283,19,5280,5.438.244.048
08/01/2016 10:00,34.73,67949,2715,44,46,2192,20,5017,5.438.244.048
08/01/2016 11:00,34.43,67563,2500,44,55,2080,19,4698,5.438.244.048
08/01/2016 12:00,34.09,67017,2309,44,66,1982,20,4421,5.438.244.048
08/01/2016 13:00,31.7,66440,2044,47,78,1912,19,4100,5.438.244.048
08/01/2016 14:00,34.42,66248,1822,53,80,1783,18,3756,5.438.244.048
08/01/2016 15:00,43.8,66677,1583,61,82,1708,18,3452,5.438.244.048
08/01/2016 16:00,48.51,67447,1335,68,84,1610,18,3115,5.438.244.048
08/01/2016 17:00,48.94,67748,1125,74,87,1600,19,2905,5.438.244.048
08/01/2016 18:00,49.75,66693,949,80,88,1553,22,2692,5.438.244.048
08/01/2016 19:00,42.84,64834,788,83,88,1444,21,2424,5.438.244.048
08/01/2016 20:00,34.43,62611,640,85,84,1406,20,2235,5.438.244.048
08/01/2016 21:00,28.78,61117,513,85,80,1335,17,2030,5.438.244.048
08/01/2016 22:00,26.49,59223,433,83,77,1261,14,1868,5.438.244.048
08/01/2016 23:00,23.7,57107,389,77,74,1215,13,1768,5.438.244.048
09/01/2016 00:00,25.69,54540,502,57,56,1110,1,1726,5.438.244.048
09/01/2016 01:00,23.95,53590,571,57,50,1062,0,1740,5.438.244.048
09/01/2016 02:00,22.96,52860,634,58,45,1063,0,1800,5.438.244.048
09/01/2016 03:00,22.77,52542,722,58,41,997,0,1818,5.438.244.048
09/01/2016 04:00,22.29,52708,829,57,40,943,2,1871,5.438.244.048
09/01/2016 05:00,22.64,53351,923,55,38,935,1,1952,5.438.244.048
09/01/2016 06:00,22.74,54402,1018,51,34,921,1,2025,5.438.244.048
09/01/2016 07:00,24.02,56060,1072,47,29,896,2,2046,5.438.244.048
09/01/2016 08:00,25.02,58684,1111,44,27,847,1,2030,5.438.244.048
09/01/2016 09:00,26.51,60079,1183,42,24,846,1,2096,5.438.244.048
09/01/2016 10:00,27.88,61166,1242,38,21,854,2,2157,5.438.244.048
09/01/2016 11:00,28.6,61334,1233,32,18,809,5,2097,5.438.244.048
09/01/2016 12:00,27.77,61142,1196,29,15,807,7,2054,5.438.244.048
09/01/2016 13:00,26.98,60834,1171,27,15,807,6,2026,5.438.244.048
09/01/2016 14:00,27.08,61097,1171,28,18,852,7,2076,5.438.244.048
09/01/2016 15:00,29.52,62059,1212,30,21,918,5,2186,5.438.244.048
09/01/2016 16:00,34.48,63633,1339,30,20,990,3,2382,5.438.244.048
09/01/2016 17:00,45.4,64285,1480,31,17,1088,2,2618,5.438.244.048
09/01/2016 18:00,33.1,63398,1635,32,16,1181,2,2866,5.438.244.048
09/01/2016 19:00,27.49,61659,1762,30,15,1232,2,3041,5.438.244.048
09/01/2016 20:00,24.32,59877,1831,30,14,1301,3,3179,5.438.244.048
09/01/2016 21:00,23.47,58582,1898,29,13,1353,7,3300,5.438.244.048
09/01/2016 22:00,22.7,56945,1931,29,12,1410,8,3390,5.438.244.048
09/01/2016 23:00,21.91,55221,1998,26,13,1480,7,3524,5.438.244.048
10/01/2016 00:00,21.36,53092,1784,14,26,1739,2,3565,5.438.244.048
10/01/2016 01:00,20.06,51994,1973,14,31,1774,1,3793,5.438.244.048
10/01/2016 02:00,19.8,51267,2146,14,33,1812,1,4006,5.438.244.048
10/01/2016 03:00,19.62,50953,2305,15,35,1841,1,4197,5.438.244.048
10/01/2016 04:00,19.47,50908,2480,16,39,1853,2,4390,5.438.244.048
10/01/2016 05:00,19.62,51237,2694,18,42,1892,3,4649,5.438.244.048
10/01/2016 06:00,19.62,51911,2913,19,45,1959,3,4939,5.438.244.048
10/01/2016 07:00,19.86,53096,3063,20,51,2031,5,5170,5.438.244.048
10/01/2016 08:00,19.86,54529,3161,21,57,2102,3,5344,5.438.244.048
10/01/2016 09:00,20.61,55851,3222,22,63,2187,4,5498,5.438.244.048
10/01/2016 10:00,21.44,57031,3163,23,68,2277,5,5536,5.438.244.048
10/01/2016 11:00,22.07,57592,2988,23,72,2354,6,5443,5.438.244.048
10/01/2016 12:00,22.16,57565,2812,26,75,2433,8,5354,5.438.244.048
10/01/2016 13:00,21.85,57541,2610,30,79,2577,11,5307,5.438.244.048
10/01/2016 14:00,21.76,57714,2379,36,89,2671,12,5187,5.438.244.048
10/01/2016 15:00,22.56,58461,2147,44,100,2805,11,5107,5.438.244.048
10/01/2016 16:00,24.7,59626,1932,53,110,2883,19,4997,5.438.244.048
10/01/2016 17:00,27.88,60340,1800,61,118,2880,14,4873,5.438.244.048
10/01/2016 18:00,27.37,59734,1708,69,127,2846,16,4766,5.438.244.048
10/01/2016 19:00,25.9,58753,1558,74,132,2746,18,4528,5.438.244.048
10/01/2016 20:00,24.45,57321,1363,80,136,2659,18,4256,5.438.244.048
10/01/2016 21:00,23.82,56243,1223,85,139,2550,18,4015,5.438.244.048
10/01/2016 22:00,22.78,54376,1178,89,138,2461,20,3886,5.438.244.048
10/01/2016 23:00,21.88,52469,1122,85,142,2342,18,3709,5.438.244.048
11/01/2016 00:00,21.42,51502,735,110,173,2331,29,3378,5.169.821.429
11/01/2016 01:00,20.09,50429,694,117,173,2241,30,3255,5.169.821.429
11/01/2016 02:00,19.82,50071,664,124,171,2151,31,3141,5.169.821.429
11/01/2016 03:00,19.39,50156,655,132,168,2082,33,3070,5.169.821.429
11/01/2016 04:00,20.2,51010,617,139,164,2060,37,3017,5.169.821.429
11/01/2016 05:00,22.41,53662,561,145,157,1992,35,2890,5.169.821.429
11/01/2016 06:00,27.33,58226,516,149,149,1886,42,2742,5.169.821.429
11/01/2016 07:00,45.46,62452,488,153,141,1894,39,2715,5.169.821.429
11/01/2016 08:00,46.37,63981,462,154,134,1859,28,2637,5.169.821.429
11/01/2016 09:00,44.74,63482,415,155,122,1836,36,2564,5.169.821.429
11/01/2016 10:00,39.18,63355,383,156,110,1759,24,2432,5.169.821.429
11/01/2016 11:00,39.87,63145,368,156,99,1712,18,2353,5.169.821.429
11/01/2016 12:00,44.08,62687,354,155,87,1690,16,2302,5.169.821.429
11/01/2016 13:00,44.67,62541,311,154,75,1641,13,2194,5.169.821.429
11/01/2016 14:00,43.38,62534,269,154,66,1596,11,2096,5.169.821.429
11/01/2016 15:00,44.54,63091,269,153,57,1541,20,2040,5.169.821.429
11/01/2016 16:00,44.43,63785,286,151,51,1437,21,1946,5.169.821.429
11/01/2016 17:00,41.6,63963,314,149,45,1434,22,1964,5.169.821.429
11/01/2016 18:00,38.87,62950,342,149,40,1378,19,1928,5.169.821.429
11/01/2016 19:00,34.29,61787,363,145,35,1367,9,1919,5.169.821.429
11/01/2016 20:00,28.08,59852,365,142,32,1348,7,1894,5.169.821.429
11/01/2016 21:00,25.79,58305,379,139,26,1391,6,1941,5.169.821.429
11/01/2016 22:00,23.37,55902,388,134,23,1434,6,1985,5.169.821.429
11/01/2016 23:00,21.79,53094,385,126,20,1417,2,1950,5.169.821.429
12/01/2016 00:00,21.2,51917,695,121,26,1359,3,2204,5.169.821.429
12/01/2016 01:00,19.9,50866,718,120,24,1406,2,2270,5.169.821.429
12/01/2016 02:00,19.19,50515,735,120,21,1430,3,2309,5.169.821.429
12/01/2016 03:00,18.48,50662,734,120,19,1438,3,2314,5.169.821.429
12/01/2016 04:00,19.2,51536,720,119,18,1439,5,2301,5.169.821.429
12/01/2016 05:00,21.66,54125,699,117,17,1448,4,2285,5.169.821.429
12/01/2016 06:00,24.19,58668,679,115,17,1488,4,2303,5.169.821.429
12/01/2016 07:00,35.34,62996,657,112,20,1519,4,2312,5.169.821.429
12/01/2016 08:00,40.29,64396,650,111,26,1554,4,2345,5.169.821.429
12/01/2016 09:00,41.17,63902,685,113,37,1586,8,2429,5.169.821.429
12/01/2016 10:00,39.35,63815,713,115,45,1632,11,2516,5.169.821.429
12/01/2016 11:00,38.84,63789,716,119,45,1642,11,2533,5.169.821.429
12/01/2016 12:00,38.58,63872,706,122,44,1651,15,2538,5.169.821.429
12/01/2016 13:00,37.59,63865,677,122,45,1691,25,2560,5.169.821.429
12/01/2016 14:00,38.8,63930,637,120,52,1700,16,2525,5.169.821.429
12/01/2016 15:00,41.52,64310,607,116,58,1756,26,2563,5.169.821.429
12/01/2016 16:00,44.63,65120,576,115,67,1831,16,2605,5.169.821.429
12/01/2016 17:00,45.56,65595,543,116,73,1884,14,2630,5.169.821.429
12/01/2016 18:00,40.05,64631,527,116,79,1985,15,2722,5.169.821.429
12/01/2016 19:00,29.41,63233,531,114,85,2044,20,2794,5.169.821.429
12/01/2016 20:00,25.94,61467,543,111,88,2040,24,2806,5.169.821.429
12/01/2016 21:00,25.72,59849,555,110,95,1986,16,2762,5.169.821.429
12/01/2016 22:00,23.66,57679,575,112,99,2062,12,2860,5.169.821.429
12/01/2016 23:00,21.58,54807,634,115,96,2140,11,2996,5.169.821.429
13/01/2016 00:00,21.06,52457,1353,75,45,2093,3,3569,5.169.821.429
13/01/2016 01:00,19.72,51451,1483,78,44,2124,3,3732,5.169.821.429
13/01/2016 02:00,18.77,51210,1544,80,40,2188,3,3855,5.169.821.429
13/01/2016 03:00,18.71,51407,1640,81,37,2211,4,3973,5.169.821.429
13/01/2016 04:00,19.49,52201,1698,81,36,2240,5,4060,5.169.821.429
13/01/2016 05:00,21.75,54559,1659,76,34,2164,4,3937,5.169.821.429
13/01/2016 06:00,24.47,58841,1571,70,39,2116,4,3800,5.169.821.429
13/01/2016 07:00,33.05,63282,1413,67,45,2108,5,3638,5.169.821.429
13/01/2016 08:00,34.12,65079,1236,64,47,2099,9,3455,5.169.821.429
13/01/2016 09:00,33.91,64820,1120,59,48,2073,11,3311,5.169.821.429
13/01/2016 10:00,32.11,64676,938,57,51,2081,17,3144,5.169.821.429
13/01/2016 11:00,33.63,64585,675,56,54,2016,26,2827,5.169.821.429
13/01/2016 12:00,34.89,64385,455,54,59,1958,35,2561,5.169.821.429
13/01/2016 13:00,34.95,64357,303,55,69,1956,41,2424,5.169.821.429
13/01/2016 14:00,35.26,64470,218,58,63,1989,29,2357,5.169.821.429
13/01/2016 15:00,43.44,65002,183,61,57,1965,17,2283,5.169.821.429
13/01/2016 16:00,75,65886,200,66,59,2017,16,2358,5.169.821.429
13/01/2016 17:00,78.86,66320,214,70,66,2047,22,2419,5.169.821.429
13/01/2016 18:00,54.42,65651,226,71,68,2045,20,2430,5.169.821.429
13/01/2016 19:00,34.99,64685,248,73,73,2025,20,2439,5.169.821.429
13/01/2016 20:00,28.2,63139,292,74,81,2027,27,2501,5.169.821.429
13/01/2016 21:00,26.92,61649,353,72,88,2028,33,2574,5.169.821.429
13/01/2016 22:00,25.45,59492,378,71,96,2014,31,2590,5.169.821.429
13/01/2016 23:00,22.95,56923,403,74,99,1985,25,2586,5.169.821.429
14/01/2016 00:00,23.47,54753,462,100,161,1862,43,2628,5.169.821.429
14/01/2016 01:00,22.55,53708,485,100,169,1866,40,2660,5.169.821.429
14/01/2016 02:00,22.18,53316,500,101,171,1864,38,2674,5.169.821.429
14/01/2016 03:00,22.01,53504,553,99,171,1835,37,2695,5.169.821.429
14/01/2016 04:00,22.58,54395,622,96,171,1810,30,2729,5.169.821.429
14/01/2016 05:00,25.06,56764,681,90,165,1765,29,2730,5.169.821.429
14/01/2016 06:00,31.62,61028,713,85,161,1699,27,2685,5.169.821.429
14/01/2016 07:00,41.42,65148,719,79,152,1684,34,2668,5.169.821.429
14/01/2016 08:00,57.07,66601,730,73,139,1631,30,2603,5.169.821.429
14/01/2016 09:00,53.38,66501,753,69,125,1624,25,2596,5.169.821.429
14/01/2016 10:00,44.05,66691,716,67,101,1557,24,2465,5.169.821.429
14/01/2016 11:00,40.38,66673,678,66,88,1567,23,2422,5.169.821.429
14/01/2016 12:00,45.44,66384,710,66,75,1621,25,2497,5.169.821.429
14/01/2016 13:00,44.05,66207,759,64,68,1583,21,2495,5.169.821.429
14/01/2016 14:00,44.04,66212,812,61,56,1530,16,2475,5.169.821.429
14/01/2016 15:00,49.92,66866,871,61,44,1554,14,2544,5.169.821.429
14/01/2016 16:00,95.03,67713,937,61,37,1619,14,2668,5.169.821.429
14/01/2016 17:00,95.03,68182,1009,61,29,1625,15,2739,5.169.821.429
14/01/2016 18:00,91.09,67064,1087,61,23,1639,13,2823,5.169.821.429
14/01/2016 19:00,44.41,65607,1093,59,18,1720,10,2900,5.169.821.429
14/01/2016 20:00,33.67,63804,1017,56,14,1738,9,2834,5.169.821.429
14/01/2016 21:00,30.86,62218,967,54,13,1769,7,2810,5.169.821.429
14/01/2016 22:00,28.31,59989,927,51,13,1805,7,2803,5.169.821.429
14/01/2016 23:00,25.29,57400,892,46,11,1793,3,2745,5.169.821.429
15/01/2016 00:00,23.96,56122,1469,44,7,1883,3,3406,5.169.821.429
15/01/2016 01:00,24.02,55076,1464,41,9,1904,3,3421,5.169.821.429
15/01/2016 02:00,23.25,54651,1503,40,9,1939,2,3493,5.169.821.429
15/01/2016 03:00,22.9,54771,1556,40,11,1918,3,3528,5.169.821.429
15/01/2016 04:00,24.54,55610,1535,38,13,1913,3,3502,5.169.821.429
15/01/2016 05:00,25.75,58129,1432,38,15,1913,2,3400,5.169.821.429
15/01/2016 06:00,29.67,62730,1283,41,18,1891,1,3234,5.169.821.429
15/01/2016 07:00,46.6,66771,1103,43,20,1870,1,3037,5.169.821.429
15/01/2016 08:00,88.08,69253,946,42,22,1812,10,2832,5.169.821.429
15/01/2016 09:00,83.06,68766,828,47,25,1747,12,2659,5.169.821.429
15/01/2016 10:00,51.98,68563,722,49,28,1668,4,2471,5.169.821.429
15/01/2016 11:00,50.36,67734,623,49,29,1598,3,2302,5.169.821.429
15/01/2016 12:00,51.42,66891,545,49,31,1558,5,2188,5.169.821.429
15/01/2016 13:00,43.06,65886,489,49,33,1539,4,2114,5.169.821.429
15/01/2016 14:00,37.95,65586,447,51,35,1524,2,2059,5.169.821.429
15/01/2016 15:00,43.05,66047,415,53,37,1451,2,1958,5.169.821.429
15/01/2016 16:00,49.97,67194,366,55,44,1491,3,1959,5.169.821.429
15/01/2016 17:00,82.18,67860,309,54,48,1565,12,1988,5.169.821.429
15/01/2016 18:00,53.53,66992,271,48,54,1537,6,1916,5.169.821.429
15/01/2016 19:00,37.91,65322,233,43,56,1594,7,1933,5.169.821.429
15/01/2016 20:00,31.64,62981,190,37,57,1614,6,1904,5.169.821.429
15/01/2016 21:00,28.58,61320,168,32,57,1680,5,1942,5.169.821.429
15/01/2016 22:00,27.48,59552,184,29,58,1642,5,1918,5.169.821.429
15/01/2016 23:00,25.05,57498,224,26,58,1709,4,2021,5.169.821.429
16/01/2016 00:00,26.55,55625,56,27,42,1696,1,1822,5.169.821.429
16/01/2016 01:00,25.75,54622,58,25,43,1599,0,1725,5.169.821.429
16/01/2016 02:00,24.85,53989,76,24,43,1659,1,1803,5.169.821.429
16/01/2016 03:00,24.38,53784,120,24,41,1694,1,1880,5.169.821.429
16/01/2016 04:00,24.09,53970,143,23,37,1729,3,1935,5.169.821.429
16/01/2016 05:00,24.74,54649,156,21,37,1793,1,2008,5.169.821.429
16/01/2016 06:00,24.28,55754,192,19,39,1722,1,1973,5.169.821.429
16/01/2016 07:00,24.69,57459,226,17,41,1735,2,2021,5.169.821.429
16/01/2016 08:00,26.63,59673,244,13,42,1779,1,2079,5.169.821.429
16/01/2016 09:00,29.01,60914,277,11,41,1783,2,2114,5.169.821.429
16/01/2016 10:00,31.18,61682,313,9,39,1738,3,2102,5.169.821.429
16/01/2016 11:00,30.17,61607,345,7,35,1703,3,2093,5.169.821.429
16/01/2016 12:00,27.74,60988,389,6,33,1701,3,2132,5.169.821.429
16/01/2016 13:00,25.74,60380,474,6,31,1761,1,2273,5.169.821.429
16/01/2016 14:00,26.09,60473,570,7,31,1818,6,2432,5.169.821.429
16/01/2016 15:00,26.73,61499,639,8,31,1921,5,2604,5.169.821.429
16/01/2016 16:00,31.39,63059,689,9,31,2024,3,2756,5.169.821.429
16/01/2016 17:00,32.97,64056,734,10,31,2136,2,2913,5.169.821.429
16/01/2016 18:00,32.2,63381,784,12,29,2221,2,3048,5.169.821.429
16/01/2016 19:00,27.73,61813,810,13,26,2339,2,3190,5.169.821.429
16/01/2016 20:00,25.93,60153,827,13,24,2373,3,3240,5.169.821.429
16/01/2016 21:00,25.35,59011,819,13,23,2405,7,3267,5.169.821.429
16/01/2016 22:00,24.82,57563,756,13,23,2420,8,3220,5.169.821.429
16/01/2016 23:00,23.66,55882,699,12,24,2412,6,3153,5.169.821.429
17/01/2016 00:00,21.76,54521,806,13,13,2359,5,3196,5.169.821.429
17/01/2016 01:00,20.25,53467,748,14,12,2430,3,3207,5.169.821.429
17/01/2016 02:00,20.72,52899,698,16,12,2396,3,3125,5.169.821.429
17/01/2016 03:00,20.9,52723,669,21,12,2383,4,3089,5.169.821.429
17/01/2016 04:00,20.82,53044,623,23,13,2360,5,3024,5.169.821.429
17/01/2016 05:00,20.89,53441,547,25,14,2323,9,2918,5.169.821.429
17/01/2016 06:00,20.12,54605,464,27,17,2297,9,2814,5.169.821.429
17/01/2016 07:00,22.31,55891,393,32,18,2246,10,2699,5.169.821.429
17/01/2016 08:00,23.51,57814,350,39,20,2104,8,2521,5.169.821.429
17/01/2016 09:00,24.58,59119,322,45,21,1935,8,2331,5.169.821.429
17/01/2016 10:00,26.13,60134,320,46,22,1774,8,2170,5.169.821.429
17/01/2016 11:00,26.46,59764,305,45,23,1617,9,1999,5.169.821.429
17/01/2016 12:00,25.98,59217,290,43,24,1484,9,1850,5.169.821.429
17/01/2016 13:00,25.97,58964,262,48,28,1388,10,1736,5.169.821.429
17/01/2016 14:00,25.83,59095,223,51,30,1288,11,1603,5.169.821.429
17/01/2016 15:00,27.81,60449,192,57,31,1220,10,1510,5.169.821.429
17/01/2016 16:00,31.16,62630,179,57,32,1219,10,1497,5.169.821.429
17/01/2016 17:00,33.35,63985,166,59,33,1317,10,1585,5.169.821.429
17/01/2016 18:00,34.1,64649,162,56,32,1509,10,1769,5.169.821.429
17/01/2016 19:00,32.89,63409,168,55,31,1530,8,1792,5.169.821.429
17/01/2016 20:00,27.95,61546,187,55,30,1572,8,1852,5.169.821.429
17/01/2016 21:00,26.96,59722,221,55,28,1676,7,1987,5.169.821.429
17/01/2016 22:00,25.91,58055,262,54,25,1776,9,2126,5.169.821.429
17/01/2016 23:00,24.4,56076,308,50,23,1816,8,2205,5.169.821.429
18/01/2016 00:00,23.59,55425,557,42,35,1799,7,2440,4.874.166.667
18/01/2016 01:00,23.24,54430,582,47,32,1818,6,2485,4.874.166.667
18/01/2016 02:00,23.28,54101,603,58,29,1935,5,2630,4.874.166.667
18/01/2016 03:00,23.31,54240,645,67,24,1865,6,2607,4.874.166.667
18/01/2016 04:00,24.32,55066,662,70,20,1673,11,2436,4.874.166.667
18/01/2016 05:00,26.47,57897,652,73,19,1618,10,2372,4.874.166.667
18/01/2016 06:00,32.84,62750,636,77,20,1573,12,2318,4.874.166.667
18/01/2016 07:00,79.86,67210,641,82,22,1552,13,2310,4.874.166.667
18/01/2016 08:00,89.61,68302,639,81,26,1599,15,2360,4.874.166.667
18/01/2016 09:00,75.95,67760,645,79,29,1508,17,2278,4.874.166.667
18/01/2016 10:00,51.84,67476,704,76,31,1421,16,2248,4.874.166.667
18/01/2016 11:00,51.45,66928,775,70,33,1316,15,2209,4.874.166.667
18/01/2016 12:00,55.48,66497,838,64,35,1261,17,2215,4.874.166.667
18/01/2016 13:00,56.44,66158,889,60,40,1214,16,2219,4.874.166.667
18/01/2016 14:00,55.46,66025,933,58,42,1192,14,2239,4.874.166.667
18/01/2016 15:00,69.86,66468,1028,58,43,1163,13,2305,4.874.166.667
18/01/2016 16:00,89.65,67513,1100,56,44,1167,10,2377,4.874.166.667
18/01/2016 17:00,91.04,68041,1155,52,46,1150,11,2414,4.874.166.667
18/01/2016 18:00,76.24,66995,1223,49,50,1128,10,2460,4.874.166.667
18/01/2016 19:00,48.6,65752,1309,47,52,1104,10,2522,4.874.166.667
18/01/2016 20:00,34.99,63845,1409,46,54,1051,10,2570,4.874.166.667
18/01/2016 21:00,29.27,62289,1551,43,56,1027,9,2686,4.874.166.667
18/01/2016 22:00,25.6,59926,1701,41,57,1028,11,2838,4.874.166.667
18/01/2016 23:00,23.91,57148,1827,38,57,989,6,2917,4.874.166.667
19/01/2016 00:00,23.81,56296,3001,50,65,911,10,4037,4.874.166.667
19/01/2016 01:00,23.25,55344,2902,45,69,893,11,3920,4.874.166.667
19/01/2016 02:00,23.09,54980,2565,41,75,901,8,3590,4.874.166.667
19/01/2016 03:00,23.56,55198,2340,38,81,940,5,3404,4.874.166.667
19/01/2016 04:00,24.95,56128,2110,35,87,994,7,3233,4.874.166.667
19/01/2016 05:00,28.8,58782,1841,34,88,1055,6,3024,4.874.166.667
19/01/2016 06:00,37.25,62975,1655,33,86,1146,7,2927,4.874.166.667
19/01/2016 07:00,55.17,67507,1493,32,84,1197,7,2813,4.874.166.667
19/01/2016 08:00,70.09,68575,1320,31,80,1198,7,2636,4.874.166.667
19/01/2016 09:00,66.09,68267,1241,30,79,1203,9,2562,4.874.166.667
19/01/2016 10:00,61.16,69044,1174,26,77,1178,8,2463,4.874.166.667
19/01/2016 11:00,61.28,68467,1084,23,69,1157,6,2339,4.874.166.667
19/01/2016 12:00,58.98,67450,1012,20,63,1077,7,2179,4.874.166.667
19/01/2016 13:00,58.07,67244,923,18,55,998,11,2005,4.874.166.667
19/01/2016 14:00,57.57,67166,788,17,61,922,9,1797,4.874.166.667
19/01/2016 15:00,70.07,67532,645,16,64,881,11,1617,4.874.166.667
19/01/2016 16:00,120.08,68508,549,15,68,843,14,1489,4.874.166.667
19/01/2016 17:00,160.03,68952,466,15,75,766,16,1338,4.874.166.667
19/01/2016 18:00,99.94,68130,406,15,81,723,18,1243,4.874.166.667
19/01/2016 19:00,57.56,66909,391,15,89,689,18,1202,4.874.166.667
19/01/2016 20:00,48.24,65250,378,16,91,666,20,1171,4.874.166.667
19/01/2016 21:00,37.7,63602,366,19,94,673,19,1171,4.874.166.667
19/01/2016 22:00,32.86,61346,370,21,95,690,19,1195,4.874.166.667
19/01/2016 23:00,29.08,58559,371,22,97,721,16,1227,4.874.166.667
20/01/2016 00:00,26,56790,330,16,133,647,17,1143,4.874.166.667
20/01/2016 01:00,25.43,55751,288,18,132,665,18,1121,4.874.166.667
20/01/2016 02:00,25.76,55737,256,21,131,728,20,1156,4.874.166.667
20/01/2016 03:00,24.76,55953,256,23,128,745,22,1174,4.874.166.667
20/01/2016 04:00,27.2,56928,272,25,126,754,26,1203,4.874.166.667
20/01/2016 05:00,29.57,59392,292,27,122,755,21,1217,4.874.166.667
20/01/2016 06:00,35,63775,313,27,120,744,17,1221,4.874.166.667
20/01/2016 07:00,57.58,68130,313,25,113,736,14,1201,4.874.166.667
20/01/2016 08:00,70.09,69034,303,24,107,733,14,1181,4.874.166.667
20/01/2016 09:00,64.97,70576,309,24,97,729,14,1173,4.874.166.667
20/01/2016 10:00,57.57,70097,318,22,88,719,14,1161,4.874.166.667
20/01/2016 11:00,55.76,69074,323,21,74,692,13,1123,4.874.166.667
20/01/2016 12:00,57.55,67711,333,21,61,666,14,1095,4.874.166.667
20/01/2016 13:00,55.45,67283,355,23,49,650,12,1089,4.874.166.667
20/01/2016 14:00,51.86,67229,380,25,39,661,8,1113,4.874.166.667
20/01/2016 15:00,55.43,67879,400,28,32,706,6,1172,4.874.166.667
20/01/2016 16:00,84.76,69062,422,30,27,745,4,1228,4.874.166.667
20/01/2016 17:00,99.99,69731,449,29,23,800,4,1305,4.874.166.667
20/01/2016 18:00,81.02,69002,454,28,23,848,4,1357,4.874.166.667
20/01/2016 19:00,70.03,67983,446,26,23,865,4,1364,4.874.166.667
20/01/2016 20:00,50.1,66314,416,24,22,889,3,1354,4.874.166.667
20/01/2016 21:00,40.06,64762,373,23,26,902,3,1327,4.874.166.667
20/01/2016 22:00,33.52,62461,333,21,28,920,4,1306,4.874.166.667
20/01/2016 23:00,29.63,59807,301,19,32,924,0,1276,4.874.166.667
21/01/2016 00:00,29.77,57832,275,12,52,713,2,1054,4.874.166.667
21/01/2016 01:00,27.9,56930,251,12,50,722,2,1037,4.874.166.667
21/01/2016 02:00,26.71,56662,231,11,45,660,2,949,4.874.166.667
21/01/2016 03:00,27.35,56919,225,9,42,617,2,895,4.874.166.667
21/01/2016 04:00,31.52,58082,207,8,39,593,5,852,4.874.166.667
21/01/2016 05:00,32.85,60652,189,7,35,567,4,802,4.874.166.667
21/01/2016 06:00,63.08,65117,183,6,33,548,4,774,4.874.166.667
21/01/2016 07:00,160,69472,202,4,32,549,11,798,4.874.166.667
21/01/2016 08:00,199.97,70394,223,3,30,535,12,803,4.874.166.667
21/01/2016 09:00,168.64,69940,235,3,26,535,13,812,4.874.166.667
21/01/2016 10:00,120.05,69715,248,2,24,540,12,826,4.874.166.667
21/01/2016 11:00,74.97,69218,239,3,23,547,3,815,4.874.166.667
21/01/2016 12:00,60.01,68284,209,4,21,555,4,793,4.874.166.667
21/01/2016 13:00,59.1,67869,178,6,18,534,4,740,4.874.166.667
21/01/2016 14:00,59.81,67888,160,9,15,565,2,751,4.874.166.667
21/01/2016 15:00,95.01,68245,152,12,13,564,4,745,4.874.166.667
21/01/2016 16:00,149.95,69348,170,13,11,629,11,834,4.874.166.667
21/01/2016 17:00,199.94,69984,210,13,12,616,11,862,4.874.166.667
21/01/2016 18:00,150.08,69183,249,12,12,640,11,924,4.874.166.667
21/01/2016 19:00,61.03,67882,295,11,13,666,4,989,4.874.166.667
21/01/2016 20:00,50.07,66018,343,10,13,698,4,1068,4.874.166.667
21/01/2016 21:00,36.69,64471,396,10,15,676,3,1100,4.874.166.667
21/01/2016 22:00,31.62,62202,453,10,18,703,3,1187,4.874.166.667
21/01/2016 23:00,27.53,59501,524,10,20,765,1,1320,4.874.166.667
22/01/2016 00:00,25.94,57787,577,17,23,729,2,1348,4.874.166.667
22/01/2016 01:00,25.79,56783,612,16,22,781,1,1432,4.874.166.667
22/01/2016 02:00,24.74,56494,664,14,19,841,1,1539,4.874.166.667
22/01/2016 03:00,24.7,56645,727,12,15,919,0,1673,4.874.166.667
22/01/2016 04:00,25.95,57422,780,10,13,990,3,1796,4.874.166.667
22/01/2016 05:00,28.78,59826,843,8,12,1087,2,1952,4.874.166.667
22/01/2016 06:00,32.2,64082,908,6,12,1153,1,2080,4.874.166.667
22/01/2016 07:00,74.2,68227,993,4,12,1248,3,2260,4.874.166.667
22/01/2016 08:00,95.02,69100,1104,4,12,1215,4,2339,4.874.166.667
22/01/2016 09:00,91.08,68665,1230,3,12,1192,5,2442,4.874.166.667
22/01/2016 10:00,54.16,68224,1323,2,12,1237,2,2576,4.874.166.667
22/01/2016 11:00,42.87,67694,1384,3,12,1314,1,2714,4.874.166.667
22/01/2016 12:00,37.81,66774,1458,3,12,1365,3,2841,4.874.166.667
22/01/2016 13:00,34.87,65907,1559,3,12,1338,3,2915,4.874.166.667
22/01/2016 14:00,31.09,65342,1681,4,12,1326,1,3024,4.874.166.667
22/01/2016 15:00,30.24,65405,1813,5,12,1356,1,3187,4.874.166.667
22/01/2016 16:00,31.67,66446,1958,8,12,1361,2,3341,4.874.166.667
22/01/2016 17:00,35.85,67215,2128,12,12,1387,3,3542,4.874.166.667
22/01/2016 18:00,30.04,66341,2336,17,12,1446,3,3814,4.874.166.667
22/01/2016 19:00,26.78,64570,2483,22,13,1466,4,3988,4.874.166.667
22/01/2016 20:00,24.98,62468,2538,27,13,1509,4,4091,4.874.166.667
22/01/2016 21:00,24.76,60851,2539,32,14,1539,3,4127,4.874.166.667
22/01/2016 22:00,23.71,59009,2429,36,15,1626,4,4110,4.874.166.667
22/01/2016 23:00,22.7,56842,2200,0,16,1734,2,3952,4.874.166.667
23/01/2016 00:00,22.27,54435,1999,49,15,1904,3,3970,4.874.166.667
23/01/2016 01:00,21.9,53371,1706,51,18,1865,2,3642,4.874.166.667
23/01/2016 02:00,21.73,52760,1447,53,19,1831,2,3352,4.874.166.667
23/01/2016 03:00,21.84,52475,1189,53,19,1801,3,3065,4.874.166.667
23/01/2016 04:00,22.06,52604,933,54,21,1598,3,2609,4.874.166.667
23/01/2016 05:00,22.25,53175,710,53,21,1473,3,2260,4.874.166.667
23/01/2016 06:00,21.77,54180,553,55,20,1426,3,2057,4.874.166.667
23/01/2016 07:00,23.41,55524,437,57,19,1379,5,1897,4.874.166.667
23/01/2016 08:00,24.32,57232,342,63,20,1354,5,1784,4.874.166.667
23/01/2016 09:00,25.26,58683,287,69,23,1332,7,1718,4.874.166.667
23/01/2016 10:00,26.09,59720,276,72,29,1296,9,1682,4.874.166.667
23/01/2016 11:00,26.18,59776,297,71,33,1189,11,1601,4.874.166.667
23/01/2016 12:00,26.02,59341,344,69,37,1086,11,1547,4.874.166.667
23/01/2016 13:00,25.66,58847,386,70,41,1000,11,1508,4.874.166.667
23/01/2016 14:00,24.82,58728,416,73,44,917,10,1460,4.874.166.667
23/01/2016 15:00,25.88,59172,434,78,50,889,9,1460,4.874.166.667
23/01/2016 16:00,27.49,60441,463,82,53,878,8,1484,4.874.166.667
23/01/2016 17:00,31.81,61417,513,86,57,864,10,1530,4.874.166.667
23/01/2016 18:00,28.56,60671,551,91,62,885,11,1600,4.874.166.667
23/01/2016 19:00,26.09,58995,580,94,64,920,12,1670,4.874.166.667
23/01/2016 20:00,24.74,57193,622,100,66,924,13,1725,4.874.166.667
23/01/2016 21:00,23.9,55785,713,104,66,929,10,1822,4.874.166.667
23/01/2016 22:00,23.01,54193,835,107,65,963,10,1980,4.874.166.667
23/01/2016 23:00,22.91,52424,913,101,63,959,8,2044,4.874.166.667
24/01/2016 00:00,21.89,49161,1041,76,42,945,10,2114,4.874.166.667
24/01/2016 01:00,20.99,48679,1068,75,36,1023,10,2212,4.874.166.667
24/01/2016 02:00,20.76,48797,1104,74,30,1179,9,2396,4.874.166.667
24/01/2016 03:00,20.62,48509,1140,72,29,1225,9,2475,4.874.166.667
24/01/2016 04:00,20.71,48507,1120,75,30,1241,9,2475,4.874.166.667
24/01/2016 05:00,21.15,48814,1048,79,32,1280,11,2450,4.874.166.667
24/01/2016 06:00,20.94,49409,1029,84,33,1292,9,2447,4.874.166.667
24/01/2016 07:00,21.44,50564,1048,90,34,1285,9,2466,4.874.166.667
24/01/2016 08:00,22,51838,1006,94,34,1327,9,2470,4.874.166.667
24/01/2016 09:00,21.97,53204,960,99,32,1327,8,2426,4.874.166.667
24/01/2016 10:00,22.64,54257,952,95,29,1448,8,2532,4.874.166.667
24/01/2016 11:00,22.88,54689,973,91,26,1395,8,2493,4.874.166.667
24/01/2016 12:00,22.73,54600,993,82,25,1466,8,2574,4.874.166.667
24/01/2016 13:00,22.45,54319,949,72,28,1499,8,2556,4.874.166.667
24/01/2016 14:00,22.44,54212,845,64,34,1445,12,2400,4.874.166.667
24/01/2016 15:00,22.92,54921,761,64,39,1403,11,2278,4.874.166.667
24/01/2016 16:00,24.84,56503,719,68,43,1400,12,2242,4.874.166.667
24/01/2016 17:00,26.22,57650,711,65,48,1439,11,2274,4.874.166.667
24/01/2016 18:00,26.2,57312,716,60,54,1420,11,2261,4.874.166.667
24/01/2016 19:00,24.82,56310,704,54,58,1349,7,2172,4.874.166.667
24/01/2016 20:00,23.39,54845,664,50,62,1304,7,2087,4.874.166.667
24/01/2016 21:00,22.89,53606,633,47,66,1196,5,1947,4.874.166.667
24/01/2016 22:00,22.54,51747,610,43,69,1019,4,1745,4.874.166.667
24/01/2016 23:00,21.91,49635,577,38,70,964,5,1654,4.874.166.667
25/01/2016 00:00,19.99,48107,1299,20,93,859,4,2275,4.743.571.429
25/01/2016 01:00,19.6,47149,1305,18,89,754,3,2169,4.743.571.429
25/01/2016 02:00,19.63,46958,1268,15,81,646,2,2012,4.743.571.429
25/01/2016 03:00,19.96,47126,1205,13,72,532,2,1824,4.743.571.429
25/01/2016 04:00,21.13,48043,1083,11,63,464,1,1622,4.743.571.429
25/01/2016 05:00,22.52,50664,978,9,52,400,3,1442,4.743.571.429
25/01/2016 06:00,26.33,55299,934,8,39,345,2,1328,4.743.571.429
25/01/2016 07:00,38.63,59604,928,6,29,326,3,1292,4.743.571.429
25/01/2016 08:00,41.79,61331,965,5,21,316,3,1310,4.743.571.429
25/01/2016 09:00,34.75,60874,1016,4,16,336,3,1375,4.743.571.429
25/01/2016 10:00,34.71,60729,1031,3,13,389,2,1438,4.743.571.429
25/01/2016 11:00,31.6,60426,1059,3,11,445,2,1520,4.743.571.429
25/01/2016 12:00,27.5,59764,1131,3,9,570,3,1716,4.743.571.429
25/01/2016 13:00,34.71,59623,1186,3,8,690,3,1890,4.743.571.429
25/01/2016 14:00,27.66,59516,1245,5,8,855,1,2114,4.743.571.429
25/01/2016 15:00,26.94,59689,1363,5,8,1124,1,2501,4.743.571.429
25/01/2016 16:00,27.35,60405,1542,7,8,1463,2,3022,4.743.571.429
25/01/2016 17:00,28.01,61041,1744,8,8,1739,3,3502,4.743.571.429
25/01/2016 18:00,25.69,60151,1974,10,8,2006,4,4002,4.743.571.429
25/01/2016 19:00,23.73,58820,2232,12,9,2145,5,4403,4.743.571.429
25/01/2016 20:00,22.34,56854,2484,16,11,2364,6,4881,4.743.571.429
25/01/2016 21:00,21.84,55152,2690,23,14,2597,6,5330,4.743.571.429
25/01/2016 22:00,19.56,52573,2814,34,19,2833,6,5706,4.743.571.429
25/01/2016 23:00,18.11,49604,2890,46,25,2945,11,5917,4.743.571.429
26/01/2016 00:00,16.98,47433,2978,52,26,3227,8,6291,4.743.571.429
26/01/2016 01:00,16.44,46415,3058,68,39,3242,13,6420,4.743.571.429
26/01/2016 02:00,15.92,45968,3121,86,59,3248,16,6530,4.743.571.429
26/01/2016 03:00,15.93,46053,3156,111,74,3377,22,6740,4.743.571.429
26/01/2016 04:00,16.54,46905,3069,138,93,3483,26,6809,4.743.571.429
26/01/2016 05:00,17.56,49644,2931,162,109,3592,35,6829,4.743.571.429
26/01/2016 06:00,18.62,54036,2813,183,132,3714,38,6880,4.743.571.429
26/01/2016 07:00,19.37,58397,2561,200,143,3820,41,6765,4.743.571.429
26/01/2016 08:00,19.78,59936,2265,208,150,3875,44,6542,4.743.571.429
26/01/2016 09:00,19.79,59535,2064,214,153,3924,45,6400,4.743.571.429
26/01/2016 10:00,19.58,59305,1965,215,154,3905,43,6282,4.743.571.429
26/01/2016 11:00,19.5,58896,1977,211,155,3874,43,6260,4.743.571.429
26/01/2016 12:00,19.58,58089,2054,204,158,3894,40,6350,4.743.571.429
26/01/2016 13:00,19.55,57899,2199,196,166,3715,36,6312,4.743.571.429
26/01/2016 14:00,19.58,57879,2468,190,168,3377,29,6232,4.743.571.429
26/01/2016 15:00,19.63,58280,2808,182,166,3239,22,6417,4.743.571.429
26/01/2016 16:00,19.94,59405,3139,171,162,3181,17,6670,4.743.571.429
26/01/2016 17:00,20.26,60338,3460,163,159,3169,18,6969,4.743.571.429
26/01/2016 18:00,19.84,59540,3758,148,153,3110,17,7186,4.743.571.429
26/01/2016 19:00,19.06,58098,3960,134,148,3261,15,7518,4.743.571.429
26/01/2016 20:00,18.56,56282,4094,124,139,3422,15,7794,4.743.571.429
26/01/2016 21:00,18.33,54643,4203,116,136,3549,12,8016,4.743.571.429
26/01/2016 22:00,17.55,52293,4275,110,132,3617,8,8142,4.743.571.429
26/01/2016 23:00,16.09,49423,4307,99,128,3710,7,8251,4.743.571.429
27/01/2016 00:00,14.81,46828,4498,99,104,4000,10,8711,4.743.571.429
27/01/2016 01:00,14.47,45790,4482,98,105,4170,9,8864,4.743.571.429
27/01/2016 02:00,13.88,45348,4414,100,111,4152,8,8785,4.743.571.429
27/01/2016 03:00,14.07,45434,4326,109,121,4180,12,8748,4.743.571.429
27/01/2016 04:00,14.6,46227,4195,118,131,4159,14,8617,4.743.571.429
27/01/2016 05:00,16.15,48629,3961,131,148,4127,22,8389,4.743.571.429
27/01/2016 06:00,17.47,52826,3667,145,168,4019,27,8026,4.743.571.429
27/01/2016 07:00,18.39,56971,3364,156,182,3857,31,7590,4.743.571.429
27/01/2016 08:00,18.54,58216,3071,160,190,3746,33,7200,4.743.571.429
27/01/2016 09:00,18.41,57963,2858,162,198,3729,36,6983,4.743.571.429
27/01/2016 10:00,18.22,57664,2947,159,207,3719,37,7069,4.743.571.429
27/01/2016 11:00,18.2,57353,3311,148,214,3697,38,7408,4.743.571.429
27/01/2016 12:00,18.25,56716,3689,140,217,3637,39,7722,4.743.571.429
27/01/2016 13:00,18.21,56568,3942,142,219,3473,36,7812,4.743.571.429
27/01/2016 14:00,18.2,56412,4097,140,213,3323,37,7810,4.743.571.429
27/01/2016 15:00,18.2,56827,4184,137,203,3241,38,7803,4.743.571.429
27/01/2016 16:00,18.46,57566,4236,136,197,3199,31,7799,4.743.571.429
27/01/2016 17:00,18.67,58339,4261,134,188,3127,33,7743,4.743.571.429
27/01/2016 18:00,18.47,57480,4290,129,174,3103,28,7724,4.743.571.429
27/01/2016 19:00,17.95,56228,4303,129,165,3116,28,7741,4.743.571.429
27/01/2016 20:00,17.4,54342,4287,134,163,3058,34,7676,4.743.571.429
27/01/2016 21:00,17.28,52698,4263,141,164,3123,30,7721,4.743.571.429
27/01/2016 22:00,16.45,50266,4126,144,167,3112,34,7583,4.743.571.429
27/01/2016 23:00,15.07,47654,3759,142,172,3173,35,7281,4.743.571.429
28/01/2016 00:00,15.14,45142,4225,141,200,3138,43,7747,4.743.571.429
28/01/2016 01:00,14.66,44130,4038,145,204,3069,48,7504,4.743.571.429
28/01/2016 02:00,14.32,43871,3934,156,207,3100,49,7446,4.743.571.429
28/01/2016 03:00,14.31,44158,3892,170,208,3143,52,7465,4.743.571.429
28/01/2016 04:00,14.95,45203,3945,184,209,3189,51,7578,4.743.571.429
28/01/2016 05:00,17.07,47955,4074,196,210,3249,53,7782,4.743.571.429
28/01/2016 06:00,17.58,52482,4197,206,211,3383,53,8050,4.743.571.429
28/01/2016 07:00,18.11,56581,4240,215,217,3525,53,8250,4.743.571.429
28/01/2016 08:00,18.87,57591,4165,222,222,3689,51,8349,4.743.571.429
28/01/2016 09:00,18.56,57600,4082,226,225,3665,52,8250,4.743.571.429
28/01/2016 10:00,17.99,57554,4053,227,231,3712,52,8275,4.743.571.429
28/01/2016 11:00,17.84,57349,4038,224,235,3774,50,8321,4.743.571.429
28/01/2016 12:00,17.9,56668,3997,218,238,3968,54,8475,4.743.571.429
28/01/2016 13:00,17.9,56493,3902,214,241,3959,56,8372,4.743.571.429
28/01/2016 14:00,17.87,56360,3761,211,242,3995,55,8264,4.743.571.429
28/01/2016 15:00,17.94,56700,3580,211,241,4050,56,8138,4.743.571.429
28/01/2016 16:00,18.28,57906,3410,213,237,4121,56,8037,4.743.571.429
28/01/2016 17:00,19.01,58819,3321,215,231,4102,57,7926,4.743.571.429
28/01/2016 18:00,18.56,58167,3330,214,228,4038,58,7868,4.743.571.429
28/01/2016 19:00,17.77,57003,3383,216,228,3968,58,7853,4.743.571.429
28/01/2016 20:00,17.24,55279,3460,222,224,3942,58,7906,4.743.571.429
28/01/2016 21:00,17.22,53736,3551,228,218,3935,54,7986,4.743.571.429
28/01/2016 22:00,16.77,51490,3638,226,216,3965,51,8096,4.743.571.429
28/01/2016 23:00,16.06,48882,3719,222,210,4013,49,8213,4.743.571.429
29/01/2016 00:00,16.27,46258,3540,241,226,3984,41,8032,4.743.571.429
29/01/2016 01:00,15.79,45393,3608,240,219,4026,38,8131,4.743.571.429
29/01/2016 02:00,15.54,45043,3666,237,216,3997,38,8154,4.743.571.429
29/01/2016 03:00,15.69,45239,3674,233,212,3918,36,8073,4.743.571.429
29/01/2016 04:00,16.3,46124,3630,226,209,3801,33,7899,4.743.571.429
29/01/2016 05:00,17.26,48641,3552,217,205,3785,30,7789,4.743.571.429
29/01/2016 06:00,17.73,52824,3474,207,198,3782,27,7688,4.743.571.429
29/01/2016 07:00,18.37,56854,3530,195,195,3844,30,7794,4.743.571.429
29/01/2016 08:00,18.75,58100,3739,183,191,3940,30,8083,4.743.571.429
29/01/2016 09:00,18.51,57898,3988,171,189,4003,28,8379,4.743.571.429
29/01/2016 10:00,17.96,57883,4253,166,187,4100,30,8736,4.743.571.429
29/01/2016 11:00,17.7,57489,4469,164,183,4333,32,9181,4.743.571.429
29/01/2016 12:00,17.57,56727,4529,163,180,4365,37,9274,4.743.571.429
29/01/2016 13:00,17.32,55939,4522,163,178,4541,40,9444,4.743.571.429
29/01/2016 14:00,17.1,55542,4522,164,174,4760,40,9660,4.743.571.429
29/01/2016 15:00,16.98,55596,4526,170,174,4889,43,9802,4.743.571.429
29/01/2016 16:00,17.07,56386,4552,182,184,5126,48,10092,4.743.571.429
29/01/2016 17:00,17.26,57097,4546,196,194,5225,50,10211,4.743.571.429
29/01/2016 18:00,17.18,56223,4449,210,208,5278,54,10199,4.743.571.429
29/01/2016 19:00,16.44,54410,4322,224,219,5293,56,10114,4.743.571.429
29/01/2016 20:00,15.41,52370,4178,236,227,5242,57,9940,4.743.571.429
29/01/2016 21:00,15.28,50897,4044,244,231,5163,58,9740,4.743.571.429
29/01/2016 22:00,14.82,49178,3926,248,233,5128,55,9590,4.743.571.429
29/01/2016 23:00,13.09,47192,3819,248,234,4961,55,9317,4.743.571.429
30/01/2016 00:00,14.22,45250,3583,243,232,4852,0,8910,4.743.571.429
30/01/2016 01:00,13.67,44264,3549,241,228,4788,1,8807,4.743.571.429
30/01/2016 02:00,13.01,43759,3665,237,223,4710,1,8836,4.743.571.429
30/01/2016 03:00,11.7,43678,3808,232,214,4737,3,8994,4.743.571.429
30/01/2016 04:00,10.69,43917,3558,228,199,4823,3,8811,4.743.571.429
30/01/2016 05:00,11.71,44681,3574,226,188,4969,4,8961,4.743.571.429
30/01/2016 06:00,13.71,45934,3555,225,187,4959,4,8930,4.743.571.429
30/01/2016 07:00,14.25,47645,3790,222,190,4975,7,9184,4.743.571.429
30/01/2016 08:00,14.63,49595,3515,219,197,4953,9,8893,4.743.571.429
30/01/2016 09:00,14.97,50533,3228,216,203,4897,13,8557,4.743.571.429
30/01/2016 10:00,15.31,51527,3116,215,204,4836,18,8389,4.743.571.429
30/01/2016 11:00,15.39,51625,3119,214,203,4746,23,8305,4.743.571.429
30/01/2016 12:00,15.33,51469,3208,212,212,4586,25,8243,4.743.571.429
30/01/2016 13:00,15.09,51223,3245,212,218,4455,27,8157,4.743.571.429
30/01/2016 14:00,15.05,51145,3169,213,224,4397,24,8027,4.743.571.429
30/01/2016 15:00,15.37,51838,3133,212,229,4229,23,7826,4.743.571.429
30/01/2016 16:00,16.5,53381,3124,209,219,4185,22,7759,4.743.571.429
30/01/2016 17:00,17.67,54995,3185,201,203,4198,26,7813,4.743.571.429
30/01/2016 18:00,17.57,54591,3292,187,196,4051,28,7754,4.743.571.429
30/01/2016 19:00,17.19,53148,3443,173,187,4014,28,7845,4.743.571.429
30/01/2016 20:00,16.79,51430,3608,159,170,4002,28,7967,4.743.571.429
30/01/2016 21:00,16.21,50328,3790,143,162,4005,23,8123,4.743.571.429
30/01/2016 22:00,15.49,49013,3959,129,162,3990,22,8262,4.743.571.429
30/01/2016 23:00,14.77,47519,4076,117,141,3978,19,8331,4.743.571.429
31/01/2016 00:00,15.49,45546,3984,117,120,4093,12,8326,4.743.571.429
31/01/2016 01:00,15.28,44708,4072,107,100,4039,6,8324,4.743.571.429
31/01/2016 02:00,15.16,44258,4156,99,111,3974,4,8344,4.743.571.429
31/01/2016 03:00,15.12,44089,4236,94,121,3851,8,8310,4.743.571.429
31/01/2016 04:00,14.96,44187,3894,93,133,3771,11,7902,4.743.571.429
31/01/2016 05:00,15.21,44646,4262,96,140,3633,10,8141,4.743.571.429
31/01/2016 06:00,15.59,45447,4225,99,154,3428,11,7917,4.743.571.429
31/01/2016 07:00,15.81,46711,4136,101,165,3375,14,7791,4.743.571.429
31/01/2016 08:00,15.87,48115,4027,98,176,3309,13,7623,4.743.571.429
31/01/2016 09:00,16.21,49892,3917,98,191,3261,13,7480,4.743.571.429
31/01/2016 10:00,16.52,50946,3855,97,202,3255,16,7425,4.743.571.429
31/01/2016 11:00,16.63,51311,3833,98,209,3231,20,7391,4.743.571.429
31/01/2016 12:00,16.58,51125,3767,93,212,3199,26,7297,4.743.571.429
31/01/2016 13:00,16.43,50945,3680,90,216,3162,26,7174,4.743.571.429
31/01/2016 14:00,16.36,50889,3546,85,218,3151,26,7026,4.743.571.429
31/01/2016 15:00,16.68,51541,3351,82,219,3096,21,6769,4.743.571.429
31/01/2016 16:00,17.45,53248,3101,77,219,3108,18,6523,4.743.571.429
31/01/2016 17:00,18.63,54958,2837,71,220,3077,16,6221,4.743.571.429
31/01/2016 18:00,18.86,54911,2576,65,222,3050,11,5924,4.743.571.429
31/01/2016 19:00,18.64,54068,2316,58,221,3043,7,5645,4.743.571.429
31/01/2016 20:00,18.07,52684,2135,53,218,3050,7,5463,4.743.571.429
31/01/2016 21:00,17.73,51748,2006,53,215,2974,11,5259,4.743.571.429
31/01/2016 22:00,17.58,50092,1855,55,208,2969,13,5100,4.743.571.429
31/01/2016 23:00,16.47,48194,1664,57,197,3034,18,4970,4.743.571.429
01/02/2016 00:00,16.3,46494,1616,38,150,2891,32,4727,4.571.607.143
01/02/2016 01:00,15.43,45756,1413,34,144,2861,29,4481,4.571.607.143
01/02/2016 02:00,15.59,45593,1207,32,136,2908,27,4310,4.571.607.143
01/02/2016 03:00,15.77,45877,995,36,134,3042,21,4228,4.571.607.143
01/02/2016 04:00,16.6,46979,803,40,137,2976,19,3975,4.571.607.143
01/02/2016 05:00,17.96,49730,662,38,138,2858,19,3715,4.571.607.143
01/02/2016 06:00,19.96,54423,609,34,137,2805,16,3601,4.571.607.143
01/02/2016 07:00,30.54,58709,645,33,132,2811,15,3636,4.571.607.143
01/02/2016 08:00,31.97,59872,855,31,118,2718,14,3736,4.571.607.143
01/02/2016 09:00,26.42,59825,1300,32,107,2650,15,4104,4.571.607.143
01/02/2016 10:00,20.21,59758,1920,34,96,2659,13,4722,4.571.607.143
01/02/2016 11:00,19.11,59405,2730,35,89,2735,13,5602,4.571.607.143
01/02/2016 12:00,18.93,58692,3536,38,82,2805,17,6478,4.571.607.143
01/02/2016 13:00,18.93,58509,3972,39,80,2997,17,7105,4.571.607.143
01/02/2016 14:00,18.71,58449,4200,44,81,3275,16,7616,4.571.607.143
01/02/2016 15:00,18.42,58635,4411,57,81,3593,14,8156,4.571.607.143
01/02/2016 16:00,18.73,59448,4511,76,83,3735,13,8418,4.571.607.143
01/02/2016 17:00,19.07,60401,4540,97,102,3896,17,8652,4.571.607.143
01/02/2016 18:00,18.87,59631,4557,120,127,4078,26,8908,4.571.607.143
01/02/2016 19:00,18.04,58243,4550,138,137,4110,34,8969,4.571.607.143
01/02/2016 20:00,17.47,56261,4537,151,164,4032,34,8918,4.571.607.143
01/02/2016 21:00,16.79,54605,4521,163,194,4031,29,8938,4.571.607.143
01/02/2016 22:00,16.21,52119,4501,178,210,3940,35,8864,4.571.607.143
01/02/2016 23:00,15.41,49236,4509,192,219,3837,45,8802,4.571.607.143
02/02/2016 00:00,15.25,46852,4593,205,209,3799,49,8855,4.571.607.143
02/02/2016 01:00,14.54,46014,4596,214,231,3746,44,8831,4.571.607.143
02/02/2016 02:00,13.35,45645,4216,221,232,3641,48,8358,4.571.607.143
02/02/2016 03:00,13.13,45999,4205,226,236,3643,52,8362,4.571.607.143
02/02/2016 04:00,14.57,46982,4618,230,237,3601,54,8740,4.571.607.143
02/02/2016 05:00,16.15,49599,4630,229,238,3589,54,8740,4.571.607.143
02/02/2016 06:00,17.01,53614,4567,227,238,3597,54,8683,4.571.607.143
02/02/2016 07:00,18.66,57995,4507,226,238,3583,56,8610,4.571.607.143
02/02/2016 08:00,18.85,59360,4404,225,238,3492,55,8414,4.571.607.143
02/02/2016 09:00,18.71,59597,4276,224,239,3457,57,8253,4.571.607.143
02/02/2016 10:00,18.46,59177,4158,222,239,3414,57,8090,4.571.607.143
02/02/2016 11:00,18.38,58914,4042,219,239,3311,56,7867,4.571.607.143
02/02/2016 12:00,18.19,58158,3915,216,240,3254,57,7682,4.571.607.143
02/02/2016 13:00,18.36,58068,3878,214,240,3183,58,7573,4.571.607.143
02/02/2016 14:00,18.31,58008,3931,209,240,3120,56,7556,4.571.607.143
02/02/2016 15:00,18.5,58210,3974,207,237,3056,56,7530,4.571.607.143
02/02/2016 16:00,18.92,59003,4105,202,237,3030,56,7630,4.571.607.143
02/02/2016 17:00,19.5,59876,4318,198,237,3008,57,7818,4.571.607.143
02/02/2016 18:00,19.25,59081,4433,195,237,2984,58,7907,4.571.607.143
02/02/2016 19:00,18.34,57789,4495,194,240,2973,59,7961,4.571.607.143
02/02/2016 20:00,17.7,55942,4475,194,240,2958,59,7926,4.571.607.143
02/02/2016 21:00,17.18,54305,4357,196,240,3133,56,7982,4.571.607.143
02/02/2016 22:00,16.26,51957,4303,197,240,3140,56,7936,4.571.607.143
02/02/2016 23:00,15.69,49335,4267,198,241,3152,56,7914,4.571.607.143
03/02/2016 00:00,16.04,47063,4487,165,242,2998,55,7947,4.571.607.143
03/02/2016 01:00,15.69,46112,4547,151,243,3041,56,8038,4.571.607.143
03/02/2016 02:00,15.65,45864,4604,134,243,3109,56,8146,4.571.607.143
03/02/2016 03:00,15.71,46053,4584,117,243,3110,56,8110,4.571.607.143
03/02/2016 04:00,16.11,47087,4498,105,243,3076,55,7977,4.571.607.143
03/02/2016 05:00,17.14,49732,4350,96,243,3011,56,7756,4.571.607.143
03/02/2016 06:00,18.28,54275,4122,90,243,2917,55,7427,4.571.607.143
03/02/2016 07:00,20.06,58336,3853,85,243,2932,55,7168,4.571.607.143
03/02/2016 08:00,20.77,59023,3568,78,243,2824,55,6768,4.571.607.143
03/02/2016 09:00,20.57,59566,3294,74,243,2764,55,6430,4.571.607.143
03/02/2016 10:00,20.12,59098,3218,73,243,2560,53,6147,4.571.607.143
03/02/2016 11:00,19.78,58715,3300,72,243,2431,51,6097,4.571.607.143
03/02/2016 12:00,19.05,57739,3418,80,239,2325,52,6114,4.571.607.143
03/02/2016 13:00,19.38,57277,3496,89,238,2292,51,6166,4.571.607.143
03/02/2016 14:00,19.19,57090,3532,100,237,2248,45,6162,4.571.607.143
03/02/2016 15:00,18.96,57546,3545,114,226,2226,43,6154,4.571.607.143
03/02/2016 16:00,19.67,58709,3529,121,204,2438,39,6331,4.571.607.143
03/02/2016 17:00,20.43,59976,3542,122,180,2457,29,6330,4.571.607.143
03/02/2016 18:00,20.05,59540,3610,115,166,2481,27,6399,4.571.607.143
03/02/2016 19:00,18.91,58431,3664,107,149,2297,22,6239,4.571.607.143
03/02/2016 20:00,18.17,56673,3656,98,132,2672,14,6572,4.571.607.143
03/02/2016 21:00,17.77,55074,3665,92,119,2628,10,6514,4.571.607.143
03/02/2016 22:00,17.17,52811,3697,89,110,2765,11,6672,4.571.607.143
03/02/2016 23:00,16.61,50164,3678,82,106,2956,9,6831,4.571.607.143
04/02/2016 00:00,16.75,48094,3782,56,64,2977,4,6883,4.571.607.143
04/02/2016 01:00,16.36,47167,3735,51,54,3034,4,6878,4.571.607.143
04/02/2016 02:00,15.98,46925,3635,48,53,3156,4,6896,4.571.607.143
04/02/2016 03:00,15.27,47151,3518,44,51,3209,4,6826,4.571.607.143
04/02/2016 04:00,15.83,48090,3368,40,51,3270,4,6733,4.571.607.143
04/02/2016 05:00,17.37,50702,3183,39,57,3294,6,6579,4.571.607.143
04/02/2016 06:00,18.44,55043,2938,39,58,3304,7,6346,4.571.607.143
04/02/2016 07:00,20.28,59104,2696,40,59,3321,6,6122,4.571.607.143
04/02/2016 08:00,20.85,60075,2499,40,61,3159,7,5766,4.571.607.143
04/02/2016 09:00,20.53,60500,2322,39,62,3152,8,5583,4.571.607.143
04/02/2016 10:00,19.98,60183,2265,40,64,3136,6,5511,4.571.607.143
04/02/2016 11:00,19.62,59276,2330,41,72,3163,7,5613,4.571.607.143
04/02/2016 12:00,19.06,58351,2387,43,80,3151,11,5672,4.571.607.143
04/02/2016 13:00,19.14,58054,2380,46,83,3115,12,5636,4.571.607.143
04/02/2016 14:00,19.08,57974,2294,49,84,3110,12,5549,4.571.607.143
04/02/2016 15:00,19.28,58338,2160,52,85,3089,14,5400,4.571.607.143
04/02/2016 16:00,19.81,59304,2039,59,87,3134,11,5330,4.571.607.143
04/02/2016 17:00,20.95,60601,1901,67,86,3149,14,5217,4.571.607.143
04/02/2016 18:00,20.85,60240,1771,72,85,3130,18,5076,4.571.607.143
04/02/2016 19:00,19.85,59028,1633,76,84,3095,18,4906,4.571.607.143
04/02/2016 20:00,18.95,57267,1454,81,84,3046,18,4683,4.571.607.143
04/02/2016 21:00,18.63,55729,1291,85,84,2948,14,4422,4.571.607.143
04/02/2016 22:00,18.08,53562,1189,91,80,2874,17,4251,4.571.607.143
04/02/2016 23:00,17.54,50982,1111,95,79,2820,12,4117,4.571.607.143
05/02/2016 00:00,17.73,49204,1077,95,98,2717,10,3997,4.571.607.143
05/02/2016 01:00,17.6,48306,998,102,97,2618,10,3825,4.571.607.143
05/02/2016 02:00,17.57,47956,955,108,97,2555,11,3726,4.571.607.143
05/02/2016 03:00,17.84,48065,958,114,100,2433,7,3612,4.571.607.143
05/02/2016 04:00,18.27,48945,947,118,103,2342,12,3522,4.571.607.143
05/02/2016 05:00,19.03,51451,852,122,105,2221,18,3318,4.571.607.143
05/02/2016 06:00,20.6,55733,777,125,106,2155,18,3181,4.571.607.143
05/02/2016 07:00,35.2,59765,762,129,116,2122,19,3148,4.571.607.143
05/02/2016 08:00,39.02,60567,800,133,124,1954,17,3028,4.571.607.143
05/02/2016 09:00,38.36,60249,905,137,127,1789,22,2980,4.571.607.143
05/02/2016 10:00,27.94,60178,982,138,131,1533,27,2811,4.571.607.143
05/02/2016 11:00,24.19,59563,1050,136,139,1314,32,2671,4.571.607.143
05/02/2016 12:00,21.83,58632,1148,131,141,1171,36,2627,4.571.607.143
05/02/2016 13:00,21.3,57753,1224,123,145,1009,33,2534,4.571.607.143
05/02/2016 14:00,20.86,57180,1303,111,140,876,30,2460,4.571.607.143
05/02/2016 15:00,20.96,57301,1387,99,136,825,26,2473,4.571.607.143
05/02/2016 16:00,22.77,58363,1354,90,123,791,19,2377,4.571.607.143
05/02/2016 17:00,30.78,59557,1291,80,108,837,14,2330,4.571.607.143
05/02/2016 18:00,25.57,59084,1287,69,95,892,14,2357,4.571.607.143
05/02/2016 19:00,20.58,57375,1393,58,88,1006,13,2558,4.571.607.143
05/02/2016 20:00,19.52,55215,1548,46,78,1186,10,2868,4.571.607.143
05/02/2016 21:00,18.96,53759,1717,34,68,1340,7,3166,4.571.607.143
05/02/2016 22:00,18.23,51967,1885,25,50,1583,6,3549,4.571.607.143
05/02/2016 23:00,17.56,49830,2056,17,46,1836,3,3958,4.571.607.143
06/02/2016 00:00,17.11,47697,2424,15,32,2143,0,4614,4.571.607.143
06/02/2016 01:00,16.24,46629,2647,13,25,2342,1,5028,4.571.607.143
06/02/2016 02:00,16.04,45962,2858,12,21,2504,1,5396,4.571.607.143
06/02/2016 03:00,15.01,45684,3045,11,21,2528,3,5608,4.571.607.143
06/02/2016 04:00,14.63,45734,3227,15,25,2616,3,5886,4.571.607.143
06/02/2016 05:00,14.94,46407,3421,23,32,2818,4,6298,4.571.607.143
06/02/2016 06:00,15.48,47570,3580,36,44,3055,4,6719,4.571.607.143
06/02/2016 07:00,16.34,49132,3634,48,58,3281,7,7028,4.571.607.143
06/02/2016 08:00,16.56,50758,3588,59,72,3451,9,7179,4.571.607.143
06/02/2016 09:00,16.87,52227,3504,69,84,3595,13,7265,4.571.607.143
06/02/2016 10:00,17,53201,3323,81,88,3708,18,7218,4.571.607.143
06/02/2016 11:00,16.76,53243,3086,95,87,3846,23,7137,4.571.607.143
06/02/2016 12:00,16.32,52845,2906,111,83,3860,25,6985,4.571.607.143
06/02/2016 13:00,15.83,52363,2812,126,77,3789,27,6831,4.571.607.143
06/02/2016 14:00,15.63,52170,2794,141,73,3659,24,6691,4.571.607.143
06/02/2016 15:00,16.02,52467,2791,153,75,3508,23,6550,4.571.607.143
06/02/2016 16:00,16.87,54009,2795,163,86,3263,22,6329,4.571.607.143
06/02/2016 17:00,18.13,55523,2823,170,98,3065,26,6182,4.571.607.143
06/02/2016 18:00,18.06,55029,2876,176,113,2970,28,6163,4.571.607.143
06/02/2016 19:00,17.39,53282,2952,181,125,2854,28,6140,4.571.607.143
06/02/2016 20:00,16.17,51388,3013,183,132,2713,28,6069,4.571.607.143
06/02/2016 21:00,15.94,50101,3015,185,138,2585,23,5946,4.571.607.143
06/02/2016 22:00,15.47,48538,2954,187,142,2570,22,5875,4.571.607.143
06/02/2016 23:00,14.94,46867,2869,186,140,2561,19,5775,4.571.607.143
07/02/2016 00:00,14.57,44946,3035,157,125,2419,24,5760,4.571.607.143
07/02/2016 01:00,14.1,43953,3026,151,126,2316,24,5643,4.571.607.143
07/02/2016 02:00,13.96,43389,3046,149,123,2196,24,5538,4.571.607.143
07/02/2016 03:00,13.66,43189,3080,147,117,2186,25,5555,4.571.607.143
07/02/2016 04:00,13.35,43278,3146,146,112,2102,26,5532,4.571.607.143
07/02/2016 05:00,13.41,43735,3220,142,106,2160,24,5652,4.571.607.143
07/02/2016 06:00,13.61,44352,3265,137,102,2335,24,5863,4.571.607.143
07/02/2016 07:00,14.49,45485,3329,132,96,2612,22,6191,4.571.607.143
07/02/2016 08:00,14.67,46495,3431,129,96,2651,22,6329,4.571.607.143
07/02/2016 09:00,15.25,48179,3528,127,97,2795,25,6572,4.571.607.143
07/02/2016 10:00,15.48,49332,3524,127,102,3014,24,6791,4.571.607.143
07/02/2016 11:00,15.48,49672,3400,129,106,3124,26,6785,4.571.607.143
07/02/2016 12:00,15.29,49505,3260,128,105,3206,27,6726,4.571.607.143
07/02/2016 13:00,15.05,49102,3159,124,104,3321,25,6733,4.571.607.143
07/02/2016 14:00,14.86,48793,3090,122,109,3386,23,6730,4.571.607.143
07/02/2016 15:00,14.92,49309,3098,119,124,3463,19,6823,4.571.607.143
07/02/2016 16:00,15.09,51072,3152,118,139,3560,16,6985,4.571.607.143
07/02/2016 17:00,16.51,53061,3245,122,150,3617,21,7155,4.571.607.143
07/02/2016 18:00,17.24,53325,3373,131,158,3709,30,7401,4.571.607.143
07/02/2016 19:00,16.82,52337,3509,142,163,3721,37,7572,4.571.607.143
07/02/2016 20:00,16.24,50785,3608,154,160,3754,40,7716,4.571.607.143
07/02/2016 21:00,15.47,49648,3669,163,154,3792,36,7814,4.571.607.143
07/02/2016 22:00,15.25,47761,3707,168,152,3823,32,7882,4.571.607.143
07/02/2016 23:00,14.13,45615,3744,169,148,3840,27,7928,4.571.607.143
08/02/2016 00:00,12.41,43675,3714,184,135,3975,27,8035,4.353.869.048
08/02/2016 01:00,10.51,42953,3847,183,132,3976,29,8167,4.353.869.048
08/02/2016 02:00,11.08,42799,4005,182,124,4077,30,8418,4.353.869.048
08/02/2016 03:00,10.43,43035,4158,179,117,4141,28,8623,4.353.869.048
08/02/2016 04:00,12.83,44034,4294,177,109,4204,30,8814,4.353.869.048
08/02/2016 05:00,14.64,46724,4397,176,102,4275,31,8981,4.353.869.048
08/02/2016 06:00,15.79,51599,4464,173,95,4331,29,9092,4.353.869.048
08/02/2016 07:00,16.88,55972,4490,171,88,4357,28,9134,4.353.869.048
08/02/2016 08:00,17.23,56935,4463,168,83,4388,29,9131,4.353.869.048
08/02/2016 09:00,17.04,56683,4419,161,79,4453,22,9134,4.353.869.048
08/02/2016 10:00,17,56818,4357,155,80,4506,15,9113,4.353.869.048
08/02/2016 11:00,17.01,56663,4269,148,86,4579,16,9098,4.353.869.048
08/02/2016 12:00,16.71,56280,4176,142,97,4552,22,8989,4.353.869.048
08/02/2016 13:00,16.63,56213,4046,138,111,4435,26,8756,4.353.869.048
08/02/2016 14:00,16.66,56151,3905,139,131,4226,28,8429,4.353.869.048
08/02/2016 15:00,16.98,56181,3738,141,157,4010,29,8075,4.353.869.048
08/02/2016 16:00,17.03,56819,3583,147,175,3928,29,7862,4.353.869.048
08/02/2016 17:00,18.1,57911,3510,155,188,3811,29,7693,4.353.869.048
08/02/2016 18:00,17.98,57319,3515,164,198,3779,32,7688,4.353.869.048
08/02/2016 19:00,17.46,55870,3533,171,203,3685,39,7631,4.353.869.048
08/02/2016 20:00,16.23,53962,3570,176,203,3564,40,7553,4.353.869.048
08/02/2016 21:00,15.63,52344,3558,180,204,3375,39,7356,4.353.869.048
08/02/2016 22:00,15.07,49840,3446,183,205,3305,39,7178,4.353.869.048
08/02/2016 23:00,14.15,46991,3291,186,204,3192,38,6911,4.353.869.048
09/02/2016 00:00,14,44773,2545,193,184,3169,37,6128,4.353.869.048
09/02/2016 01:00,13.71,43778,2396,197,175,2990,34,5792,4.353.869.048
09/02/2016 02:00,12.94,43363,2402,201,169,2913,33,5718,4.353.869.048
09/02/2016 03:00,12.72,43502,2497,202,155,2807,38,5699,4.353.869.048
09/02/2016 04:00,14.16,44480,2900,201,151,2648,37,5937,4.353.869.048
09/02/2016 05:00,15.73,47132,2850,198,158,2542,35,5783,4.353.869.048
09/02/2016 06:00,17.06,51968,2821,194,169,2486,26,5696,4.353.869.048
09/02/2016 07:00,18.37,56285,2899,189,182,2423,21,5714,4.353.869.048
09/02/2016 08:00,18.45,56593,3012,186,192,2396,22,5808,4.353.869.048
09/02/2016 09:00,18.36,56456,3100,184,196,2424,25,5929,4.353.869.048
09/02/2016 10:00,18.06,56353,3162,187,201,2401,32,5983,4.353.869.048
09/02/2016 11:00,17.95,56153,3201,191,203,2359,36,5990,4.353.869.048
09/02/2016 12:00,17.85,55763,3270,197,200,2347,44,6058,4.353.869.048
09/02/2016 13:00,18.14,55692,3217,202,196,2288,44,5947,4.353.869.048
09/02/2016 14:00,18.16,55448,2874,205,187,2156,44,5466,4.353.869.048
09/02/2016 15:00,18.33,55528,2473,206,176,2027,46,4928,4.353.869.048
09/02/2016 16:00,18.71,56550,2024,205,163,1834,47,4273,4.353.869.048
09/02/2016 17:00,19.83,57803,1635,205,149,1711,47,3747,4.353.869.048
09/02/2016 18:00,19.86,57210,1362,203,137,1604,48,3354,4.353.869.048
09/02/2016 19:00,18.88,55928,1118,201,127,1484,46,2976,4.353.869.048
09/02/2016 20:00,18.53,54059,916,197,120,1355,41,2629,4.353.869.048
09/02/2016 21:00,18.2,52419,757,192,115,1225,30,2319,4.353.869.048
09/02/2016 22:00,17.82,50126,619,186,109,1068,21,2003,4.353.869.048
09/02/2016 23:00,16.5,47275,474,178,116,1011,16,1795,4.353.869.048
10/02/2016 00:00,16.4,45216,502,162,137,1085,8,1894,4.353.869.048
10/02/2016 01:00,16.04,44173,477,153,152,1107,12,1901,4.353.869.048
10/02/2016 02:00,16.04,43828,523,146,165,1132,15,1981,4.353.869.048
10/02/2016 03:00,16.03,43997,624,137,174,1097,20,2052,4.353.869.048
10/02/2016 04:00,16.29,44865,694,127,176,1119,21,2137,4.353.869.048
10/02/2016 05:00,17.16,47472,745,119,173,1152,30,2219,4.353.869.048
10/02/2016 06:00,18.88,52107,867,117,169,1172,32,2357,4.353.869.048
10/02/2016 07:00,20.63,56343,893,122,157,1252,31,2455,4.353.869.048
10/02/2016 08:00,21.35,56758,847,132,150,1332,30,2491,4.353.869.048
10/02/2016 09:00,21.52,56628,834,145,147,1400,32,2558,4.353.869.048
10/02/2016 10:00,21.04,56607,822,157,139,1421,30,2569,4.353.869.048
10/02/2016 11:00,20.73,56407,813,166,127,1448,27,2581,4.353.869.048
10/02/2016 12:00,20.13,55889,832,172,105,1460,29,2598,4.353.869.048
10/02/2016 13:00,20.33,55758,817,178,89,1492,27,2603,4.353.869.048
10/02/2016 14:00,20.7,55579,731,178,68,1536,25,2538,4.353.869.048
10/02/2016 15:00,20.48,55787,620,177,41,1515,24,2377,4.353.869.048
10/02/2016 16:00,21.53,56704,520,177,36,1491,23,2247,4.353.869.048
10/02/2016 17:00,30.67,57935,471,174,33,1465,24,2167,4.353.869.048
10/02/2016 18:00,30.06,57562,461,168,28,1406,28,2091,4.353.869.048
10/02/2016 19:00,20.82,56286,480,162,25,1360,28,2055,4.353.869.048
10/02/2016 20:00,19.45,54438,493,156,27,1322,27,2025,4.353.869.048
10/02/2016 21:00,18.92,52865,481,150,30,1310,25,1996,4.353.869.048
10/02/2016 22:00,18,50571,469,139,29,1309,17,1963,4.353.869.048
10/02/2016 23:00,17.19,47809,458,125,25,1280,14,1902,4.353.869.048
11/02/2016 00:00,17.71,45788,100,113,20,1211,2,1446,4.353.869.048
11/02/2016 01:00,17.46,44814,96,100,21,1234,1,1452,4.353.869.048
11/02/2016 02:00,16.91,44436,98,93,23,1281,1,1496,4.353.869.048
11/02/2016 03:00,16.97,44595,103,83,24,1277,0,1487,4.353.869.048
11/02/2016 04:00,17.75,45503,110,80,24,1320,0,1534,4.353.869.048
11/02/2016 05:00,18.43,48116,111,78,24,1373,2,1588,4.353.869.048
11/02/2016 06:00,19.99,52535,126,77,25,1429,1,1658,4.353.869.048
11/02/2016 07:00,22.72,56742,150,72,26,1440,1,1689,4.353.869.048
11/02/2016 08:00,23.97,57581,166,67,28,1447,2,1710,4.353.869.048
11/02/2016 09:00,22.73,57824,175,64,31,1579,3,1852,4.353.869.048
11/02/2016 10:00,21.09,57906,178,59,37,1595,2,1871,4.353.869.048
11/02/2016 11:00,20.65,57633,191,55,42,1718,1,2007,4.353.869.048
11/02/2016 12:00,20.29,56996,218,52,45,1767,3,2085,4.353.869.048
11/02/2016 13:00,20.42,56760,249,50,47,1827,3,2176,4.353.869.048
11/02/2016 14:00,20.26,56563,273,49,49,1814,2,2187,4.353.869.048
11/02/2016 15:00,20.33,56756,286,51,50,1902,3,2292,4.353.869.048
11/02/2016 16:00,20.95,57698,282,54,50,1944,3,2333,4.353.869.048
11/02/2016 17:00,26.01,59190,290,55,52,2026,5,2428,4.353.869.048
11/02/2016 18:00,31.61,58877,325,57,53,2113,6,2554,4.353.869.048
11/02/2016 19:00,20.96,57684,339,59,54,2226,8,2686,4.353.869.048
11/02/2016 20:00,19.93,55855,323,60,54,2323,11,2771,4.353.869.048
11/02/2016 21:00,19.53,54345,322,61,53,2356,14,2806,4.353.869.048
11/02/2016 22:00,18.63,52023,344,60,51,2381,16,2852,4.353.869.048
11/02/2016 23:00,17.88,49256,369,59,50,2398,21,2897,4.353.869.048
12/02/2016 00:00,17.91,47027,235,62,67,2590,5,2959,4.353.869.048
12/02/2016 01:00,17.7,46201,246,62,64,2573,6,2951,4.353.869.048
12/02/2016 02:00,17.6,45838,251,61,58,2614,9,2993,4.353.869.048
12/02/2016 03:00,17.74,46020,258,60,53,2687,8,3066,4.353.869.048
12/02/2016 04:00,18.13,46985,266,61,50,2707,11,3095,4.353.869.048
12/02/2016 05:00,18.95,49626,265,64,48,2703,14,3094,4.353.869.048
12/02/2016 06:00,20.35,54268,272,70,48,2712,18,3120,4.353.869.048
12/02/2016 07:00,30.27,58656,271,76,52,2656,20,3075,4.353.869.048
12/02/2016 08:00,32.53,59998,266,84,59,2622,20,3051,4.353.869.048
12/02/2016 09:00,28.67,59832,266,94,68,2594,23,3045,4.353.869.048
12/02/2016 10:00,24.69,59774,258,102,72,2583,21,3036,4.353.869.048
12/02/2016 11:00,23.17,59201,251,114,75,2499,20,2959,4.353.869.048
12/02/2016 12:00,21.7,58365,240,130,73,2528,19,2990,4.353.869.048
12/02/2016 13:00,22.27,57523,223,143,69,2486,16,2937,4.353.869.048
12/02/2016 14:00,20.87,56954,205,152,63,2469,14,2903,4.353.869.048
12/02/2016 15:00,20.48,56977,189,152,59,2467,13,2880,4.353.869.048
12/02/2016 16:00,21.55,57709,178,149,55,2464,10,2856,4.353.869.048
12/02/2016 17:00,28.61,58899,173,141,50,2404,8,2776,4.353.869.048
12/02/2016 18:00,24.63,58748,179,125,44,2383,6,2737,4.353.869.048
12/02/2016 19:00,20.59,57174,182,108,40,2356,4,2690,4.353.869.048
12/02/2016 20:00,19.47,54953,179,94,38,2302,4,2617,4.353.869.048
12/02/2016 21:00,19.15,53497,181,82,37,2181,4,2485,4.353.869.048
12/02/2016 22:00,18.51,51686,182,74,39,2087,3,2385,4.353.869.048
12/02/2016 23:00,17.99,49586,181,69,43,2003,3,2299,4.353.869.048
13/02/2016 00:00,18.42,47745,116,67,39,1947,5,2174,4.353.869.048
13/02/2016 01:00,18.07,46789,130,66,36,1862,6,2100,4.353.869.048
13/02/2016 02:00,17.79,46288,140,63,32,1776,5,2016,4.353.869.048
13/02/2016 03:00,17.84,46249,148,65,29,1705,6,1953,4.353.869.048
13/02/2016 04:00,17.92,46530,151,71,28,1631,6,1887,4.353.869.048
13/02/2016 05:00,18.13,47355,153,75,28,1519,3,1778,4.353.869.048
13/02/2016 06:00,17.91,48715,163,79,31,1380,3,1656,4.353.869.048
13/02/2016 07:00,18.22,50423,175,79,33,1298,3,1588,4.353.869.048
13/02/2016 08:00,18.56,52280,190,75,37,1176,2,1480,4.353.869.048
13/02/2016 09:00,19.15,54031,196,73,45,1093,2,1409,4.353.869.048
13/02/2016 10:00,19.31,54856,194,70,47,961,2,1274,4.353.869.048
13/02/2016 11:00,19.23,54669,187,64,46,922,3,1222,4.353.869.048
13/02/2016 12:00,19.06,54125,183,57,46,905,3,1194,4.353.869.048
13/02/2016 13:00,18.86,53549,178,51,44,837,4,1114,4.353.869.048
13/02/2016 14:00,18.82,53211,180,48,40,782,6,1056,4.353.869.048
13/02/2016 15:00,18.98,53303,194,47,38,760,7,1046,4.353.869.048
13/02/2016 16:00,19.47,54807,227,49,37,729,8,1050,4.353.869.048
13/02/2016 17:00,21.58,56791,273,54,40,735,9,1111,4.353.869.048
13/02/2016 18:00,21.5,56870,335,62,41,725,8,1171,4.353.869.048
13/02/2016 19:00,19.98,55276,401,66,44,754,8,1273,4.353.869.048
13/02/2016 20:00,19.12,53413,442,74,42,776,6,1340,4.353.869.048
13/02/2016 21:00,18.62,52221,458,81,39,805,5,1388,4.353.869.048
13/02/2016 22:00,18.2,50771,457,84,37,780,4,1362,4.353.869.048
13/02/2016 23:00,17.26,49063,461,81,33,745,3,1323,4.353.869.048
14/02/2016 00:00,17.14,47794,755,103,25,659,2,1544,4.353.869.048
14/02/2016 01:00,16.77,46833,876,103,23,595,1,1598,4.353.869.048
14/02/2016 02:00,16.55,46319,1038,100,21,629,2,1790,4.353.869.048
14/02/2016 03:00,16.49,46171,1208,96,20,579,2,1905,4.353.869.048
14/02/2016 04:00,16.62,46334,1387,91,23,597,2,2100,4.353.869.048
14/02/2016 05:00,16.83,46850,1564,88,26,620,1,2299,4.353.869.048
14/02/2016 06:00,16.94,47581,1714,85,31,613,1,2444,4.353.869.048
14/02/2016 07:00,16.91,48676,1813,83,36,602,1,2535,4.353.869.048
14/02/2016 08:00,17.13,50252,1850,79,37,584,1,2551,4.353.869.048
14/02/2016 09:00,17.55,51970,1860,75,37,570,1,2543,4.353.869.048
14/02/2016 10:00,17.69,52952,1886,69,37,563,1,2556,4.353.869.048
14/02/2016 11:00,17.84,53242,1918,62,38,560,1,2579,4.353.869.048
14/02/2016 12:00,17.69,52878,1959,55,38,557,1,2610,4.353.869.048
14/02/2016 13:00,17.35,52431,1999,47,38,563,1,2648,4.353.869.048
14/02/2016 14:00,17.23,52203,2047,40,37,592,0,2716,4.353.869.048
14/02/2016 15:00,17.42,52430,2134,34,37,642,0,2847,4.353.869.048
14/02/2016 16:00,17.74,53807,2203,30,37,700,3,2973,4.353.869.048
14/02/2016 17:00,18.62,56006,2223,28,36,764,2,3053,4.353.869.048
14/02/2016 18:00,19.34,56491,2222,26,36,810,3,3097,4.353.869.048
14/02/2016 19:00,18.8,55635,2171,23,38,825,2,3059,4.353.869.048
14/02/2016 20:00,18.28,54305,2076,20,37,847,2,2982,4.353.869.048
14/02/2016 21:00,18.01,53413,2001,16,35,894,0,2946,4.353.869.048
14/02/2016 22:00,17.81,51675,1955,13,32,959,0,2959,4.353.869.048
14/02/2016 23:00,17.52,49729,1931,10,28,1035,0,3004,4.353.869.048
15/02/2016 00:00,17.13,48068,1469,8,17,1062,0,2556,4.113.809.524
15/02/2016 01:00,16.53,47287,1427,6,15,1116,0,2564,4.113.809.524
15/02/2016 02:00,15.97,47120,1406,5,14,1141,0,2566,4.113.809.524
15/02/2016 03:00,16.23,47473,1388,5,15,1151,1,2560,4.113.809.524
15/02/2016 04:00,16.98,48522,1332,5,16,1246,1,2600,4.113.809.524
15/02/2016 05:00,17.84,51403,1254,4,20,1330,1,2609,4.113.809.524
15/02/2016 06:00,18.99,56576,1188,5,23,1401,2,2619,4.113.809.524
15/02/2016 07:00,36.86,60987,1164,5,27,1511,2,2709,4.113.809.524
15/02/2016 08:00,38.67,62432,1172,5,30,1626,2,2835,4.113.809.524
15/02/2016 09:00,33.46,61862,1195,6,31,1671,4,2907,4.113.809.524
15/02/2016 10:00,32.09,61766,1256,8,33,1701,2,3000,4.113.809.524
15/02/2016 11:00,24.73,61147,1339,11,38,1636,2,3026,4.113.809.524
15/02/2016 12:00,21.21,60254,1441,13,45,1638,2,3139,4.113.809.524
15/02/2016 13:00,21.34,59740,1499,14,54,1568,4,3139,4.113.809.524
15/02/2016 14:00,20.74,59252,1486,16,60,1722,6,3290,4.113.809.524
15/02/2016 15:00,20.73,59004,1437,17,66,1831,10,3361,4.113.809.524
15/02/2016 16:00,22.11,59588,1349,18,71,1927,12,3377,4.113.809.524
15/02/2016 17:00,30.15,61428,1249,19,75,2012,11,3366,4.113.809.524
15/02/2016 18:00,30.45,61495,1162,21,84,2177,11,3455,4.113.809.524
15/02/2016 19:00,22.01,60146,1053,23,92,2351,11,3530,4.113.809.524
15/02/2016 20:00,19.9,58405,895,26,94,2398,16,3429,4.113.809.524
15/02/2016 21:00,18.94,56977,703,31,98,2335,21,3188,4.113.809.524
15/02/2016 22:00,18.51,54750,531,36,103,2296,20,2986,4.113.809.524
15/02/2016 23:00,17.91,52170,413,40,105,2316,21,2895,4.113.809.524
16/02/2016 00:00,18.22,50815,318,39,107,2284,8,2756,4.113.809.524
16/02/2016 01:00,18.14,50039,238,40,105,2189,9,2581,4.113.809.524
16/02/2016 02:00,18.09,49767,191,41,99,2101,9,2441,4.113.809.524
16/02/2016 03:00,18.26,50034,168,44,91,2060,10,2373,4.113.809.524
16/02/2016 04:00,18.65,51041,157,48,86,2015,11,2317,4.113.809.524
16/02/2016 05:00,19.15,53755,145,53,81,1979,12,2270,4.113.809.524
16/02/2016 06:00,24.01,58359,141,57,75,1941,11,2225,4.113.809.524
16/02/2016 07:00,38.73,62464,142,59,73,1756,10,2040,4.113.809.524
16/02/2016 08:00,42.3,63427,152,59,72,1554,9,1846,4.113.809.524
16/02/2016 09:00,42.82,62688,175,60,73,1370,9,1687,4.113.809.524
16/02/2016 10:00,37.31,62035,195,61,68,1147,9,1480,4.113.809.524
16/02/2016 11:00,37.07,60996,202,64,59,951,10,1286,4.113.809.524
16/02/2016 12:00,31.26,59842,217,68,55,890,10,1240,4.113.809.524
16/02/2016 13:00,30.39,59199,255,73,48,834,10,1220,4.113.809.524
16/02/2016 14:00,26.38,58753,324,78,44,819,9,1274,4.113.809.524
16/02/2016 15:00,23.88,58746,404,82,40,830,8,1364,4.113.809.524
16/02/2016 16:00,27.6,59607,479,83,34,976,5,1577,4.113.809.524
16/02/2016 17:00,38.8,62030,569,78,28,1388,4,2067,4.113.809.524
16/02/2016 18:00,36.25,62342,729,70,22,1667,4,2492,4.113.809.524
16/02/2016 19:00,22.97,61239,899,63,19,1775,4,2760,4.113.809.524
16/02/2016 20:00,19.65,59464,1019,57,15,1961,4,3056,4.113.809.524
16/02/2016 21:00,18.82,57897,1116,52,14,2109,4,3295,4.113.809.524
16/02/2016 22:00,18.25,55538,1216,49,12,2267,3,3547,4.113.809.524
16/02/2016 23:00,17.54,52773,1339,47,11,2380,4,3781,4.113.809.524
17/02/2016 00:00,17.42,49757,1704,52,7,2753,2,4518,4.113.809.524
17/02/2016 01:00,17.18,48927,1760,52,7,2928,3,4750,4.113.809.524
17/02/2016 02:00,16.99,48600,1796,54,7,3021,3,4881,4.113.809.524
17/02/2016 03:00,17.15,48699,1833,55,8,3107,3,5006,4.113.809.524
17/02/2016 04:00,17.55,49492,1844,57,9,3103,3,5016,4.113.809.524
17/02/2016 05:00,18.17,52088,1841,61,11,3091,3,5007,4.113.809.524
17/02/2016 06:00,18.75,56745,1879,67,11,3017,4,4978,4.113.809.524
17/02/2016 07:00,20.76,60732,1908,69,11,2952,4,4944,4.113.809.524
17/02/2016 08:00,21.4,61213,1958,70,11,2862,4,4905,4.113.809.524
17/02/2016 09:00,20.59,60662,2047,72,10,2803,5,4937,4.113.809.524
17/02/2016 10:00,19.62,60364,2084,69,12,2717,2,4884,4.113.809.524
17/02/2016 11:00,18.99,59838,2081,67,14,2621,2,4785,4.113.809.524
17/02/2016 12:00,18.83,59007,2117,63,16,2449,3,4648,4.113.809.524
17/02/2016 13:00,18.87,58636,2077,61,19,2365,2,4524,4.113.809.524
17/02/2016 14:00,18.77,58267,1947,62,29,2343,1,4382,4.113.809.524
17/02/2016 15:00,18.78,58222,1858,65,41,2326,2,4292,4.113.809.524
17/02/2016 16:00,18.92,59372,1860,68,59,2400,2,4389,4.113.809.524
17/02/2016 17:00,20.01,61109,1932,71,86,2559,6,4654,4.113.809.524
17/02/2016 18:00,20.38,61361,2027,71,119,2744,10,4971,4.113.809.524
17/02/2016 19:00,18.95,60041,2017,69,144,2878,9,5117,4.113.809.524
17/02/2016 20:00,18.47,58271,1820,65,165,2917,11,4978,4.113.809.524
17/02/2016 21:00,18.2,56733,1525,60,183,2927,13,4708,4.113.809.524
17/02/2016 22:00,17.84,54426,1188,54,206,2817,13,4278,4.113.809.524
17/02/2016 23:00,17.44,51738,867,49,231,2666,16,3829,4.113.809.524
18/02/2016 00:00,18,49591,709,56,275,2538,26,3604,4.113.809.524
18/02/2016 01:00,18.11,48560,523,62,273,2365,30,3253,4.113.809.524
18/02/2016 02:00,18.12,48139,382,71,274,2178,33,2938,4.113.809.524
18/02/2016 03:00,18.37,48301,279,83,272,1956,37,2627,4.113.809.524
18/02/2016 04:00,19.01,49196,226,101,267,1805,36,2435,4.113.809.524
18/02/2016 05:00,19.66,51759,187,118,267,1728,36,2336,4.113.809.524
18/02/2016 06:00,21.93,56226,164,133,263,1590,36,2186,4.113.809.524
18/02/2016 07:00,34.69,60192,164,144,255,1484,35,2082,4.113.809.524
18/02/2016 08:00,38.65,60983,209,149,245,1448,34,2085,4.113.809.524
18/02/2016 09:00,34.68,60858,284,154,233,1449,32,2152,4.113.809.524
18/02/2016 10:00,25.18,60628,332,158,225,1358,32,2105,4.113.809.524
18/02/2016 11:00,25.03,60024,366,159,211,1197,30,1963,4.113.809.524
18/02/2016 12:00,23.29,59360,439,159,192,1113,27,1930,4.113.809.524
18/02/2016 13:00,24.3,59030,484,159,175,1104,25,1947,4.113.809.524
18/02/2016 14:00,23.78,58667,455,159,166,1044,21,1845,4.113.809.524
18/02/2016 15:00,24.3,58569,418,159,134,968,23,1702,4.113.809.524
18/02/2016 16:00,24.72,59153,410,161,101,915,21,1608,4.113.809.524
18/02/2016 17:00,31.2,60604,444,160,85,934,20,1643,4.113.809.524
18/02/2016 18:00,35.04,60612,513,155,76,957,22,1723,4.113.809.524
18/02/2016 19:00,23.84,59323,560,149,71,919,14,1713,4.113.809.524
18/02/2016 20:00,20.32,57417,570,141,61,907,12,1691,4.113.809.524
18/02/2016 21:00,19.79,55843,589,133,52,901,8,1683,4.113.809.524
18/02/2016 22:00,19.13,53412,580,124,42,853,7,1606,4.113.809.524
18/02/2016 23:00,18.19,50472,550,112,35,839,6,1542,4.113.809.524
19/02/2016 00:00,18.49,48504,687,74,30,846,2,1639,4.113.809.524
19/02/2016 01:00,18.15,47542,627,67,27,839,2,1562,4.113.809.524
19/02/2016 02:00,18.12,47205,574,61,24,786,2,1447,4.113.809.524
19/02/2016 03:00,18.53,47401,540,55,22,740,1,1358,4.113.809.524
19/02/2016 04:00,19,48334,509,50,23,751,1,1334,4.113.809.524
19/02/2016 05:00,19.35,50802,479,45,23,752,0,1299,4.113.809.524
19/02/2016 06:00,20.72,55269,458,41,23,774,0,1296,4.113.809.524
19/02/2016 07:00,29.88,59265,448,39,23,689,1,1200,4.113.809.524
19/02/2016 08:00,34.58,60219,454,37,22,661,1,1175,4.113.809.524
19/02/2016 09:00,30.71,60767,475,35,21,665,0,1196,4.113.809.524
19/02/2016 10:00,24.36,60596,485,32,18,654,0,1189,4.113.809.524
19/02/2016 11:00,22.98,59822,489,28,16,673,0,1206,4.113.809.524
19/02/2016 12:00,21.46,58866,507,25,14,663,0,1209,4.113.809.524
19/02/2016 13:00,20.89,58021,523,23,14,672,0,1232,4.113.809.524
19/02/2016 14:00,20.43,57368,579,24,15,651,0,1269,4.113.809.524
19/02/2016 15:00,20.06,57005,645,27,15,655,0,1342,4.113.809.524
19/02/2016 16:00,20.11,57642,690,30,16,737,0,1473,4.113.809.524
19/02/2016 17:00,20.83,58962,761,32,16,827,0,1636,4.113.809.524
19/02/2016 18:00,21.22,58963,900,35,16,997,0,1948,4.113.809.524
19/02/2016 19:00,19.98,57253,1114,37,16,1192,0,2359,4.113.809.524
19/02/2016 20:00,18.98,55062,1385,39,18,1360,0,2802,4.113.809.524
19/02/2016 21:00,18.46,53432,1705,40,19,1450,0,3214,4.113.809.524
19/02/2016 22:00,17.77,51556,2054,40,20,1612,0,3726,4.113.809.524
19/02/2016 23:00,17.07,49269,2389,38,20,1758,0,4205,4.113.809.524
20/02/2016 00:00,17.62,47183,2867,31,7,1911,5,4821,4.113.809.524
20/02/2016 01:00,16.82,46275,3184,33,6,2121,4,5348,4.113.809.524
20/02/2016 02:00,15.76,45627,3480,34,6,2212,6,5738,4.113.809.524
20/02/2016 03:00,15.72,45491,3760,37,8,2386,7,6198,4.113.809.524
20/02/2016 04:00,16.14,45746,3994,39,12,2695,8,6748,4.113.809.524
20/02/2016 05:00,16.56,46496,4134,43,14,3014,8,7213,4.113.809.524
20/02/2016 06:00,16.57,47668,4176,46,16,3400,8,7646,4.113.809.524
20/02/2016 07:00,15.59,49132,4053,52,18,3691,9,7823,4.113.809.524
20/02/2016 08:00,16.15,51321,3750,58,20,3925,10,7763,4.113.809.524
20/02/2016 09:00,16.79,53023,3471,68,22,4171,11,7743,4.113.809.524
20/02/2016 10:00,17.02,53898,3262,79,22,4325,18,7706,4.113.809.524
20/02/2016 11:00,17.51,53913,3112,92,25,4467,19,7715,4.113.809.524
20/02/2016 12:00,17.08,53481,3025,103,28,4556,22,7734,4.113.809.524
20/02/2016 13:00,16.27,52944,2915,111,32,4568,26,7652,4.113.809.524
20/02/2016 14:00,16.18,52624,2729,117,37,4547,28,7458,4.113.809.524
20/02/2016 15:00,16.45,52684,2562,123,48,4420,29,7182,4.113.809.524
20/02/2016 16:00,17.41,53856,2440,128,61,4334,29,6992,4.113.809.524
20/02/2016 17:00,18.94,55810,2330,133,81,4203,24,6771,4.113.809.524
20/02/2016 18:00,19.05,55987,2293,140,102,4078,19,6632,4.113.809.524
20/02/2016 19:00,18.29,54215,2319,148,122,3963,17,6569,4.113.809.524
20/02/2016 20:00,17.47,52340,2357,154,142,3850,13,6516,4.113.809.524
20/02/2016 21:00,16.24,51137,2375,161,151,3752,12,6451,4.113.809.524
20/02/2016 22:00,15.69,49700,2416,167,152,3565,12,6312,4.113.809.524
20/02/2016 23:00,15.1,47896,2440,173,150,3428,12,6203,4.113.809.524
21/02/2016 00:00,15.6,46143,2867,194,192,3355,41,6649,4.113.809.524
21/02/2016 01:00,14.93,45239,2963,196,172,3203,40,6574,4.113.809.524
21/02/2016 02:00,14.92,44766,3030,198,149,3040,34,6451,4.113.809.524
21/02/2016 03:00,14.93,44574,3092,199,121,2964,30,6406,4.113.809.524
21/02/2016 04:00,14.94,44813,3174,197,97,2960,25,6453,4.113.809.524
21/02/2016 05:00,14.93,45285,3234,192,87,2920,21,6454,4.113.809.524
21/02/2016 06:00,15,45942,2986,184,80,2961,22,6233,4.113.809.524
21/02/2016 07:00,15.73,46904,3293,176,77,2998,21,6565,4.113.809.524
21/02/2016 08:00,16.06,48630,3336,167,78,2994,19,6594,4.113.809.524
21/02/2016 09:00,16.74,50350,3416,159,82,2968,16,6641,4.113.809.524
21/02/2016 10:00,16.96,51380,3517,149,83,2994,16,6759,4.113.809.524
21/02/2016 11:00,16.89,51608,3578,139,89,3016,16,6838,4.113.809.524
21/02/2016 12:00,16.77,51340,3572,130,95,2964,17,6778,4.113.809.524
21/02/2016 13:00,16.12,51058,3493,125,103,2941,20,6682,4.113.809.524
21/02/2016 14:00,15.97,50928,3344,121,111,2910,19,6505,4.113.809.524
21/02/2016 15:00,15.95,51117,3131,114,119,2907,13,6284,4.113.809.524
21/02/2016 16:00,16.21,52190,2861,104,124,2868,12,5969,4.113.809.524
21/02/2016 17:00,17.53,54318,2618,92,124,2733,11,5578,4.113.809.524
21/02/2016 18:00,18.56,55143,2425,81,124,2668,12,5310,4.113.809.524
21/02/2016 19:00,18.18,54413,2344,75,130,2600,9,5158,4.113.809.524
21/02/2016 20:00,17.55,53142,2323,68,135,2474,7,5007,4.113.809.524
21/02/2016 21:00,16.96,52153,2289,59,139,2343,7,4837,4.113.809.524
21/02/2016 22:00,16.36,50438,2267,55,143,2165,6,4636,4.113.809.524
21/02/2016 23:00,15.6,48516,2253,53,143,2035,5,4489,4.113.809.524
22/02/2016 00:00,16.27,46415,2135,61,113,1724,6,4039,3.855.833.333
22/02/2016 01:00,15.54,45616,2488,58,101,1701,7,4355,3.855.833.333
22/02/2016 02:00,15.23,45482,2459,54,90,1585,7,4195,3.855.833.333
22/02/2016 03:00,15.52,45774,2664,50,84,1557,8,4363,3.855.833.333
22/02/2016 04:00,16.01,46740,3125,46,83,1596,8,4858,3.855.833.333
22/02/2016 05:00,17.34,49274,3059,43,87,1627,7,4823,3.855.833.333
22/02/2016 06:00,18.27,53806,3011,41,90,1698,9,4849,3.855.833.333
22/02/2016 07:00,20.17,57972,2989,40,107,1739,9,4884,3.855.833.333
22/02/2016 08:00,20.4,58953,2992,36,129,1792,10,4959,3.855.833.333
22/02/2016 09:00,20.3,58673,3069,32,151,1836,13,5101,3.855.833.333
22/02/2016 10:00,20.09,58546,3244,30,170,1865,21,5330,3.855.833.333
22/02/2016 11:00,19.85,58004,3488,27,201,1796,25,5537,3.855.833.333
22/02/2016 12:00,19.57,57289,3664,25,247,1815,25,5776,3.855.833.333
22/02/2016 13:00,19.26,56826,3693,25,272,1828,23,5841,3.855.833.333
22/02/2016 14:00,19.05,56484,3659,26,271,1791,22,5769,3.855.833.333
22/02/2016 15:00,19.23,56120,3598,30,263,1743,22,5656,3.855.833.333
22/02/2016 16:00,19.62,56636,3436,33,252,1673,18,5412,3.855.833.333
22/02/2016 17:00,20.3,58135,3186,39,239,1684,13,5161,3.855.833.333
22/02/2016 18:00,20.46,58649,2987,48,232,1707,11,4985,3.855.833.333
22/02/2016 19:00,20.19,57614,2895,52,228,1713,9,4897,3.855.833.333
22/02/2016 20:00,19.35,55937,2856,53,223,1683,11,4826,3.855.833.333
22/02/2016 21:00,18.75,54452,2842,54,219,1727,12,4854,3.855.833.333
22/02/2016 22:00,18.2,52212,2857,56,223,1732,10,4878,3.855.833.333
22/02/2016 23:00,17.7,49556,2862,56,232,1716,8,4874,3.855.833.333
23/02/2016 00:00,18.08,47962,3056,77,209,1510,21,4873,3.855.833.333
23/02/2016 01:00,17.33,47132,2960,76,211,1501,18,4766,3.855.833.333
23/02/2016 02:00,17.2,46847,2869,74,221,1493,14,4671,3.855.833.333
23/02/2016 03:00,17.44,47120,2797,71,219,1518,12,4617,3.855.833.333
23/02/2016 04:00,17.81,47956,2724,68,221,1562,10,4585,3.855.833.333
23/02/2016 05:00,19.08,50570,2666,63,229,1554,7,4519,3.855.833.333
23/02/2016 06:00,19.97,54918,2608,58,225,1518,7,4416,3.855.833.333
23/02/2016 07:00,20.97,58791,2567,55,224,1536,7,4389,3.855.833.333
23/02/2016 08:00,21.63,59443,2596,49,223,1488,9,4365,3.855.833.333
23/02/2016 09:00,21.07,59023,2670,47,220,1449,9,4395,3.855.833.333
23/02/2016 10:00,20.87,58693,2761,46,213,1414,11,4445,3.855.833.333
23/02/2016 11:00,20.71,58097,2834,43,203,1297,14,4391,3.855.833.333
23/02/2016 12:00,20.65,57316,2889,41,190,1265,15,4400,3.855.833.333
23/02/2016 13:00,20.58,56923,2927,39,182,1308,19,4475,3.855.833.333
23/02/2016 14:00,20.4,56600,2938,39,168,1354,22,4521,3.855.833.333
23/02/2016 15:00,20.25,56403,2919,40,158,1382,22,4521,3.855.833.333
23/02/2016 16:00,20.4,57082,2879,39,151,1451,20,4540,3.855.833.333
23/02/2016 17:00,20.96,58796,2830,40,145,1645,13,4673,3.855.833.333
23/02/2016 18:00,21.43,59398,2819,41,140,1776,9,4785,3.855.833.333
23/02/2016 19:00,20.76,58472,2881,42,129,1894,7,4953,3.855.833.333
23/02/2016 20:00,20.19,56771,2910,41,120,2014,6,5091,3.855.833.333
23/02/2016 21:00,19.49,55287,2922,40,118,2145,5,5230,3.855.833.333
23/02/2016 22:00,18.9,53046,2894,39,103,2215,4,5255,3.855.833.333
23/02/2016 23:00,17.89,50420,2865,37,95,2264,3,5264,3.855.833.333
24/02/2016 00:00,18.03,48289,2535,35,89,2321,1,4981,3.855.833.333
24/02/2016 01:00,17.05,47494,2606,38,79,2472,1,5196,3.855.833.333
24/02/2016 02:00,16.97,47263,2648,41,70,2446,1,5206,3.855.833.333
24/02/2016 03:00,17.08,47536,2632,46,64,2436,2,5180,3.855.833.333
24/02/2016 04:00,17.88,48554,2559,49,60,2406,2,5076,3.855.833.333
24/02/2016 05:00,19.29,50944,2447,54,57,2386,3,4947,3.855.833.333
24/02/2016 06:00,20.52,55210,2363,59,54,2379,3,4858,3.855.833.333
24/02/2016 07:00,21.47,58766,2300,59,53,2305,3,4720,3.855.833.333
24/02/2016 08:00,22.66,59672,2265,56,55,2203,4,4583,3.855.833.333
24/02/2016 09:00,22.08,59287,2314,56,58,2111,5,4544,3.855.833.333
24/02/2016 10:00,21.35,58807,2398,58,57,2059,8,4580,3.855.833.333
24/02/2016 11:00,21.16,58018,2422,59,57,1963,14,4515,3.855.833.333
24/02/2016 12:00,21,57126,2437,58,58,1746,14,4313,3.855.833.333
24/02/2016 13:00,21.01,56675,2413,56,60,1640,13,4182,3.855.833.333
24/02/2016 14:00,20.92,56352,2301,53,62,1649,13,4078,3.855.833.333
24/02/2016 15:00,21.01,56240,2181,49,62,1673,11,3976,3.855.833.333
24/02/2016 16:00,21.12,56648,2044,50,60,1832,9,3995,3.855.833.333
24/02/2016 17:00,22.38,58270,1859,50,59,1882,10,3860,3.855.833.333
24/02/2016 18:00,25.21,58968,1692,54,60,1954,9,3769,3.855.833.333
24/02/2016 19:00,21.86,58141,1621,56,65,1899,6,3647,3.855.833.333
24/02/2016 20:00,21.08,56499,1577,56,68,1844,7,3552,3.855.833.333
24/02/2016 21:00,20.5,55102,1511,54,69,1786,6,3426,3.855.833.333
24/02/2016 22:00,19.55,52697,1469,53,71,1781,5,3379,3.855.833.333
24/02/2016 23:00,18.83,50214,1465,51,74,1719,4,3313,3.855.833.333
25/02/2016 00:00,19.06,48570,1496,64,77,1704,5,3346,3.855.833.333
25/02/2016 01:00,18.85,47835,1468,68,87,1616,4,3243,3.855.833.333
25/02/2016 02:00,18.81,47526,1413,73,90,1527,5,3108,3.855.833.333
25/02/2016 03:00,19.02,47771,1327,77,94,1450,5,2953,3.855.833.333
25/02/2016 04:00,19.43,48928,1227,80,99,1435,8,2849,3.855.833.333
25/02/2016 05:00,21.01,51643,1092,78,109,1410,8,2697,3.855.833.333
25/02/2016 06:00,22.9,56016,971,76,110,1279,8,2444,3.855.833.333
25/02/2016 07:00,35.05,59821,855,75,120,1192,9,2251,3.855.833.333
25/02/2016 08:00,37.21,60537,764,72,132,1149,8,2125,3.855.833.333
25/02/2016 09:00,35.07,60566,727,71,140,1072,9,2019,3.855.833.333
25/02/2016 10:00,28.09,59971,720,70,138,998,8,1934,3.855.833.333
25/02/2016 11:00,28.02,59130,717,68,132,869,7,1793,3.855.833.333
25/02/2016 12:00,25.27,58050,730,67,126,853,9,1785,3.855.833.333
25/02/2016 13:00,26.19,57456,738,65,118,835,11,1767,3.855.833.333
25/02/2016 14:00,24.86,57151,761,59,116,850,11,1797,3.855.833.333
25/02/2016 15:00,23.82,56960,773,57,114,884,11,1839,3.855.833.333
25/02/2016 16:00,24.54,57354,758,56,113,950,8,1885,3.855.833.333
25/02/2016 17:00,35.03,59141,734,56,107,1086,8,1991,3.855.833.333
25/02/2016 18:00,39.92,59879,713,57,97,1227,7,2101,3.855.833.333
25/02/2016 19:00,35.03,58859,746,59,92,1305,5,2207,3.855.833.333
25/02/2016 20:00,23.44,57177,827,60,91,1360,6,2344,3.855.833.333
25/02/2016 21:00,21.21,55718,890,61,90,1345,6,2392,3.855.833.333
25/02/2016 22:00,20.27,53052,924,62,88,1271,7,2352,3.855.833.333
25/02/2016 23:00,19.17,50396,937,60,85,1242,7,2331,3.855.833.333
26/02/2016 00:00,18.84,48643,967,82,96,1164,6,2315,3.855.833.333
26/02/2016 01:00,18.49,47907,996,85,91,1110,6,2288,3.855.833.333
26/02/2016 02:00,18.46,47644,1024,90,86,1074,6,2280,3.855.833.333
26/02/2016 03:00,18.64,47889,1045,94,82,1036,6,2263,3.855.833.333
26/02/2016 04:00,19.38,49013,1024,96,79,995,7,2201,3.855.833.333
26/02/2016 05:00,20.64,51679,948,96,77,1003,7,2131,3.855.833.333
26/02/2016 06:00,21.94,56145,868,100,74,1038,9,2089,3.855.833.333
26/02/2016 07:00,34.93,60065,836,103,72,1060,10,2081,3.855.833.333
26/02/2016 08:00,36.3,61091,831,106,73,1098,12,2120,3.855.833.333
26/02/2016 09:00,36.51,60670,829,110,75,1127,14,2155,3.855.833.333
26/02/2016 10:00,30.89,60225,853,106,78,1134,22,2193,3.855.833.333
26/02/2016 11:00,25.12,59283,911,97,83,1042,27,2160,3.855.833.333
26/02/2016 12:00,22.36,58254,952,91,90,986,30,2149,3.855.833.333
26/02/2016 13:00,22.34,57143,932,87,95,960,27,2101,3.855.833.333
26/02/2016 14:00,21.26,56262,894,91,88,1062,22,2157,3.855.833.333
26/02/2016 15:00,20.85,56063,863,87,84,1096,20,2150,3.855.833.333
26/02/2016 16:00,21.4,56554,769,77,82,1140,17,2085,3.855.833.333
26/02/2016 17:00,25.48,58127,642,70,86,1195,15,2008,3.855.833.333
26/02/2016 18:00,34.98,58904,562,71,90,1251,17,1991,3.855.833.333
26/02/2016 19:00,24.07,57616,547,71,102,1280,16,2016,3.855.833.333
26/02/2016 20:00,20.81,55606,543,69,113,1278,15,2018,3.855.833.333
26/02/2016 21:00,20.29,54169,524,61,126,1345,15,2071,3.855.833.333
26/02/2016 22:00,19.69,52024,497,57,138,1320,15,2027,3.855.833.333
26/02/2016 23:00,19.07,49948,465,51,144,1295,18,1973,3.855.833.333
27/02/2016 00:00,19.68,48286,544,23,100,1303,8,1978,3.855.833.333
27/02/2016 01:00,19.44,47374,532,25,99,1248,6,1910,3.855.833.333
27/02/2016 02:00,19.26,46981,510,31,96,1245,5,1887,3.855.833.333
27/02/2016 03:00,19.15,47024,495,36,99,1219,3,1852,3.855.833.333
27/02/2016 04:00,19.21,47320,464,42,101,1220,3,1830,3.855.833.333
27/02/2016 05:00,19.53,48139,404,44,98,1246,3,1795,3.855.833.333
27/02/2016 06:00,19.62,49178,347,46,101,1313,6,1813,3.855.833.333
27/02/2016 07:00,19.71,50521,304,42,101,1457,8,1912,3.855.833.333
27/02/2016 08:00,19.96,52230,260,40,98,1374,7,1779,3.855.833.333
27/02/2016 09:00,20.01,53744,222,37,96,1370,9,1734,3.855.833.333
27/02/2016 10:00,20.1,54209,207,37,92,1512,14,1862,3.855.833.333
27/02/2016 11:00,19.85,53769,213,39,88,1576,17,1933,3.855.833.333
27/02/2016 12:00,19.51,52837,221,43,85,1553,19,1921,3.855.833.333
27/02/2016 13:00,19.21,51995,222,47,79,1645,22,2015,3.855.833.333
27/02/2016 14:00,19.11,51422,217,54,64,1663,23,2021,3.855.833.333
27/02/2016 15:00,19.19,51362,208,62,53,1659,25,2007,3.855.833.333
27/02/2016 16:00,19.59,52515,188,71,42,1613,23,1937,3.855.833.333
27/02/2016 17:00,20.24,54837,157,84,37,1713,19,2010,3.855.833.333
27/02/2016 18:00,21.6,55921,134,97,34,1904,16,2185,3.855.833.333
27/02/2016 19:00,20.18,54788,126,106,30,1896,14,2172,3.855.833.333
27/02/2016 20:00,19.69,53083,124,112,31,1925,12,2204,3.855.833.333
27/02/2016 21:00,19.46,52025,125,119,32,1933,12,2221,3.855.833.333
27/02/2016 22:00,19.25,50685,122,125,33,1872,11,2163,3.855.833.333
27/02/2016 23:00,18.82,49094,122,125,33,1781,11,2072,3.855.833.333
28/02/2016 00:00,19.44,47860,175,141,50,1704,9,2079,3.855.833.333
28/02/2016 01:00,18.4,46950,173,147,50,1622,8,2000,3.855.833.333
28/02/2016 02:00,18.01,46497,174,148,41,1517,7,1887,3.855.833.333
28/02/2016 03:00,17.97,46391,187,148,36,1395,6,1772,3.855.833.333
28/02/2016 04:00,17.89,46561,195,144,32,1228,5,1604,3.855.833.333
28/02/2016 05:00,18.04,47108,196,139,30,1124,4,1493,3.855.833.333
28/02/2016 06:00,18.1,47642,186,133,28,1051,4,1402,3.855.833.333
28/02/2016 07:00,18.18,48598,161,127,24,1038,4,1354,3.855.833.333
28/02/2016 08:00,18.41,50063,130,120,19,987,3,1259,3.855.833.333
28/02/2016 09:00,19.04,51471,106,112,16,881,3,1118,3.855.833.333
28/02/2016 10:00,19.06,52038,91,101,12,751,3,958,3.855.833.333
28/02/2016 11:00,19.04,51969,88,87,9,622,3,809,3.855.833.333
28/02/2016 12:00,18.33,51311,92,71,9,484,2,658,3.855.833.333
28/02/2016 13:00,18.21,50632,102,55,8,453,2,620,3.855.833.333
28/02/2016 14:00,18.05,50208,118,41,9,459,2,629,3.855.833.333
28/02/2016 15:00,17.95,50220,136,33,11,554,2,736,3.855.833.333
28/02/2016 16:00,18.18,51131,146,29,11,612,1,799,3.855.833.333
28/02/2016 17:00,19.62,53440,152,27,12,746,1,938,3.855.833.333
28/02/2016 18:00,22.26,55093,164,26,14,820,1,1025,3.855.833.333
28/02/2016 19:00,22.74,54788,168,24,16,870,2,1080,3.855.833.333
28/02/2016 20:00,20.74,53663,156,24,17,941,2,1140,3.855.833.333
28/02/2016 21:00,19.78,52825,137,22,18,946,2,1125,3.855.833.333
28/02/2016 22:00,19.85,51224,116,22,20,926,3,1087,3.855.833.333
28/02/2016 23:00,19.57,49433,92,21,20,929,2,1064,3.855.833.333
29/02/2016 00:00,19.21,48545,47,18,14,996,1,1076,3.591.904.762
29/02/2016 01:00,18.19,47944,47,19,12,925,1,1004,3.591.904.762
29/02/2016 02:00,18.02,47801,51,19,10,886,1,967,3.591.904.762
29/02/2016 03:00,18,48124,58,18,9,876,0,961,3.591.904.762
29/02/2016 04:00,18.41,49071,64,17,9,878,0,968,3.591.904.762
29/02/2016 05:00,20.04,51635,70,15,9,879,0,973,3.591.904.762
29/02/2016 06:00,27.87,55985,79,13,10,814,0,916,3.591.904.762
29/02/2016 07:00,38,59966,88,10,10,848,2,958,3.591.904.762
29/02/2016 08:00,38.26,61491,94,8,11,741,2,856,3.591.904.762
29/02/2016 09:00,38.72,60831,99,7,15,614,0,735,3.591.904.762
29/02/2016 10:00,31.12,60205,117,6,19,571,0,713,3.591.904.762
29/02/2016 11:00,25.98,59086,149,6,23,593,0,771,3.591.904.762
29/02/2016 12:00,23.82,57983,189,6,38,520,1,754,3.591.904.762
29/02/2016 13:00,24.14,57365,210,5,47,492,1,755,3.591.904.762
29/02/2016 14:00,23.27,56850,205,5,57,583,1,851,3.591.904.762
29/02/2016 15:00,22.6,56597,199,5,68,647,1,920,3.591.904.762
29/02/2016 16:00,23.03,56799,195,5,77,744,1,1022,3.591.904.762
29/02/2016 17:00,27.25,58621,199,5,91,923,1,1219,3.591.904.762
29/02/2016 18:00,37.16,59786,214,7,103,1073,2,1399,3.591.904.762
29/02/2016 19:00,24.9,59165,261,9,116,1207,1,1594,3.591.904.762
29/02/2016 20:00,21.28,57567,319,13,129,1285,3,1749,3.591.904.762
29/02/2016 21:00,20.14,56183,369,16,142,1383,3,1913,3.591.904.762
29/02/2016 22:00,19.67,53914,411,19,161,1426,4,2021,3.591.904.762
29/02/2016 23:00,18.81,51322,438,22,167,1377,3,2007,3.591.904.762
01/03/2016 00:00,19.24,49368,371,23,87,1370,3,1854,3.591.904.762
01/03/2016 01:00,19.04,48568,390,23,89,1208,3,1713,3.591.904.762
01/03/2016 02:00,18.93,48170,440,21,96,1159,3,1719,3.591.904.762
01/03/2016 03:00,19.02,48405,514,19,105,1143,3,1784,3.591.904.762
01/03/2016 04:00,19.29,49592,581,20,115,1200,3,1919,3.591.904.762
01/03/2016 05:00,19.99,52350,646,22,123,1295,3,2089,3.591.904.762
01/03/2016 06:00,20.56,56604,781,23,132,1350,4,2290,3.591.904.762
01/03/2016 07:00,25.97,60630,984,22,139,1387,4,2536,3.591.904.762
01/03/2016 08:00,29.22,61665,1204,19,148,1462,6,2839,3.591.904.762
01/03/2016 09:00,23.68,61143,1429,17,155,1538,7,3146,3.591.904.762
01/03/2016 10:00,22.51,60663,1640,15,158,1494,12,3319,3.591.904.762
01/03/2016 11:00,20.97,59575,1847,15,155,1421,16,3454,3.591.904.762
01/03/2016 12:00,20.4,58464,2020,17,149,1391,17,3594,3.591.904.762
01/03/2016 13:00,20.15,58057,2129,19,139,1409,16,3712,3.591.904.762
01/03/2016 14:00,19.93,57757,2162,25,128,1507,14,3836,3.591.904.762
01/03/2016 15:00,19.84,57769,2205,34,123,1654,14,4030,3.591.904.762
01/03/2016 16:00,19.87,58211,2343,48,121,1833,13,4358,3.591.904.762
01/03/2016 17:00,20.41,60010,2506,63,120,2079,11,4779,3.591.904.762
01/03/2016 18:00,20.83,61006,2661,78,117,2355,11,5222,3.591.904.762
01/03/2016 19:00,19.92,60147,2795,85,111,2468,10,5469,3.591.904.762
01/03/2016 20:00,19.47,58317,2912,88,101,2620,10,5731,3.591.904.762
01/03/2016 21:00,19.08,56575,2991,88,88,2746,7,5920,3.591.904.762
01/03/2016 22:00,18.28,54146,2974,85,78,2771,5,5913,3.591.904.762
01/03/2016 23:00,17.14,51429,2872,80,67,2816,2,5837,3.591.904.762
02/03/2016 00:00,16.94,48604,2987,80,40,2783,3,5893,3.591.904.762
02/03/2016 01:00,16.95,47734,2768,79,31,2702,2,5582,3.591.904.762
02/03/2016 02:00,16.99,47400,2514,76,23,2670,2,5285,3.591.904.762
02/03/2016 03:00,17.03,47517,2270,72,19,2709,2,5072,3.591.904.762
02/03/2016 04:00,17.36,48354,2059,71,16,2767,1,4914,3.591.904.762
02/03/2016 05:00,18.46,50677,1893,67,12,2811,1,4784,3.591.904.762
02/03/2016 06:00,19.54,54971,1782,61,12,2866,1,4722,3.591.904.762
02/03/2016 07:00,22.98,58831,1663,54,11,2889,0,4617,3.591.904.762
02/03/2016 08:00,28.77,59562,1527,43,8,2808,0,4386,3.591.904.762
02/03/2016 09:00,27.32,59394,1416,38,7,2765,0,4226,3.591.904.762
02/03/2016 10:00,28.39,59522,1269,37,6,2666,0,3978,3.591.904.762
02/03/2016 11:00,25.08,58988,1098,40,6,2547,1,3692,3.591.904.762
02/03/2016 12:00,27.42,58350,1018,44,8,2395,0,3465,3.591.904.762
02/03/2016 13:00,25.91,58031,964,45,9,2324,0,3342,3.591.904.762
02/03/2016 14:00,25.93,57402,876,43,10,2302,0,3231,3.591.904.762
02/03/2016 15:00,25.03,57227,803,44,12,2289,1,3149,3.591.904.762
02/03/2016 16:00,24.99,57417,689,46,13,2280,1,3029,3.591.904.762
02/03/2016 17:00,37.87,58889,589,47,13,2281,1,2931,3.591.904.762
02/03/2016 18:00,38.55,59477,597,48,14,2183,4,2846,3.591.904.762
02/03/2016 19:00,29.6,58421,626,46,16,2129,2,2819,3.591.904.762
02/03/2016 20:00,23.76,56520,621,41,19,1979,2,2662,3.591.904.762
02/03/2016 21:00,20.61,54887,586,35,23,1930,2,2576,3.591.904.762
02/03/2016 22:00,19.89,52504,508,30,28,1740,1,2307,3.591.904.762
02/03/2016 23:00,19.33,49883,447,26,30,1588,2,2093,3.591.904.762
03/03/2016 00:00,19.54,47889,512,24,69,1416,4,2025,3.591.904.762
03/03/2016 01:00,19.14,47035,394,23,65,1308,3,1793,3.591.904.762
03/03/2016 02:00,18.59,46662,310,22,60,1194,4,1590,3.591.904.762
03/03/2016 03:00,18.12,46783,297,23,57,1132,3,1512,3.591.904.762
03/03/2016 04:00,18.8,47646,309,23,54,1058,3,1447,3.591.904.762
03/03/2016 05:00,20.39,50031,315,25,52,989,3,1384,3.591.904.762
03/03/2016 06:00,23,54134,314,24,49,960,3,1350,3.591.904.762
03/03/2016 07:00,35.02,57923,317,22,45,904,3,1291,3.591.904.762
03/03/2016 08:00,40.33,59049,348,19,39,755,4,1165,3.591.904.762
03/03/2016 09:00,35.94,58785,370,16,35,702,5,1128,3.591.904.762
03/03/2016 10:00,29.6,58693,347,14,39,678,5,1083,3.591.904.762
03/03/2016 11:00,26.21,58251,337,14,40,699,4,1094,3.591.904.762
03/03/2016 12:00,26.31,57490,321,14,41,650,6,1032,3.591.904.762
03/03/2016 13:00,25.46,57094,281,16,46,615,3,961,3.591.904.762
03/03/2016 14:00,25.05,56718,245,19,56,590,3,913,3.591.904.762
03/03/2016 15:00,24.94,56565,224,25,62,589,4,904,3.591.904.762
03/03/2016 16:00,24.8,56662,203,31,68,618,4,924,3.591.904.762
03/03/2016 17:00,32.49,58205,184,36,75,680,6,981,3.591.904.762
03/03/2016 18:00,41.12,59043,169,40,92,714,7,1022,3.591.904.762
03/03/2016 19:00,25.06,58161,158,42,106,757,5,1068,3.591.904.762
03/03/2016 20:00,21.94,56318,147,44,104,785,6,1086,3.591.904.762
03/03/2016 21:00,21.17,54630,145,45,102,790,6,1088,3.591.904.762
03/03/2016 22:00,20.59,52160,146,44,99,786,7,1082,3.591.904.762
03/03/2016 23:00,19.87,49426,140,44,92,785,9,1070,3.591.904.762
04/03/2016 00:00,19.94,47534,252,43,92,775,7,1169,3.591.904.762
04/03/2016 01:00,19.6,46588,229,44,85,747,7,1112,3.591.904.762
04/03/2016 02:00,19.32,46284,223,44,83,694,7,1051,3.591.904.762
04/03/2016 03:00,19.14,46451,222,45,81,695,7,1050,3.591.904.762
04/03/2016 04:00,19.1,47353,221,47,80,694,7,1049,3.591.904.762
04/03/2016 05:00,20.55,49712,235,49,81,728,8,1101,3.591.904.762
04/03/2016 06:00,23.32,53897,263,47,81,734,6,1131,3.591.904.762
04/03/2016 07:00,32.5,57847,275,45,80,716,7,1123,3.591.904.762
04/03/2016 08:00,35.52,59003,270,39,73,743,12,1137,3.591.904.762
04/03/2016 09:00,35.88,58885,274,34,68,710,13,1099,3.591.904.762
04/03/2016 10:00,34.06,58791,270,29,63,679,10,1051,3.591.904.762
04/03/2016 11:00,25.27,58163,266,23,57,681,9,1036,3.591.904.762
04/03/2016 12:00,23.84,57259,296,20,51,665,9,1041,3.591.904.762
04/03/2016 13:00,23.63,56329,331,20,43,677,8,1079,3.591.904.762
04/03/2016 14:00,22.34,55577,355,22,39,684,5,1105,3.591.904.762
04/03/2016 15:00,22.13,54959,406,24,38,713,3,1184,3.591.904.762
04/03/2016 16:00,21.93,54993,469,28,39,760,3,1299,3.591.904.762
04/03/2016 17:00,23.85,56465,523,31,42,812,4,1412,3.591.904.762
04/03/2016 18:00,25.17,57313,625,33,47,831,5,1541,3.591.904.762
04/03/2016 19:00,21.92,56037,751,33,47,805,4,1640,3.591.904.762
04/03/2016 20:00,21.07,53971,886,31,44,804,4,1769,3.591.904.762
04/03/2016 21:00,20.76,52361,1013,28,39,817,3,1900,3.591.904.762
04/03/2016 22:00,20.19,50531,1094,24,38,807,2,1965,3.591.904.762
04/03/2016 23:00,19.76,48400,1184,20,34,833,2,2073,3.591.904.762
05/03/2016 00:00,19.56,46543,1539,16,37,780,2,2374,3.591.904.762
05/03/2016 01:00,19.17,45465,1657,13,34,783,2,2489,3.591.904.762
05/03/2016 02:00,19.04,44931,1701,12,34,737,2,2486,3.591.904.762
05/03/2016 03:00,18.96,44734,1739,11,33,714,2,2499,3.591.904.762
05/03/2016 04:00,18.88,44945,1803,10,31,787,3,2634,3.591.904.762
05/03/2016 05:00,19.01,45673,1905,9,28,857,1,2800,3.591.904.762
05/03/2016 06:00,19.12,46720,1983,8,27,887,2,2907,3.591.904.762
05/03/2016 07:00,19.83,48103,1981,6,27,912,1,2927,3.591.904.762
05/03/2016 08:00,20.32,50270,1938,4,26,943,1,2912,3.591.904.762
05/03/2016 09:00,20.88,51899,1920,3,27,973,1,2924,3.591.904.762
05/03/2016 10:00,21.07,52632,1869,4,26,979,1,2879,3.591.904.762
05/03/2016 11:00,20.99,52430,1805,5,23,1084,1,2918,3.591.904.762
05/03/2016 12:00,20.78,51907,1783,7,21,1116,1,2928,3.591.904.762
05/03/2016 13:00,20.23,51294,1784,9,22,1140,1,2956,3.591.904.762
05/03/2016 14:00,19.93,50843,1788,11,27,1203,1,3030,3.591.904.762
05/03/2016 15:00,19.91,50773,1784,13,32,1216,2,3047,3.591.904.762
05/03/2016 16:00,20.52,51602,1771,14,40,1272,3,3100,3.591.904.762
05/03/2016 17:00,21.11,53721,1729,15,55,1345,4,3148,3.591.904.762
05/03/2016 18:00,21.45,54876,1692,15,68,1389,4,3168,3.591.904.762
05/03/2016 19:00,21.15,53707,1652,15,78,1422,4,3171,3.591.904.762
05/03/2016 20:00,20.6,51877,1617,13,84,1426,2,3142,3.591.904.762
05/03/2016 21:00,20.46,50689,1590,12,88,1486,1,3177,3.591.904.762
05/03/2016 22:00,19.97,49255,1589,10,92,1489,1,3181,3.591.904.762
05/03/2016 23:00,19.52,47572,1654,10,96,1482,1,3243,3.591.904.762
06/03/2016 00:00,20.03,45649,1083,9,88,1406,6,2592,3.591.904.762
06/03/2016 01:00,19.46,44647,1062,10,90,1466,7,2635,3.591.904.762
06/03/2016 02:00,19.13,44141,1024,14,96,1474,8,2616,3.591.904.762
06/03/2016 03:00,18.69,44081,959,15,109,1501,9,2593,3.591.904.762
06/03/2016 04:00,18.58,44294,888,16,134,1530,10,2578,3.591.904.762
06/03/2016 05:00,18.83,44880,825,15,153,1592,10,2595,3.591.904.762
06/03/2016 06:00,18.65,45350,753,14,160,1640,11,2578,3.591.904.762
06/03/2016 07:00,18.78,46409,680,12,164,1655,13,2524,3.591.904.762
06/03/2016 08:00,19.28,48300,610,11,161,1645,17,2444,3.591.904.762
06/03/2016 09:00,19.99,50003,527,11,157,1657,23,2375,3.591.904.762
06/03/2016 10:00,20.26,50996,440,13,155,1642,26,2276,3.591.904.762
06/03/2016 11:00,20.51,51211,374,15,155,1618,25,2187,3.591.904.762
06/03/2016 12:00,20.01,50973,355,18,159,1634,24,2190,3.591.904.762
06/03/2016 13:00,19.15,50653,373,23,163,1645,24,2228,3.591.904.762
06/03/2016 14:00,18.84,50385,402,30,166,1664,25,2287,3.591.904.762
06/03/2016 15:00,18.83,50449,441,39,164,1667,24,2335,3.591.904.762
06/03/2016 16:00,19.18,51266,458,50,159,1656,22,2345,3.591.904.762
06/03/2016 17:00,20.57,53357,437,61,152,1663,20,2333,3.591.904.762
06/03/2016 18:00,22.37,54997,418,71,144,1591,20,2244,3.591.904.762
06/03/2016 19:00,21.87,54485,421,75,140,1575,17,2228,3.591.904.762
06/03/2016 20:00,21.13,53054,439,79,144,1522,15,2199,3.591.904.762
06/03/2016 21:00,20.97,51959,471,83,145,1428,14,2141,3.591.904.762
06/03/2016 22:00,20.3,50123,490,86,134,1338,9,2057,3.591.904.762
06/03/2016 23:00,19.59,48079,492,87,119,1308,6,2012,3.591.904.762
07/03/2016 00:00,19.93,46205,317,94,160,1181,14,1766,3.327.678.571
07/03/2016 01:00,19.74,45483,316,99,147,1189,14,1765,3.327.678.571
07/03/2016 02:00,19.63,45292,314,103,126,1206,12,1761,3.327.678.571
07/03/2016 03:00,19.51,45544,311,108,109,1235,10,1773,3.327.678.571
07/03/2016 04:00,19.79,46519,325,108,92,1250,9,1784,3.327.678.571
07/03/2016 05:00,21.01,49167,350,111,78,1268,9,1816,3.327.678.571
07/03/2016 06:00,21.49,53659,378,109,66,1293,5,1851,3.327.678.571
07/03/2016 07:00,24.18,57727,421,105,53,1317,5,1901,3.327.678.571
07/03/2016 08:00,25.71,58812,470,95,41,1324,4,1934,3.327.678.571
07/03/2016 09:00,28.65,58814,512,82,30,1315,4,1943,3.327.678.571
07/03/2016 10:00,27.57,58672,517,72,22,1268,4,1883,3.327.678.571
07/03/2016 11:00,25.68,58183,485,63,17,1232,5,1802,3.327.678.571
07/03/2016 12:00,25.18,57521,465,52,13,1194,5,1729,3.327.678.571
07/03/2016 13:00,24.91,57167,444,41,11,1114,4,1614,3.327.678.571
07/03/2016 14:00,24.22,56811,423,33,10,1049,3,1518,3.327.678.571
07/03/2016 15:00,22.9,56511,404,27,10,975,2,1418,3.327.678.571
07/03/2016 16:00,23.35,56420,369,24,11,949,1,1354,3.327.678.571
07/03/2016 17:00,25.61,57890,322,23,15,891,1,1252,3.327.678.571
07/03/2016 18:00,30.02,58971,288,22,18,855,1,1184,3.327.678.571
07/03/2016 19:00,26.42,58136,265,20,23,810,0,1118,3.327.678.571
07/03/2016 20:00,23.52,56145,253,18,27,750,0,1048,3.327.678.571
07/03/2016 21:00,21.78,54348,250,16,29,719,0,1014,3.327.678.571
07/03/2016 22:00,21.22,51837,228,14,29,681,1,953,3.327.678.571
07/03/2016 23:00,20.82,49005,221,12,27,622,1,883,3.327.678.571
08/03/2016 00:00,21.01,47507,176,15,30,537,2,760,3.327.678.571
08/03/2016 01:00,20.62,46556,161,15,26,507,1,710,3.327.678.571
08/03/2016 02:00,20.58,46169,141,16,25,478,1,661,3.327.678.571
08/03/2016 03:00,20.66,46321,129,16,25,462,1,633,3.327.678.571
08/03/2016 04:00,20.98,47193,121,14,32,468,0,635,3.327.678.571
08/03/2016 05:00,21.55,49814,116,12,34,477,0,639,3.327.678.571
08/03/2016 06:00,23.64,54080,124,10,34,489,1,658,3.327.678.571
08/03/2016 07:00,32.3,57988,133,8,34,479,2,656,3.327.678.571
08/03/2016 08:00,37.75,58609,141,6,39,464,4,654,3.327.678.571
08/03/2016 09:00,34.14,58178,149,6,46,443,2,646,3.327.678.571
08/03/2016 10:00,28.61,57887,163,7,55,437,3,665,3.327.678.571
08/03/2016 11:00,25.45,57375,184,10,61,428,5,688,3.327.678.571
08/03/2016 12:00,25,56650,219,15,67,451,9,761,3.327.678.571
08/03/2016 13:00,24.66,56287,266,22,76,439,7,810,3.327.678.571
08/03/2016 14:00,24.23,55986,306,27,79,426,6,844,3.327.678.571
08/03/2016 15:00,23.92,55754,344,29,83,408,11,875,3.327.678.571
08/03/2016 16:00,23.75,55790,348,33,89,389,13,872,3.327.678.571
08/03/2016 17:00,27.43,57156,330,38,96,370,10,844,3.327.678.571
08/03/2016 18:00,34.19,58212,324,42,111,375,10,862,3.327.678.571
08/03/2016 19:00,30.77,57512,341,42,100,409,8,900,3.327.678.571
08/03/2016 20:00,24.44,55700,388,43,94,422,6,953,3.327.678.571
08/03/2016 21:00,22.98,54042,465,45,89,440,7,1046,3.327.678.571
08/03/2016 22:00,21.38,51538,523,48,83,453,9,1116,3.327.678.571
08/03/2016 23:00,20.7,48790,542,52,80,455,11,1140,3.327.678.571
09/03/2016 00:00,21.06,47395,504,33,37,473,1,1048,3.327.678.571
09/03/2016 01:00,20.63,46531,531,36,27,442,1,1037,3.327.678.571
09/03/2016 02:00,20.33,46196,570,37,18,412,1,1038,3.327.678.571
09/03/2016 03:00,20.14,46403,635,35,13,393,1,1077,3.327.678.571
09/03/2016 04:00,20.15,47296,699,30,11,388,1,1129,3.327.678.571
09/03/2016 05:00,21.54,49667,744,28,10,384,1,1167,3.327.678.571
09/03/2016 06:00,24.17,53789,789,27,9,400,1,1226,3.327.678.571
09/03/2016 07:00,27.74,57670,840,26,9,396,2,1273,3.327.678.571
09/03/2016 08:00,39.65,58383,889,24,8,389,3,1313,3.327.678.571
09/03/2016 09:00,27.1,58071,939,24,7,378,2,1350,3.327.678.571
09/03/2016 10:00,25.05,57872,979,25,6,373,1,1384,3.327.678.571
09/03/2016 11:00,25.12,57308,996,24,5,385,2,1412,3.327.678.571
09/03/2016 12:00,23.89,56538,982,23,4,386,2,1397,3.327.678.571
09/03/2016 13:00,23.16,55901,877,21,4,388,2,1292,3.327.678.571
09/03/2016 14:00,23.52,55304,727,16,4,381,0,1128,3.327.678.571
09/03/2016 15:00,23.8,54877,621,14,6,379,3,1023,3.327.678.571
09/03/2016 16:00,23.82,54732,568,13,8,388,1,978,3.327.678.571
09/03/2016 17:00,25.1,56233,521,14,11,396,1,943,3.327.678.571
09/03/2016 18:00,32.97,57441,514,14,14,383,2,927,3.327.678.571
09/03/2016 19:00,25.53,56989,570,14,18,428,0,1030,3.327.678.571
09/03/2016 20:00,23.16,55301,632,13,22,477,1,1145,3.327.678.571
09/03/2016 21:00,22.36,53838,669,13,27,473,2,1184,3.327.678.571
09/03/2016 22:00,21.6,51543,647,11,30,482,2,1172,3.327.678.571
09/03/2016 23:00,21.02,48995,583,10,32,490,1,1116,3.327.678.571
10/03/2016 00:00,20.72,46765,624,5,38,454,2,1123,3.327.678.571
10/03/2016 01:00,20.17,45983,556,4,39,460,2,1061,3.327.678.571
10/03/2016 02:00,20.05,45792,519,4,33,491,2,1049,3.327.678.571
10/03/2016 03:00,20.16,46022,512,4,33,499,1,1049,3.327.678.571
10/03/2016 04:00,20.94,47019,512,4,39,505,1,1061,3.327.678.571
10/03/2016 05:00,21.97,49534,515,4,46,504,1,1070,3.327.678.571
10/03/2016 06:00,24.32,53600,503,3,50,511,1,1068,3.327.678.571
10/03/2016 07:00,29.3,57342,466,3,53,514,2,1038,3.327.678.571
10/03/2016 08:00,38.49,58386,405,3,56,497,4,965,3.327.678.571
10/03/2016 09:00,39.01,57813,351,2,54,482,2,891,3.327.678.571
10/03/2016 10:00,26.53,57211,336,2,53,468,1,860,3.327.678.571
10/03/2016 11:00,25.07,56434,345,3,53,512,4,917,3.327.678.571
10/03/2016 12:00,25.29,55456,365,3,55,461,4,888,3.327.678.571
10/03/2016 13:00,25.04,54956,373,4,56,446,6,885,3.327.678.571
10/03/2016 14:00,24.7,54395,381,5,57,463,5,911,3.327.678.571
10/03/2016 15:00,24.1,53994,409,7,60,493,11,980,3.327.678.571
10/03/2016 16:00,24.14,54021,417,9,67,523,10,1026,3.327.678.571
10/03/2016 17:00,25.07,55544,387,10,73,586,8,1064,3.327.678.571
10/03/2016 18:00,28.63,56856,369,12,80,650,7,1118,3.327.678.571
10/03/2016 19:00,25.74,56485,366,11,84,726,5,1192,3.327.678.571
10/03/2016 20:00,24.12,54861,360,11,84,866,5,1326,3.327.678.571
10/03/2016 21:00,23.35,53357,338,10,84,925,5,1362,3.327.678.571
10/03/2016 22:00,22.18,51098,284,9,84,995,5,1377,3.327.678.571
10/03/2016 23:00,21.24,48510,222,8,82,1017,4,1333,3.327.678.571
11/03/2016 00:00,21.55,46900,219,8,67,1054,4,1352,3.327.678.571
11/03/2016 01:00,20.88,46133,183,8,62,991,5,1249,3.327.678.571
11/03/2016 02:00,21.07,45961,149,9,61,884,5,1108,3.327.678.571
11/03/2016 03:00,21.09,46185,134,10,61,855,4,1064,3.327.678.571
11/03/2016 04:00,21.8,47129,125,11,61,833,5,1035,3.327.678.571
11/03/2016 05:00,22.59,49504,123,12,64,801,4,1004,3.327.678.571
11/03/2016 06:00,26.08,53686,130,12,65,818,4,1029,3.327.678.571
11/03/2016 07:00,37.68,57389,136,10,66,860,5,1077,3.327.678.571
11/03/2016 08:00,37.71,58295,136,8,65,747,8,964,3.327.678.571
11/03/2016 09:00,37.7,57685,149,6,63,594,8,820,3.327.678.571
11/03/2016 10:00,34.51,57169,160,5,60,501,7,733,3.327.678.571
11/03/2016 11:00,30.04,56267,154,4,58,430,10,656,3.327.678.571
11/03/2016 12:00,26.56,55161,145,4,55,332,7,543,3.327.678.571
11/03/2016 13:00,25.22,54183,135,5,53,304,7,504,3.327.678.571
11/03/2016 14:00,24.47,53357,125,6,52,275,7,465,3.327.678.571
11/03/2016 15:00,23.61,52786,121,7,52,296,11,487,3.327.678.571
11/03/2016 16:00,23.59,52818,116,8,53,299,11,487,3.327.678.571
11/03/2016 17:00,27.46,54216,108,8,59,333,10,518,3.327.678.571
11/03/2016 18:00,37.69,55527,114,8,67,364,9,562,3.327.678.571
11/03/2016 19:00,28.85,54874,118,8,73,406,6,611,3.327.678.571
11/03/2016 20:00,23.83,53079,116,8,70,410,5,609,3.327.678.571
11/03/2016 21:00,23.2,51732,120,7,66,417,5,615,3.327.678.571
11/03/2016 22:00,22.53,50095,125,7,61,424,3,620,3.327.678.571
11/03/2016 23:00,21.98,48113,129,6,57,412,3,607,3.327.678.571
12/03/2016 00:00,22.28,46174,109,4,47,455,2,617,3.327.678.571
12/03/2016 01:00,22.11,45267,123,4,44,447,3,621,3.327.678.571
12/03/2016 02:00,22.06,44859,142,5,44,412,2,605,3.327.678.571
12/03/2016 03:00,22.05,44727,153,5,45,389,2,594,3.327.678.571
12/03/2016 04:00,22.18,44954,150,5,48,392,2,597,3.327.678.571
12/03/2016 05:00,22.37,45640,143,5,48,358,2,556,3.327.678.571
12/03/2016 06:00,22.38,46515,138,5,47,344,2,536,3.327.678.571
12/03/2016 07:00,22.35,47897,137,4,46,322,2,511,3.327.678.571
12/03/2016 08:00,22.49,49718,142,4,43,299,1,489,3.327.678.571
12/03/2016 09:00,23.24,50983,147,3,41,307,1,499,3.327.678.571
12/03/2016 10:00,23.47,51165,145,3,39,303,1,491,3.327.678.571
12/03/2016 11:00,22.95,50612,148,4,37,297,1,487,3.327.678.571
12/03/2016 12:00,22.45,49761,153,5,36,300,1,495,3.327.678.571
12/03/2016 13:00,22.26,49042,155,6,36,289,1,487,3.327.678.571
12/03/2016 14:00,22.05,48608,146,7,37,326,1,517,3.327.678.571
12/03/2016 15:00,22,48568,140,8,39,375,2,564,3.327.678.571
12/03/2016 16:00,22.18,49362,128,9,40,470,2,649,3.327.678.571
12/03/2016 17:00,22.84,51491,107,9,41,630,2,789,3.327.678.571
12/03/2016 18:00,24.39,52997,92,11,41,713,2,859,3.327.678.571
12/03/2016 19:00,23.57,52277,83,11,41,821,2,958,3.327.678.571
12/03/2016 20:00,22.4,50623,76,10,38,876,1,1001,3.327.678.571
12/03/2016 21:00,22.37,49580,78,9,36,962,0,1085,3.327.678.571
12/03/2016 22:00,22.37,48300,80,9,34,974,0,1097,3.327.678.571
12/03/2016 23:00,22.18,46792,87,9,32,943,0,1071,3.327.678.571
13/03/2016 00:00,22.26,45271,85,11,26,1053,1,1176,3.327.678.571
13/03/2016 01:00,21.85,44440,94,12,21,1095,0,1222,3.327.678.571
13/03/2016 02:00,21.2,44035,99,13,19,1086,0,1217,3.327.678.571
13/03/2016 03:00,20.79,43948,112,15,19,1064,0,1210,3.327.678.571
13/03/2016 04:00,20.85,44097,119,16,18,1090,0,1243,3.327.678.571
13/03/2016 05:00,21.03,44465,128,17,18,1166,0,1329,3.327.678.571
13/03/2016 06:00,20.95,44809,145,18,18,1166,0,1347,3.327.678.571
13/03/2016 07:00,21.1,45691,160,18,17,1244,1,1440,3.327.678.571
13/03/2016 08:00,21.3,47128,164,17,17,1226,1,1425,3.327.678.571
13/03/2016 09:00,21.77,48456,156,17,17,1298,0,1488,3.327.678.571
13/03/2016 10:00,21.92,49016,184,18,19,1281,1,1503,3.327.678.571
13/03/2016 11:00,21.77,48847,243,19,21,1326,2,1611,3.327.678.571
13/03/2016 12:00,21.08,48335,303,20,24,1294,2,1643,3.327.678.571
13/03/2016 13:00,20.6,47806,357,21,27,1286,3,1694,3.327.678.571
13/03/2016 14:00,20.43,47510,410,23,30,1322,4,1789,3.327.678.571
13/03/2016 15:00,20.41,47635,435,27,32,1365,5,1864,3.327.678.571
13/03/2016 16:00,20.83,48223,434,32,31,1404,7,1908,3.327.678.571
13/03/2016 17:00,21.64,49939,418,37,29,1514,6,2004,3.327.678.571
13/03/2016 18:00,22.94,51590,415,44,25,1610,6,2100,3.327.678.571
13/03/2016 19:00,22.97,51567,431,47,21,1511,8,2018,3.327.678.571
13/03/2016 20:00,22.41,50345,436,45,18,1458,8,1965,3.327.678.571
13/03/2016 21:00,22.24,49458,444,41,16,1446,9,1956,3.327.678.571
13/03/2016 22:00,22.16,47838,459,38,15,1359,10,1881,3.327.678.571
13/03/2016 23:00,21.87,45926,471,34,15,1322,10,1852,3.327.678.571
14/03/2016 00:00,21.05,44362,450,38,21,1341,4,1854,3.142.916.667
14/03/2016 01:00,20.49,43572,468,42,22,1279,4,1815,3.142.916.667
14/03/2016 02:00,20.19,43347,494,48,24,1176,5,1747,3.142.916.667
14/03/2016 03:00,20.22,43557,509,54,27,1104,5,1699,3.142.916.667
14/03/2016 04:00,20.74,44433,516,57,34,1094,5,1706,3.142.916.667
14/03/2016 05:00,21.76,47335,539,58,46,1089,5,1737,3.142.916.667
14/03/2016 06:00,22.75,51341,561,63,51,1104,6,1785,3.142.916.667
14/03/2016 07:00,24.83,55057,550,69,56,1090,9,1774,3.142.916.667
14/03/2016 08:00,26.92,55944,518,73,62,1096,10,1759,3.142.916.667
14/03/2016 09:00,24.84,55376,485,78,65,982,11,1621,3.142.916.667
14/03/2016 10:00,24.98,55086,442,79,69,922,8,1520,3.142.916.667
14/03/2016 11:00,23.76,54396,399,76,71,936,6,1488,3.142.916.667
14/03/2016 12:00,22.96,53517,361,75,75,980,5,1496,3.142.916.667
14/03/2016 13:00,22.5,53072,325,75,79,1151,4,1634,3.142.916.667
14/03/2016 14:00,22.37,52621,307,76,82,1325,5,1795,3.142.916.667
14/03/2016 15:00,22.36,52202,308,78,85,1451,5,1927,3.142.916.667
14/03/2016 16:00,22.39,52047,315,83,88,1732,5,2223,3.142.916.667
14/03/2016 17:00,22.84,53532,321,91,91,1980,5,2488,3.142.916.667
14/03/2016 18:00,23.45,54678,363,94,91,2186,4,2738,3.142.916.667
14/03/2016 19:00,22.97,54156,441,96,91,2317,4,2949,3.142.916.667
14/03/2016 20:00,22.43,52474,525,94,91,2561,5,3276,3.142.916.667
14/03/2016 21:00,22.21,50837,596,87,91,2690,8,3472,3.142.916.667
14/03/2016 22:00,21.93,48610,598,77,90,2714,13,3492,3.142.916.667
14/03/2016 23:00,21,46030,557,65,89,2707,13,3431,3.142.916.667
15/03/2016 00:00,20.44,44180,776,57,88,2659,9,3589,3.142.916.667
15/03/2016 01:00,20.21,43319,741,50,80,2593,10,3474,3.142.916.667
15/03/2016 02:00,20.23,43042,642,42,76,2492,10,3262,3.142.916.667
15/03/2016 03:00,20.19,43304,566,33,72,2494,7,3172,3.142.916.667
15/03/2016 04:00,20.67,44285,592,28,70,2497,8,3195,3.142.916.667
15/03/2016 05:00,21.71,46862,636,23,72,2439,8,3178,3.142.916.667
15/03/2016 06:00,22.35,50760,625,18,75,2436,8,3162,3.142.916.667
15/03/2016 07:00,23.91,54390,583,12,76,2377,9,3057,3.142.916.667
15/03/2016 08:00,24.64,55301,538,8,75,2263,9,2893,3.142.916.667
15/03/2016 09:00,24.1,54834,529,6,76,2048,8,2667,3.142.916.667
15/03/2016 10:00,24.02,54414,533,4,81,1910,7,2535,3.142.916.667
15/03/2016 11:00,23.3,53785,570,3,74,1863,4,2514,3.142.916.667
15/03/2016 12:00,22.92,53041,631,3,64,1911,2,2611,3.142.916.667
15/03/2016 13:00,22.6,52397,702,4,56,1908,2,2672,3.142.916.667
15/03/2016 14:00,22.41,51934,750,5,39,1875,2,2671,3.142.916.667
15/03/2016 15:00,22.22,51511,771,6,30,1873,2,2682,3.142.916.667
15/03/2016 16:00,22.15,51422,709,9,24,1861,2,2605,3.142.916.667
15/03/2016 17:00,22.48,52631,601,14,20,1890,3,2528,3.142.916.667
15/03/2016 18:00,23.18,53846,532,23,20,1882,2,2459,3.142.916.667
15/03/2016 19:00,22.9,53628,516,33,20,1883,1,2453,3.142.916.667
15/03/2016 20:00,22.41,52072,515,44,19,2023,1,2602,3.142.916.667
15/03/2016 21:00,22.08,50586,503,55,15,2043,1,2617,3.142.916.667
15/03/2016 22:00,21.66,48397,436,66,11,2069,1,2583,3.142.916.667
15/03/2016 23:00,20.84,45777,337,75,9,2030,1,2452,3.142.916.667
16/03/2016 00:00,20.58,43472,268,81,6,1975,0,2330,3.142.916.667
16/03/2016 01:00,20.29,42564,263,85,7,1940,1,2296,3.142.916.667
16/03/2016 02:00,20.21,42432,231,87,10,1951,1,2280,3.142.916.667
16/03/2016 03:00,20.07,42740,191,93,13,1995,2,2294,3.142.916.667
16/03/2016 04:00,20.33,43738,161,96,17,2000,3,2277,3.142.916.667
16/03/2016 05:00,21.32,46120,141,96,21,1994,4,2256,3.142.916.667
16/03/2016 06:00,22.16,50050,132,97,26,2011,5,2271,3.142.916.667
16/03/2016 07:00,23.27,53644,128,93,32,1959,5,2217,3.142.916.667
16/03/2016 08:00,23.96,54736,127,86,35,1777,8,2033,3.142.916.667
16/03/2016 09:00,23.27,54062,133,81,41,1584,9,1848,3.142.916.667
16/03/2016 10:00,22.44,53361,125,77,48,1512,9,1771,3.142.916.667
16/03/2016 11:00,22.4,52479,118,77,59,1461,9,1724,3.142.916.667
16/03/2016 12:00,22.09,51576,125,78,69,1522,11,1805,3.142.916.667
16/03/2016 13:00,21.79,50983,126,75,82,1560,13,1856,3.142.916.667
16/03/2016 14:00,21.79,50447,132,72,84,1698,11,1997,3.142.916.667
16/03/2016 15:00,21.72,50117,150,72,86,1928,12,2248,3.142.916.667
16/03/2016 16:00,21.9,50218,170,74,85,2165,11,2505,3.142.916.667
16/03/2016 17:00,22.16,51451,185,77,87,2287,10,2646,3.142.916.667
16/03/2016 18:00,22.63,52802,189,79,95,2475,10,2848,3.142.916.667
16/03/2016 19:00,22.39,52987,207,80,97,2600,9,2993,3.142.916.667
16/03/2016 20:00,22.08,51770,239,81,90,2639,6,3055,3.142.916.667
16/03/2016 21:00,21.79,50383,283,82,85,2685,6,3141,3.142.916.667
16/03/2016 22:00,21.16,48179,327,83,80,2687,5,3182,3.142.916.667
16/03/2016 23:00,20.47,45598,382,84,77,2741,4,3288,3.142.916.667
17/03/2016 00:00,20.41,43129,519,112,67,2761,3,3462,3.142.916.667
17/03/2016 01:00,20.07,42367,579,121,58,2741,4,3503,3.142.916.667
17/03/2016 02:00,20.12,42205,647,128,57,2721,4,3557,3.142.916.667
17/03/2016 03:00,20.3,42449,709,134,56,2694,5,3598,3.142.916.667
17/03/2016 04:00,20.91,43423,752,139,59,2677,5,3632,3.142.916.667
17/03/2016 05:00,21.73,46312,780,143,65,2660,5,3653,3.142.916.667
17/03/2016 06:00,22.22,50234,791,146,66,2618,6,3627,3.142.916.667
17/03/2016 07:00,23.26,53813,767,147,73,2562,7,3556,3.142.916.667
17/03/2016 08:00,23.73,54724,716,144,77,2440,11,3388,3.142.916.667
17/03/2016 09:00,23.63,54089,674,141,88,2415,12,3330,3.142.916.667
17/03/2016 10:00,22.62,52917,649,137,105,2401,11,3303,3.142.916.667
17/03/2016 11:00,22.47,52174,621,132,120,2354,14,3241,3.142.916.667
17/03/2016 12:00,22.22,51302,613,130,128,2333,14,3218,3.142.916.667
17/03/2016 13:00,22.04,50839,631,134,133,2253,13,3164,3.142.916.667
17/03/2016 14:00,22.01,50437,660,141,134,2234,12,3181,3.142.916.667
17/03/2016 15:00,21.89,50094,689,152,131,2333,13,3318,3.142.916.667
17/03/2016 16:00,22.03,50264,691,159,126,2395,13,3384,3.142.916.667
17/03/2016 17:00,22.27,51600,683,163,114,2396,12,3368,3.142.916.667
17/03/2016 18:00,22.67,52952,698,163,106,2464,10,3441,3.142.916.667
17/03/2016 19:00,22.49,52933,744,158,98,2503,8,3511,3.142.916.667
17/03/2016 20:00,22.14,51701,801,149,92,2532,7,3581,3.142.916.667
17/03/2016 21:00,21.94,50350,848,140,86,2594,5,3673,3.142.916.667
17/03/2016 22:00,21.39,48276,840,134,79,2679,5,3737,3.142.916.667
17/03/2016 23:00,20.81,45894,813,122,81,2673,6,3695,3.142.916.667
18/03/2016 00:00,20.17,43713,816,110,63,2653,11,3653,3.142.916.667
18/03/2016 01:00,19.61,42959,833,106,60,2643,10,3652,3.142.916.667
18/03/2016 02:00,19.62,42750,806,100,58,2639,9,3612,3.142.916.667
18/03/2016 03:00,19.73,43042,779,99,60,2683,9,3630,3.142.916.667
18/03/2016 04:00,20.11,44108,736,105,68,2818,9,3736,3.142.916.667
18/03/2016 05:00,21.43,47060,674,115,76,2833,12,3710,3.142.916.667
18/03/2016 06:00,22.15,50948,641,126,88,2693,17,3565,3.142.916.667
18/03/2016 07:00,22.85,54631,595,139,110,2614,26,3484,3.142.916.667
18/03/2016 08:00,23.62,55689,514,155,162,2427,38,3296,3.142.916.667
18/03/2016 09:00,23.03,55324,457,170,205,2463,48,3343,3.142.916.667
18/03/2016 10:00,22.48,54494,413,183,235,2457,55,3343,3.142.916.667
18/03/2016 11:00,22.43,53842,372,192,242,2492,55,3353,3.142.916.667
18/03/2016 12:00,22.22,52890,350,194,245,2457,54,3300,3.142.916.667
18/03/2016 13:00,22.03,52017,343,194,246,2401,54,3238,3.142.916.667
18/03/2016 14:00,21.99,51309,320,187,245,2290,53,3095,3.142.916.667
18/03/2016 15:00,22.01,50699,307,178,240,2188,52,2965,3.142.916.667
18/03/2016 16:00,22.07,50816,306,171,233,2044,53,2807,3.142.916.667
18/03/2016 17:00,22.53,51851,289,162,215,1891,52,2609,3.142.916.667
18/03/2016 18:00,23.61,53127,264,157,180,1716,49,2366,3.142.916.667
18/03/2016 19:00,22.97,52690,244,153,155,1476,45,2073,3.142.916.667
18/03/2016 20:00,22.38,51076,230,144,136,1422,40,1972,3.142.916.667
18/03/2016 21:00,22.12,49887,212,135,116,1330,35,1828,3.142.916.667
18/03/2016 22:00,21.72,48307,175,126,98,1315,32,1746,3.142.916.667
18/03/2016 23:00,21.11,46503,143,116,89,1207,30,1585,3.142.916.667
19/03/2016 00:00,21.3,44561,94,111,94,1141,24,1464,3.142.916.667
19/03/2016 01:00,21.16,43799,88,108,86,1061,21,1364,3.142.916.667
19/03/2016 02:00,21.13,43486,90,104,74,999,19,1286,3.142.916.667
19/03/2016 03:00,21.23,43539,100,95,63,963,13,1234,3.142.916.667
19/03/2016 04:00,21.26,43925,110,83,59,979,5,1236,3.142.916.667
19/03/2016 05:00,21.45,44578,116,70,48,1036,2,1272,3.142.916.667
19/03/2016 06:00,21.53,45278,132,63,39,1067,2,1303,3.142.916.667
19/03/2016 07:00,21.7,46736,158,60,27,1087,3,1335,3.142.916.667
19/03/2016 08:00,21.79,48182,194,56,42,1100,7,1399,3.142.916.667
19/03/2016 09:00,22.25,49383,247,59,65,1144,13,1528,3.142.916.667
19/03/2016 10:00,22.11,49628,316,64,91,1213,20,1704,3.142.916.667
19/03/2016 11:00,21.87,49110,419,69,130,1303,22,1943,3.142.916.667
19/03/2016 12:00,21.43,48268,607,70,159,1388,19,2243,3.142.916.667
19/03/2016 13:00,21.13,47573,877,68,173,1451,18,2587,3.142.916.667
19/03/2016 14:00,20.65,47068,1160,60,173,1527,17,2937,3.142.916.667
19/03/2016 15:00,20.41,46712,1364,52,173,1514,15,3118,3.142.916.667
19/03/2016 16:00,20.79,47293,1498,40,175,1497,11,3221,3.142.916.667
19/03/2016 17:00,21.68,48990,1565,32,169,1464,7,3237,3.142.916.667
19/03/2016 18:00,22.29,50618,1633,30,160,1430,2,3255,3.142.916.667
19/03/2016 19:00,22.2,50359,1722,27,155,1398,0,3302,3.142.916.667
19/03/2016 20:00,21.71,48815,1777,26,155,1323,0,3281,3.142.916.667
19/03/2016 21:00,21.53,47879,1753,27,150,1292,0,3222,3.142.916.667
19/03/2016 22:00,21.31,46653,1699,29,130,1257,0,3115,3.142.916.667
19/03/2016 23:00,20.7,45276,1689,30,110,1209,0,3038,3.142.916.667
20/03/2016 00:00,20.15,43139,2018,34,43,1249,5,3349,3.142.916.667
20/03/2016 01:00,19.66,42435,2166,35,33,1159,4,3397,3.142.916.667
20/03/2016 02:00,19.35,42145,2269,35,21,1093,4,3422,3.142.916.667
20/03/2016 03:00,19.25,42155,2324,36,14,996,2,3372,3.142.916.667
20/03/2016 04:00,19.36,42377,2299,35,11,926,1,3272,3.142.916.667
20/03/2016 05:00,19.64,42720,2151,32,11,839,0,3033,3.142.916.667
20/03/2016 06:00,19.74,42927,1972,29,11,739,0,2751,3.142.916.667
20/03/2016 07:00,19.69,43885,1867,27,10,604,0,2508,3.142.916.667
20/03/2016 08:00,19.92,45049,1864,28,8,500,0,2400,3.142.916.667
20/03/2016 09:00,20.3,46294,1789,28,6,403,0,2226,3.142.916.667
20/03/2016 10:00,20.59,46747,1609,31,5,329,0,1974,3.142.916.667
20/03/2016 11:00,20.66,46520,1446,34,6,341,2,1829,3.142.916.667
20/03/2016 12:00,20.52,45934,1336,35,7,366,2,1746,3.142.916.667
20/03/2016 13:00,20.21,45254,1261,36,8,467,2,1774,3.142.916.667
20/03/2016 14:00,20.15,45049,1236,34,10,529,2,1811,3.142.916.667
20/03/2016 15:00,20.14,44879,1243,30,10,604,2,1889,3.142.916.667
20/03/2016 16:00,20.05,45484,1237,27,10,675,1,1950,3.142.916.667
20/03/2016 17:00,20.54,47176,1229,22,10,760,1,2022,3.142.916.667
20/03/2016 18:00,22.02,49099,1219,18,12,848,3,2100,3.142.916.667
20/03/2016 19:00,22.19,49508,1318,14,14,930,0,2276,3.142.916.667
20/03/2016 20:00,21.86,48525,1522,10,16,972,1,2521,3.142.916.667
20/03/2016 21:00,21.54,48441,1746,8,18,979,0,2751,3.142.916.667
20/03/2016 22:00,21.27,46882,1959,7,18,1011,0,2995,3.142.916.667
20/03/2016 23:00,20.33,44366,2149,7,18,1015,1,3190,3.142.916.667
21/03/2016 00:00,20.29,43192,2088,11,26,1217,1,3343,2.971.309.524
21/03/2016 01:00,19.9,42640,2283,12,26,1205,1,3527,2.971.309.524
21/03/2016 02:00,19.81,42592,2270,11,26,1212,1,3520,2.971.309.524
21/03/2016 03:00,19.95,42941,2201,10,26,1166,1,3404,2.971.309.524
21/03/2016 04:00,20.65,43943,2230,9,29,1085,1,3354,2.971.309.524
21/03/2016 05:00,21.83,46631,2311,8,34,987,2,3342,2.971.309.524
21/03/2016 06:00,22.09,50384,2410,8,42,919,3,3382,2.971.309.524
21/03/2016 07:00,22.47,53923,2532,8,55,835,5,3435,2.971.309.524
21/03/2016 08:00,22.81,54493,2630,8,65,753,5,3461,2.971.309.524
21/03/2016 09:00,22.55,53975,2722,8,73,666,4,3473,2.971.309.524
21/03/2016 10:00,22.44,53299,2765,9,88,574,4,3440,2.971.309.524
21/03/2016 11:00,22.29,52493,2743,10,94,522,2,3371,2.971.309.524
21/03/2016 12:00,22.13,51638,2778,12,101,526,2,3419,2.971.309.524
21/03/2016 13:00,22.04,51195,2836,13,107,566,2,3524,2.971.309.524
21/03/2016 14:00,21.9,50975,2847,14,103,597,2,3563,2.971.309.524
21/03/2016 15:00,21.89,50761,2818,15,97,626,3,3559,2.971.309.524
21/03/2016 16:00,21.91,50879,2737,16,88,629,2,3472,2.971.309.524
21/03/2016 17:00,22.21,51832,2621,20,72,641,3,3357,2.971.309.524
21/03/2016 18:00,22.7,52947,2517,25,57,649,2,3250,2.971.309.524
21/03/2016 19:00,22.48,53155,2405,28,46,679,2,3160,2.971.309.524
21/03/2016 20:00,22.13,51787,2283,30,38,671,1,3023,2.971.309.524
21/03/2016 21:00,21.93,50533,2126,32,30,673,1,2862,2.971.309.524
21/03/2016 22:00,21.65,48511,1967,34,24,666,1,2692,2.971.309.524
21/03/2016 23:00,20.9,46179,1867,35,21,640,1,2564,2.971.309.524
22/03/2016 00:00,20.34,44059,1583,32,12,593,2,2222,2.971.309.524
22/03/2016 01:00,20.11,43513,1543,34,11,617,2,2207,2.971.309.524
22/03/2016 02:00,20.08,43412,1396,36,12,604,3,2051,2.971.309.524
22/03/2016 03:00,20.51,43726,1232,39,14,644,5,1934,2.971.309.524
22/03/2016 04:00,21.19,44721,1122,41,17,666,6,1852,2.971.309.524
22/03/2016 05:00,21.96,47046,1050,41,23,724,7,1845,2.971.309.524
22/03/2016 06:00,22.06,50479,974,40,30,733,7,1784,2.971.309.524
22/03/2016 07:00,22.62,53307,965,39,31,755,11,1801,2.971.309.524
22/03/2016 08:00,23.36,54666,1008,35,34,775,13,1865,2.971.309.524
22/03/2016 09:00,23.02,53957,1057,30,39,752,13,1891,2.971.309.524
22/03/2016 10:00,22.68,53372,1075,26,47,729,12,1889,2.971.309.524
22/03/2016 11:00,22.41,52710,1051,25,42,700,9,1827,2.971.309.524
22/03/2016 12:00,22.19,51964,1014,23,39,643,8,1727,2.971.309.524
22/03/2016 13:00,22.09,51458,958,21,37,646,9,1671,2.971.309.524
22/03/2016 14:00,22,50959,898,21,35,678,10,1642,2.971.309.524
22/03/2016 15:00,22.02,50667,834,21,34,699,9,1597,2.971.309.524
22/03/2016 16:00,22.04,50686,744,20,35,723,7,1529,2.971.309.524
22/03/2016 17:00,22.24,51621,627,22,35,784,6,1474,2.971.309.524
22/03/2016 18:00,22.57,52944,570,25,34,873,4,1506,2.971.309.524
22/03/2016 19:00,22.46,53260,591,28,32,886,3,1540,2.971.309.524
22/03/2016 20:00,22.2,52070,639,32,27,889,2,1589,2.971.309.524
22/03/2016 21:00,22,50667,704,36,23,866,1,1630,2.971.309.524
22/03/2016 22:00,21.45,48532,786,40,19,832,0,1677,2.971.309.524
22/03/2016 23:00,20.96,46175,867,42,16,845,0,1770,2.971.309.524
23/03/2016 00:00,20.89,44188,1039,42,15,873,1,1970,2.971.309.524
23/03/2016 01:00,20.51,43492,1167,44,11,887,1,2110,2.971.309.524
23/03/2016 02:00,20.26,43328,1322,46,10,920,2,2300,2.971.309.524
23/03/2016 03:00,20.56,43560,1456,46,11,929,3,2445,2.971.309.524
23/03/2016 04:00,21,44484,1551,46,14,956,3,2570,2.971.309.524
23/03/2016 05:00,21.54,46684,1570,48,16,989,3,2626,2.971.309.524
23/03/2016 06:00,21.85,50018,1550,45,19,1000,4,2618,2.971.309.524
23/03/2016 07:00,22.39,53108,1525,43,21,1022,7,2618,2.971.309.524
23/03/2016 08:00,22.92,53935,1540,37,24,937,9,2547,2.971.309.524
23/03/2016 09:00,22.55,52542,1542,34,27,931,10,2544,2.971.309.524
23/03/2016 10:00,22.43,52451,1473,33,29,886,10,2431,2.971.309.524
23/03/2016 11:00,22.3,52077,1413,33,29,820,8,2303,2.971.309.524
23/03/2016 12:00,21.94,51655,1441,31,31,737,8,2248,2.971.309.524
23/03/2016 13:00,21.86,51381,1495,29,31,709,7,2271,2.971.309.524
23/03/2016 14:00,21.78,50824,1490,25,32,676,4,2227,2.971.309.524
23/03/2016 15:00,21.73,50385,1439,22,32,662,5,2160,2.971.309.524
23/03/2016 16:00,21.73,50202,1297,21,34,627,3,1982,2.971.309.524
23/03/2016 17:00,21.9,50990,1071,23,39,614,2,1749,2.971.309.524
23/03/2016 18:00,22.45,52126,819,28,49,657,1,1554,2.971.309.524
23/03/2016 19:00,22.48,52363,596,32,56,687,0,1371,2.971.309.524
23/03/2016 20:00,22.03,51188,461,38,58,704,3,1264,2.971.309.524
23/03/2016 21:00,21.92,49956,367,44,58,760,1,1230,2.971.309.524
23/03/2016 22:00,21.59,48091,301,47,56,823,2,1229,2.971.309.524
23/03/2016 23:00,21.14,46147,238,48,50,883,3,1222,2.971.309.524
24/03/2016 00:00,21.36,44247,134,65,50,856,6,1111,2.971.309.524
24/03/2016 01:00,21,43479,83,62,40,890,6,1081,2.971.309.524
24/03/2016 02:00,20.71,43214,50,56,32,857,6,1001,2.971.309.524
24/03/2016 03:00,20.87,43368,41,51,28,886,4,1010,2.971.309.524
24/03/2016 04:00,21.35,44037,46,46,24,970,3,1089,2.971.309.524
24/03/2016 05:00,22,45411,56,43,23,1000,2,1124,2.971.309.524
24/03/2016 06:00,21.89,47277,91,40,23,975,2,1131,2.971.309.524
24/03/2016 07:00,22.05,49094,144,41,22,854,6,1067,2.971.309.524
24/03/2016 08:00,22.32,49871,232,44,19,789,7,1091,2.971.309.524
24/03/2016 09:00,22.21,50397,314,49,14,771,7,1155,2.971.309.524
24/03/2016 10:00,21.95,50446,389,54,11,786,4,1244,2.971.309.524
24/03/2016 11:00,21.79,50264,490,56,12,900,3,1461,2.971.309.524
24/03/2016 12:00,21.54,49505,624,57,13,989,3,1686,2.971.309.524
24/03/2016 13:00,21.23,48862,753,54,14,1111,3,1935,2.971.309.524
24/03/2016 14:00,21.03,48491,816,48,14,1262,3,2143,2.971.309.524
24/03/2016 15:00,20.88,48144,826,45,12,1375,5,2263,2.971.309.524
24/03/2016 16:00,20.87,48249,789,46,11,1486,2,2334,2.971.309.524
24/03/2016 17:00,21.09,48799,719,51,10,1580,2,2362,2.971.309.524
24/03/2016 18:00,21.39,49734,649,59,12,1617,1,2338,2.971.309.524
24/03/2016 19:00,21.35,50490,648,67,18,1698,1,2432,2.971.309.524
24/03/2016 20:00,21.13,49743,714,68,21,1749,4,2556,2.971.309.524
24/03/2016 21:00,20.94,48670,788,71,28,1758,2,2647,2.971.309.524
24/03/2016 22:00,20.56,46734,848,72,41,1705,2,2668,2.971.309.524
24/03/2016 23:00,20.28,44572,873,72,65,1634,2,2646,2.971.309.524
25/03/2016 00:00,20.72,42695,915,62,57,1409,2,2445,2.971.309.524
25/03/2016 01:00,20.29,41778,917,61,53,1282,3,2316,2.971.309.524
25/03/2016 02:00,20.26,41292,921,63,45,1209,3,2241,2.971.309.524
25/03/2016 03:00,20,41252,896,65,41,1157,4,2163,2.971.309.524
25/03/2016 04:00,20.05,41406,842,69,43,1120,3,2077,2.971.309.524
25/03/2016 05:00,20.36,41666,803,72,51,1119,4,2049,2.971.309.524
25/03/2016 06:00,20.27,42035,800,75,54,1088,4,2021,2.971.309.524
25/03/2016 07:00,20.4,43026,785,77,54,1030,6,1952,2.971.309.524
25/03/2016 08:00,20.87,43755,746,79,52,969,7,1853,2.971.309.524
25/03/2016 09:00,21.11,45208,714,81,51,1041,9,1896,2.971.309.524
25/03/2016 10:00,21.08,45985,677,85,52,1084,10,1908,2.971.309.524
25/03/2016 11:00,20.96,46353,686,91,60,1107,10,1954,2.971.309.524
25/03/2016 12:00,20.85,46150,772,94,58,1139,11,2074,2.971.309.524
25/03/2016 13:00,20.47,45789,899,94,55,1147,13,2208,2.971.309.524
25/03/2016 14:00,20.4,45438,1093,87,42,1134,13,2369,2.971.309.524
25/03/2016 15:00,20.4,45285,1337,78,27,1144,13,2599,2.971.309.524
25/03/2016 16:00,20.45,45457,1414,71,22,1163,13,2683,2.971.309.524
25/03/2016 17:00,20.73,46129,1247,64,20,1192,12,2535,2.971.309.524
25/03/2016 18:00,21.16,46961,1055,62,22,1247,12,2398,2.971.309.524
25/03/2016 19:00,21.11,47585,975,63,25,1304,7,2374,2.971.309.524
25/03/2016 20:00,20.79,47059,978,67,28,1437,7,2517,2.971.309.524
25/03/2016 21:00,20.53,46280,956,71,33,1544,7,2611,2.971.309.524
25/03/2016 22:00,20.45,44703,872,76,34,1579,7,2568,2.971.309.524
25/03/2016 23:00,20.15,42892,774,75,31,1569,9,2458,2.971.309.524
26/03/2016 00:00,20.82,41752,840,70,34,1366,11,2321,2.971.309.524
26/03/2016 01:00,20.54,40868,735,67,31,1300,9,2142,2.971.309.524
26/03/2016 02:00,20.43,40443,605,62,28,1162,9,1866,2.971.309.524
26/03/2016 03:00,20,40504,544,57,27,1085,8,1721,2.971.309.524
26/03/2016 04:00,20,40715,536,49,26,918,8,1537,2.971.309.524
26/03/2016 05:00,20.01,40936,582,43,23,874,6,1528,2.971.309.524
26/03/2016 06:00,20.01,41141,673,37,19,789,3,1521,2.971.309.524
26/03/2016 07:00,20.47,41989,752,31,13,844,2,1642,2.971.309.524
26/03/2016 08:00,20.88,43504,845,26,10,851,1,1733,2.971.309.524
26/03/2016 09:00,21.11,44357,1050,23,8,962,1,2044,2.971.309.524
26/03/2016 10:00,20.91,44898,1363,20,7,1103,1,2494,2.971.309.524
26/03/2016 11:00,19.97,44857,1702,19,7,1396,1,3125,2.971.309.524
26/03/2016 12:00,19.06,44329,2056,18,8,1626,1,3709,2.971.309.524
26/03/2016 13:00,18.26,43776,2310,16,8,1727,1,4062,2.971.309.524
26/03/2016 14:00,17.51,43347,2445,13,8,1951,1,4418,2.971.309.524
26/03/2016 15:00,17.67,43134,2573,11,9,2063,1,4657,2.971.309.524
26/03/2016 16:00,17.82,43455,2699,10,10,2298,1,5018,2.971.309.524
26/03/2016 17:00,19.2,44195,2795,12,10,2464,0,5281,2.971.309.524
26/03/2016 18:00,20.13,45173,2886,14,10,2699,3,5612,2.971.309.524
26/03/2016 19:00,20.09,45943,3037,18,10,2962,0,6027,2.971.309.524
26/03/2016 20:00,19.94,45587,3247,20,9,3130,0,6406,2.971.309.524
26/03/2016 21:00,18.7,45092,3436,21,8,3295,0,6760,2.971.309.524
26/03/2016 22:00,17.91,43678,3543,23,8,3478,2,7054,2.971.309.524
26/03/2016 23:00,17.16,42097,3585,25,8,3588,0,7206,2.971.309.524
27/03/2016 00:00,15.83,40483,3547,47,12,3748,3,7357,2.971.309.524
27/03/2016 01:00,14.71,39569,3601,47,15,3749,4,7416,2.971.309.524
27/03/2016 02:00,15.075,39312,3623,51,20,3493,5,7192,2.971.309.524
27/03/2016 03:00,15.44,39055,3645,53,19,3760,4,7481,2.971.309.524
27/03/2016 04:00,15.14,39143,3684,56,22,3826,4,7592,2.971.309.524
27/03/2016 05:00,15.47,39285,3676,59,25,3919,5,7684,2.971.309.524
27/03/2016 06:00,15.59,39212,3583,62,27,4057,5,7734,2.971.309.524
27/03/2016 07:00,16.12,39697,3450,66,27,4158,5,7706,2.971.309.524
27/03/2016 08:00,15.99,40654,3135,71,30,4251,6,7493,2.971.309.524
27/03/2016 09:00,16.88,41582,2667,75,40,4375,13,7170,2.971.309.524
27/03/2016 10:00,17.25,41923,2343,83,56,4462,14,6958,2.971.309.524
27/03/2016 11:00,17.3,41687,2106,89,65,4517,15,6792,2.971.309.524
27/03/2016 12:00,16.8,41272,1975,92,75,4552,14,6708,2.971.309.524
27/03/2016 13:00,16.08,40871,1997,90,80,4551,14,6732,2.971.309.524
27/03/2016 14:00,15.57,40454,1953,85,85,4470,14,6607,2.971.309.524
27/03/2016 15:00,15.55,40403,1832,82,86,4384,12,6396,2.971.309.524
27/03/2016 16:00,15.98,40787,1755,82,94,4118,10,6059,2.971.309.524
27/03/2016 17:00,17.03,41714,1643,84,100,3906,8,5741,2.971.309.524
27/03/2016 18:00,17.54,42986,1562,89,108,3584,7,5350,2.971.309.524
27/03/2016 19:00,19.6,44104,1602,94,116,3412,6,5230,2.971.309.524
27/03/2016 20:00,20.43,44304,1723,100,122,3247,7,5199,2.971.309.524
27/03/2016 21:00,19.87,43797,1920,106,126,3119,9,5280,2.971.309.524
27/03/2016 22:00,19.5,42733,2107,108,127,2998,0,5340,2.971.309.524
27/03/2016 23:00,18.5,41073,2155,138,135,2968,12,5408,2.971.309.524
28/03/2016 00:00,15.69,39548,2221,134,134,2863,12,5364,2.835.357.143
28/03/2016 01:00,14.8,38996,2280,133,129,2739,15,5296,2.835.357.143
28/03/2016 02:00,14.69,38879,2266,132,122,2600,12,5132,2.835.357.143
28/03/2016 03:00,14.45,38973,2190,127,124,2522,12,4975,2.835.357.143
28/03/2016 04:00,15.36,39381,2108,124,122,2537,13,4904,2.835.357.143
28/03/2016 05:00,16.42,39847,2093,119,115,2562,13,4902,2.835.357.143
28/03/2016 06:00,15.89,40192,2161,109,103,2648,12,5033,2.835.357.143
28/03/2016 07:00,16.06,40945,2314,97,91,2685,13,5200,2.835.357.143
28/03/2016 08:00,16.65,42034,2558,84,78,2696,10,5426,2.835.357.143
28/03/2016 09:00,17.58,43008,2898,74,70,2739,9,5790,2.835.357.143
28/03/2016 10:00,18.09,43497,3297,73,67,2838,12,6287,2.835.357.143
28/03/2016 11:00,18.02,43480,3667,78,75,3081,15,6916,2.835.357.143
28/03/2016 12:00,17.53,43127,3562,83,81,3325,14,7065,2.835.357.143
28/03/2016 13:00,17.15,42785,3762,81,85,3499,13,7440,2.835.357.143
28/03/2016 14:00,16.76,42514,3881,72,84,3564,10,7611,2.835.357.143
28/03/2016 15:00,16.56,42350,3303,61,87,3454,7,6912,2.835.357.143
28/03/2016 16:00,16.67,42862,3315,59,93,3510,7,6984,2.835.357.143
28/03/2016 17:00,17.05,43743,3946,62,102,3615,6,7731,2.835.357.143
28/03/2016 18:00,18.21,44934,4379,69,113,3637,4,8202,2.835.357.143
28/03/2016 19:00,18.59,46109,4428,79,119,3648,5,8279,2.835.357.143
28/03/2016 20:00,18.64,46136,4407,91,123,3731,7,8359,2.835.357.143
28/03/2016 21:00,18.08,45593,4330,102,125,3818,8,8383,2.835.357.143
28/03/2016 22:00,17.73,44117,4261,105,127,3788,10,8291,2.835.357.143
28/03/2016 23:00,16.73,42608,4172,130,172,3520,14,8008,2.835.357.143
29/03/2016 00:00,16.51,41199,3644,129,166,3152,14,7105,2.835.357.143
29/03/2016 01:00,16.42,40581,3443,129,158,2905,17,6652,2.835.357.143
29/03/2016 02:00,15.78,40451,3175,131,153,2757,17,6233,2.835.357.143
29/03/2016 03:00,15.78,40714,2870,132,152,2631,18,5803,2.835.357.143
29/03/2016 04:00,16.7,41639,2605,133,154,2552,20,5464,2.835.357.143
29/03/2016 05:00,18.84,43519,2398,133,156,2528,21,5236,2.835.357.143
29/03/2016 06:00,20.53,46993,2243,133,159,2459,25,5019,2.835.357.143
29/03/2016 07:00,21.46,49984,2132,128,156,2446,25,4887,2.835.357.143
29/03/2016 08:00,21.67,49576,2114,125,146,2301,26,4712,2.835.357.143
29/03/2016 09:00,21.64,49645,2193,123,130,2279,27,4752,2.835.357.143
29/03/2016 10:00,21.53,49599,2272,124,115,2351,26,4888,2.835.357.143
29/03/2016 11:00,21.37,49296,2306,125,107,2297,32,4867,2.835.357.143
29/03/2016 12:00,20.87,49129,2312,128,96,2307,33,4876,2.835.357.143
29/03/2016 13:00,20.38,48977,2335,125,84,2371,31,4946,2.835.357.143
29/03/2016 14:00,20.05,48511,2321,119,68,2372,29,4909,2.835.357.143
29/03/2016 15:00,19.96,48135,2211,112,56,2436,21,4836,2.835.357.143
29/03/2016 16:00,20.08,48061,2079,109,48,2368,15,4619,2.835.357.143
29/03/2016 17:00,21.13,48834,1900,107,40,2375,6,4428,2.835.357.143
29/03/2016 18:00,21.48,49722,1632,101,40,2361,3,4137,2.835.357.143
29/03/2016 19:00,21.62,50177,1370,100,46,2301,4,3821,2.835.357.143
29/03/2016 20:00,21.52,49479,1235,96,54,2338,1,3724,2.835.357.143
29/03/2016 21:00,21.19,48378,1253,90,62,2461,1,3867,2.835.357.143
29/03/2016 22:00,20.55,46467,1304,81,72,2522,0,3979,2.835.357.143
29/03/2016 23:00,20.09,43979,1322,67,58,2318,0,3765,2.835.357.143
30/03/2016 00:00,20.32,42078,1101,63,68,2153,1,3386,2.835.357.143
30/03/2016 01:00,20.15,41210,1038,60,83,1967,1,3149,2.835.357.143
30/03/2016 02:00,20.22,40919,950,57,86,1796,1,2890,2.835.357.143
30/03/2016 03:00,19.94,41135,815,54,91,1525,3,2488,2.835.357.143
30/03/2016 04:00,20.23,42091,665,50,93,1390,3,2201,2.835.357.143
30/03/2016 05:00,21.31,44268,610,45,93,1260,3,2011,2.835.357.143
30/03/2016 06:00,21.95,47666,609,38,97,1228,6,1978,2.835.357.143
30/03/2016 07:00,23.41,50916,611,29,96,1191,6,1933,2.835.357.143
30/03/2016 08:00,24.99,51130,649,20,98,1042,7,1816,2.835.357.143
30/03/2016 09:00,23.98,51112,744,15,106,917,7,1789,2.835.357.143
30/03/2016 10:00,23,50985,840,15,110,915,8,1888,2.835.357.143
30/03/2016 11:00,22.25,50649,905,16,107,983,9,2020,2.835.357.143
30/03/2016 12:00,21.88,50226,979,18,99,987,7,2090,2.835.357.143
30/03/2016 13:00,21.81,49871,1153,19,91,961,10,2234,2.835.357.143
30/03/2016 14:00,21.72,49456,1288,21,70,934,15,2328,2.835.357.143
30/03/2016 15:00,21.61,49029,1339,22,45,938,11,2355,2.835.357.143
30/03/2016 16:00,21.61,48846,1408,22,37,925,10,2402,2.835.357.143
30/03/2016 17:00,21.79,49410,1377,23,30,903,9,2342,2.835.357.143
30/03/2016 18:00,21.98,50067,1217,21,37,931,5,2211,2.835.357.143
30/03/2016 19:00,22.4,50319,1063,21,41,919,6,2050,2.835.357.143
30/03/2016 20:00,21.98,49520,966,19,46,917,5,1953,2.835.357.143
30/03/2016 21:00,21.75,48444,950,20,57,983,3,2013,2.835.357.143
30/03/2016 22:00,21.4,46540,969,19,69,1007,4,2068,2.835.357.143
30/03/2016 23:00,21.03,44301,960,9,103,908,2,1982,2.835.357.143
31/03/2016 00:00,20.65,42690,930,7,122,938,3,2000,2.835.357.143
31/03/2016 01:00,20.32,41845,930,6,130,909,3,1978,2.835.357.143
31/03/2016 02:00,20.22,41525,902,6,144,881,2,1935,2.835.357.143
31/03/2016 03:00,20.31,41797,840,5,163,846,1,1855,2.835.357.143
31/03/2016 04:00,20.7,42732,766,5,187,786,1,1745,2.835.357.143
31/03/2016 05:00,21.62,44733,711,5,202,729,1,1648,2.835.357.143
31/03/2016 06:00,22.91,47890,670,4,216,660,5,1555,2.835.357.143
31/03/2016 07:00,26.1,50965,634,3,235,600,6,1478,2.835.357.143
31/03/2016 08:00,28.14,51886,624,3,245,560,6,1438,2.835.357.143
31/03/2016 09:00,27.06,51671,689,3,251,585,3,1531,2.835.357.143
31/03/2016 10:00,25.01,51510,822,4,246,615,3,1690,2.835.357.143
31/03/2016 11:00,24.07,50993,996,5,224,650,4,1879,2.835.357.143
31/03/2016 12:00,22.61,50346,1192,7,198,698,4,2099,2.835.357.143
31/03/2016 13:00,22.05,49837,1387,9,170,748,4,2318,2.835.357.143
31/03/2016 14:00,21.85,49365,1542,12,138,766,7,2465,2.835.357.143
31/03/2016 15:00,21.76,49039,1668,14,120,809,8,2619,2.835.357.143
31/03/2016 16:00,21.65,48825,1753,16,94,844,6,2713,2.835.357.143
31/03/2016 17:00,21.74,49305,1751,16,76,892,4,2739,2.835.357.143
31/03/2016 18:00,21.86,49915,1696,17,55,976,2,2746,2.835.357.143
31/03/2016 19:00,21.98,50204,1590,18,32,1142,1,2783,2.835.357.143
31/03/2016 20:00,21.93,49749,1486,18,27,1305,1,2837,2.835.357.143
31/03/2016 21:00,21.78,48789,1463,19,25,1556,1,3064,2.835.357.143
31/03/2016 22:00,21.38,46985,1451,19,23,1780,2,3275,2.835.357.143
31/03/2016 23:00,20.48,44712,1418,31,36,1998,5,3488,2.835.357.143
01/04/2016 00:00,20.71,43075,1201,31,31,2063,5,3331,2.835.357.143
01/04/2016 01:00,20.33,42203,1156,26,25,2102,5,3314,2.835.357.143
01/04/2016 02:00,20.36,41881,1092,21,23,2254,6,3396,2.835.357.143
01/04/2016 03:00,20.16,42055,1014,16,26,2298,5,3359,2.835.357.143
01/04/2016 04:00,20.63,42937,923,15,34,2263,3,3238,2.835.357.143
01/04/2016 05:00,21.46,45148,787,12,44,2185,3,3031,2.835.357.143
01/04/2016 06:00,22.61,48592,648,11,57,2159,4,2879,2.835.357.143
01/04/2016 07:00,26.39,51979,551,10,63,2045,8,2677,2.835.357.143
01/04/2016 08:00,29.64,52953,466,8,82,1920,8,2484,2.835.357.143
01/04/2016 09:00,29.89,52877,383,7,98,1750,8,2246,2.835.357.143
01/04/2016 10:00,28.3,52117,333,6,126,1654,8,2127,2.835.357.143
01/04/2016 11:00,25.97,51307,289,6,152,1590,8,2045,2.835.357.143
01/04/2016 12:00,23.05,50290,272,8,176,1570,8,2034,2.835.357.143
01/04/2016 13:00,22.25,49450,300,11,186,1587,9,2093,2.835.357.143
01/04/2016 14:00,21.85,48743,344,15,190,1579,12,2140,2.835.357.143
01/04/2016 15:00,21.6,47992,375,22,195,1575,15,2182,2.835.357.143
01/04/2016 16:00,21.66,47797,391,33,196,1454,16,2090,2.835.357.143
01/04/2016 17:00,21.77,48385,361,43,205,1242,20,1871,2.835.357.143
01/04/2016 18:00,21.99,49491,296,57,213,1080,25,1671,2.835.357.143
01/04/2016 19:00,22.04,49748,240,68,207,997,30,1542,2.835.357.143
01/04/2016 20:00,21.94,48664,235,78,191,1017,28,1549,2.835.357.143
01/04/2016 21:00,21.76,47690,277,86,168,1026,26,1583,2.835.357.143
01/04/2016 22:00,21.5,46184,358,89,138,1018,18,1621,2.835.357.143
01/04/2016 23:00,21.06,44293,466,83,110,1097,3,1759,2.835.357.143
02/04/2016 00:00,21.11,42229,806,86,92,1134,3,2121,2.835.357.143
02/04/2016 01:00,20.8,41349,922,86,76,1179,5,2268,2.835.357.143
02/04/2016 02:00,20.59,40904,1027,84,73,1150,7,2341,2.835.357.143
02/04/2016 03:00,19.84,40813,1111,81,73,1190,7,2462,2.835.357.143
02/04/2016 04:00,19.91,41074,1197,78,73,1310,6,2664,2.835.357.143
02/04/2016 05:00,20.09,41414,1256,71,63,1321,5,2716,2.835.357.143
02/04/2016 06:00,20.19,42061,1293,63,59,1372,4,2791,2.835.357.143
02/04/2016 07:00,20.79,43312,1324,56,54,1428,2,2864,2.835.357.143
02/04/2016 08:00,21.14,44860,1322,50,45,1407,2,2826,2.835.357.143
02/04/2016 09:00,21.33,45715,1296,48,44,1384,2,2774,2.835.357.143
02/04/2016 10:00,20.81,46020,1306,48,44,1416,2,2816,2.835.357.143
02/04/2016 11:00,20.08,45573,1320,53,56,1564,3,2996,2.835.357.143
02/04/2016 12:00,19.77,45123,1334,57,69,1710,4,3174,2.835.357.143
02/04/2016 13:00,19.76,44667,1323,64,84,1787,6,3264,2.835.357.143
02/04/2016 14:00,19.36,44205,1222,69,75,1780,5,3151,2.835.357.143
02/04/2016 15:00,19.28,44069,1066,67,65,1777,4,2979,2.835.357.143
02/04/2016 16:00,19.36,44511,905,64,44,1808,3,2824,2.835.357.143
02/04/2016 17:00,20.45,45586,733,57,28,1826,2,2646,2.835.357.143
02/04/2016 18:00,21.54,46777,543,51,21,1784,2,2401,2.835.357.143
02/04/2016 19:00,21.72,46764,386,46,18,1728,3,2181,2.835.357.143
02/04/2016 20:00,21.56,45859,308,43,18,1683,2,2054,2.835.357.143
02/04/2016 21:00,21.38,44957,295,43,21,1579,2,1940,2.835.357.143
02/04/2016 22:00,21.17,43805,296,44,23,1530,2,1895,2.835.357.143
02/04/2016 23:00,20.92,42252,301,48,26,1287,5,1667,2.835.357.143
03/04/2016 00:00,20.14,40915,249,46,30,1148,5,1478,2.835.357.143
03/04/2016 01:00,18.9,40016,228,44,35,988,5,1300,2.835.357.143
03/04/2016 02:00,18.56,39570,219,44,36,875,5,1179,2.835.357.143
03/04/2016 03:00,18.57,39374,225,42,47,781,4,1099,2.835.357.143
03/04/2016 04:00,18.29,39479,259,39,50,660,4,1012,2.835.357.143
03/04/2016 05:00,18.4,39593,331,38,48,535,4,956,2.835.357.143
03/04/2016 06:00,18.43,39770,434,33,45,447,4,963,2.835.357.143
03/04/2016 07:00,18.57,40424,577,30,42,347,6,1002,2.835.357.143
03/04/2016 08:00,19.08,41396,704,27,39,267,8,1045,2.835.357.143
03/04/2016 09:00,19.41,42758,793,23,39,217,12,1084,2.835.357.143
03/04/2016 10:00,19.72,43490,873,20,42,184,15,1134,2.835.357.143
03/04/2016 11:00,19.83,43438,977,19,47,191,19,1253,2.835.357.143
03/04/2016 12:00,19.29,43166,1062,19,57,206,20,1364,2.835.357.143
03/04/2016 13:00,19.18,42902,1141,17,63,228,19,1468,2.835.357.143
03/04/2016 14:00,19.15,42648,1150,16,61,279,14,1520,2.835.357.143
03/04/2016 15:00,19.58,42602,1063,13,56,289,12,1433,2.835.357.143
03/04/2016 16:00,20.12,42974,1016,9,47,339,9,1420,2.835.357.143
03/04/2016 17:00,20.41,44001,928,8,47,439,5,1427,2.835.357.143
03/04/2016 18:00,21.19,45140,768,7,48,549,2,1374,2.835.357.143
03/04/2016 19:00,21.95,45596,647,5,50,662,2,1366,2.835.357.143
03/04/2016 20:00,22.02,45443,547,5,51,823,0,1426,2.835.357.143
03/04/2016 21:00,21.68,44708,447,5,52,905,0,1409,2.835.357.143
03/04/2016 22:00,21.38,43200,386,4,53,1033,0,1476,2.835.357.143
03/04/2016 23:00,20.71,41322,316,10,51,1015,1,1393,2.835.357.143
04/04/2016 00:00,20.49,40318,169,15,41,1011,1,1237,272.797.619
04/04/2016 01:00,19.59,39532,158,18,39,1016,1,1232,272.797.619
04/04/2016 02:00,19.15,39331,160,19,28,976,2,1185,272.797.619
04/04/2016 03:00,19.14,39494,166,21,20,1048,1,1256,272.797.619
04/04/2016 04:00,19.34,40276,191,20,17,1114,1,1343,272.797.619
04/04/2016 05:00,20.94,42536,258,19,13,1136,2,1428,272.797.619
04/04/2016 06:00,22.58,45998,349,15,12,1174,4,1554,272.797.619
04/04/2016 07:00,26.94,49318,473,12,12,1050,4,1551,272.797.619
04/04/2016 08:00,31.79,49636,576,10,15,1014,4,1619,272.797.619
04/04/2016 09:00,30.02,49822,616,10,15,1005,4,1650,272.797.619
04/04/2016 10:00,28.49,49853,633,10,15,983,2,1643,272.797.619
04/04/2016 11:00,25.35,49584,639,11,15,981,1,1647,272.797.619
04/04/2016 12:00,23.12,49187,656,12,16,983,1,1668,272.797.619
04/04/2016 13:00,23.56,48833,708,13,19,1008,1,1749,272.797.619
04/04/2016 14:00,22.98,48514,733,14,22,1033,3,1805,272.797.619
04/04/2016 15:00,22.28,48061,745,15,25,940,2,1727,272.797.619
04/04/2016 16:00,22.45,47811,775,18,25,974,2,1794,272.797.619
04/04/2016 17:00,22.41,48085,730,24,26,1033,2,1815,272.797.619
04/04/2016 18:00,22.61,48526,642,30,37,1058,3,1770,272.797.619
04/04/2016 19:00,23.2,48776,585,37,52,1082,6,1762,272.797.619
04/04/2016 20:00,22.85,48400,544,43,59,1095,4,1745,272.797.619
04/04/2016 21:00,22.37,47206,491,49,67,1015,4,1626,272.797.619
04/04/2016 22:00,21.78,45207,416,48,75,949,4,1492,272.797.619
04/04/2016 23:00,21.09,42718,355,54,77,896,7,1389,272.797.619
05/04/2016 00:00,20.31,40855,647,55,77,770,8,1557,272.797.619
05/04/2016 01:00,20.04,39777,588,57,73,651,7,1376,272.797.619
05/04/2016 02:00,20.03,39436,504,55,72,583,5,1219,272.797.619
05/04/2016 03:00,19.81,39638,414,54,73,525,6,1072,272.797.619
05/04/2016 04:00,20.08,40500,358,54,74,474,8,968,272.797.619
05/04/2016 05:00,21.14,42648,314,53,74,448,9,898,272.797.619
05/04/2016 06:00,22.71,46483,258,49,73,410,12,802,272.797.619
05/04/2016 07:00,25.2,50015,226,39,71,393,11,740,272.797.619
05/04/2016 08:00,26.42,50240,210,31,66,373,10,690,272.797.619
05/04/2016 09:00,26.41,50230,196,26,62,338,9,631,272.797.619
05/04/2016 10:00,26.25,50094,182,26,62,321,7,598,272.797.619
05/04/2016 11:00,24.33,49630,187,26,65,339,6,623,272.797.619
05/04/2016 12:00,23.33,49255,227,29,70,339,7,672,272.797.619
05/04/2016 13:00,22.94,48910,294,31,72,332,9,738,272.797.619
05/04/2016 14:00,22.83,48531,339,31,73,343,10,796,272.797.619
05/04/2016 15:00,22.6,48070,354,33,73,369,10,839,272.797.619
05/04/2016 16:00,22.54,47837,346,39,76,397,9,867,272.797.619
05/04/2016 17:00,22.82,48260,316,48,84,396,8,852,272.797.619
05/04/2016 18:00,22.81,48665,286,61,96,385,7,835,272.797.619
05/04/2016 19:00,23.19,48869,290,74,101,393,9,867,272.797.619
05/04/2016 20:00,22.95,48394,320,82,104,408,8,922,272.797.619
05/04/2016 21:00,22.69,47145,398,89,107,403,8,1005,272.797.619
05/04/2016 22:00,21.96,44991,530,92,108,420,7,1157,272.797.619
05/04/2016 23:00,21.05,42360,674,108,118,385,9,1294,272.797.619
06/04/2016 00:00,19.76,39659,603,109,113,389,8,1222,272.797.619
06/04/2016 01:00,19.2,38703,828,109,105,407,10,1459,272.797.619
06/04/2016 02:00,19.06,38328,1075,110,103,496,12,1796,272.797.619
06/04/2016 03:00,18.95,38487,1230,112,98,636,14,2090,272.797.619
06/04/2016 04:00,19.02,39265,1313,114,93,751,15,2286,272.797.619
06/04/2016 05:00,20.05,41337,1408,120,91,860,17,2496,272.797.619
06/04/2016 06:00,21.52,45315,1566,125,87,1022,19,2819,272.797.619
06/04/2016 07:00,22.83,49147,1794,125,88,1169,24,3200,272.797.619
06/04/2016 08:00,23.55,49440,1957,125,93,1342,33,3550,272.797.619
06/04/2016 09:00,22.95,49794,2049,130,110,1614,41,3944,272.797.619
06/04/2016 10:00,22.71,50146,2150,139,125,1994,40,4448,272.797.619
06/04/2016 11:00,22,50224,2218,149,135,2143,40,4685,272.797.619
06/04/2016 12:00,21.39,49998,2248,159,147,2286,39,4879,272.797.619
06/04/2016 13:00,21.11,49839,2227,161,164,2406,36,4994,272.797.619
06/04/2016 14:00,21.08,49500,2176,161,162,2505,32,5036,272.797.619
06/04/2016 15:00,20.56,49080,2087,155,150,2642,28,5062,272.797.619
06/04/2016 16:00,20.88,48696,1948,146,137,2677,28,4936,272.797.619
06/04/2016 17:00,21.26,48979,1703,129,122,2689,27,4670,272.797.619
06/04/2016 18:00,21.69,49295,1463,119,108,2681,29,4400,272.797.619
06/04/2016 19:00,21.98,49322,1391,111,98,2631,27,4258,272.797.619
06/04/2016 20:00,21.84,48841,1480,105,89,2481,24,4179,272.797.619
06/04/2016 21:00,21.3,47602,1664,101,82,2364,21,4232,272.797.619
06/04/2016 22:00,20.09,45382,1884,94,76,2321,19,4394,272.797.619
06/04/2016 23:00,18.99,42684,1952,107,59,2367,11,4496,272.797.619
07/04/2016 00:00,17.45,40543,1933,101,60,2309,8,4411,272.797.619
07/04/2016 01:00,16.66,39507,2005,96,60,2271,8,4440,272.797.619
07/04/2016 02:00,16.49,39128,2052,90,67,2178,6,4393,272.797.619
07/04/2016 03:00,15.95,39202,2050,86,77,2216,7,4436,272.797.619
07/04/2016 04:00,16.93,40064,2008,84,83,2191,7,4373,272.797.619
07/04/2016 05:00,18.91,42161,2016,86,87,2153,6,4348,272.797.619
07/04/2016 06:00,20.79,45828,2147,84,90,2129,8,4458,272.797.619
07/04/2016 07:00,21.59,49381,2289,84,93,2132,15,4613,272.797.619
07/04/2016 08:00,21.92,49087,2463,84,100,2219,17,4883,272.797.619
07/04/2016 09:00,21.83,49287,2633,89,118,2382,22,5244,272.797.619
07/04/2016 10:00,21.53,49505,2787,100,130,2444,19,5480,272.797.619
07/04/2016 11:00,21.43,49533,2884,113,144,2448,24,5613,272.797.619
07/04/2016 12:00,21.35,49202,2923,119,155,2467,33,5697,272.797.619
07/04/2016 13:00,21.34,49040,2931,121,161,2608,36,5857,272.797.619
07/04/2016 14:00,21.21,48662,2859,123,132,2520,26,5660,272.797.619
07/04/2016 15:00,20.9,48160,2740,126,94,2468,19,5447,272.797.619
07/04/2016 16:00,21.07,48092,2603,131,64,2460,10,5268,272.797.619
07/04/2016 17:00,21.25,48394,2358,140,34,2433,6,4971,272.797.619
07/04/2016 18:00,21.52,48682,2041,146,22,2358,5,4572,272.797.619
07/04/2016 19:00,21.87,48898,1761,148,13,2376,5,4303,272.797.619
07/04/2016 20:00,21.65,48656,1562,146,13,2473,2,4196,272.797.619
07/04/2016 21:00,21.35,47666,1422,148,14,2415,3,4002,272.797.619
07/04/2016 22:00,20.82,45670,1306,146,18,2438,2,3910,272.797.619
07/04/2016 23:00,19.95,43194,1279,131,28,2286,8,3732,272.797.619
08/04/2016 00:00,19.55,41104,1444,130,25,2277,6,3882,272.797.619
08/04/2016 01:00,19.29,40006,1443,127,26,2261,4,3861,272.797.619
08/04/2016 02:00,19.24,39581,1401,121,28,2177,4,3731,272.797.619
08/04/2016 03:00,19.3,39745,1366,112,31,2141,6,3656,272.797.619
08/04/2016 04:00,19.64,40634,1371,105,31,2115,7,3629,272.797.619
08/04/2016 05:00,20.36,42764,1389,96,29,2043,7,3564,272.797.619
08/04/2016 06:00,21.51,46229,1389,90,24,2017,10,3530,272.797.619
08/04/2016 07:00,22.69,49724,1398,89,17,1995,12,3511,272.797.619
08/04/2016 08:00,23.96,49739,1450,92,14,1965,20,3541,272.797.619
08/04/2016 09:00,23.93,49982,1562,97,16,1815,21,3511,272.797.619
08/04/2016 10:00,23.45,49890,1712,99,20,1769,24,3624,272.797.619
08/04/2016 11:00,22.9,49598,1824,101,25,1810,27,3787,272.797.619
08/04/2016 12:00,22.75,48951,1876,97,31,1865,27,3896,272.797.619
08/04/2016 13:00,22.5,48324,1861,90,32,1928,25,3936,272.797.619
08/04/2016 14:00,22.12,47447,1799,84,30,1937,23,3873,272.797.619
08/04/2016 15:00,21.49,46608,1690,77,24,1912,17,3720,272.797.619
08/04/2016 16:00,21.62,46347,1553,70,19,1775,12,3429,272.797.619
08/04/2016 17:00,21.75,46640,1370,62,17,1645,9,3103,272.797.619
08/04/2016 18:00,22.14,46979,1135,55,18,1575,6,2789,272.797.619
08/04/2016 19:00,22.19,46921,904,51,18,1518,6,2497,272.797.619
08/04/2016 20:00,21.79,46344,739,49,19,1576,3,2386,272.797.619
08/04/2016 21:00,21.79,45495,673,49,19,1566,3,2310,272.797.619
08/04/2016 22:00,21.22,44000,649,43,16,1600,3,2311,272.797.619
08/04/2016 23:00,20.77,42250,631,53,14,1610,3,2311,272.797.619
09/04/2016 00:00,21.02,40573,759,46,12,1673,2,2492,272.797.619
09/04/2016 01:00,20.6,39590,743,40,11,1583,3,2380,272.797.619
09/04/2016 02:00,20.53,39094,691,35,9,1470,3,2208,272.797.619
09/04/2016 03:00,20.57,38989,616,30,9,1482,2,2139,272.797.619
09/04/2016 04:00,20.56,39122,543,23,9,1407,2,1984,272.797.619
09/04/2016 05:00,20.79,39456,471,18,9,1348,2,1848,272.797.619
09/04/2016 06:00,21.13,40085,400,16,8,1257,1,1682,272.797.619
09/04/2016 07:00,21.19,41464,334,15,8,1079,0,1436,272.797.619
09/04/2016 08:00,21.83,42953,286,16,8,975,2,1287,272.797.619
09/04/2016 09:00,22.25,44309,274,18,9,853,2,1156,272.797.619
09/04/2016 10:00,22.15,44746,293,20,11,798,2,1124,272.797.619
09/04/2016 11:00,21.99,44381,281,21,14,755,3,1074,272.797.619
09/04/2016 12:00,21.41,43767,251,21,19,737,0,1028,272.797.619
09/04/2016 13:00,20.56,43289,242,20,24,737,1,1024,272.797.619
09/04/2016 14:00,20.15,42793,226,17,28,697,1,969,272.797.619
09/04/2016 15:00,20.24,42609,203,13,33,647,1,897,272.797.619
09/04/2016 16:00,20.5,42937,194,10,36,610,1,851,272.797.619
09/04/2016 17:00,21.43,43859,196,9,40,653,1,899,272.797.619
09/04/2016 18:00,22.3,44702,225,9,46,707,5,992,272.797.619
09/04/2016 19:00,22.26,44733,262,9,54,732,4,1061,272.797.619
09/04/2016 20:00,22.14,44377,299,8,62,775,3,1147,272.797.619
09/04/2016 21:00,21.89,43815,354,9,69,879,3,1314,272.797.619
09/04/2016 22:00,21.4,42732,437,9,73,952,3,1474,272.797.619
09/04/2016 23:00,21.06,41311,495,19,76,967,0,1557,272.797.619
10/04/2016 00:00,20.79,40354,517,19,81,940,0,1557,272.797.619
10/04/2016 01:00,20.17,39504,535,17,80,918,0,1550,272.797.619
10/04/2016 02:00,19.73,39135,546,15,75,909,0,1545,272.797.619
10/04/2016 03:00,19.59,39021,567,12,71,884,1,1535,272.797.619
10/04/2016 04:00,19.6,39046,605,9,71,855,2,1542,272.797.619
10/04/2016 05:00,19.5,39097,673,7,72,807,2,1561,272.797.619
10/04/2016 06:00,19.55,39267,728,5,74,732,2,1541,272.797.619
10/04/2016 07:00,19.66,40023,751,5,76,578,1,1411,272.797.619
10/04/2016 08:00,20.2,41851,727,5,78,404,4,1218,272.797.619
10/04/2016 09:00,20.79,42979,736,6,79,304,5,1130,272.797.619
10/04/2016 10:00,20.89,43444,778,7,80,257,7,1129,272.797.619
10/04/2016 11:00,20.89,43152,790,9,80,226,11,1116,272.797.619
10/04/2016 12:00,20.27,42661,784,12,82,244,12,1134,272.797.619
10/04/2016 13:00,20.11,42059,782,15,83,291,15,1186,272.797.619
10/04/2016 14:00,20.02,41683,788,18,86,301,19,1212,272.797.619
10/04/2016 15:00,20.06,41538,771,21,90,304,21,1207,272.797.619
10/04/2016 16:00,20.4,41704,761,22,94,331,21,1229,272.797.619
10/04/2016 17:00,20.64,42483,745,23,102,369,21,1260,272.797.619
10/04/2016 18:00,21.07,43410,729,24,108,412,21,1294,272.797.619
10/04/2016 19:00,21.8,43787,709,26,111,451,15,1312,272.797.619
10/04/2016 20:00,21.84,44126,666,25,111,503,16,1321,272.797.619
10/04/2016 21:00,21.76,44002,636,25,110,558,13,1342,272.797.619
10/04/2016 22:00,21.14,42742,627,24,109,566,12,1338,272.797.619
10/04/2016 23:00,20.04,41010,605,38,136,570,6,1355,272.797.619
11/04/2016 00:00,20.02,40071,736,33,130,581,6,1486,2.607.142.857
11/04/2016 01:00,19.4,39382,696,29,123,554,6,1408,2.607.142.857
11/04/2016 02:00,19.33,39189,667,25,120,545,5,1362,2.607.142.857
11/04/2016 03:00,19.54,39423,647,20,115,540,4,1326,2.607.142.857
11/04/2016 04:00,20.27,40315,631,16,112,536,3,1298,2.607.142.857
11/04/2016 05:00,21.33,42473,643,13,107,563,3,1329,2.607.142.857
11/04/2016 06:00,22.63,46311,665,10,99,576,3,1353,2.607.142.857
11/04/2016 07:00,27.94,49694,669,6,92,554,4,1325,2.607.142.857
11/04/2016 08:00,34.5,50484,667,4,87,556,6,1320,2.607.142.857
11/04/2016 09:00,29.33,50112,712,4,82,554,7,1359,2.607.142.857
11/04/2016 10:00,25.93,49522,850,5,79,557,9,1500,2.607.142.857
11/04/2016 11:00,23.52,48807,1009,6,78,637,8,1738,2.607.142.857
11/04/2016 12:00,22.73,47843,1122,9,78,685,9,1903,2.607.142.857
11/04/2016 13:00,22.48,47373,1201,12,77,698,9,1997,2.607.142.857
11/04/2016 14:00,22.21,46913,1225,15,75,710,10,2035,2.607.142.857
11/04/2016 15:00,21.75,46340,1198,18,72,739,11,2038,2.607.142.857
11/04/2016 16:00,22.15,46170,1180,18,68,703,14,1983,2.607.142.857
11/04/2016 17:00,22.4,46357,1173,18,67,731,11,2000,2.607.142.857
11/04/2016 18:00,22.47,46494,1182,20,66,768,8,2044,2.607.142.857
11/04/2016 19:00,22.59,46669,1216,22,70,771,4,2083,2.607.142.857
11/04/2016 20:00,22.55,46734,1228,26,73,858,6,2191,2.607.142.857
11/04/2016 21:00,22.28,46164,1266,30,76,1034,5,2411,2.607.142.857
11/04/2016 22:00,21.63,44619,1357,30,81,1034,5,2507,2.607.142.857
11/04/2016 23:00,21.05,42437,1373,40,91,1118,4,2626,2.607.142.857
12/04/2016 00:00,20.6,40838,1233,38,86,1134,4,2495,2.607.142.857
12/04/2016 01:00,20.27,39938,1184,35,79,1186,5,2489,2.607.142.857
12/04/2016 02:00,20.2,39678,1141,28,74,1217,3,2463,2.607.142.857
12/04/2016 03:00,20.2,39940,1100,21,71,1153,3,2348,2.607.142.857
12/04/2016 04:00,20.48,40715,1105,16,67,1154,3,2345,2.607.142.857
12/04/2016 05:00,21.25,42789,1150,13,61,1108,4,2336,2.607.142.857
12/04/2016 06:00,22.32,46538,1226,10,50,1102,3,2391,2.607.142.857
12/04/2016 07:00,23.53,49740,1300,8,40,1058,4,2410,2.607.142.857
12/04/2016 08:00,25.8,50566,1306,6,34,976,5,2327,2.607.142.857
12/04/2016 09:00,24.88,50273,1278,5,33,894,6,2216,2.607.142.857
12/04/2016 10:00,23.27,49834,1316,4,31,839,9,2199,2.607.142.857
12/04/2016 11:00,22.73,49174,1353,4,32,857,9,2255,2.607.142.857
12/04/2016 12:00,22.48,48312,1283,5,35,884,9,2216,2.607.142.857
12/04/2016 13:00,22.42,47746,1187,6,37,891,9,2130,2.607.142.857
12/04/2016 14:00,22.36,47258,1076,7,35,844,9,1971,2.607.142.857
12/04/2016 15:00,22.12,46693,945,8,31,853,7,1844,2.607.142.857
12/04/2016 16:00,22.2,46606,863,10,33,858,6,1770,2.607.142.857
12/04/2016 17:00,22.27,46768,803,12,36,898,6,1755,2.607.142.857
12/04/2016 18:00,22.32,46894,747,14,38,840,6,1645,2.607.142.857
12/04/2016 19:00,22.51,47110,697,15,50,891,6,1659,2.607.142.857
12/04/2016 20:00,22.51,46992,661,16,58,911,7,1653,2.607.142.857
12/04/2016 21:00,22.36,46323,616,18,67,986,6,1693,2.607.142.857
12/04/2016 22:00,21.86,44632,586,16,72,1101,6,1781,2.607.142.857
12/04/2016 23:00,21.35,42359,568,20,75,1090,5,1758,2.607.142.857
13/04/2016 00:00,21.64,40521,405,21,74,1029,5,1534,2.607.142.857
13/04/2016 01:00,21.13,39655,378,23,72,990,4,1467,2.607.142.857
13/04/2016 02:00,21.08,39445,356,26,69,926,4,1381,2.607.142.857
13/04/2016 03:00,21.15,39632,345,26,68,894,3,1336,2.607.142.857
13/04/2016 04:00,21.6,40431,332,27,68,893,4,1324,2.607.142.857
13/04/2016 05:00,22.2,42677,308,25,64,882,4,1283,2.607.142.857
13/04/2016 06:00,23.12,46128,291,22,58,827,5,1203,2.607.142.857
13/04/2016 07:00,28.11,49668,282,20,47,761,7,1117,2.607.142.857
13/04/2016 08:00,34.06,50111,268,20,41,705,8,1042,2.607.142.857
13/04/2016 09:00,32.08,49859,243,20,35,616,10,924,2.607.142.857
13/04/2016 10:00,28.97,49309,229,23,32,633,13,930,2.607.142.857
13/04/2016 11:00,26.77,48863,228,26,31,611,14,910,2.607.142.857
13/04/2016 12:00,25.25,48187,225,29,29,668,16,967,2.607.142.857
13/04/2016 13:00,24.32,47621,217,32,29,700,16,994,2.607.142.857
13/04/2016 14:00,24.13,47178,202,35,28,745,16,1026,2.607.142.857
13/04/2016 15:00,23.05,46571,189,38,28,786,15,1056,2.607.142.857
13/04/2016 16:00,23.13,46393,194,43,28,820,17,1102,2.607.142.857
13/04/2016 17:00,23.19,46546,217,52,28,848,16,1161,2.607.142.857
13/04/2016 18:00,23.21,46604,226,61,25,893,15,1220,2.607.142.857
13/04/2016 19:00,23.38,46754,227,66,24,868,15,1200,2.607.142.857
13/04/2016 20:00,23.28,46677,220,72,25,920,13,1250,2.607.142.857
13/04/2016 21:00,23.19,46105,205,82,29,932,13,1261,2.607.142.857
13/04/2016 22:00,22.76,44335,198,87,32,972,14,1303,2.607.142.857
13/04/2016 23:00,22.26,42013,184,112,42,1008,19,1365,2.607.142.857
14/04/2016 00:00,21.63,40135,82,121,45,1025,18,1291,2.607.142.857
14/04/2016 01:00,21.24,39229,81,130,46,1088,17,1362,2.607.142.857
14/04/2016 02:00,21.08,38891,89,135,46,1124,17,1411,2.607.142.857
14/04/2016 03:00,20.8,39045,104,136,49,1155,20,1464,2.607.142.857
14/04/2016 04:00,21.01,39801,128,139,53,1179,19,1518,2.607.142.857
14/04/2016 05:00,22.1,41853,150,138,54,1154,15,1511,2.607.142.857
14/04/2016 06:00,23.05,45380,149,138,57,1159,18,1521,2.607.142.857
14/04/2016 07:00,29.31,48936,143,137,60,1127,23,1490,2.607.142.857
14/04/2016 08:00,31.45,49208,127,133,61,1086,27,1434,2.607.142.857
14/04/2016 09:00,30.79,49177,118,131,62,998,31,1340,2.607.142.857
14/04/2016 10:00,28.76,49023,113,128,63,998,29,1331,2.607.142.857
14/04/2016 11:00,25.7,48647,91,123,64,1058,27,1363,2.607.142.857
14/04/2016 12:00,24.23,48278,74,117,71,1098,27,1387,2.607.142.857
14/04/2016 13:00,24,48104,75,108,72,1099,30,1384,2.607.142.857
14/04/2016 14:00,23.42,47687,81,97,79,1141,31,1429,2.607.142.857
14/04/2016 15:00,22.87,47198,94,86,81,1132,30,1423,2.607.142.857
14/04/2016 16:00,22.94,47007,121,78,82,1166,27,1474,2.607.142.857
14/04/2016 17:00,23.18,47162,122,70,75,1223,22,1512,2.607.142.857
14/04/2016 18:00,23.5,47258,121,68,72,1306,18,1585,2.607.142.857
14/04/2016 19:00,23.39,47352,134,67,69,1461,13,1744,2.607.142.857
14/04/2016 20:00,23.07,47311,163,67,61,1507,10,1808,2.607.142.857
14/04/2016 21:00,22.91,46695,205,64,54,1620,8,1951,2.607.142.857
14/04/2016 22:00,22.65,44883,289,60,42,1808,6,2205,2.607.142.857
14/04/2016 23:00,22.09,42554,419,53,41,1894,3,2410,2.607.142.857
15/04/2016 00:00,21.33,40705,413,48,33,1824,3,2321,2.607.142.857
15/04/2016 01:00,20.87,39799,495,42,26,1781,2,2346,2.607.142.857
15/04/2016 02:00,20.56,39424,579,38,20,1816,3,2456,2.607.142.857
15/04/2016 03:00,20.38,39509,685,35,18,1750,2,2490,2.607.142.857
15/04/2016 04:00,20.51,40192,795,33,18,1676,2,2524,2.607.142.857
15/04/2016 05:00,21.55,42166,861,31,15,1565,2,2474,2.607.142.857
15/04/2016 06:00,22.72,45610,889,28,8,1451,2,2378,2.607.142.857
15/04/2016 07:00,23.94,49109,898,29,7,1407,4,2345,2.607.142.857
15/04/2016 08:00,26.15,49456,946,28,5,1424,4,2407,2.607.142.857
15/04/2016 09:00,24.56,49572,1045,29,4,1461,3,2542,2.607.142.857
15/04/2016 10:00,23.99,49422,1117,29,4,1520,3,2673,2.607.142.857
15/04/2016 11:00,23.52,49033,1108,32,4,1599,2,2745,2.607.142.857
15/04/2016 12:00,23.27,48335,1021,34,6,1668,3,2732,2.607.142.857
15/04/2016 13:00,22.97,47765,923,34,8,1693,4,2662,2.607.142.857
15/04/2016 14:00,22.73,46914,801,31,9,1700,3,2544,2.607.142.857
15/04/2016 15:00,21.87,46210,702,30,10,1633,4,2379,2.607.142.857
15/04/2016 16:00,21.91,45898,658,26,12,1549,3,2248,2.607.142.857
15/04/2016 17:00,22.32,46171,582,22,16,1475,2,2097,2.607.142.857
15/04/2016 18:00,22.76,46399,460,21,27,1463,1,1972,2.607.142.857
15/04/2016 19:00,22.77,46272,366,23,34,1447,0,1870,2.607.142.857
15/04/2016 20:00,22.75,45839,313,26,48,1449,0,1836,2.607.142.857
15/04/2016 21:00,22.71,45148,275,31,93,1476,0,1875,2.607.142.857
15/04/2016 22:00,22.51,43708,273,36,123,1520,1,1953,2.607.142.857
15/04/2016 23:00,21.83,41935,295,67,137,1471,5,1975,2.607.142.857
16/04/2016 00:00,21.27,39978,255,81,137,1345,7,1825,2.607.142.857
16/04/2016 01:00,20.47,38977,230,86,132,1320,9,1777,2.607.142.857
16/04/2016 02:00,19.97,38483,217,90,130,1248,10,1695,2.607.142.857
16/04/2016 03:00,19.6,38371,206,90,134,1192,11,1633,2.607.142.857
16/04/2016 04:00,19.61,38476,208,87,140,1166,12,1613,2.607.142.857
16/04/2016 05:00,19.74,38834,193,83,148,1140,13,1577,2.607.142.857
16/04/2016 06:00,20.09,39465,172,82,148,1142,12,1556,2.607.142.857
16/04/2016 07:00,20.52,40746,165,85,144,1058,13,1465,2.607.142.857
16/04/2016 08:00,21.14,42474,177,85,133,1075,14,1484,2.607.142.857
16/04/2016 09:00,21.5,43543,227,89,123,1034,14,1487,2.607.142.857
16/04/2016 10:00,21.33,44083,300,93,111,1043,17,1564,2.607.142.857
16/04/2016 11:00,21.22,43865,365,98,92,994,23,1572,2.607.142.857
16/04/2016 12:00,20.93,43303,453,103,75,942,23,1596,2.607.142.857
16/04/2016 13:00,20.61,42768,582,106,64,989,26,1767,2.607.142.857
16/04/2016 14:00,20.43,42230,738,109,52,1010,21,1930,2.607.142.857
16/04/2016 15:00,20.26,41914,944,112,46,1036,18,2156,2.607.142.857
16/04/2016 16:00,20.42,42115,1193,112,45,1033,11,2394,2.607.142.857
16/04/2016 17:00,20.58,42841,1339,113,53,1046,5,2556,2.607.142.857
16/04/2016 18:00,20.82,43285,1403,114,62,1108,5,2692,2.607.142.857
16/04/2016 19:00,21.29,43154,1585,112,80,1114,8,2899,2.607.142.857
16/04/2016 20:00,21.53,42840,1750,108,94,1144,8,3104,2.607.142.857
16/04/2016 21:00,21.46,42404,1856,103,108,1217,10,3294,2.607.142.857
16/04/2016 22:00,21.16,41321,1969,96,116,1265,13,3459,2.607.142.857
16/04/2016 23:00,20.41,39773,2000,106,88,1521,11,3726,2.607.142.857
17/04/2016 00:00,19.37,38201,2964,107,71,1549,11,4702,2.607.142.857
17/04/2016 01:00,18.08,37378,3066,107,58,1574,11,4816,2.607.142.857
17/04/2016 02:00,17.23,37010,3149,110,46,1600,10,4915,2.607.142.857
17/04/2016 03:00,16.81,36939,3226,112,43,1651,8,5040,2.607.142.857
17/04/2016 04:00,16.8,36981,3276,107,43,1709,4,5139,2.607.142.857
17/04/2016 05:00,16.51,37041,3295,103,45,1766,2,5211,2.607.142.857
17/04/2016 06:00,16.6,37355,3320,99,42,1842,2,5305,2.607.142.857
17/04/2016 07:00,17.62,38245,3361,94,40,1906,2,5403,2.607.142.857
17/04/2016 08:00,18.57,39814,3439,87,42,1959,2,5529,2.607.142.857
17/04/2016 09:00,19.48,41228,3550,81,46,1993,2,5672,2.607.142.857
17/04/2016 10:00,19.6,42145,3658,76,53,2018,6,5811,2.607.142.857
17/04/2016 11:00,19.82,42399,3716,75,61,2054,6,5912,2.607.142.857
17/04/2016 12:00,19.55,42361,3743,72,69,2098,6,5988,2.607.142.857
17/04/2016 13:00,19.47,42096,3775,70,71,2113,8,6037,2.607.142.857
17/04/2016 14:00,19.21,41912,3804,66,67,2143,8,6088,2.607.142.857
17/04/2016 15:00,18.94,41743,3814,65,71,2138,10,6098,2.607.142.857
17/04/2016 16:00,18.63,41805,3799,66,74,2106,15,6060,2.607.142.857
17/04/2016 17:00,19.3,42325,3725,71,76,2075,11,5958,2.607.142.857
17/04/2016 18:00,19.61,42788,3591,71,85,2067,14,5828,2.607.142.857
17/04/2016 19:00,20.58,42932,3396,77,99,2109,19,5700,2.607.142.857
17/04/2016 20:00,21.28,43342,3105,83,119,2152,22,5481,2.607.142.857
17/04/2016 21:00,21.4,43370,2868,89,139,2178,21,5295,2.607.142.857
17/04/2016 22:00,20.97,42138,2698,89,164,2187,29,5167,2.607.142.857
17/04/2016 23:00,19.91,40309,2562,86,243,1967,39,4897,2.607.142.857
18/04/2016 00:00,19.82,38968,2333,92,251,1968,39,4683,2.525.178.571
18/04/2016 01:00,19.59,38164,2311,86,253,1959,43,4652,2.525.178.571
18/04/2016 02:00,19.1,37901,2318,78,244,1981,43,4664,2.525.178.571
18/04/2016 03:00,18.94,38237,2323,74,238,2023,40,4698,2.525.178.571
18/04/2016 04:00,19.03,39143,2352,79,238,2094,35,4798,2.525.178.571
18/04/2016 05:00,21.06,41492,2378,87,238,2138,34,4875,2.525.178.571
18/04/2016 06:00,21.98,45220,2416,98,236,2220,36,5006,2.525.178.571
18/04/2016 07:00,22.88,48820,2511,110,234,2283,44,5182,2.525.178.571
18/04/2016 08:00,23.19,49395,2721,115,228,2366,50,5480,2.525.178.571
18/04/2016 09:00,22.91,49426,3052,121,224,2477,49,5923,2.525.178.571
18/04/2016 10:00,22.65,49444,3395,126,229,2567,43,6360,2.525.178.571
18/04/2016 11:00,22.47,49117,3650,133,234,2683,35,6735,2.525.178.571
18/04/2016 12:00,21.93,48646,3837,130,236,2857,32,7092,2.525.178.571
18/04/2016 13:00,21.77,48397,3988,130,234,2968,33,7353,2.525.178.571
18/04/2016 14:00,21.69,47911,4035,127,227,3083,36,7508,2.525.178.571
18/04/2016 15:00,21.35,47275,4038,125,219,3173,38,7593,2.525.178.571
18/04/2016 16:00,21.3,46985,4041,121,207,3228,41,7638,2.525.178.571
18/04/2016 17:00,21.55,47169,3982,117,188,3286,39,7612,2.525.178.571
18/04/2016 18:00,21.51,47115,3870,119,174,3337,39,7539,2.525.178.571
18/04/2016 19:00,21.48,47077,3734,124,170,3390,36,7454,2.525.178.571
18/04/2016 20:00,21.49,46993,3642,131,177,3344,33,7327,2.525.178.571
18/04/2016 21:00,21.33,46581,3588,137,189,3346,34,7294,2.525.178.571
18/04/2016 22:00,20.13,44784,3574,141,201,3308,34,7258,2.525.178.571
18/04/2016 23:00,19.19,42358,3636,132,194,3349,39,7350,2.525.178.571
19/04/2016 00:00,19.03,40242,3773,132,203,3310,38,7456,2.525.178.571
19/04/2016 01:00,18.58,39341,3874,129,207,3357,36,7603,2.525.178.571
19/04/2016 02:00,18.51,39018,3966,126,207,3342,39,7680,2.525.178.571
19/04/2016 03:00,18.32,39230,4086,121,203,3360,40,7810,2.525.178.571
19/04/2016 04:00,18.58,40051,4209,118,202,3418,37,7984,2.525.178.571
19/04/2016 05:00,19.82,42127,4293,113,204,3417,32,8059,2.525.178.571
19/04/2016 06:00,21.27,45741,4337,109,208,3414,34,8102,2.525.178.571
19/04/2016 07:00,22.58,49354,4370,109,212,3383,36,8110,2.525.178.571
19/04/2016 08:00,22.85,49323,4425,110,220,3407,40,8202,2.525.178.571
19/04/2016 09:00,22.59,49283,4483,111,232,3377,45,8248,2.525.178.571
19/04/2016 10:00,21.73,49188,4508,110,246,3413,51,8328,2.525.178.571
19/04/2016 11:00,21.2,48774,4497,105,261,3544,49,8456,2.525.178.571
19/04/2016 12:00,20.99,48407,4479,98,269,3675,47,8568,2.525.178.571
19/04/2016 13:00,20.91,47985,4477,89,275,3733,46,8620,2.525.178.571
19/04/2016 14:00,20.74,47612,4463,80,277,3782,47,8649,2.525.178.571
19/04/2016 15:00,20.4,47061,4449,70,278,3790,43,8630,2.525.178.571
19/04/2016 16:00,20.27,46735,4426,57,267,3761,38,8549,2.525.178.571
19/04/2016 17:00,20.37,46635,4375,46,253,3716,28,8418,2.525.178.571
19/04/2016 18:00,21.06,46487,4271,39,239,3681,20,8250,2.525.178.571
19/04/2016 19:00,21.5,46462,4106,34,219,3511,12,7882,2.525.178.571
19/04/2016 20:00,21.47,46309,3913,35,198,3536,13,7695,2.525.178.571
19/04/2016 21:00,21.43,46046,3754,35,191,3604,21,7605,2.525.178.571
19/04/2016 22:00,20.36,44411,3625,31,195,3660,32,7543,2.525.178.571
19/04/2016 23:00,19.4,42131,3479,66,162,3587,10,7304,2.525.178.571
20/04/2016 00:00,19.17,40266,3109,70,159,3634,18,6990,2.525.178.571
20/04/2016 01:00,18.96,39364,2928,76,167,3643,24,6838,2.525.178.571
20/04/2016 02:00,18.53,39070,2756,77,168,3597,24,6622,2.525.178.571
20/04/2016 03:00,18.39,39215,2616,79,168,3579,19,6461,2.525.178.571
20/04/2016 04:00,18.82,40045,2516,79,166,3553,13,6327,2.525.178.571
20/04/2016 05:00,20.33,41953,2459,84,160,3436,14,6153,2.525.178.571
20/04/2016 06:00,21.87,45291,2351,95,161,3290,21,5918,2.525.178.571
20/04/2016 07:00,23.36,48753,2185,99,167,3098,32,5581,2.525.178.571
20/04/2016 08:00,23.75,49023,2060,105,175,2878,40,5258,2.525.178.571
20/04/2016 09:00,23.49,48910,1928,109,189,2711,37,4974,2.525.178.571
20/04/2016 10:00,23.23,48651,1769,112,204,2549,39,4673,2.525.178.571
20/04/2016 11:00,23,48289,1635,112,221,2497,40,4505,2.525.178.571
20/04/2016 12:00,21.96,47836,1547,113,238,2429,41,4368,2.525.178.571
20/04/2016 13:00,21.76,47360,1508,114,245,2357,43,4267,2.525.178.571
20/04/2016 14:00,21.82,46886,1528,118,243,2219,43,4151,2.525.178.571
20/04/2016 15:00,21.67,46128,1600,124,235,2096,41,4096,2.525.178.571
20/04/2016 16:00,21.77,45830,1689,131,226,1950,39,4035,2.525.178.571
20/04/2016 17:00,22.48,45940,1739,137,211,1679,36,3802,2.525.178.571
20/04/2016 18:00,22.82,45902,1735,138,197,1415,32,3517,2.525.178.571
20/04/2016 19:00,23.08,45882,1710,139,177,1204,26,3256,2.525.178.571
20/04/2016 20:00,23.1,45844,1617,139,161,1112,21,3050,2.525.178.571
20/04/2016 21:00,23.17,45703,1542,137,150,1034,16,2879,2.525.178.571
20/04/2016 22:00,22.66,44039,1534,134,140,993,16,2817,2.525.178.571
20/04/2016 23:00,21.64,41643,1524,123,132,1033,14,2826,2.525.178.571
21/04/2016 00:00,21.02,39918,1487,124,131,1086,13,2841,2.525.178.571
21/04/2016 01:00,20.49,38969,1373,124,130,1153,13,2793,2.525.178.571
21/04/2016 02:00,19.92,38669,1341,123,121,1186,11,2782,2.525.178.571
21/04/2016 03:00,19.6,38796,1397,118,108,1346,8,2977,2.525.178.571
21/04/2016 04:00,19.92,39462,1520,111,96,1457,6,3190,2.525.178.571
21/04/2016 05:00,21.35,41367,1647,104,69,1630,5,3455,2.525.178.571
21/04/2016 06:00,22.44,45075,1737,95,47,1749,4,3632,2.525.178.571
21/04/2016 07:00,24.16,48689,1809,78,29,1757,6,3679,2.525.178.571
21/04/2016 08:00,25.23,49946,1892,67,34,1837,6,3836,2.525.178.571
21/04/2016 09:00,23.69,48652,2021,58,42,1849,6,3976,2.525.178.571
21/04/2016 10:00,22.99,48029,2140,54,53,1849,9,4105,2.525.178.571
21/04/2016 11:00,22.76,47645,2243,52,73,2022,11,4401,2.525.178.571
21/04/2016 12:00,22.54,47305,2346,50,94,2177,13,4680,2.525.178.571
21/04/2016 13:00,22.39,46876,2460,45,123,2303,14,4945,2.525.178.571
21/04/2016 14:00,22.23,46402,2667,42,135,2438,18,5300,2.525.178.571
21/04/2016 15:00,21.82,45829,2892,35,144,2540,24,5635,2.525.178.571
21/04/2016 16:00,21.74,45574,3053,28,141,2562,21,5805,2.525.178.571
21/04/2016 17:00,21.69,45647,3161,21,135,2477,16,5810,2.525.178.571
21/04/2016 18:00,21.67,45654,3248,19,127,2517,10,5921,2.525.178.571
21/04/2016 19:00,21.62,45626,3266,18,126,2513,8,5931,2.525.178.571
21/04/2016 20:00,21.59,45591,3246,19,120,2560,7,5952,2.525.178.571
21/04/2016 21:00,21.66,45402,3243,19,139,2631,7,6039,2.525.178.571
21/04/2016 22:00,20.95,43799,3288,17,165,2753,8,6231,2.525.178.571
21/04/2016 23:00,20.12,41498,3348,14,195,2968,12,6537,2.525.178.571
22/04/2016 00:00,19.65,40001,3607,12,200,2947,13,6779,2.525.178.571
22/04/2016 01:00,19.08,39075,3618,10,213,2954,12,6807,2.525.178.571
22/04/2016 02:00,18.98,38800,3508,9,215,2901,11,6644,2.525.178.571
22/04/2016 03:00,18.91,38937,3274,9,216,2867,12,6378,2.525.178.571
22/04/2016 04:00,19.35,39521,2973,9,216,2842,13,6053,2.525.178.571
22/04/2016 05:00,21.21,41294,2605,8,216,2738,12,5579,2.525.178.571
22/04/2016 06:00,21.89,44759,2160,8,219,2569,16,4972,2.525.178.571
22/04/2016 07:00,23.04,48142,1764,9,221,2423,24,4441,2.525.178.571
22/04/2016 08:00,23.91,49022,1496,10,228,2245,29,4008,2.525.178.571
22/04/2016 09:00,23.74,48908,1270,15,237,2065,32,3619,2.525.178.571
22/04/2016 10:00,23.64,48297,1072,21,239,1965,38,3335,2.525.178.571
22/04/2016 11:00,23.19,47949,1028,28,240,1904,36,3236,2.525.178.571
22/04/2016 12:00,22.88,47399,1133,39,247,1954,33,3406,2.525.178.571
22/04/2016 13:00,22.62,46530,1264,44,239,1983,28,3558,2.525.178.571
22/04/2016 14:00,22.3,45805,1372,45,225,1981,26,3649,2.525.178.571
22/04/2016 15:00,21.83,45127,1474,44,196,1952,24,3690,2.525.178.571
22/04/2016 16:00,21.79,44910,1570,42,174,1914,21,3721,2.525.178.571
22/04/2016 17:00,22.01,45078,1558,41,146,1773,19,3537,2.525.178.571
22/04/2016 18:00,22.08,45236,1464,39,137,1593,15,3248,2.525.178.571
22/04/2016 19:00,22.24,45094,1360,41,99,1514,9,3023,2.525.178.571
22/04/2016 20:00,22.09,44755,1222,41,89,1477,6,2835,2.525.178.571
22/04/2016 21:00,22.18,44468,1105,40,82,1492,6,2725,2.525.178.571
22/04/2016 22:00,21.9,43390,1057,36,74,1508,6,2681,2.525.178.571
22/04/2016 23:00,21.38,41562,1018,34,49,1300,7,2408,2.525.178.571
23/04/2016 00:00,21.44,39836,1292,32,52,1326,7,2709,2.525.178.571
23/04/2016 01:00,21.23,38902,1208,29,48,1286,8,2579,2.525.178.571
23/04/2016 02:00,20.97,38544,1128,24,43,1189,7,2391,2.525.178.571
23/04/2016 03:00,20.95,38542,1056,19,34,1088,6,2203,2.525.178.571
23/04/2016 04:00,20.94,38636,1011,14,30,989,5,2049,2.525.178.571
23/04/2016 05:00,20.87,38891,973,10,29,905,5,1922,2.525.178.571
23/04/2016 06:00,21.03,39554,957,7,28,841,5,1838,2.525.178.571
23/04/2016 07:00,21.43,40928,923,7,27,727,4,1688,2.525.178.571
23/04/2016 08:00,22.32,42523,879,6,27,626,4,1542,2.525.178.571
23/04/2016 09:00,23.08,43717,886,6,27,509,4,1432,2.525.178.571
23/04/2016 10:00,23.2,44180,882,6,27,485,4,1404,2.525.178.571
23/04/2016 11:00,23,43933,922,8,29,444,5,1408,2.525.178.571
23/04/2016 12:00,22.26,43495,1040,9,28,488,5,1570,2.525.178.571
23/04/2016 13:00,21.34,43000,1161,10,24,534,5,1734,2.525.178.571
23/04/2016 14:00,20.66,42568,1190,10,23,549,5,1777,2.525.178.571
23/04/2016 15:00,20.4,42468,1120,9,21,567,5,1722,2.525.178.571
23/04/2016 16:00,20.58,42720,1067,9,20,592,4,1692,2.525.178.571
23/04/2016 17:00,20.73,43401,993,8,24,579,4,1608,2.525.178.571
23/04/2016 18:00,21.26,43736,868,7,25,514,3,1417,2.525.178.571
23/04/2016 19:00,22.32,43402,758,7,28,518,3,1314,2.525.178.571
23/04/2016 20:00,23.05,43177,651,8,31,525,3,1218,2.525.178.571
23/04/2016 21:00,23.22,43244,610,10,34,574,3,1231,2.525.178.571
23/04/2016 22:00,22.85,42471,588,11,39,628,4,1270,2.525.178.571
23/04/2016 23:00,21.84,41040,517,7,43,590,4,1161,2.525.178.571
24/04/2016 00:00,21.41,39864,504,7,45,569,4,1129,2.525.178.571
24/04/2016 01:00,20.55,39111,468,8,46,558,5,1085,2.525.178.571
24/04/2016 02:00,20.52,38764,404,9,44,566,6,1029,2.525.178.571
24/04/2016 03:00,20.64,38720,350,11,42,598,7,1008,2.525.178.571
24/04/2016 04:00,20.75,38721,303,13,41,600,7,964,2.525.178.571
24/04/2016 05:00,20.84,38719,258,15,46,578,8,905,2.525.178.571
24/04/2016 06:00,20.75,39069,231,17,50,605,8,911,2.525.178.571
24/04/2016 07:00,21.07,39915,236,20,55,587,12,910,2.525.178.571
24/04/2016 08:00,21.44,41482,235,25,67,536,12,875,2.525.178.571
24/04/2016 09:00,21.63,42723,258,33,79,526,15,911,2.525.178.571
24/04/2016 10:00,21.49,43452,318,44,98,505,19,984,2.525.178.571
24/04/2016 11:00,21.4,43555,380,58,110,484,28,1060,2.525.178.571
24/04/2016 12:00,21.3,43229,439,73,122,484,28,1146,2.525.178.571
24/04/2016 13:00,21.15,42920,526,83,135,505,29,1278,2.525.178.571
24/04/2016 14:00,20.99,42655,666,91,125,504,31,1417,2.525.178.571
24/04/2016 15:00,20.89,42376,794,97,117,471,29,1508,2.525.178.571
24/04/2016 16:00,20.93,42445,896,99,114,460,27,1596,2.525.178.571
24/04/2016 17:00,21.1,43061,960,100,85,449,25,1619,2.525.178.571
24/04/2016 18:00,21.19,43560,971,99,67,432,26,1595,2.525.178.571
24/04/2016 19:00,21.93,43688,900,92,55,440,25,1512,2.525.178.571
24/04/2016 20:00,23.29,43965,706,87,49,433,23,1298,2.525.178.571
24/04/2016 21:00,23.5,44333,528,90,52,456,22,1148,2.525.178.571
24/04/2016 22:00,23.21,43319,450,100,51,494,25,1120,2.525.178.571
24/04/2016 23:00,22.84,41701,418,124,36,561,6,1145,2.525.178.571
25/04/2016 00:00,22.31,40520,429,123,28,625,6,1211,2.444.880.952
25/04/2016 01:00,21.47,39810,399,120,23,689,6,1237,2.444.880.952
25/04/2016 02:00,20.94,39645,386,122,14,777,6,1305,2.444.880.952
25/04/2016 03:00,20.79,39889,371,126,10,883,6,1396,2.444.880.952
25/04/2016 04:00,21.04,40522,339,130,10,967,5,1451,2.444.880.952
25/04/2016 05:00,22.88,42493,295,126,10,1038,4,1473,2.444.880.952
25/04/2016 06:00,25.05,46037,240,120,9,1169,4,1542,2.444.880.952
25/04/2016 07:00,28.78,49678,211,110,8,1325,6,1660,2.444.880.952
25/04/2016 08:00,33.58,51056,198,99,7,1380,7,1691,2.444.880.952
25/04/2016 09:00,30.46,51607,195,88,6,1520,6,1815,2.444.880.952
25/04/2016 10:00,27.58,51281,206,74,6,1624,5,1915,2.444.880.952
25/04/2016 11:00,26.56,50712,222,57,7,1591,3,1880,2.444.880.952
25/04/2016 12:00,26.1,49932,249,43,10,1833,2,2137,2.444.880.952
25/04/2016 13:00,26.02,49281,300,30,12,1941,3,2286,2.444.880.952
25/04/2016 14:00,25.29,48617,361,20,13,2041,2,2437,2.444.880.952
25/04/2016 15:00,23.74,48078,431,14,13,2116,3,2577,2.444.880.952
25/04/2016 16:00,24.03,47843,538,9,13,2094,6,2660,2.444.880.952
25/04/2016 17:00,24.82,47801,659,9,14,2041,3,2726,2.444.880.952
25/04/2016 18:00,24.49,47502,752,9,15,1909,3,2688,2.444.880.952
25/04/2016 19:00,25.57,47311,867,10,17,1813,3,2710,2.444.880.952
25/04/2016 20:00,25.02,47124,1030,14,20,1734,6,2804,2.444.880.952
25/04/2016 21:00,25.08,46993,1190,20,25,1691,3,2929,2.444.880.952
25/04/2016 22:00,24.02,45457,1306,28,29,1695,3,3061,2.444.880.952
25/04/2016 23:00,22.81,43155,1389,39,30,1638,5,3101,2.444.880.952
26/04/2016 00:00,21.71,41658,1504,44,29,1587,5,3169,2.444.880.952
26/04/2016 01:00,20.95,40732,1531,50,28,1564,5,3178,2.444.880.952
26/04/2016 02:00,21,40414,1579,55,24,1519,5,3182,2.444.880.952
26/04/2016 03:00,20.72,40699,1690,64,20,1516,5,3295,2.444.880.952
26/04/2016 04:00,21.21,41426,1841,69,18,1546,5,3479,2.444.880.952
26/04/2016 05:00,22.79,43358,1947,70,18,1564,8,3607,2.444.880.952
26/04/2016 06:00,24.84,47263,2013,74,18,1605,6,3716,2.444.880.952
26/04/2016 07:00,27.68,50713,2120,80,21,1633,11,3865,2.444.880.952
26/04/2016 08:00,31.49,51531,2203,88,25,1680,12,4008,2.444.880.952
26/04/2016 09:00,29.76,50926,2257,95,31,1695,12,4090,2.444.880.952
26/04/2016 10:00,27.97,50519,2318,94,34,1761,12,4219,2.444.880.952
26/04/2016 11:00,26.89,50038,2322,92,35,1771,9,4229,2.444.880.952
26/04/2016 12:00,26.9,49631,2270,85,40,1773,11,4179,2.444.880.952
26/04/2016 13:00,26.38,49366,2208,81,45,1769,13,4116,2.444.880.952
26/04/2016 14:00,25.6,48872,2167,76,42,1751,16,4052,2.444.880.952
26/04/2016 15:00,24.5,48311,2116,74,37,1725,17,3969,2.444.880.952
26/04/2016 16:00,24.37,47962,1986,71,33,1739,21,3850,2.444.880.952
26/04/2016 17:00,25.06,47943,1870,67,30,1721,17,3705,2.444.880.952
26/04/2016 18:00,25.09,47641,1759,62,26,1725,14,3586,2.444.880.952
26/04/2016 19:00,25.06,47383,1700,56,24,1740,13,3533,2.444.880.952
26/04/2016 20:00,24.43,47255,1648,51,25,1784,13,3521,2.444.880.952
26/04/2016 21:00,24.4,47065,1644,44,29,1896,9,3622,2.444.880.952
26/04/2016 22:00,24.21,45448,1662,43,41,2053,8,3807,2.444.880.952
26/04/2016 23:00,22.81,43123,1659,45,69,2194,3,3970,2.444.880.952
27/04/2016 00:00,22.08,41035,1345,42,82,2287,2,3758,2.444.880.952
27/04/2016 01:00,21.68,40097,1363,42,95,2333,2,3835,2.444.880.952
27/04/2016 02:00,21.65,39789,1399,42,91,2363,2,3897,2.444.880.952
27/04/2016 03:00,21.36,39902,1497,45,83,2402,3,4030,2.444.880.952
27/04/2016 04:00,21.62,40507,1605,50,70,2367,5,4097,2.444.880.952
27/04/2016 05:00,22.85,42325,1671,49,55,2235,8,4018,2.444.880.952
27/04/2016 06:00,23.83,45989,1763,47,46,2045,11,3912,2.444.880.952
27/04/2016 07:00,27.33,49771,1894,44,39,1902,19,3898,2.444.880.952
27/04/2016 08:00,29.92,49727,1993,42,37,1698,24,3794,2.444.880.952
27/04/2016 09:00,29.33,49611,2063,41,37,1539,20,3700,2.444.880.952
27/04/2016 10:00,26.9,49531,2090,44,37,1433,15,3619,2.444.880.952
27/04/2016 11:00,25.85,49204,2040,44,40,1329,11,3464,2.444.880.952
27/04/2016 12:00,24.67,48758,1888,42,48,1255,8,3241,2.444.880.952
27/04/2016 13:00,24.46,48523,1714,37,58,1233,5,3047,2.444.880.952
27/04/2016 14:00,23.77,48018,1553,30,58,1255,3,2899,2.444.880.952
27/04/2016 15:00,23.34,47407,1396,26,49,1365,1,2837,2.444.880.952
27/04/2016 16:00,23.66,47062,1305,25,49,1466,1,2846,2.444.880.952
27/04/2016 17:00,23.8,47079,1242,31,45,1577,2,2897,2.444.880.952
27/04/2016 18:00,24.2,46876,1150,42,45,1763,4,3004,2.444.880.952
27/04/2016 19:00,24.08,46565,1080,57,48,1848,2,3035,2.444.880.952
27/04/2016 20:00,23.86,46319,1030,73,48,1926,8,3085,2.444.880.952
27/04/2016 21:00,24.13,46257,960,85,51,1924,14,3034,2.444.880.952
27/04/2016 22:00,23.93,44789,811,87,60,1861,22,2841,2.444.880.952
27/04/2016 23:00,23.26,42486,688,105,40,1789,9,2631,2.444.880.952
28/04/2016 00:00,22.37,40715,833,104,32,1615,6,2590,2.444.880.952
28/04/2016 01:00,22.24,39813,712,103,29,1423,7,2274,2.444.880.952
28/04/2016 02:00,22.24,39555,642,103,25,1295,8,2073,2.444.880.952
28/04/2016 03:00,22.27,39696,602,102,24,1175,8,1911,2.444.880.952
28/04/2016 04:00,22.84,40231,582,94,23,1130,9,1838,2.444.880.952
28/04/2016 05:00,24.06,42005,586,80,22,1073,11,1772,2.444.880.952
28/04/2016 06:00,24.39,45713,565,68,21,1018,12,1684,2.444.880.952
28/04/2016 07:00,29.45,49300,561,65,20,970,15,1631,2.444.880.952
28/04/2016 08:00,35.36,50051,576,66,22,1021,11,1696,2.444.880.952
28/04/2016 09:00,32.29,49638,611,67,25,1092,7,1802,2.444.880.952
28/04/2016 10:00,29.86,49523,643,69,28,1176,7,1923,2.444.880.952
28/04/2016 11:00,28.45,49255,652,70,31,1227,7,1987,2.444.880.952
28/04/2016 12:00,26.07,48835,729,71,32,1300,8,2140,2.444.880.952
28/04/2016 13:00,24.96,48606,832,65,33,1430,8,2368,2.444.880.952
28/04/2016 14:00,25.55,48136,902,60,32,1554,7,2555,2.444.880.952
28/04/2016 15:00,24.36,47539,969,57,29,1723,5,2783,2.444.880.952
28/04/2016 16:00,24.29,47173,1058,56,25,1865,4,3008,2.444.880.952
28/04/2016 17:00,24.2,47078,1125,51,25,2076,3,3280,2.444.880.952
28/04/2016 18:00,23.98,46780,1110,52,23,2261,3,3449,2.444.880.952
28/04/2016 19:00,24.04,46462,1011,55,24,2334,3,3427,2.444.880.952
28/04/2016 20:00,24.08,46153,857,50,26,2410,5,3348,2.444.880.952
28/04/2016 21:00,24.22,45971,741,44,35,2240,3,3063,2.444.880.952
28/04/2016 22:00,24.06,44451,703,41,51,2216,3,3014,2.444.880.952
28/04/2016 23:00,23.49,42034,695,38,64,2471,12,3280,2.444.880.952
29/04/2016 00:00,22.28,40182,601,40,69,2619,11,3340,2.444.880.952
29/04/2016 01:00,21.72,39262,694,43,72,2750,9,3568,2.444.880.952
29/04/2016 02:00,21.5,38924,796,42,63,2813,8,3722,2.444.880.952
29/04/2016 03:00,21.53,38993,871,39,54,2745,8,3717,2.444.880.952
29/04/2016 04:00,21.66,39494,975,35,39,2687,7,3743,2.444.880.952
29/04/2016 05:00,22.26,41280,1105,30,33,2644,9,3821,2.444.880.952
29/04/2016 06:00,23.03,44918,1247,24,25,2630,4,3930,2.444.880.952
29/04/2016 07:00,25.42,48544,1467,19,16,2485,5,3992,2.444.880.952
29/04/2016 08:00,27.57,49120,1791,17,13,2536,6,4363,2.444.880.952
29/04/2016 09:00,23.68,49424,2267,14,11,2617,7,4916,2.444.880.952
29/04/2016 10:00,22.82,49137,2756,13,10,2856,7,5642,2.444.880.952
29/04/2016 11:00,22.44,48522,3164,13,10,2977,5,6169,2.444.880.952
29/04/2016 12:00,22.36,47855,3435,13,11,3123,4,6586,2.444.880.952
29/04/2016 13:00,22.12,47181,3650,12,11,3247,2,6922,2.444.880.952
29/04/2016 14:00,21.91,46335,3677,11,12,3230,2,6932,2.444.880.952
29/04/2016 15:00,21.97,45590,3441,12,12,3197,2,6664,2.444.880.952
29/04/2016 16:00,22.33,45264,3122,10,12,3150,4,6298,2.444.880.952
29/04/2016 17:00,22.51,45452,2736,10,12,3033,2,5793,2.444.880.952
29/04/2016 18:00,22.69,45375,2322,11,13,2937,2,5285,2.444.880.952
29/04/2016 19:00,22.7,44961,1936,12,16,2841,2,4807,2.444.880.952
29/04/2016 20:00,22.53,44333,1658,13,21,2825,4,4521,2.444.880.952
29/04/2016 21:00,22.44,44181,1505,14,28,2768,2,4317,2.444.880.952
29/04/2016 22:00,22.13,43032,1444,14,34,2781,3,4276,2.444.880.952
29/04/2016 23:00,21.88,41152,1383,19,19,2696,1,4118,2.444.880.952
30/04/2016 00:00,22.07,39251,1479,22,19,2604,1,4125,2.444.880.952
30/04/2016 01:00,21.74,38267,1539,24,18,2511,1,4093,2.444.880.952
30/04/2016 02:00,21.67,37747,1550,25,15,2425,1,4016,2.444.880.952
30/04/2016 03:00,21.75,37646,1472,25,12,2225,1,3735,2.444.880.952
30/04/2016 04:00,21.79,37513,1429,25,12,2114,1,3581,2.444.880.952
30/04/2016 05:00,21.74,37686,1414,23,14,2003,1,3455,2.444.880.952
30/04/2016 06:00,21.53,38356,1390,22,14,1911,1,3338,2.444.880.952
30/04/2016 07:00,22.49,39792,1380,19,14,1856,1,3270,2.444.880.952
30/04/2016 08:00,22.58,41465,1363,17,17,1873,1,3271,2.444.880.952
30/04/2016 09:00,23.55,42169,1339,17,20,1889,1,3266,2.444.880.952
30/04/2016 10:00,23.76,42695,1335,17,22,1946,1,3321,2.444.880.952
30/04/2016 11:00,23.19,42623,1337,17,25,1998,2,3379,2.444.880.952
30/04/2016 12:00,22.19,42226,1286,16,28,2037,3,3370,2.444.880.952
30/04/2016 13:00,21.82,41742,1167,16,29,1996,4,3212,2.444.880.952
30/04/2016 14:00,21.43,41349,1037,17,29,1930,5,3018,2.444.880.952
30/04/2016 15:00,21.19,41165,921,16,29,1793,6,2765,2.444.880.952
30/04/2016 16:00,21.44,41406,823,14,30,1690,7,2564,2.444.880.952
30/04/2016 17:00,21.99,42040,684,14,32,1597,6,2333,2.444.880.952
30/04/2016 18:00,23.57,42346,530,14,32,1538,5,2119,2.444.880.952
30/04/2016 19:00,23.48,41879,437,14,32,1485,4,1972,2.444.880.952
30/04/2016 20:00,23.45,41535,385,16,35,1416,4,1856,2.444.880.952
30/04/2016 21:00,23.83,41675,342,18,36,1385,5,1786,2.444.880.952
30/04/2016 22:00,23.46,40976,332,16,52,1358,7,1765,2.444.880.952
30/04/2016 23:00,23.01,39519,329,16,47,1208,7,1607,2.444.880.952
01/05/2016 00:00,22.05,38513,258,14,52,1057,7,1388,2.444.880.952
01/05/2016 01:00,20.59,37585,264,11,57,922,7,1261,2.444.880.952
01/05/2016 02:00,20.2,37050,274,9,64,879,7,1233,2.444.880.952
01/05/2016 03:00,20.25,36862,277,9,71,808,5,1170,2.444.880.952
01/05/2016 04:00,20.25,36713,273,7,77,683,5,1045,2.444.880.952
01/05/2016 05:00,20.24,36687,276,5,74,560,5,920,2.444.880.952
01/05/2016 06:00,20.2,37066,272,4,67,503,2,848,2.444.880.952
01/05/2016 07:00,20.71,37901,259,3,60,455,1,778,2.444.880.952
01/05/2016 08:00,21.06,39173,230,2,62,403,2,699,2.444.880.952
01/05/2016 09:00,21.51,39904,200,3,64,403,2,672,2.444.880.952
01/05/2016 10:00,22,40627,167,3,68,420,3,661,2.444.880.952
01/05/2016 11:00,22.03,40687,135,5,66,480,3,689,2.444.880.952
01/05/2016 12:00,21.59,40331,118,8,66,606,5,803,2.444.880.952
01/05/2016 13:00,21.25,39944,111,11,66,674,8,870,2.444.880.952
01/05/2016 14:00,21.05,39610,113,12,59,657,10,851,2.444.880.952
01/05/2016 15:00,20.91,39399,128,12,52,665,11,868,2.444.880.952
01/05/2016 16:00,20.93,39475,148,13,45,707,13,926,2.444.880.952
01/05/2016 17:00,21.22,40077,157,14,43,752,11,977,2.444.880.952
01/05/2016 18:00,21.76,40539,146,14,43,728,8,939,2.444.880.952
01/05/2016 19:00,23.37,40585,135,14,43,706,5,903,2.444.880.952
01/05/2016 20:00,24.11,40754,112,14,47,711,4,888,2.444.880.952
01/05/2016 21:00,24.65,41537,81,13,51,713,4,862,2.444.880.952
01/05/2016 22:00,24.37,40821,68,10,56,704,5,843,2.444.880.952
01/05/2016 23:00,23.77,39224,71,11,31,930,3,1046,2.444.880.952
02/05/2016 00:00,21.98,37755,107,9,33,1003,2,1154,2.562.261.905
02/05/2016 01:00,20.75,37022,136,8,33,872,3,1052,2.562.261.905
02/05/2016 02:00,20.48,36820,189,7,31,824,2,1053,2.562.261.905
02/05/2016 03:00,20.52,37013,255,7,30,766,2,1060,2.562.261.905
02/05/2016 04:00,20.64,37538,333,6,30,744,2,1115,2.562.261.905
02/05/2016 05:00,22.91,39229,418,4,26,727,2,1177,2.562.261.905
02/05/2016 06:00,24.65,42641,514,3,21,667,2,1207,2.562.261.905
02/05/2016 07:00,29.88,46284,600,2,16,660,4,1282,2.562.261.905
02/05/2016 08:00,31.15,47586,672,2,16,670,5,1365,2.562.261.905
02/05/2016 09:00,28.2,46460,796,2,17,741,6,1562,2.562.261.905
02/05/2016 10:00,27.41,46266,981,2,19,839,6,1847,2.562.261.905
02/05/2016 11:00,25.47,45916,1152,3,21,1062,4,2242,2.562.261.905
02/05/2016 12:00,24.49,45412,1294,5,23,1222,5,2549,2.562.261.905
02/05/2016 13:00,24.38,44995,1409,7,26,1311,8,2761,2.562.261.905
02/05/2016 14:00,24.1,44578,1477,8,28,1373,11,2897,2.562.261.905
02/05/2016 15:00,24.18,44085,1500,9,32,1433,13,2987,2.562.261.905
02/05/2016 16:00,23.95,43909,1476,9,25,1487,12,3009,2.562.261.905
02/05/2016 17:00,23.9,44020,1388,9,24,1480,10,2911,2.562.261.905
02/05/2016 18:00,23.84,43915,1330,11,24,1566,7,2938,2.562.261.905
02/05/2016 19:00,23.89,43787,1334,13,29,1552,6,2934,2.562.261.905
02/05/2016 20:00,23.83,43621,1339,16,32,1613,8,3008,2.562.261.905
02/05/2016 21:00,23.88,43678,1433,17,36,1710,6,3202,2.562.261.905
02/05/2016 22:00,23.43,42499,1549,17,42,1830,6,3444,2.562.261.905
02/05/2016 23:00,22.41,40117,1592,7,32,1934,3,3568,2.562.261.905
03/05/2016 00:00,21.75,38031,1734,6,32,1992,3,3767,2.562.261.905
03/05/2016 01:00,21.11,37034,1763,6,32,1905,4,3710,2.562.261.905
03/05/2016 02:00,21.04,36625,1740,6,31,1755,3,3535,2.562.261.905
03/05/2016 03:00,20.85,36673,1636,5,30,1688,3,3362,2.562.261.905
03/05/2016 04:00,21.16,37050,1508,5,30,1605,3,3151,2.562.261.905
03/05/2016 05:00,22.51,38660,1317,4,29,1530,3,2883,2.562.261.905
03/05/2016 06:00,23.63,42286,1129,3,24,1427,3,2586,2.562.261.905
03/05/2016 07:00,25.69,45770,983,2,20,1272,3,2280,2.562.261.905
03/05/2016 08:00,28.39,46485,841,2,19,1212,6,2080,2.562.261.905
03/05/2016 09:00,27.88,45752,757,2,19,1124,7,1909,2.562.261.905
03/05/2016 10:00,26.66,45567,766,3,21,1126,5,1921,2.562.261.905
03/05/2016 11:00,26.67,45229,776,5,18,1216,5,2020,2.562.261.905
03/05/2016 12:00,25.12,44933,865,9,16,1217,6,2113,2.562.261.905
03/05/2016 13:00,24.72,44594,1012,14,16,1194,6,2242,2.562.261.905
03/05/2016 14:00,24.15,44134,1090,18,17,1184,9,2318,2.562.261.905
03/05/2016 15:00,24.01,43675,1095,20,20,1130,13,2278,2.562.261.905
03/05/2016 16:00,23.85,43532,1086,21,23,1033,14,2177,2.562.261.905
03/05/2016 17:00,24.23,43733,1043,22,25,950,14,2054,2.562.261.905
03/05/2016 18:00,24.21,43722,978,24,25,950,10,1987,2.562.261.905
03/05/2016 19:00,24.3,43481,874,25,26,926,9,1860,2.562.261.905
03/05/2016 20:00,24.23,43121,748,26,27,957,8,1766,2.562.261.905
03/05/2016 21:00,24.53,43150,666,27,28,1002,9,1732,2.562.261.905
03/05/2016 22:00,24.21,41895,671,24,29,1112,8,1844,2.562.261.905
03/05/2016 23:00,23.61,39483,713,18,30,1152,5,1918,2.562.261.905
04/05/2016 00:00,22.14,36991,800,13,24,1134,4,1975,2.562.261.905
04/05/2016 01:00,21.46,36056,830,11,21,1094,4,1960,2.562.261.905
04/05/2016 02:00,21.25,35810,809,12,18,1045,4,1888,2.562.261.905
04/05/2016 03:00,21.17,35895,749,14,14,970,3,1750,2.562.261.905
04/05/2016 04:00,21.54,36289,687,14,11,847,3,1562,2.562.261.905
04/05/2016 05:00,23.2,37894,619,12,10,699,2,1342,2.562.261.905
04/05/2016 06:00,24.69,41716,541,9,10,608,2,1170,2.562.261.905
04/05/2016 07:00,31.8,45413,457,6,10,556,1,1030,2.562.261.905
04/05/2016 08:00,33.05,45746,409,5,13,506,4,937,2.562.261.905
04/05/2016 09:00,30.81,45456,378,5,17,525,5,930,2.562.261.905
04/05/2016 10:00,28.57,45192,325,6,20,533,6,890,2.562.261.905
04/05/2016 11:00,27.67,44806,295,9,21,566,8,899,2.562.261.905
04/05/2016 12:00,25.57,44281,299,13,25,606,9,952,2.562.261.905
04/05/2016 13:00,24.39,44019,316,16,32,640,11,1015,2.562.261.905
04/05/2016 14:00,23.99,43496,323,19,40,681,8,1071,2.562.261.905
04/05/2016 15:00,23.36,42864,323,22,49,719,10,1123,2.562.261.905
04/05/2016 16:00,23.78,42604,312,21,56,719,9,1117,2.562.261.905
04/05/2016 17:00,24.55,42536,269,23,53,709,8,1062,2.562.261.905
04/05/2016 18:00,25.62,42496,220,26,45,668,7,966,2.562.261.905
04/05/2016 19:00,25.45,42409,176,27,39,662,5,909,2.562.261.905
04/05/2016 20:00,24.59,42228,135,28,38,716,4,921,2.562.261.905
04/05/2016 21:00,24.67,42376,108,28,37,768,3,944,2.562.261.905
04/05/2016 22:00,24.26,41194,103,24,35,837,3,1002,2.562.261.905
04/05/2016 23:00,23.69,38783,101,27,55,903,6,1092,2.562.261.905
05/05/2016 00:00,23.12,36410,124,24,51,931,5,1135,2.562.261.905
05/05/2016 01:00,21.86,35529,136,24,51,973,4,1188,2.562.261.905
05/05/2016 02:00,21.26,35088,154,23,50,962,4,1193,2.562.261.905
05/05/2016 03:00,20.26,34862,182,19,50,942,4,1197,2.562.261.905
05/05/2016 04:00,19.79,34495,225,15,45,852,5,1142,2.562.261.905
05/05/2016 05:00,20.27,34419,266,10,36,708,7,1027,2.562.261.905
05/05/2016 06:00,20.44,35271,303,7,27,620,3,960,2.562.261.905
05/05/2016 07:00,20.73,36288,332,5,28,527,5,897,2.562.261.905
05/05/2016 08:00,21.34,37773,317,5,31,569,6,928,2.562.261.905
05/05/2016 09:00,21.54,38809,321,5,32,580,6,944,2.562.261.905
05/05/2016 10:00,21.47,39539,331,7,32,659,6,1035,2.562.261.905
05/05/2016 11:00,21.29,39502,325,9,33,749,5,1121,2.562.261.905
05/05/2016 12:00,20.98,39237,325,12,39,919,5,1300,2.562.261.905
05/05/2016 13:00,20.62,38685,317,16,43,993,6,1375,2.562.261.905
05/05/2016 14:00,20.19,38311,292,18,49,995,6,1360,2.562.261.905
05/05/2016 15:00,19.67,37893,260,19,50,1015,6,1350,2.562.261.905
05/05/2016 16:00,19.71,38084,233,19,53,1053,8,1366,2.562.261.905
05/05/2016 17:00,20.48,38525,196,19,53,1015,6,1289,2.562.261.905
05/05/2016 18:00,21.46,38860,160,20,53,954,5,1192,2.562.261.905
05/05/2016 19:00,23.42,38707,145,20,50,882,4,1101,2.562.261.905
05/05/2016 20:00,23.26,38559,139,23,42,852,5,1061,2.562.261.905
05/05/2016 21:00,23.52,39028,161,25,35,892,2,1115,2.562.261.905
05/05/2016 22:00,23.35,38937,209,24,32,923,2,1190,2.562.261.905
05/05/2016 23:00,21.62,37147,271,24,42,1006,3,1346,2.562.261.905
06/05/2016 00:00,20.73,35865,353,23,35,917,4,1332,2.562.261.905
06/05/2016 01:00,19.08,34987,446,19,33,902,4,1404,2.562.261.905
06/05/2016 02:00,18.46,34684,532,16,31,912,4,1495,2.562.261.905
06/05/2016 03:00,18.24,34584,576,15,31,904,4,1530,2.562.261.905
06/05/2016 04:00,19.11,34692,593,11,31,870,4,1509,2.562.261.905
06/05/2016 05:00,21.15,35685,611,8,30,713,3,1365,2.562.261.905
06/05/2016 06:00,23.05,37893,633,5,24,573,3,1238,2.562.261.905
06/05/2016 07:00,24,40568,606,4,19,495,4,1128,2.562.261.905
06/05/2016 08:00,25.27,41955,538,4,15,397,5,959,2.562.261.905
06/05/2016 09:00,25.63,41900,554,5,15,394,6,974,2.562.261.905
06/05/2016 10:00,23.96,41747,638,7,18,412,6,1081,2.562.261.905
06/05/2016 11:00,23.08,41325,753,9,19,469,5,1255,2.562.261.905
06/05/2016 12:00,22.45,40772,904,12,19,539,5,1479,2.562.261.905
06/05/2016 13:00,22.12,40240,1078,13,21,557,5,1674,2.562.261.905
06/05/2016 14:00,21.75,39775,1217,14,21,584,5,1841,2.562.261.905
06/05/2016 15:00,20.87,39475,1298,14,24,610,6,1952,2.562.261.905
06/05/2016 16:00,20.66,39258,1389,13,28,642,6,2078,2.562.261.905
06/05/2016 17:00,21.85,39361,1485,13,32,669,5,2204,2.562.261.905
06/05/2016 18:00,22.91,39321,1544,13,35,658,5,2255,2.562.261.905
06/05/2016 19:00,22.76,38932,1527,13,41,680,4,2265,2.562.261.905
06/05/2016 20:00,22.25,38173,1497,13,46,701,3,2260,2.562.261.905
06/05/2016 21:00,22.09,38173,1558,13,53,782,3,2409,2.562.261.905
06/05/2016 22:00,21.8,37862,1687,12,66,851,3,2619,2.562.261.905
06/05/2016 23:00,20.91,36310,1802,36,83,887,1,2809,2.562.261.905
07/05/2016 00:00,19.81,35259,2092,36,78,934,1,3141,2.562.261.905
07/05/2016 01:00,16.9,34174,2071,35,71,938,1,3116,2.562.261.905
07/05/2016 02:00,14.95,33743,2029,35,67,931,2,3064,2.562.261.905
07/05/2016 03:00,14.64,33660,1958,34,62,925,3,2982,2.562.261.905
07/05/2016 04:00,14.96,33569,1913,33,53,922,3,2924,2.562.261.905
07/05/2016 05:00,15.2,33585,1890,32,38,941,2,2903,2.562.261.905
07/05/2016 06:00,16.27,33981,1848,32,30,920,1,2831,2.562.261.905
07/05/2016 07:00,19.32,35277,1798,32,19,841,1,2691,2.562.261.905
07/05/2016 08:00,19.94,36731,1761,32,14,778,2,2587,2.562.261.905
07/05/2016 09:00,20.1,37947,1745,32,13,716,4,2510,2.562.261.905
07/05/2016 10:00,20.2,38330,1778,33,15,739,4,2569,2.562.261.905
07/05/2016 11:00,19.93,37960,1883,33,17,791,4,2728,2.562.261.905
07/05/2016 12:00,19.89,37530,2023,34,19,823,3,2902,2.562.261.905
07/05/2016 13:00,19.33,37029,2137,34,22,870,2,3065,2.562.261.905
07/05/2016 14:00,18.72,36603,2145,35,24,878,5,3087,2.562.261.905
07/05/2016 15:00,18.55,36404,2038,35,27,912,7,3019,2.562.261.905
07/05/2016 16:00,18.15,36576,1921,35,29,926,7,2918,2.562.261.905
07/05/2016 17:00,19.26,37196,1803,35,30,871,8,2747,2.562.261.905
07/05/2016 18:00,19.92,37458,1714,36,33,837,12,2632,2.562.261.905
07/05/2016 19:00,21.42,37110,1639,37,37,830,8,2551,2.562.261.905
07/05/2016 20:00,19.98,36724,1626,37,44,916,7,2630,2.562.261.905
07/05/2016 21:00,19.86,36928,1704,39,57,1013,9,2822,2.562.261.905
07/05/2016 22:00,19.75,36490,1777,12,68,1114,8,2979,2.562.261.905
07/05/2016 23:00,18.25,35159,1776,23,62,1059,6,2926,2.562.261.905
08/05/2016 00:00,15.17,33518,1879,24,56,1083,7,3049,2.562.261.905
08/05/2016 01:00,13.99,32701,1770,23,53,1133,8,2987,2.562.261.905
08/05/2016 02:00,11.89,32295,1647,23,52,1134,8,2864,2.562.261.905
08/05/2016 03:00,9.93,32068,1528,22,47,1081,8,2686,2.562.261.905
08/05/2016 04:00,9.08,31897,1429,17,42,1047,9,2544,2.562.261.905
08/05/2016 05:00,7.45,31616,1365,12,36,954,8,2375,2.562.261.905
08/05/2016 06:00,9.57,31799,1285,9,31,799,4,2128,2.562.261.905
08/05/2016 07:00,13.94,32465,1140,7,23,610,1,1781,2.562.261.905
08/05/2016 08:00,16.94,33711,1038,6,22,507,1,1574,2.562.261.905
08/05/2016 09:00,18.59,34609,1001,6,24,443,1,1475,2.562.261.905
08/05/2016 10:00,20.02,35434,1017,7,28,472,1,1525,2.562.261.905
08/05/2016 11:00,19.73,35607,1180,7,31,536,1,1755,2.562.261.905
08/05/2016 12:00,19.23,35379,1467,8,32,680,1,2188,2.562.261.905
08/05/2016 13:00,18.48,34975,1704,8,37,700,1,2450,2.562.261.905
08/05/2016 14:00,18.02,34641,1787,7,39,716,3,2552,2.562.261.905
08/05/2016 15:00,17.63,34489,1779,6,38,768,4,2595,2.562.261.905
08/05/2016 16:00,17.18,34653,1774,6,36,827,8,2651,2.562.261.905
08/05/2016 17:00,17.72,35263,1763,8,36,826,8,2641,2.562.261.905
08/05/2016 18:00,17.93,35753,1672,10,37,807,5,2531,2.562.261.905
08/05/2016 19:00,19.35,36025,1549,12,39,822,5,2427,2.562.261.905
08/05/2016 20:00,19.4,36133,1444,14,44,878,4,2384,2.562.261.905
08/05/2016 21:00,20.02,36646,1424,15,57,902,4,2402,2.562.261.905
08/05/2016 22:00,20.12,36105,1492,11,68,937,4,2512,2.562.261.905
08/05/2016 23:00,18.66,34435,1545,25,72,870,6,2518,2.562.261.905
09/05/2016 00:00,15.75,32992,1573,26,71,857,7,2534,2.831.904.762
09/05/2016 01:00,13.1,32223,1486,27,69,824,7,2413,2.831.904.762
09/05/2016 02:00,12.49,31941,1383,26,63,744,7,2223,2.831.904.762
09/05/2016 03:00,12.35,32068,1289,23,54,651,6,2023,2.831.904.762
09/05/2016 04:00,14.71,32379,1223,17,48,574,6,1868,2.831.904.762
09/05/2016 05:00,20.12,33887,1193,12,38,487,6,1736,2.831.904.762
09/05/2016 06:00,22.47,37386,1182,8,29,407,5,1631,2.831.904.762
09/05/2016 07:00,26.59,41238,1097,5,22,330,4,1458,2.831.904.762
09/05/2016 08:00,28.92,40775,987,5,18,287,3,1300,2.831.904.762
09/05/2016 09:00,28,40760,970,6,17,274,4,1271,2.831.904.762
09/05/2016 10:00,24.24,40789,1037,7,18,266,3,1331,2.831.904.762
09/05/2016 11:00,22.82,40629,1145,9,17,291,3,1465,2.831.904.762
09/05/2016 12:00,22.38,40481,1271,12,17,339,4,1643,2.831.904.762
09/05/2016 13:00,22.19,40406,1388,13,21,372,4,1798,2.831.904.762
09/05/2016 14:00,22.02,40040,1423,13,21,385,5,1847,2.831.904.762
09/05/2016 15:00,22.01,39650,1419,13,21,417,5,1875,2.831.904.762
09/05/2016 16:00,21.94,39392,1419,12,22,437,7,1897,2.831.904.762
09/05/2016 17:00,22.76,39408,1380,11,22,453,8,1874,2.831.904.762
09/05/2016 18:00,22.87,39200,1309,12,23,475,7,1826,2.831.904.762
09/05/2016 19:00,22.81,39081,1213,14,26,525,6,1784,2.831.904.762
09/05/2016 20:00,22.43,38687,1183,16,29,596,6,1830,2.831.904.762
09/05/2016 21:00,22.7,38744,1260,17,33,619,6,1935,2.831.904.762
09/05/2016 22:00,22.13,37802,1304,19,37,715,5,2080,2.831.904.762
09/05/2016 23:00,21.31,35452,1272,18,33,783,4,2110,2.831.904.762
10/05/2016 00:00,21.07,33830,1032,20,31,881,4,1968,2.831.904.762
10/05/2016 01:00,20.4,32874,1006,20,28,999,4,2057,2.831.904.762
10/05/2016 02:00,19.59,32459,978,19,24,942,3,1966,2.831.904.762
10/05/2016 03:00,19.29,32447,943,15,20,905,3,1886,2.831.904.762
10/05/2016 04:00,19.86,32707,899,11,17,843,3,1773,2.831.904.762
10/05/2016 05:00,21.6,34142,866,7,14,730,3,1620,2.831.904.762
10/05/2016 06:00,23.36,37262,808,5,13,664,4,1494,2.831.904.762
10/05/2016 07:00,28.49,40756,718,4,9,613,4,1348,2.831.904.762
10/05/2016 08:00,33.42,40130,615,4,7,608,5,1239,2.831.904.762
10/05/2016 09:00,31.33,40157,549,5,7,611,5,1177,2.831.904.762
10/05/2016 10:00,29.37,40191,552,7,7,645,4,1215,2.831.904.762
10/05/2016 11:00,26.79,40223,608,10,8,675,2,1303,2.831.904.762
10/05/2016 12:00,24.18,40144,694,14,10,735,3,1456,2.831.904.762
10/05/2016 13:00,23.95,40167,805,16,12,797,4,1634,2.831.904.762
10/05/2016 14:00,23.88,39876,882,17,12,883,5,1799,2.831.904.762
10/05/2016 15:00,23.45,39442,927,17,12,978,4,1938,2.831.904.762
10/05/2016 16:00,23.06,39242,959,17,12,1134,3,2125,2.831.904.762
10/05/2016 17:00,23.48,39205,954,18,9,1169,2,2152,2.831.904.762
10/05/2016 18:00,23.32,38973,922,21,11,1215,2,2171,2.831.904.762
10/05/2016 19:00,23.12,38748,856,25,11,1233,2,2127,2.831.904.762
10/05/2016 20:00,22.46,38406,825,29,10,1268,2,2134,2.831.904.762
10/05/2016 21:00,22.45,38494,885,40,11,1358,2,2296,2.831.904.762
10/05/2016 22:00,22.22,37628,976,50,11,1417,4,2458,2.831.904.762
10/05/2016 23:00,21.61,35454,1034,62,6,1545,2,2649,2.831.904.762
11/05/2016 00:00,21.08,33690,857,61,9,1641,4,2572,2.831.904.762
11/05/2016 01:00,20.05,32829,799,50,14,1719,4,2586,2.831.904.762
11/05/2016 02:00,19.75,32477,733,48,15,1646,6,2448,2.831.904.762
11/05/2016 03:00,19.43,32380,698,57,14,1545,4,2318,2.831.904.762
11/05/2016 04:00,19.92,32677,691,70,12,1426,4,2203,2.831.904.762
11/05/2016 05:00,21.72,34052,726,73,10,1273,6,2088,2.831.904.762
11/05/2016 06:00,23.92,37127,763,67,9,1163,4,2006,2.831.904.762
11/05/2016 07:00,29.4,40623,767,66,8,1057,7,1905,2.831.904.762
11/05/2016 08:00,36.24,41380,768,60,8,1011,9,1856,2.831.904.762
11/05/2016 09:00,34.49,41769,828,58,8,985,12,1891,2.831.904.762
11/05/2016 10:00,29.61,41876,942,52,10,951,13,1968,2.831.904.762
11/05/2016 11:00,26.25,41809,1107,47,12,922,18,2106,2.831.904.762
11/05/2016 12:00,24.49,41536,1340,41,22,919,22,2344,2.831.904.762
11/05/2016 13:00,24.16,41463,1567,37,35,917,26,2582,2.831.904.762
11/05/2016 14:00,23.74,41170,1693,36,42,923,29,2723,2.831.904.762
11/05/2016 15:00,23.16,40773,1770,35,47,998,33,2883,2.831.904.762
11/05/2016 16:00,23,40547,1805,34,52,1125,37,3053,2.831.904.762
11/05/2016 17:00,23.74,40548,1772,34,56,1218,36,3116,2.831.904.762
11/05/2016 18:00,24.15,40358,1726,32,63,1330,31,3182,2.831.904.762
11/05/2016 19:00,23.92,39915,1679,28,63,1469,24,3263,2.831.904.762
11/05/2016 20:00,23.48,39504,1570,25,69,1729,15,3408,2.831.904.762
11/05/2016 21:00,23.45,39488,1534,24,84,2047,15,3704,2.831.904.762
11/05/2016 22:00,22.22,38510,1627,23,97,2287,13,4047,2.831.904.762
11/05/2016 23:00,20.67,36265,1708,22,111,2487,12,4340,2.831.904.762
12/05/2016 00:00,19.47,34547,1699,21,111,2567,11,4409,2.831.904.762
12/05/2016 01:00,18.04,33555,1699,20,111,2524,12,4366,2.831.904.762
12/05/2016 02:00,17.52,33171,1682,20,111,2456,11,4280,2.831.904.762
12/05/2016 03:00,17.75,33108,1650,19,110,2327,10,4116,2.831.904.762
12/05/2016 04:00,18.62,33305,1618,17,110,2213,9,3967,2.831.904.762
12/05/2016 05:00,19.97,34735,1575,13,92,1962,7,3649,2.831.904.762
12/05/2016 06:00,23.39,37884,1545,12,82,1668,9,3316,2.831.904.762
12/05/2016 07:00,26.13,41629,1514,14,76,1410,13,3027,2.831.904.762
12/05/2016 08:00,29.12,42403,1439,15,68,1181,13,2716,2.831.904.762
12/05/2016 09:00,27.27,42611,1307,16,63,1125,13,2524,2.831.904.762
12/05/2016 10:00,26.32,42773,1192,17,60,1145,14,2428,2.831.904.762
12/05/2016 11:00,25.67,42816,1106,20,58,1239,18,2441,2.831.904.762
12/05/2016 12:00,24.81,42685,1061,22,58,1353,18,2512,2.831.904.762
12/05/2016 13:00,24.61,42628,1018,25,58,1449,17,2567,2.831.904.762
12/05/2016 14:00,24.52,42270,939,27,58,1486,16,2526,2.831.904.762
12/05/2016 15:00,23.93,41840,846,28,58,1549,15,2496,2.831.904.762
12/05/2016 16:00,23.81,41516,762,29,57,1575,14,2437,2.831.904.762
12/05/2016 17:00,24.19,41550,678,30,57,1513,14,2292,2.831.904.762
12/05/2016 18:00,24.48,41280,605,36,64,1412,14,2131,2.831.904.762
12/05/2016 19:00,24.71,40778,536,46,74,1246,12,1914,2.831.904.762
12/05/2016 20:00,24.22,40317,465,58,86,1171,11,1791,2.831.904.762
12/05/2016 21:00,24.22,40255,401,70,100,1202,9,1782,2.831.904.762
12/05/2016 22:00,23.78,39239,352,71,111,1219,9,1762,2.831.904.762
12/05/2016 23:00,23.08,36851,307,82,114,1283,9,1795,2.831.904.762
13/05/2016 00:00,22.3,35002,235,84,107,1350,9,1785,2.831.904.762
13/05/2016 01:00,21.41,34012,251,84,102,1284,9,1730,2.831.904.762
13/05/2016 02:00,21.04,33651,260,85,97,1240,9,1691,2.831.904.762
13/05/2016 03:00,20.55,33602,286,82,90,1175,9,1642,2.831.904.762
13/05/2016 04:00,21.15,33827,383,75,82,1091,9,1640,2.831.904.762
13/05/2016 05:00,22.62,35276,491,65,72,1016,7,1651,2.831.904.762
13/05/2016 06:00,24.35,39180,589,53,62,877,8,1589,2.831.904.762
13/05/2016 07:00,28.88,42859,692,46,51,846,8,1643,2.831.904.762
13/05/2016 08:00,32.63,43569,757,47,49,815,7,1675,2.831.904.762
13/05/2016 09:00,31.68,43852,792,50,49,788,5,1684,2.831.904.762
13/05/2016 10:00,32.68,43940,880,50,50,818,3,1801,2.831.904.762
13/05/2016 11:00,29.9,43804,983,49,52,796,4,1884,2.831.904.762
13/05/2016 12:00,27.76,43354,1064,47,54,879,3,2047,2.831.904.762
13/05/2016 13:00,27.21,42796,1139,44,59,933,3,2178,2.831.904.762
13/05/2016 14:00,25.01,42180,1221,40,61,1031,3,2356,2.831.904.762
13/05/2016 15:00,23.91,41705,1330,38,61,1067,3,2499,2.831.904.762
13/05/2016 16:00,23.65,40952,1435,35,60,1033,3,2566,2.831.904.762
13/05/2016 17:00,23.87,40853,1503,36,62,987,5,2593,2.831.904.762
13/05/2016 18:00,24.21,40653,1570,41,62,974,9,2656,2.831.904.762
13/05/2016 19:00,24.04,40056,1645,51,69,975,8,2748,2.831.904.762
13/05/2016 20:00,23.65,39005,1639,65,69,1002,5,2780,2.831.904.762
13/05/2016 21:00,23.52,38765,1557,78,72,1096,6,2809,2.831.904.762
13/05/2016 22:00,23.03,38091,1510,79,75,1197,7,2868,2.831.904.762
13/05/2016 23:00,22.28,36235,1458,94,62,1309,9,2932,2.831.904.762
14/05/2016 00:00,20.91,34745,1589,96,57,1415,9,3166,2.831.904.762
14/05/2016 01:00,19.83,33743,1583,95,55,1420,9,3162,2.831.904.762
14/05/2016 02:00,19.24,33143,1559,94,53,1405,9,3120,2.831.904.762
14/05/2016 03:00,18.96,32884,1511,90,50,1420,9,3080,2.831.904.762
14/05/2016 04:00,18.45,32677,1523,86,45,1400,9,3063,2.831.904.762
14/05/2016 05:00,18.79,32748,1540,79,36,1340,9,3004,2.831.904.762
14/05/2016 06:00,18.56,33506,1586,71,33,1257,9,2956,2.831.904.762
14/05/2016 07:00,20,35166,1684,66,27,1229,9,3015,2.831.904.762
14/05/2016 08:00,20.41,36561,1813,65,22,1204,9,3113,2.831.904.762
14/05/2016 09:00,21.5,38174,1952,65,19,1213,8,3257,2.831.904.762
14/05/2016 10:00,21.7,39035,2069,68,18,1176,8,3339,2.831.904.762
14/05/2016 11:00,21.58,39086,2223,66,19,1094,8,3410,2.831.904.762
14/05/2016 12:00,21.1,38862,2409,64,22,1135,8,3638,2.831.904.762
14/05/2016 13:00,20.73,38534,2579,62,20,1131,8,3800,2.831.904.762
14/05/2016 14:00,20.3,38287,2702,57,17,1123,8,3907,2.831.904.762
14/05/2016 15:00,20.04,38078,2759,57,16,1118,8,3958,2.831.904.762
14/05/2016 16:00,20.03,38187,2743,57,16,1129,8,3953,2.831.904.762
14/05/2016 17:00,20.32,38694,2645,56,15,1100,8,3824,2.831.904.762
14/05/2016 18:00,20.5,38748,2481,58,16,1102,8,3665,2.831.904.762
14/05/2016 19:00,20.76,38288,2306,63,18,1109,8,3504,2.831.904.762
14/05/2016 20:00,20.46,37559,2127,69,21,1255,8,3480,2.831.904.762
14/05/2016 21:00,20.66,37484,1954,73,25,1397,8,3457,2.831.904.762
14/05/2016 22:00,22.18,37227,1854,78,30,1575,8,3545,2.831.904.762
14/05/2016 23:00,20.62,36041,1812,71,50,1731,7,3671,2.831.904.762
15/05/2016 00:00,20.42,34593,1333,80,58,1856,10,3337,2.831.904.762
15/05/2016 01:00,19.51,33653,1366,86,66,1912,13,3443,2.831.904.762
15/05/2016 02:00,18.99,33072,1433,95,66,2002,13,3609,2.831.904.762
15/05/2016 03:00,18.73,32767,1432,102,64,2105,15,3718,2.831.904.762
15/05/2016 04:00,18.08,32530,1424,106,64,2164,14,3772,2.831.904.762
15/05/2016 05:00,18.05,32388,1478,103,64,2169,11,3825,2.831.904.762
15/05/2016 06:00,17.9,32762,1519,103,64,2164,8,3858,2.831.904.762
15/05/2016 07:00,18.56,33795,1535,99,64,2141,5,3844,2.831.904.762
15/05/2016 08:00,19.3,35448,1691,94,67,2190,5,4047,2.831.904.762
15/05/2016 09:00,20.26,36894,1924,91,71,2188,4,4278,2.831.904.762
15/05/2016 10:00,20.58,37924,2059,88,77,2162,6,4392,2.831.904.762
15/05/2016 11:00,20.54,38133,2110,84,77,2143,6,4420,2.831.904.762
15/05/2016 12:00,20.24,38060,2203,81,77,2112,5,4478,2.831.904.762
15/05/2016 13:00,20.04,37819,2327,76,77,2099,5,4584,2.831.904.762
15/05/2016 14:00,19.85,37426,2421,71,70,2133,6,4701,2.831.904.762
15/05/2016 15:00,19.74,37317,2481,63,60,2096,6,4706,2.831.904.762
15/05/2016 16:00,19.92,37291,2472,57,60,2079,6,4674,2.831.904.762
15/05/2016 17:00,20.23,37681,2382,51,53,2056,6,4548,2.831.904.762
15/05/2016 18:00,20.48,38182,2273,46,46,2003,5,4373,2.831.904.762
15/05/2016 19:00,21.44,38203,2131,45,46,1994,7,4223,2.831.904.762
15/05/2016 20:00,21.69,37995,1919,43,48,2121,7,4138,2.831.904.762
15/05/2016 21:00,22.33,37994,1774,41,57,2303,8,4183,2.831.904.762
15/05/2016 22:00,22.29,37600,1800,37,69,2504,7,4417,2.831.904.762
15/05/2016 23:00,21.74,36081,1850,53,109,2964,5,4981,2.831.904.762
16/05/2016 00:00,21.46,35206,1841,57,115,3071,4,5088,3.007.916.667
16/05/2016 01:00,20.09,34480,1782,54,116,3059,5,5016,3.007.916.667
16/05/2016 02:00,18.76,34162,1809,50,116,3040,6,5021,3.007.916.667
16/05/2016 03:00,18.65,34092,1934,45,126,3051,7,5163,3.007.916.667
16/05/2016 04:00,18.69,34364,2065,39,146,3025,7,5282,3.007.916.667
16/05/2016 05:00,20.03,35396,2170,37,161,2963,7,5338,3.007.916.667
16/05/2016 06:00,21.82,37613,2229,35,173,2852,9,5298,3.007.916.667
16/05/2016 07:00,22.71,39815,2275,33,181,2709,9,5207,3.007.916.667
16/05/2016 08:00,23.19,40351,2313,36,181,2640,10,5180,3.007.916.667
16/05/2016 09:00,23.52,41330,2297,37,177,2513,9,5033,3.007.916.667
16/05/2016 10:00,23.68,42008,2276,35,176,2471,7,4965,3.007.916.667
16/05/2016 11:00,23.87,42323,2326,33,169,2381,9,4918,3.007.916.667
16/05/2016 12:00,23.54,42198,2446,32,169,2194,11,4852,3.007.916.667
16/05/2016 13:00,23.29,42078,2573,35,170,1997,11,4786,3.007.916.667
16/05/2016 14:00,23.03,41726,2714,34,180,1787,9,4724,3.007.916.667
16/05/2016 15:00,22.74,41392,2843,33,184,1614,9,4683,3.007.916.667
16/05/2016 16:00,22.75,41190,2919,32,182,1426,10,4569,3.007.916.667
16/05/2016 17:00,23.25,41248,2905,30,178,1269,8,4390,3.007.916.667
16/05/2016 18:00,23.84,41051,2851,29,167,1113,7,4167,3.007.916.667
16/05/2016 19:00,24.51,40747,2815,29,161,1010,6,4021,3.007.916.667
16/05/2016 20:00,24.1,40225,2730,32,163,952,5,3882,3.007.916.667
16/05/2016 21:00,24.01,39996,2595,38,162,1017,5,3817,3.007.916.667
16/05/2016 22:00,23.57,39343,2506,40,156,1051,4,3757,3.007.916.667
16/05/2016 23:00,22.86,37386,2464,56,155,1193,21,3889,3.007.916.667
17/05/2016 00:00,22.9,35348,2469,55,150,1250,19,3943,3.007.916.667
17/05/2016 01:00,22.54,34413,2386,57,144,1239,14,3840,3.007.916.667
17/05/2016 02:00,22.08,33989,2474,58,143,1201,14,3890,3.007.916.667
17/05/2016 03:00,21.59,33808,2600,57,144,1206,14,4021,3.007.916.667
17/05/2016 04:00,21.72,33836,2607,57,144,1202,13,4023,3.007.916.667
17/05/2016 05:00,22.78,34959,2589,54,140,1198,12,3993,3.007.916.667
17/05/2016 06:00,24.45,38089,2630,55,137,1255,15,4092,3.007.916.667
17/05/2016 07:00,26.51,40791,2693,57,128,1157,18,4053,3.007.916.667
17/05/2016 08:00,27.96,41256,2695,62,110,1041,17,3925,3.007.916.667
17/05/2016 09:00,27.16,41906,2631,66,93,1232,17,4039,3.007.916.667
17/05/2016 10:00,26.4,42272,2567,66,87,1337,14,4071,3.007.916.667
17/05/2016 11:00,25.99,42140,2506,64,87,1365,14,4036,3.007.916.667
17/05/2016 12:00,25.39,41678,2433,56,83,1419,12,4003,3.007.916.667
17/05/2016 13:00,25.2,41505,2386,46,80,1386,8,3906,3.007.916.667
17/05/2016 14:00,25.43,41169,2333,39,76,1301,8,3757,3.007.916.667
17/05/2016 15:00,24.82,40823,2262,31,67,1206,5,3571,3.007.916.667
17/05/2016 16:00,24.6,40582,2233,22,50,1107,6,3418,3.007.916.667
17/05/2016 17:00,25.45,40514,2242,18,40,970,8,3278,3.007.916.667
17/05/2016 18:00,25.45,40214,2182,15,33,896,8,3134,3.007.916.667
17/05/2016 19:00,25.71,39957,2100,14,28,849,9,3000,3.007.916.667
17/05/2016 20:00,25,39397,1997,13,27,790,7,2834,3.007.916.667
17/05/2016 21:00,25.45,39180,1828,13,28,790,4,2663,3.007.916.667
17/05/2016 22:00,24.96,38487,1699,14,28,820,4,2565,3.007.916.667
17/05/2016 23:00,23.92,36503,1619,10,24,896,8,2557,3.007.916.667
18/05/2016 00:00,23.47,35085,1460,10,24,885,8,2387,3.007.916.667
18/05/2016 01:00,23.21,34143,1369,11,24,903,8,2315,3.007.916.667
18/05/2016 02:00,22.9,33761,1253,12,23,873,7,2168,3.007.916.667
18/05/2016 03:00,22.37,33619,1121,13,21,807,7,1969,3.007.916.667
18/05/2016 04:00,22.66,33706,1051,12,20,829,7,1919,3.007.916.667
18/05/2016 05:00,23.69,35100,1038,9,19,842,7,1915,3.007.916.667
18/05/2016 06:00,26.8,39400,1032,6,18,810,8,1874,3.007.916.667
18/05/2016 07:00,30.22,43372,1052,6,16,827,10,1911,3.007.916.667
18/05/2016 08:00,31.32,44097,1063,8,16,875,12,1974,3.007.916.667
18/05/2016 09:00,30.39,44242,1017,11,17,908,12,1965,3.007.916.667
18/05/2016 10:00,29.67,44313,933,13,20,898,11,1875,3.007.916.667
18/05/2016 11:00,28.93,44055,856,17,24,914,11,1822,3.007.916.667
18/05/2016 12:00,28.78,43484,787,18,30,925,11,1771,3.007.916.667
18/05/2016 13:00,28.18,43353,729,19,34,906,11,1699,3.007.916.667
18/05/2016 14:00,28.41,42976,684,18,32,888,11,1633,3.007.916.667
18/05/2016 15:00,27.25,42507,664,16,29,859,10,1578,3.007.916.667
18/05/2016 16:00,28.02,42152,688,13,27,799,11,1538,3.007.916.667
18/05/2016 17:00,28.97,42035,648,13,24,738,11,1434,3.007.916.667
18/05/2016 18:00,30.28,41764,575,12,19,682,12,1300,3.007.916.667
18/05/2016 19:00,30.4,41393,507,12,17,655,14,1205,3.007.916.667
18/05/2016 20:00,29.92,40716,437,13,15,647,13,1125,3.007.916.667
18/05/2016 21:00,29.86,40547,366,12,15,660,9,1062,3.007.916.667
18/05/2016 22:00,28.02,39542,343,12,15,683,9,1062,3.007.916.667
18/05/2016 23:00,25.32,37081,305,9,10,683,4,1011,3.007.916.667
19/05/2016 00:00,24.47,35347,279,10,13,695,5,1002,3.007.916.667
19/05/2016 01:00,22.89,34206,270,12,17,691,5,995,3.007.916.667
19/05/2016 02:00,22.21,33628,239,13,19,671,5,947,3.007.916.667
19/05/2016 03:00,21.93,33452,195,13,19,664,5,896,3.007.916.667
19/05/2016 04:00,22.33,33593,153,12,19,664,5,853,3.007.916.667
19/05/2016 05:00,24.18,35019,114,9,19,621,5,768,3.007.916.667
19/05/2016 06:00,29.03,38759,94,9,18,579,4,704,3.007.916.667
19/05/2016 07:00,32.82,42505,84,11,16,538,5,654,3.007.916.667
19/05/2016 08:00,38.99,44115,82,15,16,545,6,664,3.007.916.667
19/05/2016 09:00,36.76,43552,79,21,16,559,6,681,3.007.916.667
19/05/2016 10:00,38.92,43764,81,26,18,569,5,699,3.007.916.667
19/05/2016 11:00,37.79,43656,78,28,19,619,7,751,3.007.916.667
19/05/2016 12:00,33.15,43317,79,29,21,746,7,882,3.007.916.667
19/05/2016 13:00,32,43147,87,26,23,827,7,970,3.007.916.667
19/05/2016 14:00,30.9,42794,99,24,23,781,7,934,3.007.916.667
19/05/2016 15:00,30.28,42398,108,21,20,834,6,989,3.007.916.667
19/05/2016 16:00,29.82,42066,121,17,17,876,6,1037,3.007.916.667
19/05/2016 17:00,30.06,41882,124,12,13,880,5,1034,3.007.916.667
19/05/2016 18:00,30.15,41555,118,10,10,889,4,1031,3.007.916.667
19/05/2016 19:00,29.78,41092,124,10,10,792,6,942,3.007.916.667
19/05/2016 20:00,27.63,40433,142,9,11,742,6,910,3.007.916.667
19/05/2016 21:00,27.95,40078,187,11,13,708,3,922,3.007.916.667
19/05/2016 22:00,26.54,39175,290,12,16,716,3,1037,3.007.916.667
19/05/2016 23:00,24.72,36930,403,5,16,741,2,1167,3.007.916.667
20/05/2016 00:00,23.91,35096,723,4,17,737,2,1483,3.007.916.667
20/05/2016 01:00,22.98,33943,865,4,17,756,1,1643,3.007.916.667
20/05/2016 02:00,21.64,33515,891,4,16,713,1,1625,3.007.916.667
20/05/2016 03:00,21.45,33374,864,4,13,695,1,1577,3.007.916.667
20/05/2016 04:00,21.69,33541,877,3,10,654,1,1545,3.007.916.667
20/05/2016 05:00,23.62,34924,929,3,10,609,2,1553,3.007.916.667
20/05/2016 06:00,25.78,38269,988,3,10,576,2,1579,3.007.916.667
20/05/2016 07:00,29.56,42259,1052,2,12,584,4,1654,3.007.916.667
20/05/2016 08:00,30.06,43229,1182,3,13,655,4,1857,3.007.916.667
20/05/2016 09:00,29.56,43606,1385,4,16,691,4,2100,3.007.916.667
20/05/2016 10:00,28.19,43864,1573,6,20,768,2,2369,3.007.916.667
20/05/2016 11:00,26.9,43659,1666,8,24,888,3,2589,3.007.916.667
20/05/2016 12:00,26.08,43194,1665,11,30,1118,4,2828,3.007.916.667
20/05/2016 13:00,24.73,42584,1664,14,33,1277,6,2994,3.007.916.667
20/05/2016 14:00,24.49,41916,1642,14,33,1414,7,3110,3.007.916.667
20/05/2016 15:00,24.35,41229,1503,12,33,1504,5,3057,3.007.916.667
20/05/2016 16:00,24.48,40728,1356,11,28,1617,4,3016,3.007.916.667
20/05/2016 17:00,25.22,40705,1227,9,25,1637,3,2901,3.007.916.667
20/05/2016 18:00,25.09,40485,1034,11,21,1631,2,2699,3.007.916.667
20/05/2016 19:00,24.98,39894,824,13,23,1560,4,2424,3.007.916.667
20/05/2016 20:00,24.47,38842,647,14,26,1625,4,2316,3.007.916.667
20/05/2016 21:00,24.45,38436,523,15,26,1652,3,2219,3.007.916.667
20/05/2016 22:00,24.36,37908,474,16,27,1635,2,2154,3.007.916.667
20/05/2016 23:00,23.98,36096,463,19,22,1636,2,2142,3.007.916.667
21/05/2016 00:00,24.02,33977,528,18,22,1596,4,2168,3.007.916.667
21/05/2016 01:00,23.48,32873,457,18,22,1523,7,2027,3.007.916.667
21/05/2016 02:00,22.59,32268,395,19,24,1358,9,1805,3.007.916.667
21/05/2016 03:00,21.82,32000,375,20,27,1206,14,1642,3.007.916.667
21/05/2016 04:00,21.54,31732,386,18,31,1074,9,1518,3.007.916.667
21/05/2016 05:00,21.25,31814,395,14,40,970,5,1424,3.007.916.667
21/05/2016 06:00,21.64,32963,424,12,47,877,5,1365,3.007.916.667
21/05/2016 07:00,23.16,34449,493,13,53,764,5,1328,3.007.916.667
21/05/2016 08:00,23.63,35941,561,16,62,702,4,1345,3.007.916.667
21/05/2016 09:00,23.67,37409,613,21,74,648,3,1359,3.007.916.667
21/05/2016 10:00,23.67,38196,682,29,90,675,5,1481,3.007.916.667
21/05/2016 11:00,23.57,38100,783,35,94,657,7,1576,3.007.916.667
21/05/2016 12:00,23.18,37499,899,43,96,651,8,1697,3.007.916.667
21/05/2016 13:00,22.91,37094,1044,51,100,638,8,1841,3.007.916.667
21/05/2016 14:00,22.61,36765,1143,56,94,598,7,1898,3.007.916.667
21/05/2016 15:00,22.46,36473,1142,63,83,583,8,1879,3.007.916.667
21/05/2016 16:00,22.01,36678,1156,64,72,533,7,1832,3.007.916.667
21/05/2016 17:00,22.51,37195,1163,62,54,492,8,1779,3.007.916.667
21/05/2016 18:00,23.67,37373,1077,61,38,492,9,1677,3.007.916.667
21/05/2016 19:00,24.14,36955,963,62,26,500,8,1559,3.007.916.667
21/05/2016 20:00,23.95,36366,848,61,21,529,5,1464,3.007.916.667
21/05/2016 21:00,23.97,36281,764,60,20,603,4,1451,3.007.916.667
21/05/2016 22:00,23.92,36048,785,57,20,676,4,1542,3.007.916.667
21/05/2016 23:00,23.46,34644,821,50,18,803,4,1696,3.007.916.667
22/05/2016 00:00,21.9,33136,948,47,17,796,5,1813,3.007.916.667
22/05/2016 01:00,21.01,32150,951,43,17,802,5,1818,3.007.916.667
22/05/2016 02:00,20.3,31571,912,39,16,761,5,1733,3.007.916.667
22/05/2016 03:00,20.43,31217,907,32,13,746,5,1703,3.007.916.667
22/05/2016 04:00,20.52,30838,991,24,11,727,4,1757,3.007.916.667
22/05/2016 05:00,19.94,30653,1092,17,11,678,3,1801,3.007.916.667
22/05/2016 06:00,19.82,30932,1203,12,8,638,4,1865,3.007.916.667
22/05/2016 07:00,20.79,31781,1365,10,8,632,3,2018,3.007.916.667
22/05/2016 08:00,22.16,33193,1453,10,7,727,3,2200,3.007.916.667
22/05/2016 09:00,23.19,34552,1453,12,7,926,3,2401,3.007.916.667
22/05/2016 10:00,23.35,35586,1494,16,8,1149,4,2671,3.007.916.667
22/05/2016 11:00,23.32,35982,1488,19,9,1351,3,2870,3.007.916.667
22/05/2016 12:00,23.01,35930,1441,22,10,1572,4,3049,3.007.916.667
22/05/2016 13:00,22.76,35597,1424,22,10,1744,3,3203,3.007.916.667
22/05/2016 14:00,22.48,35387,1433,21,11,1735,2,3202,3.007.916.667
22/05/2016 15:00,22.17,35198,1511,17,11,1847,2,3388,3.007.916.667
22/05/2016 16:00,22.16,35277,1549,14,9,2009,2,3583,3.007.916.667
22/05/2016 17:00,21.83,35680,1435,12,9,1957,1,3414,3.007.916.667
22/05/2016 18:00,21.86,36124,1286,12,11,2015,1,3325,3.007.916.667
22/05/2016 19:00,23.27,36276,1183,12,14,2085,1,3295,3.007.916.667
22/05/2016 20:00,23.72,36017,1001,15,20,2230,3,3269,3.007.916.667
22/05/2016 21:00,23.85,36092,802,16,30,2417,6,3271,3.007.916.667
22/05/2016 22:00,23.84,35697,653,16,34,2522,6,3231,3.007.916.667
22/05/2016 23:00,22.9,34111,489,11,54,2599,4,3157,3.007.916.667
23/05/2016 00:00,22.04,32397,317,12,62,2613,4,3008,347.172.619
23/05/2016 01:00,20.8,31503,354,12,68,2509,4,2947,347.172.619
23/05/2016 02:00,19.45,31037,331,11,71,2379,5,2797,347.172.619
23/05/2016 03:00,18.9,30897,252,10,73,2212,6,2553,347.172.619
23/05/2016 04:00,19.39,31087,228,7,71,2006,7,2319,347.172.619
23/05/2016 05:00,21.65,32533,245,5,61,1745,5,2061,347.172.619
23/05/2016 06:00,24.84,35764,300,5,56,1552,5,1918,347.172.619
23/05/2016 07:00,26.22,39378,348,5,50,1390,7,1800,347.172.619
23/05/2016 08:00,27.88,40555,330,6,51,1260,8,1655,347.172.619
23/05/2016 09:00,27.75,40877,304,6,54,1159,8,1531,347.172.619
23/05/2016 10:00,27.41,41040,356,7,56,1121,6,1546,347.172.619
23/05/2016 11:00,27.1,40989,433,9,54,1173,6,1675,347.172.619
23/05/2016 12:00,25.97,40623,512,12,53,1276,6,1859,347.172.619
23/05/2016 13:00,26.31,40396,607,13,53,1275,6,1954,347.172.619
23/05/2016 14:00,25.88,40136,731,11,56,1322,5,2125,347.172.619
23/05/2016 15:00,25.24,39702,854,11,57,1346,5,2273,347.172.619
23/05/2016 16:00,25,39383,897,10,56,1328,5,2296,347.172.619
23/05/2016 17:00,25.54,39413,913,11,60,1249,6,2239,347.172.619
23/05/2016 18:00,25.11,39156,918,12,68,1185,7,2190,347.172.619
23/05/2016 19:00,24.93,38720,895,13,72,1234,8,2222,347.172.619
23/05/2016 20:00,24.08,37980,826,15,76,1321,9,2247,347.172.619
23/05/2016 21:00,24.01,37775,749,19,79,1438,8,2293,347.172.619
23/05/2016 22:00,23.88,37064,699,22,85,1498,6,2310,347.172.619
23/05/2016 23:00,22.69,35015,718,24,97,1548,4,2391,347.172.619
24/05/2016 00:00,21.47,33265,686,24,94,1643,5,2452,347.172.619
24/05/2016 01:00,21.06,32152,677,25,92,1628,6,2428,347.172.619
24/05/2016 02:00,19.99,31683,714,27,89,1605,5,2440,347.172.619
24/05/2016 03:00,19.62,31489,777,26,82,1551,4,2440,347.172.619
24/05/2016 04:00,20.3,31623,801,18,75,1522,4,2420,347.172.619
24/05/2016 05:00,22.22,33003,790,11,59,1491,4,2355,347.172.619
24/05/2016 06:00,24.09,36186,784,5,40,1394,2,2225,347.172.619
24/05/2016 07:00,25.57,40007,824,2,32,1301,3,2162,347.172.619
24/05/2016 08:00,25.77,41707,881,3,28,1237,4,2153,347.172.619
24/05/2016 09:00,26.17,41716,927,4,27,1179,4,2141,347.172.619
24/05/2016 10:00,25.99,41798,985,6,27,1158,3,2179,347.172.619
24/05/2016 11:00,25.96,41830,1066,9,28,1203,3,2309,347.172.619
24/05/2016 12:00,25.76,41582,1151,14,31,1236,4,2436,347.172.619
24/05/2016 13:00,25.55,41536,1233,18,33,1218,6,2508,347.172.619
24/05/2016 14:00,25.35,41307,1325,21,34,1244,9,2633,347.172.619
24/05/2016 15:00,24.81,40858,1399,24,32,1288,11,2754,347.172.619
24/05/2016 16:00,24.65,40261,1458,24,30,1353,11,2876,347.172.619
24/05/2016 17:00,25.04,40234,1497,23,30,1365,10,2925,347.172.619
24/05/2016 18:00,24.84,40305,1520,22,33,1444,10,3029,347.172.619
24/05/2016 19:00,24.86,39876,1556,26,37,1561,10,3190,347.172.619
24/05/2016 20:00,24.35,39248,1557,28,44,1709,9,3347,347.172.619
24/05/2016 21:00,24.24,38649,1521,34,55,1846,9,3465,347.172.619
24/05/2016 22:00,23.87,37845,1489,31,57,1963,6,3546,347.172.619
24/05/2016 23:00,23.2,35502,1451,33,54,2018,8,3564,347.172.619
25/05/2016 00:00,21.64,33416,1334,29,50,2109,7,3529,347.172.619
25/05/2016 01:00,21.14,32269,1296,27,42,2192,7,3564,347.172.619
25/05/2016 02:00,20.88,31785,1261,24,41,2206,5,3537,347.172.619
25/05/2016 03:00,20.38,31545,1219,20,34,2211,4,3488,347.172.619
25/05/2016 04:00,20.94,31617,1196,13,29,2137,4,3379,347.172.619
25/05/2016 05:00,22.43,33126,1248,6,26,2077,3,3360,347.172.619
25/05/2016 06:00,24.47,37354,1335,3,20,1977,1,3336,347.172.619
25/05/2016 07:00,25.82,41713,1415,3,19,1795,3,3235,347.172.619
25/05/2016 08:00,26.94,42314,1466,4,19,1764,5,3258,347.172.619
25/05/2016 09:00,26.89,42462,1469,6,20,1738,8,3241,347.172.619
25/05/2016 10:00,26.93,42916,1457,9,21,1723,7,3217,347.172.619
25/05/2016 11:00,25.99,42999,1459,12,21,1726,9,3227,347.172.619
25/05/2016 12:00,26.04,42721,1482,18,22,1721,14,3257,347.172.619
25/05/2016 13:00,25.77,42527,1508,26,25,1712,21,3292,347.172.619
25/05/2016 14:00,25.64,42250,1526,31,29,1732,25,3343,347.172.619
25/05/2016 15:00,24.57,41857,1557,34,33,1761,29,3414,347.172.619
25/05/2016 16:00,24.46,41770,1603,36,40,1796,27,3502,347.172.619
25/05/2016 17:00,24.91,41635,1626,36,37,1909,30,3638,347.172.619
25/05/2016 18:00,24.67,41070,1628,37,37,1920,36,3658,347.172.619
25/05/2016 19:00,24.72,40604,1639,36,37,1914,40,3666,347.172.619
25/05/2016 20:00,24.2,39836,1646,34,38,1970,37,3725,347.172.619
25/05/2016 21:00,24.05,39384,1633,32,40,1984,33,3722,347.172.619
25/05/2016 22:00,23.3,38439,1633,28,40,2078,31,3810,347.172.619
25/05/2016 23:00,22.66,36401,1598,30,61,2225,26,3940,347.172.619
26/05/2016 00:00,22.85,34566,1156,28,61,2295,27,3567,347.172.619
26/05/2016 01:00,22.51,33320,1099,28,62,2350,29,3568,347.172.619
26/05/2016 02:00,22.46,32791,1046,27,61,2355,26,3515,347.172.619
26/05/2016 03:00,22.46,32602,984,27,60,2301,30,3402,347.172.619
26/05/2016 04:00,22.58,32777,896,26,56,2207,29,3214,347.172.619
26/05/2016 05:00,23.21,34386,826,24,51,2104,33,3038,347.172.619
26/05/2016 06:00,25.24,38299,792,25,48,2004,34,2903,347.172.619
26/05/2016 07:00,27.33,42279,792,25,42,1933,34,2826,347.172.619
26/05/2016 08:00,29.15,42450,809,25,41,1959,36,2870,347.172.619
26/05/2016 09:00,28.42,42713,804,25,42,1967,33,2871,347.172.619
26/05/2016 10:00,25.96,42952,781,28,46,1991,36,2882,347.172.619
26/05/2016 11:00,25.73,43279,709,35,52,1963,39,2798,347.172.619
26/05/2016 12:00,25.51,43363,608,40,58,2003,45,2754,347.172.619
26/05/2016 13:00,25.3,43137,530,42,61,2000,45,2678,347.172.619
26/05/2016 14:00,25.58,42945,458,46,61,1966,44,2575,347.172.619
26/05/2016 15:00,25.13,42609,388,48,59,1922,44,2461,347.172.619
26/05/2016 16:00,25.49,42254,341,45,55,1868,38,2347,347.172.619
26/05/2016 17:00,26.57,42075,301,38,45,1763,25,2172,347.172.619
26/05/2016 18:00,26.13,41693,271,31,34,1681,13,2030,347.172.619
26/05/2016 19:00,26.03,41161,264,28,28,1631,9,1960,347.172.619
26/05/2016 20:00,25.66,40387,257,25,26,1622,7,1937,347.172.619
26/05/2016 21:00,25.51,39920,245,25,26,1598,4,1898,347.172.619
26/05/2016 22:00,25.32,39100,257,25,25,1597,7,1911,347.172.619
26/05/2016 23:00,23.98,36995,293,22,14,1612,6,1947,347.172.619
27/05/2016 00:00,23.65,35088,245,22,14,1623,6,1910,347.172.619
27/05/2016 01:00,22.85,33972,277,22,14,1606,6,1925,347.172.619
27/05/2016 02:00,21.96,33465,290,22,13,1485,6,1816,347.172.619
27/05/2016 03:00,20.69,33239,304,22,11,1386,6,1729,347.172.619
27/05/2016 04:00,21.76,33390,304,20,10,1301,7,1642,347.172.619
27/05/2016 05:00,23.66,34933,262,19,11,1213,8,1513,347.172.619
27/05/2016 06:00,25.84,38392,222,19,10,1105,8,1364,347.172.619
27/05/2016 07:00,28.81,42167,189,21,9,1043,10,1272,347.172.619
27/05/2016 08:00,31.25,42593,173,21,8,1059,11,1272,347.172.619
27/05/2016 09:00,30.81,43037,172,22,9,1161,11,1375,347.172.619
27/05/2016 10:00,30.38,43309,192,20,10,1106,8,1336,347.172.619
27/05/2016 11:00,30.18,43371,214,18,11,1022,8,1273,347.172.619
27/05/2016 12:00,29.27,42974,244,17,12,984,7,1264,347.172.619
27/05/2016 13:00,27.85,42403,289,17,11,947,6,1270,347.172.619
27/05/2016 14:00,27.12,41713,354,16,9,880,5,1264,347.172.619
27/05/2016 15:00,25.57,40966,456,16,8,843,5,1328,347.172.619
27/05/2016 16:00,25.65,40559,562,16,9,798,5,1390,347.172.619
27/05/2016 17:00,26.1,40383,598,18,12,760,5,1393,347.172.619
27/05/2016 18:00,25.75,40162,604,21,17,768,6,1416,347.172.619
27/05/2016 19:00,25.46,39476,621,28,24,750,8,1431,347.172.619
27/05/2016 20:00,24.7,38449,595,38,28,751,8,1420,347.172.619
27/05/2016 21:00,24.7,37890,553,48,31,749,8,1389,347.172.619
27/05/2016 22:00,24.26,37457,563,46,35,780,6,1430,347.172.619
27/05/2016 23:00,23.89,35902,576,53,63,754,5,1451,347.172.619
28/05/2016 00:00,23.81,34127,380,57,68,704,7,1216,347.172.619
28/05/2016 01:00,23.56,32872,377,57,76,650,9,1169,347.172.619
28/05/2016 02:00,22.79,32225,384,55,73,588,10,1110,347.172.619
28/05/2016 03:00,22.14,31852,388,53,70,509,9,1029,347.172.619
28/05/2016 04:00,21.69,31622,398,44,66,477,8,993,347.172.619
28/05/2016 05:00,21.91,31727,401,34,52,454,9,950,347.172.619
28/05/2016 06:00,22.56,32572,373,27,40,445,10,895,347.172.619
28/05/2016 07:00,23.43,34060,363,22,28,443,13,869,347.172.619
28/05/2016 08:00,23.87,34898,395,22,27,483,12,939,347.172.619
28/05/2016 09:00,24.19,36510,432,25,27,523,14,1021,347.172.619
28/05/2016 10:00,23.91,37299,477,29,29,577,13,1125,347.172.619
28/05/2016 11:00,23.59,37438,523,35,29,646,8,1241,347.172.619
28/05/2016 12:00,23.14,37275,551,40,30,692,8,1321,347.172.619
28/05/2016 13:00,22.61,36947,592,43,32,758,5,1430,347.172.619
28/05/2016 14:00,22.11,36688,636,46,32,756,4,1474,347.172.619
28/05/2016 15:00,21.91,36549,674,47,32,768,3,1524,347.172.619
28/05/2016 16:00,22.15,36595,709,50,31,790,5,1585,347.172.619
28/05/2016 17:00,22.95,36932,742,49,35,831,5,1662,347.172.619
28/05/2016 18:00,23.8,37106,767,51,42,839,6,1705,347.172.619
28/05/2016 19:00,23.96,36619,781,52,50,880,5,1768,347.172.619
28/05/2016 20:00,23.82,35879,773,52,64,927,7,1823,347.172.619
28/05/2016 21:00,23.72,35550,767,53,82,957,5,1864,347.172.619
28/05/2016 22:00,23.34,35374,810,50,102,1004,6,1972,347.172.619
28/05/2016 23:00,22.31,34104,818,54,102,922,12,1908,347.172.619
29/05/2016 00:00,20.73,32394,656,50,107,912,13,1738,347.172.619
29/05/2016 01:00,20.09,31327,608,47,110,920,12,1697,347.172.619
29/05/2016 02:00,18.36,30594,588,45,107,919,13,1672,347.172.619
29/05/2016 03:00,17.34,30116,572,42,105,871,11,1601,347.172.619
29/05/2016 04:00,17.05,29670,570,34,102,849,10,1565,347.172.619
29/05/2016 05:00,15.56,29627,575,29,80,827,10,1521,347.172.619
29/05/2016 06:00,16.35,30014,546,23,69,822,10,1470,347.172.619
29/05/2016 07:00,19.22,31063,524,21,50,810,9,1414,347.172.619
29/05/2016 08:00,21.79,32284,552,20,50,839,8,1469,347.172.619
29/05/2016 09:00,22.28,33860,630,22,55,886,8,1601,347.172.619
29/05/2016 10:00,22.68,35086,745,27,57,959,8,1796,347.172.619
29/05/2016 11:00,22.68,35689,873,29,57,1005,8,1972,347.172.619
29/05/2016 12:00,22.72,35743,982,33,59,1058,6,2138,347.172.619
29/05/2016 13:00,22.51,35587,1104,35,61,1140,7,2347,347.172.619
29/05/2016 14:00,21.96,35347,1242,38,65,1204,9,2558,347.172.619
29/05/2016 15:00,21.3,35159,1383,40,72,1284,9,2788,347.172.619
29/05/2016 16:00,21.43,35216,1516,42,72,1354,10,2994,347.172.619
29/05/2016 17:00,22.25,35690,1618,43,72,1399,10,3142,347.172.619
29/05/2016 18:00,22.58,36116,1686,46,72,1462,9,3275,347.172.619
29/05/2016 19:00,22.56,36140,1774,49,73,1533,8,3437,347.172.619
29/05/2016 20:00,22.77,35813,1812,53,78,1640,7,3590,347.172.619
29/05/2016 21:00,23.04,35707,1883,56,84,1774,7,3804,347.172.619
29/05/2016 22:00,22.81,35372,2030,53,92,1811,6,3992,347.172.619
29/05/2016 23:00,20.01,33706,2163,57,105,1791,8,4124,347.172.619
30/05/2016 00:00,18.07,31906,2133,53,103,1831,8,4128,4.034.821.429
30/05/2016 01:00,14.17,30927,2277,50,97,1800,7,4231,4.034.821.429
30/05/2016 02:00,12.69,30442,2341,49,96,1749,6,4241,4.034.821.429
30/05/2016 03:00,11.55,30314,2307,46,95,1724,5,4177,4.034.821.429
30/05/2016 04:00,12.54,30509,2288,37,93,1686,5,4109,4.034.821.429
30/05/2016 05:00,20.45,32099,2278,27,87,1609,5,4006,4.034.821.429
30/05/2016 06:00,24.38,35554,2261,18,74,1616,4,3973,4.034.821.429
30/05/2016 07:00,25.75,39309,2275,17,71,1621,6,3990,4.034.821.429
30/05/2016 08:00,27.25,40217,2358,20,77,1656,8,4119,4.034.821.429
30/05/2016 09:00,26.97,40696,2508,27,86,1697,14,4332,4.034.821.429
30/05/2016 10:00,26.94,41020,2617,35,98,1737,16,4503,4.034.821.429
30/05/2016 11:00,26.38,41049,2717,43,96,1812,18,4686,4.034.821.429
30/05/2016 12:00,25.87,40770,2814,49,95,1932,20,4910,4.034.821.429
30/05/2016 13:00,25.61,40642,2879,55,94,1964,21,5013,4.034.821.429
30/05/2016 14:00,25.26,40303,2943,60,91,1989,23,5106,4.034.821.429
30/05/2016 15:00,24.51,39811,3016,65,88,2034,24,5227,4.034.821.429
30/05/2016 16:00,24.45,39361,3061,68,83,2030,26,5268,4.034.821.429
30/05/2016 17:00,24.9,39267,3062,68,86,2028,25,5269,4.034.821.429
30/05/2016 18:00,24.85,38923,3009,70,90,2037,20,5226,4.034.821.429
30/05/2016 19:00,24.89,38435,2897,71,96,2012,15,5091,4.034.821.429
30/05/2016 20:00,24.35,37609,2832,69,97,1978,12,4988,4.034.821.429
30/05/2016 21:00,24.07,37149,2838,69,103,1953,9,4972,4.034.821.429
30/05/2016 22:00,23.43,36418,2856,62,111,1933,10,4972,4.034.821.429
30/05/2016 23:00,21.99,34481,2861,61,137,1912,7,4978,4.034.821.429
31/05/2016 00:00,21.15,32268,2489,59,134,1878,7,4567,4.034.821.429
31/05/2016 01:00,19.22,31143,2465,57,130,1817,7,4476,4.034.821.429
31/05/2016 02:00,16.39,30616,2444,53,127,1744,8,4376,4.034.821.429
31/05/2016 03:00,16.08,30387,2385,49,122,1651,7,4214,4.034.821.429
31/05/2016 04:00,17.27,30478,2249,41,116,1590,6,4002,4.034.821.429
31/05/2016 05:00,22.4,31896,2057,31,103,1497,5,3693,4.034.821.429
31/05/2016 06:00,24.63,35233,1934,26,89,1357,5,3411,4.034.821.429
31/05/2016 07:00,26.02,38904,1864,23,75,1278,6,3246,4.034.821.429
31/05/2016 08:00,27.93,40158,1805,25,78,1224,8,3140,4.034.821.429
31/05/2016 09:00,27.97,40535,1759,29,92,1198,12,3090,4.034.821.429
31/05/2016 10:00,27.67,40697,1717,33,105,1184,16,3055,4.034.821.429
31/05/2016 11:00,27.46,40690,1632,38,111,1209,18,3008,4.034.821.429
31/05/2016 12:00,26.92,40496,1546,42,114,1247,18,2967,4.034.821.429
31/05/2016 13:00,26.65,40427,1501,43,118,1287,16,2965,4.034.821.429
31/05/2016 14:00,26.48,40140,1447,45,114,1289,16,2911,4.034.821.429
31/05/2016 15:00,25.74,39698,1351,49,107,1314,17,2838,4.034.821.429
31/05/2016 16:00,25.65,39206,1344,54,98,1343,19,2858,4.034.821.429
31/05/2016 17:00,25.98,38915,1371,57,100,1323,20,2871,4.034.821.429
31/05/2016 18:00,25.99,38474,1309,59,103,1314,15,2800,4.034.821.429
31/05/2016 19:00,25.94,37997,1291,61,106,1285,13,2756,4.034.821.429
31/05/2016 20:00,25.26,37309,1208,61,116,1316,11,2712,4.034.821.429
31/05/2016 21:00,25.06,36820,1109,61,127,1433,8,2738,4.034.821.429
31/05/2016 22:00,24.82,36063,1130,52,138,1489,9,2818,4.034.821.429
31/05/2016 23:00,24.04,34018,1166,56,149,1520,7,2898,4.034.821.429
01/06/2016 00:00,23.17,31976,1161,54,149,1490,6,2860,4.034.821.429
01/06/2016 01:00,21.88,30842,1208,49,146,1435,7,2845,4.034.821.429
01/06/2016 02:00,21.18,30461,1202,44,141,1362,8,2757,4.034.821.429
01/06/2016 03:00,20.09,30170,1124,38,137,1301,7,2607,4.034.821.429
01/06/2016 04:00,20.31,30487,1057,28,120,1168,7,2380,4.034.821.429
01/06/2016 05:00,23.19,32024,997,17,107,1012,6,2139,4.034.821.429
01/06/2016 06:00,25.69,35873,952,11,92,915,6,1976,4.034.821.429
01/06/2016 07:00,28.02,39820,907,9,78,841,7,1842,4.034.821.429
01/06/2016 08:00,29.33,40620,888,12,84,824,6,1814,4.034.821.429
01/06/2016 09:00,29.33,40877,942,14,91,826,6,1879,4.034.821.429
01/06/2016 10:00,29.38,41206,1060,18,106,857,12,2053,4.034.821.429
01/06/2016 11:00,28.96,41154,1183,21,109,903,14,2230,4.034.821.429
01/06/2016 12:00,28.36,41073,1286,24,113,946,16,2385,4.034.821.429
01/06/2016 13:00,27.87,41094,1351,25,116,977,18,2487,4.034.821.429
01/06/2016 14:00,26.88,40839,1343,25,115,1001,17,2501,4.034.821.429
01/06/2016 15:00,26.13,40427,1312,26,110,1002,19,2469,4.034.821.429
01/06/2016 16:00,25.5,40043,1322,25,105,976,18,2446,4.034.821.429
01/06/2016 17:00,25.83,39762,1313,25,100,942,16,2396,4.034.821.429
01/06/2016 18:00,26.34,39216,1286,25,93,923,16,2343,4.034.821.429
01/06/2016 19:00,26.21,38704,1239,27,88,926,11,2291,4.034.821.429
01/06/2016 20:00,25.6,37933,1114,29,98,927,7,2175,4.034.821.429
01/06/2016 21:00,25.15,37385,1018,33,105,947,6,2109,4.034.821.429
01/06/2016 22:00,24.94,36526,1033,29,110,985,6,2163,4.034.821.429
01/06/2016 23:00,24.07,34581,1021,27,74,1031,7,2160,4.034.821.429
02/06/2016 00:00,22.04,32456,823,23,78,1053,6,1983,4.034.821.429
02/06/2016 01:00,20.73,31181,738,18,81,1065,5,1907,4.034.821.429
02/06/2016 02:00,20.01,30559,679,14,79,1037,4,1813,4.034.821.429
02/06/2016 03:00,19.94,30274,617,10,75,1015,5,1722,4.034.821.429
02/06/2016 04:00,20.26,30416,582,7,70,945,4,1608,4.034.821.429
02/06/2016 05:00,22.56,32130,543,3,53,833,3,1435,4.034.821.429
02/06/2016 06:00,25.15,35959,528,2,37,776,3,1346,4.034.821.429
02/06/2016 07:00,26.84,39733,544,1,29,702,4,1280,4.034.821.429
02/06/2016 08:00,28.09,40403,542,2,31,701,4,1280,4.034.821.429
02/06/2016 09:00,27.83,40889,558,2,34,714,2,1310,4.034.821.429
02/06/2016 10:00,27.48,41211,619,4,38,761,3,1425,4.034.821.429
02/06/2016 11:00,26.98,41606,682,6,44,812,3,1547,4.034.821.429
02/06/2016 12:00,26.81,41664,759,9,52,871,4,1695,4.034.821.429
02/06/2016 13:00,26.3,41450,845,12,47,916,6,1826,4.034.821.429
02/06/2016 14:00,25.83,40888,909,15,42,945,8,1919,4.034.821.429
02/06/2016 15:00,25.35,40474,998,15,40,985,9,2047,4.034.821.429
02/06/2016 16:00,24.66,40016,1118,16,39,1029,8,2210,4.034.821.429
02/06/2016 17:00,25.07,39808,1179,15,37,1048,6,2285,4.034.821.429
02/06/2016 18:00,25.99,39342,1149,16,36,1043,6,2250,4.034.821.429
02/06/2016 19:00,26.1,38870,1083,18,34,1057,6,2198,4.034.821.429
02/06/2016 20:00,25.35,38106,1011,21,35,1115,5,2187,4.034.821.429
02/06/2016 21:00,24.68,37507,978,22,37,1152,3,2192,4.034.821.429
02/06/2016 22:00,24.24,36722,1021,18,38,1233,3,2313,4.034.821.429
02/06/2016 23:00,22.91,34643,1041,22,32,1383,4,2482,4.034.821.429
03/06/2016 00:00,22.65,32560,926,20,27,1457,3,2433,4.034.821.429
03/06/2016 01:00,21.73,31356,863,19,22,1605,3,2512,4.034.821.429
03/06/2016 02:00,21.39,30788,797,16,20,1650,4,2487,4.034.821.429
03/06/2016 03:00,20.77,30499,773,12,16,1640,4,2445,4.034.821.429
03/06/2016 04:00,21.06,30590,763,7,12,1565,4,2351,4.034.821.429
03/06/2016 05:00,22.32,32151,722,3,8,1552,3,2288,4.034.821.429
03/06/2016 06:00,25.01,35776,647,1,5,1477,3,2133,4.034.821.429
03/06/2016 07:00,26.99,39801,559,1,3,1607,4,2174,4.034.821.429
03/06/2016 08:00,28.19,41562,516,1,3,1561,3,2084,4.034.821.429
03/06/2016 09:00,27.98,41033,500,3,4,1603,2,2112,4.034.821.429
03/06/2016 10:00,27.83,41475,499,4,5,1599,3,2110,4.034.821.429
03/06/2016 11:00,27.26,41541,502,9,6,1596,3,2116,4.034.821.429
03/06/2016 12:00,26.4,41245,509,15,6,1672,5,2207,4.034.821.429
03/06/2016 13:00,25.33,40648,537,23,8,1723,7,2298,4.034.821.429
03/06/2016 14:00,24.7,39994,538,35,11,1763,7,2354,4.034.821.429
03/06/2016 15:00,24.32,39339,508,47,12,1843,9,2419,4.034.821.429
03/06/2016 16:00,23.95,38900,480,55,12,1898,12,2457,4.034.821.429
03/06/2016 17:00,24.18,38688,452,64,13,1898,10,2437,4.034.821.429
03/06/2016 18:00,24.97,38339,439,69,14,1888,10,2420,4.034.821.429
03/06/2016 19:00,25.02,37635,432,75,17,1870,8,2402,4.034.821.429
03/06/2016 20:00,24.48,36560,398,83,20,1853,6,2360,4.034.821.429
03/06/2016 21:00,24.25,35677,341,92,22,1896,4,2355,4.034.821.429
03/06/2016 22:00,24.09,35075,326,94,23,1833,4,2280,4.034.821.429
03/06/2016 23:00,23.58,33676,307,108,35,1868,4,2322,4.034.821.429
04/06/2016 00:00,22.73,32047,178,114,39,1910,4,2245,4.034.821.429
04/06/2016 01:00,22.51,30708,173,116,45,1932,5,2271,4.034.821.429
04/06/2016 02:00,21.66,30010,159,108,48,1919,6,2240,4.034.821.429
04/06/2016 03:00,21.53,29538,122,94,51,1836,6,2109,4.034.821.429
04/06/2016 04:00,20.99,29165,117,83,53,1776,7,2036,4.034.821.429
04/06/2016 05:00,21.03,29213,114,76,53,1734,9,1986,4.034.821.429
04/06/2016 06:00,20.49,30022,102,70,52,1657,10,1891,4.034.821.429
04/06/2016 07:00,22.54,31622,83,65,53,1532,11,1744,4.034.821.429
04/06/2016 08:00,23.41,33329,70,61,52,1413,10,1606,4.034.821.429
04/06/2016 09:00,23.77,35052,76,57,54,1328,10,1525,4.034.821.429
04/06/2016 10:00,23.45,36004,93,54,57,1291,11,1506,4.034.821.429
04/06/2016 11:00,23.5,36184,117,53,61,1320,9,1560,4.034.821.429
04/06/2016 12:00,23.23,36125,148,61,66,1369,10,1654,4.034.821.429
04/06/2016 13:00,22.63,35748,195,69,71,1378,12,1725,4.034.821.429
04/06/2016 14:00,22.35,35363,251,79,78,1372,14,1794,4.034.821.429
04/06/2016 15:00,22.34,35130,308,84,84,1449,16,1941,4.034.821.429
04/06/2016 16:00,22.41,35216,366,79,85,1536,14,2080,4.034.821.429
04/06/2016 17:00,22.97,35632,382,69,78,1493,15,2037,4.034.821.429
04/06/2016 18:00,23.68,35822,364,60,69,1524,16,2033,4.034.821.429
04/06/2016 19:00,24.37,35480,336,51,60,1484,16,1947,4.034.821.429
04/06/2016 20:00,24.14,34773,303,47,53,1500,15,1918,4.034.821.429
04/06/2016 21:00,24.12,34424,296,51,49,1463,12,1871,4.034.821.429
04/06/2016 22:00,24.55,34362,316,53,48,1506,11,1934,4.034.821.429
04/06/2016 23:00,23.99,33350,334,63,56,1546,10,2009,4.034.821.429
05/06/2016 00:00,22.94,32057,198,67,53,1568,10,1896,4.034.821.429
05/06/2016 01:00,22,30973,230,70,50,1519,8,1877,4.034.821.429
05/06/2016 02:00,20.57,30222,262,70,53,1503,7,1895,4.034.821.429
05/06/2016 03:00,19.74,29714,243,66,54,1411,7,1781,4.034.821.429
05/06/2016 04:00,19.9,29210,245,62,56,1255,9,1627,4.034.821.429
05/06/2016 05:00,18.79,29077,254,61,58,1103,11,1487,4.034.821.429
05/06/2016 06:00,19.7,29499,228,60,55,919,15,1277,4.034.821.429
05/06/2016 07:00,20.89,30587,202,63,53,819,15,1152,4.034.821.429
05/06/2016 08:00,22.01,32288,204,65,52,717,16,1054,4.034.821.429
05/06/2016 09:00,22.8,33548,227,74,55,657,15,1028,4.034.821.429
05/06/2016 10:00,22.95,34775,261,74,63,637,14,1049,4.034.821.429
05/06/2016 11:00,22.9,35409,283,75,72,614,13,1057,4.034.821.429
05/06/2016 12:00,22.9,35477,291,75,78,617,11,1072,4.034.821.429
05/06/2016 13:00,22.76,35413,304,72,90,623,13,1102,4.034.821.429
05/06/2016 14:00,22.7,35172,323,72,110,627,18,1150,4.034.821.429
05/06/2016 15:00,22.59,35041,348,72,124,649,18,1211,4.034.821.429
05/06/2016 16:00,22.56,35214,375,70,129,651,18,1243,4.034.821.429
05/06/2016 17:00,22.72,35755,401,65,136,638,19,1259,4.034.821.429
05/06/2016 18:00,23.15,36175,425,62,129,659,22,1297,4.034.821.429
05/06/2016 19:00,23.68,36303,446,64,121,677,23,1331,4.034.821.429
05/06/2016 20:00,24.06,35990,418,56,117,701,18,1310,4.034.821.429
05/06/2016 21:00,24.26,35881,366,58,107,764,13,1308,4.034.821.429
05/06/2016 22:00,24.96,35618,377,54,98,824,10,1363,4.034.821.429
05/06/2016 23:00,23.67,34277,402,54,75,1032,10,1573,4.034.821.429
06/06/2016 00:00,23.08,32642,433,55,63,1082,6,1639,4.260.952.381
06/06/2016 01:00,22.42,31571,520,52,59,1078,6,1715,4.260.952.381
06/06/2016 02:00,21.92,31008,574,48,57,1054,6,1739,4.260.952.381
06/06/2016 03:00,21.74,30648,628,48,48,1012,5,1741,4.260.952.381
06/06/2016 04:00,21.84,30543,730,48,46,934,5,1763,4.260.952.381
06/06/2016 05:00,23.07,31773,834,47,46,820,3,1750,4.260.952.381
06/06/2016 06:00,26.44,34291,870,47,42,700,7,1666,4.260.952.381
06/06/2016 07:00,29.21,37118,925,50,40,593,12,1620,4.260.952.381
06/06/2016 08:00,29.93,38868,989,51,39,536,10,1625,4.260.952.381
06/06/2016 09:00,29.95,38836,1020,52,42,491,9,1614,4.260.952.381
06/06/2016 10:00,29.84,39477,1036,48,45,466,10,1605,4.260.952.381
06/06/2016 11:00,29.78,39666,1048,45,49,466,11,1619,4.260.952.381
06/06/2016 12:00,28.76,39501,1051,42,53,493,12,1651,4.260.952.381
06/06/2016 13:00,28.65,39347,1053,41,55,523,12,1684,4.260.952.381
06/06/2016 14:00,28.29,39139,1021,41,62,597,11,1732,4.260.952.381
06/06/2016 15:00,28.23,38648,959,42,64,681,11,1757,4.260.952.381
06/06/2016 16:00,27.6,38502,913,41,64,732,10,1760,4.260.952.381
06/06/2016 17:00,27.84,38577,878,37,66,788,9,1778,4.260.952.381
06/06/2016 18:00,29.41,38325,866,31,61,816,9,1783,4.260.952.381
06/06/2016 19:00,29.92,37898,865,27,56,843,7,1798,4.260.952.381
06/06/2016 20:00,28.55,37179,857,21,49,928,5,1860,4.260.952.381
06/06/2016 21:00,27.7,36790,870,20,46,1045,4,1985,4.260.952.381
06/06/2016 22:00,27.54,36341,939,18,42,1147,3,2149,4.260.952.381
06/06/2016 23:00,24.35,34793,1012,18,28,1282,2,2342,4.260.952.381
07/06/2016 00:00,23.63,33263,1043,21,26,1377,1,2468,4.260.952.381
07/06/2016 01:00,23.05,32082,1016,23,19,1476,1,2535,4.260.952.381
07/06/2016 02:00,22.66,31523,964,21,18,1513,1,2517,4.260.952.381
07/06/2016 03:00,22.38,31209,902,18,15,1429,1,2365,4.260.952.381
07/06/2016 04:00,22.3,31279,853,17,11,1346,1,2228,4.260.952.381
07/06/2016 05:00,23.19,32702,832,16,9,1200,2,2059,4.260.952.381
07/06/2016 06:00,26.72,35997,844,18,8,1048,4,1922,4.260.952.381
07/06/2016 07:00,29.56,39767,882,21,9,925,4,1841,4.260.952.381
07/06/2016 08:00,30.84,40206,851,29,11,862,5,1758,4.260.952.381
07/06/2016 09:00,30.87,40765,767,39,14,868,5,1693,4.260.952.381
07/06/2016 10:00,30.81,41105,696,48,17,968,9,1738,4.260.952.381
07/06/2016 11:00,30.71,41227,655,56,23,1098,14,1846,4.260.952.381
07/06/2016 12:00,30.1,41193,635,60,33,1247,20,1995,4.260.952.381
07/06/2016 13:00,30.03,41272,621,54,36,1441,25,2177,4.260.952.381
07/06/2016 14:00,29.93,40991,620,46,44,1589,26,2325,4.260.952.381
07/06/2016 15:00,29.31,40436,635,39,51,1868,26,2619,4.260.952.381
07/06/2016 16:00,27.84,39960,671,34,61,1997,22,2785,4.260.952.381
07/06/2016 17:00,28.33,39690,700,27,58,2128,17,2930,4.260.952.381
07/06/2016 18:00,29.2,39248,704,23,52,2238,17,3034,4.260.952.381
07/06/2016 19:00,29.6,38772,738,23,52,2247,13,3073,4.260.952.381
07/06/2016 20:00,29.02,38049,738,26,52,2405,11,3232,4.260.952.381
07/06/2016 21:00,26.65,37468,720,36,55,2531,9,3351,4.260.952.381
07/06/2016 22:00,26.42,36832,736,44,57,2637,9,3483,4.260.952.381
07/06/2016 23:00,24.38,34999,768,48,85,2927,9,3837,4.260.952.381
08/06/2016 00:00,24.23,32863,899,51,90,3125,9,4174,4.260.952.381
08/06/2016 01:00,23.32,31699,1080,53,100,3153,9,4395,4.260.952.381
08/06/2016 02:00,22.7,31139,1295,58,105,3136,10,4604,4.260.952.381
08/06/2016 03:00,21.87,30747,1470,64,111,3125,12,4782,4.260.952.381
08/06/2016 04:00,21.76,30768,1601,71,111,3105,13,4901,4.260.952.381
08/06/2016 05:00,23.16,32254,1632,84,115,3129,16,4976,4.260.952.381
08/06/2016 06:00,25.87,35926,1588,91,111,3168,22,4980,4.260.952.381
08/06/2016 07:00,28.92,40065,1604,94,111,3225,25,5059,4.260.952.381
08/06/2016 08:00,29.88,41733,1594,101,115,3324,28,5162,4.260.952.381
08/06/2016 09:00,29.86,42115,1532,116,123,3310,29,5110,4.260.952.381
08/06/2016 10:00,29.92,42374,1502,120,125,3300,27,5074,4.260.952.381
08/06/2016 11:00,29.94,42580,1488,125,135,3297,24,5069,4.260.952.381
08/06/2016 12:00,29.02,42309,1511,138,145,3242,23,5059,4.260.952.381
08/06/2016 13:00,28.78,42122,1685,151,150,3229,24,5239,4.260.952.381
08/06/2016 14:00,28.26,41826,1819,157,155,3214,19,5364,4.260.952.381
08/06/2016 15:00,27.6,41312,1758,157,130,3203,19,5267,4.260.952.381
08/06/2016 16:00,26.64,40837,1755,149,120,3179,20,5223,4.260.952.381
08/06/2016 17:00,26.5,40631,1755,141,100,3155,21,5172,4.260.952.381
08/06/2016 18:00,27.03,40281,1683,136,100,3170,27,5116,4.260.952.381
08/06/2016 19:00,27.66,39815,1593,132,100,3081,23,4929,4.260.952.381
08/06/2016 20:00,27,38956,1453,129,105,3038,25,4750,4.260.952.381
08/06/2016 21:00,26.76,38292,1234,127,120,3004,23,4508,4.260.952.381
08/06/2016 22:00,26.03,37511,1047,127,120,3001,23,4318,4.260.952.381
08/06/2016 23:00,24.63,35662,875,135,136,3054,2,4202,4.260.952.381
09/06/2016 00:00,23.67,33654,663,141,116,3075,3,3998,4.260.952.381
09/06/2016 01:00,22.05,32401,587,147,84,3069,5,3892,4.260.952.381
09/06/2016 02:00,20.95,31785,461,155,65,3045,5,3731,4.260.952.381
09/06/2016 03:00,20.8,31466,335,157,58,2973,4,3527,4.260.952.381
09/06/2016 04:00,21.26,31568,251,162,57,2900,4,3374,4.260.952.381
09/06/2016 05:00,23.11,33091,194,166,56,2833,7,3256,4.260.952.381
09/06/2016 06:00,25.96,36890,162,171,53,2673,12,3071,4.260.952.381
09/06/2016 07:00,29.6,41116,157,176,51,2552,18,2954,4.260.952.381
09/06/2016 08:00,30.4,41927,168,181,53,2474,18,2894,4.260.952.381
09/06/2016 09:00,30.38,42357,172,186,57,2422,16,2853,4.260.952.381
09/06/2016 10:00,30.34,42674,219,188,68,2391,18,2884,4.260.952.381
09/06/2016 11:00,30.04,42694,319,186,76,2368,19,2968,4.260.952.381
09/06/2016 12:00,29.79,42583,444,185,85,2339,17,3070,4.260.952.381
09/06/2016 13:00,29.74,42414,583,179,96,2349,13,3220,4.260.952.381
09/06/2016 14:00,29.83,42176,748,169,108,2312,11,3348,4.260.952.381
09/06/2016 15:00,29.46,41782,911,157,100,2328,8,3504,4.260.952.381
09/06/2016 16:00,28.27,41307,1092,140,98,2338,6,3674,4.260.952.381
09/06/2016 17:00,28.5,41060,1203,121,97,2293,4,3718,4.260.952.381
09/06/2016 18:00,28.95,40527,1285,103,72,2135,4,3599,4.260.952.381
09/06/2016 19:00,29.15,40056,1493,90,36,1992,3,3614,4.260.952.381
09/06/2016 20:00,28.34,39313,1676,82,28,1916,2,3704,4.260.952.381
09/06/2016 21:00,27.08,38687,1680,78,22,1936,1,3717,4.260.952.381
09/06/2016 22:00,26.3,37911,1724,76,20,1976,1,3797,4.260.952.381
09/06/2016 23:00,25.16,36096,1848,65,16,2118,3,4050,4.260.952.381
10/06/2016 00:00,23.98,34259,2478,62,14,2213,3,4770,4.260.952.381
10/06/2016 01:00,23.01,32910,2609,56,18,2351,3,5037,4.260.952.381
10/06/2016 02:00,21.51,32303,2679,48,26,2465,5,5223,4.260.952.381
10/06/2016 03:00,20.03,32030,2707,42,36,2480,8,5273,4.260.952.381
10/06/2016 04:00,21.33,32099,2799,34,48,2440,7,5328,4.260.952.381
10/06/2016 05:00,23.57,33651,2862,25,61,2468,9,5425,4.260.952.381
10/06/2016 06:00,26.53,37419,2873,19,74,2512,14,5492,4.260.952.381
10/06/2016 07:00,28.47,41460,2906,19,87,2456,21,5489,4.260.952.381
10/06/2016 08:00,29.42,42297,2815,24,106,2350,22,5317,4.260.952.381
10/06/2016 09:00,29.57,42744,2608,26,113,2345,26,5118,4.260.952.381
10/06/2016 10:00,29.42,43076,2400,26,118,2253,32,4829,4.260.952.381
10/06/2016 11:00,28.76,43048,2205,26,124,2167,28,4550,4.260.952.381
10/06/2016 12:00,28.38,42674,2018,24,105,2090,25,4262,4.260.952.381
10/06/2016 13:00,28.17,41905,1842,20,88,2009,17,3976,4.260.952.381
10/06/2016 14:00,27.9,41240,1684,18,74,1854,11,3641,4.260.952.381
10/06/2016 15:00,26.89,40474,1553,17,63,1783,15,3431,4.260.952.381
10/06/2016 16:00,26.61,39988,1459,20,57,1762,18,3316,4.260.952.381
10/06/2016 17:00,26.97,39716,1358,25,56,1554,18,3011,4.260.952.381
10/06/2016 18:00,27.79,39386,1257,31,59,1411,18,2776,4.260.952.381
10/06/2016 19:00,27.92,38705,1160,40,60,1296,13,2569,4.260.952.381
10/06/2016 20:00,27.57,37623,1027,50,92,1194,9,2372,4.260.952.381
10/06/2016 21:00,27.76,36871,895,61,125,1127,10,2218,4.260.952.381
10/06/2016 22:00,27.76,36349,765,66,144,1130,12,2117,4.260.952.381
10/06/2016 23:00,26.34,35266,670,94,200,1252,36,2252,4.260.952.381
11/06/2016 00:00,24.87,33789,671,99,222,1263,36,2291,4.260.952.381
11/06/2016 01:00,24.2,32548,705,101,235,1252,35,2328,4.260.952.381
11/06/2016 02:00,23.68,31820,683,103,240,1193,36,2255,4.260.952.381
11/06/2016 03:00,23.3,31376,652,107,240,1132,30,2161,4.260.952.381
11/06/2016 04:00,23.18,30978,641,113,240,1055,30,2079,4.260.952.381
11/06/2016 05:00,23.55,31094,612,121,240,944,26,1943,4.260.952.381
11/06/2016 06:00,24.06,31905,532,129,255,888,22,1826,4.260.952.381
11/06/2016 07:00,24.58,33366,505,138,260,783,28,1714,4.260.952.381
11/06/2016 08:00,25.7,34899,508,143,250,691,34,1626,4.260.952.381
11/06/2016 09:00,26.95,36453,447,149,250,623,38,1507,4.260.952.381
11/06/2016 10:00,27.54,37325,383,151,250,551,36,1371,4.260.952.381
11/06/2016 11:00,27.59,37377,323,149,250,502,44,1268,4.260.952.381
11/06/2016 12:00,27.01,37131,281,143,235,433,46,1138,4.260.952.381
11/06/2016 13:00,25.97,36699,262,134,222,381,45,1044,4.260.952.381
11/06/2016 14:00,25.21,36338,236,123,220,365,40,984,4.260.952.381
11/06/2016 15:00,25,36013,213,113,215,341,37,919,4.260.952.381
11/06/2016 16:00,25.49,36085,215,104,210,296,38,863,4.260.952.381
11/06/2016 17:00,26.93,36376,222,98,200,274,39,833,4.260.952.381
11/06/2016 18:00,27.37,36427,226,97,190,266,36,815,4.260.952.381
11/06/2016 19:00,27.55,36011,248,99,160,247,32,786,4.260.952.381
11/06/2016 20:00,27.47,35332,260,103,140,227,23,753,4.260.952.381
11/06/2016 21:00,26.54,34802,265,105,130,240,18,758,4.260.952.381
11/06/2016 22:00,27.08,34582,320,103,122,271,15,831,4.260.952.381
11/06/2016 23:00,26.08,33706,369,119,113,290,14,905,4.260.952.381
12/06/2016 00:00,25.03,32394,375,120,109,318,13,935,4.260.952.381
12/06/2016 01:00,24.39,31391,377,120,105,333,11,946,4.260.952.381
12/06/2016 02:00,23.79,30751,373,115,100,316,10,914,4.260.952.381
12/06/2016 03:00,23.71,30250,341,109,80,308,9,847,4.260.952.381
12/06/2016 04:00,23.83,29810,294,103,75,276,8,756,4.260.952.381
12/06/2016 05:00,23.63,29681,271,102,70,222,9,674,4.260.952.381
12/06/2016 06:00,23.97,30128,280,99,67,196,12,654,4.260.952.381
12/06/2016 07:00,23.96,31151,308,96,65,163,13,645,4.260.952.381
12/06/2016 08:00,24.48,32643,359,92,70,140,13,674,4.260.952.381
12/06/2016 09:00,24.57,34079,446,87,76,146,11,766,4.260.952.381
12/06/2016 10:00,25.1,35063,583,81,79,161,11,915,4.260.952.381
12/06/2016 11:00,25.84,35570,682,77,82,170,10,1021,4.260.952.381
12/06/2016 12:00,25.49,35585,703,74,83,204,11,1075,4.260.952.381
12/06/2016 13:00,25.1,35422,731,72,85,228,11,1127,4.260.952.381
12/06/2016 14:00,24.89,35214,759,73,87,251,11,1181,4.260.952.381
12/06/2016 15:00,24.86,35081,765,77,84,267,9,1202,4.260.952.381
12/06/2016 16:00,24.97,35183,766,82,76,294,8,1226,4.260.952.381
12/06/2016 17:00,25.78,35626,763,80,68,309,7,1227,4.260.952.381
12/06/2016 18:00,27.33,35875,765,79,41,348,5,1238,4.260.952.381
12/06/2016 19:00,27.91,35876,766,78,34,438,4,1320,4.260.952.381
12/06/2016 20:00,27.45,35550,770,77,26,543,3,1419,4.260.952.381
12/06/2016 21:00,27.61,35364,801,76,25,627,3,1532,4.260.952.381
12/06/2016 22:00,27.4,35094,865,70,23,749,3,1710,4.260.952.381
12/06/2016 23:00,25.15,33988,930,73,16,843,3,1865,4.260.952.381
13/06/2016 00:00,24.77,32836,747,68,14,880,3,1712,4.418.214.286
13/06/2016 01:00,24.13,31945,894,65,14,971,2,1946,4.418.214.286
13/06/2016 02:00,23.48,31474,1010,62,14,963,3,2052,4.418.214.286
13/06/2016 03:00,22.97,31224,1083,57,14,955,3,2112,4.418.214.286
13/06/2016 04:00,23.06,31303,1145,51,12,889,2,2099,4.418.214.286
13/06/2016 05:00,24.24,32802,1213,43,12,829,2,2099,4.418.214.286
13/06/2016 06:00,26.68,36179,1283,38,7,771,3,2102,4.418.214.286
13/06/2016 07:00,29.64,39664,1390,35,5,734,4,2168,4.418.214.286
13/06/2016 08:00,31.24,41247,1578,32,5,793,4,2412,4.418.214.286
13/06/2016 09:00,31.56,40855,1802,32,5,815,2,2656,4.418.214.286
13/06/2016 10:00,31.19,41148,2029,32,6,841,2,2910,4.418.214.286
13/06/2016 11:00,30.91,41204,2226,32,6,913,3,3180,4.418.214.286
13/06/2016 12:00,30.25,41133,2332,33,6,971,3,3345,4.418.214.286
13/06/2016 13:00,29.99,41272,2369,33,7,1010,4,3423,4.418.214.286
13/06/2016 14:00,29.46,41013,2273,33,8,1069,3,3386,4.418.214.286
13/06/2016 15:00,28.74,40577,2132,32,10,1114,3,3291,4.418.214.286
13/06/2016 16:00,28.07,40180,2030,32,12,1096,3,3173,4.418.214.286
13/06/2016 17:00,28.65,40071,1926,32,13,1065,3,3039,4.418.214.286
13/06/2016 18:00,28.92,39623,1838,32,15,999,5,2889,4.418.214.286
13/06/2016 19:00,29.68,39087,1725,34,18,984,4,2765,4.418.214.286
13/06/2016 20:00,29.28,38288,1591,38,25,1062,3,2719,4.418.214.286
13/06/2016 21:00,28.13,37685,1483,43,33,1054,4,2617,4.418.214.286
13/06/2016 22:00,27.39,36985,1430,45,40,1098,3,2616,4.418.214.286
13/06/2016 23:00,25.9,35319,1425,40,68,1233,4,2770,4.418.214.286
14/06/2016 00:00,25.21,33534,1462,38,80,1285,5,2870,4.418.214.286
14/06/2016 01:00,24.13,32370,1458,36,90,1350,6,2940,4.418.214.286
14/06/2016 02:00,23.43,31850,1455,31,100,1354,7,2947,4.418.214.286
14/06/2016 03:00,22.96,31585,1442,26,105,1341,7,2921,4.418.214.286
14/06/2016 04:00,23.51,31601,1436,17,103,1233,7,2796,4.418.214.286
14/06/2016 05:00,24.88,32925,1453,10,106,1067,7,2643,4.418.214.286
14/06/2016 06:00,27.66,36394,1489,6,97,955,7,2554,4.418.214.286
14/06/2016 07:00,29.66,40244,1523,5,86,905,9,2528,4.418.214.286
14/06/2016 08:00,30.07,41036,1528,5,77,917,11,2538,4.418.214.286
14/06/2016 09:00,30.09,41142,1506,6,78,991,10,2591,4.418.214.286
14/06/2016 10:00,30.11,41529,1467,7,81,1040,9,2604,4.418.214.286
14/06/2016 11:00,30.13,41739,1421,6,84,1077,8,2596,4.418.214.286
14/06/2016 12:00,29.98,41676,1391,6,81,1160,6,2644,4.418.214.286
14/06/2016 13:00,29.87,41692,1404,6,84,1232,7,2733,4.418.214.286
14/06/2016 14:00,29.42,41436,1381,7,91,1256,8,2743,4.418.214.286
14/06/2016 15:00,29.21,40908,1316,8,88,1294,10,2716,4.418.214.286
14/06/2016 16:00,28.04,40487,1254,9,84,1343,11,2701,4.418.214.286
14/06/2016 17:00,28.02,40251,1158,12,81,1311,10,2572,4.418.214.286
14/06/2016 18:00,28.52,39798,1020,16,91,1293,12,2432,4.418.214.286
14/06/2016 19:00,29.22,39224,901,21,108,1228,10,2268,4.418.214.286
14/06/2016 20:00,29.29,38384,830,28,119,1193,9,2179,4.418.214.286
14/06/2016 21:00,27.81,37696,761,35,121,1200,9,2126,4.418.214.286
14/06/2016 22:00,27.1,37081,698,41,131,1228,11,2109,4.418.214.286
14/06/2016 23:00,26.13,35453,660,56,116,1308,10,2150,4.418.214.286
15/06/2016 00:00,26.55,33544,700,60,111,1317,9,2197,4.418.214.286
15/06/2016 01:00,25.2,32372,621,63,107,1305,8,2104,4.418.214.286
15/06/2016 02:00,24.82,31899,526,66,101,1266,7,1966,4.418.214.286
15/06/2016 03:00,24.55,31497,416,65,100,1147,6,1734,4.418.214.286
15/06/2016 04:00,24.66,31441,345,55,105,1040,6,1551,4.418.214.286
15/06/2016 05:00,26.55,32843,292,42,111,934,5,1384,4.418.214.286
15/06/2016 06:00,29.14,36358,264,31,112,880,6,1293,4.418.214.286
15/06/2016 07:00,30.84,40402,251,30,115,827,7,1230,4.418.214.286
15/06/2016 08:00,31.95,40838,250,35,112,819,8,1224,4.418.214.286
15/06/2016 09:00,31.95,41071,256,45,101,877,11,1290,4.418.214.286
15/06/2016 10:00,31,41528,267,54,90,929,18,1358,4.418.214.286
15/06/2016 11:00,30.91,41755,264,61,85,976,21,1407,4.418.214.286
15/06/2016 12:00,30.86,41785,233,62,70,1075,20,1460,4.418.214.286
15/06/2016 13:00,30.47,41833,216,71,62,1122,19,1490,4.418.214.286
15/06/2016 14:00,30.39,41584,189,81,53,1200,19,1542,4.418.214.286
15/06/2016 15:00,30.04,41148,152,88,48,1241,22,1551,4.418.214.286
15/06/2016 16:00,28.66,40735,132,93,45,1207,23,1500,4.418.214.286
15/06/2016 17:00,28.73,40467,119,87,41,1191,21,1459,4.418.214.286
15/06/2016 18:00,29.06,40009,109,93,33,1181,20,1436,4.418.214.286
15/06/2016 19:00,29.52,39516,103,96,27,1165,15,1406,4.418.214.286
15/06/2016 20:00,29,38686,95,96,24,1150,13,1378,4.418.214.286
15/06/2016 21:00,27.96,37994,81,93,22,1179,9,1384,4.418.214.286
15/06/2016 22:00,27.64,37288,82,86,18,1196,5,1387,4.418.214.286
15/06/2016 23:00,26.66,35599,104,108,28,1228,4,1472,4.418.214.286
16/06/2016 00:00,26.09,33572,88,106,27,1235,3,1459,4.418.214.286
16/06/2016 01:00,25.4,32353,80,103,31,1186,2,1402,4.418.214.286
16/06/2016 02:00,25.15,31697,78,98,34,1096,2,1308,4.418.214.286
16/06/2016 03:00,24.32,31334,88,91,38,938,3,1158,4.418.214.286
16/06/2016 04:00,24.75,31254,100,87,32,801,3,1023,4.418.214.286
16/06/2016 05:00,25.94,32768,104,81,32,666,4,887,4.418.214.286
16/06/2016 06:00,28.5,36025,113,78,34,594,6,825,4.418.214.286
16/06/2016 07:00,30.48,39892,137,77,34,490,8,746,4.418.214.286
16/06/2016 08:00,31.68,40109,151,78,37,483,9,758,4.418.214.286
16/06/2016 09:00,31.35,40495,150,76,44,537,7,814,4.418.214.286
16/06/2016 10:00,31.19,40941,153,72,51,655,8,939,4.418.214.286
16/06/2016 11:00,30.92,41391,140,67,54,757,8,1026,4.418.214.286
16/06/2016 12:00,30.6,41434,137,62,54,857,8,1118,4.418.214.286
16/06/2016 13:00,30.36,41624,149,55,54,931,10,1199,4.418.214.286
16/06/2016 14:00,30.3,41415,150,52,49,1035,9,1295,4.418.214.286
16/06/2016 15:00,30.08,40996,141,45,43,1119,10,1358,4.418.214.286
16/06/2016 16:00,29.59,40586,140,47,38,1181,8,1414,4.418.214.286
16/06/2016 17:00,29.45,40384,129,45,32,1177,9,1392,4.418.214.286
16/06/2016 18:00,29.61,39940,102,43,30,1229,11,1415,4.418.214.286
16/06/2016 19:00,29.5,39443,82,44,29,1236,10,1401,4.418.214.286
16/06/2016 20:00,29.22,38664,66,46,26,1252,7,1397,4.418.214.286
16/06/2016 21:00,28.52,38035,54,50,26,1287,7,1424,4.418.214.286
16/06/2016 22:00,27.91,37294,52,53,24,1290,4,1423,4.418.214.286
16/06/2016 23:00,26.77,35562,56,51,42,1420,7,1576,4.418.214.286
17/06/2016 00:00,25.6,33417,39,52,42,1468,8,1609,4.418.214.286
17/06/2016 01:00,24.89,32097,44,56,43,1432,7,1582,4.418.214.286
17/06/2016 02:00,24.36,31463,48,57,48,1378,5,1536,4.418.214.286
17/06/2016 03:00,24.11,31111,56,59,48,1306,6,1475,4.418.214.286
17/06/2016 04:00,24.14,31064,71,61,50,1178,5,1365,4.418.214.286
17/06/2016 05:00,25.31,32479,80,62,46,1111,4,1303,4.418.214.286
17/06/2016 06:00,27.6,36011,90,64,41,1021,5,1221,4.418.214.286
17/06/2016 07:00,29.91,39732,97,62,45,902,6,1112,4.418.214.286
17/06/2016 08:00,30.56,40461,102,59,51,854,5,1071,4.418.214.286
17/06/2016 09:00,30.67,40863,117,58,62,767,4,1008,4.418.214.286
17/06/2016 10:00,30.82,41244,142,56,75,711,7,991,4.418.214.286
17/06/2016 11:00,30.7,41301,179,50,93,654,10,986,4.418.214.286
17/06/2016 12:00,30.53,40988,230,45,120,643,17,1055,4.418.214.286
17/06/2016 13:00,30.22,40626,327,44,145,588,25,1129,4.418.214.286
17/06/2016 14:00,30.01,39988,451,46,160,606,26,1289,4.418.214.286
17/06/2016 15:00,28.72,39288,587,50,180,657,20,1494,4.418.214.286
17/06/2016 16:00,27.79,38854,748,63,196,755,13,1775,4.418.214.286
17/06/2016 17:00,27.29,38593,869,75,218,834,15,2011,4.418.214.286
17/06/2016 18:00,27.55,38239,947,91,247,991,18,2294,4.418.214.286
17/06/2016 19:00,27.92,37504,1022,106,256,1089,16,2489,4.418.214.286
17/06/2016 20:00,27.35,36469,1055,122,264,1176,28,2645,4.418.214.286
17/06/2016 21:00,26.79,35683,1089,135,284,1247,41,2796,4.418.214.286
17/06/2016 22:00,26.78,35174,1193,137,300,1356,38,3024,4.418.214.286
17/06/2016 23:00,25.6,34046,1369,153,342,1589,34,3487,4.418.214.286
18/06/2016 00:00,25.11,32490,1566,153,348,1743,31,3841,4.418.214.286
18/06/2016 01:00,24.29,31145,1732,156,349,1877,37,4151,4.418.214.286
18/06/2016 02:00,23.27,30359,1801,164,348,2029,32,4374,4.418.214.286
18/06/2016 03:00,22.46,29870,1837,163,348,2131,42,4521,4.418.214.286
18/06/2016 04:00,21.75,29405,1918,162,347,2269,48,4744,4.418.214.286
18/06/2016 05:00,21.68,29512,2061,163,340,2339,54,4957,4.418.214.286
18/06/2016 06:00,22.51,30376,2211,175,339,2409,55,5189,4.418.214.286
18/06/2016 07:00,23.36,32159,2345,185,337,2513,55,5435,4.418.214.286
18/06/2016 08:00,24.79,33479,2397,196,332,2669,54,5648,4.418.214.286
18/06/2016 09:00,25.11,35248,2359,206,328,2747,51,5691,4.418.214.286
18/06/2016 10:00,25.64,36086,2344,212,323,2815,49,5743,4.418.214.286
18/06/2016 11:00,25.58,36281,2339,215,316,2860,48,5778,4.418.214.286
18/06/2016 12:00,25.92,36167,2311,215,302,2904,45,5777,4.418.214.286
18/06/2016 13:00,25.71,35879,2279,212,288,3152,45,5976,4.418.214.286
18/06/2016 14:00,24.72,35561,2251,208,277,3182,46,5964,4.418.214.286
18/06/2016 15:00,24.49,35352,2239,205,262,3146,44,5896,4.418.214.286
18/06/2016 16:00,24.7,35455,2236,203,237,3056,40,5772,4.418.214.286
18/06/2016 17:00,25.13,35872,2180,201,208,3033,37,5659,4.418.214.286
18/06/2016 18:00,25.7,35931,2136,198,184,2975,31,5524,4.418.214.286
18/06/2016 19:00,26.34,35481,2111,191,169,2892,26,5389,4.418.214.286
18/06/2016 20:00,26.54,34695,2063,184,156,2870,24,5297,4.418.214.286
18/06/2016 21:00,26.51,34163,2045,181,143,2864,21,5254,4.418.214.286
18/06/2016 22:00,26.61,33885,2040,177,132,2848,19,5216,4.418.214.286
18/06/2016 23:00,25.16,32966,2114,171,113,2958,37,5393,4.418.214.286
19/06/2016 00:00,24.12,31440,1949,166,110,2978,35,5238,4.418.214.286
19/06/2016 01:00,22.11,30258,2041,159,107,2911,29,5247,4.418.214.286
19/06/2016 02:00,20.36,29568,2218,148,105,2838,24,5333,4.418.214.286
19/06/2016 03:00,19.09,29029,2298,138,98,2710,23,5267,4.418.214.286
19/06/2016 04:00,17.9,28524,2325,129,94,2553,21,5122,4.418.214.286
19/06/2016 05:00,18.57,28513,2385,124,87,2446,21,5063,4.418.214.286
19/06/2016 06:00,18.49,29071,2497,123,75,2360,21,5076,4.418.214.286
19/06/2016 07:00,20.62,30214,2638,127,65,2301,23,5154,4.418.214.286
19/06/2016 08:00,23.2,31822,2680,134,57,2257,22,5150,4.418.214.286
19/06/2016 09:00,24.71,33477,2641,140,59,2212,29,5081,4.418.214.286
19/06/2016 10:00,25.01,34679,2644,142,62,2243,31,5122,4.418.214.286
19/06/2016 11:00,25.22,35312,2657,141,60,2218,28,5104,4.418.214.286
19/06/2016 12:00,24.92,35389,2645,138,51,2228,30,5092,4.418.214.286
19/06/2016 13:00,24.78,35255,2651,130,44,2214,24,5063,4.418.214.286
19/06/2016 14:00,24.56,35016,2679,121,38,2199,23,5060,4.418.214.286
19/06/2016 15:00,24.48,34910,2668,109,35,2181,25,5018,4.418.214.286
19/06/2016 16:00,24.72,35051,2620,98,32,2101,24,4875,4.418.214.286
19/06/2016 17:00,25.12,35470,2474,89,28,1997,22,4610,4.418.214.286
19/06/2016 18:00,25.64,35663,2228,83,25,1833,20,4189,4.418.214.286
19/06/2016 19:00,26.3,35652,1977,82,22,1783,16,3880,4.418.214.286
19/06/2016 20:00,26.84,35270,1701,83,19,1677,11,3491,4.418.214.286
19/06/2016 21:00,27.32,35127,1461,84,21,1616,10,3192,4.418.214.286
19/06/2016 22:00,27.15,34806,1281,87,24,1512,11,2915,4.418.214.286
19/06/2016 23:00,26.76,33616,1119,94,24,1596,9,2842,4.418.214.286
20/06/2016 00:00,25.38,32387,952,97,29,1647,8,2733,4.645.238.095
20/06/2016 01:00,23.82,31275,882,95,33,1638,7,2655,4.645.238.095
20/06/2016 02:00,22.34,30756,868,89,31,1604,7,2599,4.645.238.095
20/06/2016 03:00,22.46,30504,936,84,26,1558,6,2610,4.645.238.095
20/06/2016 04:00,22.35,30750,1026,79,21,1487,7,2620,4.645.238.095
20/06/2016 05:00,25.03,32699,1116,70,20,1406,6,2618,4.645.238.095
20/06/2016 06:00,26.92,36362,1262,64,17,1317,6,2666,4.645.238.095
20/06/2016 07:00,30.02,40175,1500,59,17,1288,5,2869,4.645.238.095
20/06/2016 08:00,30.9,40595,1773,57,15,1221,3,3069,4.645.238.095
20/06/2016 09:00,30.68,41131,2074,57,15,1153,6,3305,4.645.238.095
20/06/2016 10:00,30.08,41626,2354,55,15,1185,5,3614,4.645.238.095
20/06/2016 11:00,29.9,41781,2529,52,18,1307,20,3926,4.645.238.095
20/06/2016 12:00,29.3,41681,2636,48,21,1407,20,4132,4.645.238.095
20/06/2016 13:00,28.54,41717,2718,40,26,1464,3,4251,4.645.238.095
20/06/2016 14:00,28.33,41548,2759,30,31,1515,7,4342,4.645.238.095
20/06/2016 15:00,28.43,41074,2774,20,35,1602,9,4440,4.645.238.095
20/06/2016 16:00,27.94,40686,2779,13,37,1696,9,4534,4.645.238.095
20/06/2016 17:00,28.07,40504,2655,8,41,1765,9,4478,4.645.238.095
20/06/2016 18:00,29.21,40084,2427,6,45,1862,12,4352,4.645.238.095
20/06/2016 19:00,29.85,39524,2172,6,51,1876,15,4120,4.645.238.095
20/06/2016 20:00,29.74,38679,1902,10,57,1936,14,3919,4.645.238.095
20/06/2016 21:00,28.68,38029,1651,17,57,1967,14,3706,4.645.238.095
20/06/2016 22:00,28.02,37325,1479,20,59,2039,13,3610,4.645.238.095
20/06/2016 23:00,26.04,35296,1337,23,36,2304,4,3704,4.645.238.095
21/06/2016 00:00,24.28,33127,1088,26,33,2318,2,3467,4.645.238.095
21/06/2016 01:00,23.37,31802,1025,26,35,2286,2,3374,4.645.238.095
21/06/2016 02:00,22.86,31052,966,26,38,2221,3,3254,4.645.238.095
21/06/2016 03:00,21.74,30744,889,26,34,2087,2,3038,4.645.238.095
21/06/2016 04:00,22.42,30932,815,21,31,1941,2,2810,4.645.238.095
21/06/2016 05:00,24.8,32730,692,16,32,1787,4,2531,4.645.238.095
21/06/2016 06:00,26.97,36112,604,14,24,1663,4,2309,4.645.238.095
21/06/2016 07:00,29.55,39828,576,13,28,1543,4,2164,4.645.238.095
21/06/2016 08:00,30.6,41243,590,15,26,1467,5,2103,4.645.238.095
21/06/2016 09:00,30.56,40588,605,20,29,1314,5,1973,4.645.238.095
21/06/2016 10:00,30.47,41066,635,28,31,1113,7,1814,4.645.238.095
21/06/2016 11:00,30.67,41287,662,35,35,1079,6,1817,4.645.238.095
21/06/2016 12:00,30.33,41176,640,44,40,1068,7,1799,4.645.238.095
21/06/2016 13:00,30.13,41237,618,51,43,1094,5,1811,4.645.238.095
21/06/2016 14:00,30.03,40883,588,55,46,1117,5,1811,4.645.238.095
21/06/2016 15:00,29.75,40341,555,56,41,1152,6,1810,4.645.238.095
21/06/2016 16:00,28.56,39944,513,54,38,1147,3,1755,4.645.238.095
21/06/2016 17:00,28.6,39649,422,51,35,1047,3,1558,4.645.238.095
21/06/2016 18:00,29.04,39111,319,53,34,1002,5,1413,4.645.238.095
21/06/2016 19:00,29.07,38611,240,56,34,990,8,1328,4.645.238.095
21/06/2016 20:00,29.07,37666,179,59,33,1018,8,1297,4.645.238.095
21/06/2016 21:00,28.62,36877,152,63,32,1106,8,1361,4.645.238.095
21/06/2016 22:00,28.25,36041,166,64,32,1154,7,1423,4.645.238.095
21/06/2016 23:00,26.9,34311,166,37,64,1259,4,1530,4.645.238.095
22/06/2016 00:00,25.69,32547,196,38,71,1365,4,1674,4.645.238.095
22/06/2016 01:00,24.77,31299,208,36,77,1367,5,1693,4.645.238.095
22/06/2016 02:00,24.09,30679,216,31,79,1318,5,1649,4.645.238.095
22/06/2016 03:00,23.26,30308,222,25,68,1210,5,1530,4.645.238.095
22/06/2016 04:00,23.46,30242,248,19,63,1072,7,1409,4.645.238.095
22/06/2016 05:00,25.28,31648,278,16,56,844,7,1201,4.645.238.095
22/06/2016 06:00,27.73,34774,283,15,54,714,7,1073,4.645.238.095
22/06/2016 07:00,29.92,38379,271,17,53,633,8,982,4.645.238.095
22/06/2016 08:00,31.02,39171,263,19,53,628,7,970,4.645.238.095
22/06/2016 09:00,30.86,39811,291,22,51,683,12,1059,4.645.238.095
22/06/2016 10:00,31,40297,356,25,50,754,15,1200,4.645.238.095
22/06/2016 11:00,30.65,40510,418,29,45,808,27,1327,4.645.238.095
22/06/2016 12:00,30.07,40430,475,32,39,873,14,1433,4.645.238.095
22/06/2016 13:00,29.94,40463,552,35,34,952,12,1585,4.645.238.095
22/06/2016 14:00,29.55,40219,581,37,29,956,11,1614,4.645.238.095
22/06/2016 15:00,29.47,39800,565,35,27,967,10,1604,4.645.238.095
22/06/2016 16:00,28.65,39368,548,32,21,934,8,1543,4.645.238.095
22/06/2016 17:00,29.11,39123,487,29,17,881,6,1420,4.645.238.095
22/06/2016 18:00,29.34,38581,398,26,15,802,8,1249,4.645.238.095
22/06/2016 19:00,29.44,38023,324,25,13,766,9,1137,4.645.238.095
22/06/2016 20:00,29.05,37158,265,27,15,742,7,1056,4.645.238.095
22/06/2016 21:00,28.75,36456,245,31,15,737,6,1034,4.645.238.095
22/06/2016 22:00,28.24,35660,266,33,19,749,4,1071,4.645.238.095
22/06/2016 23:00,26.7,34120,290,39,13,759,4,1105,4.645.238.095
23/06/2016 00:00,25.28,32385,235,41,15,738,5,1034,4.645.238.095
23/06/2016 01:00,24.96,31038,224,41,17,670,5,957,4.645.238.095
23/06/2016 02:00,24.03,30312,224,38,19,591,5,877,4.645.238.095
23/06/2016 03:00,23.53,29961,242,34,21,515,5,817,4.645.238.095
23/06/2016 04:00,23.49,29898,286,26,26,442,5,785,4.645.238.095
23/06/2016 05:00,25.07,31520,359,20,31,370,3,783,4.645.238.095
23/06/2016 06:00,28.49,35078,421,15,27,318,3,784,4.645.238.095
23/06/2016 07:00,29.97,38754,458,15,20,315,5,813,4.645.238.095
23/06/2016 08:00,30.42,40168,474,16,17,332,4,843,4.645.238.095
23/06/2016 09:00,30.51,39487,486,21,17,374,9,907,4.645.238.095
23/06/2016 10:00,30.52,40003,535,24,19,424,10,1012,4.645.238.095
23/06/2016 11:00,30.08,40191,612,27,22,475,10,1146,4.645.238.095
23/06/2016 12:00,29.94,39946,700,28,23,544,12,1307,4.645.238.095
23/06/2016 13:00,29.35,39852,808,29,23,597,11,1468,4.645.238.095
23/06/2016 14:00,28.85,39412,867,30,21,654,13,1585,4.645.238.095
23/06/2016 15:00,29.12,38832,834,30,19,688,9,1580,4.645.238.095
23/06/2016 16:00,27.9,38289,784,28,20,690,6,1528,4.645.238.095
23/06/2016 17:00,28.55,38152,730,26,17,683,4,1460,4.645.238.095
23/06/2016 18:00,29.67,37742,673,27,16,690,7,1413,4.645.238.095
23/06/2016 19:00,29.83,37098,665,27,15,765,7,1479,4.645.238.095
23/06/2016 20:00,29.39,36169,700,24,16,848,6,1594,4.645.238.095
23/06/2016 21:00,28.65,35304,764,25,19,955,4,1767,4.645.238.095
23/06/2016 22:00,27.54,34503,852,26,27,1019,4,1928,4.645.238.095
23/06/2016 23:00,25.34,32949,890,33,31,1144,2,2100,4.645.238.095
24/06/2016 00:00,24.87,30957,594,33,42,1118,2,1789,4.645.238.095
24/06/2016 01:00,24.54,29552,470,32,56,1090,2,1650,4.645.238.095
24/06/2016 02:00,24,28967,371,27,55,1037,2,1492,4.645.238.095
24/06/2016 03:00,23.27,28485,286,22,58,985,3,1354,4.645.238.095
24/06/2016 04:00,23.67,28095,286,16,60,918,4,1284,4.645.238.095
24/06/2016 05:00,24.67,28715,299,11,61,808,5,1184,4.645.238.095
24/06/2016 06:00,27.06,30785,297,9,37,718,6,1067,4.645.238.095
24/06/2016 07:00,28.96,33552,315,9,31,656,10,1021,4.645.238.095
24/06/2016 08:00,29.71,35533,331,13,40,618,10,1012,4.645.238.095
24/06/2016 09:00,29.4,36227,356,17,51,638,17,1079,4.645.238.095
24/06/2016 10:00,28.88,36838,405,20,53,691,22,1191,4.645.238.095
24/06/2016 11:00,27.94,37041,430,23,58,681,24,1216,4.645.238.095
24/06/2016 12:00,27.84,36742,433,24,64,736,33,1290,4.645.238.095
24/06/2016 13:00,27.19,36282,527,27,71,765,34,1424,4.645.238.095
24/06/2016 14:00,26.53,35557,487,29,75,795,38,1424,4.645.238.095
24/06/2016 15:00,26.37,34953,378,33,72,799,36,1318,4.645.238.095
24/06/2016 16:00,26.65,34665,343,37,63,798,31,1272,4.645.238.095
24/06/2016 17:00,28.33,34742,312,39,59,770,25,1205,4.645.238.095
24/06/2016 18:00,28.72,34617,271,43,55,774,23,1166,4.645.238.095
24/06/2016 19:00,28.55,34141,217,47,52,765,19,1100,4.645.238.095
24/06/2016 20:00,28.03,33285,208,52,53,791,14,1118,4.645.238.095
24/06/2016 21:00,27.87,32584,207,57,68,789,11,1132,4.645.238.095
24/06/2016 22:00,27.85,32129,211,60,74,833,12,1190,4.645.238.095
24/06/2016 23:00,27.21,31280,213,36,80,688,10,1027,4.645.238.095
25/06/2016 00:00,25.32,30145,266,34,90,686,13,1089,4.645.238.095
25/06/2016 01:00,24.99,29062,237,32,95,678,11,1053,4.645.238.095
25/06/2016 02:00,24.67,28223,216,30,95,640,10,991,4.645.238.095
25/06/2016 03:00,24.02,27652,195,28,85,591,9,908,4.645.238.095
25/06/2016 04:00,23.41,27230,186,23,75,492,7,783,4.645.238.095
25/06/2016 05:00,23.13,27286,180,18,45,439,7,689,4.645.238.095
25/06/2016 06:00,24.27,27889,170,14,35,374,5,598,4.645.238.095
25/06/2016 07:00,24.85,29235,167,12,25,322,7,533,4.645.238.095
25/06/2016 08:00,25.79,30689,187,12,25,308,4,536,4.645.238.095
25/06/2016 09:00,27.96,32016,230,12,30,324,8,604,4.645.238.095
25/06/2016 10:00,28.35,33571,271,14,35,321,9,650,4.645.238.095
25/06/2016 11:00,28.13,34011,328,16,35,355,6,740,4.645.238.095
25/06/2016 12:00,25.99,34135,410,17,35,385,9,856,4.645.238.095
25/06/2016 13:00,25.4,34063,527,15,40,403,5,990,4.645.238.095
25/06/2016 14:00,25.25,33589,650,11,50,424,4,1139,4.645.238.095
25/06/2016 15:00,25.18,33266,779,8,50,454,3,1294,4.645.238.095
25/06/2016 16:00,25.1,33270,920,6,55,493,2,1476,4.645.238.095
25/06/2016 17:00,25.24,33781,986,4,50,539,2,1581,4.645.238.095
25/06/2016 18:00,25.63,33746,1027,4,50,568,1,1650,4.645.238.095
25/06/2016 19:00,26.25,33327,1125,4,60,616,1,1806,4.645.238.095
25/06/2016 20:00,25.64,32547,1224,4,65,746,3,2042,4.645.238.095
25/06/2016 21:00,25.36,32297,1287,5,80,873,5,2250,4.645.238.095
25/06/2016 22:00,25.86,31683,1390,6,100,996,6,2498,4.645.238.095
25/06/2016 23:00,25.22,30862,1529,10,125,1348,5,3017,4.645.238.095
26/06/2016 00:00,23.9,29709,1416,13,125,1471,5,3030,4.645.238.095
26/06/2016 01:00,21.84,28711,1515,15,123,1517,5,3175,4.645.238.095
26/06/2016 02:00,21.17,28073,1567,20,133,1507,5,3232,4.645.238.095
26/06/2016 03:00,20.72,27694,1463,23,133,1454,5,3078,4.645.238.095
26/06/2016 04:00,20.08,27372,1466,20,125,1359,6,2976,4.645.238.095
26/06/2016 05:00,19.97,27384,1502,13,123,1246,6,2890,4.645.238.095
26/06/2016 06:00,20.97,27863,1614,10,111,1167,6,2908,4.645.238.095
26/06/2016 07:00,22.99,28805,1869,9,100,1124,7,3109,4.645.238.095
26/06/2016 08:00,23.24,30043,2069,8,88,1147,7,3319,4.645.238.095
26/06/2016 09:00,23.85,31640,2171,9,85,1192,9,3466,4.645.238.095
26/06/2016 10:00,24.65,32855,2322,10,80,1271,14,3697,4.645.238.095
26/06/2016 11:00,24.83,33561,2368,11,77,1383,14,3853,4.645.238.095
26/06/2016 12:00,24.82,33707,2257,11,75,1530,9,3882,4.645.238.095
26/06/2016 13:00,24.7,33711,2126,10,75,1625,15,3851,4.645.238.095
26/06/2016 14:00,24.63,33470,1912,16,70,1772,18,3788,4.645.238.095
26/06/2016 15:00,24.47,33315,1598,16,66,1864,15,3559,4.645.238.095
26/06/2016 16:00,24.58,33381,1369,15,60,1896,11,3351,4.645.238.095
26/06/2016 17:00,25.01,33773,1219,21,55,1856,12,3163,4.645.238.095
26/06/2016 18:00,25.32,33726,1046,20,55,1847,10,2978,4.645.238.095
26/06/2016 19:00,25.36,33599,882,19,66,1847,6,2820,4.645.238.095
26/06/2016 20:00,25.84,33288,755,23,69,1853,4,2704,4.645.238.095
26/06/2016 21:00,25.74,33183,674,28,69,1860,4,2635,4.645.238.095
26/06/2016 22:00,26.26,32772,663,29,69,1858,3,2622,4.645.238.095
26/06/2016 23:00,25.23,31586,723,17,60,1733,8,2541,4.645.238.095
27/06/2016 00:00,23.65,30190,1054,17,65,1741,6,2883,4.914.047.619
27/06/2016 01:00,22.09,29076,1132,15,66,1713,7,2933,4.914.047.619
27/06/2016 02:00,20.26,28562,1164,16,69,1713,6,2968,4.914.047.619
27/06/2016 03:00,20.49,28291,1166,17,70,1665,7,2925,4.914.047.619
27/06/2016 04:00,21.04,28350,1131,17,70,1555,9,2782,4.914.047.619
27/06/2016 05:00,24.09,29938,1147,17,70,1671,12,2917,4.914.047.619
27/06/2016 06:00,27.87,33418,1227,17,70,1583,14,2911,4.914.047.619
27/06/2016 07:00,30.48,37349,1366,18,75,1713,13,3185,4.914.047.619
27/06/2016 08:00,31.61,39392,1513,22,75,1795,11,3416,4.914.047.619
27/06/2016 09:00,31.75,39191,1606,24,85,1921,13,3649,4.914.047.619
27/06/2016 10:00,31.98,39968,1712,28,95,2173,13,4021,4.914.047.619
27/06/2016 11:00,32.1,40319,1855,34,99,2186,12,4186,4.914.047.619
27/06/2016 12:00,31.9,40397,1988,38,100,2214,13,4353,4.914.047.619
27/06/2016 13:00,31.91,40411,2085,41,111,2192,18,4447,4.914.047.619
27/06/2016 14:00,31.79,40259,2039,41,120,2164,18,4382,4.914.047.619
27/06/2016 15:00,31.91,39665,1945,40,111,2164,17,4277,4.914.047.619
27/06/2016 16:00,30.58,39269,1909,38,100,2170,12,4229,4.914.047.619
27/06/2016 17:00,30.09,39181,1760,34,90,2045,8,3937,4.914.047.619
27/06/2016 18:00,30.58,38707,1596,31,80,1874,11,3592,4.914.047.619
27/06/2016 19:00,30.47,38023,1549,31,65,1717,12,3374,4.914.047.619
27/06/2016 20:00,29.38,37185,1481,31,45,1625,8,3190,4.914.047.619
27/06/2016 21:00,29.32,36430,1364,30,40,1590,6,3030,4.914.047.619
27/06/2016 22:00,28.56,35548,1308,28,40,1523,4,2903,4.914.047.619
27/06/2016 23:00,27.95,33859,1226,35,35,1602,4,2902,4.914.047.619
28/06/2016 00:00,24.91,32031,1007,34,36,1543,4,2624,4.914.047.619
28/06/2016 01:00,24.4,30742,982,33,31,1485,3,2534,4.914.047.619
28/06/2016 02:00,24.02,30107,943,31,30,1378,3,2385,4.914.047.619
28/06/2016 03:00,23.45,29711,839,28,28,1204,4,2103,4.914.047.619
28/06/2016 04:00,23.51,29697,744,23,27,1007,3,1804,4.914.047.619
28/06/2016 05:00,25.22,31277,721,17,26,823,6,1593,4.914.047.619
28/06/2016 06:00,29.85,34954,699,13,23,779,10,1524,4.914.047.619
28/06/2016 07:00,30.92,38798,648,13,26,744,11,1442,4.914.047.619
28/06/2016 08:00,33.01,39252,645,13,25,767,7,1457,4.914.047.619
28/06/2016 09:00,33.35,39990,636,14,25,814,16,1505,4.914.047.619
28/06/2016 10:00,34.95,40598,612,18,30,920,24,1604,4.914.047.619
28/06/2016 11:00,34.98,40876,591,19,32,1018,25,1685,4.914.047.619
28/06/2016 12:00,34.59,40882,591,20,32,1109,25,1777,4.914.047.619
28/06/2016 13:00,34.03,40996,594,19,30,1162,23,1828,4.914.047.619
28/06/2016 14:00,32.69,40694,572,17,29,1197,13,1828,4.914.047.619
28/06/2016 15:00,31.31,40212,534,16,28,1194,9,1781,4.914.047.619
28/06/2016 16:00,30.32,39785,488,16,25,1173,6,1708,4.914.047.619
28/06/2016 17:00,30.03,39520,397,13,22,1058,5,1495,4.914.047.619
28/06/2016 18:00,30.48,38989,300,11,22,947,4,1284,4.914.047.619
28/06/2016 19:00,30.56,38380,229,9,22,910,5,1175,4.914.047.619
28/06/2016 20:00,29.93,37526,184,9,20,822,4,1039,4.914.047.619
28/06/2016 21:00,29.78,36748,166,10,17,782,4,979,4.914.047.619
28/06/2016 22:00,28.94,35977,188,12,19,751,2,972,4.914.047.619
28/06/2016 23:00,26.96,34472,260,10,12,646,3,931,4.914.047.619
29/06/2016 00:00,25.64,32527,220,10,11,610,2,853,4.914.047.619
29/06/2016 01:00,24.76,31329,354,10,11,598,2,975,4.914.047.619
29/06/2016 02:00,24.29,30761,549,10,11,557,1,1128,4.914.047.619
29/06/2016 03:00,23.72,30365,792,9,13,492,0,1306,4.914.047.619
29/06/2016 04:00,23.46,30402,1048,7,15,404,0,1474,4.914.047.619
29/06/2016 05:00,24.9,31809,1269,4,15,324,3,1615,4.914.047.619
29/06/2016 06:00,29.39,35020,1438,3,15,284,4,1744,4.914.047.619
29/06/2016 07:00,30.68,38501,1594,3,17,305,5,1924,4.914.047.619
29/06/2016 08:00,31.93,40406,1613,4,17,365,5,2004,4.914.047.619
29/06/2016 09:00,32.25,40484,1514,5,17,459,10,2005,4.914.047.619
29/06/2016 10:00,32.37,41063,1416,6,22,548,11,2003,4.914.047.619
29/06/2016 11:00,31.66,41220,1272,6,26,582,12,1898,4.914.047.619
29/06/2016 12:00,31.07,41088,1140,8,29,619,11,1807,4.914.047.619
29/06/2016 13:00,30.87,40881,1032,9,30,635,9,1715,4.914.047.619
29/06/2016 14:00,30.64,40565,914,9,32,660,10,1625,4.914.047.619
29/06/2016 15:00,30.37,40044,946,11,30,661,10,1658,4.914.047.619
29/06/2016 16:00,30.08,39598,1045,11,28,680,6,1770,4.914.047.619
29/06/2016 17:00,30.02,39332,1051,11,29,716,4,1811,4.914.047.619
29/06/2016 18:00,30.33,39038,1083,12,26,739,4,1864,4.914.047.619
29/06/2016 19:00,30.14,38506,1177,13,24,770,4,1988,4.914.047.619
29/06/2016 20:00,29.72,37694,1124,19,22,798,4,1967,4.914.047.619
29/06/2016 21:00,28.86,37013,967,24,27,878,4,1900,4.914.047.619
29/06/2016 22:00,28.44,36162,880,26,35,944,3,1888,4.914.047.619
29/06/2016 23:00,26.46,34626,883,52,52,939,1,1927,4.914.047.619
30/06/2016 00:00,24.91,32844,1313,51,51,931,3,2349,4.914.047.619
30/06/2016 01:00,23.94,31600,1484,48,49,894,6,2481,4.914.047.619
30/06/2016 02:00,23.34,30980,1714,44,47,865,7,2677,4.914.047.619
30/06/2016 03:00,22.69,30647,1978,40,42,824,8,2892,4.914.047.619
30/06/2016 04:00,22.48,30567,2218,38,33,728,11,3028,4.914.047.619
30/06/2016 05:00,24.17,31851,2346,32,27,643,13,3061,4.914.047.619
30/06/2016 06:00,27.53,35026,2305,28,21,618,18,2990,4.914.047.619
30/06/2016 07:00,28.63,38540,2260,28,20,720,23,3051,4.914.047.619
30/06/2016 08:00,29.76,39356,2140,29,22,903,22,3116,4.914.047.619
30/06/2016 09:00,29.51,39996,1951,36,26,1123,28,3164,4.914.047.619
30/06/2016 10:00,29.68,40587,1860,37,28,1264,27,3216,4.914.047.619
30/06/2016 11:00,29.45,40872,1787,39,30,1472,30,3358,4.914.047.619
30/06/2016 12:00,29.39,40816,1665,45,31,1517,26,3284,4.914.047.619
30/06/2016 13:00,29.26,40702,1510,44,30,1622,22,3228,4.914.047.619
30/06/2016 14:00,28.84,40373,1350,42,30,1609,22,3053,4.914.047.619
30/06/2016 15:00,28.45,39959,1219,38,29,1576,18,2880,4.914.047.619
30/06/2016 16:00,27.76,39452,1011,32,32,1546,12,2633,4.914.047.619
30/06/2016 17:00,27.79,39315,789,26,29,1526,7,2377,4.914.047.619
30/06/2016 18:00,28.4,38794,636,20,25,1388,6,2075,4.914.047.619
30/06/2016 19:00,28.8,38292,519,16,25,1344,6,1910,4.914.047.619
30/06/2016 20:00,28.02,37419,445,13,26,1232,4,1720,4.914.047.619
30/06/2016 21:00,26.97,36771,419,14,31,1222,1,1687,4.914.047.619
30/06/2016 22:00,26.84,36073,473,15,36,1200,1,1725,4.914.047.619
30/06/2016 23:00,25.09,34571,579,9,33,1153,1,1775,4.914.047.619
01/07/2016 00:00,24.7,32647,517,8,32,1098,1,1656,4.914.047.619
01/07/2016 01:00,23.63,31440,597,8,28,1015,2,1650,4.914.047.619
01/07/2016 02:00,23.22,30818,689,7,28,963,2,1689,4.914.047.619
01/07/2016 03:00,22.42,30487,766,8,25,943,1,1743,4.914.047.619
01/07/2016 04:00,21.46,30387,907,8,22,870,1,1808,4.914.047.619
01/07/2016 05:00,23.67,31665,1064,8,21,856,16,1965,4.914.047.619
01/07/2016 06:00,26.84,34582,1185,6,20,902,19,2132,4.914.047.619
01/07/2016 07:00,28,37949,1340,5,22,960,3,2330,4.914.047.619
01/07/2016 08:00,28.37,38971,1559,4,18,1141,20,2742,4.914.047.619
01/07/2016 09:00,27.95,39939,1940,5,20,1257,23,3245,4.914.047.619
01/07/2016 10:00,27.67,40622,2432,7,21,1510,22,3992,4.914.047.619
01/07/2016 11:00,26.95,40693,2806,8,22,1720,22,4578,4.914.047.619
01/07/2016 12:00,26.27,40401,2998,9,24,1921,23,4975,4.914.047.619
01/07/2016 13:00,25.51,40035,3137,11,24,2096,24,5292,4.914.047.619
01/07/2016 14:00,25.16,39390,3083,14,24,2231,29,5381,4.914.047.619
01/07/2016 15:00,25.02,38781,2887,18,21,2312,34,5272,4.914.047.619
01/07/2016 16:00,24.52,38269,2602,21,19,2321,29,4992,4.914.047.619
01/07/2016 17:00,25.05,38031,2253,20,16,2256,32,4577,4.914.047.619
01/07/2016 18:00,26.01,37656,1895,20,13,2082,37,4047,4.914.047.619
01/07/2016 19:00,26.12,36980,1552,27,12,1962,34,3587,4.914.047.619
01/07/2016 20:00,25.38,35928,1302,29,12,1897,12,3252,4.914.047.619
01/07/2016 21:00,25.03,35094,1158,32,13,1753,10,2966,4.914.047.619
01/07/2016 22:00,24.63,34543,1068,34,13,1757,7,2879,4.914.047.619
01/07/2016 23:00,24.19,33466,1025,26,29,1808,2,2890,4.914.047.619
02/07/2016 00:00,23.6,32218,1386,30,33,1875,2,3326,4.914.047.619
02/07/2016 01:00,20.56,30986,1523,34,54,1928,5,3544,4.914.047.619
02/07/2016 02:00,19.08,30182,1567,36,64,1896,6,3569,4.914.047.619
02/07/2016 03:00,17.59,29638,1587,34,69,1906,6,3602,4.914.047.619
02/07/2016 04:00,16.84,29106,1650,28,75,1876,7,3636,4.914.047.619
02/07/2016 05:00,16.64,29198,1688,23,76,1866,6,3659,4.914.047.619
02/07/2016 06:00,18.8,29978,1758,21,69,1950,9,3807,4.914.047.619
02/07/2016 07:00,20.4,31248,1903,23,62,1969,10,3967,4.914.047.619
02/07/2016 08:00,22.57,32265,2015,31,59,1990,18,4113,4.914.047.619
02/07/2016 09:00,23.97,33962,2086,36,63,2035,34,4254,4.914.047.619
02/07/2016 10:00,23.71,35133,2104,41,67,2033,25,4270,4.914.047.619
02/07/2016 11:00,22.97,35384,2093,47,72,2124,19,4355,4.914.047.619
02/07/2016 12:00,22.6,35334,2106,50,76,2278,21,4531,4.914.047.619
02/07/2016 13:00,21.52,35071,2179,50,70,2402,19,4720,4.914.047.619
02/07/2016 14:00,20.51,34616,2210,49,84,2360,15,4718,4.914.047.619
02/07/2016 15:00,20.1,34405,2164,49,81,2345,10,4649,4.914.047.619
02/07/2016 16:00,20.89,34425,2187,46,75,2359,6,4673,4.914.047.619
02/07/2016 17:00,22.48,34736,2169,41,68,2335,3,4616,4.914.047.619
02/07/2016 18:00,23.41,34822,2059,38,62,2130,6,4295,4.914.047.619
02/07/2016 19:00,24.18,34427,2004,40,60,2198,4,4306,4.914.047.619
02/07/2016 20:00,24.16,33683,1959,49,62,2209,5,4284,4.914.047.619
02/07/2016 21:00,23.83,33279,1863,61,64,2249,6,4243,4.914.047.619
02/07/2016 22:00,24.04,33052,1783,62,67,2355,11,4278,4.914.047.619
02/07/2016 23:00,22.48,32306,1779,99,59,2149,10,4096,4.914.047.619
03/07/2016 00:00,21.63,31239,1946,103,73,2228,4,4354,4.914.047.619
03/07/2016 01:00,20.26,30147,2046,79,79,2143,3,4350,4.914.047.619
03/07/2016 02:00,18.52,29431,2071,60,87,2079,5,4302,4.914.047.619
03/07/2016 03:00,16.39,28870,2068,55,80,1987,7,4197,4.914.047.619
03/07/2016 04:00,12.21,28374,2046,60,76,1846,9,4037,4.914.047.619
03/07/2016 05:00,12.12,28375,1993,53,73,1767,10,3896,4.914.047.619
03/07/2016 06:00,14.96,28945,1947,52,61,1783,9,3852,4.914.047.619
03/07/2016 07:00,18.12,30159,1918,49,50,1707,7,3731,4.914.047.619
03/07/2016 08:00,18.03,31483,1907,42,41,1721,5,3716,4.914.047.619
03/07/2016 09:00,21.52,32939,1913,36,38,1819,8,3814,4.914.047.619
03/07/2016 10:00,22.48,34085,1913,30,38,1906,10,3897,4.914.047.619
03/07/2016 11:00,22.98,34674,1883,30,38,1937,7,3895,4.914.047.619
03/07/2016 12:00,22.83,34708,1867,33,39,1943,10,3892,4.914.047.619
03/07/2016 13:00,22.9,34636,1910,39,40,1872,6,3867,4.914.047.619
03/07/2016 14:00,22.91,34424,1931,41,44,1807,7,3830,4.914.047.619
03/07/2016 15:00,22.98,34266,1897,41,45,1724,8,3715,4.914.047.619
03/07/2016 16:00,22.48,34257,1888,41,45,1632,5,3611,4.914.047.619
03/07/2016 17:00,23.34,34634,1863,40,49,1462,5,3419,4.914.047.619
03/07/2016 18:00,23.99,34896,1807,41,51,1300,8,3207,4.914.047.619
03/07/2016 19:00,24.4,34872,1768,42,54,1216,7,3087,4.914.047.619
03/07/2016 20:00,25.08,34629,1704,45,55,1124,6,2934,4.914.047.619
03/07/2016 21:00,25.84,34541,1614,52,57,1139,10,2872,4.914.047.619
03/07/2016 22:00,26.64,34122,1587,52,60,1117,11,2827,4.914.047.619
03/07/2016 23:00,25.26,33008,1610,32,47,1152,3,2844,4.914.047.619
04/07/2016 00:00,24.02,31832,1372,33,51,1131,3,2590,5.033.452.381
04/07/2016 01:00,23.36,30758,1437,36,55,1025,4,2557,5.033.452.381
04/07/2016 02:00,22.63,30146,1431,41,60,989,4,2525,5.033.452.381
04/07/2016 03:00,22.08,29849,1387,46,65,978,4,2480,5.033.452.381
04/07/2016 04:00,22.09,29888,1345,51,71,903,4,2374,5.033.452.381
04/07/2016 05:00,23.72,31306,1298,55,78,801,4,2236,5.033.452.381
04/07/2016 06:00,26.64,34697,1267,57,82,743,5,2154,5.033.452.381
04/07/2016 07:00,27.38,38475,1250,57,87,659,6,2059,5.033.452.381
04/07/2016 08:00,27.5,39132,1251,57,94,675,5,2082,5.033.452.381
04/07/2016 09:00,27.17,39921,1253,58,107,715,9,2142,5.033.452.381
04/07/2016 10:00,27.34,40525,1262,60,121,730,11,2184,5.033.452.381
04/07/2016 11:00,27.31,40538,1268,66,121,777,14,2246,5.033.452.381
04/07/2016 12:00,26.91,40584,1274,74,139,849,19,2355,5.033.452.381
04/07/2016 13:00,26.8,40573,1308,77,163,937,16,2501,5.033.452.381
04/07/2016 14:00,26.75,40387,1345,78,173,990,16,2602,5.033.452.381
04/07/2016 15:00,26.58,39873,1331,74,165,1076,15,2661,5.033.452.381
04/07/2016 16:00,26.73,39464,1297,70,159,1069,11,2606,5.033.452.381
04/07/2016 17:00,26.8,39263,1193,71,154,1027,12,2457,5.033.452.381
04/07/2016 18:00,26.96,38778,1036,71,136,1005,15,2263,5.033.452.381
04/07/2016 19:00,26.89,38430,867,73,135,1005,16,2096,5.033.452.381
04/07/2016 20:00,26.97,37583,707,73,134,1076,11,2001,5.033.452.381
04/07/2016 21:00,26.81,36639,579,72,129,1185,8,1973,5.033.452.381
04/07/2016 22:00,26.67,35874,528,74,125,1327,6,2060,5.033.452.381
04/07/2016 23:00,26.5,34474,539,104,126,1466,8,2243,5.033.452.381
05/07/2016 00:00,24.11,32550,346,106,125,1566,6,2149,5.033.452.381
05/07/2016 01:00,23.36,31398,342,107,125,1648,7,2229,5.033.452.381
05/07/2016 02:00,22.9,30859,322,108,124,1667,8,2229,5.033.452.381
05/07/2016 03:00,22.47,30547,299,108,118,1683,7,2215,5.033.452.381
05/07/2016 04:00,22.31,30570,282,113,105,1586,8,2094,5.033.452.381
05/07/2016 05:00,22.83,31931,262,120,100,1484,10,1976,5.033.452.381
05/07/2016 06:00,25.42,35097,265,129,99,1382,13,1888,5.033.452.381
05/07/2016 07:00,27.28,38656,288,142,104,1297,16,1847,5.033.452.381
05/07/2016 08:00,27.93,39737,312,156,107,1246,19,1840,5.033.452.381
05/07/2016 09:00,27.84,40574,339,170,120,1258,24,1911,5.033.452.381
05/07/2016 10:00,27.18,41121,395,179,128,1346,29,2077,5.033.452.381
05/07/2016 11:00,26.97,41013,443,186,129,1380,29,2167,5.033.452.381
05/07/2016 12:00,26.57,40967,460,189,134,1415,28,2226,5.033.452.381
05/07/2016 13:00,26.04,40979,520,189,136,1439,26,2310,5.033.452.381
05/07/2016 14:00,25.91,40732,553,187,139,1459,28,2366,5.033.452.381
05/07/2016 15:00,25.5,40255,548,182,136,1490,33,2389,5.033.452.381
05/07/2016 16:00,25.21,39726,627,176,121,1514,28,2466,5.033.452.381
05/07/2016 17:00,25.37,39407,740,167,107,1510,25,2549,5.033.452.381
05/07/2016 18:00,25.11,39014,889,161,77,1544,19,2690,5.033.452.381
05/07/2016 19:00,24.34,38575,1103,155,65,1589,13,2925,5.033.452.381
05/07/2016 20:00,23.82,37675,1279,148,53,1679,8,3167,5.033.452.381
05/07/2016 21:00,23.8,36823,1466,144,53,1722,7,3392,5.033.452.381
05/07/2016 22:00,23.57,36096,1689,135,53,1828,4,3709,5.033.452.381
05/07/2016 23:00,21.98,34643,1815,121,53,1912,3,3904,5.033.452.381
06/07/2016 00:00,22.41,33042,2302,117,53,2028,3,4503,5.033.452.381
06/07/2016 01:00,19.64,31918,2629,113,66,2211,4,5023,5.033.452.381
06/07/2016 02:00,17.45,31283,2866,109,77,2360,3,5415,5.033.452.381
06/07/2016 03:00,15.11,30814,2995,103,80,2497,3,5678,5.033.452.381
06/07/2016 04:00,14.67,30699,3094,96,80,2603,2,5875,5.033.452.381
06/07/2016 05:00,18.96,31946,3172,91,85,2687,1,6036,5.033.452.381
06/07/2016 06:00,21.13,34665,3267,88,90,2701,1,6147,5.033.452.381
06/07/2016 07:00,23.14,37904,3378,84,90,2697,3,6252,5.033.452.381
06/07/2016 08:00,24.38,38561,3480,84,90,2732,2,6388,5.033.452.381
06/07/2016 09:00,24.14,39384,3571,85,120,2791,4,6571,5.033.452.381
06/07/2016 10:00,24.4,40066,3643,90,140,2875,4,6752,5.033.452.381
06/07/2016 11:00,24.31,40300,3691,91,150,2849,4,6785,5.033.452.381
06/07/2016 12:00,24.12,40312,3737,88,155,2911,4,6895,5.033.452.381
06/07/2016 13:00,24.18,40357,3802,84,160,2987,4,7037,5.033.452.381
06/07/2016 14:00,24.1,40074,3879,82,165,3069,8,7203,5.033.452.381
06/07/2016 15:00,23.08,39726,3902,83,190,3083,11,7269,5.033.452.381
06/07/2016 16:00,22.87,39333,3924,84,185,3039,15,7247,5.033.452.381
06/07/2016 17:00,22.94,39117,3939,80,155,3059,20,7253,5.033.452.381
06/07/2016 18:00,23.28,38701,3886,76,120,3069,23,7174,5.033.452.381
06/07/2016 19:00,23.76,38144,3779,74,90,3036,26,7005,5.033.452.381
06/07/2016 20:00,23.89,37288,3639,75,70,3062,20,6866,5.033.452.381
06/07/2016 21:00,23.92,36729,3466,77,60,3055,14,6672,5.033.452.381
06/07/2016 22:00,23.56,35989,3260,83,50,3035,11,6439,5.033.452.381
06/07/2016 23:00,22.87,34524,3125,90,36,3006,13,6270,5.033.452.381
07/07/2016 00:00,23.73,32732,2862,96,44,2955,11,5968,5.033.452.381
07/07/2016 01:00,22.71,31506,2705,96,55,2927,10,5793,5.033.452.381
07/07/2016 02:00,22.1,30839,2569,95,60,2959,9,5692,5.033.452.381
07/07/2016 03:00,21.38,30486,2471,93,75,2975,10,5624,5.033.452.381
07/07/2016 04:00,21.83,30384,2414,97,88,2883,13,5495,5.033.452.381
07/07/2016 05:00,22.75,31655,2362,107,100,2787,15,5371,5.033.452.381
07/07/2016 06:00,24.7,34343,2290,115,100,2698,16,5219,5.033.452.381
07/07/2016 07:00,26.14,37658,2264,122,120,2730,18,5254,5.033.452.381
07/07/2016 08:00,27.06,39634,2265,131,130,2691,16,5233,5.033.452.381
07/07/2016 09:00,26.85,39489,2249,139,145,2711,19,5263,5.033.452.381
07/07/2016 10:00,26.32,40285,2179,147,170,2786,23,5305,5.033.452.381
07/07/2016 11:00,25.89,40545,2061,153,200,2821,26,5261,5.033.452.381
07/07/2016 12:00,25.64,40513,1982,159,212,2812,32,5197,5.033.452.381
07/07/2016 13:00,25.8,40515,2003,160,220,2878,34,5295,5.033.452.381
07/07/2016 14:00,25.79,40211,2082,160,220,2908,36,5406,5.033.452.381
07/07/2016 15:00,25.55,39757,2131,161,222,2943,35,5492,5.033.452.381
07/07/2016 16:00,25.35,39260,2152,158,215,2881,28,5434,5.033.452.381
07/07/2016 17:00,25.88,39066,2128,152,205,2794,16,5295,5.033.452.381
07/07/2016 18:00,26.67,38678,2064,143,191,2638,10,5046,5.033.452.381
07/07/2016 19:00,26.75,38105,2010,140,175,2508,8,4841,5.033.452.381
07/07/2016 20:00,26.27,37229,1901,137,165,2441,4,4648,5.033.452.381
07/07/2016 21:00,26.02,36606,1742,135,155,2327,4,4363,5.033.452.381
07/07/2016 22:00,25.51,35827,1599,131,150,2186,4,4070,5.033.452.381
07/07/2016 23:00,25.09,34320,1472,129,159,2108,12,3880,5.033.452.381
08/07/2016 00:00,24.05,32496,1391,129,161,2038,17,3736,5.033.452.381
08/07/2016 01:00,23.68,31320,1257,129,162,1996,17,3561,5.033.452.381
08/07/2016 02:00,23.45,30727,1127,125,161,1910,14,3337,5.033.452.381
08/07/2016 03:00,22.9,30379,980,120,152,1843,17,3112,5.033.452.381
08/07/2016 04:00,22.74,30291,845,111,130,1740,15,2841,5.033.452.381
08/07/2016 05:00,23.4,31498,760,102,124,1594,14,2594,5.033.452.381
08/07/2016 06:00,25.33,34310,697,98,119,1455,20,2389,5.033.452.381
08/07/2016 07:00,28.01,37583,647,100,118,1311,21,2197,5.033.452.381
08/07/2016 08:00,28.77,39499,624,105,117,1315,21,2182,5.033.452.381
08/07/2016 09:00,28.89,39466,590,109,128,1321,24,2172,5.033.452.381
08/07/2016 10:00,28.53,40135,555,112,131,1346,23,2167,5.033.452.381
08/07/2016 11:00,28.44,40184,543,112,149,1296,25,2125,5.033.452.381
08/07/2016 12:00,27.36,39975,534,109,163,1265,25,2096,5.033.452.381
08/07/2016 13:00,26.87,39574,527,104,169,1233,22,2055,5.033.452.381
08/07/2016 14:00,26.63,39037,503,97,165,1221,23,2009,5.033.452.381
08/07/2016 15:00,25.97,38443,469,93,161,1202,23,1948,5.033.452.381
08/07/2016 16:00,25.84,37940,462,81,150,1062,20,1775,5.033.452.381
08/07/2016 17:00,26.03,37824,451,67,152,978,20,1668,5.033.452.381
08/07/2016 18:00,25.85,37420,448,57,125,933,17,1580,5.033.452.381
08/07/2016 19:00,25.71,36692,498,51,103,861,14,1527,5.033.452.381
08/07/2016 20:00,24.89,35553,554,50,88,826,11,1529,5.033.452.381
08/07/2016 21:00,24.22,34742,602,54,80,805,7,1548,5.033.452.381
08/07/2016 22:00,24.61,34332,711,55,73,832,8,1679,5.033.452.381
08/07/2016 23:00,23.56,33200,861,52,44,776,4,1737,5.033.452.381
09/07/2016 00:00,23.77,31829,1382,48,44,812,4,2290,5.033.452.381
09/07/2016 01:00,22.97,30626,1503,41,44,799,3,2390,5.033.452.381
09/07/2016 02:00,22.5,29899,1601,36,44,819,3,2503,5.033.452.381
09/07/2016 03:00,22.01,29396,1609,30,40,793,2,2474,5.033.452.381
09/07/2016 04:00,20.73,28956,1595,23,30,727,1,2376,5.033.452.381
09/07/2016 05:00,21.38,29086,1590,17,22,614,1,2244,5.033.452.381
09/07/2016 06:00,22,29815,1640,13,20,481,1,2155,5.033.452.381
09/07/2016 07:00,23.08,31106,1753,12,15,425,1,2206,5.033.452.381
09/07/2016 08:00,23.54,32564,1861,13,11,418,1,2304,5.033.452.381
09/07/2016 09:00,24.08,34237,1949,16,8,518,1,2492,5.033.452.381
09/07/2016 10:00,24.4,35189,2053,18,8,643,1,2723,5.033.452.381
09/07/2016 11:00,24.24,35399,2132,21,10,781,1,2945,5.033.452.381
09/07/2016 12:00,23.9,35291,2157,25,15,916,5,3118,5.033.452.381
09/07/2016 13:00,23.62,34968,2153,26,20,1076,6,3281,5.033.452.381
09/07/2016 14:00,23.36,34571,2165,22,25,1284,3,3499,5.033.452.381
09/07/2016 15:00,23.19,34375,2128,18,25,1466,4,3641,5.033.452.381
09/07/2016 16:00,23.22,34476,2006,15,35,1599,4,3659,5.033.452.381
09/07/2016 17:00,23.54,34710,1868,12,50,1618,3,3551,5.033.452.381
09/07/2016 18:00,24.51,34727,1673,13,55,1625,6,3372,5.033.452.381
09/07/2016 19:00,25.4,34369,1383,13,65,1609,7,3077,5.033.452.381
09/07/2016 20:00,25.25,33679,1101,15,70,1615,5,2806,5.033.452.381
09/07/2016 21:00,25.25,33354,916,19,70,1648,4,2657,5.033.452.381
09/07/2016 22:00,25.24,33093,856,23,75,1632,6,2592,5.033.452.381
09/07/2016 23:00,24.55,32122,846,37,60,1705,4,2652,5.033.452.381
10/07/2016 00:00,23.64,30823,979,40,65,1708,6,2798,5.033.452.381
10/07/2016 01:00,22.79,29789,1085,38,77,1680,5,2885,5.033.452.381
10/07/2016 02:00,22.07,29209,1207,34,80,1629,7,2957,5.033.452.381
10/07/2016 03:00,21.32,28740,1329,28,90,1505,9,2961,5.033.452.381
10/07/2016 04:00,20.78,28247,1462,21,95,1319,7,2904,5.033.452.381
10/07/2016 05:00,20.58,28249,1490,16,106,1097,8,2717,5.033.452.381
10/07/2016 06:00,21.44,28778,1444,17,110,901,11,2483,5.033.452.381
10/07/2016 07:00,22.15,29834,1470,19,115,758,13,2375,5.033.452.381
10/07/2016 08:00,22.88,30922,1478,22,120,671,16,2307,5.033.452.381
10/07/2016 09:00,23.95,32487,1441,27,130,610,18,2226,5.033.452.381
10/07/2016 10:00,24.25,33723,1442,34,135,586,18,2215,5.033.452.381
10/07/2016 11:00,24.35,34380,1433,40,145,579,23,2220,5.033.452.381
10/07/2016 12:00,24.3,34435,1389,48,140,612,22,2211,5.033.452.381
10/07/2016 13:00,24.24,34393,1377,49,135,631,29,2221,5.033.452.381
10/07/2016 14:00,24.18,34163,1392,49,125,668,28,2262,5.033.452.381
10/07/2016 15:00,23.98,34021,1372,48,111,673,28,2232,5.033.452.381
10/07/2016 16:00,24,34104,1275,40,100,651,22,2088,5.033.452.381
10/07/2016 17:00,24.3,34470,1067,33,90,632,21,1843,5.033.452.381
10/07/2016 18:00,24.66,34722,822,27,80,619,17,1565,5.033.452.381
10/07/2016 19:00,25.37,34697,648,24,80,608,17,1377,5.033.452.381
10/07/2016 20:00,25.55,34448,553,23,75,619,14,1284,5.033.452.381
10/07/2016 21:00,25.51,34335,550,24,75,682,8,1339,5.033.452.381
10/07/2016 22:00,25.67,33978,631,25,77,742,6,1481,5.033.452.381
10/07/2016 23:00,25.21,32727,725,34,65,700,3,1527,5.033.452.381
11/07/2016 00:00,23.97,31351,1012,32,66,809,3,1922,515.375
11/07/2016 01:00,22.68,30243,1061,29,66,817,2,1975,515.375
11/07/2016 02:00,22.05,29657,996,27,66,783,2,1874,515.375
11/07/2016 03:00,21.28,29343,927,23,66,794,2,1812,515.375
11/07/2016 04:00,20.98,29347,923,20,66,737,2,1748,515.375
11/07/2016 05:00,22.96,30585,974,18,66,677,3,1738,515.375
11/07/2016 06:00,25.14,33355,1124,17,69,695,3,1908,515.375
11/07/2016 07:00,26.59,36749,1293,20,70,773,5,2161,515.375
11/07/2016 08:00,27.98,37124,1400,25,70,863,6,2364,515.375
11/07/2016 09:00,26.98,38163,1489,31,77,976,8,2581,515.375
11/07/2016 10:00,27.06,38900,1612,35,88,1081,13,2829,515.375
11/07/2016 11:00,26.74,39232,1810,38,105,1225,17,3195,515.375
11/07/2016 12:00,25.88,39237,2035,40,111,1430,19,3635,515.375
11/07/2016 13:00,25.43,39364,2224,40,123,1588,18,3993,515.375
11/07/2016 14:00,25.24,39193,2381,44,135,1714,15,4289,515.375
11/07/2016 15:00,25.1,38663,2480,49,115,1844,16,4504,515.375
11/07/2016 16:00,25.12,38190,2538,46,95,1897,10,4586,515.375
11/07/2016 17:00,25.24,38093,2544,46,85,1817,5,4497,515.375
11/07/2016 18:00,25.38,37734,2504,46,85,1769,5,4409,515.375
11/07/2016 19:00,25.55,37205,2426,50,80,1689,3,4248,515.375
11/07/2016 20:00,25.25,36376,2401,53,80,1705,3,4242,515.375
11/07/2016 21:00,25.05,35890,2456,60,85,1654,4,4259,515.375
11/07/2016 22:00,24.72,35213,2551,63,88,1665,5,4372,515.375
11/07/2016 23:00,24.05,33718,2610,78,115,1758,18,4579,515.375
12/07/2016 00:00,23.02,31474,2586,76,120,1729,18,4529,515.375
12/07/2016 01:00,22.57,30416,2526,73,123,1735,17,4474,515.375
12/07/2016 02:00,22.28,29841,2417,75,127,1730,15,4364,515.375
12/07/2016 03:00,22.09,29481,2256,74,123,1706,15,4174,515.375
12/07/2016 04:00,22.08,29451,2105,77,115,1688,13,3998,515.375
12/07/2016 05:00,22.81,30543,2030,82,109,1644,10,3875,515.375
12/07/2016 06:00,24.59,32986,1999,87,111,1573,16,3786,515.375
12/07/2016 07:00,26.26,35976,1999,96,114,1518,24,3751,515.375
12/07/2016 08:00,27.11,36788,1983,105,122,1500,29,3739,515.375
12/07/2016 09:00,26.92,37837,1966,114,137,1504,34,3755,515.375
12/07/2016 10:00,26.88,38541,1930,120,147,1475,34,3706,515.375
12/07/2016 11:00,26.98,38823,1904,123,153,1536,34,3750,515.375
12/07/2016 12:00,26.91,38895,1991,125,155,1589,30,3890,515.375
12/07/2016 13:00,26.67,38964,2032,124,154,1627,32,3969,515.375
12/07/2016 14:00,26.4,38681,1942,122,146,1638,33,3881,515.375
12/07/2016 15:00,26.18,38327,1874,118,132,1678,34,3836,515.375
12/07/2016 16:00,26,37939,1796,113,124,1668,29,3730,515.375
12/07/2016 17:00,26.38,37603,1709,109,107,1588,25,3538,515.375
12/07/2016 18:00,26.82,37278,1655,105,91,1507,23,3381,515.375
12/07/2016 19:00,26.9,36752,1648,105,79,1466,17,3315,515.375
12/07/2016 20:00,26.91,35885,1561,107,68,1452,9,3197,515.375
12/07/2016 21:00,26.92,35332,1433,110,65,1429,10,3047,515.375
12/07/2016 22:00,26.62,34738,1334,106,62,1443,11,2956,515.375
12/07/2016 23:00,25.86,33327,1247,102,48,1413,10,2820,515.375
13/07/2016 00:00,24.26,31192,1024,97,47,1383,9,2560,515.375
13/07/2016 01:00,24.02,30115,968,88,43,1349,8,2456,515.375
13/07/2016 02:00,23.36,29615,929,80,41,1273,7,2330,515.375
13/07/2016 03:00,23.08,29279,899,72,37,1177,5,2190,515.375
13/07/2016 04:00,23.09,29190,855,65,29,1086,4,2039,515.375
13/07/2016 05:00,23.91,30312,839,60,25,990,3,1917,515.375
13/07/2016 06:00,26.13,32734,862,58,22,925,2,1869,515.375
13/07/2016 07:00,27.69,35676,887,55,21,891,4,1858,515.375
13/07/2016 08:00,28.58,36416,906,53,19,866,3,1847,515.375
13/07/2016 09:00,28.58,37431,925,51,18,877,3,1874,515.375
13/07/2016 10:00,28.5,38187,960,50,17,954,3,1984,515.375
13/07/2016 11:00,28.48,38489,1008,50,17,991,3,2069,515.375
13/07/2016 12:00,28.1,38466,1076,48,18,1236,2,2380,515.375
13/07/2016 13:00,27.7,38505,1139,44,18,1115,3,2319,515.375
13/07/2016 14:00,27.39,38267,1201,39,18,1153,4,2415,515.375
13/07/2016 15:00,26.96,37887,1299,35,19,1225,3,2581,515.375
13/07/2016 16:00,26.64,37531,1413,30,18,1295,3,2759,515.375
13/07/2016 17:00,26.67,37407,1446,26,18,1276,4,2770,515.375
13/07/2016 18:00,26.54,37064,1441,23,17,1188,4,2673,515.375
13/07/2016 19:00,26.46,36571,1461,20,18,1137,4,2640,515.375
13/07/2016 20:00,26.14,35732,1481,22,19,1137,3,2662,515.375
13/07/2016 21:00,25.74,35206,1496,24,17,1147,4,2688,515.375
13/07/2016 22:00,25.24,34608,1553,26,16,1154,4,2753,515.375
13/07/2016 23:00,24.69,33153,1612,40,19,1189,6,2866,515.375
14/07/2016 00:00,24.38,31156,1454,43,16,1205,5,2723,515.375
14/07/2016 01:00,23.65,30067,1538,46,14,1233,5,2836,515.375
14/07/2016 02:00,22.57,29472,1604,45,13,1135,4,2801,515.375
14/07/2016 03:00,22.16,29199,1608,39,12,1069,3,2731,515.375
14/07/2016 04:00,21.61,29098,1568,31,10,946,2,2557,515.375
14/07/2016 05:00,22.6,30167,1462,24,9,809,1,2305,515.375
14/07/2016 06:00,25.14,32562,1301,18,9,705,1,2034,515.375
14/07/2016 07:00,25.65,35491,1184,15,10,630,1,1840,515.375
14/07/2016 08:00,26.81,36329,1055,15,11,563,1,1645,515.375
14/07/2016 09:00,27.16,37334,985,16,14,502,1,1518,515.375
14/07/2016 10:00,27.55,38174,1000,15,16,449,1,1481,515.375
14/07/2016 11:00,27.63,38486,1009,13,19,395,2,1438,515.375
14/07/2016 12:00,27.56,38488,1001,10,26,378,1,1416,515.375
14/07/2016 13:00,27.39,38524,1037,7,35,387,3,1469,515.375
14/07/2016 14:00,26.87,38272,1126,6,51,433,3,1619,515.375
14/07/2016 15:00,26.62,37791,1263,8,71,444,4,1790,515.375
14/07/2016 16:00,26.3,37353,1391,6,108,441,5,1951,515.375
14/07/2016 17:00,26.33,37239,1491,5,136,463,9,2104,515.375
14/07/2016 18:00,26.11,36864,1569,5,158,474,8,2214,515.375
14/07/2016 19:00,26,36407,1630,6,180,561,10,2387,515.375
14/07/2016 20:00,25.72,35557,1619,10,199,665,17,2510,515.375
14/07/2016 21:00,25.49,34936,1555,18,212,793,27,2605,515.375
14/07/2016 22:00,25.36,34359,1536,25,220,896,36,2713,515.375
14/07/2016 23:00,24.8,32951,1584,39,183,1059,40,2905,515.375
15/07/2016 00:00,23.8,31249,1799,52,162,1134,45,3192,515.375
15/07/2016 01:00,22.38,30132,1846,59,167,1219,47,3338,515.375
15/07/2016 02:00,21.57,29550,1902,68,137,1260,44,3411,515.375
15/07/2016 03:00,21.01,29166,1930,75,119,1284,35,3443,515.375
15/07/2016 04:00,20.95,29031,1929,85,99,1220,30,3363,515.375
15/07/2016 05:00,22.52,30116,1962,95,72,1082,16,3227,515.375
15/07/2016 06:00,24.69,32660,2037,102,63,965,7,3174,515.375
15/07/2016 07:00,25.49,35495,2125,101,68,915,3,3212,515.375
15/07/2016 08:00,26.09,36217,2204,98,88,885,2,3277,515.375
15/07/2016 09:00,26.78,37322,2260,91,117,878,4,3350,515.375
15/07/2016 10:00,27.08,38085,2266,85,154,860,9,3374,515.375
15/07/2016 11:00,26.96,38211,2284,77,186,901,15,3463,515.375
15/07/2016 12:00,26.34,38038,2345,77,228,969,15,3634,515.375
15/07/2016 13:00,25.82,37715,2424,79,250,989,16,3758,515.375
15/07/2016 14:00,25.34,37186,2566,84,263,985,24,3922,515.375
15/07/2016 15:00,25.06,36591,2776,89,268,978,29,4140,515.375
15/07/2016 16:00,25.18,36071,2938,89,255,1009,36,4327,515.375
15/07/2016 17:00,25.33,35938,2952,84,230,1040,42,4348,515.375
15/07/2016 18:00,25.42,35645,2880,87,193,1060,42,4262,515.375
15/07/2016 19:00,25.73,34996,2756,99,160,1129,37,4181,515.375
15/07/2016 20:00,25.43,34011,2523,110,141,1254,31,4059,515.375
15/07/2016 21:00,25.26,33419,2252,120,136,1339,20,3867,515.375
15/07/2016 22:00,25.42,32977,2051,125,134,1441,14,3765,515.375
15/07/2016 23:00,25.36,31921,1908,124,115,1520,6,3673,515.375
16/07/2016 00:00,24.98,30679,1693,135,111,1562,5,3506,515.375
16/07/2016 01:00,23.27,29519,1645,135,110,1562,4,3456,515.375
16/07/2016 02:00,22.93,28776,1585,131,105,1606,6,3433,515.375
16/07/2016 03:00,22.12,28326,1525,124,100,1587,5,3341,515.375
16/07/2016 04:00,22.04,27880,1577,116,100,1532,5,3330,515.375
16/07/2016 05:00,22.07,27962,1699,111,95,1412,4,3321,515.375
16/07/2016 06:00,22.82,28607,1855,109,100,1355,4,3423,515.375
16/07/2016 07:00,24.09,29872,2002,106,101,1277,6,3492,515.375
16/07/2016 08:00,25.06,31250,2024,102,101,1292,9,3528,515.375
16/07/2016 09:00,25.18,32927,1944,97,101,1394,9,3545,515.375
16/07/2016 10:00,25.19,33982,1909,94,95,1545,12,3655,515.375
16/07/2016 11:00,25.27,34233,1896,87,95,1725,14,3817,515.375
16/07/2016 12:00,25.12,34209,1857,82,105,1888,17,3949,515.375
16/07/2016 13:00,24.82,33941,1810,80,115,2063,18,4086,515.375
16/07/2016 14:00,24.54,33563,1748,76,125,2136,18,4103,515.375
16/07/2016 15:00,24.47,33317,1764,72,120,2093,18,4067,515.375
16/07/2016 16:00,24.63,33353,1833,69,110,2073,21,4106,515.375
16/07/2016 17:00,25.15,33619,1868,66,100,2070,22,4126,515.375
16/07/2016 18:00,25.83,33658,1876,66,95,2005,21,4063,515.375
16/07/2016 19:00,25.93,33276,1890,69,85,2006,22,4072,515.375
16/07/2016 20:00,25.72,32590,1823,75,75,2044,21,4038,515.375
16/07/2016 21:00,25.7,32334,1625,84,70,2096,18,3893,515.375
16/07/2016 22:00,26.08,32118,1436,84,70,2078,17,3685,515.375
16/07/2016 23:00,25.11,31225,1313,92,60,2099,15,3579,515.375
17/07/2016 00:00,24.05,29936,1568,92,65,2055,15,3795,515.375
17/07/2016 01:00,22.03,28946,1566,93,70,2014,17,3760,515.375
17/07/2016 02:00,21.43,28346,1501,95,77,1955,18,3646,515.375
17/07/2016 03:00,20.17,27821,1424,99,85,1856,17,3481,515.375
17/07/2016 04:00,19.57,27359,1353,103,85,1686,14,3241,515.375
17/07/2016 05:00,19.4,27261,1272,104,90,1534,12,3012,515.375
17/07/2016 06:00,19.65,27788,1175,105,90,1440,11,2821,515.375
17/07/2016 07:00,21.46,28858,1109,106,85,1406,9,2715,515.375
17/07/2016 08:00,22.8,30255,1133,100,80,1383,11,2707,515.375
17/07/2016 09:00,24.09,31578,1219,91,80,1393,12,2795,515.375
17/07/2016 10:00,25.03,32706,1265,86,80,1423,11,2865,515.375
17/07/2016 11:00,25.14,33347,1269,81,75,1459,12,2896,515.375
17/07/2016 12:00,25.13,33409,1297,76,75,1521,14,2983,515.375
17/07/2016 13:00,24.72,33332,1329,72,70,1601,14,3086,515.375
17/07/2016 14:00,24.83,33187,1329,68,70,1673,14,3154,515.375
17/07/2016 15:00,24.36,33055,1331,62,70,1736,11,3210,515.375
17/07/2016 16:00,24.43,33156,1372,56,70,1703,11,3212,515.375
17/07/2016 17:00,25.01,33498,1366,48,65,1594,9,3082,515.375
17/07/2016 18:00,25.36,33708,1314,42,60,1542,9,2967,515.375
17/07/2016 19:00,25.65,33731,1260,35,45,1500,6,2846,515.375
17/07/2016 20:00,25.66,33452,1149,32,45,1513,5,2744,515.375
17/07/2016 21:00,26.05,33268,1029,29,50,1480,4,2592,515.375
17/07/2016 22:00,26.27,32852,957,28,50,1538,3,2576,515.375
17/07/2016 23:00,25.57,31582,955,55,30,1517,3,2560,515.375
18/07/2016 00:00,24.82,30338,727,54,25,1575,2,2383,521.702.381
18/07/2016 01:00,23.63,29257,777,53,25,1552,1,2408,521.702.381
18/07/2016 02:00,23.02,28726,808,53,30,1497,1,2389,521.702.381
18/07/2016 03:00,22.72,28398,810,52,35,1398,2,2297,521.702.381
18/07/2016 04:00,22.94,28365,806,51,35,1243,2,2137,521.702.381
18/07/2016 05:00,23.79,29458,838,50,35,1140,2,2065,521.702.381
18/07/2016 06:00,26.21,32044,901,49,35,1025,2,2012,521.702.381
18/07/2016 07:00,27.69,35098,952,49,35,957,2,1995,521.702.381
18/07/2016 08:00,28.87,36077,983,50,44,894,2,1973,521.702.381
18/07/2016 09:00,28.67,37206,997,50,50,944,3,2044,521.702.381
18/07/2016 10:00,27.93,37988,1033,50,60,985,3,2131,521.702.381
18/07/2016 11:00,27.78,38322,1076,50,75,1066,4,2271,521.702.381
18/07/2016 12:00,27.43,38415,1093,49,80,1196,4,2422,521.702.381
18/07/2016 13:00,27.34,38233,1133,49,90,1265,5,2542,521.702.381
18/07/2016 14:00,27.19,38038,1173,48,95,1253,4,2573,521.702.381
18/07/2016 15:00,26.97,37597,1202,47,100,1294,4,2647,521.702.381
18/07/2016 16:00,26.46,37276,1207,45,100,1254,4,2610,521.702.381
18/07/2016 17:00,27.02,37098,1150,43,95,1187,4,2479,521.702.381
18/07/2016 18:00,28.02,36804,1077,41,45,1113,4,2280,521.702.381
18/07/2016 19:00,27.99,36250,996,38,40,1068,3,2145,521.702.381
18/07/2016 20:00,28.19,35439,858,38,35,1066,2,1999,521.702.381
18/07/2016 21:00,28.04,34974,705,37,35,1080,2,1859,521.702.381
18/07/2016 22:00,27.35,34328,627,60,33,1103,2,1825,521.702.381
18/07/2016 23:00,25.9,32829,615,31,28,1036,2,1712,521.702.381
19/07/2016 00:00,25.08,30924,596,31,25,1070,2,1724,521.702.381
19/07/2016 01:00,24.94,29857,580,32,22,1081,2,1717,521.702.381
19/07/2016 02:00,24.67,29371,513,31,21,1006,2,1573,521.702.381
19/07/2016 03:00,24.25,29080,415,29,21,901,2,1368,521.702.381
19/07/2016 04:00,24,29096,336,26,20,743,2,1127,521.702.381
19/07/2016 05:00,24.29,30192,284,23,21,545,2,875,521.702.381
19/07/2016 06:00,27.64,32415,249,23,20,373,3,668,521.702.381
19/07/2016 07:00,29.47,35142,215,25,21,244,5,510,521.702.381
19/07/2016 08:00,30.1,36915,185,32,25,174,7,423,521.702.381
19/07/2016 09:00,30.07,36905,161,42,32,152,11,398,521.702.381
19/07/2016 10:00,29.73,37593,148,50,37,157,16,408,521.702.381
19/07/2016 11:00,29.57,37875,136,58,48,176,20,438,521.702.381
19/07/2016 12:00,28.54,37923,129,65,61,206,25,486,521.702.381
19/07/2016 13:00,28.28,37899,129,68,77,229,23,526,521.702.381
19/07/2016 14:00,28.09,37822,138,68,93,255,24,578,521.702.381
19/07/2016 15:00,28.24,37537,150,68,102,271,21,612,521.702.381
19/07/2016 16:00,28.46,37187,167,68,108,300,20,663,521.702.381
19/07/2016 17:00,29.56,36946,163,66,112,315,19,675,521.702.381
19/07/2016 18:00,30.02,36635,135,65,110,320,16,646,521.702.381
19/07/2016 19:00,29.92,36079,107,66,104,320,12,609,521.702.381
19/07/2016 20:00,29.65,35219,83,67,106,384,7,647,521.702.381
19/07/2016 21:00,29.66,34745,64,72,102,429,6,673,521.702.381
19/07/2016 22:00,28.3,34137,51,71,99,482,6,709,521.702.381
19/07/2016 23:00,25.68,32697,40,66,84,403,3,596,521.702.381
20/07/2016 00:00,24.98,31009,52,62,81,381,4,580,521.702.381
20/07/2016 01:00,24.65,29998,43,58,77,392,3,573,521.702.381
20/07/2016 02:00,24.17,29478,38,55,73,306,4,476,521.702.381
20/07/2016 03:00,23.95,29128,41,51,66,286,4,448,521.702.381
20/07/2016 04:00,23.92,29017,59,47,46,248,4,404,521.702.381
20/07/2016 05:00,24.47,29933,80,40,41,187,3,351,521.702.381
20/07/2016 06:00,26.33,32132,101,38,39,116,3,297,521.702.381
20/07/2016 07:00,28.35,34879,108,38,42,74,3,265,521.702.381
20/07/2016 08:00,29.7,35549,101,43,47,63,4,258,521.702.381
20/07/2016 09:00,29.46,36555,112,51,60,75,6,304,521.702.381
20/07/2016 10:00,29.01,37274,138,57,70,90,8,363,521.702.381
20/07/2016 11:00,28.65,37578,171,59,78,127,9,444,521.702.381
20/07/2016 12:00,27.85,37572,218,62,90,157,14,541,521.702.381
20/07/2016 13:00,27.94,37555,286,63,106,152,16,623,521.702.381
20/07/2016 14:00,27.73,37333,368,62,120,169,18,737,521.702.381
20/07/2016 15:00,27.34,36854,479,58,128,177,19,861,521.702.381
20/07/2016 16:00,27.03,36431,618,56,127,178,21,1000,521.702.381
20/07/2016 17:00,27.85,36194,755,56,137,178,20,1146,521.702.381
20/07/2016 18:00,28.69,35815,889,61,134,207,18,1309,521.702.381
20/07/2016 19:00,28.85,35376,1014,66,130,230,17,1457,521.702.381
20/07/2016 20:00,28.44,34631,1118,74,127,298,13,1630,521.702.381
20/07/2016 21:00,27.07,34130,1233,82,124,434,9,1882,521.702.381
20/07/2016 22:00,25.94,33557,1367,83,121,566,8,2145,521.702.381
20/07/2016 23:00,25.61,32193,1485,95,122,552,11,2265,521.702.381
21/07/2016 00:00,24.58,30500,1429,92,125,567,9,2222,521.702.381
21/07/2016 01:00,24.34,29447,1467,91,128,522,8,2216,521.702.381
21/07/2016 02:00,24.08,28852,1458,91,128,505,12,2194,521.702.381
21/07/2016 03:00,24.09,28559,1352,91,132,491,14,2080,521.702.381
21/07/2016 04:00,24.2,28502,1253,89,135,459,15,1951,521.702.381
21/07/2016 05:00,24.53,29452,1180,88,136,367,18,1789,521.702.381
21/07/2016 06:00,27.1,31622,1076,85,127,292,19,1599,521.702.381
21/07/2016 07:00,27.88,34345,1001,80,125,246,19,1471,521.702.381
21/07/2016 08:00,28.74,35086,974,80,124,241,21,1440,521.702.381
21/07/2016 09:00,29.3,36169,945,77,135,288,23,1468,521.702.381
21/07/2016 10:00,29.49,36983,936,75,144,347,27,1529,521.702.381
21/07/2016 11:00,29.6,37307,936,72,147,373,27,1555,521.702.381
21/07/2016 12:00,29.45,37358,953,71,149,397,25,1595,521.702.381
21/07/2016 13:00,29.26,37376,934,72,152,386,23,1567,521.702.381
21/07/2016 14:00,28.92,37144,822,71,150,403,26,1472,521.702.381
21/07/2016 15:00,28.76,36640,676,69,139,415,23,1322,521.702.381
21/07/2016 16:00,28.69,36143,560,69,131,402,24,1186,521.702.381
21/07/2016 17:00,29.21,35991,454,67,120,394,20,1055,521.702.381
21/07/2016 18:00,28.94,35684,356,67,111,413,19,966,521.702.381
21/07/2016 19:00,28.59,35207,307,66,104,406,16,899,521.702.381
21/07/2016 20:00,28.54,34433,304,63,96,436,13,912,521.702.381
21/07/2016 21:00,28.88,33970,353,63,94,509,10,1029,521.702.381
21/07/2016 22:00,28.01,33415,404,58,89,533,9,1093,521.702.381
21/07/2016 23:00,27.17,31976,417,65,70,615,8,1175,521.702.381
22/07/2016 00:00,25.52,30335,423,61,66,608,7,1165,521.702.381
22/07/2016 01:00,25.15,29304,399,59,65,600,8,1131,521.702.381
22/07/2016 02:00,25.12,28802,340,56,60,580,8,1044,521.702.381
22/07/2016 03:00,25.02,28492,294,52,55,541,8,950,521.702.381
22/07/2016 04:00,25,28401,274,48,45,486,7,860,521.702.381
22/07/2016 05:00,25.2,29339,273,46,35,414,7,775,521.702.381
22/07/2016 06:00,27.51,31490,259,42,25,327,8,661,521.702.381
22/07/2016 07:00,28.15,34163,244,39,25,242,8,558,521.702.381
22/07/2016 08:00,29.01,35074,226,38,25,230,9,528,521.702.381
22/07/2016 09:00,29.18,36178,213,36,25,223,10,507,521.702.381
22/07/2016 10:00,29.18,36856,218,35,25,232,9,519,521.702.381
22/07/2016 11:00,28.83,37019,231,34,25,253,9,552,521.702.381
22/07/2016 12:00,28.01,36907,245,33,25,282,10,595,521.702.381
22/07/2016 13:00,27.4,36702,267,31,30,313,11,652,521.702.381
22/07/2016 14:00,27.23,36267,277,30,30,324,12,673,521.702.381
22/07/2016 15:00,27.4,35736,287,30,33,337,13,700,521.702.381
22/07/2016 16:00,27.44,35337,295,28,35,334,13,705,521.702.381
22/07/2016 17:00,27.8,35205,283,27,35,319,11,675,521.702.381
22/07/2016 18:00,28,34992,268,25,35,308,9,645,521.702.381
22/07/2016 19:00,27.82,34458,255,24,35,294,6,614,521.702.381
22/07/2016 20:00,27.54,33551,243,24,30,308,6,611,521.702.381
22/07/2016 21:00,27.14,33017,232,24,30,340,4,630,521.702.381
22/07/2016 22:00,27.04,32628,247,22,25,375,4,673,521.702.381
22/07/2016 23:00,25.96,31480,254,18,36,338,3,649,521.702.381
23/07/2016 00:00,26.3,30117,180,16,34,352,3,585,521.702.381
23/07/2016 01:00,25.98,29041,150,16,33,329,3,531,521.702.381
23/07/2016 02:00,25.61,28310,140,15,35,311,3,504,521.702.381
23/07/2016 03:00,25.18,27846,140,14,33,282,3,472,521.702.381
23/07/2016 04:00,24.87,27486,148,11,32,241,3,435,521.702.381
23/07/2016 05:00,24.61,27451,149,8,25,175,2,359,521.702.381
23/07/2016 06:00,25.04,27965,127,6,21,129,2,285,521.702.381
23/07/2016 07:00,25.71,29094,104,6,20,102,2,234,521.702.381
23/07/2016 08:00,26.21,30204,77,6,21,91,2,197,521.702.381
23/07/2016 09:00,27.06,31786,61,7,21,83,4,176,521.702.381
23/07/2016 10:00,27.04,32803,70,9,22,94,3,198,521.702.381
23/07/2016 11:00,26.83,33178,91,10,23,116,4,244,521.702.381
23/07/2016 12:00,26.06,33259,104,11,25,138,3,281,521.702.381
23/07/2016 13:00,25.73,33207,117,15,28,152,4,316,521.702.381
23/07/2016 14:00,25.38,32897,117,15,32,171,5,340,521.702.381
23/07/2016 15:00,25.49,32739,105,17,35,196,5,358,521.702.381
23/07/2016 16:00,25.79,32775,101,16,36,201,5,359,521.702.381
23/07/2016 17:00,26.33,32984,100,15,35,219,5,374,521.702.381
23/07/2016 18:00,26.94,33103,104,14,34,227,5,384,521.702.381
23/07/2016 19:00,27.59,32732,113,14,33,244,4,408,521.702.381
23/07/2016 20:00,27.31,32113,115,12,33,272,2,434,521.702.381
23/07/2016 21:00,26.99,31831,117,13,35,304,3,472,521.702.381
23/07/2016 22:00,26.95,31569,131,11,34,374,3,553,521.702.381
23/07/2016 23:00,26.03,30734,133,8,19,335,1,496,521.702.381
24/07/2016 00:00,26.2,29587,152,6,20,306,1,485,521.702.381
24/07/2016 01:00,25.8,28665,156,6,19,290,1,472,521.702.381
24/07/2016 02:00,25.03,27974,152,6,17,234,1,410,521.702.381
24/07/2016 03:00,24.6,27454,148,5,15,198,1,367,521.702.381
24/07/2016 04:00,23.96,27005,151,3,14,152,1,321,521.702.381
24/07/2016 05:00,23.65,26865,155,2,12,113,1,283,521.702.381
24/07/2016 06:00,23.9,27255,140,1,10,79,1,231,521.702.381
24/07/2016 07:00,24.97,28228,108,1,9,62,1,181,521.702.381
24/07/2016 08:00,25.69,28928,77,1,9,64,1,152,521.702.381
24/07/2016 09:00,25.63,30597,69,2,9,78,1,159,521.702.381
24/07/2016 10:00,25.67,32016,72,3,9,103,1,188,521.702.381
24/07/2016 11:00,25.74,32784,87,4,9,128,1,229,521.702.381
24/07/2016 12:00,25.63,33050,107,5,10,173,1,296,521.702.381
24/07/2016 13:00,25.22,33176,127,7,11,222,1,368,521.702.381
24/07/2016 14:00,24.91,32940,139,8,13,254,1,415,521.702.381
24/07/2016 15:00,24.75,32791,149,8,15,273,1,446,521.702.381
24/07/2016 16:00,25,32808,167,8,16,295,2,488,521.702.381
24/07/2016 17:00,25.67,33103,175,8,17,301,2,503,521.702.381
24/07/2016 18:00,26.17,33359,175,7,19,323,1,525,521.702.381
24/07/2016 19:00,26.98,33361,167,7,21,291,1,487,521.702.381
24/07/2016 20:00,27.25,33111,156,7,23,277,1,464,521.702.381
24/07/2016 21:00,27.52,32986,156,7,27,256,1,447,521.702.381
24/07/2016 22:00,27.73,32599,184,7,30,251,1,473,521.702.381
24/07/2016 23:00,26.82,31475,234,4,21,278,1,538,521.702.381
25/07/2016 00:00,25.78,30394,306,3,21,293,1,624,5.330.178.571
25/07/2016 01:00,25.28,29377,360,3,23,280,1,667,5.330.178.571
25/07/2016 02:00,24.94,28723,382,3,25,263,1,674,5.330.178.571
25/07/2016 03:00,24.92,28361,353,2,25,247,1,628,5.330.178.571
25/07/2016 04:00,24.95,28244,317,2,23,227,1,570,5.330.178.571
25/07/2016 05:00,25.14,29109,300,1,19,179,1,500,5.330.178.571
25/07/2016 06:00,27.94,31548,285,1,15,141,1,443,5.330.178.571
25/07/2016 07:00,28.81,34543,266,1,12,134,1,414,5.330.178.571
25/07/2016 08:00,29.27,36529,262,1,11,128,1,403,5.330.178.571
25/07/2016 09:00,29.84,37114,290,1,10,147,3,451,5.330.178.571
25/07/2016 10:00,29.96,38060,339,1,10,198,1,549,5.330.178.571
25/07/2016 11:00,29.97,38394,374,2,10,265,2,653,5.330.178.571
25/07/2016 12:00,29.37,38500,400,3,11,343,4,761,5.330.178.571
25/07/2016 13:00,29.11,38543,437,4,11,423,4,879,5.330.178.571
25/07/2016 14:00,28.46,38312,456,4,11,477,4,952,5.330.178.571
25/07/2016 15:00,28.64,37853,448,4,12,513,4,981,5.330.178.571
25/07/2016 16:00,28.27,37400,442,4,13,517,4,980,5.330.178.571
25/07/2016 17:00,28.72,37212,404,4,14,509,6,937,5.330.178.571
25/07/2016 18:00,28.81,36872,334,4,14,469,5,826,5.330.178.571
25/07/2016 19:00,28.61,36324,302,4,16,450,3,775,5.330.178.571
25/07/2016 20:00,28.24,35446,290,6,18,497,2,813,5.330.178.571
25/07/2016 21:00,28.06,34953,250,8,20,579,3,860,5.330.178.571
25/07/2016 22:00,27.96,34182,220,6,21,686,3,936,5.330.178.571
25/07/2016 23:00,26.3,32590,225,6,9,775,2,1017,5.330.178.571
26/07/2016 00:00,25.13,30682,377,5,9,821,1,1213,5.330.178.571
26/07/2016 01:00,25.04,29479,397,5,8,815,2,1227,5.330.178.571
26/07/2016 02:00,24.65,28699,402,4,7,762,2,1177,5.330.178.571
26/07/2016 03:00,24.11,28320,408,3,8,701,2,1122,5.330.178.571
26/07/2016 04:00,24.1,28111,439,2,7,627,1,1076,5.330.178.571
26/07/2016 05:00,24.68,28955,474,2,7,564,1,1048,5.330.178.571
26/07/2016 06:00,26.09,31369,519,1,7,516,1,1044,5.330.178.571
26/07/2016 07:00,28.22,34567,570,1,7,494,1,1073,5.330.178.571
26/07/2016 08:00,28.65,34386,629,1,6,469,1,1106,5.330.178.571
26/07/2016 09:00,29.09,35660,703,1,6,610,3,1323,5.330.178.571
26/07/2016 10:00,29.18,36465,801,2,8,701,2,1514,5.330.178.571
26/07/2016 11:00,29.05,36925,859,2,12,865,2,1740,5.330.178.571
26/07/2016 12:00,28.44,37105,855,4,13,1070,4,1946,5.330.178.571
26/07/2016 13:00,28.19,37217,867,7,17,1286,3,2180,5.330.178.571
26/07/2016 14:00,28.02,36925,887,6,18,1355,3,2269,5.330.178.571
26/07/2016 15:00,28.01,36593,864,6,17,1435,2,2324,5.330.178.571
26/07/2016 16:00,27.69,36187,812,7,17,1409,2,2247,5.330.178.571
26/07/2016 17:00,28.21,35976,713,7,17,1358,2,2097,5.330.178.571
26/07/2016 18:00,28.61,35612,567,8,18,1285,2,1880,5.330.178.571
26/07/2016 19:00,28.5,35050,436,9,20,1276,3,1744,5.330.178.571
26/07/2016 20:00,28.22,34314,349,8,22,1210,2,1591,5.330.178.571
26/07/2016 21:00,28.16,33939,301,9,21,1265,2,1598,5.330.178.571
26/07/2016 22:00,27.51,33375,271,10,22,1288,2,1593,5.330.178.571
26/07/2016 23:00,25.78,31914,242,10,29,1313,2,1596,5.330.178.571
27/07/2016 00:00,25.2,30244,205,10,25,1251,2,1493,5.330.178.571
27/07/2016 01:00,25.08,29208,197,9,21,1197,2,1426,5.330.178.571
27/07/2016 02:00,24.9,28656,181,8,17,1158,1,1365,5.330.178.571
27/07/2016 03:00,24.61,28351,173,7,14,1091,1,1286,5.330.178.571
27/07/2016 04:00,24.64,28302,182,5,13,1003,1,1204,5.330.178.571
27/07/2016 05:00,24.93,29180,216,3,10,852,1,1082,5.330.178.571
27/07/2016 06:00,26.55,31324,266,3,8,723,1,1001,5.330.178.571
27/07/2016 07:00,27.82,33987,318,3,7,630,1,959,5.330.178.571
27/07/2016 08:00,28.3,34490,371,4,8,643,1,1027,5.330.178.571
27/07/2016 09:00,28.73,35612,433,5,10,677,3,1128,5.330.178.571
27/07/2016 10:00,29.03,36432,518,7,13,699,1,1238,5.330.178.571
27/07/2016 11:00,28.58,36818,584,9,15,708,1,1317,5.330.178.571
27/07/2016 12:00,28.47,36830,632,12,17,739,2,1402,5.330.178.571
27/07/2016 13:00,28.27,36851,713,12,18,794,3,1540,5.330.178.571
27/07/2016 14:00,27.83,36672,779,13,18,747,2,1559,5.330.178.571
27/07/2016 15:00,27.77,36235,768,12,16,750,1,1547,5.330.178.571
27/07/2016 16:00,27.58,35860,736,10,15,750,1,1512,5.330.178.571
27/07/2016 17:00,27.88,35723,738,8,12,734,1,1493,5.330.178.571
27/07/2016 18:00,28.06,35491,773,7,11,713,1,1505,5.330.178.571
27/07/2016 19:00,27.95,35058,833,7,12,661,1,1514,5.330.178.571
27/07/2016 20:00,27.5,34308,858,7,13,670,1,1549,5.330.178.571
27/07/2016 21:00,27.49,33954,854,9,15,705,1,1584,5.330.178.571
27/07/2016 22:00,26.44,33339,889,10,17,772,1,1689,5.330.178.571
27/07/2016 23:00,25.82,31864,871,6,37,866,1,1781,5.330.178.571
28/07/2016 00:00,24.31,30201,1135,6,43,928,1,2113,5.330.178.571
28/07/2016 01:00,24.09,29131,1149,7,55,989,1,2201,5.330.178.571
28/07/2016 02:00,23.96,28587,1090,6,62,928,1,2087,5.330.178.571
28/07/2016 03:00,23.58,28391,974,6,65,888,1,1934,5.330.178.571
28/07/2016 04:00,23.43,28364,873,5,70,829,6,1783,5.330.178.571
28/07/2016 05:00,24.23,29263,748,5,67,734,5,1559,5.330.178.571
28/07/2016 06:00,25.39,31283,681,3,58,696,4,1442,5.330.178.571
28/07/2016 07:00,26.58,33899,652,4,52,639,5,1352,5.330.178.571
28/07/2016 08:00,27.49,34730,609,5,40,674,5,1333,5.330.178.571
28/07/2016 09:00,27.82,35847,594,7,36,782,7,1426,5.330.178.571
28/07/2016 10:00,27.97,36606,593,9,32,845,5,1484,5.330.178.571
28/07/2016 11:00,27.89,36995,578,11,32,924,5,1550,5.330.178.571
28/07/2016 12:00,27.91,37055,548,13,35,1123,5,1724,5.330.178.571
28/07/2016 13:00,27.33,36996,518,15,39,1264,4,1840,5.330.178.571
28/07/2016 14:00,27.15,36704,483,19,36,1292,5,1835,5.330.178.571
28/07/2016 15:00,26.92,36272,434,20,41,1341,3,1839,5.330.178.571
28/07/2016 16:00,26.71,35817,373,20,52,1148,3,1596,5.330.178.571
28/07/2016 17:00,27.54,35672,302,20,55,1075,3,1455,5.330.178.571
28/07/2016 18:00,27.55,35357,229,22,49,994,3,1297,5.330.178.571
28/07/2016 19:00,27.5,34867,172,24,50,932,4,1182,5.330.178.571
28/07/2016 20:00,27.12,34077,130,26,51,892,6,1105,5.330.178.571
28/07/2016 21:00,27.14,33743,106,31,50,903,7,1097,5.330.178.571
28/07/2016 22:00,26.87,33174,101,33,49,871,9,1063,5.330.178.571
28/07/2016 23:00,25.37,31608,98,40,31,783,3,955,5.330.178.571
29/07/2016 00:00,24.93,29964,97,43,27,746,3,916,5.330.178.571
29/07/2016 01:00,24.68,28919,117,44,24,662,3,850,5.330.178.571
29/07/2016 02:00,24.25,28433,122,41,21,607,2,793,5.330.178.571
29/07/2016 03:00,23,28164,131,36,17,511,1,696,5.330.178.571
29/07/2016 04:00,23.08,28144,172,30,16,430,4,652,5.330.178.571
29/07/2016 05:00,24.25,29078,232,24,14,328,1,599,5.330.178.571
29/07/2016 06:00,25.43,31182,302,18,13,241,1,575,5.330.178.571
29/07/2016 07:00,27.3,33873,361,16,13,191,1,582,5.330.178.571
29/07/2016 08:00,28.02,35065,358,15,13,193,2,581,5.330.178.571
29/07/2016 09:00,28.3,36257,355,14,15,219,4,607,5.330.178.571
29/07/2016 10:00,28.49,36951,387,14,16,240,3,660,5.330.178.571
29/07/2016 11:00,28.37,37127,393,14,17,268,4,696,5.330.178.571
29/07/2016 12:00,27.61,37018,425,15,18,303,6,767,5.330.178.571
29/07/2016 13:00,26.77,36762,512,15,15,332,5,879,5.330.178.571
29/07/2016 14:00,26.29,36408,526,13,13,337,5,894,5.330.178.571
29/07/2016 15:00,26.16,35846,443,11,12,342,3,811,5.330.178.571
29/07/2016 16:00,25.85,35444,403,7,9,363,2,784,5.330.178.571
29/07/2016 17:00,26.3,35354,363,5,9,374,2,753,5.330.178.571
29/07/2016 18:00,26.89,35039,323,4,9,377,1,714,5.330.178.571
29/07/2016 19:00,27.27,34346,310,4,10,376,1,701,5.330.178.571
29/07/2016 20:00,26.53,33455,281,4,12,428,1,726,5.330.178.571
29/07/2016 21:00,26.09,33161,272,5,16,476,1,770,5.330.178.571
29/07/2016 22:00,25.52,32673,341,6,19,533,1,900,5.330.178.571
29/07/2016 23:00,25.09,31417,425,4,32,467,2,930,5.330.178.571
30/07/2016 00:00,25.18,30434,242,4,32,418,2,698,5.330.178.571
30/07/2016 01:00,24.54,29355,274,4,30,405,2,715,5.330.178.571
30/07/2016 02:00,24.17,28663,295,4,32,368,2,701,5.330.178.571
30/07/2016 03:00,23.53,28223,329,4,33,357,2,725,5.330.178.571
30/07/2016 04:00,23.01,27910,392,4,31,343,4,774,5.330.178.571
30/07/2016 05:00,23.2,27839,446,4,28,300,6,784,5.330.178.571
30/07/2016 06:00,23.64,28394,472,5,28,272,3,780,5.330.178.571
30/07/2016 07:00,24.14,29527,507,6,32,292,3,840,5.330.178.571
30/07/2016 08:00,24.52,31347,515,8,37,337,6,903,5.330.178.571
30/07/2016 09:00,25.06,32804,521,9,45,386,10,971,5.330.178.571
30/07/2016 10:00,25.08,33798,546,12,54,476,11,1099,5.330.178.571
30/07/2016 11:00,25.03,33912,600,14,62,627,14,1317,5.330.178.571
30/07/2016 12:00,24.95,33763,674,15,67,732,20,1508,5.330.178.571
30/07/2016 13:00,24.62,33470,761,17,70,811,21,1680,5.330.178.571
30/07/2016 14:00,24.3,33151,846,18,71,887,24,1846,5.330.178.571
30/07/2016 15:00,24.31,32935,922,21,67,951,24,1985,5.330.178.571
30/07/2016 16:00,24.48,32958,961,21,65,1016,25,2088,5.330.178.571
30/07/2016 17:00,24.73,33282,927,24,63,1065,21,2100,5.330.178.571
30/07/2016 18:00,25.19,33368,841,28,59,1071,19,2018,5.330.178.571
30/07/2016 19:00,25.49,33007,762,31,57,1082,18,1950,5.330.178.571
30/07/2016 20:00,25.44,32385,694,32,54,1106,19,1905,5.330.178.571
30/07/2016 21:00,25.43,32249,645,37,57,1110,17,1866,5.330.178.571
30/07/2016 22:00,25.41,32023,645,43,61,1178,14,1941,5.330.178.571
30/07/2016 23:00,25.17,30991,662,34,55,1179,6,1936,5.330.178.571
31/07/2016 00:00,25.03,29445,643,35,56,1215,6,1955,5.330.178.571
31/07/2016 01:00,24.28,28414,644,35,61,1235,7,1982,5.330.178.571
31/07/2016 02:00,22.97,27810,663,37,64,1218,9,1991,5.330.178.571
31/07/2016 03:00,22.56,27413,685,35,65,1186,12,1983,5.330.178.571
31/07/2016 04:00,22.14,27056,721,33,65,1126,13,1958,5.330.178.571
31/07/2016 05:00,21.65,26889,729,33,63,1070,8,1903,5.330.178.571
31/07/2016 06:00,20.98,27304,681,34,61,1028,11,1815,5.330.178.571
31/07/2016 07:00,21.99,28229,644,36,62,1002,7,1751,5.330.178.571
31/07/2016 08:00,23.38,29867,612,36,64,1037,8,1757,5.330.178.571
31/07/2016 09:00,24.15,31202,612,43,58,1140,9,1862,5.330.178.571
31/07/2016 10:00,24.49,32214,601,42,57,1233,10,1943,5.330.178.571
31/07/2016 11:00,25.04,32670,543,45,55,1315,13,1971,5.330.178.571
31/07/2016 12:00,25.01,32686,530,51,50,1409,12,2052,5.330.178.571
31/07/2016 13:00,24.54,32592,535,55,49,1494,14,2147,5.330.178.571
31/07/2016 14:00,24.04,32438,532,54,46,1559,9,2200,5.330.178.571
31/07/2016 15:00,23.91,32311,529,49,42,1563,8,2191,5.330.178.571
31/07/2016 16:00,23.82,32405,555,45,36,1508,8,2152,5.330.178.571
31/07/2016 17:00,24.32,32745,536,38,32,1439,7,2052,5.330.178.571
31/07/2016 18:00,24.47,32957,483,30,26,1354,5,1898,5.330.178.571
31/07/2016 19:00,25.06,32986,445,28,24,1241,4,1742,5.330.178.571
31/07/2016 20:00,25.18,32756,427,28,24,1200,2,1681,5.330.178.571
31/07/2016 21:00,25.35,32792,434,31,24,1217,3,1709,5.330.178.571
31/07/2016 22:00,25.61,32446,452,33,31,1176,3,1695,5.330.178.571
31/07/2016 23:00,24.93,31182,506,35,21,1190,3,1755,5.330.178.571
01/08/2016 00:00,24.24,30388,530,35,28,1135,3,1731,5.431.904.762
01/08/2016 01:00,23.1,29429,634,35,36,1130,2,1837,5.431.904.762
01/08/2016 02:00,22.61,28971,721,35,47,1111,2,1916,5.431.904.762
01/08/2016 03:00,21.96,28731,811,32,54,1078,1,1976,5.431.904.762
01/08/2016 04:00,21.76,28774,927,27,58,986,1,1999,5.431.904.762
01/08/2016 05:00,22.96,29773,1050,19,55,853,4,1981,5.431.904.762
01/08/2016 06:00,25.6,32128,1133,14,46,768,3,1964,5.431.904.762
01/08/2016 07:00,27.11,34908,1165,10,42,734,2,1953,5.431.904.762
01/08/2016 08:00,28.04,36681,1245,9,41,783,1,2079,5.431.904.762
01/08/2016 09:00,27.63,36965,1360,10,46,870,3,2289,5.431.904.762
01/08/2016 10:00,26.86,37691,1464,10,50,1001,1,2526,5.431.904.762
01/08/2016 11:00,26.85,37920,1575,8,57,1150,1,2791,5.431.904.762
01/08/2016 12:00,26.61,37915,1709,8,60,1304,2,3083,5.431.904.762
01/08/2016 13:00,26.48,37903,1811,7,67,1453,2,3340,5.431.904.762
01/08/2016 14:00,26.22,37646,1887,7,70,1560,2,3526,5.431.904.762
01/08/2016 15:00,25.96,37165,1944,9,75,1635,3,3666,5.431.904.762
01/08/2016 16:00,25.55,36781,1892,11,78,1642,4,3627,5.431.904.762
01/08/2016 17:00,26.44,36588,1850,10,81,1633,6,3580,5.431.904.762
01/08/2016 18:00,26.97,36299,1789,11,79,1572,7,3458,5.431.904.762
01/08/2016 19:00,26.85,35796,1614,11,74,1504,6,3209,5.431.904.762
01/08/2016 20:00,26.47,35058,1426,13,72,1463,4,2978,5.431.904.762
01/08/2016 21:00,26.55,34737,1282,17,74,1438,4,2815,5.431.904.762
01/08/2016 22:00,26.23,34053,1273,18,70,1504,5,2870,5.431.904.762
01/08/2016 23:00,25.39,32428,1316,33,72,1488,5,2914,5.431.904.762
02/08/2016 00:00,24.48,30438,1109,35,78,1486,6,2714,5.431.904.762
02/08/2016 01:00,23.58,29458,1039,35,84,1465,6,2629,5.431.904.762
02/08/2016 02:00,23.22,28958,978,38,90,1407,5,2518,5.431.904.762
02/08/2016 03:00,23.1,28702,917,41,86,1321,6,2371,5.431.904.762
02/08/2016 04:00,22.94,28632,893,43,82,1235,6,2259,5.431.904.762
02/08/2016 05:00,24,29583,851,41,80,1142,7,2121,5.431.904.762
02/08/2016 06:00,25.5,31845,756,39,76,1042,6,1919,5.431.904.762
02/08/2016 07:00,26.73,34584,689,39,76,1028,11,1843,5.431.904.762
02/08/2016 08:00,27.91,36571,633,48,74,1040,13,1808,5.431.904.762
02/08/2016 09:00,28.09,36795,593,56,74,1084,18,1825,5.431.904.762
02/08/2016 10:00,28.49,37386,573,67,77,1111,20,1848,5.431.904.762
02/08/2016 11:00,28.74,37729,521,76,76,1180,28,1881,5.431.904.762
02/08/2016 12:00,28.34,37719,508,84,75,1243,31,1941,5.431.904.762
02/08/2016 13:00,28.09,37626,530,87,74,1309,32,2032,5.431.904.762
02/08/2016 14:00,28.02,37190,518,85,73,1321,31,2028,5.431.904.762
02/08/2016 15:00,27.77,36829,484,80,64,1295,28,1951,5.431.904.762
02/08/2016 16:00,27.02,36405,471,72,56,1254,27,1880,5.431.904.762
02/08/2016 17:00,27.83,36182,418,58,49,1181,25,1731,5.431.904.762
02/08/2016 18:00,27.91,35869,324,47,42,1094,19,1526,5.431.904.762
02/08/2016 19:00,27.58,35298,241,44,39,1034,12,1370,5.431.904.762
02/08/2016 20:00,26.76,34657,187,44,34,1002,9,1276,5.431.904.762
02/08/2016 21:00,26.42,34225,171,48,36,1019,8,1282,5.431.904.762
02/08/2016 22:00,25.45,33507,174,53,41,1069,7,1344,5.431.904.762
02/08/2016 23:00,24.94,31929,183,50,32,1149,5,1419,5.431.904.762
03/08/2016 00:00,24.02,30750,216,50,30,1151,4,1451,5.431.904.762
03/08/2016 01:00,22.95,29759,286,48,30,1048,4,1416,5.431.904.762
03/08/2016 02:00,22.65,29208,371,46,32,986,3,1438,5.431.904.762
03/08/2016 03:00,22.06,28912,475,41,32,903,3,1454,5.431.904.762
03/08/2016 04:00,22.1,28886,579,34,29,794,2,1438,5.431.904.762
03/08/2016 05:00,23.71,29796,728,25,23,663,3,1442,5.431.904.762
03/08/2016 06:00,25.08,32062,903,20,17,571,2,1513,5.431.904.762
03/08/2016 07:00,26.49,34854,1074,16,16,509,4,1619,5.431.904.762
03/08/2016 08:00,27.53,36675,1252,15,15,510,3,1795,5.431.904.762
03/08/2016 09:00,27.85,37628,1513,15,14,551,4,2097,5.431.904.762
03/08/2016 10:00,27.8,38226,1784,16,15,632,3,2450,5.431.904.762
03/08/2016 11:00,27.52,38428,1945,18,19,738,4,2724,5.431.904.762
03/08/2016 12:00,26.94,38299,2013,20,22,877,6,2938,5.431.904.762
03/08/2016 13:00,26.52,38116,2020,19,26,977,7,3049,5.431.904.762
03/08/2016 14:00,26.51,37781,1921,16,30,1051,8,3026,5.431.904.762
03/08/2016 15:00,26.3,37291,1843,16,29,1119,6,3013,5.431.904.762
03/08/2016 16:00,25.89,36945,1882,13,27,1157,4,3083,5.431.904.762
03/08/2016 17:00,26.18,36833,1904,10,24,1127,3,3068,5.431.904.762
03/08/2016 18:00,26.17,36474,1855,9,23,1179,3,3069,5.431.904.762
03/08/2016 19:00,26.14,35966,1790,9,28,1235,2,3064,5.431.904.762
03/08/2016 20:00,25.47,35199,1675,9,28,1356,2,3070,5.431.904.762
03/08/2016 21:00,25.19,34872,1596,12,39,1428,3,3078,5.431.904.762
03/08/2016 22:00,24.6,34131,1582,18,59,1468,4,3131,5.431.904.762
03/08/2016 23:00,24.15,32452,1509,38,124,1549,8,3228,5.431.904.762
04/08/2016 00:00,22.01,30917,1860,42,136,1498,10,3546,5.431.904.762
04/08/2016 01:00,21.66,30073,1778,50,151,1411,12,3402,5.431.904.762
04/08/2016 02:00,20.35,29575,1723,59,165,1353,16,3316,5.431.904.762
04/08/2016 03:00,19.84,29372,1698,69,169,1297,19,3252,5.431.904.762
04/08/2016 04:00,20.08,29370,1717,77,164,1244,20,3222,5.431.904.762
04/08/2016 05:00,21.86,30307,1783,92,160,1167,21,3223,5.431.904.762
04/08/2016 06:00,24.15,32496,1921,104,151,1113,26,3315,5.431.904.762
04/08/2016 07:00,25.42,35267,2071,116,144,1082,27,3440,5.431.904.762
04/08/2016 08:00,26.54,36659,2171,130,145,1087,31,3564,5.431.904.762
04/08/2016 09:00,26.42,37756,2238,143,141,1091,23,3636,5.431.904.762
04/08/2016 10:00,26.46,38464,2389,148,136,1170,23,3866,5.431.904.762
04/08/2016 11:00,26.41,38853,2516,144,127,1219,18,4024,5.431.904.762
04/08/2016 12:00,26.26,38858,2558,139,128,1300,16,4141,5.431.904.762
04/08/2016 13:00,26.17,38682,2585,128,126,1374,14,4227,5.431.904.762
04/08/2016 14:00,25.93,38285,2595,117,122,1487,13,4334,5.431.904.762
04/08/2016 15:00,25.45,37843,2560,111,103,1456,10,4240,5.431.904.762
04/08/2016 16:00,25.16,37373,2475,101,89,1410,7,4082,5.431.904.762
04/08/2016 17:00,25.75,37183,2409,89,71,1305,9,3883,5.431.904.762
04/08/2016 18:00,26.22,36801,2359,82,61,1175,10,3687,5.431.904.762
04/08/2016 19:00,26.2,36314,2299,76,58,1069,9,3511,5.431.904.762
04/08/2016 20:00,25.68,35573,2174,80,56,1039,9,3358,5.431.904.762
04/08/2016 21:00,25.52,35218,1994,85,55,1001,9,3144,5.431.904.762
04/08/2016 22:00,25.13,34455,1868,83,56,963,8,2978,5.431.904.762
04/08/2016 23:00,24.2,32718,1780,57,60,827,4,2728,5.431.904.762
05/08/2016 00:00,23.72,31068,1339,57,55,855,4,2310,5.431.904.762
05/08/2016 01:00,22.44,29998,1171,59,48,831,4,2113,5.431.904.762
05/08/2016 02:00,21.97,29482,1043,63,47,762,3,1918,5.431.904.762
05/08/2016 03:00,21.74,29199,926,65,44,723,3,1761,5.431.904.762
05/08/2016 04:00,21.76,29225,796,65,38,682,6,1587,5.431.904.762
05/08/2016 05:00,22.71,30197,712,70,34,612,4,1432,5.431.904.762
05/08/2016 06:00,25.45,32397,660,72,28,548,3,1311,5.431.904.762
05/08/2016 07:00,27.07,35222,625,74,25,509,3,1236,5.431.904.762
05/08/2016 08:00,27.88,37091,622,74,23,498,4,1221,5.431.904.762
05/08/2016 09:00,28.02,37573,635,75,20,516,6,1252,5.431.904.762
05/08/2016 10:00,28.08,38311,650,74,20,548,3,1295,5.431.904.762
05/08/2016 11:00,28.04,38502,674,75,22,580,3,1354,5.431.904.762
05/08/2016 12:00,27.68,38296,732,74,26,637,3,1472,5.431.904.762
05/08/2016 13:00,27.2,37839,787,68,31,680,6,1572,5.431.904.762
05/08/2016 14:00,26.52,37401,842,63,33,733,10,1681,5.431.904.762
05/08/2016 15:00,26.26,36802,912,58,35,783,21,1809,5.431.904.762
05/08/2016 16:00,26.06,36360,961,54,38,745,24,1822,5.431.904.762
05/08/2016 17:00,26.48,36232,1023,52,41,677,20,1813,5.431.904.762
05/08/2016 18:00,26.88,35948,1104,49,46,622,11,1832,5.431.904.762
05/08/2016 19:00,26.56,35284,1209,48,49,585,10,1901,5.431.904.762
05/08/2016 20:00,26.13,34434,1282,50,54,588,9,1983,5.431.904.762
05/08/2016 21:00,25.94,34144,1382,52,55,610,7,2106,5.431.904.762
05/08/2016 22:00,25.35,33541,1491,60,60,636,2,2249,5.431.904.762
05/08/2016 23:00,24.34,32129,1591,7,85,694,17,2394,5.431.904.762
06/08/2016 00:00,23.88,30615,1576,15,89,722,19,2421,5.431.904.762
06/08/2016 01:00,22.66,29569,1640,22,94,745,17,2518,5.431.904.762
06/08/2016 02:00,21.82,28943,1718,27,99,790,40,2674,5.431.904.762
06/08/2016 03:00,21.56,28552,1724,40,97,825,30,2716,5.431.904.762
06/08/2016 04:00,21.16,28302,1646,42,97,886,18,2689,5.431.904.762
06/08/2016 05:00,20.97,28200,1561,42,95,878,10,2586,5.431.904.762
06/08/2016 06:00,21.21,28744,1573,42,82,857,6,2560,5.431.904.762
06/08/2016 07:00,21.8,29969,1627,42,71,915,6,2661,5.431.904.762
06/08/2016 08:00,22.62,31552,1720,42,64,996,6,2828,5.431.904.762
06/08/2016 09:00,24.18,32839,1877,38,65,1076,6,3062,5.431.904.762
06/08/2016 10:00,24.47,33918,2051,36,70,1153,6,3316,5.431.904.762
06/08/2016 11:00,24.31,34180,2203,36,79,1235,6,3559,5.431.904.762
06/08/2016 12:00,23.96,34100,2352,38,90,1310,7,3797,5.431.904.762
06/08/2016 13:00,22.7,33917,2528,35,98,1362,6,4029,5.431.904.762
06/08/2016 14:00,21.88,33633,2692,30,105,1477,4,4308,5.431.904.762
06/08/2016 15:00,21.8,33430,2839,25,104,1496,4,4468,5.431.904.762
06/08/2016 16:00,21.8,33394,2992,21,103,1508,4,4628,5.431.904.762
06/08/2016 17:00,22.11,33647,3091,17,102,1528,4,4742,5.431.904.762
06/08/2016 18:00,22.6,33651,3110,17,99,1555,3,4784,5.431.904.762
06/08/2016 19:00,23.33,33236,3088,17,98,1595,2,4800,5.431.904.762
06/08/2016 20:00,23.61,32668,3001,17,93,1650,2,4763,5.431.904.762
06/08/2016 21:00,24,32619,2861,19,90,1731,3,4704,5.431.904.762
06/08/2016 22:00,24.17,32334,2710,19,90,1831,3,4653,5.431.904.762
06/08/2016 23:00,23.26,31159,2598,18,58,1923,5,4602,5.431.904.762
07/08/2016 00:00,21.74,30109,1951,16,65,1877,3,3912,5.431.904.762
07/08/2016 01:00,20.09,29037,1754,14,73,1856,3,3700,5.431.904.762
07/08/2016 02:00,18.55,28445,1654,13,78,1803,3,3551,5.431.904.762
07/08/2016 03:00,15.34,28073,1613,13,80,1775,3,3484,5.431.904.762
07/08/2016 04:00,14.37,27740,1614,11,81,1673,4,3383,5.431.904.762
07/08/2016 05:00,14.37,27508,1564,7,84,1516,5,3176,5.431.904.762
07/08/2016 06:00,14.92,27857,1461,8,83,1343,3,2898,5.431.904.762
07/08/2016 07:00,17.13,28853,1365,9,83,1198,3,2658,5.431.904.762
07/08/2016 08:00,20.15,30155,1343,9,88,1119,4,2563,5.431.904.762
07/08/2016 09:00,21.68,31396,1444,12,104,1108,6,2674,5.431.904.762
07/08/2016 10:00,22.39,32411,1637,15,136,1124,7,2919,5.431.904.762
07/08/2016 11:00,23.65,32983,1804,20,148,1158,9,3139,5.431.904.762
07/08/2016 12:00,23.14,33091,1970,28,188,1202,10,3398,5.431.904.762
07/08/2016 13:00,22.46,33049,2259,32,209,1300,14,3814,5.431.904.762
07/08/2016 14:00,21.94,32948,2529,38,214,1456,12,4249,5.431.904.762
07/08/2016 15:00,21.86,32797,2585,41,221,1700,16,4563,5.431.904.762
07/08/2016 16:00,21.87,32960,2526,43,215,1917,16,4717,5.431.904.762
07/08/2016 17:00,21.97,33381,2452,43,200,2116,12,4823,5.431.904.762
07/08/2016 18:00,22.65,33597,2385,43,179,2353,11,4971,5.431.904.762
07/08/2016 19:00,24.01,33596,2307,44,160,2540,12,5063,5.431.904.762
07/08/2016 20:00,24.29,33471,2208,45,146,2709,10,5118,5.431.904.762
07/08/2016 21:00,24.33,33637,2116,50,133,2887,11,5197,5.431.904.762
07/08/2016 22:00,24.16,33103,2039,54,131,3027,8,5259,5.431.904.762
07/08/2016 23:00,22.34,31639,2000,55,122,2984,11,5172,5.431.904.762
08/08/2016 00:00,21.26,30343,2075,60,124,3008,10,5277,5.579.880.952
08/08/2016 01:00,17.83,29354,2036,61,122,2989,8,5216,5.579.880.952
08/08/2016 02:00,14.84,28896,2117,61,123,2930,8,5239,5.579.880.952
08/08/2016 03:00,12.98,28705,2272,59,140,2882,9,5362,5.579.880.952
08/08/2016 04:00,12.96,28770,2427,59,143,2887,12,5528,5.579.880.952
08/08/2016 05:00,17.84,29865,2629,58,132,2923,11,5753,5.579.880.952
08/08/2016 06:00,21.85,32396,2933,63,127,2966,10,6099,5.579.880.952
08/08/2016 07:00,25.02,35512,3305,76,134,3070,12,6597,5.579.880.952
08/08/2016 08:00,25.86,36934,3521,88,148,3147,16,6920,5.579.880.952
08/08/2016 09:00,25.82,37875,3608,106,158,3304,23,7199,5.579.880.952
08/08/2016 10:00,25.34,38445,3779,119,170,3442,27,7537,5.579.880.952
08/08/2016 11:00,24.93,38787,3960,132,183,3633,33,7941,5.579.880.952
08/08/2016 12:00,24.39,38886,4042,141,185,3881,38,8287,5.579.880.952
08/08/2016 13:00,23.95,38920,4063,145,192,4034,37,8471,5.579.880.952
08/08/2016 14:00,23.58,38819,4051,149,195,4169,35,8599,5.579.880.952
08/08/2016 15:00,23.79,38448,4002,150,189,4278,38,8657,5.579.880.952
08/08/2016 16:00,23.42,38047,3943,145,181,4320,30,8619,5.579.880.952
08/08/2016 17:00,24.8,37909,3897,138,176,4311,30,8552,5.579.880.952
08/08/2016 18:00,25.05,37582,3843,139,168,4402,33,8585,5.579.880.952
08/08/2016 19:00,25.03,36990,3762,144,167,4392,26,8491,5.579.880.952
08/08/2016 20:00,24.51,36264,3657,152,162,4312,24,8307,5.579.880.952
08/08/2016 21:00,24.43,35921,3509,161,151,4184,24,8029,5.579.880.952
08/08/2016 22:00,23.6,34958,3369,166,151,4010,22,7718,5.579.880.952
08/08/2016 23:00,21.39,33105,3312,176,129,3995,33,7645,5.579.880.952
09/08/2016 00:00,19.38,30763,3014,173,130,3926,27,7270,5.579.880.952
09/08/2016 01:00,17.81,29786,2983,171,136,3836,26,7152,5.579.880.952
09/08/2016 02:00,18.07,29345,2950,169,139,3660,27,6945,5.579.880.952
09/08/2016 03:00,17.95,29506,2937,168,140,3576,30,6851,5.579.880.952
09/08/2016 04:00,18.24,29615,2902,168,140,3560,30,6800,5.579.880.952
09/08/2016 05:00,19.62,30687,2883,170,141,3443,36,6673,5.579.880.952
09/08/2016 06:00,23.28,33357,2899,174,141,3372,35,6621,5.579.880.952
09/08/2016 07:00,25.3,36408,2917,179,145,3344,41,6626,5.579.880.952
09/08/2016 08:00,26.11,37779,2955,185,147,3327,46,6660,5.579.880.952
09/08/2016 09:00,26.11,38805,3021,191,151,3317,47,6727,5.579.880.952
09/08/2016 10:00,26.1,39359,3095,196,160,3375,47,6873,5.579.880.952
09/08/2016 11:00,26.04,39670,3135,201,165,3439,50,6990,5.579.880.952
09/08/2016 12:00,26.03,39790,3140,204,171,3460,48,7023,5.579.880.952
09/08/2016 13:00,25.74,39818,3164,204,166,3471,50,7055,5.579.880.952
09/08/2016 14:00,25.22,39490,3191,201,160,3534,50,7136,5.579.880.952
09/08/2016 15:00,24.99,39016,3236,195,153,3513,51,7148,5.579.880.952
09/08/2016 16:00,23.92,38675,3246,186,146,3446,49,7073,5.579.880.952
09/08/2016 17:00,24.2,38616,3136,176,138,3386,45,6881,5.579.880.952
09/08/2016 18:00,24.74,38343,3005,167,128,3354,36,6690,5.579.880.952
09/08/2016 19:00,25.1,37815,2925,162,129,3367,31,6614,5.579.880.952
09/08/2016 20:00,24.54,36930,2867,161,129,3386,31,6574,5.579.880.952
09/08/2016 21:00,24.48,36341,2778,161,128,3468,31,6566,5.579.880.952
09/08/2016 22:00,23.57,35464,2678,161,128,3493,30,6490,5.579.880.952
09/08/2016 23:00,21,33572,2664,151,98,3215,27,6155,5.579.880.952
10/08/2016 00:00,20.24,32017,2930,145,97,3250,22,6444,5.579.880.952
10/08/2016 01:00,19.8,30955,2898,136,97,3221,19,6371,5.579.880.952
10/08/2016 02:00,19.47,30350,2841,127,98,3157,16,6239,5.579.880.952
10/08/2016 03:00,19.49,30369,2768,120,92,3196,11,6187,5.579.880.952
10/08/2016 04:00,19.47,30387,2711,113,86,3092,11,6013,5.579.880.952
10/08/2016 05:00,20.09,31448,2656,112,80,3045,9,5902,5.579.880.952
10/08/2016 06:00,24.53,34127,2551,110,71,2892,10,5634,5.579.880.952
10/08/2016 07:00,26.08,37170,2434,111,65,2741,10,5361,5.579.880.952
10/08/2016 08:00,27.19,39252,2376,112,62,2615,12,5177,5.579.880.952
10/08/2016 09:00,27.44,39975,2346,116,67,2530,11,5070,5.579.880.952
10/08/2016 10:00,27.66,40459,2305,121,73,2446,9,4954,5.579.880.952
10/08/2016 11:00,27.68,40577,2327,121,82,2377,10,4917,5.579.880.952
10/08/2016 12:00,27.39,40297,2453,115,87,2249,14,4918,5.579.880.952
10/08/2016 13:00,27.43,40129,2596,104,91,2168,12,4971,5.579.880.952
10/08/2016 14:00,27.31,39835,2630,90,93,2091,15,4919,5.579.880.952
10/08/2016 15:00,27.2,39383,2542,77,91,1983,17,4710,5.579.880.952
10/08/2016 16:00,26.76,39068,2491,64,87,1879,14,4535,5.579.880.952
10/08/2016 17:00,27,38913,2417,57,85,1739,14,4312,5.579.880.952
10/08/2016 18:00,26.79,38516,2260,53,73,1610,15,4011,5.579.880.952
10/08/2016 19:00,26.66,38055,2116,58,66,1472,12,3724,5.579.880.952
10/08/2016 20:00,26.36,37204,1986,64,58,1417,10,3535,5.579.880.952
10/08/2016 21:00,26.6,36548,1895,71,65,1400,12,3443,5.579.880.952
10/08/2016 22:00,26.64,35551,1875,73,71,1471,12,3502,5.579.880.952
10/08/2016 23:00,25.27,33673,1872,53,46,1474,14,3459,5.579.880.952
11/08/2016 00:00,21.98,32480,2130,57,49,1442,16,3694,5.579.880.952
11/08/2016 01:00,21.07,31311,2129,62,57,1439,17,3704,5.579.880.952
11/08/2016 02:00,21.02,30703,2064,63,66,1454,16,3663,5.579.880.952
11/08/2016 03:00,20.65,30685,1950,66,73,1478,14,3581,5.579.880.952
11/08/2016 04:00,20.52,30857,1830,69,81,1429,13,3422,5.579.880.952
11/08/2016 05:00,22.69,32233,1699,74,86,1331,12,3202,5.579.880.952
11/08/2016 06:00,25.96,34895,1557,81,83,1178,11,2910,5.579.880.952
11/08/2016 07:00,27.54,38005,1417,85,81,1088,17,2688,5.579.880.952
11/08/2016 08:00,28.06,40410,1303,90,81,1033,24,2531,5.579.880.952
11/08/2016 09:00,28.3,40989,1258,95,84,962,25,2424,5.579.880.952
11/08/2016 10:00,28.58,41256,1217,98,90,956,23,2384,5.579.880.952
11/08/2016 11:00,28.65,41224,1150,98,98,953,22,2321,5.579.880.952
11/08/2016 12:00,28.71,40943,1068,100,102,986,17,2273,5.579.880.952
11/08/2016 13:00,28.42,40710,987,98,102,999,13,2199,5.579.880.952
11/08/2016 14:00,28.19,40331,951,91,99,1015,11,2167,5.579.880.952
11/08/2016 15:00,27.97,39864,906,83,95,1044,6,2134,5.579.880.952
11/08/2016 16:00,27.44,39453,826,76,86,1024,6,2018,5.579.880.952
11/08/2016 17:00,27.96,39357,696,68,79,933,6,1782,5.579.880.952
11/08/2016 18:00,27.74,38950,572,64,70,881,4,1591,5.579.880.952
11/08/2016 19:00,27.79,38479,505,58,60,772,4,1399,5.579.880.952
11/08/2016 20:00,27.12,37763,438,55,56,893,4,1446,5.579.880.952
11/08/2016 21:00,26.87,37243,379,54,56,997,5,1491,5.579.880.952
11/08/2016 22:00,27.08,36228,346,53,59,1073,7,1538,5.579.880.952
11/08/2016 23:00,25.6,34231,336,37,102,1300,6,1781,5.579.880.952
12/08/2016 00:00,22,32949,295,31,107,1323,7,1763,5.579.880.952
12/08/2016 01:00,21.22,31879,294,28,111,1287,6,1726,5.579.880.952
12/08/2016 02:00,21,31347,290,27,113,1301,8,1739,5.579.880.952
12/08/2016 03:00,20.3,31281,284,26,109,1203,10,1632,5.579.880.952
12/08/2016 04:00,20.38,31519,293,24,101,1098,9,1525,5.579.880.952
12/08/2016 05:00,22.69,32950,292,19,93,1021,6,1431,5.579.880.952
12/08/2016 06:00,25.67,35678,297,14,84,854,6,1255,5.579.880.952
12/08/2016 07:00,27.23,38854,329,11,72,705,8,1125,5.579.880.952
12/08/2016 08:00,28.04,40756,378,10,67,651,9,1115,5.579.880.952
12/08/2016 09:00,28.23,41493,445,11,68,690,8,1222,5.579.880.952
12/08/2016 10:00,28.28,41780,536,14,70,796,7,1423,5.579.880.952
12/08/2016 11:00,28.46,41709,671,19,73,1001,9,1773,5.579.880.952
12/08/2016 12:00,28.17,41277,832,22,76,1230,10,2170,5.579.880.952
12/08/2016 13:00,27.68,40682,1039,25,77,1397,13,2551,5.579.880.952
12/08/2016 14:00,27.09,40123,1287,25,74,1518,11,2915,5.579.880.952
12/08/2016 15:00,26.46,39509,1528,26,68,1683,10,3315,5.579.880.952
12/08/2016 16:00,25.88,39094,1755,26,63,1794,9,3647,5.579.880.952
12/08/2016 17:00,25.93,38975,1930,27,58,1887,7,3909,5.579.880.952
12/08/2016 18:00,25.72,38651,2135,28,55,1993,5,4216,5.579.880.952
12/08/2016 19:00,25.38,37901,2403,30,52,2093,6,4584,5.579.880.952
12/08/2016 20:00,24.95,36913,2587,36,53,2257,8,4941,5.579.880.952
12/08/2016 21:00,24.5,36361,2653,45,62,2529,9,5298,5.579.880.952
12/08/2016 22:00,23.14,35442,2719,51,76,2608,10,5464,5.579.880.952
12/08/2016 23:00,20.79,33789,2751,92,111,2714,13,5681,5.579.880.952
13/08/2016 00:00,20.43,32156,2710,102,123,2690,17,5642,5.579.880.952
13/08/2016 01:00,19.7,31020,2548,114,130,2673,19,5484,5.579.880.952
13/08/2016 02:00,18.95,30362,2400,126,145,2589,25,5285,5.579.880.952
13/08/2016 03:00,17.58,29960,2264,139,155,2506,27,5091,5.579.880.952
13/08/2016 04:00,16.71,29677,2142,150,155,2434,26,4907,5.579.880.952
13/08/2016 05:00,15.7,29598,2050,157,160,2412,31,4810,5.579.880.952
13/08/2016 06:00,16.59,30179,1955,166,166,2376,40,4703,5.579.880.952
13/08/2016 07:00,19.94,31604,1918,176,177,2359,39,4669,5.579.880.952
13/08/2016 08:00,20.77,33522,2002,188,177,2290,32,4689,5.579.880.952
13/08/2016 09:00,21.61,35145,2190,195,170,2212,22,4789,5.579.880.952
13/08/2016 10:00,21.76,36188,2489,192,160,2177,20,5038,5.579.880.952
13/08/2016 11:00,21.75,36404,2784,181,166,2106,16,5253,5.579.880.952
13/08/2016 12:00,21.52,36228,2935,162,175,2128,14,5414,5.579.880.952
13/08/2016 13:00,21.24,36019,3047,147,175,2103,15,5487,5.579.880.952
13/08/2016 14:00,21.05,35761,3149,138,160,2047,17,5511,5.579.880.952
13/08/2016 15:00,20.89,35605,3261,129,145,2008,14,5557,5.579.880.952
13/08/2016 16:00,21.11,35717,3379,120,135,1980,14,5628,5.579.880.952
13/08/2016 17:00,21.56,36032,3423,113,133,1930,17,5616,5.579.880.952
13/08/2016 18:00,21.85,36063,3341,102,130,1853,13,5439,5.579.880.952
13/08/2016 19:00,22.57,35624,3167,93,130,1881,10,5281,5.579.880.952
13/08/2016 20:00,23.02,35087,2927,88,125,1833,9,4982,5.579.880.952
13/08/2016 21:00,24.14,35031,2676,84,125,2016,7,4908,5.579.880.952
13/08/2016 22:00,24.03,34442,2445,76,123,2058,7,4709,5.579.880.952
13/08/2016 23:00,21.94,33077,2240,63,135,2055,8,4501,5.579.880.952
14/08/2016 00:00,20.52,31670,2576,57,140,2160,7,4940,5.579.880.952
14/08/2016 01:00,20.17,30595,2449,51,144,2111,8,4763,5.579.880.952
14/08/2016 02:00,19.71,30022,2274,49,144,2190,11,4668,5.579.880.952
14/08/2016 03:00,19.23,29651,2024,48,140,2182,13,4407,5.579.880.952
14/08/2016 04:00,18.33,29297,1769,46,130,2173,13,4131,5.579.880.952
14/08/2016 05:00,18.31,29147,1594,44,120,2158,11,3927,5.579.880.952
14/08/2016 06:00,18.43,29494,1521,50,120,1999,8,3698,5.579.880.952
14/08/2016 07:00,20.11,30630,1484,49,133,1916,9,3591,5.579.880.952
14/08/2016 08:00,20.84,31977,1452,50,140,1869,14,3525,5.579.880.952
14/08/2016 09:00,21.71,33470,1456,53,150,1816,13,3488,5.579.880.952
14/08/2016 10:00,22.61,34658,1457,53,169,1807,13,3499,5.579.880.952
14/08/2016 11:00,23.09,35359,1434,54,188,1866,14,3556,5.579.880.952
14/08/2016 12:00,22.6,35368,1406,51,215,1907,15,3594,5.579.880.952
14/08/2016 13:00,21.75,35226,1441,48,230,1888,18,3625,5.579.880.952
14/08/2016 14:00,21.47,35056,1499,44,230,1870,18,3661,5.579.880.952
14/08/2016 15:00,21.12,34914,1521,44,222,1837,18,3642,5.579.880.952
14/08/2016 16:00,21.85,35136,1547,40,205,1826,17,3635,5.579.880.952
14/08/2016 17:00,22.73,35565,1475,41,195,1771,15,3497,5.579.880.952
14/08/2016 18:00,24.74,35839,1288,45,170,1713,14,3230,5.579.880.952
14/08/2016 19:00,25.48,35830,1100,49,155,1704,9,3017,5.579.880.952
14/08/2016 20:00,26.09,35702,966,51,150,1677,5,2849,5.579.880.952
14/08/2016 21:00,26.36,35824,902,49,144,1699,3,2797,5.579.880.952
14/08/2016 22:00,26.03,35157,863,46,120,1776,3,2808,5.579.880.952
14/08/2016 23:00,24.78,33512,830,66,90,1806,3,2795,5.579.880.952
15/08/2016 00:00,21.73,32265,911,66,85,1882,3,2947,5.583.988.095
15/08/2016 01:00,20.7,31267,896,63,70,1923,2,2954,5.583.988.095
15/08/2016 02:00,20.47,30827,1014,58,65,1953,2,3092,5.583.988.095
15/08/2016 03:00,20.2,30710,1096,55,60,1998,2,3211,5.583.988.095
15/08/2016 04:00,20.14,30895,1146,50,55,1954,5,3210,5.583.988.095
15/08/2016 05:00,20.42,32250,1117,46,50,1876,9,3098,5.583.988.095
15/08/2016 06:00,25.36,35047,1024,46,40,1767,8,2885,5.583.988.095
15/08/2016 07:00,27.02,38327,973,47,35,1604,8,2667,5.583.988.095
15/08/2016 08:00,27.41,39735,954,47,45,1534,11,2591,5.583.988.095
15/08/2016 09:00,27.76,40581,926,42,70,1528,19,2585,5.583.988.095
15/08/2016 10:00,28.04,41007,858,40,90,1602,27,2617,5.583.988.095
15/08/2016 11:00,27.9,41141,796,39,140,1691,29,2695,5.583.988.095
15/08/2016 12:00,28.11,41055,768,41,170,1768,29,2776,5.583.988.095
15/08/2016 13:00,27.57,40945,754,40,181,1818,25,2818,5.583.988.095
15/08/2016 14:00,27.3,40709,752,39,181,1865,21,2858,5.583.988.095
15/08/2016 15:00,27.03,40215,738,34,177,1919,22,2890,5.583.988.095
15/08/2016 16:00,26.53,39769,696,29,165,1913,16,2819,5.583.988.095
15/08/2016 17:00,26.78,39674,638,26,145,2000,13,2822,5.583.988.095
15/08/2016 18:00,27.23,39258,591,26,125,1934,11,2687,5.583.988.095
15/08/2016 19:00,27.38,38761,550,28,125,1932,9,2644,5.583.988.095
15/08/2016 20:00,27.43,38115,466,31,130,2022,8,2657,5.583.988.095
15/08/2016 21:00,27.66,37790,413,36,140,2076,8,2673,5.583.988.095
15/08/2016 22:00,27.04,36617,394,41,160,2244,12,2851,5.583.988.095
15/08/2016 23:00,25.65,34424,376,39,185,2392,42,3034,5.583.988.095
16/08/2016 00:00,23.29,32887,359,38,200,2469,43,3109,5.583.988.095
16/08/2016 01:00,21.03,31824,354,41,205,2521,33,3154,5.583.988.095
16/08/2016 02:00,20.73,31315,339,48,199,2554,23,3163,5.583.988.095
16/08/2016 03:00,20.58,31160,326,55,190,2557,16,3144,5.583.988.095
16/08/2016 04:00,20.56,31329,313,66,177,2511,14,3081,5.583.988.095
16/08/2016 05:00,21.26,32488,305,82,150,2452,26,3015,5.583.988.095
16/08/2016 06:00,25.01,35486,297,95,133,2332,38,2895,5.583.988.095
16/08/2016 07:00,27.07,38803,283,102,130,2275,42,2832,5.583.988.095
16/08/2016 08:00,27.78,39676,279,100,130,2253,46,2808,5.583.988.095
16/08/2016 09:00,28.21,40499,305,98,140,2282,47,2872,5.583.988.095
16/08/2016 10:00,28.21,40992,327,93,155,2284,48,2907,5.583.988.095
16/08/2016 11:00,27.88,41227,360,93,166,2322,48,2989,5.583.988.095
16/08/2016 12:00,27.41,41263,393,94,185,2326,47,3045,5.583.988.095
16/08/2016 13:00,27.29,41312,453,98,200,2274,43,3068,5.583.988.095
16/08/2016 14:00,27.22,41024,530,102,220,2275,38,3165,5.583.988.095
16/08/2016 15:00,26.84,40565,571,104,230,2232,36,3173,5.583.988.095
16/08/2016 16:00,26.55,40066,596,106,233,2142,31,3108,5.583.988.095
16/08/2016 17:00,27.36,39846,586,107,233,2022,26,2974,5.583.988.095
16/08/2016 18:00,27.75,39406,524,108,225,1959,20,2836,5.583.988.095
16/08/2016 19:00,27.88,38868,457,107,212,1968,14,2758,5.583.988.095
16/08/2016 20:00,27.21,38302,382,103,205,2021,12,2723,5.583.988.095
16/08/2016 21:00,27.22,37994,323,100,202,2103,10,2738,5.583.988.095
16/08/2016 22:00,26.19,36717,288,93,195,2204,8,2788,5.583.988.095
16/08/2016 23:00,24.96,34551,263,106,177,2340,22,2908,5.583.988.095
17/08/2016 00:00,21.72,32923,192,97,184,2408,20,2901,5.583.988.095
17/08/2016 01:00,20.93,31860,211,95,183,2460,21,2970,5.583.988.095
17/08/2016 02:00,20.68,31375,224,96,182,2521,21,3044,5.583.988.095
17/08/2016 03:00,20.25,31197,204,97,184,2594,17,3096,5.583.988.095
17/08/2016 04:00,20.41,31385,200,94,181,2598,15,3088,5.583.988.095
17/08/2016 05:00,21.37,32576,215,89,177,2503,12,2996,5.583.988.095
17/08/2016 06:00,25.78,35393,234,85,175,2369,10,2873,5.583.988.095
17/08/2016 07:00,28.76,38941,246,84,175,2297,8,2810,5.583.988.095
17/08/2016 08:00,29.73,40785,251,83,167,2166,6,2673,5.583.988.095
17/08/2016 09:00,30.01,41155,275,85,157,2020,3,2540,5.583.988.095
17/08/2016 10:00,30.64,41757,312,87,162,2018,3,2582,5.583.988.095
17/08/2016 11:00,30.33,41751,350,88,157,2054,2,2651,5.583.988.095
17/08/2016 12:00,30.18,41645,378,87,156,2087,1,2709,5.583.988.095
17/08/2016 13:00,30.07,41528,413,89,163,2040,1,2706,5.583.988.095
17/08/2016 14:00,29.66,41439,470,89,154,1947,1,2661,5.583.988.095
17/08/2016 15:00,28.94,40944,555,93,149,1932,1,2730,5.583.988.095
17/08/2016 16:00,28.36,40437,661,91,168,1967,1,2888,5.583.988.095
17/08/2016 17:00,28.85,40586,697,90,153,1923,1,2864,5.583.988.095
17/08/2016 18:00,28.55,40102,661,91,135,1833,1,2721,5.583.988.095
17/08/2016 19:00,28.69,39594,602,92,125,1793,1,2613,5.583.988.095
17/08/2016 20:00,28.26,39017,565,93,109,1722,2,2491,5.583.988.095
17/08/2016 21:00,28.06,38740,572,91,110,1692,2,2467,5.583.988.095
17/08/2016 22:00,26.76,37439,579,85,108,1700,3,2475,5.583.988.095
17/08/2016 23:00,24.98,35189,589,73,103,1770,5,2540,5.583.988.095
18/08/2016 00:00,23.03,33294,586,69,122,1789,5,2571,5.583.988.095
18/08/2016 01:00,21.47,32088,613,69,128,1844,5,2659,5.583.988.095
18/08/2016 02:00,21.11,31615,598,68,137,1915,5,2723,5.583.988.095
18/08/2016 03:00,20.73,31433,583,69,136,1978,6,2772,5.583.988.095
18/08/2016 04:00,20.82,31719,597,72,134,2065,8,2876,5.583.988.095
18/08/2016 05:00,22.71,33102,628,70,129,2122,7,2956,5.583.988.095
18/08/2016 06:00,25.72,36047,664,72,129,2129,8,3002,5.583.988.095
18/08/2016 07:00,27.65,39667,721,73,129,2147,11,3081,5.583.988.095
18/08/2016 08:00,28.74,41630,775,75,129,2205,15,3199,5.583.988.095
18/08/2016 09:00,28.99,42030,854,76,130,2210,15,3285,5.583.988.095
18/08/2016 10:00,28.88,42552,933,70,130,2208,18,3359,5.583.988.095
18/08/2016 11:00,28.56,42632,981,64,131,2230,18,3424,5.583.988.095
18/08/2016 12:00,28.44,42314,929,58,129,2171,16,3303,5.583.988.095
18/08/2016 13:00,28.36,42236,879,53,125,2103,17,3177,5.583.988.095
18/08/2016 14:00,28.16,42060,863,50,121,2047,16,3097,5.583.988.095
18/08/2016 15:00,27.91,41664,857,49,110,1961,13,2990,5.583.988.095
18/08/2016 16:00,27.37,41224,930,54,111,1903,10,3008,5.583.988.095
18/08/2016 17:00,27.95,41100,938,58,110,1764,8,2878,5.583.988.095
18/08/2016 18:00,28.12,40676,843,59,115,1607,7,2631,5.583.988.095
18/08/2016 19:00,28.73,40135,707,61,118,1565,6,2457,5.583.988.095
18/08/2016 20:00,28.18,39579,601,54,122,1497,6,2280,5.583.988.095
18/08/2016 21:00,27.54,39238,551,51,125,1413,5,2145,5.583.988.095
18/08/2016 22:00,26.36,37702,524,47,130,1307,4,2012,5.583.988.095
18/08/2016 23:00,24.86,35394,480,46,159,1160,12,1857,5.583.988.095
19/08/2016 00:00,23.62,33183,378,49,159,1067,13,1666,5.583.988.095
19/08/2016 01:00,22.7,32168,345,55,156,1027,14,1597,5.583.988.095
19/08/2016 02:00,22.06,31800,307,57,153,955,14,1486,5.583.988.095
19/08/2016 03:00,21.8,31666,267,59,149,905,13,1393,5.583.988.095
19/08/2016 04:00,21.99,32007,236,59,142,888,14,1339,5.583.988.095
19/08/2016 05:00,24.03,33295,216,59,137,817,16,1245,5.583.988.095
19/08/2016 06:00,26.84,36244,199,61,134,751,20,1165,5.583.988.095
19/08/2016 07:00,30.1,39754,182,60,120,677,20,1059,5.583.988.095
19/08/2016 08:00,31.17,41978,150,62,111,654,22,999,5.583.988.095
19/08/2016 09:00,31.43,42677,113,65,103,651,24,956,5.583.988.095
19/08/2016 10:00,31.56,43073,95,70,97,645,29,936,5.583.988.095
19/08/2016 11:00,31.36,43041,77,75,94,621,34,901,5.583.988.095
19/08/2016 12:00,30.68,42442,67,76,90,559,30,822,5.583.988.095
19/08/2016 13:00,30.28,41961,67,69,86,522,24,768,5.583.988.095
19/08/2016 14:00,29.89,41425,66,59,75,519,22,741,5.583.988.095
19/08/2016 15:00,29.21,40717,59,54,62,494,17,686,5.583.988.095
19/08/2016 16:00,28.36,40241,52,47,52,517,10,678,5.583.988.095
19/08/2016 17:00,28.76,40045,42,40,45,455,7,589,5.583.988.095
19/08/2016 18:00,28.65,39715,36,38,42,434,4,554,5.583.988.095
19/08/2016 19:00,28.57,38927,38,37,41,403,3,522,5.583.988.095
19/08/2016 20:00,27.86,38117,46,36,38,418,2,540,5.583.988.095
19/08/2016 21:00,27.24,37691,72,32,38,433,2,577,5.583.988.095
19/08/2016 22:00,26.5,36464,129,29,37,478,2,675,5.583.988.095
19/08/2016 23:00,25.16,34602,207,20,25,411,1,664,5.583.988.095
20/08/2016 00:00,24.38,31974,448,15,25,370,1,859,5.583.988.095
20/08/2016 01:00,23.68,30992,514,11,25,346,1,897,5.583.988.095
20/08/2016 02:00,22.8,30557,567,8,25,337,1,938,5.583.988.095
20/08/2016 03:00,22.63,30276,590,6,25,344,1,966,5.583.988.095
20/08/2016 04:00,22.28,30204,603,4,25,344,1,977,5.583.988.095
20/08/2016 05:00,22.19,30114,621,2,22,338,1,984,5.583.988.095
20/08/2016 06:00,23.09,30875,658,1,20,323,2,1004,5.583.988.095
20/08/2016 07:00,24.74,32324,707,1,11,289,1,1009,5.583.988.095
20/08/2016 08:00,25.55,33760,733,1,11,289,3,1037,5.583.988.095
20/08/2016 09:00,26.28,35398,781,2,15,311,1,1110,5.583.988.095
20/08/2016 10:00,26.69,36406,883,3,20,344,2,1252,5.583.988.095
20/08/2016 11:00,26.73,36467,941,5,25,400,3,1374,5.583.988.095
20/08/2016 12:00,26.31,36283,952,7,35,470,3,1467,5.583.988.095
20/08/2016 13:00,25.72,36057,951,8,35,512,4,1510,5.583.988.095
20/08/2016 14:00,25.55,35717,877,9,35,582,4,1507,5.583.988.095
20/08/2016 15:00,25.19,35391,749,8,33,616,3,1409,5.583.988.095
20/08/2016 16:00,25.25,35586,649,6,30,595,3,1283,5.583.988.095
20/08/2016 17:00,25.87,35862,587,6,30,589,2,1214,5.583.988.095
20/08/2016 18:00,26.24,35881,514,6,33,616,2,1171,5.583.988.095
20/08/2016 19:00,26.05,35501,479,7,40,691,2,1219,5.583.988.095
20/08/2016 20:00,25.91,35203,467,9,50,832,1,1359,5.583.988.095
20/08/2016 21:00,26.09,35192,496,12,50,936,1,1495,5.583.988.095
20/08/2016 22:00,25.57,34221,541,17,65,1009,1,1633,5.583.988.095
20/08/2016 23:00,24.81,32740,621,31,111,962,7,1732,5.583.988.095
21/08/2016 00:00,22.14,31585,871,35,125,891,8,1930,5.583.988.095
21/08/2016 01:00,21.31,30608,872,35,130,809,6,1852,5.583.988.095
21/08/2016 02:00,20.63,29974,861,36,135,661,6,1699,5.583.988.095
21/08/2016 03:00,20.39,29600,858,37,145,597,6,1643,5.583.988.095
21/08/2016 04:00,20.12,29296,879,41,145,527,7,1599,5.583.988.095
21/08/2016 05:00,20.08,29171,880,43,133,430,6,1492,5.583.988.095
21/08/2016 06:00,20.47,29351,877,45,133,362,4,1421,5.583.988.095
21/08/2016 07:00,21.54,30373,878,45,145,295,4,1367,5.583.988.095
21/08/2016 08:00,22.38,31447,866,45,145,249,5,1310,5.583.988.095
21/08/2016 09:00,23.79,32969,904,46,140,228,5,1323,5.583.988.095
21/08/2016 10:00,24.45,34211,1008,50,135,263,6,1462,5.583.988.095
21/08/2016 11:00,24.83,34906,1109,55,135,220,7,1526,5.583.988.095
21/08/2016 12:00,24.94,34974,1172,60,140,230,8,1610,5.583.988.095
21/08/2016 13:00,24.76,34830,1221,59,145,240,10,1675,5.583.988.095
21/08/2016 14:00,24.57,34737,1208,58,140,241,13,1660,5.583.988.095
21/08/2016 15:00,24.63,34664,1137,60,140,230,12,1579,5.583.988.095
21/08/2016 16:00,24.77,34916,1038,62,140,251,11,1502,5.583.988.095
21/08/2016 17:00,25.1,35444,911,68,133,235,9,1356,5.583.988.095
21/08/2016 18:00,25.85,35726,765,73,115,264,10,1227,5.583.988.095
21/08/2016 19:00,26.3,35808,608,82,95,291,10,1086,5.583.988.095
21/08/2016 20:00,26.41,35820,515,92,88,318,11,1024,5.583.988.095
21/08/2016 21:00,26.67,35948,510,100,88,328,13,1039,5.583.988.095
21/08/2016 22:00,26.15,34925,532,100,88,333,13,1066,5.583.988.095
21/08/2016 23:00,24.9,33148,567,105,66,257,9,1004,5.583.988.095
22/08/2016 00:00,23.2,31738,521,105,60,254,9,949,5.636.547.619
22/08/2016 01:00,21.73,30817,565,104,55,255,9,988,5.636.547.619
22/08/2016 02:00,21.47,30409,581,104,55,256,7,1003,5.636.547.619
22/08/2016 03:00,21.53,30346,572,104,50,261,6,993,5.636.547.619
22/08/2016 04:00,21.77,30619,595,99,50,256,7,1007,5.636.547.619
22/08/2016 05:00,24.08,32050,614,95,50,254,8,1021,5.636.547.619
22/08/2016 06:00,26.48,35263,631,90,55,258,9,1043,5.636.547.619
22/08/2016 07:00,30.03,38743,616,85,55,245,9,1010,5.636.547.619
22/08/2016 08:00,32.49,39768,605,85,55,241,10,996,5.636.547.619
22/08/2016 09:00,33.21,40446,627,87,55,259,10,1038,5.636.547.619
22/08/2016 10:00,33.83,40998,673,88,50,312,11,1134,5.636.547.619
22/08/2016 11:00,33.72,41154,747,88,50,379,11,1275,5.636.547.619
22/08/2016 12:00,33.56,41188,808,86,50,478,11,1433,5.636.547.619
22/08/2016 13:00,33.3,41143,865,75,50,566,10,1566,5.636.547.619
22/08/2016 14:00,32.47,40903,874,64,50,667,11,1666,5.636.547.619
22/08/2016 15:00,31.86,40406,794,57,45,723,10,1629,5.636.547.619
22/08/2016 16:00,30.84,40020,715,54,33,768,7,1577,5.636.547.619
22/08/2016 17:00,31.07,39975,641,46,30,768,6,1491,5.636.547.619
22/08/2016 18:00,29.69,39650,554,36,25,762,5,1382,5.636.547.619
22/08/2016 19:00,29.41,39220,496,30,25,842,5,1398,5.636.547.619
22/08/2016 20:00,28.93,38833,495,26,25,911,5,1462,5.636.547.619
22/08/2016 21:00,27.99,38487,545,25,25,1011,5,1611,5.636.547.619
22/08/2016 22:00,26.45,36969,624,21,25,1040,5,1715,5.636.547.619
22/08/2016 23:00,25.15,34473,678,8,22,1015,2,1725,5.636.547.619
23/08/2016 00:00,22.43,32739,840,7,20,995,2,1864,5.636.547.619
23/08/2016 01:00,22.13,31718,820,8,20,967,3,1818,5.636.547.619
23/08/2016 02:00,21.63,31223,750,9,19,916,2,1696,5.636.547.619
23/08/2016 03:00,21.2,31132,657,9,19,923,3,1611,5.636.547.619
23/08/2016 04:00,21.95,31425,582,10,22,918,3,1535,5.636.547.619
23/08/2016 05:00,24.06,33125,520,10,23,886,3,1442,5.636.547.619
23/08/2016 06:00,26.55,36029,463,9,21,824,4,1321,5.636.547.619
23/08/2016 07:00,28.96,39519,405,10,21,745,5,1186,5.636.547.619
23/08/2016 08:00,29.93,40153,367,11,24,680,6,1088,5.636.547.619
23/08/2016 09:00,30.12,40872,349,10,28,624,6,1017,5.636.547.619
23/08/2016 10:00,30.14,41444,331,10,30,679,6,1056,5.636.547.619
23/08/2016 11:00,29.97,41637,315,10,35,724,6,1090,5.636.547.619
23/08/2016 12:00,30.35,41684,313,11,40,753,6,1123,5.636.547.619
23/08/2016 13:00,30.06,41700,320,13,38,788,7,1166,5.636.547.619
23/08/2016 14:00,29.9,41356,318,14,37,825,6,1200,5.636.547.619
23/08/2016 15:00,29.66,40688,296,12,37,861,7,1213,5.636.547.619
23/08/2016 16:00,29.64,40268,257,12,35,890,6,1200,5.636.547.619
23/08/2016 17:00,29.96,40139,203,12,31,870,6,1122,5.636.547.619
23/08/2016 18:00,30.06,39788,152,12,31,778,6,979,5.636.547.619
23/08/2016 19:00,30,39403,114,12,32,816,7,981,5.636.547.619
23/08/2016 20:00,29.36,39049,88,13,33,927,6,1067,5.636.547.619
23/08/2016 21:00,29.05,38686,68,14,34,974,4,1094,5.636.547.619
23/08/2016 22:00,27.11,37132,60,16,34,1005,3,1118,5.636.547.619
23/08/2016 23:00,25.11,34751,51,25,0,961,1,1038,5.636.547.619
24/08/2016 00:00,23.75,32906,54,23,0,819,2,898,5.636.547.619
24/08/2016 01:00,23.21,31917,64,23,0,728,2,817,5.636.547.619
24/08/2016 02:00,23.05,31418,73,22,0,597,2,694,5.636.547.619
24/08/2016 03:00,23.05,31287,82,21,0,483,3,589,5.636.547.619
24/08/2016 04:00,23.14,31529,104,20,0,396,3,523,5.636.547.619
24/08/2016 05:00,24.31,33272,142,20,0,310,3,475,5.636.547.619
24/08/2016 06:00,26.88,36195,188,19,0,223,3,433,5.636.547.619
24/08/2016 07:00,29.7,39721,243,20,0,166,2,431,5.636.547.619
24/08/2016 08:00,31.58,40401,273,24,0,131,2,430,5.636.547.619
24/08/2016 09:00,31.6,41144,300,30,0,124,2,456,5.636.547.619
24/08/2016 10:00,31.56,41723,352,36,0,148,2,538,5.636.547.619
24/08/2016 11:00,30.48,41907,414,42,0,179,3,638,5.636.547.619
24/08/2016 12:00,31.03,41892,479,45,0,252,4,780,5.636.547.619
24/08/2016 13:00,30.29,41796,557,44,0,331,4,936,5.636.547.619
24/08/2016 14:00,29.94,41512,613,43,0,449,6,1111,5.636.547.619
24/08/2016 15:00,29.09,40773,665,40,0,602,5,1312,5.636.547.619
24/08/2016 16:00,28.9,40325,711,39,0,738,3,1491,5.636.547.619
24/08/2016 17:00,29.17,40215,734,39,0,867,3,1643,5.636.547.619
24/08/2016 18:00,29.2,39845,705,38,0,1094,2,1839,5.636.547.619
24/08/2016 19:00,29.22,39442,660,35,0,1284,2,1981,5.636.547.619
24/08/2016 20:00,28.81,39038,695,30,0,1426,2,2153,5.636.547.619
24/08/2016 21:00,27.94,38679,802,26,0,1652,2,2482,5.636.547.619
24/08/2016 22:00,25.3,37081,899,22,0,1729,3,2653,5.636.547.619
24/08/2016 23:00,24.33,34710,932,11,18,1870,2,2833,5.636.547.619
25/08/2016 00:00,22.14,32691,1040,10,16,1832,2,2900,5.636.547.619
25/08/2016 01:00,21.65,31606,1020,9,15,1784,2,2830,5.636.547.619
25/08/2016 02:00,20.87,31114,1018,8,14,1797,2,2839,5.636.547.619
25/08/2016 03:00,20.78,31022,984,9,14,1783,2,2792,5.636.547.619
25/08/2016 04:00,21.09,31298,934,9,13,1711,3,2670,5.636.547.619
25/08/2016 05:00,23.11,32693,893,8,13,1647,4,2565,5.636.547.619
25/08/2016 06:00,26.54,35938,837,10,13,1469,4,2333,5.636.547.619
25/08/2016 07:00,28.72,39598,795,16,13,1297,6,2127,5.636.547.619
25/08/2016 08:00,29.59,40424,734,26,13,1257,11,2041,5.636.547.619
25/08/2016 09:00,29.92,41127,676,39,15,1376,16,2122,5.636.547.619
25/08/2016 10:00,30.31,41854,641,50,18,1368,17,2094,5.636.547.619
25/08/2016 11:00,30,42125,609,64,21,1425,20,2139,5.636.547.619
25/08/2016 12:00,30.05,42033,585,74,27,1435,24,2145,5.636.547.619
25/08/2016 13:00,29.83,41944,594,78,32,1463,23,2190,5.636.547.619
25/08/2016 14:00,29.38,41543,607,80,37,1512,24,2260,5.636.547.619
25/08/2016 15:00,28.92,41120,607,80,40,1494,26,2247,5.636.547.619
25/08/2016 16:00,28.46,40628,586,78,40,1396,25,2125,5.636.547.619
25/08/2016 17:00,28.96,40481,519,73,40,1299,22,1953,5.636.547.619
25/08/2016 18:00,28.98,40104,415,72,43,1253,17,1800,5.636.547.619
25/08/2016 19:00,29.55,39687,360,73,47,1177,16,1673,5.636.547.619
25/08/2016 20:00,28.91,39293,386,74,53,1196,15,1724,5.636.547.619
25/08/2016 21:00,28.38,38813,486,75,60,1218,16,1855,5.636.547.619
25/08/2016 22:00,25.61,37159,657,71,71,1188,17,2004,5.636.547.619
25/08/2016 23:00,24.34,34610,801,59,84,1318,7,2269,5.636.547.619
26/08/2016 00:00,22.74,32779,991,56,93,1304,7,2451,5.636.547.619
26/08/2016 01:00,21.06,31655,1050,55,104,1297,7,2513,5.636.547.619
26/08/2016 02:00,20.94,31070,1077,52,115,1279,8,2531,5.636.547.619
26/08/2016 03:00,20.77,30912,1076,52,115,1258,9,2510,5.636.547.619
26/08/2016 04:00,22.08,31183,1073,48,116,1225,8,2470,5.636.547.619
26/08/2016 05:00,23.64,32542,1073,44,114,1168,9,2408,5.636.547.619
26/08/2016 06:00,26.03,35534,1110,40,105,1109,9,2373,5.636.547.619
26/08/2016 07:00,28.77,39142,1130,38,97,1047,10,2322,5.636.547.619
26/08/2016 08:00,29.47,40181,1091,36,91,1063,10,2291,5.636.547.619
26/08/2016 09:00,29.41,40854,1067,36,88,1097,14,2302,5.636.547.619
26/08/2016 10:00,28.84,41274,1191,39,92,1213,17,2552,5.636.547.619
26/08/2016 11:00,28.32,41327,1336,42,109,1347,18,2852,5.636.547.619
26/08/2016 12:00,27.85,41087,1328,45,127,1603,24,3127,5.636.547.619
26/08/2016 13:00,27.03,40561,1275,44,142,1860,30,3351,5.636.547.619
26/08/2016 14:00,26.77,39948,1212,46,152,2150,41,3601,5.636.547.619
26/08/2016 15:00,26.36,39160,1136,49,155,2381,42,3763,5.636.547.619
26/08/2016 16:00,26.4,38625,1115,59,153,2532,34,3893,5.636.547.619
26/08/2016 17:00,27.21,38553,1106,78,156,2812,30,4182,5.636.547.619
26/08/2016 18:00,27.31,38264,1105,100,157,3069,23,4454,5.636.547.619
26/08/2016 19:00,26.96,37713,1150,123,166,3241,21,4701,5.636.547.619
26/08/2016 20:00,26.71,37275,1114,141,175,3342,24,4796,5.636.547.619
26/08/2016 21:00,26.53,36778,1043,152,184,3374,23,4776,5.636.547.619
26/08/2016 22:00,25.32,35312,1011,154,189,3375,24,4753,5.636.547.619
26/08/2016 23:00,24.07,33396,1015,163,232,3492,33,4935,5.636.547.619
27/08/2016 00:00,23.31,31467,1063,162,230,3427,30,4912,5.636.547.619
27/08/2016 01:00,22.35,30364,1009,158,228,3431,26,4852,5.636.547.619
27/08/2016 02:00,22.09,29792,890,156,217,3476,22,4761,5.636.547.619
27/08/2016 03:00,22.24,29592,777,153,206,3452,17,4605,5.636.547.619
27/08/2016 04:00,22.33,29498,692,151,194,3414,16,4467,5.636.547.619
27/08/2016 05:00,22.31,29513,660,153,179,3384,14,4390,5.636.547.619
27/08/2016 06:00,22.35,30054,609,155,162,3396,14,4336,5.636.547.619
27/08/2016 07:00,23.24,31529,540,160,138,3431,17,4286,5.636.547.619
27/08/2016 08:00,23.89,33037,493,167,124,3498,19,4301,5.636.547.619
27/08/2016 09:00,24.38,34670,456,173,110,3432,22,4193,5.636.547.619
27/08/2016 10:00,23.4,35627,463,181,100,3564,23,4331,5.636.547.619
27/08/2016 11:00,22.92,35790,426,187,97,3596,22,4328,5.636.547.619
27/08/2016 12:00,22.26,35612,353,192,96,3516,20,4177,5.636.547.619
27/08/2016 13:00,21.89,35405,309,193,96,3509,22,4129,5.636.547.619
27/08/2016 14:00,21.58,35115,276,192,92,3360,22,3942,5.636.547.619
27/08/2016 15:00,22.08,34962,242,189,85,3103,19,3638,5.636.547.619
27/08/2016 16:00,22.81,35061,207,182,77,2792,15,3273,5.636.547.619
27/08/2016 17:00,23.84,35492,165,173,71,2519,11,2939,5.636.547.619
27/08/2016 18:00,25.54,35565,119,161,62,2211,6,2559,5.636.547.619
27/08/2016 19:00,25.74,35295,95,144,48,1982,3,2272,5.636.547.619
27/08/2016 20:00,25.87,35243,97,127,42,1807,4,2077,5.636.547.619
27/08/2016 21:00,25.65,35083,129,109,37,1671,4,1950,5.636.547.619
27/08/2016 22:00,24.62,34042,176,90,33,1626,3,1928,5.636.547.619
27/08/2016 23:00,23.22,32454,247,98,28,1499,4,1876,5.636.547.619
28/08/2016 00:00,22.44,31277,514,82,22,1339,3,1960,5.636.547.619
28/08/2016 01:00,20.42,30281,639,70,16,1211,2,1938,5.636.547.619
28/08/2016 02:00,20.39,29735,739,59,13,1110,3,1924,5.636.547.619
28/08/2016 03:00,20.48,29498,922,51,12,1014,2,2001,5.636.547.619
28/08/2016 04:00,20.03,29318,1189,42,12,912,2,2157,5.636.547.619
28/08/2016 05:00,19.54,29275,1482,33,13,817,1,2346,5.636.547.619
28/08/2016 06:00,20.08,29378,1769,25,13,739,0,2546,5.636.547.619
28/08/2016 07:00,20.81,30445,2001,18,12,723,0,2754,5.636.547.619
28/08/2016 08:00,23.26,31883,1958,14,13,703,0,2688,5.636.547.619
28/08/2016 09:00,23.69,33524,1879,11,16,693,0,2599,5.636.547.619
28/08/2016 10:00,23.95,34793,1879,9,23,728,0,2639,5.636.547.619
28/08/2016 11:00,24.06,35488,1729,7,26,771,0,2533,5.636.547.619
28/08/2016 12:00,23.95,35728,1496,6,31,812,0,2345,5.636.547.619
28/08/2016 13:00,23.89,35646,1304,5,37,839,0,2185,5.636.547.619
28/08/2016 14:00,23.84,35550,1145,4,42,849,1,2041,5.636.547.619
28/08/2016 15:00,23.62,35521,976,3,44,905,3,1931,5.636.547.619
28/08/2016 16:00,23.64,35812,802,3,51,962,6,1824,5.636.547.619
28/08/2016 17:00,24.18,36410,772,4,63,1027,6,1872,5.636.547.619
28/08/2016 18:00,24.36,36774,878,6,75,1075,8,2042,5.636.547.619
28/08/2016 19:00,25.23,37006,999,10,106,1125,9,2249,5.636.547.619
28/08/2016 20:00,26.16,37293,1087,15,132,1164,9,2407,5.636.547.619
28/08/2016 21:00,26.23,37155,1094,20,143,1140,12,2409,5.636.547.619
28/08/2016 22:00,25.07,35918,1167,25,152,1132,14,2490,5.636.547.619
28/08/2016 23:00,23.21,34008,1232,51,0,924,10,2217,5.636.547.619
29/08/2016 00:00,21.87,32198,1062,53,0,903,9,2027,571.702.381
29/08/2016 01:00,22.28,31304,1274,61,0,900,7,2242,571.702.381
29/08/2016 02:00,21.55,30922,1403,64,0,918,6,2391,571.702.381
29/08/2016 03:00,21.79,30925,1454,69,0,1024,7,2554,571.702.381
29/08/2016 04:00,21.37,31366,1681,71,0,1090,8,2850,571.702.381
29/08/2016 05:00,23.11,32962,1937,76,0,1110,8,3131,571.702.381
29/08/2016 06:00,26.92,36240,2111,78,0,1127,11,3327,571.702.381
29/08/2016 07:00,29.9,40058,2281,78,0,1131,11,3501,571.702.381
29/08/2016 08:00,33.35,40621,2389,78,0,1180,17,3664,571.702.381
29/08/2016 09:00,31.2,41475,2544,81,0,1301,21,3947,571.702.381
29/08/2016 10:00,30.11,42088,2726,84,0,1435,21,4266,571.702.381
29/08/2016 11:00,29.57,42290,2907,87,0,1571,27,4592,571.702.381
29/08/2016 12:00,29.46,42358,3056,90,0,1756,31,4933,571.702.381
29/08/2016 13:00,29.2,42397,3167,93,0,1865,31,5156,571.702.381
29/08/2016 14:00,28.56,42153,3223,97,0,1908,42,5270,571.702.381
29/08/2016 15:00,27.95,41743,3269,106,0,1970,37,5382,571.702.381
29/08/2016 16:00,26.93,41329,3336,109,0,1994,40,5479,571.702.381
29/08/2016 17:00,27.59,41266,3347,112,0,1963,42,5464,571.702.381
29/08/2016 18:00,27.96,40856,3270,119,0,1914,36,5339,571.702.381
29/08/2016 19:00,28.16,40541,3149,120,0,1859,27,5155,571.702.381
29/08/2016 20:00,28.14,40171,2993,117,0,1834,22,4966,571.702.381
29/08/2016 21:00,27.82,39522,2825,115,0,1936,17,4893,571.702.381
29/08/2016 22:00,25.59,37799,2623,107,0,1953,12,4695,571.702.381
29/08/2016 23:00,23.44,35347,2421,106,273,1917,40,4757,571.702.381
30/08/2016 00:00,23.74,33577,2086,102,264,1932,39,4423,571.702.381
30/08/2016 01:00,22.8,32585,1924,103,257,1873,35,4192,571.702.381
30/08/2016 02:00,22.35,32162,1802,109,257,1848,41,4057,571.702.381
30/08/2016 03:00,22.13,32114,1704,113,261,1803,42,3923,571.702.381
30/08/2016 04:00,21.67,32512,1610,110,253,1726,40,3739,571.702.381
30/08/2016 05:00,23.45,33998,1496,115,247,1452,36,3346,571.702.381
30/08/2016 06:00,27.75,37093,1381,131,242,1336,36,3126,571.702.381
30/08/2016 07:00,30.12,40625,1270,138,241,1283,36,2968,571.702.381
30/08/2016 08:00,35.58,41001,1210,140,244,1278,34,2906,571.702.381
30/08/2016 09:00,33.39,41526,1204,141,246,1297,36,2924,571.702.381
30/08/2016 10:00,32.84,41923,1275,137,244,1409,35,3100,571.702.381
30/08/2016 11:00,32.08,42056,1392,137,240,1642,40,3451,571.702.381
30/08/2016 12:00,31.18,42008,1477,143,233,1834,32,3719,571.702.381
30/08/2016 13:00,30.54,42033,1529,149,228,1999,26,3931,571.702.381
30/08/2016 14:00,29.92,41721,1504,149,213,2102,22,3990,571.702.381
30/08/2016 15:00,29.46,41339,1394,146,192,2120,18,3870,571.702.381
30/08/2016 16:00,28.27,40914,1266,136,175,2120,17,3714,571.702.381
30/08/2016 17:00,29.24,40764,1130,125,159,2001,16,3431,571.702.381
30/08/2016 18:00,30.33,40401,991,110,133,1861,14,3109,571.702.381
30/08/2016 19:00,32.48,40152,842,94,108,1805,15,2864,571.702.381
30/08/2016 20:00,31.33,39910,719,82,86,1781,17,2685,571.702.381
30/08/2016 21:00,29.98,39338,665,74,81,1860,15,2695,571.702.381
30/08/2016 22:00,26.89,37587,635,65,80,1874,10,2664,571.702.381
30/08/2016 23:00,24.86,35113,594,56,84,1818,7,2559,571.702.381
31/08/2016 00:00,23.66,33021,581,52,82,1678,6,2399,571.702.381
31/08/2016 01:00,21.88,32108,586,47,84,1550,5,2272,571.702.381
31/08/2016 02:00,21.29,31736,555,42,88,1402,5,2092,571.702.381
31/08/2016 03:00,20.99,31643,519,36,88,1318,6,1967,571.702.381
31/08/2016 04:00,21.07,31970,514,32,86,1283,7,1922,571.702.381
31/08/2016 05:00,23.73,33413,523,26,76,1323,7,1955,571.702.381
31/08/2016 06:00,26.94,36457,525,21,66,1288,6,1906,571.702.381
31/08/2016 07:00,30.05,39895,535,22,51,1213,6,1827,571.702.381
31/08/2016 08:00,31.04,40692,560,20,53,1175,7,1815,571.702.381
31/08/2016 09:00,31.17,41182,657,21,61,1168,7,1914,571.702.381
31/08/2016 10:00,31.04,41581,806,20,70,1311,6,2213,571.702.381
31/08/2016 11:00,29.67,41617,916,21,78,1507,6,2528,571.702.381
31/08/2016 12:00,28.96,41464,1003,21,79,1816,6,2925,571.702.381
31/08/2016 13:00,28.63,41448,1119,20,79,2087,4,3309,571.702.381
31/08/2016 14:00,28.02,41187,1233,18,75,2250,4,3580,571.702.381
31/08/2016 15:00,27.26,40682,1267,15,68,2292,4,3646,571.702.381
31/08/2016 16:00,26.83,40295,1289,13,61,2404,2,3769,571.702.381
31/08/2016 17:00,28.94,40221,1249,14,54,2630,2,3949,571.702.381
31/08/2016 18:00,28.75,39913,1150,16,42,2724,1,3933,571.702.381
31/08/2016 19:00,28.65,39765,1055,21,36,2846,1,3959,571.702.381
31/08/2016 20:00,27.77,39504,1018,28,36,2961,2,4045,571.702.381
31/08/2016 21:00,27.21,38854,1082,39,39,3094,3,4257,571.702.381
31/08/2016 22:00,24.75,36993,1215,46,43,3188,4,4496,571.702.381
31/08/2016 23:00,23.01,34502,1298,51,43,3183,10,4585,571.702.381
01/09/2016 00:00,21.23,32516,891,59,56,3114,9,4129,571.702.381
01/09/2016 01:00,20.45,31480,818,64,69,3016,11,3978,571.702.381
01/09/2016 02:00,20.27,31071,737,69,80,2865,12,3763,571.702.381
01/09/2016 03:00,20.67,30972,653,74,83,2664,12,3486,571.702.381
01/09/2016 04:00,21.31,31356,591,79,87,2417,12,3186,571.702.381
01/09/2016 05:00,23.57,32813,572,86,90,2286,10,3044,571.702.381
01/09/2016 06:00,25.97,35892,561,94,82,2134,9,2880,571.702.381
01/09/2016 07:00,29.12,39431,567,89,66,1976,9,2707,571.702.381
01/09/2016 08:00,30.28,40486,606,91,61,1938,11,2707,571.702.381
01/09/2016 09:00,30.29,40965,707,96,65,2043,11,2922,571.702.381
01/09/2016 10:00,29.05,41399,835,99,78,2064,12,3088,571.702.381
01/09/2016 11:00,28.54,41562,922,103,96,2226,13,3360,571.702.381
01/09/2016 12:00,26.62,41433,989,101,109,2421,15,3635,571.702.381
01/09/2016 13:00,26.5,41469,1060,95,107,2545,19,3826,571.702.381
01/09/2016 14:00,25.54,41128,1097,91,110,2530,24,3852,571.702.381
01/09/2016 15:00,25.02,40729,1125,88,101,2592,24,3930,571.702.381
01/09/2016 16:00,25.18,40334,1157,88,83,2584,19,3931,571.702.381
01/09/2016 17:00,26.62,40288,1113,85,74,2473,17,3762,571.702.381
01/09/2016 18:00,27.51,39839,1007,84,73,2380,15,3559,571.702.381
01/09/2016 19:00,27.86,39589,918,84,73,2356,20,3451,571.702.381
01/09/2016 20:00,26.78,39400,916,80,79,2364,20,3459,571.702.381
01/09/2016 21:00,25.97,38735,955,71,83,2398,16,3523,571.702.381
01/09/2016 22:00,24.5,36923,979,67,92,2438,8,3584,571.702.381
01/09/2016 23:00,23.39,34431,984,54,0,2332,5,3375,571.702.381
02/09/2016 00:00,22.88,32684,1227,50,0,2339,5,3621,571.702.381
02/09/2016 01:00,21.62,31616,1226,48,0,2425,4,3703,571.702.381
02/09/2016 02:00,21.11,31188,1134,47,0,2430,3,3614,571.702.381
02/09/2016 03:00,20.05,31136,1065,46,0,2396,3,3510,571.702.381
02/09/2016 04:00,20.29,31520,1008,45,0,2363,3,3419,571.702.381
02/09/2016 05:00,23.21,32982,922,45,0,2269,6,3242,571.702.381
02/09/2016 06:00,25.44,36008,839,47,0,2113,6,3005,571.702.381
02/09/2016 07:00,27.61,39573,848,52,0,1994,7,2901,571.702.381
02/09/2016 08:00,28.81,40381,960,62,0,1931,10,2963,571.702.381
02/09/2016 09:00,28.8,41002,1148,72,0,1866,16,3102,571.702.381
02/09/2016 10:00,27.34,41440,1371,81,0,1885,17,3354,571.702.381
02/09/2016 11:00,26.59,41537,1557,83,0,1858,15,3513,571.702.381
02/09/2016 12:00,25.93,41296,1670,80,0,1774,14,3538,571.702.381
02/09/2016 13:00,25.55,40944,1749,79,0,1693,14,3535,571.702.381
02/09/2016 14:00,24.76,40319,1818,79,0,1604,16,3517,571.702.381
02/09/2016 15:00,24.35,39699,1857,79,0,1522,12,3470,571.702.381
02/09/2016 16:00,24.94,39264,1754,74,0,1430,11,3269,571.702.381
02/09/2016 17:00,25.92,39162,1575,66,0,1297,10,2948,571.702.381
02/09/2016 18:00,26.35,38897,1375,58,0,1212,7,2652,571.702.381
02/09/2016 19:00,26.51,38500,1224,50,0,1182,5,2461,571.702.381
02/09/2016 20:00,25.9,38036,1120,45,0,1253,4,2422,571.702.381
02/09/2016 21:00,25.56,37308,1051,41,0,1318,4,2414,571.702.381
02/09/2016 22:00,24.24,35794,1047,35,0,1337,3,2422,571.702.381
02/09/2016 23:00,23.7,33831,1066,32,61,1344,5,2508,571.702.381
03/09/2016 00:00,23.24,32001,1162,28,51,1292,4,2537,571.702.381
03/09/2016 01:00,22.52,31006,1151,28,49,1279,3,2510,571.702.381
03/09/2016 02:00,22.07,30376,1133,27,55,1322,4,2541,571.702.381
03/09/2016 03:00,22.04,30164,1084,26,59,1362,3,2534,571.702.381
03/09/2016 04:00,21.83,30131,1051,23,62,1392,4,2532,571.702.381
03/09/2016 05:00,22.13,30272,1066,19,64,1426,4,2579,571.702.381
03/09/2016 06:00,22.84,30858,1085,16,69,1406,5,2581,571.702.381
03/09/2016 07:00,23.85,32263,1133,17,75,1354,6,2585,571.702.381
03/09/2016 08:00,24.3,33654,1199,22,83,1362,10,2676,571.702.381
03/09/2016 09:00,24.71,35310,1289,29,88,1373,17,2796,571.702.381
03/09/2016 10:00,24.54,36084,1317,39,97,1410,20,2883,571.702.381
03/09/2016 11:00,24.31,36291,1273,45,106,1506,21,2951,571.702.381
03/09/2016 12:00,23.87,36168,1297,55,112,1581,18,3063,571.702.381
03/09/2016 13:00,23.28,35842,1339,57,117,1671,16,3200,571.702.381
03/09/2016 14:00,23.02,35419,1312,60,122,1749,18,3261,571.702.381
03/09/2016 15:00,23.41,35250,1245,63,122,1768,19,3217,571.702.381
03/09/2016 16:00,23.73,35383,1125,64,113,1745,15,3062,571.702.381
03/09/2016 17:00,24.2,35865,922,65,106,1669,12,2774,571.702.381
03/09/2016 18:00,25.31,36080,733,66,97,1593,12,2501,571.702.381
03/09/2016 19:00,25.37,35985,587,68,94,1561,15,2325,571.702.381
03/09/2016 20:00,25.52,35917,478,68,99,1568,13,2226,571.702.381
03/09/2016 21:00,25.19,35506,429,66,103,1536,10,2144,571.702.381
03/09/2016 22:00,24.8,34388,403,63,106,1545,6,2123,571.702.381
03/09/2016 23:00,24.22,32859,360,58,141,1748,12,2319,571.702.381
04/09/2016 00:00,23.82,31628,314,62,134,1706,13,2229,571.702.381
04/09/2016 01:00,23.33,30667,243,59,126,1638,10,2076,571.702.381
04/09/2016 02:00,21.22,30208,213,57,118,1535,8,1931,571.702.381
04/09/2016 03:00,19.59,30085,241,60,109,1441,8,1859,571.702.381
04/09/2016 04:00,18.85,29961,333,64,96,1388,7,1888,571.702.381
04/09/2016 05:00,18.75,29938,443,71,84,1313,7,1918,571.702.381
04/09/2016 06:00,18.68,30094,549,75,78,1247,7,1956,571.702.381
04/09/2016 07:00,20.56,31051,663,78,73,1122,8,1944,571.702.381
04/09/2016 08:00,22.55,31884,694,77,74,1113,13,1971,571.702.381
04/09/2016 09:00,23.57,33544,671,76,71,1022,16,1856,571.702.381
04/09/2016 10:00,23.87,34768,696,79,68,905,18,1766,571.702.381
04/09/2016 11:00,24.18,35268,741,82,66,834,17,1740,571.702.381
04/09/2016 12:00,24,35408,804,82,55,795,17,1753,571.702.381
04/09/2016 13:00,23.8,35364,866,78,40,756,17,1757,571.702.381
04/09/2016 14:00,23.57,35233,912,75,31,780,16,1814,571.702.381
04/09/2016 15:00,23.29,35108,936,68,22,792,13,1831,571.702.381
04/09/2016 16:00,23.56,35361,943,60,18,791,8,1820,571.702.381
04/09/2016 17:00,23.84,36016,942,49,19,880,4,1894,571.702.381
04/09/2016 18:00,24.32,36422,928,41,20,1022,2,2013,571.702.381
04/09/2016 19:00,24.88,36794,926,34,25,1154,1,2140,571.702.381
04/09/2016 20:00,25.83,36990,965,30,32,1323,1,2351,571.702.381
04/09/2016 21:00,25.29,36616,1035,27,40,1560,1,2663,571.702.381
04/09/2016 22:00,24.95,35289,1126,24,44,1727,1,2922,571.702.381
04/09/2016 23:00,23.56,33294,1167,25,30,1951,3,3176,571.702.381
05/09/2016 00:00,21.67,32063,827,22,33,1973,3,2858,5.761.428.571
05/09/2016 01:00,20.48,31597,893,20,34,1987,3,2937,5.761.428.571
05/09/2016 02:00,20.21,31208,958,18,36,1994,4,3010,5.761.428.571
05/09/2016 03:00,19.9,31259,895,19,39,1916,3,2872,5.761.428.571
05/09/2016 04:00,21.31,31725,862,20,40,1891,3,2816,5.761.428.571
05/09/2016 05:00,23.08,33589,869,22,40,1766,3,2700,5.761.428.571
05/09/2016 06:00,25.69,36897,854,24,38,1607,3,2526,5.761.428.571
05/09/2016 07:00,27.77,40521,795,25,35,1319,3,2177,5.761.428.571
05/09/2016 08:00,30.13,41276,671,25,33,979,2,1710,5.761.428.571
05/09/2016 09:00,29.65,41757,558,26,32,752,2,1370,5.761.428.571
05/09/2016 10:00,29.84,41887,489,27,32,601,2,1151,5.761.428.571
05/09/2016 11:00,30.19,41837,406,29,34,522,2,993,5.761.428.571
05/09/2016 12:00,30.03,41626,323,30,38,462,3,856,5.761.428.571
05/09/2016 13:00,29.14,41525,258,30,39,419,5,751,5.761.428.571
05/09/2016 14:00,28.99,41264,207,29,39,385,4,664,5.761.428.571
05/09/2016 15:00,28.45,40812,168,30,40,366,4,608,5.761.428.571
05/09/2016 16:00,27.95,40421,145,28,44,317,4,538,5.761.428.571
05/09/2016 17:00,28.1,40361,138,27,47,280,4,496,5.761.428.571
05/09/2016 18:00,28.82,40127,124,29,56,285,4,498,5.761.428.571
05/09/2016 19:00,30.06,40109,108,30,66,317,4,525,5.761.428.571
05/09/2016 20:00,29.54,39911,101,32,75,408,5,621,5.761.428.571
05/09/2016 21:00,29.26,39114,121,33,81,528,4,767,5.761.428.571
05/09/2016 22:00,26.3,37238,174,27,84,633,4,922,5.761.428.571
05/09/2016 23:00,24.75,34716,235,18,66,797,2,1118,5.761.428.571
06/09/2016 00:00,24.18,32976,141,14,59,922,2,1138,5.761.428.571
06/09/2016 01:00,23.89,31993,205,11,50,1009,1,1276,5.761.428.571
06/09/2016 02:00,23.57,31633,280,11,39,1023,1,1354,5.761.428.571
06/09/2016 03:00,22.72,31620,354,13,32,1029,1,1429,5.761.428.571
06/09/2016 04:00,22.92,32050,450,13,27,1059,1,1550,5.761.428.571
06/09/2016 05:00,24.13,33997,560,13,23,1140,1,1737,5.761.428.571
06/09/2016 06:00,27.34,37303,649,13,20,1198,1,1881,5.761.428.571
06/09/2016 07:00,29.48,40964,721,12,16,1080,1,1830,5.761.428.571
06/09/2016 08:00,30.06,41657,693,13,14,1039,1,1760,5.761.428.571
06/09/2016 09:00,29.96,42030,702,14,13,1203,2,1934,5.761.428.571
06/09/2016 10:00,29.43,42183,878,18,13,1380,2,2291,5.761.428.571
06/09/2016 11:00,28.09,42107,1082,24,14,1663,4,2787,5.761.428.571
06/09/2016 12:00,26.17,41628,1233,33,17,1909,6,3198,5.761.428.571
06/09/2016 13:00,25.89,41613,1374,42,21,2168,8,3613,5.761.428.571
06/09/2016 14:00,25.73,41370,1457,50,27,2468,10,4012,5.761.428.571
06/09/2016 15:00,25.73,40996,1477,59,33,2713,15,4297,5.761.428.571
06/09/2016 16:00,26.06,40655,1479,65,35,2817,17,4413,5.761.428.571
06/09/2016 17:00,26.22,40682,1423,74,38,2996,20,4551,5.761.428.571
06/09/2016 18:00,26.35,40466,1324,85,42,3273,21,4745,5.761.428.571
06/09/2016 19:00,26.18,40394,1239,102,44,3499,24,4908,5.761.428.571
06/09/2016 20:00,26.17,40263,1220,121,48,3573,31,4993,5.761.428.571
06/09/2016 21:00,25.64,39280,1226,138,50,3605,35,5054,5.761.428.571
06/09/2016 22:00,24.22,37123,1237,146,52,3651,43,5129,5.761.428.571
06/09/2016 23:00,23.33,34467,1234,157,59,3741,15,5206,5.761.428.571
07/09/2016 00:00,20.6,32423,1297,162,73,3765,19,5316,5.761.428.571
07/09/2016 01:00,19.59,31332,1273,166,87,3728,20,5274,5.761.428.571
07/09/2016 02:00,18.94,30858,1225,172,104,3803,21,5325,5.761.428.571
07/09/2016 03:00,19.1,30789,1159,179,116,3809,22,5285,5.761.428.571
07/09/2016 04:00,20.21,31223,1068,184,127,3693,26,5098,5.761.428.571
07/09/2016 05:00,23.26,33242,912,187,140,3486,29,4754,5.761.428.571
07/09/2016 06:00,25.31,36617,718,189,144,3276,30,4357,5.761.428.571
07/09/2016 07:00,27.24,40479,596,187,153,3103,35,4074,5.761.428.571
07/09/2016 08:00,27.74,41123,541,183,159,2971,37,3891,5.761.428.571
07/09/2016 09:00,27.84,41563,502,178,173,2988,38,3879,5.761.428.571
07/09/2016 10:00,26.75,41866,467,170,184,2991,36,3848,5.761.428.571
07/09/2016 11:00,26.41,41880,436,159,200,2983,35,3813,5.761.428.571
07/09/2016 12:00,26.11,41478,412,152,210,2958,33,3765,5.761.428.571
07/09/2016 13:00,26.07,41478,401,142,215,2890,29,3677,5.761.428.571
07/09/2016 14:00,25.69,41251,386,130,217,2835,27,3595,5.761.428.571
07/09/2016 15:00,25.66,40930,352,117,202,2803,26,3500,5.761.428.571
07/09/2016 16:00,25.82,40608,324,105,185,2625,21,3260,5.761.428.571
07/09/2016 17:00,26.94,40634,291,95,172,2564,18,3140,5.761.428.571
07/09/2016 18:00,27.04,40323,256,86,151,2441,14,2948,5.761.428.571
07/09/2016 19:00,27.53,40290,232,78,139,2306,11,2766,5.761.428.571
07/09/2016 20:00,27.44,40098,221,72,122,2233,10,2658,5.761.428.571
07/09/2016 21:00,26.69,38960,213,67,107,2181,7,2575,5.761.428.571
07/09/2016 22:00,24.85,36872,213,63,96,2092,5,2469,5.761.428.571
07/09/2016 23:00,24.22,34256,214,51,132,2107,10,2514,5.761.428.571
08/09/2016 00:00,23.38,32198,170,48,123,1986,11,2338,5.761.428.571
08/09/2016 01:00,23,31204,163,47,115,1890,11,2226,5.761.428.571
08/09/2016 02:00,22.59,30783,169,51,111,1741,8,2080,5.761.428.571
08/09/2016 03:00,22.13,30727,178,56,105,1575,8,1922,5.761.428.571
08/09/2016 04:00,22.22,31187,186,62,99,1412,7,1766,5.761.428.571
08/09/2016 05:00,23.24,33188,204,62,92,1117,5,1480,5.761.428.571
08/09/2016 06:00,25.73,36572,217,60,75,912,4,1268,5.761.428.571
08/09/2016 07:00,28.33,40365,239,58,52,704,3,1056,5.761.428.571
08/09/2016 08:00,29.17,41195,276,57,39,565,3,940,5.761.428.571
08/09/2016 09:00,29.34,41579,296,58,37,477,3,871,5.761.428.571
08/09/2016 10:00,28.41,41850,364,64,40,313,2,783,5.761.428.571
08/09/2016 11:00,27.96,41864,520,71,46,236,2,875,5.761.428.571
08/09/2016 12:00,27.68,41460,742,78,47,205,2,1074,5.761.428.571
08/09/2016 13:00,27.28,41451,951,78,40,193,5,1267,5.761.428.571
08/09/2016 14:00,26.6,41179,1085,72,36,212,2,1407,5.761.428.571
08/09/2016 15:00,26.21,40852,1154,64,32,230,2,1482,5.761.428.571
08/09/2016 16:00,26.2,40566,1180,52,26,258,1,1517,5.761.428.571
08/09/2016 17:00,27.77,40509,1105,44,23,315,1,1488,5.761.428.571
08/09/2016 18:00,28.11,40201,939,37,20,430,1,1427,5.761.428.571
08/09/2016 19:00,28.35,40209,876,34,20,570,2,1502,5.761.428.571
08/09/2016 20:00,27.95,40051,888,31,19,746,2,1686,5.761.428.571
08/09/2016 21:00,26.95,39056,911,28,19,977,2,1937,5.761.428.571
08/09/2016 22:00,24.45,37118,947,23,19,1191,2,2182,5.761.428.571
08/09/2016 23:00,24.05,34561,898,11,16,1365,4,2294,5.761.428.571
09/09/2016 00:00,23.27,32515,534,9,18,1500,2,2063,5.761.428.571
09/09/2016 01:00,22.48,31558,505,7,20,1584,2,2118,5.761.428.571
09/09/2016 02:00,21.84,31134,537,5,22,1602,4,2170,5.761.428.571
09/09/2016 03:00,21.43,31068,549,3,23,1609,2,2186,5.761.428.571
09/09/2016 04:00,21.87,31549,511,2,25,1593,5,2136,5.761.428.571
09/09/2016 05:00,23.4,33602,527,2,24,1570,2,2125,5.761.428.571
09/09/2016 06:00,26.14,36941,569,2,21,1507,2,2101,5.761.428.571
09/09/2016 07:00,27.85,40637,600,1,17,1336,3,1957,5.761.428.571
09/09/2016 08:00,27.69,42344,617,1,12,1243,3,1876,5.761.428.571
09/09/2016 09:00,27.79,41677,602,1,12,1130,5,1750,5.761.428.571
09/09/2016 10:00,27.97,42088,591,1,14,1073,4,1683,5.761.428.571
09/09/2016 11:00,27.84,42025,582,2,15,1025,3,1627,5.761.428.571
09/09/2016 12:00,27.18,41397,567,3,16,981,2,1569,5.761.428.571
09/09/2016 13:00,26.17,41027,548,3,15,1066,3,1635,5.761.428.571
09/09/2016 14:00,25.71,40308,520,3,14,1050,3,1590,5.761.428.571
09/09/2016 15:00,25.73,39781,500,3,13,1041,3,1560,5.761.428.571
09/09/2016 16:00,26.03,39380,482,3,14,993,1,1493,5.761.428.571
09/09/2016 17:00,26.45,39290,447,3,18,1008,1,1477,5.761.428.571
09/09/2016 18:00,26.52,39126,386,4,28,1041,1,1460,5.761.428.571
09/09/2016 19:00,26.6,38901,340,6,39,963,4,1352,5.761.428.571
09/09/2016 20:00,26.28,38432,348,8,54,905,6,1321,5.761.428.571
09/09/2016 21:00,25.79,37425,391,10,67,904,5,1377,5.761.428.571
09/09/2016 22:00,24.43,35903,451,13,80,866,5,1415,5.761.428.571
09/09/2016 23:00,23.79,33833,522,22,59,783,3,1389,5.761.428.571
10/09/2016 00:00,24.04,31977,625,25,56,728,3,1437,5.761.428.571
10/09/2016 01:00,23.65,30923,731,25,51,684,1,1492,5.761.428.571
10/09/2016 02:00,23.38,30340,800,25,40,657,1,1523,5.761.428.571
10/09/2016 03:00,22.98,30158,823,24,34,647,1,1529,5.761.428.571
10/09/2016 04:00,22.61,30244,858,24,29,675,2,1588,5.761.428.571
10/09/2016 05:00,23.02,30452,903,22,25,707,2,1659,5.761.428.571
10/09/2016 06:00,23.4,30968,947,20,19,718,1,1705,5.761.428.571
10/09/2016 07:00,24.02,32249,990,15,13,670,1,1689,5.761.428.571
10/09/2016 08:00,24.37,33721,985,13,10,632,1,1641,5.761.428.571
10/09/2016 09:00,24.65,35444,993,13,10,656,1,1673,5.761.428.571
10/09/2016 10:00,24.22,36298,1086,14,10,731,3,1844,5.761.428.571
10/09/2016 11:00,24.13,36369,1143,16,11,787,2,1959,5.761.428.571
10/09/2016 12:00,23.92,36218,1121,18,14,802,1,1956,5.761.428.571
10/09/2016 13:00,23.8,35823,1079,19,15,868,1,1982,5.761.428.571
10/09/2016 14:00,23.72,35490,998,16,16,809,1,1840,5.761.428.571
10/09/2016 15:00,24.02,35375,871,14,16,737,1,1639,5.761.428.571
10/09/2016 16:00,24.4,35600,744,13,16,707,1,1481,5.761.428.571
10/09/2016 17:00,25.17,36248,645,12,16,696,1,1370,5.761.428.571
10/09/2016 18:00,26.36,36521,593,12,15,737,1,1358,5.761.428.571
10/09/2016 19:00,26.46,36614,617,12,14,797,1,1441,5.761.428.571
10/09/2016 20:00,26.34,36515,743,11,12,877,1,1644,5.761.428.571
10/09/2016 21:00,25.48,35784,970,10,11,932,3,1926,5.761.428.571
10/09/2016 22:00,24.35,34437,1225,9,9,1011,2,2256,5.761.428.571
10/09/2016 23:00,24.01,32752,1419,17,12,1093,3,2544,5.761.428.571
11/09/2016 00:00,22.99,31256,1580,15,11,1136,3,2745,5.761.428.571
11/09/2016 01:00,20.9,30295,1716,14,10,1277,1,3018,5.761.428.571
11/09/2016 02:00,20.39,29816,1796,13,10,1420,1,3240,5.761.428.571
11/09/2016 03:00,20.14,29614,1810,11,10,1557,1,3389,5.761.428.571
11/09/2016 04:00,20.07,29538,1827,10,10,1761,2,3610,5.761.428.571
11/09/2016 05:00,20.23,29516,1735,9,10,1941,2,3697,5.761.428.571
11/09/2016 06:00,20.44,29653,1493,8,10,2058,1,3570,5.761.428.571
11/09/2016 07:00,20.52,30446,1312,7,8,2022,1,3350,5.761.428.571
11/09/2016 08:00,22.95,32049,1148,6,8,2158,1,3321,5.761.428.571
11/09/2016 09:00,23.87,33591,1024,8,9,2372,1,3414,5.761.428.571
11/09/2016 10:00,23.97,33938,1002,10,10,2510,4,3536,5.761.428.571
11/09/2016 11:00,24.09,34530,949,14,11,2688,4,3666,5.761.428.571
11/09/2016 12:00,24.04,34683,873,19,12,2847,4,3755,5.761.428.571
11/09/2016 13:00,23.62,34763,807,23,13,2936,5,3784,5.761.428.571
11/09/2016 14:00,23.08,34799,682,28,14,2942,5,3671,5.761.428.571
11/09/2016 15:00,23.04,34691,542,30,13,2896,5,3486,5.761.428.571
11/09/2016 16:00,23.55,35062,423,36,13,2777,5,3254,5.761.428.571
11/09/2016 17:00,24.59,35819,305,44,13,2664,4,3030,5.761.428.571
11/09/2016 18:00,24.92,36441,195,52,13,2524,5,2789,5.761.428.571
11/09/2016 19:00,25.23,37144,126,62,12,2422,5,2627,5.761.428.571
11/09/2016 20:00,25.57,37365,89,69,12,2287,6,2463,5.761.428.571
11/09/2016 21:00,25.17,36744,68,72,12,2146,8,2306,5.761.428.571
11/09/2016 22:00,24.71,35238,71,72,13,2055,10,2221,5.761.428.571
11/09/2016 23:00,24.23,33101,82,70,17,1918,4,2091,5.761.428.571
12/09/2016 00:00,22.67,31671,122,64,18,1835,4,2043,5.773.095.238
12/09/2016 01:00,20.92,30900,171,59,18,1751,3,2002,5.773.095.238
12/09/2016 02:00,20.82,30563,239,55,20,1657,4,1975,5.773.095.238
12/09/2016 03:00,20.55,30667,354,51,17,1594,2,2018,5.773.095.238
12/09/2016 04:00,21,31249,507,47,16,1528,2,2100,5.773.095.238
12/09/2016 05:00,23.27,33081,638,43,13,1468,3,2165,5.773.095.238
12/09/2016 06:00,25.27,36574,729,40,10,1377,2,2158,5.773.095.238
12/09/2016 07:00,27.54,40354,834,37,9,1259,3,2142,5.773.095.238
12/09/2016 08:00,28.61,42078,881,35,8,1058,5,1987,5.773.095.238
12/09/2016 09:00,28.62,41808,866,32,8,895,6,1807,5.773.095.238
12/09/2016 10:00,27.97,42098,852,35,11,821,7,1726,5.773.095.238
12/09/2016 11:00,26.96,42141,816,36,14,801,9,1676,5.773.095.238
12/09/2016 12:00,26.54,41945,756,39,19,767,8,1589,5.773.095.238
12/09/2016 13:00,26.36,41659,730,43,23,738,7,1541,5.773.095.238
12/09/2016 14:00,26.06,41354,734,47,25,684,7,1497,5.773.095.238
12/09/2016 15:00,26.57,40985,751,53,25,601,7,1437,5.773.095.238
12/09/2016 16:00,27.65,40733,743,57,26,491,3,1320,5.773.095.238
12/09/2016 17:00,27.87,40706,700,59,27,475,2,1263,5.773.095.238
12/09/2016 18:00,27.91,40664,671,61,27,518,2,1279,5.773.095.238
12/09/2016 19:00,28.01,40929,678,63,27,586,4,1358,5.773.095.238
12/09/2016 20:00,27.68,40748,654,62,27,682,4,1429,5.773.095.238
12/09/2016 21:00,26.23,39622,621,59,27,733,5,1445,5.773.095.238
12/09/2016 22:00,25.14,37489,622,53,23,760,2,1460,5.773.095.238
12/09/2016 23:00,24.39,34799,605,46,20,847,2,1520,5.773.095.238
13/09/2016 00:00,23.21,32774,561,38,19,834,2,1454,5.773.095.238
13/09/2016 01:00,22.92,31811,542,31,19,803,2,1397,5.773.095.238
13/09/2016 02:00,22.64,31452,519,25,18,763,3,1328,5.773.095.238
13/09/2016 03:00,22.3,31435,489,21,18,737,2,1267,5.773.095.238
13/09/2016 04:00,22.35,31962,473,17,16,703,2,1211,5.773.095.238
13/09/2016 05:00,23.52,33927,491,15,15,694,2,1217,5.773.095.238
13/09/2016 06:00,25.69,37446,531,14,14,648,3,1210,5.773.095.238
13/09/2016 07:00,28.14,41029,578,13,12,545,4,1152,5.773.095.238
13/09/2016 08:00,29.07,41654,596,14,10,420,3,1043,5.773.095.238
13/09/2016 09:00,28.79,41755,570,17,10,356,4,957,5.773.095.238
13/09/2016 10:00,28.54,41989,560,20,11,286,6,883,5.773.095.238
13/09/2016 11:00,27.76,41984,599,24,12,263,6,904,5.773.095.238
13/09/2016 12:00,26.96,41820,685,28,14,269,6,1002,5.773.095.238
13/09/2016 13:00,26.72,41560,760,30,18,258,5,1071,5.773.095.238
13/09/2016 14:00,26.26,41208,833,32,23,250,5,1143,5.773.095.238
13/09/2016 15:00,25.97,40929,885,28,25,247,4,1189,5.773.095.238
13/09/2016 16:00,26.63,40611,895,26,29,257,2,1209,5.773.095.238
13/09/2016 17:00,27.25,40813,884,26,34,297,1,1242,5.773.095.238
13/09/2016 18:00,27.11,40681,884,30,39,389,1,1343,5.773.095.238
13/09/2016 19:00,27.26,40646,970,32,42,510,4,1558,5.773.095.238
13/09/2016 20:00,26.53,40491,1023,32,43,565,5,1668,5.773.095.238
13/09/2016 21:00,25.64,39350,1056,30,42,668,6,1802,5.773.095.238
13/09/2016 22:00,24.48,37202,1135,60,39,744,4,1982,5.773.095.238
13/09/2016 23:00,23.4,34658,1187,40,57,781,2,2067,5.773.095.238
14/09/2016 00:00,22.62,32705,1118,36,50,785,2,1991,5.773.095.238
14/09/2016 01:00,22.06,31778,1068,31,42,827,2,1970,5.773.095.238
14/09/2016 02:00,21.54,31373,1015,27,42,835,2,1921,5.773.095.238
14/09/2016 03:00,21.57,31336,957,23,41,877,1,1899,5.773.095.238
14/09/2016 04:00,22.72,31828,940,19,35,882,1,1877,5.773.095.238
14/09/2016 05:00,23.45,33583,929,16,29,943,1,1918,5.773.095.238
14/09/2016 06:00,25.7,36950,922,13,23,838,1,1797,5.773.095.238
14/09/2016 07:00,28.35,40596,913,9,19,759,2,1702,5.773.095.238
14/09/2016 08:00,29.11,41127,821,6,18,676,3,1524,5.773.095.238
14/09/2016 09:00,29.13,41362,692,4,20,548,1,1265,5.773.095.238
14/09/2016 10:00,28.8,41731,627,3,21,387,1,1039,5.773.095.238
14/09/2016 11:00,28.76,41759,614,4,21,362,4,1005,5.773.095.238
14/09/2016 12:00,28.32,41608,633,4,22,367,4,1030,5.773.095.238
14/09/2016 13:00,27.99,41406,661,5,21,352,3,1042,5.773.095.238
14/09/2016 14:00,27.28,41210,703,5,19,389,1,1117,5.773.095.238
14/09/2016 15:00,27.04,40894,747,6,17,426,4,1200,5.773.095.238
14/09/2016 16:00,27.7,40542,766,6,15,461,2,1250,5.773.095.238
14/09/2016 17:00,28.31,40533,775,6,15,508,3,1307,5.773.095.238
14/09/2016 18:00,27.93,40400,788,6,20,607,3,1424,5.773.095.238
14/09/2016 19:00,27.76,40632,858,6,23,705,4,1596,5.773.095.238
14/09/2016 20:00,26.79,40432,952,6,26,837,6,1827,5.773.095.238
14/09/2016 21:00,25.29,39237,974,7,29,969,7,1986,5.773.095.238
14/09/2016 22:00,24.57,37132,960,8,32,1107,4,2111,5.773.095.238
14/09/2016 23:00,23.42,34654,928,10,20,1132,1,2091,5.773.095.238
15/09/2016 00:00,22.2,32713,829,12,20,1170,1,2032,5.773.095.238
15/09/2016 01:00,21.17,31753,798,14,16,1185,1,2014,5.773.095.238
15/09/2016 02:00,20.88,31395,752,15,15,1209,1,1992,5.773.095.238
15/09/2016 03:00,20.86,31327,695,16,15,1208,1,1935,5.773.095.238
15/09/2016 04:00,21.67,31799,655,16,14,1170,1,1856,5.773.095.238
15/09/2016 05:00,23.12,33526,621,16,13,1124,1,1775,5.773.095.238
15/09/2016 06:00,25.38,37230,589,15,12,1119,1,1736,5.773.095.238
15/09/2016 07:00,27.96,40687,558,14,12,927,2,1513,5.773.095.238
15/09/2016 08:00,28.81,41281,480,13,11,705,2,1211,5.773.095.238
15/09/2016 09:00,29.12,41724,392,15,10,548,1,966,5.773.095.238
15/09/2016 10:00,28.26,41915,350,18,10,402,1,781,5.773.095.238
15/09/2016 11:00,28.35,41941,353,23,10,347,4,737,5.773.095.238
15/09/2016 12:00,28.02,41817,385,29,12,278,3,707,5.773.095.238
15/09/2016 13:00,28.21,41634,437,36,12,246,1,732,5.773.095.238
15/09/2016 14:00,27.32,41365,510,42,13,235,1,801,5.773.095.238
15/09/2016 15:00,26.89,41103,591,47,13,229,3,883,5.773.095.238
15/09/2016 16:00,26.89,40744,679,45,13,239,1,977,5.773.095.238
15/09/2016 17:00,27.75,40722,716,42,14,253,2,1027,5.773.095.238
15/09/2016 18:00,28.53,40653,696,45,14,296,1,1052,5.773.095.238
15/09/2016 19:00,28.61,40864,722,50,16,350,1,1139,5.773.095.238
15/09/2016 20:00,27.47,40636,826,57,19,437,4,1343,5.773.095.238
15/09/2016 21:00,25.78,39384,924,66,17,554,4,1565,5.773.095.238
15/09/2016 22:00,23.94,37264,920,71,15,638,4,1648,5.773.095.238
15/09/2016 23:00,23.43,34611,878,82,17,771,4,1752,5.773.095.238
16/09/2016 00:00,21.79,32624,797,83,15,776,4,1675,5.773.095.238
16/09/2016 01:00,20.87,31669,730,84,15,805,5,1639,5.773.095.238
16/09/2016 02:00,20.71,31272,684,85,18,840,6,1633,5.773.095.238
16/09/2016 03:00,20.77,31256,671,85,18,923,5,1702,5.773.095.238
16/09/2016 04:00,21,31785,690,86,22,1016,6,1820,5.773.095.238
16/09/2016 05:00,22.85,33608,724,86,21,1115,4,1950,5.773.095.238
16/09/2016 06:00,25.65,37288,800,85,21,1187,4,2097,5.773.095.238
16/09/2016 07:00,26.91,40987,945,82,21,1164,5,2217,5.773.095.238
16/09/2016 08:00,27.17,41577,1069,74,20,1102,7,2272,5.773.095.238
16/09/2016 09:00,26.95,41934,1201,65,20,1030,6,2322,5.773.095.238
16/09/2016 10:00,26.95,42326,1403,57,20,1041,7,2528,5.773.095.238
16/09/2016 11:00,26.71,42286,1618,51,21,1059,7,2756,5.773.095.238
16/09/2016 12:00,26.37,41964,1808,46,23,1052,7,2936,5.773.095.238
16/09/2016 13:00,25.93,41240,1970,43,24,1055,6,3098,5.773.095.238
16/09/2016 14:00,25.54,40602,2027,41,23,1046,7,3144,5.773.095.238
16/09/2016 15:00,25.43,40038,2014,40,29,1058,11,3152,5.773.095.238
16/09/2016 16:00,25.7,39728,1972,39,38,1069,9,3127,5.773.095.238
16/09/2016 17:00,25.76,39823,1835,39,51,1145,10,3080,5.773.095.238
16/09/2016 18:00,25.76,39880,1679,38,69,1278,8,3072,5.773.095.238
16/09/2016 19:00,25.86,39901,1577,36,84,1355,9,3061,5.773.095.238
16/09/2016 20:00,25.49,39359,1521,32,104,1395,10,3062,5.773.095.238
16/09/2016 21:00,24.77,38126,1496,28,97,1421,9,3051,5.773.095.238
16/09/2016 22:00,23.63,36442,1465,23,89,1401,6,2984,5.773.095.238
16/09/2016 23:00,23.3,34221,1433,16,88,1303,3,2843,5.773.095.238
17/09/2016 00:00,23.64,32370,1295,15,90,1205,3,2608,5.773.095.238
17/09/2016 01:00,23.18,31369,1328,14,90,1147,3,2582,5.773.095.238
17/09/2016 02:00,22.9,30876,1340,14,90,1147,3,2594,5.773.095.238
17/09/2016 03:00,22.02,30751,1299,15,88,1131,3,2536,5.773.095.238
17/09/2016 04:00,21.66,30863,1250,16,85,1115,3,2469,5.773.095.238
17/09/2016 05:00,22.08,31233,1249,15,80,1107,6,2457,5.773.095.238
17/09/2016 06:00,23.61,31822,1279,13,70,1045,3,2410,5.773.095.238
17/09/2016 07:00,24.14,33084,1288,12,65,958,4,2327,5.773.095.238
17/09/2016 08:00,24.4,34290,1320,10,60,886,5,2281,5.773.095.238
17/09/2016 09:00,24.86,36061,1351,11,55,860,6,2283,5.773.095.238
17/09/2016 10:00,24.96,37014,1357,11,55,826,7,2256,5.773.095.238
17/09/2016 11:00,24.92,37181,1338,10,55,769,5,2177,5.773.095.238
17/09/2016 12:00,24.7,37141,1310,12,50,727,4,2103,5.773.095.238
17/09/2016 13:00,24.39,36905,1299,14,50,681,5,2049,5.773.095.238
17/09/2016 14:00,24.23,36631,1297,15,50,655,3,2020,5.773.095.238
17/09/2016 15:00,24.13,36451,1299,16,50,637,2,2004,5.773.095.238
17/09/2016 16:00,24.26,36716,1297,18,50,614,4,1983,5.773.095.238
17/09/2016 17:00,24.58,37407,1275,19,55,615,3,1967,5.773.095.238
17/09/2016 18:00,24.81,37810,1206,20,65,608,3,1902,5.773.095.238
17/09/2016 19:00,25.59,38073,1149,19,66,623,3,1860,5.773.095.238
17/09/2016 20:00,25.28,37730,1175,17,69,658,4,1923,5.773.095.238
17/09/2016 21:00,24.41,36816,1180,15,65,661,4,1925,5.773.095.238
17/09/2016 22:00,23.89,35476,1161,13,60,668,5,1907,5.773.095.238
17/09/2016 23:00,23.06,33872,1157,8,88,647,2,1902,5.773.095.238
18/09/2016 00:00,22.3,32536,887,6,77,632,2,1604,5.773.095.238
18/09/2016 01:00,22.21,31645,866,7,75,657,2,1607,5.773.095.238
18/09/2016 02:00,21.45,31176,837,8,69,631,2,1547,5.773.095.238
18/09/2016 03:00,20.78,31025,795,10,60,617,2,1484,5.773.095.238
18/09/2016 04:00,20.49,31022,758,12,50,592,2,1414,5.773.095.238
18/09/2016 05:00,21.15,31207,728,12,44,582,4,1370,5.773.095.238
18/09/2016 06:00,21.52,31397,730,12,35,554,2,1333,5.773.095.238
18/09/2016 07:00,22.61,32073,759,11,33,517,2,1322,5.773.095.238
18/09/2016 08:00,23.47,33170,784,10,33,448,1,1276,5.773.095.238
18/09/2016 09:00,24.12,34795,818,9,33,418,3,1281,5.773.095.238
18/09/2016 10:00,24.27,35886,887,7,33,402,4,1333,5.773.095.238
18/09/2016 11:00,24.39,36289,904,7,33,384,3,1331,5.773.095.238
18/09/2016 12:00,24.31,36240,830,7,30,379,1,1247,5.773.095.238
18/09/2016 13:00,24.33,36063,765,9,30,354,2,1160,5.773.095.238
18/09/2016 14:00,24.16,35862,738,10,25,340,1,1114,5.773.095.238
18/09/2016 15:00,24.13,35783,745,11,25,338,1,1120,5.773.095.238
18/09/2016 16:00,24.19,36155,750,10,25,327,1,1113,5.773.095.238
18/09/2016 17:00,24.48,36916,736,10,25,303,1,1075,5.773.095.238
18/09/2016 18:00,25.87,37674,711,10,30,327,1,1079,5.773.095.238
18/09/2016 19:00,27.09,38375,709,11,30,335,2,1087,5.773.095.238
18/09/2016 20:00,27.48,38358,697,9,30,352,2,1090,5.773.095.238
18/09/2016 21:00,25.85,37449,670,8,30,359,3,1070,5.773.095.238
18/09/2016 22:00,24.76,35870,622,8,25,345,3,1003,5.773.095.238
18/09/2016 23:00,24.24,33870,536,10,25,326,1,898,5.773.095.238
19/09/2016 00:00,23.68,32433,394,10,22,311,1,738,5.697.083.333
19/09/2016 01:00,23.47,31661,365,10,15,302,1,693,5.697.083.333
19/09/2016 02:00,23.15,31372,297,12,15,320,1,645,5.697.083.333
19/09/2016 03:00,22.56,31440,238,14,11,325,1,589,5.697.083.333
19/09/2016 04:00,23.04,32020,212,16,11,300,2,541,5.697.083.333
19/09/2016 05:00,24.25,33920,203,17,11,292,1,524,5.697.083.333
19/09/2016 06:00,28,37485,197,16,11,280,1,505,5.697.083.333
19/09/2016 07:00,31.86,41146,195,15,11,248,2,471,5.697.083.333
19/09/2016 08:00,31.97,42712,197,14,11,182,2,406,5.697.083.333
19/09/2016 09:00,31.91,42106,196,14,11,143,1,365,5.697.083.333
19/09/2016 10:00,31.86,42288,187,14,11,122,2,336,5.697.083.333
19/09/2016 11:00,31.31,42237,175,14,11,104,2,306,5.697.083.333
19/09/2016 12:00,30.16,42007,163,14,11,97,3,288,5.697.083.333
19/09/2016 13:00,30.11,41905,153,14,15,95,1,278,5.697.083.333
19/09/2016 14:00,29.97,41567,154,15,15,103,1,288,5.697.083.333
19/09/2016 15:00,29.75,41270,158,17,20,121,3,319,5.697.083.333
19/09/2016 16:00,29.69,40982,170,17,22,157,1,367,5.697.083.333
19/09/2016 17:00,29.6,41131,167,18,22,216,3,426,5.697.083.333
19/09/2016 18:00,29.86,41147,139,19,25,319,1,503,5.697.083.333
19/09/2016 19:00,30.02,41506,125,19,30,364,2,540,5.697.083.333
19/09/2016 20:00,29.8,41134,109,19,33,427,4,592,5.697.083.333
19/09/2016 21:00,27.56,39812,95,19,33,514,4,665,5.697.083.333
19/09/2016 22:00,25.33,37684,97,17,30,578,3,725,5.697.083.333
19/09/2016 23:00,24.85,35162,100,20,22,699,2,843,5.697.083.333
20/09/2016 00:00,24.12,33212,114,21,20,722,2,879,5.697.083.333
20/09/2016 01:00,24.07,32313,129,23,20,717,1,890,5.697.083.333
20/09/2016 02:00,23.29,31941,164,28,19,680,1,892,5.697.083.333
20/09/2016 03:00,23.27,31967,218,32,18,639,1,908,5.697.083.333
20/09/2016 04:00,23.59,32505,265,36,20,600,2,923,5.697.083.333
20/09/2016 05:00,24.25,34513,300,36,21,526,1,884,5.697.083.333
20/09/2016 06:00,27.92,38127,318,35,19,481,1,854,5.697.083.333
20/09/2016 07:00,30,41610,323,31,19,394,3,770,5.697.083.333
20/09/2016 08:00,30.94,42667,318,30,24,339,4,715,5.697.083.333
20/09/2016 09:00,29.59,41985,304,29,29,293,3,658,5.697.083.333
20/09/2016 10:00,29.41,42295,278,32,32,285,4,631,5.697.083.333
20/09/2016 11:00,29.12,42134,262,33,35,285,4,619,5.697.083.333
20/09/2016 12:00,28.95,42018,282,36,38,291,5,652,5.697.083.333
20/09/2016 13:00,28.69,41946,324,39,40,302,4,709,5.697.083.333
20/09/2016 14:00,27.92,41548,364,39,45,301,6,755,5.697.083.333
20/09/2016 15:00,27.87,41265,389,39,50,305,7,790,5.697.083.333
20/09/2016 16:00,28.17,40988,398,41,52,311,4,806,5.697.083.333
20/09/2016 17:00,28.52,41080,386,43,53,305,4,791,5.697.083.333
20/09/2016 18:00,29.04,41077,370,45,54,310,2,781,5.697.083.333
20/09/2016 19:00,29.51,41395,369,44,56,313,4,786,5.697.083.333
20/09/2016 20:00,29,40992,376,42,58,322,7,805,5.697.083.333
20/09/2016 21:00,27.56,39671,382,38,59,339,7,825,5.697.083.333
20/09/2016 22:00,25.1,37518,386,35,59,322,4,806,5.697.083.333
20/09/2016 23:00,24.75,35048,333,32,85,296,4,750,5.697.083.333
21/09/2016 00:00,24.55,33161,228,32,75,266,4,605,5.697.083.333
21/09/2016 01:00,24.21,32251,202,32,70,248,4,556,5.697.083.333
21/09/2016 02:00,23.68,31876,201,35,62,244,4,546,5.697.083.333
21/09/2016 03:00,23.71,31901,208,38,60,234,4,544,5.697.083.333
21/09/2016 04:00,24.04,32438,219,41,59,227,7,553,5.697.083.333
21/09/2016 05:00,24.71,34258,221,41,59,233,5,559,5.697.083.333
21/09/2016 06:00,27.6,37846,211,41,54,233,6,545,5.697.083.333
21/09/2016 07:00,29.94,41238,215,38,43,212,7,515,5.697.083.333
21/09/2016 08:00,30.34,41596,214,35,44,189,7,489,5.697.083.333
21/09/2016 09:00,29.87,41962,208,33,44,179,9,473,5.697.083.333
21/09/2016 10:00,29.49,41910,210,33,46,164,14,467,5.697.083.333
21/09/2016 11:00,29.29,41897,200,31,46,154,11,442,5.697.083.333
21/09/2016 12:00,28.74,41784,185,32,44,155,13,429,5.697.083.333
21/09/2016 13:00,28.5,41806,184,35,44,146,11,420,5.697.083.333
21/09/2016 14:00,27.64,41564,192,38,46,152,10,438,5.697.083.333
21/09/2016 15:00,27.84,41286,195,43,47,154,12,451,5.697.083.333
21/09/2016 16:00,28.44,41046,202,46,47,153,11,459,5.697.083.333
21/09/2016 17:00,28.27,41147,212,46,51,164,9,482,5.697.083.333
21/09/2016 18:00,28.75,41251,214,48,56,194,7,519,5.697.083.333
21/09/2016 19:00,29.94,41711,230,47,74,221,8,580,5.697.083.333
21/09/2016 20:00,29.17,41216,263,44,86,232,12,637,5.697.083.333
21/09/2016 21:00,27.53,39888,296,40,84,233,12,665,5.697.083.333
21/09/2016 22:00,25.12,37759,338,35,80,209,11,673,5.697.083.333
21/09/2016 23:00,24.91,35229,386,33,76,165,4,664,5.697.083.333
22/09/2016 00:00,24.31,33591,537,30,72,162,4,805,5.697.083.333
22/09/2016 01:00,24.17,32584,589,33,69,156,4,851,5.697.083.333
22/09/2016 02:00,24.04,32200,615,36,66,167,3,887,5.697.083.333
22/09/2016 03:00,23.78,32206,622,40,64,167,4,897,5.697.083.333
22/09/2016 04:00,23.82,32773,608,42,62,165,5,882,5.697.083.333
22/09/2016 05:00,24.54,34628,573,43,60,156,3,835,5.697.083.333
22/09/2016 06:00,26.93,37975,555,41,51,152,3,802,5.697.083.333
22/09/2016 07:00,28.93,41355,540,37,41,132,5,755,5.697.083.333
22/09/2016 08:00,28.89,42600,479,36,37,118,4,674,5.697.083.333
22/09/2016 09:00,28.7,42591,420,35,39,116,3,613,5.697.083.333
22/09/2016 10:00,28.34,42715,445,35,38,109,5,632,5.697.083.333
22/09/2016 11:00,27.24,42638,471,39,37,101,2,650,5.697.083.333
22/09/2016 12:00,27.24,42405,462,44,37,112,2,657,5.697.083.333
22/09/2016 13:00,26.96,42269,445,47,40,117,3,652,5.697.083.333
22/09/2016 14:00,26.59,42041,402,48,41,125,2,618,5.697.083.333
22/09/2016 15:00,26.81,41792,342,48,44,132,2,568,5.697.083.333
22/09/2016 16:00,27.23,41510,298,48,46,146,2,540,5.697.083.333
22/09/2016 17:00,27.96,41659,264,48,47,147,4,510,5.697.083.333
22/09/2016 18:00,28.16,41788,252,49,44,151,3,499,5.697.083.333
22/09/2016 19:00,28.93,42095,271,49,43,168,4,535,5.697.083.333
22/09/2016 20:00,27.65,41546,300,49,39,186,6,580,5.697.083.333
22/09/2016 21:00,26.6,40077,313,52,35,202,6,608,5.697.083.333
22/09/2016 22:00,24.99,37846,312,52,31,227,5,627,5.697.083.333
22/09/2016 23:00,24.66,35386,322,49,26,258,1,656,5.697.083.333
23/09/2016 00:00,24.43,33787,415,51,24,266,1,757,5.697.083.333
23/09/2016 01:00,24.18,32831,468,56,24,284,1,833,5.697.083.333
23/09/2016 02:00,24.09,32423,506,60,24,291,1,882,5.697.083.333
23/09/2016 03:00,24.09,32351,516,65,25,303,2,911,5.697.083.333
23/09/2016 04:00,24.3,32881,507,68,26,317,3,921,5.697.083.333
23/09/2016 05:00,24.69,34738,489,69,25,333,1,917,5.697.083.333
23/09/2016 06:00,26.94,38581,469,69,23,324,1,886,5.697.083.333
23/09/2016 07:00,27.72,42121,458,63,18,303,3,845,5.697.083.333
23/09/2016 08:00,28.3,43157,471,59,14,294,1,839,5.697.083.333
23/09/2016 09:00,28.47,42483,478,53,16,313,1,861,5.697.083.333
23/09/2016 10:00,28.29,42755,516,50,22,327,6,921,5.697.083.333
23/09/2016 11:00,27.58,42650,637,50,32,350,2,1071,5.697.083.333
23/09/2016 12:00,27.28,42185,810,52,39,401,2,1304,5.697.083.333
23/09/2016 13:00,26.91,41630,1023,53,57,453,5,1591,5.697.083.333
23/09/2016 14:00,26.35,41062,1154,53,72,554,7,1840,5.697.083.333
23/09/2016 15:00,25.98,40479,1173,51,73,616,8,1921,5.697.083.333
23/09/2016 16:00,25.99,40237,1195,48,77,673,9,2002,5.697.083.333
23/09/2016 17:00,26.29,40447,1120,44,78,797,11,2050,5.697.083.333
23/09/2016 18:00,26.36,40713,1023,40,68,856,9,1996,5.697.083.333
23/09/2016 19:00,26.77,40779,1002,38,57,936,9,2042,5.697.083.333
23/09/2016 20:00,26.23,39936,1029,33,48,1024,9,2143,5.697.083.333
23/09/2016 21:00,25.63,38497,1029,30,38,1091,7,2195,5.697.083.333
23/09/2016 22:00,24.86,36927,1016,30,30,1126,5,2207,5.697.083.333
23/09/2016 23:00,24.39,34746,995,26,52,1306,2,2381,5.697.083.333
24/09/2016 00:00,24.26,33210,823,26,59,1270,2,2180,5.697.083.333
24/09/2016 01:00,23.96,32138,778,28,70,1197,4,2077,5.697.083.333
24/09/2016 02:00,23.75,31663,718,28,87,1118,6,1957,5.697.083.333
24/09/2016 03:00,23.99,31565,657,28,103,1034,7,1829,5.697.083.333
24/09/2016 04:00,23.97,31688,627,28,115,944,10,1724,5.697.083.333
24/09/2016 05:00,24.02,32149,576,29,119,855,8,1587,5.697.083.333
24/09/2016 06:00,24.43,32803,472,29,113,723,8,1345,5.697.083.333
24/09/2016 07:00,24.78,33956,392,28,97,617,7,1141,5.697.083.333
24/09/2016 08:00,25.32,35481,359,28,90,512,7,996,5.697.083.333
24/09/2016 09:00,25.87,37079,352,26,87,465,8,938,5.697.083.333
24/09/2016 10:00,25.57,37847,392,28,74,449,6,949,5.697.083.333
24/09/2016 11:00,25.41,37808,484,30,68,436,3,1021,5.697.083.333
24/09/2016 12:00,24.98,37541,602,32,64,429,3,1130,5.697.083.333
24/09/2016 13:00,24.84,37151,684,32,65,431,3,1215,5.697.083.333
24/09/2016 14:00,24.6,36767,715,31,63,440,2,1251,5.697.083.333
24/09/2016 15:00,24.78,36588,736,28,58,450,2,1274,5.697.083.333
24/09/2016 16:00,24.96,36848,782,23,50,455,1,1311,5.697.083.333
24/09/2016 17:00,25.62,37716,759,18,40,521,1,1339,5.697.083.333
24/09/2016 18:00,25.79,38431,674,16,34,631,1,1356,5.697.083.333
24/09/2016 19:00,25.95,38768,642,13,30,795,1,1481,5.697.083.333
24/09/2016 20:00,25.68,38014,667,12,26,983,3,1691,5.697.083.333
24/09/2016 21:00,25.2,36902,704,10,23,1086,3,1826,5.697.083.333
24/09/2016 22:00,24.64,35593,759,10,20,1158,3,1950,5.697.083.333
24/09/2016 23:00,24.28,34065,842,9,10,1442,1,2304,5.697.083.333
25/09/2016 00:00,23.96,32596,968,10,9,1394,1,2382,5.697.083.333
25/09/2016 01:00,22.86,31688,1014,12,9,1319,2,2356,5.697.083.333
25/09/2016 02:00,21.96,31207,1081,15,10,1278,1,2385,5.697.083.333
25/09/2016 03:00,20.75,31035,1155,18,12,1261,1,2447,5.697.083.333
25/09/2016 04:00,20.9,31004,1221,23,12,1276,1,2533,5.697.083.333
25/09/2016 05:00,21.85,31292,1265,27,12,1282,4,2590,5.697.083.333
25/09/2016 06:00,22.13,31517,1280,30,13,1268,1,2592,5.697.083.333
25/09/2016 07:00,22.81,32200,1299,30,12,1191,1,2533,5.697.083.333
25/09/2016 08:00,23.63,33172,1286,27,11,1063,1,2388,5.697.083.333
25/09/2016 09:00,23.94,34707,1267,24,10,980,2,2283,5.697.083.333
25/09/2016 10:00,23.87,35654,1327,21,10,979,3,2340,5.697.083.333
25/09/2016 11:00,24.01,35975,1471,20,10,987,1,2489,5.697.083.333
25/09/2016 12:00,23.88,35776,1718,20,10,983,1,2732,5.697.083.333
25/09/2016 13:00,23.85,35583,2030,18,9,986,2,3045,5.697.083.333
25/09/2016 14:00,23.57,35400,2179,16,9,922,1,3127,5.697.083.333
25/09/2016 15:00,23.44,35389,2134,16,8,904,1,3063,5.697.083.333
25/09/2016 16:00,23.77,35755,2029,18,9,965,1,3022,5.697.083.333
25/09/2016 17:00,24.24,36581,1884,22,11,1113,1,3031,5.697.083.333
25/09/2016 18:00,24.94,37572,1714,29,14,1267,1,3025,5.697.083.333
25/09/2016 19:00,25.38,38402,1654,35,19,1418,1,3127,5.697.083.333
25/09/2016 20:00,25.15,38043,1654,38,24,1535,3,3254,5.697.083.333
25/09/2016 21:00,24.68,37069,1604,39,28,1576,3,3250,5.697.083.333
25/09/2016 22:00,24.34,35490,1568,38,33,1604,3,3246,5.697.083.333
25/09/2016 23:00,24.09,33604,1490,32,0,1656,3,3181,5.697.083.333
26/09/2016 00:00,23.73,32052,1252,30,0,1601,2,2885,584.125
26/09/2016 01:00,23.59,31419,1132,27,0,1532,3,2694,584.125
26/09/2016 02:00,23.51,31199,999,25,0,1550,3,2577,584.125
26/09/2016 03:00,23.46,31294,839,23,0,1498,4,2364,584.125
26/09/2016 04:00,23.64,32245,710,20,0,1470,5,2205,584.125
26/09/2016 05:00,24.32,34193,570,17,0,1430,3,2020,584.125
26/09/2016 06:00,27.44,37820,404,14,0,1315,3,1736,584.125
26/09/2016 07:00,29.03,41499,288,11,0,1205,4,1508,584.125
26/09/2016 08:00,29.8,41893,219,7,0,1087,2,1315,584.125
26/09/2016 09:00,29.4,42222,169,6,0,944,2,1121,584.125
26/09/2016 10:00,29.25,42331,145,5,0,837,4,991,584.125
26/09/2016 11:00,29.02,42216,136,5,0,782,1,924,584.125
26/09/2016 12:00,28.88,41689,130,5,0,787,1,923,584.125
26/09/2016 13:00,28.64,41625,133,6,0,702,2,843,584.125
26/09/2016 14:00,27.92,41185,131,6,0,658,1,796,584.125
26/09/2016 15:00,28.48,40855,120,6,0,625,1,752,584.125
26/09/2016 16:00,28.61,40621,113,6,0,597,1,717,584.125
26/09/2016 17:00,28.61,40830,97,5,0,669,1,772,584.125
26/09/2016 18:00,28.97,41146,73,4,0,741,1,819,584.125
26/09/2016 19:00,29.95,41609,63,4,0,807,2,876,584.125
26/09/2016 20:00,28.62,40975,60,4,0,823,4,891,584.125
26/09/2016 21:00,27.01,39544,56,4,0,845,4,909,584.125
26/09/2016 22:00,25.45,37469,60,4,0,842,3,909,584.125
26/09/2016 23:00,24.88,34982,61,7,26,859,1,954,584.125
27/09/2016 00:00,24.83,33098,73,9,23,784,1,890,584.125
27/09/2016 01:00,24.61,32216,95,9,20,674,1,799,584.125
27/09/2016 02:00,24.43,31880,113,9,19,617,1,759,584.125
27/09/2016 03:00,24.4,31958,129,9,19,556,2,715,584.125
27/09/2016 04:00,24.58,32615,146,7,18,558,3,732,584.125
27/09/2016 05:00,24.96,34932,171,6,18,576,1,772,584.125
27/09/2016 06:00,27.36,38556,223,5,17,564,1,810,584.125
27/09/2016 07:00,29.54,41893,297,4,15,591,3,910,584.125
27/09/2016 08:00,29.79,43089,350,3,9,572,1,935,584.125
27/09/2016 09:00,29.3,42920,363,3,8,621,1,996,584.125
27/09/2016 10:00,28.53,43028,394,3,8,606,4,1015,584.125
27/09/2016 11:00,27.77,42812,514,4,9,678,3,1208,584.125
27/09/2016 12:00,26.97,42529,721,4,9,775,4,1513,584.125
27/09/2016 13:00,26.53,42265,943,5,9,960,4,1921,584.125
27/09/2016 14:00,25.87,41770,1148,6,9,1153,3,2319,584.125
27/09/2016 15:00,25.69,41481,1365,7,9,1367,3,2751,584.125
27/09/2016 16:00,25.84,41332,1602,7,9,1658,3,3279,584.125
27/09/2016 17:00,25.79,41630,1781,7,10,2008,4,3810,584.125
27/09/2016 18:00,25.74,42120,1931,9,14,2395,4,4353,584.125
27/09/2016 19:00,25.81,42528,2126,12,19,2777,7,4941,584.125
27/09/2016 20:00,25.12,41676,2430,18,25,3066,10,5549,584.125
27/09/2016 21:00,24.49,39772,2776,25,33,3385,11,6230,584.125
27/09/2016 22:00,23.65,37439,3084,33,43,3670,11,6841,584.125
27/09/2016 23:00,22.21,34753,3324,45,68,4065,11,7513,584.125
28/09/2016 00:00,20.7,33158,3504,55,90,4266,12,7927,584.125
28/09/2016 01:00,19.18,32343,3554,64,105,4437,12,8172,584.125
28/09/2016 02:00,17.44,31863,3528,72,120,4541,14,8275,584.125
28/09/2016 03:00,15.02,31894,3511,80,133,4618,18,8360,584.125
28/09/2016 04:00,15.65,32616,3515,90,145,4671,21,8442,584.125
28/09/2016 05:00,21.13,34675,3526,98,156,4598,20,8398,584.125
28/09/2016 06:00,24.51,38275,3603,107,162,4419,24,8315,584.125
28/09/2016 07:00,24.97,41676,3700,121,160,4252,25,8258,584.125
28/09/2016 08:00,25.35,42379,3798,134,167,4171,27,8297,584.125
28/09/2016 09:00,25.04,42454,3906,146,171,4043,36,8302,584.125
28/09/2016 10:00,24.9,42768,4027,159,178,3959,44,8367,584.125
28/09/2016 11:00,24.72,42776,4127,167,189,3737,43,8263,584.125
28/09/2016 12:00,24.58,42600,4193,174,208,3558,50,8183,584.125
28/09/2016 13:00,24.47,42575,4238,181,232,3419,59,8129,584.125
28/09/2016 14:00,24.31,42224,4238,185,246,3422,48,8139,584.125
28/09/2016 15:00,24.39,41876,4179,184,268,3396,33,8060,584.125
28/09/2016 16:00,24.52,41590,4100,168,275,3462,25,8030,584.125
28/09/2016 17:00,24.89,41804,3985,146,283,3481,37,7932,584.125
28/09/2016 18:00,25.15,42193,3756,114,283,3503,37,7693,584.125
28/09/2016 19:00,25.61,42691,3464,96,275,3602,30,7467,584.125
28/09/2016 20:00,24.95,41771,3170,81,264,3573,27,7115,584.125
28/09/2016 21:00,24.68,39942,2908,71,249,3479,25,6732,584.125
28/09/2016 22:00,24.07,37782,2645,65,241,3339,23,6313,584.125
28/09/2016 23:00,22.15,35270,2401,69,238,3280,25,6013,584.125
29/09/2016 00:00,20.08,33402,2335,58,238,3035,21,5687,584.125
29/09/2016 01:00,17.61,32641,2636,52,230,2654,20,5592,584.125
29/09/2016 02:00,19.27,32243,3018,45,224,2475,16,5778,584.125
29/09/2016 03:00,16.11,32004,3345,42,215,2286,16,5904,584.125
29/09/2016 04:00,17.3,32725,3591,40,199,2375,18,6223,584.125
29/09/2016 05:00,22.72,34850,3780,38,186,2510,13,6527,584.125
29/09/2016 06:00,25.35,38602,3927,34,175,2799,8,6943,584.125
29/09/2016 07:00,26.07,42247,4024,31,161,3043,9,7268,584.125
29/09/2016 08:00,26.39,42187,4067,32,155,3282,12,7548,584.125
29/09/2016 09:00,26.08,42496,4104,39,169,3609,12,7933,584.125
29/09/2016 10:00,25.77,42767,4137,49,182,3896,16,8280,584.125
29/09/2016 11:00,25.51,42875,4185,71,196,4180,25,8657,584.125
29/09/2016 12:00,24.92,42841,4218,100,219,4282,33,8852,584.125
29/09/2016 13:00,24.78,42872,4208,131,238,4405,43,9025,584.125
29/09/2016 14:00,24.3,42603,4209,157,249,4452,46,9113,584.125
29/09/2016 15:00,24.3,42375,4238,182,252,4504,57,9233,584.125
29/09/2016 16:00,24.3,42194,4262,200,261,4501,62,9286,584.125
29/09/2016 17:00,24.7,42320,4257,214,276,4609,62,9418,584.125
29/09/2016 18:00,25.55,42605,4196,222,297,4469,61,9245,584.125
29/09/2016 19:00,25.71,42880,4125,225,303,4466,61,9180,584.125
29/09/2016 20:00,25.05,42038,4057,224,300,4455,61,9097,584.125
29/09/2016 21:00,24.2,40232,3963,221,307,4558,59,9108,584.125
29/09/2016 22:00,23.02,38173,3841,219,317,4627,53,9057,584.125
29/09/2016 23:00,19.11,35561,3704,226,310,4680,49,8969,584.125
30/09/2016 00:00,16.44,33510,3763,224,313,4701,52,9053,584.125
30/09/2016 01:00,16.04,32578,3631,224,313,4670,51,8889,584.125
30/09/2016 02:00,14.47,32326,3496,224,309,4680,51,8760,584.125
30/09/2016 03:00,13.16,32442,3347,225,307,4638,51,8568,584.125
30/09/2016 04:00,19,33181,3102,219,307,4674,56,8358,584.125
30/09/2016 05:00,22.57,35320,2791,222,307,4663,52,8035,584.125
30/09/2016 06:00,24.74,39049,2551,224,304,4574,51,7704,584.125
30/09/2016 07:00,26.21,42577,2313,226,300,4482,52,7373,584.125
30/09/2016 08:00,26.63,43982,2162,226,304,4399,47,7138,584.125
30/09/2016 09:00,26.58,43169,2173,225,312,4414,46,7170,584.125
30/09/2016 10:00,26.58,43443,2269,224,317,4400,47,7257,584.125
30/09/2016 11:00,26.3,43347,2474,221,317,4420,44,7476,584.125
30/09/2016 12:00,26.09,43012,2667,216,312,4423,47,7665,584.125
30/09/2016 13:00,25.77,42571,2824,210,299,4378,50,7761,584.125
30/09/2016 14:00,25.09,41838,2910,203,274,4314,49,7750,584.125
30/09/2016 15:00,25.18,41341,2938,195,258,4227,48,7666,584.125
30/09/2016 16:00,25.22,41034,3000,195,241,4056,44,7536,584.125
30/09/2016 17:00,25.33,41423,2977,189,219,4031,40,7456,584.125
30/09/2016 18:00,25.8,42069,2821,178,200,3886,41,7126,584.125
30/09/2016 19:00,26.26,42143,2658,170,186,3957,36,7007,584.125
30/09/2016 20:00,25.42,40908,2574,164,175,3987,36,6936,584.125
30/09/2016 21:00,24.63,39283,2454,159,169,4012,35,6829,584.125
30/09/2016 22:00,24.21,37676,2261,146,162,4063,30,6662,584.125
30/09/2016 23:00,23.75,35610,2062,139,177,4184,27,6589,584.125
01/10/2016 00:00,23.18,33910,1873,139,177,4120,28,6337,584.125
01/10/2016 01:00,22.99,32859,1674,142,170,3946,27,5959,584.125
01/10/2016 02:00,22.91,32377,1440,149,170,3931,27,5717,584.125
01/10/2016 03:00,23.04,32285,1185,157,170,3814,21,5347,584.125
01/10/2016 04:00,23.25,32469,964,167,170,3691,20,5012,584.125
01/10/2016 05:00,23.71,33054,802,175,160,3544,22,4703,584.125
01/10/2016 06:00,24.47,33831,711,180,150,3436,18,4495,584.125
01/10/2016 07:00,25.24,35106,611,186,145,3265,20,4227,584.125
01/10/2016 08:00,25.63,36168,515,194,135,3059,22,3925,584.125
01/10/2016 09:00,26.08,37793,467,198,140,2907,28,3740,584.125
01/10/2016 10:00,26.44,38558,435,200,144,2719,33,3531,584.125
01/10/2016 11:00,26.2,38553,381,197,140,2613,32,3363,584.125
01/10/2016 12:00,26.02,38394,296,189,122,2492,33,3132,584.125
01/10/2016 13:00,25.83,38178,232,177,101,2390,34,2934,584.125
01/10/2016 14:00,25.78,37729,177,162,85,2206,26,2656,584.125
01/10/2016 15:00,25.79,37691,129,145,55,2007,22,2358,584.125
01/10/2016 16:00,25.99,38154,108,129,40,1888,15,2180,584.125
01/10/2016 17:00,26.48,39220,116,112,22,1795,9,2054,584.125
01/10/2016 18:00,27.27,40152,138,95,20,1754,6,2013,584.125
01/10/2016 19:00,27.48,40415,172,79,20,1800,4,2075,584.125
01/10/2016 20:00,27.01,39473,196,66,25,1699,7,1993,584.125
01/10/2016 21:00,26.23,38369,227,57,30,1630,7,1951,584.125
01/10/2016 22:00,25.77,37183,276,49,40,1545,6,1916,584.125
01/10/2016 23:00,25.52,35710,283,36,65,1410,3,1797,584.125
02/10/2016 00:00,25.27,34249,313,31,80,1392,3,1819,584.125
02/10/2016 01:00,24.78,33430,308,26,100,1368,3,1805,584.125
02/10/2016 02:00,24.66,33054,322,21,115,1432,3,1893,584.125
02/10/2016 03:00,24.55,32900,337,17,122,1452,5,1933,584.125
02/10/2016 04:00,24.38,32967,359,15,125,1459,11,1969,584.125
02/10/2016 05:00,24.51,33417,412,16,125,1529,15,2097,584.125
02/10/2016 06:00,24.73,33843,494,16,115,1496,21,2142,584.125
02/10/2016 07:00,24.97,34532,592,13,100,1425,20,2150,584.125
02/10/2016 08:00,25.94,35163,662,10,88,1337,17,2114,584.125
02/10/2016 09:00,26.27,36753,690,7,77,1206,14,1994,584.125
02/10/2016 10:00,26.44,37782,719,8,60,1124,11,1922,584.125
02/10/2016 11:00,26.46,38223,724,9,55,1130,6,1924,584.125
02/10/2016 12:00,26.19,38028,692,12,55,1200,7,1966,584.125
02/10/2016 13:00,25.81,37930,670,15,55,1247,8,1995,584.125
02/10/2016 14:00,25.54,37710,685,20,55,1307,6,2073,584.125
02/10/2016 15:00,25.37,37696,719,25,55,1323,6,2128,584.125
02/10/2016 16:00,25.65,38092,769,29,50,1350,8,2206,584.125
02/10/2016 17:00,26.39,38971,802,32,44,1475,8,2361,584.125
02/10/2016 18:00,27.34,40151,877,34,40,1589,8,2548,584.125
02/10/2016 19:00,27.81,40877,994,36,40,1815,7,2892,584.125
02/10/2016 20:00,27.33,40260,1084,35,40,1901,8,3068,584.125
02/10/2016 21:00,26.53,39267,1125,35,40,2078,9,3287,584.125
02/10/2016 22:00,26.11,37840,1184,37,35,2097,11,3364,584.125
02/10/2016 23:00,25.14,35959,1271,28,22,2097,5,3423,584.125
03/10/2016 00:00,25.74,34514,868,29,22,2144,6,3069,5.778.154.762
03/10/2016 01:00,25.39,33857,971,34,22,2177,6,3210,5.778.154.762
03/10/2016 02:00,24.82,33647,1074,40,25,2151,6,3296,5.778.154.762
03/10/2016 03:00,24.55,33836,1183,45,30,2144,7,3409,5.778.154.762
03/10/2016 04:00,24.69,34658,1313,48,33,2156,11,3561,5.778.154.762
03/10/2016 05:00,25.97,37126,1440,48,40,2178,12,3718,5.778.154.762
03/10/2016 06:00,27.83,40945,1586,48,50,2090,12,3786,5.778.154.762
03/10/2016 07:00,28.84,44661,1731,45,60,2001,18,3855,5.778.154.762
03/10/2016 08:00,29.25,44610,1864,44,70,1901,18,3897,5.778.154.762
03/10/2016 09:00,29.19,45054,2028,44,85,1739,23,3919,5.778.154.762
03/10/2016 10:00,28.8,45239,2220,48,95,1593,30,3986,5.778.154.762
03/10/2016 11:00,28.75,45131,2342,53,115,1582,29,4121,5.778.154.762
03/10/2016 12:00,28.06,44922,2423,56,125,1599,27,4230,5.778.154.762
03/10/2016 13:00,27.89,44513,2530,59,140,1581,28,4338,5.778.154.762
03/10/2016 14:00,27.75,44116,2540,63,155,1554,30,4342,5.778.154.762
03/10/2016 15:00,28.03,43712,2413,71,175,1506,33,4198,5.778.154.762
03/10/2016 16:00,28.14,43541,2284,80,195,1479,33,4071,5.778.154.762
03/10/2016 17:00,28.5,43963,2128,93,230,1527,28,4006,5.778.154.762
03/10/2016 18:00,28.96,44567,1885,104,260,1638,31,3918,5.778.154.762
03/10/2016 19:00,29.6,45007,1707,111,270,1814,34,3936,5.778.154.762
03/10/2016 20:00,28.5,44086,1611,112,275,1848,36,3882,5.778.154.762
03/10/2016 21:00,27.51,42241,1572,110,275,1855,35,3847,5.778.154.762
03/10/2016 22:00,26.68,40311,1563,106,275,1865,30,3839,5.778.154.762
03/10/2016 23:00,25.3,37898,1515,103,0,1884,17,3519,5.778.154.762
04/10/2016 00:00,25.63,36541,1645,104,0,1834,15,3598,5.778.154.762
04/10/2016 01:00,25.31,35733,1566,107,0,1813,15,3501,5.778.154.762
04/10/2016 02:00,24.19,35435,1492,115,0,1766,15,3388,5.778.154.762
04/10/2016 03:00,23.67,35526,1421,125,0,1732,16,3294,5.778.154.762
04/10/2016 04:00,24.18,36090,1351,134,0,1738,15,3238,5.778.154.762
04/10/2016 05:00,25.72,38089,1341,140,0,1732,13,3226,5.778.154.762
04/10/2016 06:00,27.78,41733,1392,143,0,1721,18,3274,5.778.154.762
04/10/2016 07:00,29.61,45082,1446,151,0,1622,23,3242,5.778.154.762
04/10/2016 08:00,30.34,46105,1504,160,0,1511,31,3206,5.778.154.762
04/10/2016 09:00,30.11,45271,1514,164,0,1405,40,3123,5.778.154.762
04/10/2016 10:00,28.8,45397,1546,165,0,1391,44,3146,5.778.154.762
04/10/2016 11:00,28.35,45293,1552,165,0,1439,44,3200,5.778.154.762
04/10/2016 12:00,28.58,45112,1435,165,0,1488,45,3133,5.778.154.762
04/10/2016 13:00,28.56,45014,1338,165,0,1527,47,3077,5.778.154.762
04/10/2016 14:00,28.48,44618,1358,167,0,1495,45,3065,5.778.154.762
04/10/2016 15:00,28.31,44331,1434,169,0,1496,40,3139,5.778.154.762
04/10/2016 16:00,28.11,44170,1516,169,0,1480,34,3199,5.778.154.762
04/10/2016 17:00,28.88,44601,1574,172,0,1514,35,3295,5.778.154.762
04/10/2016 18:00,29.84,45280,1596,174,0,1596,39,3405,5.778.154.762
04/10/2016 19:00,30.32,45683,1667,173,0,1721,43,3604,5.778.154.762
04/10/2016 20:00,28.37,44709,1753,172,0,1849,44,3818,5.778.154.762
04/10/2016 21:00,27.29,43287,1798,171,0,1992,45,4006,5.778.154.762
04/10/2016 22:00,26.38,41190,1819,167,0,2026,46,4058,5.778.154.762
04/10/2016 23:00,25.55,38783,1778,182,274,2148,43,4425,5.778.154.762
05/10/2016 00:00,25.48,37006,1806,181,277,2202,45,4511,5.778.154.762
05/10/2016 01:00,24.71,36138,1748,181,287,2243,47,4506,5.778.154.762
05/10/2016 02:00,23.91,35872,1661,181,291,2322,49,4504,5.778.154.762
05/10/2016 03:00,23.77,35995,1561,182,298,2443,50,4534,5.778.154.762
05/10/2016 04:00,24.98,36615,1533,182,306,2515,52,4588,5.778.154.762
05/10/2016 05:00,26.25,39068,1562,183,313,2506,50,4614,5.778.154.762
05/10/2016 06:00,28.11,42973,1653,181,316,2544,51,4745,5.778.154.762
05/10/2016 07:00,30.21,46499,1816,179,320,2396,54,4765,5.778.154.762
05/10/2016 08:00,31.2,46616,1972,177,324,2291,54,4818,5.778.154.762
05/10/2016 09:00,29.99,46724,2156,176,328,2198,56,4914,5.778.154.762
05/10/2016 10:00,29.29,46717,2406,176,330,2124,59,5095,5.778.154.762
05/10/2016 11:00,28.89,46432,2545,175,331,2022,57,5130,5.778.154.762
05/10/2016 12:00,28.37,45667,2491,175,331,1991,56,5044,5.778.154.762
05/10/2016 13:00,28.6,45536,2389,174,332,2004,57,4956,5.778.154.762
05/10/2016 14:00,28.48,45147,2294,174,333,2043,56,4900,5.778.154.762
05/10/2016 15:00,28.3,44787,2238,173,329,2109,55,4904,5.778.154.762
05/10/2016 16:00,28.21,44530,2217,172,329,2208,54,4980,5.778.154.762
05/10/2016 17:00,28.67,44934,2203,171,330,2401,53,5158,5.778.154.762
05/10/2016 18:00,29.21,45559,2199,169,326,2643,53,5390,5.778.154.762
05/10/2016 19:00,29.68,46049,2281,163,322,2829,53,5648,5.778.154.762
05/10/2016 20:00,28.54,44942,2402,156,320,2970,53,5901,5.778.154.762
05/10/2016 21:00,27.63,43420,2483,147,318,3034,49,6031,5.778.154.762
05/10/2016 22:00,26.74,41335,2498,137,315,3015,46,6011,5.778.154.762
05/10/2016 23:00,25.89,38778,2441,150,340,3055,45,6031,5.778.154.762
06/10/2016 00:00,25.92,37254,2418,147,340,3031,44,5980,5.778.154.762
06/10/2016 01:00,25.36,36352,2433,147,341,3037,43,6001,5.778.154.762
06/10/2016 02:00,25.23,36122,2425,148,340,3038,44,5995,5.778.154.762
06/10/2016 03:00,25.25,36241,2429,149,338,3061,45,6022,5.778.154.762
06/10/2016 04:00,25.68,36853,2441,148,337,3079,47,6052,5.778.154.762
06/10/2016 05:00,26.67,39191,2442,145,337,3109,45,6078,5.778.154.762
06/10/2016 06:00,28.33,43075,2460,141,335,3106,45,6087,5.778.154.762
06/10/2016 07:00,29.84,46582,2514,143,333,3030,47,6067,5.778.154.762
06/10/2016 08:00,30.64,46280,2628,146,328,2940,45,6087,5.778.154.762
06/10/2016 09:00,30.29,46522,2805,147,321,2855,45,6173,5.778.154.762
06/10/2016 10:00,30,46683,3012,146,314,2659,47,6178,5.778.154.762
06/10/2016 11:00,29.8,46537,3107,143,307,2533,44,6134,5.778.154.762
06/10/2016 12:00,29.44,45766,3084,140,297,2507,43,6071,5.778.154.762
06/10/2016 13:00,29.4,45625,3035,137,287,2497,44,6000,5.778.154.762
06/10/2016 14:00,29.08,45128,2941,133,274,2513,42,5903,5.778.154.762
06/10/2016 15:00,28.76,44758,2842,133,262,2585,40,5862,5.778.154.762
06/10/2016 16:00,28.75,44574,2746,134,282,2633,39,5834,5.778.154.762
06/10/2016 17:00,29.09,44867,2649,135,273,2705,36,5798,5.778.154.762
06/10/2016 18:00,29.39,45447,2550,133,263,2850,33,5829,5.778.154.762
06/10/2016 19:00,29.74,45738,2489,125,253,2994,31,5892,5.778.154.762
06/10/2016 20:00,28.98,44785,2475,117,245,2955,30,5822,5.778.154.762
06/10/2016 21:00,28.38,43275,2456,108,249,2927,29,5769,5.778.154.762
06/10/2016 22:00,27.64,41175,2434,102,235,2828,27,5626,5.778.154.762
06/10/2016 23:00,26.96,38662,2408,109,162,2743,18,5440,5.778.154.762
07/10/2016 00:00,27,36875,2266,113,155,2657,16,5207,5.778.154.762
07/10/2016 01:00,26.85,35916,2198,118,151,2556,15,5038,5.778.154.762
07/10/2016 02:00,26.92,35588,2144,128,148,2464,16,4900,5.778.154.762
07/10/2016 03:00,26.83,35677,2127,136,149,2394,18,4824,5.778.154.762
07/10/2016 04:00,27.22,36299,2149,140,151,2392,20,4852,5.778.154.762
07/10/2016 05:00,27.76,38652,2222,143,155,2383,22,4925,5.778.154.762
07/10/2016 06:00,29.39,42529,2308,147,163,2373,23,5014,5.778.154.762
07/10/2016 07:00,30.92,46052,2374,152,170,2341,26,5063,5.778.154.762
07/10/2016 08:00,31.38,46625,2397,157,176,2302,30,5062,5.778.154.762
07/10/2016 09:00,30.91,46828,2421,162,174,2311,33,5101,5.778.154.762
07/10/2016 10:00,30.35,46818,2471,166,174,2294,35,5140,5.778.154.762
07/10/2016 11:00,29.94,46284,2449,172,175,2351,35,5182,5.778.154.762
07/10/2016 12:00,29.43,45178,2347,177,178,2378,39,5119,5.778.154.762
07/10/2016 13:00,29.14,44401,2265,181,181,2383,41,5051,5.778.154.762
07/10/2016 14:00,28.97,43632,2158,184,184,2387,38,4951,5.778.154.762
07/10/2016 15:00,28.68,43017,2026,187,184,2402,33,4832,5.778.154.762
07/10/2016 16:00,28.67,42823,1919,188,186,2414,29,4736,5.778.154.762
07/10/2016 17:00,29.35,43240,1770,187,187,2498,29,4671,5.778.154.762
07/10/2016 18:00,29.97,44001,1655,184,189,2540,31,4599,5.778.154.762
07/10/2016 19:00,30.15,44028,1677,182,189,2608,33,4689,5.778.154.762
07/10/2016 20:00,29.05,42624,1766,180,188,2636,29,4799,5.778.154.762
07/10/2016 21:00,28.42,41089,1831,175,178,2624,25,4833,5.778.154.762
07/10/2016 22:00,28.05,39545,1829,170,170,2600,23,4792,5.778.154.762
07/10/2016 23:00,27.59,37710,1775,181,130,2666,29,4781,5.778.154.762
08/10/2016 00:00,28.05,36321,1699,181,125,2636,27,4668,5.778.154.762
08/10/2016 01:00,27.84,35346,1724,181,121,2613,27,4666,5.778.154.762
08/10/2016 02:00,27.7,34802,1746,180,116,2611,25,4678,5.778.154.762
08/10/2016 03:00,27.69,34706,1804,179,113,2581,25,4702,5.778.154.762
08/10/2016 04:00,27.72,34850,1909,178,113,2588,22,4810,5.778.154.762
08/10/2016 05:00,27.93,35521,1997,177,112,2594,23,4903,5.778.154.762
08/10/2016 06:00,28.42,36355,2043,178,115,2622,18,4976,5.778.154.762
08/10/2016 07:00,28.63,37634,2109,183,120,2614,17,5043,5.778.154.762
08/10/2016 08:00,28.94,39116,2259,186,124,2630,17,5216,5.778.154.762
08/10/2016 09:00,29.79,40672,2451,191,124,2594,18,5378,5.778.154.762
08/10/2016 10:00,29.86,41471,2641,194,118,2554,21,5528,5.778.154.762
08/10/2016 11:00,29.5,41407,2667,196,113,2557,18,5551,5.778.154.762
08/10/2016 12:00,28.9,41082,2543,199,105,2582,18,5447,5.778.154.762
08/10/2016 13:00,28.68,40607,2381,199,91,2549,19,5239,5.778.154.762
08/10/2016 14:00,28.68,40150,2251,199,81,2557,21,5109,5.778.154.762
08/10/2016 15:00,28.66,40030,2151,195,73,2609,20,5048,5.778.154.762
08/10/2016 16:00,28.94,40506,2053,194,64,2611,20,4942,5.778.154.762
08/10/2016 17:00,29.77,41629,1996,184,59,2663,17,4919,5.778.154.762
08/10/2016 18:00,30.94,42574,1958,171,63,2704,16,4912,5.778.154.762
08/10/2016 19:00,30.93,42679,1944,160,69,2733,16,4922,5.778.154.762
08/10/2016 20:00,29.93,41407,1971,150,78,2709,16,4924,5.778.154.762
08/10/2016 21:00,29.23,40367,1978,138,88,2668,13,4885,5.778.154.762
08/10/2016 22:00,29,39208,1958,124,96,2622,17,4817,5.778.154.762
08/10/2016 23:00,28.71,37690,1880,112,95,1948,19,4054,5.778.154.762
09/10/2016 00:00,28.55,36246,1482,105,120,1968,21,3696,5.778.154.762
09/10/2016 01:00,28.26,35338,1415,101,149,2011,18,3694,5.778.154.762
09/10/2016 02:00,28.12,34813,1367,97,174,2056,15,3709,5.778.154.762
09/10/2016 03:00,28.01,34730,1385,98,197,2097,17,3794,5.778.154.762
09/10/2016 04:00,27.86,34759,1458,99,210,2122,13,3902,5.778.154.762
09/10/2016 05:00,27.97,35131,1549,101,215,2152,16,4033,5.778.154.762
09/10/2016 06:00,28.32,35672,1638,100,212,2174,16,4140,5.778.154.762
09/10/2016 07:00,28.6,36374,1725,105,184,2129,16,4159,5.778.154.762
09/10/2016 08:00,29.02,37729,1786,109,156,2815,16,4882,5.778.154.762
09/10/2016 09:00,29.92,39512,1850,112,135,2708,14,4819,5.778.154.762
09/10/2016 10:00,30.02,40583,1908,115,118,2642,13,4796,5.778.154.762
09/10/2016 11:00,29.95,41010,1888,122,100,2614,13,4737,5.778.154.762
09/10/2016 12:00,29.41,40896,1813,126,88,2464,10,4501,5.778.154.762
09/10/2016 13:00,28.79,40778,1751,132,77,2389,10,4359,5.778.154.762
09/10/2016 14:00,28.53,40519,1675,138,67,2302,10,4192,5.778.154.762
09/10/2016 15:00,28.53,40488,1588,143,59,2215,12,4017,5.778.154.762
09/10/2016 16:00,28.74,41007,1498,146,60,2169,16,3889,5.778.154.762
09/10/2016 17:00,30.14,42030,1388,151,59,2101,16,3715,5.778.154.762
09/10/2016 18:00,31.8,43219,1316,153,67,2084,15,3635,5.778.154.762
09/10/2016 19:00,32.12,43660,1282,150,72,2060,17,3581,5.778.154.762
09/10/2016 20:00,31.08,42910,1283,146,89,2028,14,3560,5.778.154.762
09/10/2016 21:00,30.57,41777,1306,139,102,2017,15,3579,5.778.154.762
09/10/2016 22:00,29.78,40207,1323,129,115,2005,17,3589,5.778.154.762
09/10/2016 23:00,28.97,38306,1311,126,139,1872,17,3465,5.778.154.762
10/10/2016 00:00,29.07,36499,1205,120,143,1870,12,3350,5.628.809.524
10/10/2016 01:00,29.1,35705,1155,115,147,1872,12,3301,5.628.809.524
10/10/2016 02:00,28.93,35413,1096,111,150,1864,12,3233,5.628.809.524
10/10/2016 03:00,28.92,35577,1018,110,154,1879,16,3177,5.628.809.524
10/10/2016 04:00,28.93,36281,976,109,157,1894,18,3154,5.628.809.524
10/10/2016 05:00,29.18,38474,1006,107,160,1929,17,3219,5.628.809.524
10/10/2016 06:00,33.37,42540,1103,106,164,1962,19,3354,5.628.809.524
10/10/2016 07:00,37.47,46364,1176,107,171,1974,20,3448,5.628.809.524
10/10/2016 08:00,38.31,47708,1199,110,176,2005,21,3511,5.628.809.524
10/10/2016 09:00,36.3,47105,1248,109,174,2001,23,3555,5.628.809.524
10/10/2016 10:00,35.31,47410,1298,114,171,1990,25,3598,5.628.809.524
10/10/2016 11:00,34.49,47398,1333,119,170,1985,25,3632,5.628.809.524
10/10/2016 12:00,34.02,47248,1390,124,170,1986,25,3695,5.628.809.524
10/10/2016 13:00,33.97,47198,1475,127,170,1990,27,3789,5.628.809.524
10/10/2016 14:00,33.99,46849,1588,126,170,1986,26,3896,5.628.809.524
10/10/2016 15:00,33.03,46480,1714,122,171,1993,25,4025,5.628.809.524
10/10/2016 16:00,32.78,46413,1869,118,174,2001,22,4184,5.628.809.524
10/10/2016 17:00,33.95,47032,2031,115,178,2027,19,4370,5.628.809.524
10/10/2016 18:00,34.12,47628,2179,108,182,2045,17,4531,5.628.809.524
10/10/2016 19:00,35.79,47657,2329,100,189,2081,16,4715,5.628.809.524
10/10/2016 20:00,33.34,46245,2452,90,199,2047,17,4805,5.628.809.524
10/10/2016 21:00,31.35,44569,2535,79,195,1985,14,4808,5.628.809.524
10/10/2016 22:00,30.2,42398,2591,71,192,1957,16,4827,5.628.809.524
10/10/2016 23:00,29.18,39854,2588,67,158,1787,15,4615,5.628.809.524
11/10/2016 00:00,29.04,38223,2571,63,156,1731,11,4532,5.628.809.524
11/10/2016 01:00,28.73,37238,2558,58,154,1735,10,4515,5.628.809.524
11/10/2016 02:00,28.47,36850,2502,53,153,1725,9,4442,5.628.809.524
11/10/2016 03:00,28.52,36914,2444,53,155,1729,15,4396,5.628.809.524
11/10/2016 04:00,28.85,37506,2432,53,157,1759,17,4418,5.628.809.524
11/10/2016 05:00,29.61,39693,2425,53,159,1741,13,4391,5.628.809.524
11/10/2016 06:00,31.61,43724,2438,54,161,1692,14,4359,5.628.809.524
11/10/2016 07:00,35.5,47416,2448,51,163,1692,15,4369,5.628.809.524
11/10/2016 08:00,35.49,47771,2453,46,167,1643,18,4327,5.628.809.524
11/10/2016 09:00,35.47,48019,2475,41,163,1575,21,4275,5.628.809.524
11/10/2016 10:00,34.88,48311,2521,39,158,1478,24,4220,5.628.809.524
11/10/2016 11:00,34.07,48355,2564,37,154,1430,22,4207,5.628.809.524
11/10/2016 12:00,33.91,48081,2597,35,153,1397,19,4201,5.628.809.524
11/10/2016 13:00,33.79,47811,2613,35,153,1384,19,4204,5.628.809.524
11/10/2016 14:00,33.08,47335,2511,36,153,1346,19,4065,5.628.809.524
11/10/2016 15:00,32.76,47056,2353,36,156,1283,18,3846,5.628.809.524
11/10/2016 16:00,32.84,46983,2210,38,160,1293,15,3716,5.628.809.524
11/10/2016 17:00,34.08,47635,2113,40,165,1318,12,3648,5.628.809.524
11/10/2016 18:00,34.94,48321,2101,42,172,1313,10,3638,5.628.809.524
11/10/2016 19:00,35.29,48371,2099,43,175,1306,10,3633,5.628.809.524
11/10/2016 20:00,32.32,46818,2096,45,174,1259,11,3585,5.628.809.524
11/10/2016 21:00,30.92,45220,2079,43,166,1218,9,3515,5.628.809.524
11/10/2016 22:00,29.98,43062,2061,38,160,1182,11,3452,5.628.809.524
11/10/2016 23:00,29.27,40559,2030,36,138,1123,9,3336,5.628.809.524
12/10/2016 00:00,28.88,38765,1963,33,137,1078,6,3217,5.628.809.524
12/10/2016 01:00,28.32,37764,1950,28,135,1065,6,3184,5.628.809.524
12/10/2016 02:00,28.12,37453,1958,25,135,1034,6,3158,5.628.809.524
12/10/2016 03:00,28.25,37596,1936,22,139,1051,9,3157,5.628.809.524
12/10/2016 04:00,28.77,38418,1918,22,143,1076,10,3169,5.628.809.524
12/10/2016 05:00,30,40678,1939,22,148,1093,7,3209,5.628.809.524
12/10/2016 06:00,32.33,44767,1916,20,150,1112,6,3204,5.628.809.524
12/10/2016 07:00,36.71,48366,1822,17,150,1109,6,3104,5.628.809.524
12/10/2016 08:00,37.36,48827,1766,13,151,1102,6,3038,5.628.809.524
12/10/2016 09:00,36.71,48953,1845,11,145,1069,8,3078,5.628.809.524
12/10/2016 10:00,35.51,49068,1970,10,141,1039,12,3172,5.628.809.524
12/10/2016 11:00,35.61,48848,2026,9,136,988,10,3169,5.628.809.524
12/10/2016 12:00,35.25,48375,1970,9,131,971,9,3090,5.628.809.524
12/10/2016 13:00,35.21,48286,1884,7,129,962,7,2989,5.628.809.524
12/10/2016 14:00,34.72,48031,1826,7,124,946,8,2911,5.628.809.524
12/10/2016 15:00,33.95,48025,1779,7,123,922,8,2839,5.628.809.524
12/10/2016 16:00,33.94,47780,1702,9,123,906,7,2747,5.628.809.524
12/10/2016 17:00,35.68,48318,1618,10,126,872,6,2632,5.628.809.524
12/10/2016 18:00,35.88,48766,1575,12,129,881,5,2602,5.628.809.524
12/10/2016 19:00,36.85,48729,1575,11,131,876,5,2598,5.628.809.524
12/10/2016 20:00,34.42,47187,1569,10,133,839,7,2558,5.628.809.524
12/10/2016 21:00,32.51,45550,1539,9,127,822,6,2503,5.628.809.524
12/10/2016 22:00,31.38,43361,1541,9,118,784,8,2460,5.628.809.524
12/10/2016 23:00,29.94,40718,1527,6,106,748,10,2397,5.628.809.524
13/10/2016 00:00,29.5,39125,1489,6,100,721,7,2323,5.628.809.524
13/10/2016 01:00,28.93,38167,1479,5,92,695,5,2276,5.628.809.524
13/10/2016 02:00,28.48,37830,1522,5,88,703,4,2322,5.628.809.524
13/10/2016 03:00,28.54,37943,1526,6,86,724,5,2347,5.628.809.524
13/10/2016 04:00,29.07,38570,1458,7,83,746,6,2300,5.628.809.524
13/10/2016 05:00,30.77,40987,1460,7,82,775,4,2328,5.628.809.524
13/10/2016 06:00,34.26,44959,1544,8,81,790,4,2427,5.628.809.524
13/10/2016 07:00,37.91,48646,1610,8,74,784,5,2481,5.628.809.524
13/10/2016 08:00,39.42,49152,1673,7,67,774,5,2526,5.628.809.524
13/10/2016 09:00,38.48,49402,1781,6,54,761,5,2607,5.628.809.524
13/10/2016 10:00,37.79,49680,1923,6,46,735,7,2717,5.628.809.524
13/10/2016 11:00,36.55,49541,2073,6,49,719,7,2854,5.628.809.524
13/10/2016 12:00,35.64,49195,2229,7,46,706,7,2995,5.628.809.524
13/10/2016 13:00,35.65,48872,2362,9,44,708,7,3130,5.628.809.524
13/10/2016 14:00,34.88,48468,2452,10,39,728,9,3238,5.628.809.524
13/10/2016 15:00,34.09,48132,2512,11,43,754,8,3328,5.628.809.524
13/10/2016 16:00,33.97,48135,2550,15,47,801,7,3420,5.628.809.524
13/10/2016 17:00,34.87,48712,2560,16,54,874,7,3511,5.628.809.524
13/10/2016 18:00,35.77,49369,2604,17,67,961,7,3656,5.628.809.524
13/10/2016 19:00,35.6,49411,2699,16,78,1012,6,3811,5.628.809.524
13/10/2016 20:00,33.73,47767,2784,15,85,1047,7,3938,5.628.809.524
13/10/2016 21:00,31.93,46113,2857,14,79,1065,6,4021,5.628.809.524
13/10/2016 22:00,30.35,43954,2919,10,66,1082,9,4086,5.628.809.524
13/10/2016 23:00,29.27,41363,2920,10,76,1074,7,4087,5.628.809.524
14/10/2016 00:00,28.69,39936,2726,9,65,1046,4,3850,5.628.809.524
14/10/2016 01:00,28.2,39041,2703,8,56,1029,4,3800,5.628.809.524
14/10/2016 02:00,27.99,38706,2652,7,44,1033,4,3740,5.628.809.524
14/10/2016 03:00,28.07,38747,2621,5,39,1034,4,3703,5.628.809.524
14/10/2016 04:00,28.44,39334,2642,5,36,1065,3,3751,5.628.809.524
14/10/2016 05:00,30.06,41622,2707,4,36,1087,3,3837,5.628.809.524
14/10/2016 06:00,32.36,45517,2837,3,37,1127,3,4007,5.628.809.524
14/10/2016 07:00,35.52,49343,2990,4,41,1204,3,4242,5.628.809.524
14/10/2016 08:00,36.55,49751,3171,3,43,1275,4,4496,5.628.809.524
14/10/2016 09:00,35.47,50123,3411,3,43,1330,4,4791,5.628.809.524
14/10/2016 10:00,34.71,50430,3665,4,39,1406,5,5119,5.628.809.524
14/10/2016 11:00,33.1,50248,3836,3,40,1440,5,5324,5.628.809.524
14/10/2016 12:00,32.64,49775,3909,4,40,1478,5,5436,5.628.809.524
14/10/2016 13:00,31.71,49027,3954,4,43,1505,4,5510,5.628.809.524
14/10/2016 14:00,31.21,48186,3966,6,47,1601,5,5625,5.628.809.524
14/10/2016 15:00,31.2,47454,3947,7,56,1666,4,5680,5.628.809.524
14/10/2016 16:00,31.1,47287,3902,8,70,1703,3,5686,5.628.809.524
14/10/2016 17:00,32.43,47876,3821,7,86,1800,4,5718,5.628.809.524
14/10/2016 18:00,33.21,48646,3734,8,106,1882,5,5735,5.628.809.524
14/10/2016 19:00,33.1,48357,3701,8,118,1916,5,5748,5.628.809.524
14/10/2016 20:00,31,46652,3680,9,132,1988,6,5815,5.628.809.524
14/10/2016 21:00,30.04,44869,3639,9,140,2001,5,5794,5.628.809.524
14/10/2016 22:00,29.22,43191,3607,10,145,2016,6,5784,5.628.809.524
14/10/2016 23:00,28.44,41322,3596,13,155,2060,7,5831,5.628.809.524
15/10/2016 00:00,28.14,39659,3568,14,155,2129,7,5873,5.628.809.524
15/10/2016 01:00,27.53,38593,3618,15,155,2154,10,5952,5.628.809.524
15/10/2016 02:00,27.27,37949,3683,15,155,2205,8,6066,5.628.809.524
15/10/2016 03:00,27.15,37781,3738,15,160,2307,10,6230,5.628.809.524
15/10/2016 04:00,27.1,37976,3786,17,166,2378,9,6356,5.628.809.524
15/10/2016 05:00,27.74,38634,3839,19,170,2397,9,6434,5.628.809.524
15/10/2016 06:00,28.51,39533,3887,21,180,2481,11,6580,5.628.809.524
15/10/2016 07:00,29.17,40823,3920,19,188,2539,10,6676,5.628.809.524
15/10/2016 08:00,29.73,42602,3946,20,190,2575,12,6743,5.628.809.524
15/10/2016 09:00,30.63,43642,3974,20,200,2635,15,6844,5.628.809.524
15/10/2016 10:00,30.71,44526,3977,20,215,2650,16,6878,5.628.809.524
15/10/2016 11:00,30.93,44607,3925,20,222,2648,17,6832,5.628.809.524
15/10/2016 12:00,30.54,44256,3822,19,240,2729,16,6826,5.628.809.524
15/10/2016 13:00,30.47,43776,3732,19,250,2728,18,6747,5.628.809.524
15/10/2016 14:00,30.4,43407,3628,18,260,2801,18,6725,5.628.809.524
15/10/2016 15:00,30.43,43313,3485,20,270,2823,20,6618,5.628.809.524
15/10/2016 16:00,30.62,43781,3291,26,280,2873,20,6490,5.628.809.524
15/10/2016 17:00,31.39,45037,3031,31,290,2935,20,6307,5.628.809.524
15/10/2016 18:00,32.51,46057,2772,37,295,2995,23,6122,5.628.809.524
15/10/2016 19:00,32.19,45679,2529,39,290,2980,26,5864,5.628.809.524
15/10/2016 20:00,31.37,44193,2321,40,288,2923,24,5596,5.628.809.524
15/10/2016 21:00,30.84,42935,2133,40,285,2847,23,5328,5.628.809.524
15/10/2016 22:00,30.44,41707,1952,36,280,2774,20,5062,5.628.809.524
15/10/2016 23:00,29.84,40208,1785,37,285,2662,21,4790,5.628.809.524
16/10/2016 00:00,29.9,38563,1606,33,280,2559,17,4495,5.628.809.524
16/10/2016 01:00,29.44,37631,1445,29,270,2499,16,4259,5.628.809.524
16/10/2016 02:00,29.33,36648,1344,28,260,2468,14,4114,5.628.809.524
16/10/2016 03:00,29.21,36767,1282,27,255,2424,14,4002,5.628.809.524
16/10/2016 04:00,29.26,36784,1219,25,250,2388,11,3893,5.628.809.524
16/10/2016 05:00,29.47,37194,1169,25,245,2376,11,3826,5.628.809.524
16/10/2016 06:00,29.9,37898,1133,25,240,2361,12,3771,5.628.809.524
16/10/2016 07:00,30.41,38715,1089,24,235,2323,11,3682,5.628.809.524
16/10/2016 08:00,30.95,39755,1044,20,230,2272,11,3577,5.628.809.524
16/10/2016 09:00,31.39,41438,1019,18,240,2058,13,3348,5.628.809.524
16/10/2016 10:00,31.9,42513,1039,16,260,1983,18,3316,5.628.809.524
16/10/2016 11:00,32,42978,1051,16,265,1906,25,3263,5.628.809.524
16/10/2016 12:00,31.49,42890,1032,16,265,1828,23,3164,5.628.809.524
16/10/2016 13:00,30.99,42722,1011,15,250,1795,20,3091,5.628.809.524
16/10/2016 14:00,30.24,42489,989,14,225,1738,17,2983,5.628.809.524
16/10/2016 15:00,30.34,42607,966,15,205,1739,16,2941,5.628.809.524
16/10/2016 16:00,30.82,43277,976,18,195,1906,12,3107,5.628.809.524
16/10/2016 17:00,32.24,44442,1050,22,185,2002,10,3269,5.628.809.524
16/10/2016 18:00,33.49,45572,1187,29,185,2041,9,3451,5.628.809.524
16/10/2016 19:00,33.45,45562,1335,34,185,1966,12,3532,5.628.809.524
16/10/2016 20:00,32.29,44470,1426,38,180,1895,7,3546,5.628.809.524
16/10/2016 21:00,31.03,43168,1487,39,177,1716,7,3426,5.628.809.524
16/10/2016 22:00,30.29,41446,1566,40,170,1698,7,3481,5.628.809.524
16/10/2016 23:00,29.26,39598,1619,43,160,1769,9,3600,5.628.809.524
17/10/2016 00:00,29.72,38117,1551,42,155,1694,6,3448,5.480.178.571
17/10/2016 01:00,29.24,37277,1565,39,150,1637,6,3397,5.480.178.571
17/10/2016 02:00,28.93,36982,1599,35,145,1610,6,3395,5.480.178.571
17/10/2016 03:00,28.36,37065,1673,33,144,1602,8,3460,5.480.178.571
17/10/2016 04:00,29.01,37714,1777,32,140,1608,6,3563,5.480.178.571
17/10/2016 05:00,30.37,40004,1898,34,135,1638,7,3712,5.480.178.571
17/10/2016 06:00,33.18,44252,2021,36,135,1663,7,3862,5.480.178.571
17/10/2016 07:00,34.85,48085,2143,34,133,1683,7,4000,5.480.178.571
17/10/2016 08:00,35.58,48507,2265,34,135,1640,6,4080,5.480.178.571
17/10/2016 09:00,35.31,48789,2378,34,140,1602,7,4161,5.480.178.571
17/10/2016 10:00,35.02,48989,2474,38,150,1627,7,4296,5.480.178.571
17/10/2016 11:00,34.96,48891,2510,37,155,1634,6,4342,5.480.178.571
17/10/2016 12:00,34.49,48713,2473,38,165,1633,8,4317,5.480.178.571
17/10/2016 13:00,34.8,48495,2417,35,175,1573,11,4211,5.480.178.571
17/10/2016 14:00,34.21,48145,2313,33,177,1594,11,4128,5.480.178.571
17/10/2016 15:00,34.12,47866,2162,30,180,1579,9,3960,5.480.178.571
17/10/2016 16:00,33.98,47905,1983,32,195,1635,7,3852,5.480.178.571
17/10/2016 17:00,34.93,48520,1782,38,205,1706,7,3738,5.480.178.571
17/10/2016 18:00,35.89,49171,1600,48,215,1802,7,3672,5.480.178.571
17/10/2016 19:00,35.77,49032,1454,55,215,1838,9,3571,5.480.178.571
17/10/2016 20:00,33.59,47488,1318,57,215,1822,9,3421,5.480.178.571
17/10/2016 21:00,32.25,45792,1206,58,215,1738,9,3226,5.480.178.571
17/10/2016 22:00,31.94,43628,1111,55,210,1697,10,3083,5.480.178.571
17/10/2016 23:00,30.78,41007,1022,53,212,1707,12,3006,5.480.178.571
18/10/2016 00:00,31.13,38804,826,51,205,1606,8,2696,5.480.178.571
18/10/2016 01:00,30.35,37884,733,51,195,1529,7,2515,5.480.178.571
18/10/2016 02:00,30.03,37484,658,49,190,1442,7,2346,5.480.178.571
18/10/2016 03:00,30.06,37578,614,48,190,1383,7,2242,5.480.178.571
18/10/2016 04:00,30.84,38269,597,49,190,1403,7,2246,5.480.178.571
18/10/2016 05:00,31.93,40729,614,50,187,1431,8,2290,5.480.178.571
18/10/2016 06:00,34.88,44706,666,49,186,1389,7,2297,5.480.178.571
18/10/2016 07:00,37.88,48366,722,45,179,1343,8,2297,5.480.178.571
18/10/2016 08:00,39.89,48716,763,41,155,1242,9,2210,5.480.178.571
18/10/2016 09:00,39.47,48786,811,35,145,1162,8,2161,5.480.178.571
18/10/2016 10:00,38.38,48990,880,35,135,1119,7,2176,5.480.178.571
18/10/2016 11:00,37.47,49009,932,35,130,1066,6,2169,5.480.178.571
18/10/2016 12:00,35.98,48848,934,34,130,1054,6,2158,5.480.178.571
18/10/2016 13:00,35.46,48591,932,34,130,1037,6,2139,5.480.178.571
18/10/2016 14:00,35.35,48317,951,34,131,1017,9,2142,5.480.178.571
18/10/2016 15:00,35.05,48155,980,37,142,992,7,2158,5.480.178.571
18/10/2016 16:00,35.13,48290,1008,43,152,1008,7,2218,5.480.178.571
18/10/2016 17:00,36.97,49074,1026,50,161,1048,8,2293,5.480.178.571
18/10/2016 18:00,38.66,49644,1030,56,166,1108,9,2369,5.480.178.571
18/10/2016 19:00,37.16,49256,1026,59,170,1099,8,2362,5.480.178.571
18/10/2016 20:00,34.57,47639,980,59,163,1109,8,2319,5.480.178.571
18/10/2016 21:00,33.16,45677,903,56,156,1071,8,2194,5.480.178.571
18/10/2016 22:00,32.25,43360,845,51,150,1027,7,2080,5.480.178.571
18/10/2016 23:00,30.86,40643,759,58,151,1007,10,1985,5.480.178.571
19/10/2016 00:00,31.05,38293,921,56,151,979,8,2115,5.480.178.571
19/10/2016 01:00,30.56,37272,822,55,151,943,7,1978,5.480.178.571
19/10/2016 02:00,30.51,36923,726,57,152,899,7,1841,5.480.178.571
19/10/2016 03:00,30.68,36974,653,57,155,874,8,1747,5.480.178.571
19/10/2016 04:00,31.01,37608,594,58,157,868,7,1684,5.480.178.571
19/10/2016 05:00,32.25,39938,543,58,160,866,8,1635,5.480.178.571
19/10/2016 06:00,34.96,43892,514,54,167,844,9,1588,5.480.178.571
19/10/2016 07:00,39.38,47640,521,46,169,823,9,1568,5.480.178.571
19/10/2016 08:00,40.45,47870,558,40,171,813,11,1593,5.480.178.571
19/10/2016 09:00,39.82,48094,576,34,161,805,10,1586,5.480.178.571
19/10/2016 10:00,39.33,48338,596,31,157,797,11,1592,5.480.178.571
19/10/2016 11:00,38.65,48381,641,27,148,801,11,1628,5.480.178.571
19/10/2016 12:00,37.45,48215,730,26,145,798,10,1709,5.480.178.571
19/10/2016 13:00,37.33,48034,864,27,142,826,9,1868,5.480.178.571
19/10/2016 14:00,36.89,47793,982,31,146,849,10,2018,5.480.178.571
19/10/2016 15:00,36.1,47500,1098,38,154,900,9,2199,5.480.178.571
19/10/2016 16:00,37.35,47675,1254,47,162,965,11,2439,5.480.178.571
19/10/2016 17:00,39.56,48429,1370,56,171,1012,12,2621,5.480.178.571
19/10/2016 18:00,38.77,48856,1443,63,172,1078,13,2769,5.480.178.571
19/10/2016 19:00,37.49,48566,1480,64,170,1084,14,2812,5.480.178.571
19/10/2016 20:00,35.48,46987,1481,61,167,1108,14,2831,5.480.178.571
19/10/2016 21:00,33.96,45096,1498,55,160,1108,10,2831,5.480.178.571
19/10/2016 22:00,33.12,42838,1517,48,155,1083,7,2810,5.480.178.571
19/10/2016 23:00,31.73,40104,1527,55,160,1245,9,2996,5.480.178.571
20/10/2016 00:00,31.18,38432,1853,53,159,1240,7,3312,5.480.178.571
20/10/2016 01:00,30.97,37443,1928,52,159,1206,7,3352,5.480.178.571
20/10/2016 02:00,30.55,37078,1961,53,158,1220,7,3399,5.480.178.571
20/10/2016 03:00,30.58,37146,1969,53,159,1183,9,3373,5.480.178.571
20/10/2016 04:00,31.04,37712,1990,56,160,1198,8,3412,5.480.178.571
20/10/2016 05:00,32.21,39835,2007,59,162,1200,10,3438,5.480.178.571
20/10/2016 06:00,34.27,43798,1994,58,164,1229,12,3457,5.480.178.571
20/10/2016 07:00,38.85,47338,1993,50,162,1231,11,3447,5.480.178.571
20/10/2016 08:00,40.5,47312,1949,42,160,1222,10,3383,5.480.178.571
20/10/2016 09:00,40.37,47690,1834,36,156,1224,9,3259,5.480.178.571
20/10/2016 10:00,40.35,48217,1719,32,153,1188,10,3102,5.480.178.571
20/10/2016 11:00,40.02,48226,1564,32,148,1157,10,2911,5.480.178.571
20/10/2016 12:00,39.77,48107,1344,33,151,1136,11,2675,5.480.178.571
20/10/2016 13:00,40.21,47898,1141,37,154,1162,11,2505,5.480.178.571
20/10/2016 14:00,39.29,47596,1013,43,158,1177,12,2403,5.480.178.571
20/10/2016 15:00,38.79,47430,974,50,166,1258,12,2460,5.480.178.571
20/10/2016 16:00,40,47613,967,55,176,1378,13,2589,5.480.178.571
20/10/2016 17:00,41.4,48355,985,59,187,1453,14,2698,5.480.178.571
20/10/2016 18:00,42.66,48997,1033,61,196,1510,15,2815,5.480.178.571
20/10/2016 19:00,41.46,48700,1113,62,206,1532,14,2927,5.480.178.571
20/10/2016 20:00,38.22,47253,1152,59,213,1510,14,2948,5.480.178.571
20/10/2016 21:00,35.87,45657,1113,57,215,1514,14,2913,5.480.178.571
20/10/2016 22:00,33.95,43550,1085,53,217,1549,11,2915,5.480.178.571
20/10/2016 23:00,32.47,40883,1105,58,233,1608,13,3017,5.480.178.571
21/10/2016 00:00,32.18,39015,1355,57,233,1647,12,3304,5.480.178.571
21/10/2016 01:00,31.33,38037,1463,57,237,1764,13,3534,5.480.178.571
21/10/2016 02:00,30.83,37623,1586,59,242,1874,14,3775,5.480.178.571
21/10/2016 03:00,30.67,37690,1654,62,248,2003,15,3982,5.480.178.571
21/10/2016 04:00,31.93,38336,1699,66,255,2058,15,4093,5.480.178.571
21/10/2016 05:00,32.83,40426,1809,68,260,2106,17,4260,5.480.178.571
21/10/2016 06:00,35.3,44302,1983,68,262,2083,18,4414,5.480.178.571
21/10/2016 07:00,37.93,47859,2172,64,266,2099,18,4619,5.480.178.571
21/10/2016 08:00,38.87,49293,2326,59,268,2141,20,4814,5.480.178.571
21/10/2016 09:00,38.53,49507,2463,56,271,2143,20,4953,5.480.178.571
21/10/2016 10:00,38.53,49661,2589,53,272,2126,20,5060,5.480.178.571
21/10/2016 11:00,38.03,49358,2653,53,272,2055,21,5054,5.480.178.571
21/10/2016 12:00,37.71,48720,2638,55,274,2043,21,5031,5.480.178.571
21/10/2016 13:00,36.29,48057,2564,57,276,2027,21,4945,5.480.178.571
21/10/2016 14:00,35.78,47502,2457,61,280,2012,24,4834,5.480.178.571
21/10/2016 15:00,35.5,46940,2362,65,284,2008,23,4742,5.480.178.571
21/10/2016 16:00,35.77,46976,2311,70,287,2025,25,4718,5.480.178.571
21/10/2016 17:00,36.81,47728,2291,75,287,2067,26,4746,5.480.178.571
21/10/2016 18:00,38.28,48512,2267,78,287,2063,25,4720,5.480.178.571
21/10/2016 19:00,37.02,47841,2249,79,285,2032,24,4669,5.480.178.571
21/10/2016 20:00,35.17,46025,2238,78,281,2020,26,4643,5.480.178.571
21/10/2016 21:00,34.15,44382,2222,76,275,1989,27,4589,5.480.178.571
21/10/2016 22:00,33.51,42682,2207,75,272,1986,24,4564,5.480.178.571
21/10/2016 23:00,32.78,40815,2218,84,257,1829,15,4403,5.480.178.571
22/10/2016 00:00,33.03,39083,1983,90,263,1879,13,4228,5.480.178.571
22/10/2016 01:00,32.76,38066,2006,95,271,1974,16,4362,5.480.178.571
22/10/2016 02:00,32.54,37477,2038,100,277,2065,16,4496,5.480.178.571
22/10/2016 03:00,32.48,37245,2015,105,283,2123,19,4545,5.480.178.571
22/10/2016 04:00,32.6,37413,1973,113,290,2195,18,4589,5.480.178.571
22/10/2016 05:00,32.93,38150,1962,117,293,2274,19,4665,5.480.178.571
22/10/2016 06:00,33.33,39245,1969,121,295,2344,23,4752,5.480.178.571
22/10/2016 07:00,33.48,40650,1963,124,300,2416,22,4825,5.480.178.571
22/10/2016 08:00,33.86,41906,1968,126,303,2455,21,4873,5.480.178.571
22/10/2016 09:00,35,43607,2009,129,305,2475,21,4939,5.480.178.571
22/10/2016 10:00,35.45,44626,2081,133,306,2482,22,5024,5.480.178.571
22/10/2016 11:00,35.22,44850,2127,134,302,2507,24,5094,5.480.178.571
22/10/2016 12:00,35.24,44673,2158,137,300,2557,23,5175,5.480.178.571
22/10/2016 13:00,34.05,44358,2136,142,298,2549,23,5148,5.480.178.571
22/10/2016 14:00,33.7,44152,2044,148,295,2545,21,5053,5.480.178.571
22/10/2016 15:00,33.66,44109,1921,155,295,2529,21,4921,5.480.178.571
22/10/2016 16:00,34.15,44883,1830,160,300,2556,22,4868,5.480.178.571
22/10/2016 17:00,36.44,46290,1745,163,303,2623,25,4859,5.480.178.571
22/10/2016 18:00,37.74,47142,1656,164,303,2631,27,4781,5.480.178.571
22/10/2016 19:00,36.64,46392,1592,163,301,2661,28,4745,5.480.178.571
22/10/2016 20:00,35.27,44804,1516,163,301,2672,28,4680,5.480.178.571
22/10/2016 21:00,34.3,43512,1452,162,297,2626,25,4562,5.480.178.571
22/10/2016 22:00,33.57,42235,1425,161,291,2604,24,4505,5.480.178.571
22/10/2016 23:00,33.28,40688,1414,139,217,2519,28,4317,5.480.178.571
23/10/2016 00:00,32.83,38992,1768,139,210,2513,26,4656,5.480.178.571
23/10/2016 01:00,32.5,38043,1769,140,201,2527,26,4663,5.480.178.571
23/10/2016 02:00,32.22,37092,1747,140,185,2501,23,4596,5.480.178.571
23/10/2016 03:00,31.42,37286,1679,140,174,2446,25,4464,5.480.178.571
23/10/2016 04:00,31.63,37321,1592,140,164,2423,24,4343,5.480.178.571
23/10/2016 05:00,31.66,37758,1499,140,151,2374,22,4186,5.480.178.571
23/10/2016 06:00,32.37,38528,1349,141,141,2314,23,3968,5.480.178.571
23/10/2016 07:00,32.83,39333,1193,141,129,2268,20,3751,5.480.178.571
23/10/2016 08:00,33.47,40717,1075,141,117,2183,20,3536,5.480.178.571
23/10/2016 09:00,34.37,42721,987,140,113,2057,20,3317,5.480.178.571
23/10/2016 10:00,34.48,43740,926,140,112,1996,20,3194,5.480.178.571
23/10/2016 11:00,34.62,44204,854,139,113,1966,19,3091,5.480.178.571
23/10/2016 12:00,34.45,44141,795,139,116,1853,17,2920,5.480.178.571
23/10/2016 13:00,34.14,44013,765,137,122,1799,18,2841,5.480.178.571
23/10/2016 14:00,34.16,43898,723,135,128,1771,17,2774,5.480.178.571
23/10/2016 15:00,33.99,44085,678,133,146,1738,16,2711,5.480.178.571
23/10/2016 16:00,35.11,44874,631,131,163,1806,16,2747,5.480.178.571
23/10/2016 17:00,36.52,46147,594,131,184,1760,17,2686,5.480.178.571
23/10/2016 18:00,39.24,46924,582,130,211,1706,18,2647,5.480.178.571
23/10/2016 19:00,39.2,46695,573,128,226,1674,19,2620,5.480.178.571
23/10/2016 20:00,37.44,45492,559,124,234,1572,18,2507,5.480.178.571
23/10/2016 21:00,35.72,44318,567,120,232,1484,22,2425,5.480.178.571
23/10/2016 22:00,33.87,42685,578,116,229,1418,22,2363,5.480.178.571
23/10/2016 23:00,33.39,40818,551,111,223,1420,21,2326,5.480.178.571
24/10/2016 00:00,31.97,39950,481,109,224,1379,21,2214,5.362.619.048
24/10/2016 01:00,31.54,38995,421,107,227,1410,19,2184,5.362.619.048
24/10/2016 02:00,31.5,38487,390,106,231,1445,20,2192,5.362.619.048
24/10/2016 03:00,31.31,38516,381,104,237,1413,21,2156,5.362.619.048
24/10/2016 04:00,31.73,39109,393,103,247,1399,19,2161,5.362.619.048
24/10/2016 05:00,33.75,41627,435,103,259,1425,19,2241,5.362.619.048
24/10/2016 06:00,37.96,45843,496,103,266,1410,22,2297,5.362.619.048
24/10/2016 07:00,41.46,49694,540,104,272,1416,21,2353,5.362.619.048
24/10/2016 08:00,42.53,50863,541,102,279,1395,24,2341,5.362.619.048
24/10/2016 09:00,42.83,50703,515,104,291,1384,24,2318,5.362.619.048
24/10/2016 10:00,42.86,50879,462,102,299,1374,24,2261,5.362.619.048
24/10/2016 11:00,41.9,50918,425,104,303,1359,24,2215,5.362.619.048
24/10/2016 12:00,41.84,50777,419,104,301,1382,21,2227,5.362.619.048
24/10/2016 13:00,41.18,50516,426,104,300,1380,22,2232,5.362.619.048
24/10/2016 14:00,40.67,50187,436,106,295,1339,25,2201,5.362.619.048
24/10/2016 15:00,40.57,50014,464,110,290,1348,25,2237,5.362.619.048
24/10/2016 16:00,40.18,50498,510,114,281,1395,26,2326,5.362.619.048
24/10/2016 17:00,41.91,51424,534,118,273,1402,24,2351,5.362.619.048
24/10/2016 18:00,43.91,51637,528,121,262,1447,20,2378,5.362.619.048
24/10/2016 19:00,41.34,51063,533,120,249,1421,20,2343,5.362.619.048
24/10/2016 20:00,38.29,49054,508,117,230,1327,17,2199,5.362.619.048
24/10/2016 21:00,36.47,47282,480,115,222,1265,16,2098,5.362.619.048
24/10/2016 22:00,35.23,44997,494,113,208,1216,11,2042,5.362.619.048
24/10/2016 23:00,33.06,42392,524,105,173,1133,12,1947,5.362.619.048
25/10/2016 00:00,33.49,40175,285,105,161,1076,11,1638,5.362.619.048
25/10/2016 01:00,33.14,39203,267,103,149,1002,10,1531,5.362.619.048
25/10/2016 02:00,33.31,38830,257,102,138,933,9,1439,5.362.619.048
25/10/2016 03:00,33.37,38961,247,101,130,868,10,1356,5.362.619.048
25/10/2016 04:00,33.83,39717,262,98,121,809,9,1299,5.362.619.048
25/10/2016 05:00,35.71,42349,283,95,111,759,8,1256,5.362.619.048
25/10/2016 06:00,38.16,46774,292,92,98,718,9,1209,5.362.619.048
25/10/2016 07:00,43.88,51081,306,84,86,662,8,1146,5.362.619.048
25/10/2016 08:00,46.2,51467,294,79,74,605,6,1058,5.362.619.048
25/10/2016 09:00,46.03,51357,261,72,55,571,7,966,5.362.619.048
25/10/2016 10:00,46.52,51443,231,66,40,533,6,876,5.362.619.048
25/10/2016 11:00,46.78,51530,209,58,34,495,4,800,5.362.619.048
25/10/2016 12:00,45.94,51350,220,51,25,471,2,769,5.362.619.048
25/10/2016 13:00,44.99,51278,250,46,20,459,2,777,5.362.619.048
25/10/2016 14:00,44.18,50975,256,42,20,453,2,773,5.362.619.048
25/10/2016 15:00,43.42,50892,229,39,24,468,1,761,5.362.619.048
25/10/2016 16:00,43.95,51354,208,35,28,493,2,766,5.362.619.048
25/10/2016 17:00,46,52253,187,31,32,524,2,776,5.362.619.048
25/10/2016 18:00,46.79,52613,183,26,34,520,2,765,5.362.619.048
25/10/2016 19:00,46.53,51843,184,23,30,510,4,751,5.362.619.048
25/10/2016 20:00,42.88,49962,141,20,33,507,4,705,5.362.619.048
25/10/2016 21:00,38.07,48342,107,18,36,485,3,649,5.362.619.048
25/10/2016 22:00,36.31,46003,92,16,39,476,4,627,5.362.619.048
25/10/2016 23:00,34.27,43309,86,12,60,415,6,579,5.362.619.048
26/10/2016 00:00,34.95,40960,80,14,66,414,5,579,5.362.619.048
26/10/2016 01:00,34.3,39968,96,18,74,397,5,590,5.362.619.048
26/10/2016 02:00,34.39,39640,128,24,82,408,5,647,5.362.619.048
26/10/2016 03:00,34.52,39774,157,31,84,376,8,656,5.362.619.048
26/10/2016 04:00,34.47,40419,192,37,87,393,8,717,5.362.619.048
26/10/2016 05:00,35.16,42937,240,42,96,405,11,794,5.362.619.048
26/10/2016 06:00,38.88,47224,300,48,95,430,14,887,5.362.619.048
26/10/2016 07:00,45.28,51295,369,51,88,441,14,963,5.362.619.048
26/10/2016 08:00,46.47,51635,458,50,83,412,12,1015,5.362.619.048
26/10/2016 09:00,46.36,51528,571,46,84,453,9,1163,5.362.619.048
26/10/2016 10:00,46,51579,675,46,86,515,6,1328,5.362.619.048
26/10/2016 11:00,46,51528,786,46,90,579,7,1508,5.362.619.048
26/10/2016 12:00,45.08,51316,948,45,93,631,6,1723,5.362.619.048
26/10/2016 13:00,44.17,51113,1142,45,94,706,8,1995,5.362.619.048
26/10/2016 14:00,41.91,50739,1314,44,92,787,8,2245,5.362.619.048
26/10/2016 15:00,40.94,50601,1477,45,78,949,6,2555,5.362.619.048
26/10/2016 16:00,41.31,51107,1678,45,61,1176,4,2964,5.362.619.048
26/10/2016 17:00,43.87,51990,1918,41,44,1420,4,3427,5.362.619.048
26/10/2016 18:00,43.08,52160,2121,37,40,1604,4,3806,5.362.619.048
26/10/2016 19:00,41.56,51493,2311,34,31,1737,7,4120,5.362.619.048
26/10/2016 20:00,37.78,49450,2422,32,25,1911,5,4395,5.362.619.048
26/10/2016 21:00,36.83,47649,2442,33,21,2025,4,4525,5.362.619.048
26/10/2016 22:00,34.81,45285,2474,33,22,2149,4,4682,5.362.619.048
26/10/2016 23:00,33.07,42446,2425,37,28,2361,5,4856,5.362.619.048
27/10/2016 00:00,32.61,40359,2200,45,38,2384,5,4672,5.362.619.048
27/10/2016 01:00,32.09,39316,2012,51,47,2369,5,4484,5.362.619.048
27/10/2016 02:00,31.59,38871,1828,58,61,2279,6,4232,5.362.619.048
27/10/2016 03:00,31.74,39007,1645,63,72,2174,8,3962,5.362.619.048
27/10/2016 04:00,32.5,39646,1537,69,83,2039,7,3735,5.362.619.048
27/10/2016 05:00,34.1,41788,1380,76,98,1948,9,3511,5.362.619.048
27/10/2016 06:00,37.54,46101,1189,85,105,1838,13,3230,5.362.619.048
27/10/2016 07:00,41.2,50119,1077,105,111,1704,13,3010,5.362.619.048
27/10/2016 08:00,43.8,51293,961,119,115,1628,17,2840,5.362.619.048
27/10/2016 09:00,43.63,50349,847,131,126,1574,17,2695,5.362.619.048
27/10/2016 10:00,43.43,50480,821,137,135,1562,22,2677,5.362.619.048
27/10/2016 11:00,41.93,50437,944,142,146,1713,23,2968,5.362.619.048
27/10/2016 12:00,39.92,50167,1215,147,155,1867,24,3408,5.362.619.048
27/10/2016 13:00,38.8,49631,1557,153,164,2199,28,4101,5.362.619.048
27/10/2016 14:00,37.88,49285,1763,160,170,2476,36,4605,5.362.619.048
27/10/2016 15:00,37.57,49190,1802,167,174,2720,36,4899,5.362.619.048
27/10/2016 16:00,37.7,49707,1885,173,176,3019,34,5287,5.362.619.048
27/10/2016 17:00,38.73,50722,2079,175,179,3369,35,5837,5.362.619.048
27/10/2016 18:00,38.7,50738,2369,175,182,3582,33,6341,5.362.619.048
27/10/2016 19:00,37.76,49949,2660,174,184,3762,34,6814,5.362.619.048
27/10/2016 20:00,36.36,48186,2859,174,188,3832,29,7082,5.362.619.048
27/10/2016 21:00,34.9,46365,2993,173,191,3796,26,7179,5.362.619.048
27/10/2016 22:00,33.49,43990,3119,171,196,3848,21,7355,5.362.619.048
27/10/2016 23:00,31.02,41255,3238,176,226,3841,35,7516,5.362.619.048
28/10/2016 00:00,29.54,38913,3510,182,234,3772,40,7738,5.362.619.048
28/10/2016 01:00,27.71,37810,3585,186,239,3657,42,7709,5.362.619.048
28/10/2016 02:00,27.1,37403,3656,190,254,3578,41,7719,5.362.619.048
28/10/2016 03:00,27.31,37445,3707,193,264,3565,48,7777,5.362.619.048
28/10/2016 04:00,28.08,38130,3688,194,284,3545,49,7760,5.362.619.048
28/10/2016 05:00,31.05,40292,3603,191,303,3530,51,7678,5.362.619.048
28/10/2016 06:00,33.97,44523,3540,187,317,3473,54,7571,5.362.619.048
28/10/2016 07:00,35.85,48551,3518,182,324,3436,54,7514,5.362.619.048
28/10/2016 08:00,36.92,48618,3420,175,341,3528,53,7517,5.362.619.048
28/10/2016 09:00,36.8,48934,3337,163,348,3515,52,7415,5.362.619.048
28/10/2016 10:00,36.72,49179,3382,150,350,3595,50,7527,5.362.619.048
28/10/2016 11:00,36.66,48861,3516,133,355,3561,47,7612,5.362.619.048
28/10/2016 12:00,36.04,48329,3679,120,360,3619,49,7827,5.362.619.048
28/10/2016 13:00,35.38,47811,3801,119,363,3721,46,8050,5.362.619.048
28/10/2016 14:00,34.89,47199,3801,118,367,3822,43,8151,5.362.619.048
28/10/2016 15:00,34.89,46833,3702,123,367,3953,47,8192,5.362.619.048
28/10/2016 16:00,35.33,47232,3618,127,360,4005,46,8156,5.362.619.048
28/10/2016 17:00,36.71,48182,3525,136,351,4093,46,8151,5.362.619.048
28/10/2016 18:00,36.96,48755,3456,146,346,4079,44,8071,5.362.619.048
28/10/2016 19:00,36.34,47891,3421,149,333,4331,43,8277,5.362.619.048
28/10/2016 20:00,34.63,46060,3430,146,323,4378,39,8316,5.362.619.048
28/10/2016 21:00,34.06,44444,3457,142,316,4385,41,8341,5.362.619.048
28/10/2016 22:00,33.14,42766,3468,137,310,4398,38,8351,5.362.619.048
28/10/2016 23:00,31.56,40816,3469,154,332,4453,30,8438,5.362.619.048
29/10/2016 00:00,30.6,38839,3336,152,325,4391,31,8235,5.362.619.048
29/10/2016 01:00,29.8,37787,3376,153,325,4371,31,8256,5.362.619.048
29/10/2016 02:00,28.92,37234,3383,155,324,4390,30,8282,5.362.619.048
29/10/2016 03:00,28.82,37077,3374,157,318,4368,28,8245,5.362.619.048
29/10/2016 04:00,28.84,37264,3397,157,312,4339,25,8230,5.362.619.048
29/10/2016 05:00,29.43,38013,3408,157,307,4306,25,8203,5.362.619.048
29/10/2016 06:00,30.77,39209,3392,156,301,4168,26,8043,5.362.619.048
29/10/2016 07:00,32.5,40614,3358,156,294,4037,23,7868,5.362.619.048
29/10/2016 08:00,33.93,42172,3290,156,293,3965,22,7726,5.362.619.048
29/10/2016 09:00,34.66,43274,3245,157,296,3865,26,7589,5.362.619.048
29/10/2016 10:00,34.86,44083,3276,156,307,3747,33,7519,5.362.619.048
29/10/2016 11:00,34.77,43869,3398,154,317,3648,38,7555,5.362.619.048
29/10/2016 12:00,33.79,43463,3546,152,322,3567,37,7624,5.362.619.048
29/10/2016 13:00,32.62,43091,3643,152,328,3576,37,7736,5.362.619.048
29/10/2016 14:00,32.22,42848,3635,153,320,3571,33,7712,5.362.619.048
29/10/2016 15:00,32.15,43084,3503,153,307,3603,30,7596,5.362.619.048
29/10/2016 16:00,32.79,44085,3275,151,300,3660,27,7413,5.362.619.048
29/10/2016 17:00,35.31,45639,3044,147,298,3753,26,7268,5.362.619.048
29/10/2016 18:00,36.17,46231,2882,140,300,3758,28,7108,5.362.619.048
29/10/2016 19:00,35.61,45565,2737,131,299,3834,30,7031,5.362.619.048
29/10/2016 20:00,34.32,44133,2625,117,291,3823,30,6886,5.362.619.048
29/10/2016 21:00,34.07,42918,2514,102,276,3841,31,6764,5.362.619.048
29/10/2016 22:00,33.9,41679,2390,89,264,3872,31,6646,5.362.619.048
29/10/2016 23:00,32.99,40138,2232,140,289,3853,39,6553,5.362.619.048
30/10/2016 00:00,32.57,38662,1716,138,287,3803,35,5979,5.362.619.048
30/10/2016 01:00,32.15,37722,1543,143,284,3336,32,5338,5.362.619.048
30/10/2016 02:00,31.83,36959.5,1293,144,281,3835,32,5585,5.362.619.048
30/10/2016 03:00,31.91,37098,1011,145,274,3522,30,4982,5.362.619.048
30/10/2016 04:00,32.03,37256,848,145,264,3362,33,4652,5.362.619.048
30/10/2016 05:00,32.68,37825,693,143,260,3129,40,4265,5.362.619.048
30/10/2016 06:00,33.3,38705,547,140,264,2971,40,3962,5.362.619.048
30/10/2016 07:00,34.03,39644,422,136,268,2822,45,3693,5.362.619.048
30/10/2016 08:00,34.88,40710,326,133,278,2660,44,3441,5.362.619.048
30/10/2016 09:00,36.15,42241,254,129,296,2411,47,3137,5.362.619.048
30/10/2016 10:00,36.62,43172,201,123,302,2181,49,2856,5.362.619.048
30/10/2016 11:00,37.32,43394,171,116,293,1900,49,2529,5.362.619.048
30/10/2016 12:00,36.49,43136,154,107,264,1628,48,2201,5.362.619.048
30/10/2016 13:00,34.82,43016,136,100,233,1495,46,2010,5.362.619.048
30/10/2016 14:00,34.57,42999,115,96,226,1403,44,1884,5.362.619.048
30/10/2016 15:00,34.78,43479,97,94,211,1425,42,1869,5.362.619.048
30/10/2016 16:00,36.63,44754,86,89,194,1491,39,1899,5.362.619.048
30/10/2016 17:00,42.4,46337,80,83,177,1492,39,1871,5.362.619.048
30/10/2016 18:00,43.12,46899,80,78,163,1417,40,1778,5.362.619.048
30/10/2016 19:00,42.67,46525,77,69,151,1200,36,1533,5.362.619.048
30/10/2016 20:00,39.61,45464,71,62,140,1120,32,1425,5.362.619.048
30/10/2016 21:00,38.15,44466,68,55,129,1060,23,1335,5.362.619.048
30/10/2016 22:00,37.43,42913,76,50,119,1000,15,1260,5.362.619.048
30/10/2016 23:00,36.25,41042,87,48,110,922,11,1178,5.362.619.048
31/10/2016 00:00,35.1,39732,177,44,105,996,18,1340,5.230.714.286
31/10/2016 01:00,34.79,38923,201,44,95,921,18,1279,5.230.714.286
31/10/2016 02:00,34.52,38565,226,44,82,861,15,1228,5.230.714.286
31/10/2016 03:00,34.19,38736,266,45,74,803,13,1201,5.230.714.286
31/10/2016 04:00,34.88,39546,283,48,65,731,17,1144,5.230.714.286
31/10/2016 05:00,38.17,41908,272,52,42,670,16,1052,5.230.714.286
31/10/2016 06:00,41.74,46377,281,59,38,603,13,994,5.230.714.286
31/10/2016 07:00,47.25,50404,302,63,34,539,10,948,5.230.714.286
31/10/2016 08:00,47.22,50874,328,59,34,486,8,915,5.230.714.286
31/10/2016 09:00,45.65,50832,341,57,42,416,8,864,5.230.714.286
31/10/2016 10:00,43.35,50664,348,56,39,362,10,815,5.230.714.286
31/10/2016 11:00,42.77,50341,364,56,50,308,10,788,5.230.714.286
31/10/2016 12:00,41.87,49887,405,55,65,272,11,808,5.230.714.286
31/10/2016 13:00,40.73,49694,442,53,71,279,10,855,5.230.714.286
31/10/2016 14:00,40.12,49525,474,50,65,281,4,874,5.230.714.286
31/10/2016 15:00,42.03,50096,513,47,59,300,2,921,5.230.714.286
31/10/2016 16:00,44.58,50647,542,42,52,334,1,971,5.230.714.286
31/10/2016 17:00,48.62,51263,580,35,42,419,1,1077,5.230.714.286
31/10/2016 18:00,47.57,50953,650,28,33,517,1,1229,5.230.714.286
31/10/2016 19:00,46.44,50126,746,21,28,633,1,1429,5.230.714.286
31/10/2016 20:00,41.71,48477,873,17,25,747,3,1665,5.230.714.286
31/10/2016 21:00,38.74,46908,1019,14,24,872,2,1931,5.230.714.286
31/10/2016 22:00,37.29,44853,1202,13,23,972,3,2213,5.230.714.286
31/10/2016 23:00,35.01,42440,1426,4,15,1074,3,2522,5.230.714.286
01/11/2016 00:00,34.1,40193,1487,7,10,1239,2,2745,5.230.714.286
01/11/2016 01:00,33.31,39319,1745,8,12,1369,1,3135,5.230.714.286
01/11/2016 02:00,33.03,39004,1948,10,17,1516,1,3492,5.230.714.286
01/11/2016 03:00,32.65,39112,2142,12,32,1634,1,3821,5.230.714.286
01/11/2016 04:00,33.17,39837,2311,16,32,1720,2,4081,5.230.714.286
01/11/2016 05:00,34.27,42041,2482,21,44,1787,1,4335,5.230.714.286
01/11/2016 06:00,37.19,46145,2690,28,56,1865,1,4640,5.230.714.286
01/11/2016 07:00,38.86,49870,2823,32,79,1901,2,4837,5.230.714.286
01/11/2016 08:00,39.25,50240,2889,35,105,1910,2,4941,5.230.714.286
01/11/2016 09:00,38.51,50216,3009,36,138,1920,3,5106,5.230.714.286
01/11/2016 10:00,37.68,50459,3177,40,216,2017,4,5454,5.230.714.286
01/11/2016 11:00,37.68,50551,3353,46,265,2151,5,5820,5.230.714.286
01/11/2016 12:00,37.76,50399,3516,53,295,2273,6,6143,5.230.714.286
01/11/2016 13:00,37.34,50516,3609,65,302,2404,7,6387,5.230.714.286
01/11/2016 14:00,36.75,50334,3601,80,295,2529,9,6514,5.230.714.286
01/11/2016 15:00,36.52,50683,3588,94,275,2648,11,6616,5.230.714.286
01/11/2016 16:00,38.07,51457,3600,111,240,2720,14,6685,5.230.714.286
01/11/2016 17:00,39.61,52311,3621,124,242,2859,20,6866,5.230.714.286
01/11/2016 18:00,38.8,52270,3639,133,227,2926,21,6946,5.230.714.286
01/11/2016 19:00,37.64,51410,3628,140,224,2967,17,6976,5.230.714.286
01/11/2016 20:00,36.46,49856,3581,145,217,3037,18,6998,5.230.714.286
01/11/2016 21:00,35.05,48389,3530,149,225,3030,20,6954,5.230.714.286
01/11/2016 22:00,34.41,46181,3461,151,226,3079,23,6940,5.230.714.286
01/11/2016 23:00,32.73,43616,3363,152,215,3098,24,6852,5.230.714.286
02/11/2016 00:00,32.65,41406,3461,155,200,3124,19,6959,5.230.714.286
02/11/2016 01:00,32.25,40560,3365,160,198,3186,19,6928,5.230.714.286
02/11/2016 02:00,32.09,40182,3220,163,199,3294,15,6891,5.230.714.286
02/11/2016 03:00,31.87,40346,3054,159,202,3373,12,6800,5.230.714.286
02/11/2016 04:00,32.95,41039,2843,159,202,3389,10,6603,5.230.714.286
02/11/2016 05:00,34.7,43212,2598,157,201,3429,8,6393,5.230.714.286
02/11/2016 06:00,37.18,47263,2410,154,204,3376,8,6152,5.230.714.286
02/11/2016 07:00,39.85,50973,2295,151,210,3412,6,6074,5.230.714.286
02/11/2016 08:00,39.86,51226,2217,146,218,3354,4,5939,5.230.714.286
02/11/2016 09:00,39.19,51892,2224,141,221,3319,4,5909,5.230.714.286
02/11/2016 10:00,38.58,52010,2303,137,228,3324,3,5995,5.230.714.286
02/11/2016 11:00,38.11,51973,2374,128,228,3372,3,6105,5.230.714.286
02/11/2016 12:00,38.1,51762,2394,125,215,3385,2,6121,5.230.714.286
02/11/2016 13:00,38.1,51763,2362,124,198,3346,2,6032,5.230.714.286
02/11/2016 14:00,37.99,51666,2251,124,174,3277,2,5828,5.230.714.286
02/11/2016 15:00,38.34,51786,2106,123,144,3217,2,5592,5.230.714.286
02/11/2016 16:00,39.76,52619,1944,124,118,3166,2,5354,5.230.714.286
02/11/2016 17:00,43.56,53654,1799,119,96,3109,4,5127,5.230.714.286
02/11/2016 18:00,42.98,53523,1674,116,81,2999,11,4881,5.230.714.286
02/11/2016 19:00,39.95,52887,1534,111,73,2949,19,4686,5.230.714.286
02/11/2016 20:00,38.98,51277,1385,105,68,2831,27,4416,5.230.714.286
02/11/2016 21:00,37.66,49666,1220,99,62,2722,31,4134,5.230.714.286
02/11/2016 22:00,36.56,47462,1052,92,55,2582,39,3820,5.230.714.286
02/11/2016 23:00,35.34,44871,876,86,52,2449,38,3501,5.230.714.286
03/11/2016 00:00,35.49,43601,632,72,58,2247,33,3042,5.230.714.286
03/11/2016 01:00,35.22,42636,530,72,73,2118,32,2825,5.230.714.286
03/11/2016 02:00,35.16,42301,440,80,96,1992,31,2639,5.230.714.286
03/11/2016 03:00,35.4,42477,367,87,115,1853,30,2452,5.230.714.286
03/11/2016 04:00,36.34,43274,341,90,132,1717,28,2308,5.230.714.286
03/11/2016 05:00,38.55,45441,330,91,145,1594,27,2187,5.230.714.286
03/11/2016 06:00,41.88,49728,306,89,151,1442,27,2015,5.230.714.286
03/11/2016 07:00,45.8,53658,293,85,157,1317,25,1877,5.230.714.286
03/11/2016 08:00,47.01,54015,321,80,160,1170,22,1753,5.230.714.286
03/11/2016 09:00,45.06,54162,362,81,157,1023,21,1644,5.230.714.286
03/11/2016 10:00,43.74,54299,412,84,152,889,20,1557,5.230.714.286
03/11/2016 11:00,43.91,54075,498,83,148,785,18,1532,5.230.714.286
03/11/2016 12:00,44.21,53652,580,80,142,698,15,1515,5.230.714.286
03/11/2016 13:00,44.09,53546,613,75,130,627,12,1457,5.230.714.286
03/11/2016 14:00,44.16,53315,616,69,115,582,12,1394,5.230.714.286
03/11/2016 15:00,44.71,53617,616,62,91,571,11,1351,5.230.714.286
03/11/2016 16:00,45.94,54491,581,59,76,561,10,1287,5.230.714.286
03/11/2016 17:00,48.25,55669,538,54,65,582,9,1248,5.230.714.286
03/11/2016 18:00,48.58,55642,571,49,57,613,7,1297,5.230.714.286
03/11/2016 19:00,44.19,54890,610,45,54,600,7,1316,5.230.714.286
03/11/2016 20:00,41.07,53333,656,41,50,556,7,1310,5.230.714.286
03/11/2016 21:00,38.99,51768,758,39,46,532,6,1381,5.230.714.286
03/11/2016 22:00,37.64,49525,873,38,43,521,6,1481,5.230.714.286
03/11/2016 23:00,35.84,46850,958,37,41,531,5,1572,5.230.714.286
04/11/2016 00:00,35.98,44796,833,42,41,539,6,1461,5.230.714.286
04/11/2016 01:00,35.64,43841,856,43,44,568,5,1516,5.230.714.286
04/11/2016 02:00,35.38,43514,837,43,43,592,6,1521,5.230.714.286
04/11/2016 03:00,35.49,43665,829,41,42,636,5,1553,5.230.714.286
04/11/2016 04:00,35.92,44564,824,39,39,717,6,1625,5.230.714.286
04/11/2016 05:00,37.42,46892,865,36,35,765,4,1705,5.230.714.286
04/11/2016 06:00,39.15,50956,965,32,34,814,3,1848,5.230.714.286
04/11/2016 07:00,43.51,54460,1041,27,29,961,3,2061,5.230.714.286
04/11/2016 08:00,44.13,55504,1132,21,21,992,3,2169,5.230.714.286
04/11/2016 09:00,44.04,54773,1232,18,15,1022,3,2290,5.230.714.286
04/11/2016 10:00,42.69,55064,1257,14,15,1064,3,2353,5.230.714.286
04/11/2016 11:00,42.64,54427,1271,12,13,1134,2,2432,5.230.714.286
04/11/2016 12:00,41.41,53749,1291,11,15,1215,2,2534,5.230.714.286
04/11/2016 13:00,41.19,53352,1285,11,16,1291,2,2605,5.230.714.286
04/11/2016 14:00,40.69,52986,1238,12,17,1376,2,2645,5.230.714.286
04/11/2016 15:00,41.98,52857,1107,12,18,1532,3,2672,5.230.714.286
04/11/2016 16:00,43.92,53963,999,13,18,1691,3,2724,5.230.714.286
04/11/2016 17:00,44.99,54793,960,14,21,1825,3,2823,5.230.714.286
04/11/2016 18:00,44.28,54071,937,12,25,1991,3,2968,5.230.714.286
04/11/2016 19:00,40.38,52575,970,10,32,2080,3,3095,5.230.714.286
04/11/2016 20:00,39.17,50557,1039,8,38,2147,4,3236,5.230.714.286
04/11/2016 21:00,38.53,49076,1002,6,43,2201,4,3256,5.230.714.286
04/11/2016 22:00,37.42,47180,897,5,48,2237,4,3191,5.230.714.286
04/11/2016 23:00,35.65,45172,838,4,54,2296,3,3195,5.230.714.286
05/11/2016 00:00,36.82,43187,868,6,71,2354,6,3305,5.230.714.286
05/11/2016 01:00,36.71,42361,755,6,81,2374,6,3222,5.230.714.286
05/11/2016 02:00,36.46,41837,678,7,91,2440,8,3224,5.230.714.286
05/11/2016 03:00,36.1,41645,698,8,100,2493,8,3307,5.230.714.286
05/11/2016 04:00,36.13,41766,712,9,106,2542,12,3381,5.230.714.286
05/11/2016 05:00,36.51,42374,738,10,112,2619,14,3493,5.230.714.286
05/11/2016 06:00,36.79,43544,768,10,116,2669,14,3577,5.230.714.286
05/11/2016 07:00,37.44,44859,808,11,119,2708,17,3663,5.230.714.286
05/11/2016 08:00,38.47,46591,858,10,120,2710,17,3715,5.230.714.286
05/11/2016 09:00,39.44,48017,918,10,120,2694,17,3759,5.230.714.286
05/11/2016 10:00,40.66,48795,946,9,122,2699,17,3793,5.230.714.286
05/11/2016 11:00,40.88,48862,924,10,125,2709,22,3790,5.230.714.286
05/11/2016 12:00,40.59,48595,911,12,134,2772,24,3853,5.230.714.286
05/11/2016 13:00,39.45,48379,881,14,143,2851,25,3914,5.230.714.286
05/11/2016 14:00,38.64,48369,834,18,153,2972,26,4003,5.230.714.286
05/11/2016 15:00,38.55,48970,816,24,176,3108,25,4149,5.230.714.286
05/11/2016 16:00,40.77,50557,791,30,211,3245,32,4309,5.230.714.286
05/11/2016 17:00,42.29,51856,771,35,231,3354,33,4424,5.230.714.286
05/11/2016 18:00,41.72,51447,791,41,242,3417,37,4528,5.230.714.286
05/11/2016 19:00,39.55,50270,802,46,254,3390,33,4525,5.230.714.286
05/11/2016 20:00,38.41,48791,824,52,262,3372,33,4543,5.230.714.286
05/11/2016 21:00,38.3,47764,835,59,269,3303,33,4499,5.230.714.286
05/11/2016 22:00,36.68,46442,909,64,279,3275,28,4555,5.230.714.286
05/11/2016 23:00,35.85,45119,1007,68,293,3267,32,4667,5.230.714.286
06/11/2016 00:00,34.98,43896,1723,61,316,3211,37,5348,5.230.714.286
06/11/2016 01:00,34.3,43059,1721,65,329,3187,40,5342,5.230.714.286
06/11/2016 02:00,34.38,41728,1737,69,337,3180,40,5363,5.230.714.286
06/11/2016 03:00,33.83,42437,1797,73,336,3198,43,5447,5.230.714.286
06/11/2016 04:00,33.8,42600,1907,78,324,3249,48,5606,5.230.714.286
06/11/2016 05:00,34.01,43122,2052,83,300,3309,46,5790,5.230.714.286
06/11/2016 06:00,34.68,44050,2197,89,273,3277,44,5880,5.230.714.286
06/11/2016 07:00,35.62,45134,2345,95,240,3356,46,6082,5.230.714.286
06/11/2016 08:00,36.1,46677,2482,100,228,3388,42,6240,5.230.714.286
06/11/2016 09:00,36.96,48388,2636,105,192,3422,42,6397,5.230.714.286
06/11/2016 10:00,37.94,49506,2783,110,159,3472,39,6563,5.230.714.286
06/11/2016 11:00,38.74,49998,2930,115,128,3438,33,6644,5.230.714.286
06/11/2016 12:00,38.47,49968,3053,121,100,3412,28,6714,5.230.714.286
06/11/2016 13:00,38.09,49950,3148,128,57,3432,23,6788,5.230.714.286
06/11/2016 14:00,37.6,50052,3244,135,46,3468,19,6912,5.230.714.286
06/11/2016 15:00,38.04,50698,3331,141,40,3536,19,7067,5.230.714.286
06/11/2016 16:00,39.51,52173,3400,146,38,3595,20,7199,5.230.714.286
06/11/2016 17:00,40.98,53655,3461,149,34,3648,18,7310,5.230.714.286
06/11/2016 18:00,40.43,53704,3564,150,32,3643,17,7406,5.230.714.286
06/11/2016 19:00,39.41,53114,3605,149,31,3620,20,7425,5.230.714.286
06/11/2016 20:00,38.42,51888,3592,147,32,3571,17,7359,5.230.714.286
06/11/2016 21:00,37.54,50730,3565,144,30,3506,18,7263,5.230.714.286
06/11/2016 22:00,36.71,49065,3503,141,30,3450,16,7140,5.230.714.286
06/11/2016 23:00,35.7,47223,3379,138,30,3419,19,6985,5.230.714.286
07/11/2016 00:00,34.09,46284,3063,148,0,3394,11,6616,5.005.119.048
07/11/2016 01:00,33.63,45499,2940,145,0,3317,11,6413,5.005.119.048
07/11/2016 02:00,33.77,45283,2859,142,0,3301,12,6314,5.005.119.048
07/11/2016 03:00,34.1,46067,2781,140,0,3291,10,6222,5.005.119.048
07/11/2016 04:00,35.3,46801,2676,138,0,3267,13,6094,5.005.119.048
07/11/2016 05:00,37.67,49355,2561,135,0,3232,11,5939,5.005.119.048
07/11/2016 06:00,40.42,54240,2453,133,0,3227,10,5823,5.005.119.048
07/11/2016 07:00,43.79,58350,2356,130,0,3144,13,5643,5.005.119.048
07/11/2016 08:00,44.02,59248,2283,129,0,3106,12,5530,5.005.119.048
07/11/2016 09:00,44.05,59392,2232,127,0,3071,10,5440,5.005.119.048
07/11/2016 10:00,42.97,59380,2133,124,0,2980,9,5246,5.005.119.048
07/11/2016 11:00,42.67,59147,1984,120,0,2964,9,5077,5.005.119.048
07/11/2016 12:00,44.12,58712,1851,117,0,2919,9,4896,5.005.119.048
07/11/2016 13:00,44.59,58536,1714,114,0,2866,8,4702,5.005.119.048
07/11/2016 14:00,44.83,58177,1562,112,0,2828,6,4508,5.005.119.048
07/11/2016 15:00,47.65,59001,1399,111,0,2875,6,4391,5.005.119.048
07/11/2016 16:00,52.48,59904,1266,107,0,2898,5,4276,5.005.119.048
07/11/2016 17:00,59.26,60795,1243,104,0,2968,5,4320,5.005.119.048
07/11/2016 18:00,54.79,60169,1259,100,0,2911,4,4274,5.005.119.048
07/11/2016 19:00,45.67,59197,1229,96,0,2842,3,4170,5.005.119.048
07/11/2016 20:00,43.77,57446,1130,93,0,2812,3,4038,5.005.119.048
07/11/2016 21:00,40.74,55773,1026,91,0,2791,3,3911,5.005.119.048
07/11/2016 22:00,39.71,53343,936,89,0,2778,2,3805,5.005.119.048
07/11/2016 23:00,38.1,50592,804,87,0,2749,2,3642,5.005.119.048
08/11/2016 00:00,37.91,48911,772,87,0,2607,2,3468,5.005.119.048
08/11/2016 01:00,37.01,48026,720,84,0,2585,2,3391,5.005.119.048
08/11/2016 02:00,36.66,47780,692,79,0,2614,3,3388,5.005.119.048
08/11/2016 03:00,36.82,47918,653,76,0,2597,2,3328,5.005.119.048
08/11/2016 04:00,38.05,48647,614,72,0,2570,3,3259,5.005.119.048
08/11/2016 05:00,39.88,51039,588,68,0,2488,1,3145,5.005.119.048
08/11/2016 06:00,44.04,55617,545,64,0,2433,1,3043,5.005.119.048
08/11/2016 07:00,49.76,59792,506,60,0,2279,2,2847,5.005.119.048
08/11/2016 08:00,56.01,59959,510,55,0,2183,1,2749,5.005.119.048
08/11/2016 09:00,54.72,59900,487,50,0,2069,1,2607,5.005.119.048
08/11/2016 10:00,50.92,59830,434,45,0,1990,1,2470,5.005.119.048
08/11/2016 11:00,50.31,59737,397,41,0,1895,1,2334,5.005.119.048
08/11/2016 12:00,50.97,59342,375,39,0,1805,1,2220,5.005.119.048
08/11/2016 13:00,51.91,59080,345,38,0,1741,1,2125,5.005.119.048
08/11/2016 14:00,51.81,58805,315,37,0,1723,2,2077,5.005.119.048
08/11/2016 15:00,54.48,59240,307,38,0,1876,2,2223,5.005.119.048
08/11/2016 16:00,59.88,60230,331,39,0,1956,1,2327,5.005.119.048
08/11/2016 17:00,73.48,61172,367,38,0,1993,2,2400,5.005.119.048
08/11/2016 18:00,58.98,60684,383,38,0,2056,2,2479,5.005.119.048
08/11/2016 19:00,50.36,59662,380,40,0,2033,1,2454,5.005.119.048
08/11/2016 20:00,43.68,57955,368,41,0,2001,1,2411,5.005.119.048
08/11/2016 21:00,41.42,56223,357,41,0,1994,1,2393,5.005.119.048
08/11/2016 22:00,40.03,53758,365,41,0,1989,1,2396,5.005.119.048
08/11/2016 23:00,38.09,51063,382,38,0,1994,1,2415,5.005.119.048
09/11/2016 00:00,37.09,49020,793,30,31,2162,1,3017,5.005.119.048
09/11/2016 01:00,36.37,48078,844,29,40,2186,1,3100,5.005.119.048
09/11/2016 02:00,35.47,47660,882,29,36,2185,1,3133,5.005.119.048
09/11/2016 03:00,35.39,47721,960,29,37,2185,1,3212,5.005.119.048
09/11/2016 04:00,36.37,48322,1036,28,41,2263,3,3371,5.005.119.048
09/11/2016 05:00,39.44,50478,1087,29,46,2287,5,3454,5.005.119.048
09/11/2016 06:00,43.76,55130,1140,29,56,2230,8,3463,5.005.119.048
09/11/2016 07:00,51.09,59195,1187,28,72,2153,12,3452,5.005.119.048
09/11/2016 08:00,52.09,59545,1216,25,76,2054,12,3383,5.005.119.048
09/11/2016 09:00,51.46,59508,1217,23,65,1960,11,3276,5.005.119.048
09/11/2016 10:00,48.93,59436,1184,19,64,1919,8,3194,5.005.119.048
09/11/2016 11:00,50.59,59246,1123,19,66,1700,7,2915,5.005.119.048
09/11/2016 12:00,52.03,58772,1065,19,70,1720,6,2880,5.005.119.048
09/11/2016 13:00,51.8,58572,993,22,76,1711,7,2809,5.005.119.048
09/11/2016 14:00,50.1,58268,909,23,93,1685,7,2717,5.005.119.048
09/11/2016 15:00,51.11,58437,822,27,109,1653,7,2618,5.005.119.048
09/11/2016 16:00,59.58,59265,780,35,125,1600,7,2547,5.005.119.048
09/11/2016 17:00,62.19,60181,732,40,139,1533,9,2453,5.005.119.048
09/11/2016 18:00,56.3,59656,700,45,147,1485,11,2388,5.005.119.048
09/11/2016 19:00,51.73,58788,683,46,152,1440,11,2332,5.005.119.048
09/11/2016 20:00,45.45,57079,633,44,154,1444,10,2285,5.005.119.048
09/11/2016 21:00,42.44,55356,557,45,150,1395,8,2155,5.005.119.048
09/11/2016 22:00,40.32,53044,490,44,146,1334,8,2022,5.005.119.048
09/11/2016 23:00,38.55,50489,445,43,139,1278,7,1912,5.005.119.048
10/11/2016 00:00,37.39,48423,375,54,111,1171,15,1726,5.005.119.048
10/11/2016 01:00,36.51,47477,327,56,100,1167,11,1661,5.005.119.048
10/11/2016 02:00,36.13,47078,314,58,85,1203,8,1668,5.005.119.048
10/11/2016 03:00,36.39,47171,357,60,70,1221,8,1716,5.005.119.048
10/11/2016 04:00,37.98,47921,409,63,55,1214,10,1751,5.005.119.048
10/11/2016 05:00,40.35,50055,476,65,40,1264,9,1854,5.005.119.048
10/11/2016 06:00,45.47,54635,522,68,33,1301,10,1934,5.005.119.048
10/11/2016 07:00,50.32,58726,544,69,30,1316,10,1969,5.005.119.048
10/11/2016 08:00,52.33,59137,553,67,22,1335,9,1986,5.005.119.048
10/11/2016 09:00,51.59,59106,540,69,20,1302,10,1941,5.005.119.048
10/11/2016 10:00,50.58,59088,500,67,15,1236,7,1825,5.005.119.048
10/11/2016 11:00,51.52,58787,460,64,11,1021,6,1562,5.005.119.048
10/11/2016 12:00,51.9,58205,425,60,10,840,4,1339,5.005.119.048
10/11/2016 13:00,53.66,58015,388,55,8,770,3,1224,5.005.119.048
10/11/2016 14:00,53.97,58151,375,48,8,777,2,1210,5.005.119.048
10/11/2016 15:00,53.59,58573,404,43,8,850,2,1307,5.005.119.048
10/11/2016 16:00,54.95,59270,491,40,8,885,3,1427,5.005.119.048
10/11/2016 17:00,63.5,60056,600,34,8,890,4,1536,5.005.119.048
10/11/2016 18:00,53.65,59288,682,28,8,915,1,1634,5.005.119.048
10/11/2016 19:00,49.82,58205,724,23,8,857,1,1613,5.005.119.048
10/11/2016 20:00,45.51,56542,723,20,8,876,1,1628,5.005.119.048
10/11/2016 21:00,42.52,54883,710,17,8,890,1,1626,5.005.119.048
10/11/2016 22:00,40.31,52587,684,17,10,889,0,1600,5.005.119.048
10/11/2016 23:00,38.68,50015,645,18,10,849,1,1523,5.005.119.048
11/11/2016 00:00,38.92,48463,816,15,13,885,1,1730,5.005.119.048
11/11/2016 01:00,37.13,47445,771,16,14,857,0,1658,5.005.119.048
11/11/2016 02:00,36.64,47131,747,17,15,845,0,1624,5.005.119.048
11/11/2016 03:00,36.59,47266,782,17,20,828,0,1647,5.005.119.048
11/11/2016 04:00,38.49,48031,813,16,22,811,1,1663,5.005.119.048
11/11/2016 05:00,40.53,50258,824,15,25,788,1,1653,5.005.119.048
11/11/2016 06:00,45.65,54925,840,14,25,758,2,1639,5.005.119.048
11/11/2016 07:00,56.02,59296,836,15,25,750,4,1630,5.005.119.048
11/11/2016 08:00,55.93,59504,753,16,25,724,4,1522,5.005.119.048
11/11/2016 09:00,54.51,59557,638,18,25,675,5,1361,5.005.119.048
11/11/2016 10:00,50.76,59434,511,22,22,645,4,1204,5.005.119.048
11/11/2016 11:00,48.44,58911,408,29,20,614,5,1076,5.005.119.048
11/11/2016 12:00,48.48,57966,332,35,15,579,4,965,5.005.119.048
11/11/2016 13:00,48.09,57359,279,41,16,607,6,949,5.005.119.048
11/11/2016 14:00,45.98,57017,250,47,17,660,5,979,5.005.119.048
11/11/2016 15:00,47.15,57265,225,51,20,768,4,1068,5.005.119.048
11/11/2016 16:00,50.5,58217,206,54,25,961,4,1250,5.005.119.048
11/11/2016 17:00,54.56,59056,205,54,25,1076,4,1364,5.005.119.048
11/11/2016 18:00,51.11,58224,211,51,25,1220,2,1509,5.005.119.048
11/11/2016 19:00,48.47,56882,201,49,25,1198,1,1474,5.005.119.048
11/11/2016 20:00,44.08,55005,193,45,25,1009,0,1272,5.005.119.048
11/11/2016 21:00,41.61,53444,208,42,22,1052,0,1324,5.005.119.048
11/11/2016 22:00,41.19,51579,240,39,20,1082,0,1381,5.005.119.048
11/11/2016 23:00,39.5,49445,267,38,20,1048,2,1375,5.005.119.048
12/11/2016 00:00,39.97,47777,363,25,22,1113,4,1527,5.005.119.048
12/11/2016 01:00,38.49,46943,395,26,24,1227,3,1675,5.005.119.048
12/11/2016 02:00,37.22,46359,447,27,25,1208,4,1711,5.005.119.048
12/11/2016 03:00,36.64,46221,513,29,25,1217,4,1788,5.005.119.048
12/11/2016 04:00,36.95,46436,605,30,25,1205,4,1869,5.005.119.048
12/11/2016 05:00,37.87,47116,712,32,25,1157,3,1929,5.005.119.048
12/11/2016 06:00,39.04,48344,842,31,25,1153,4,2055,5.005.119.048
12/11/2016 07:00,39.92,49782,965,29,23,1076,3,2096,5.005.119.048
12/11/2016 08:00,40.23,51684,1062,27,21,1065,3,2178,5.005.119.048
12/11/2016 09:00,41.85,53157,1153,26,20,1068,3,2270,5.005.119.048
12/11/2016 10:00,42.36,53837,1208,26,20,1014,3,2271,5.005.119.048
12/11/2016 11:00,41.62,53621,1257,26,21,959,4,2267,5.005.119.048
12/11/2016 12:00,40.73,53011,1366,25,23,886,4,2304,5.005.119.048
12/11/2016 13:00,40.04,52530,1447,24,25,860,4,2360,5.005.119.048
12/11/2016 14:00,39.56,52413,1447,23,25,949,5,2449,5.005.119.048
12/11/2016 15:00,40.65,53112,1424,21,27,1065,4,2541,5.005.119.048
12/11/2016 16:00,43.79,54647,1440,21,27,1156,4,2648,5.005.119.048
12/11/2016 17:00,44.79,55894,1506,20,27,1195,5,2753,5.005.119.048
12/11/2016 18:00,44.08,55481,1575,20,28,1278,4,2905,5.005.119.048
12/11/2016 19:00,41.2,54092,1633,20,30,1422,6,3111,5.005.119.048
12/11/2016 20:00,39.24,52380,1682,21,30,1532,5,3270,5.005.119.048
12/11/2016 21:00,38.34,51105,1738,21,31,1588,6,3384,5.005.119.048
12/11/2016 22:00,37.65,49568,1812,22,30,1576,6,3446,5.005.119.048
12/11/2016 23:00,36.36,47885,1882,21,28,1643,6,3580,5.005.119.048
13/11/2016 00:00,36.11,46284,1645,19,28,1611,6,3309,5.005.119.048
13/11/2016 01:00,35.45,45368,1617,18,27,1584,4,3250,5.005.119.048
13/11/2016 02:00,35.24,44461,1597,18,27,1503,4,3149,5.005.119.048
13/11/2016 03:00,35.23,44516,1576,19,28,1447,4,3074,5.005.119.048
13/11/2016 04:00,35.38,44546,1560,20,30,1390,4,3004,5.005.119.048
13/11/2016 05:00,35.55,44947,1561,20,29,1372,4,2986,5.005.119.048
13/11/2016 06:00,36.68,45778,1583,20,29,1351,4,2987,5.005.119.048
13/11/2016 07:00,36.6,46700,1595,17,29,1352,4,2997,5.005.119.048
13/11/2016 08:00,37.74,47486,1570,16,29,1325,4,2944,5.005.119.048
13/11/2016 09:00,38.87,49032,1555,14,28,1294,3,2894,5.005.119.048
13/11/2016 10:00,39.17,50091,1529,15,26,1243,3,2816,5.005.119.048
13/11/2016 11:00,39.46,50502,1448,18,24,1162,4,2656,5.005.119.048
13/11/2016 12:00,39.47,50365,1338,20,25,1108,3,2494,5.005.119.048
13/11/2016 13:00,39.5,50261,1223,23,26,1065,4,2341,5.005.119.048
13/11/2016 14:00,39.62,50304,1135,28,32,1066,8,2269,5.005.119.048
13/11/2016 15:00,40.88,51059,1062,29,39,1069,7,2206,5.005.119.048
13/11/2016 16:00,43.9,52095,1013,29,38,1075,6,2161,5.005.119.048
13/11/2016 17:00,44.76,53161,1010,27,44,1077,8,2166,5.005.119.048
13/11/2016 18:00,44.28,52915,1025,25,47,1081,6,2184,5.005.119.048
13/11/2016 19:00,42.12,52086,1075,21,46,1113,7,2262,5.005.119.048
13/11/2016 20:00,40.94,50820,1139,19,43,1124,8,2333,5.005.119.048
13/11/2016 21:00,39.72,49730,1183,18,39,1121,6,2367,5.005.119.048
13/11/2016 22:00,38.35,48155,1186,18,42,1148,5,2399,5.005.119.048
13/11/2016 23:00,36.92,46409,1169,15,36,1178,5,2403,5.005.119.048
14/11/2016 00:00,35.66,44982,1046,5,32,1305,3,2391,4.914.166.667
14/11/2016 01:00,34.8,44207,1020,5,38,1407,5,2475,4.914.166.667
14/11/2016 02:00,34.5,43992,1022,5,41,1519,5,2592,4.914.166.667
14/11/2016 03:00,35.06,44177,1063,5,51,1708,5,2832,4.914.166.667
14/11/2016 04:00,35.69,44942,1172,6,64,1853,6,3101,4.914.166.667
14/11/2016 05:00,38.27,47290,1320,7,88,1951,6,3372,4.914.166.667
14/11/2016 06:00,41.79,51739,1470,8,104,2129,7,3718,4.914.166.667
14/11/2016 07:00,43.75,55747,1618,7,118,2372,7,4122,4.914.166.667
14/11/2016 08:00,43.92,55384,1807,6,130,2489,6,4438,4.914.166.667
14/11/2016 09:00,42.85,55496,2053,7,138,2566,6,4770,4.914.166.667
14/11/2016 10:00,41.4,55586,2243,6,149,2642,7,5047,4.914.166.667
14/11/2016 11:00,41.52,55410,2357,4,160,2686,8,5215,4.914.166.667
14/11/2016 12:00,41.47,55329,2479,4,174,2661,7,5325,4.914.166.667
14/11/2016 13:00,41.35,55428,2554,4,185,2756,6,5505,4.914.166.667
14/11/2016 14:00,41.48,55405,2593,5,189,2823,4,5614,4.914.166.667
14/11/2016 15:00,41.97,55866,2641,7,186,2888,3,5725,4.914.166.667
14/11/2016 16:00,43.42,56673,2681,10,182,2875,3,5751,4.914.166.667
14/11/2016 17:00,44.05,57108,2719,12,175,2819,3,5728,4.914.166.667
14/11/2016 18:00,42.94,56220,2735,15,165,2799,2,5716,4.914.166.667
14/11/2016 19:00,40.79,54951,2648,18,159,2880,2,5707,4.914.166.667
14/11/2016 20:00,39.86,53073,2467,21,153,2864,2,5507,4.914.166.667
14/11/2016 21:00,38.64,51291,2289,24,149,2728,3,5193,4.914.166.667
14/11/2016 22:00,36.41,48948,2107,26,148,2541,4,4826,4.914.166.667
14/11/2016 23:00,35.25,46414,1958,28,150,2428,4,4568,4.914.166.667
15/11/2016 00:00,33.7,44624,2255,16,178,2404,3,4856,4.914.166.667
15/11/2016 01:00,33.06,43659,2153,19,177,2360,2,4711,4.914.166.667
15/11/2016 02:00,32.9,43212,2062,22,167,2225,3,4479,4.914.166.667
15/11/2016 03:00,32.94,43318,1983,25,161,2210,3,4382,4.914.166.667
15/11/2016 04:00,34.11,44077,1918,29,154,2231,3,4335,4.914.166.667
15/11/2016 05:00,35.82,46489,1903,33,149,2360,4,4449,4.914.166.667
15/11/2016 06:00,39.4,50780,1967,39,144,2559,7,4716,4.914.166.667
15/11/2016 07:00,42.09,54687,2112,43,142,2571,6,4874,4.914.166.667
15/11/2016 08:00,42.4,53903,2264,47,142,2675,8,5136,4.914.166.667
15/11/2016 09:00,42.54,53855,2380,53,142,2660,8,5243,4.914.166.667
15/11/2016 10:00,40.86,54308,2451,59,148,2606,8,5272,4.914.166.667
15/11/2016 11:00,40.98,54374,2462,68,156,2628,10,5324,4.914.166.667
15/11/2016 12:00,40.62,54318,2454,79,171,2743,13,5460,4.914.166.667
15/11/2016 13:00,40.78,54153,2452,91,190,2662,18,5413,4.914.166.667
15/11/2016 14:00,40.12,54040,2480,104,210,2528,22,5344,4.914.166.667
15/11/2016 15:00,41.1,54428,2510,122,221,2582,22,5457,4.914.166.667
15/11/2016 16:00,42.31,55217,2442,134,232,2474,28,5310,4.914.166.667
15/11/2016 17:00,43.56,55801,2304,142,246,2551,33,5276,4.914.166.667
15/11/2016 18:00,42.33,55139,2140,147,251,2553,34,5125,4.914.166.667
15/11/2016 19:00,40.45,53946,1969,152,258,2488,34,4901,4.914.166.667
15/11/2016 20:00,39.48,52132,1780,156,261,2351,33,4581,4.914.166.667
15/11/2016 21:00,38.72,50391,1593,160,259,2220,33,4265,4.914.166.667
15/11/2016 22:00,37.54,48219,1400,163,255,2084,30,3932,4.914.166.667
15/11/2016 23:00,35.55,45492,1221,162,246,2094,30,3753,4.914.166.667
16/11/2016 00:00,34.97,43554,1100,146,233,1995,23,3497,4.914.166.667
16/11/2016 01:00,34.23,42610,943,136,219,2007,17,3322,4.914.166.667
16/11/2016 02:00,33.8,42373,836,122,205,1872,12,3047,4.914.166.667
16/11/2016 03:00,34.03,42592,750,105,183,1617,7,2662,4.914.166.667
16/11/2016 04:00,35.35,43470,697,88,165,1337,6,2293,4.914.166.667
16/11/2016 05:00,37.96,45794,729,73,144,1350,4,2300,4.914.166.667
16/11/2016 06:00,41.68,50075,819,62,122,1269,3,2275,4.914.166.667
16/11/2016 07:00,44.58,54086,923,53,104,1190,3,2273,4.914.166.667
16/11/2016 08:00,45.22,53876,1081,45,90,1218,2,2436,4.914.166.667
16/11/2016 09:00,43.96,53849,1322,41,82,1360,2,2807,4.914.166.667
16/11/2016 10:00,41.49,53973,1644,39,76,1439,1,3199,4.914.166.667
16/11/2016 11:00,41.24,53808,2012,37,69,1608,1,3727,4.914.166.667
16/11/2016 12:00,41.64,53578,2367,38,67,1676,1,4149,4.914.166.667
16/11/2016 13:00,41.12,53640,2578,39,69,1800,2,4488,4.914.166.667
16/11/2016 14:00,40.93,53642,2728,43,68,2003,2,4844,4.914.166.667
16/11/2016 15:00,41.64,54031,2972,47,78,2307,3,5407,4.914.166.667
16/11/2016 16:00,41.95,55025,3171,53,90,2640,4,5958,4.914.166.667
16/11/2016 17:00,41.94,55540,3313,56,100,2848,5,6322,4.914.166.667
16/11/2016 18:00,40.66,54818,3485,63,114,3067,5,6734,4.914.166.667
16/11/2016 19:00,39.12,53740,3484,71,130,3335,6,7026,4.914.166.667
16/11/2016 20:00,38.31,51968,3287,80,142,3423,9,6941,4.914.166.667
16/11/2016 21:00,37.48,50272,3127,87,155,3382,11,6762,4.914.166.667
16/11/2016 22:00,36,47971,3043,96,175,3446,13,6773,4.914.166.667
16/11/2016 23:00,33.63,45156,2987,105,191,3543,19,6845,4.914.166.667
17/11/2016 00:00,31.62,42885,2673,128,200,3791,34,6826,4.914.166.667
17/11/2016 01:00,31.07,42095,2598,135,205,3787,40,6765,4.914.166.667
17/11/2016 02:00,31,41863,2563,145,210,3748,48,6714,4.914.166.667
17/11/2016 03:00,31.35,42090,2528,154,210,3720,44,6656,4.914.166.667
17/11/2016 04:00,32.21,42901,2461,162,205,3649,34,6511,4.914.166.667
17/11/2016 05:00,34.89,45181,2381,168,200,3584,23,6356,4.914.166.667
17/11/2016 06:00,38.26,49350,2272,170,190,3486,14,6132,4.914.166.667
17/11/2016 07:00,40.33,53176,2121,165,180,3327,12,5805,4.914.166.667
17/11/2016 08:00,41.03,53829,2031,152,170,3145,11,5509,4.914.166.667
17/11/2016 09:00,40.62,52731,2018,139,155,3007,10,5329,4.914.166.667
17/11/2016 10:00,39.93,53033,2018,128,145,2859,11,5161,4.914.166.667
17/11/2016 11:00,39.88,53019,2087,117,133,2759,13,5109,4.914.166.667
17/11/2016 12:00,39.83,52886,2272,110,123,2717,15,5237,4.914.166.667
17/11/2016 13:00,39.68,52998,2453,102,115,2633,15,5318,4.914.166.667
17/11/2016 14:00,39.59,53067,2557,96,111,2725,11,5500,4.914.166.667
17/11/2016 15:00,39.87,53711,2609,91,115,2642,8,5465,4.914.166.667
17/11/2016 16:00,40.76,54730,2634,95,125,2545,6,5405,4.914.166.667
17/11/2016 17:00,41.55,55290,2731,98,135,2578,7,5549,4.914.166.667
17/11/2016 18:00,40.2,54580,2878,101,150,2623,7,5759,4.914.166.667
17/11/2016 19:00,38.65,53429,3058,100,165,2633,7,5963,4.914.166.667
17/11/2016 20:00,37.46,51750,3326,98,177,2687,8,6296,4.914.166.667
17/11/2016 21:00,36.47,50201,3624,97,195,2604,8,6528,4.914.166.667
17/11/2016 22:00,35.07,47961,3812,96,215,2603,7,6733,4.914.166.667
17/11/2016 23:00,33.99,45409,3937,95,230,2645,8,6915,4.914.166.667
18/11/2016 00:00,32.88,43444,4170,92,236,2599,45,7142,4.914.166.667
18/11/2016 01:00,31.27,43086,3786,95,234,2749,41,6905,4.914.166.667
18/11/2016 02:00,30.28,42611,3677,97,228,2907,43,6952,4.914.166.667
18/11/2016 03:00,31.01,42575,3555,105,217,3071,37,6985,4.914.166.667
18/11/2016 04:00,32.39,43151,3780,108,208,3182,22,7300,4.914.166.667
18/11/2016 05:00,34.04,45153,3481,115,207,3211,16,7030,4.914.166.667
18/11/2016 06:00,36.06,49220,3137,121,216,3148,24,6646,4.914.166.667
18/11/2016 07:00,39.26,53019,2827,133,228,3028,35,6251,4.914.166.667
18/11/2016 08:00,39.47,52595,2547,139,242,2905,39,5872,4.914.166.667
18/11/2016 09:00,39.29,52666,2256,147,256,2701,46,5406,4.914.166.667
18/11/2016 10:00,38.04,52924,2073,161,270,2617,51,5172,4.914.166.667
18/11/2016 11:00,37.88,52728,2018,171,285,2571,51,5096,4.914.166.667
18/11/2016 12:00,37.99,52280,2014,183,298,2568,54,5117,4.914.166.667
18/11/2016 13:00,37.86,51996,2104,188,309,2635,54,5290,4.914.166.667
18/11/2016 14:00,37.55,51754,2208,190,323,2720,48,5489,4.914.166.667
18/11/2016 15:00,38.43,52022,2415,193,333,2799,46,5786,4.914.166.667
18/11/2016 16:00,39.52,52766,2679,198,339,2950,45,6211,4.914.166.667
18/11/2016 17:00,39.84,53172,2897,202,342,3080,51,6572,4.914.166.667
18/11/2016 18:00,38.88,52502,3075,207,341,3092,57,6772,4.914.166.667
18/11/2016 19:00,36.93,51186,3236,210,339,3065,59,6909,4.914.166.667
18/11/2016 20:00,35.36,49314,3324,211,333,3053,60,6981,4.914.166.667
18/11/2016 21:00,34.71,47833,3334,212,326,3052,62,6986,4.914.166.667
18/11/2016 22:00,33.9,46094,3309,212,318,3071,61,6971,4.914.166.667
18/11/2016 23:00,32.35,44276,3282,213,310,3037,60,6902,4.914.166.667
19/11/2016 00:00,32.26,42113,3231,213,280,3169,63,6956,4.914.166.667
19/11/2016 01:00,31.27,41169,3158,205,265,3219,48,6895,4.914.166.667
19/11/2016 02:00,31.06,40598,3095,205,260,3293,32,6885,4.914.166.667
19/11/2016 03:00,30.88,40419,3013,200,255,3324,36,6828,4.914.166.667
19/11/2016 04:00,31.01,40652,2897,197,245,3340,35,6714,4.914.166.667
19/11/2016 05:00,31.69,41388,2738,197,225,3345,29,6534,4.914.166.667
19/11/2016 06:00,32.79,42759,2703,197,225,3342,30,6497,4.914.166.667
19/11/2016 07:00,34.01,44295,2712,197,210,3385,28,6532,4.914.166.667
19/11/2016 08:00,35.46,45546,2708,196,190,3378,29,6501,4.914.166.667
19/11/2016 09:00,36.08,47203,2715,195,165,3401,37,6513,4.914.166.667
19/11/2016 10:00,36.65,48132,2695,196,140,3401,49,6481,4.914.166.667
19/11/2016 11:00,36.58,48079,2671,198,120,3302,58,6349,4.914.166.667
19/11/2016 12:00,36.24,47735,2623,194,95,3281,53,6246,4.914.166.667
19/11/2016 13:00,36,47496,2442,191,80,3233,47,5993,4.914.166.667
19/11/2016 14:00,36.11,47771,2194,180,66,3202,36,5678,4.914.166.667
19/11/2016 15:00,37.27,48765,2046,164,66,3176,21,5473,4.914.166.667
19/11/2016 16:00,39.42,50290,2016,150,66,3022,10,5264,4.914.166.667
19/11/2016 17:00,40.2,51299,2066,136,66,3019,7,5294,4.914.166.667
19/11/2016 18:00,39.33,50683,2110,121,60,2922,6,5219,4.914.166.667
19/11/2016 19:00,37.61,49169,2147,107,60,2843,4,5161,4.914.166.667
19/11/2016 20:00,35.55,47432,2204,92,50,2804,7,5157,4.914.166.667
19/11/2016 21:00,34.85,46369,2233,76,40,2645,8,5002,4.914.166.667
19/11/2016 22:00,33.89,44981,2176,67,40,2411,10,4704,4.914.166.667
19/11/2016 23:00,33.07,43431,2110,56,40,2282,16,4504,4.914.166.667
20/11/2016 00:00,32.94,42063,1589,43,75,2294,4,4005,4.914.166.667
20/11/2016 01:00,32.28,41120,1622,40,88,2222,3,3975,4.914.166.667
20/11/2016 02:00,32.02,40609,1670,39,111,2118,2,3940,4.914.166.667
20/11/2016 03:00,31.98,40594,1703,35,135,2014,3,3890,4.914.166.667
20/11/2016 04:00,32.24,40755,1835,33,145,1875,3,3891,4.914.166.667
20/11/2016 05:00,32.56,41253,1950,37,145,1793,3,3928,4.914.166.667
20/11/2016 06:00,33.37,42002,2080,49,140,1820,6,4095,4.914.166.667
20/11/2016 07:00,33.72,43040,2280,61,135,1832,6,4314,4.914.166.667
20/11/2016 08:00,34.3,43960,2465,75,125,1843,9,4517,4.914.166.667
20/11/2016 09:00,34.92,45635,2656,94,120,1888,10,4768,4.914.166.667
20/11/2016 10:00,35.94,46774,2875,106,111,1909,10,5011,4.914.166.667
20/11/2016 11:00,35.85,47179,3096,107,100,1891,11,5205,4.914.166.667
20/11/2016 12:00,35.92,47134,3328,106,90,2001,13,5538,4.914.166.667
20/11/2016 13:00,35.44,47215,3590,99,85,2202,11,5987,4.914.166.667
20/11/2016 14:00,35.06,47514,3840,94,90,2432,12,6468,4.914.166.667
20/11/2016 15:00,35.57,48708,4050,82,105,2723,11,6971,4.914.166.667
20/11/2016 16:00,36.21,50255,4125,77,125,2967,7,7301,4.914.166.667
20/11/2016 17:00,36.97,51058,4083,77,150,3130,9,7449,4.914.166.667
20/11/2016 18:00,36.24,50740,4027,82,177,3330,12,7628,4.914.166.667
20/11/2016 19:00,35.45,49763,3900,87,200,3495,16,7698,4.914.166.667
20/11/2016 20:00,34.51,48506,3365,92,215,3594,19,7285,4.914.166.667
20/11/2016 21:00,34.25,47507,3268,98,225,3639,22,7252,4.914.166.667
20/11/2016 22:00,33.61,45890,3228,102,233,3638,25,7226,4.914.166.667
20/11/2016 23:00,32.12,43918,2849,105,234,3631,28,6847,4.914.166.667
21/11/2016 00:00,32.13,42212,3530,149,290,3809,52,7830,4.849.940.476
21/11/2016 01:00,30.96,41233,3647,161,290,3867,50,8015,4.849.940.476
21/11/2016 02:00,30.75,40932,3422,174,290,3906,49,7841,4.849.940.476
21/11/2016 03:00,30.28,41068,3058,186,280,3895,48,7467,4.849.940.476
21/11/2016 04:00,31.54,41930,2435,193,270,3764,47,6709,4.849.940.476
21/11/2016 05:00,34,44246,1771,198,255,3659,43,5926,4.849.940.476
21/11/2016 06:00,37.18,48594,1275,203,240,3559,44,5321,4.849.940.476
21/11/2016 07:00,40.63,52796,980,207,235,3416,41,4879,4.849.940.476
21/11/2016 08:00,41.33,52231,771,205,235,3225,36,4472,4.849.940.476
21/11/2016 09:00,41.36,52369,598,206,225,2985,35,4049,4.849.940.476
21/11/2016 10:00,40.07,52500,557,204,205,2705,36,3707,4.849.940.476
21/11/2016 11:00,40.32,52253,550,199,190,2285,33,3257,4.849.940.476
21/11/2016 12:00,41.01,52198,590,192,185,2014,29,3010,4.849.940.476
21/11/2016 13:00,41.15,52334,648,183,180,1883,26,2920,4.849.940.476
21/11/2016 14:00,41.23,52462,703,175,190,1881,21,2970,4.849.940.476
21/11/2016 15:00,41.32,53026,822,168,205,1955,15,3165,4.849.940.476
21/11/2016 16:00,41.97,54146,889,163,222,1998,9,3281,4.849.940.476
21/11/2016 17:00,42.74,54566,896,161,225,2030,10,3322,4.849.940.476
21/11/2016 18:00,40.71,53754,964,159,235,2028,11,3397,4.849.940.476
21/11/2016 19:00,37.99,52500,1089,157,250,1989,13,3498,4.849.940.476
21/11/2016 20:00,36.8,50701,1201,155,250,1845,11,3462,4.849.940.476
21/11/2016 21:00,35.39,49188,1317,153,255,1841,12,3578,4.849.940.476
21/11/2016 22:00,34.27,46922,1437,151,260,1875,15,3738,4.849.940.476
21/11/2016 23:00,33.35,44368,1583,148,260,1864,16,3871,4.849.940.476
22/11/2016 00:00,33.24,42273,2008,152,268,1864,15,4307,4.849.940.476
22/11/2016 01:00,32.53,41368,1939,146,270,1810,16,4181,4.849.940.476
22/11/2016 02:00,32.08,40990,1890,139,267,1743,14,4053,4.849.940.476
22/11/2016 03:00,32.21,41071,1834,135,266,1631,15,3881,4.849.940.476
22/11/2016 04:00,33.16,41797,1662,133,265,1564,18,3642,4.849.940.476
22/11/2016 05:00,34.52,44128,1491,133,265,1505,19,3413,4.849.940.476
22/11/2016 06:00,37.82,48120,1367,134,262,1480,20,3263,4.849.940.476
22/11/2016 07:00,40.39,52172,1298,136,258,1466,22,3180,4.849.940.476
22/11/2016 08:00,41.14,52840,1254,133,251,1448,24,3110,4.849.940.476
22/11/2016 09:00,40.69,51311,1210,133,236,1458,26,3063,4.849.940.476
22/11/2016 10:00,39.77,51483,1192,130,231,1551,24,3128,4.849.940.476
22/11/2016 11:00,40.08,51408,1190,129,220,1641,21,3201,4.849.940.476
22/11/2016 12:00,40.2,51353,1148,128,202,1626,21,3125,4.849.940.476
22/11/2016 13:00,40.44,51506,1093,129,194,1658,21,3095,4.849.940.476
22/11/2016 14:00,41.21,51572,1079,132,201,1461,18,2891,4.849.940.476
22/11/2016 15:00,41.69,52145,1054,136,206,1548,17,2961,4.849.940.476
22/11/2016 16:00,42.88,52996,1065,142,213,1692,14,3126,4.849.940.476
22/11/2016 17:00,42.87,53296,1130,145,222,1866,18,3381,4.849.940.476
22/11/2016 18:00,41.42,52638,1155,148,222,1998,21,3544,4.849.940.476
22/11/2016 19:00,40.3,51474,1140,148,219,2056,21,3584,4.849.940.476
22/11/2016 20:00,39.29,49720,1139,146,212,2076,21,3594,4.849.940.476
22/11/2016 21:00,37.32,48688,1138,141,207,2076,18,3580,4.849.940.476
22/11/2016 22:00,36.51,46371,1089,137,201,2038,16,3481,4.849.940.476
22/11/2016 23:00,34.93,43622,1028,127,194,2040,15,3404,4.849.940.476
23/11/2016 00:00,33.88,41427,1324,134,212,1758,14,3442,4.849.940.476
23/11/2016 01:00,33.26,40368,1230,129,202,1620,13,3194,4.849.940.476
23/11/2016 02:00,33.11,39828,1129,125,192,1522,13,2981,4.849.940.476
23/11/2016 03:00,32.52,39912,1064,121,183,1414,13,2795,4.849.940.476
23/11/2016 04:00,33.64,40657,1011,119,175,1437,13,2755,4.849.940.476
23/11/2016 05:00,34.75,42883,975,116,168,1395,12,2666,4.849.940.476
23/11/2016 06:00,37.51,47013,953,115,161,1452,13,2694,4.849.940.476
23/11/2016 07:00,40.07,50995,951,113,152,1489,13,2718,4.849.940.476
23/11/2016 08:00,41.88,50468,981,107,145,1491,13,2737,4.849.940.476
23/11/2016 09:00,41.32,50354,1027,107,132,1515,13,2794,4.849.940.476
23/11/2016 10:00,40.84,50544,1007,107,119,1507,12,2752,4.849.940.476
23/11/2016 11:00,40.65,50512,926,106,95,1541,13,2681,4.849.940.476
23/11/2016 12:00,40.88,50489,871,104,66,1590,15,2646,4.849.940.476
23/11/2016 13:00,41.06,50746,814,103,56,1603,12,2588,4.849.940.476
23/11/2016 14:00,41.07,50976,740,102,53,1648,13,2556,4.849.940.476
23/11/2016 15:00,41.51,51620,719,102,51,1653,11,2536,4.849.940.476
23/11/2016 16:00,43.08,52522,744,105,52,1722,9,2632,4.849.940.476
23/11/2016 17:00,44.02,52910,836,103,52,1725,10,2726,4.849.940.476
23/11/2016 18:00,41.57,52250,947,101,50,1779,13,2890,4.849.940.476
23/11/2016 19:00,39.67,51277,956,98,49,1856,14,2973,4.849.940.476
23/11/2016 20:00,37.69,49623,875,94,49,1917,14,2949,4.849.940.476
23/11/2016 21:00,36.96,48109,893,92,49,2055,13,3102,4.849.940.476
23/11/2016 22:00,35.78,45946,998,92,50,2230,15,3385,4.849.940.476
23/11/2016 23:00,34.03,43391,1045,90,53,2395,17,3600,4.849.940.476
24/11/2016 00:00,32.68,41634,1447,100,55,2508,20,4130,4.849.940.476
24/11/2016 01:00,31.79,40778,1471,102,60,2587,20,4240,4.849.940.476
24/11/2016 02:00,30.98,40507,1400,106,60,2611,24,4201,4.849.940.476
24/11/2016 03:00,30.45,40982,1309,112,70,2670,26,4187,4.849.940.476
24/11/2016 04:00,30.83,41895,1183,120,77,2676,34,4090,4.849.940.476
24/11/2016 05:00,33.51,44532,1057,129,88,2597,46,3917,4.849.940.476
24/11/2016 06:00,36.24,48863,949,134,111,2613,48,3855,4.849.940.476
24/11/2016 07:00,39.96,52969,796,146,133,2535,51,3661,4.849.940.476
24/11/2016 08:00,41.88,53056,687,157,155,2437,53,3489,4.849.940.476
24/11/2016 09:00,41.55,52958,646,166,165,2418,42,3437,4.849.940.476
24/11/2016 10:00,40.77,53106,625,174,155,2359,38,3351,4.849.940.476
24/11/2016 11:00,40.81,52892,595,188,144,2361,40,3328,4.849.940.476
24/11/2016 12:00,40.45,52729,588,199,125,2261,34,3207,4.849.940.476
24/11/2016 13:00,40.78,52799,602,208,111,2200,28,3149,4.849.940.476
24/11/2016 14:00,40.82,53043,624,212,95,2128,19,3078,4.849.940.476
24/11/2016 15:00,41.91,53839,667,212,77,2232,10,3198,4.849.940.476
24/11/2016 16:00,43.68,54830,637,208,70,2262,7,3184,4.849.940.476
24/11/2016 17:00,44.15,55241,578,199,60,2222,6,3065,4.849.940.476
24/11/2016 18:00,42.58,54676,549,190,60,2100,5,2904,4.849.940.476
24/11/2016 19:00,40.52,53617,504,178,60,2017,7,2766,4.849.940.476
24/11/2016 20:00,38,51855,437,167,60,1882,6,2552,4.849.940.476
24/11/2016 21:00,37.3,50465,380,155,55,1699,6,2295,4.849.940.476
24/11/2016 22:00,35.83,48294,332,146,50,1590,6,2124,4.849.940.476
24/11/2016 23:00,34.41,45802,294,136,45,1407,6,1888,4.849.940.476
25/11/2016 00:00,34.62,43320,266,153,105,1274,9,1807,4.849.940.476
25/11/2016 01:00,33.57,42388,309,144,105,1081,8,1647,4.849.940.476
25/11/2016 02:00,32.95,42026,341,139,100,920,9,1509,4.849.940.476
25/11/2016 03:00,32.66,42343,348,134,95,907,10,1494,4.849.940.476
25/11/2016 04:00,33.61,43111,358,129,85,957,12,1541,4.849.940.476
25/11/2016 05:00,35.05,45688,370,123,80,1115,12,1700,4.849.940.476
25/11/2016 06:00,37.24,49870,379,114,75,1370,12,1950,4.849.940.476
25/11/2016 07:00,41.6,53989,400,102,65,1732,9,2308,4.849.940.476
25/11/2016 08:00,43.46,54777,446,79,60,2029,9,2623,4.849.940.476
25/11/2016 09:00,41.81,55163,503,61,50,2384,8,3006,4.849.940.476
25/11/2016 10:00,39.67,55002,517,46,35,2786,8,3392,4.849.940.476
25/11/2016 11:00,39.37,54397,539,32,30,2875,8,3484,4.849.940.476
25/11/2016 12:00,39.09,53572,606,20,30,2940,6,3602,4.849.940.476
25/11/2016 13:00,38.67,52816,691,16,30,3214,5,3956,4.849.940.476
25/11/2016 14:00,38.34,52564,818,14,35,3136,7,4010,4.849.940.476
25/11/2016 15:00,38.07,52874,962,21,35,3210,8,4236,4.849.940.476
25/11/2016 16:00,38.46,53495,1112,41,45,3257,10,4465,4.849.940.476
25/11/2016 17:00,38.35,53686,1236,67,75,3595,15,4988,4.849.940.476
25/11/2016 18:00,37.82,52807,1328,91,100,3686,23,5228,4.849.940.476
25/11/2016 19:00,36.05,51328,1451,107,125,3748,33,5464,4.849.940.476
25/11/2016 20:00,34.88,49171,1564,117,150,3837,38,5706,4.849.940.476
25/11/2016 21:00,34.62,47693,1646,126,200,3937,39,5948,4.849.940.476
25/11/2016 22:00,34.28,45814,1725,135,230,4049,38,6177,4.849.940.476
25/11/2016 23:00,32.84,43770,1798,138,270,4139,38,6383,4.849.940.476
26/11/2016 00:00,31.95,41609,2017,104,289,4263,18,6691,4.849.940.476
26/11/2016 01:00,31.04,40586,2148,114,311,4403,24,7000,4.849.940.476
26/11/2016 02:00,30.14,39876,2270,127,332,4482,31,7242,4.849.940.476
26/11/2016 03:00,29.79,39859,2397,140,350,4550,34,7471,4.849.940.476
26/11/2016 04:00,29.71,39973,2489,152,362,4553,41,7597,4.849.940.476
26/11/2016 05:00,29.96,40842,2540,159,373,4598,46,7716,4.849.940.476
26/11/2016 06:00,31.5,42015,2591,160,380,4600,50,7781,4.849.940.476
26/11/2016 07:00,32.23,43690,2680,149,383,4579,50,7841,4.849.940.476
26/11/2016 08:00,33.11,44632,2812,133,387,4606,50,7988,4.849.940.476
26/11/2016 09:00,33.69,46344,2946,122,390,4634,47,8139,4.849.940.476
26/11/2016 10:00,33.81,47255,3105,116,392,4704,45,8362,4.849.940.476
26/11/2016 11:00,33.68,47422,3311,117,393,4701,43,8565,4.849.940.476
26/11/2016 12:00,33.42,47356,3515,117,395,4582,38,8647,4.849.940.476
26/11/2016 13:00,33.18,47321,3652,120,397,4445,38,8652,4.849.940.476
26/11/2016 14:00,33.44,47700,3712,128,398,4350,44,8632,4.849.940.476
26/11/2016 15:00,33.95,48870,3791,134,400,4289,39,8653,4.849.940.476
26/11/2016 16:00,34.92,50384,3843,138,399,4306,40,8726,4.849.940.476
26/11/2016 17:00,35.24,51312,3867,139,398,4458,42,8904,4.849.940.476
26/11/2016 18:00,34.85,50741,3895,146,385,4677,40,9143,4.849.940.476
26/11/2016 19:00,33.92,49321,3904,149,362,4776,42,9233,4.849.940.476
26/11/2016 20:00,32.82,47499,3903,150,336,4848,36,9273,4.849.940.476
26/11/2016 21:00,32.6,46585,3885,147,308,4862,36,9238,4.849.940.476
26/11/2016 22:00,31.67,45249,3793,143,284,4832,29,9081,4.849.940.476
26/11/2016 23:00,30.19,43681,3623,139,272,4776,29,8839,4.849.940.476
27/11/2016 00:00,30.01,41887,3525,172,230,4787,37,8751,4.849.940.476
27/11/2016 01:00,29.67,41028,3306,170,231,4835,33,8575,4.849.940.476
27/11/2016 02:00,29.04,40534,3062,168,236,4864,30,8360,4.849.940.476
27/11/2016 03:00,28.28,40462,2819,168,239,4939,29,8194,4.849.940.476
27/11/2016 04:00,27.75,40634,2629,166,236,4997,30,8058,4.849.940.476
27/11/2016 05:00,28.45,41226,2480,162,228,5035,33,7938,4.849.940.476
27/11/2016 06:00,30.13,42046,2346,159,225,5055,34,7819,4.849.940.476
27/11/2016 07:00,31.31,43269,2285,160,223,5048,39,7755,4.849.940.476
27/11/2016 08:00,31.96,44482,2300,161,233,5031,46,7771,4.849.940.476
27/11/2016 09:00,32.94,46104,2334,161,240,4966,44,7745,4.849.940.476
27/11/2016 10:00,34.03,47394,2411,161,248,4961,48,7829,4.849.940.476
27/11/2016 11:00,34.69,47904,2530,160,270,4984,54,7998,4.849.940.476
27/11/2016 12:00,34.28,47912,2647,156,296,4997,56,8152,4.849.940.476
27/11/2016 13:00,33.33,47965,2702,153,305,5052,59,8271,4.849.940.476
27/11/2016 14:00,33.47,48397,2703,150,298,5047,60,8258,4.849.940.476
27/11/2016 15:00,34.17,49598,2705,153,278,4992,58,8186,4.849.940.476
27/11/2016 16:00,36.11,51129,2768,158,247,5018,57,8248,4.849.940.476
27/11/2016 17:00,36.68,52058,2855,165,233,4959,59,8271,4.849.940.476
27/11/2016 18:00,36.16,51883,2923,174,224,4937,56,8314,4.849.940.476
27/11/2016 19:00,35.1,51196,2889,180,217,4901,57,8244,4.849.940.476
27/11/2016 20:00,34.32,49999,2777,183,219,4765,50,7994,4.849.940.476
27/11/2016 21:00,33.42,49108,2661,186,244,4634,44,7769,4.849.940.476
27/11/2016 22:00,32.93,47592,2502,187,258,4541,44,7532,4.849.940.476
27/11/2016 23:00,32.29,45621,2314,189,266,4506,42,7317,4.849.940.476
28/11/2016 00:00,31.08,44411,2172,185,258,4445,40,7100,4.716.309.524
28/11/2016 01:00,29.97,43812,2004,189,274,4394,39,6900,4.716.309.524
28/11/2016 02:00,29.63,43743,1821,193,276,4297,44,6631,4.716.309.524
28/11/2016 03:00,30.16,44044,1676,196,272,4159,46,6349,4.716.309.524
28/11/2016 04:00,32.19,45045,1556,197,276,3973,48,6050,4.716.309.524
28/11/2016 05:00,33.72,47615,1450,194,286,3823,51,5804,4.716.309.524
28/11/2016 06:00,37.39,52217,1321,194,310,3618,55,5498,4.716.309.524
28/11/2016 07:00,43.69,56713,1171,186,323,3403,56,5139,4.716.309.524
28/11/2016 08:00,44.49,56557,1005,175,325,3133,54,4692,4.716.309.524
28/11/2016 09:00,42.68,56636,828,164,319,2898,49,4258,4.716.309.524
28/11/2016 10:00,39.44,56644,661,162,306,2685,45,3859,4.716.309.524
28/11/2016 11:00,41.32,56552,540,163,286,2509,36,3534,4.716.309.524
28/11/2016 12:00,39.05,56336,444,168,266,2357,27,3262,4.716.309.524
28/11/2016 13:00,41.92,56436,354,168,234,2303,23,3082,4.716.309.524
28/11/2016 14:00,43.17,56721,293,162,201,2446,33,3135,4.716.309.524
28/11/2016 15:00,44.9,57595,285,157,171,2524,44,3181,4.716.309.524
28/11/2016 16:00,46.17,58493,329,150,162,2614,40,3295,4.716.309.524
28/11/2016 17:00,49.97,58835,415,144,162,2674,25,3420,4.716.309.524
28/11/2016 18:00,45.99,58183,555,137,161,2679,14,3546,4.716.309.524
28/11/2016 19:00,41.68,57134,689,125,163,2713,10,3700,4.716.309.524
28/11/2016 20:00,40.55,55329,810,109,161,2751,9,3840,4.716.309.524
28/11/2016 21:00,37.97,53777,951,92,156,2751,10,3960,4.716.309.524
28/11/2016 22:00,36.16,51415,1109,78,147,2692,12,4038,4.716.309.524
28/11/2016 23:00,34.63,48767,1288,67,147,2637,14,4153,4.716.309.524
29/11/2016 00:00,34.65,46912,1816,82,322,2729,37,4986,4.716.309.524
29/11/2016 01:00,34.17,46050,1898,73,312,2642,29,4954,4.716.309.524
29/11/2016 02:00,33.52,45670,1931,66,289,2600,22,4908,4.716.309.524
29/11/2016 03:00,33.35,45774,1986,57,259,2523,21,4846,4.716.309.524
29/11/2016 04:00,34.12,46547,2004,48,213,2389,13,4667,4.716.309.524
29/11/2016 05:00,34.56,48999,1968,41,172,2176,9,4366,4.716.309.524
29/11/2016 06:00,37.44,53198,1869,34,127,2008,7,4045,4.716.309.524
29/11/2016 07:00,40.79,57691,1790,26,88,1927,6,3837,4.716.309.524
29/11/2016 08:00,43.57,56917,1788,18,45,1957,5,3813,4.716.309.524
29/11/2016 09:00,41.34,56719,1830,14,29,2023,4,3900,4.716.309.524
29/11/2016 10:00,39.79,56905,1909,12,23,2284,3,4231,4.716.309.524
29/11/2016 11:00,39.02,56569,2043,13,18,2474,3,4551,4.716.309.524
29/11/2016 12:00,38.51,56336,2191,17,15,2723,3,4949,4.716.309.524
29/11/2016 13:00,38.6,56412,2410,23,13,2958,3,5407,4.716.309.524
29/11/2016 14:00,38.47,56555,2672,34,12,3126,3,5847,4.716.309.524
29/11/2016 15:00,38.95,57419,2899,50,15,3278,3,6245,4.716.309.524
29/11/2016 16:00,39.64,58268,3061,73,23,3610,4,6771,4.716.309.524
29/11/2016 17:00,39.41,58359,3178,97,32,3840,5,7152,4.716.309.524
29/11/2016 18:00,37.91,57452,3292,124,51,3919,7,7393,4.716.309.524
29/11/2016 19:00,36.34,56144,3389,146,82,4102,9,7728,4.716.309.524
29/11/2016 20:00,34.98,54315,3482,163,109,4331,11,8096,4.716.309.524
29/11/2016 21:00,34.09,52586,3564,176,135,4394,15,8284,4.716.309.524
29/11/2016 22:00,32.72,50105,3585,187,164,4411,20,8367,4.716.309.524
29/11/2016 23:00,30.96,47285,3589,193,192,4454,22,8450,4.716.309.524
30/11/2016 00:00,29.98,45020,3833,197,233,4844,24,9131,4.716.309.524
30/11/2016 01:00,29.58,43984,3754,195,247,4929,23,9148,4.716.309.524
30/11/2016 02:00,29.53,43618,3664,189,269,4911,32,9065,4.716.309.524
30/11/2016 03:00,29.21,43787,3552,170,298,4915,29,8964,4.716.309.524
30/11/2016 04:00,29.84,44617,3394,139,320,4919,36,8808,4.716.309.524
30/11/2016 05:00,31.28,46914,3279,115,330,4872,40,8636,4.716.309.524
30/11/2016 06:00,34.06,51429,3232,106,338,4811,34,8521,4.716.309.524
30/11/2016 07:00,36.86,56108,3241,105,333,4646,25,8350,4.716.309.524
30/11/2016 08:00,37.68,55530,3236,103,318,4497,26,8180,4.716.309.524
30/11/2016 09:00,37.42,55345,3223,103,296,4394,26,8042,4.716.309.524
30/11/2016 10:00,36.43,55450,3208,99,278,4313,30,7928,4.716.309.524
30/11/2016 11:00,36.54,55398,3166,102,268,4180,34,7750,4.716.309.524
30/11/2016 12:00,36.16,55315,3100,107,258,4073,30,7568,4.716.309.524
30/11/2016 13:00,36.09,55355,3025,110,250,4020,31,7436,4.716.309.524
30/11/2016 14:00,36.5,55610,2962,110,232,3943,37,7284,4.716.309.524
30/11/2016 15:00,37.1,56645,2923,108,223,3927,24,7205,4.716.309.524
30/11/2016 16:00,38.59,57669,2898,109,207,3872,22,7108,4.716.309.524
30/11/2016 17:00,38.8,57836,2900,110,197,3791,20,7018,4.716.309.524
30/11/2016 18:00,37.85,56842,2985,109,190,3725,15,7024,4.716.309.524
30/11/2016 19:00,36.43,55793,3109,108,177,3569,14,6977,4.716.309.524
30/11/2016 20:00,34.93,54120,3230,102,171,3416,12,6931,4.716.309.524
30/11/2016 21:00,33.75,52557,3355,95,167,3252,10,6879,4.716.309.524
30/11/2016 22:00,32.58,50222,3500,89,159,3124,10,6882,4.716.309.524
30/11/2016 23:00,31.23,47500,3633,84,150,3084,9,6960,4.716.309.524
01/12/2016 00:00,30.97,45566,2724,90,0,2858,28,5700,4.716.309.524
01/12/2016 01:00,30.19,44649,2809,88,0,2811,26,5734,4.716.309.524
01/12/2016 02:00,30.23,44320,2887,91,0,2744,22,5744,4.716.309.524
01/12/2016 03:00,30.28,44461,3016,92,0,2719,20,5847,4.716.309.524
01/12/2016 04:00,31.07,45311,3193,90,0,2640,16,5939,4.716.309.524
01/12/2016 05:00,32.45,47632,3448,83,0,2678,15,6224,4.716.309.524
01/12/2016 06:00,34.61,52079,3711,79,0,2700,13,6503,4.716.309.524
01/12/2016 07:00,36.59,56482,3823,71,0,2682,17,6593,4.716.309.524
01/12/2016 08:00,37.44,57179,3932,62,0,2702,16,6712,4.716.309.524
01/12/2016 09:00,36.23,55298,4046,60,0,2786,13,6905,4.716.309.524
01/12/2016 10:00,36,55511,4151,58,0,2843,13,7065,4.716.309.524
01/12/2016 11:00,35.63,55516,4245,57,0,2876,12,7190,4.716.309.524
01/12/2016 12:00,35.97,55390,4333,54,0,2886,11,7284,4.716.309.524
01/12/2016 13:00,35.58,55602,4382,50,0,2937,9,7378,4.716.309.524
01/12/2016 14:00,35.26,55863,4402,42,0,3044,7,7495,4.716.309.524
01/12/2016 15:00,35.58,56861,4411,38,0,3339,8,7796,4.716.309.524
01/12/2016 16:00,36.51,57719,4414,34,0,3589,7,8044,4.716.309.524
01/12/2016 17:00,37.07,57861,4413,31,0,3732,7,8183,4.716.309.524
01/12/2016 18:00,35.66,57119,4402,29,0,3890,6,8327,4.716.309.524
01/12/2016 19:00,34.91,56043,4378,26,0,4004,5,8413,4.716.309.524
01/12/2016 20:00,33.64,54425,4344,24,0,4056,5,8429,4.716.309.524
01/12/2016 21:00,33.06,52875,4293,21,0,4055,5,8374,4.716.309.524
01/12/2016 22:00,32.17,50459,4227,19,0,4090,7,8343,4.716.309.524
01/12/2016 23:00,30.71,47799,4110,17,0,4135,7,8269,4.716.309.524
02/12/2016 00:00,30.52,45609,3880,22,38,4313,6,8259,4.716.309.524
02/12/2016 01:00,30.07,44704,3555,20,37,4254,6,7872,4.716.309.524
02/12/2016 02:00,29.63,44396,3162,17,37,4201,6,7423,4.716.309.524
02/12/2016 03:00,29.61,44576,2749,16,37,4090,7,6899,4.716.309.524
02/12/2016 04:00,30.68,45412,2435,16,35,4018,8,6512,4.716.309.524
02/12/2016 05:00,32.34,47753,2240,16,33,3986,9,6284,4.716.309.524
02/12/2016 06:00,34,52224,2090,18,31,3926,10,6075,4.716.309.524
02/12/2016 07:00,38.02,56819,1967,19,34,3838,17,5875,4.716.309.524
02/12/2016 08:00,38.46,56660,1848,18,47,3817,25,5755,4.716.309.524
02/12/2016 09:00,37.83,56434,1715,17,65,3792,26,5615,4.716.309.524
02/12/2016 10:00,37.06,56467,1551,19,90,3762,25,5447,4.716.309.524
02/12/2016 11:00,37.07,56889,1376,22,120,3661,21,5200,4.716.309.524
02/12/2016 12:00,37.17,56197,1233,29,135,3476,20,4893,4.716.309.524
02/12/2016 13:00,37.47,55590,1122,40,146,3338,19,4665,4.716.309.524
02/12/2016 14:00,37.47,55570,1024,56,160,3235,24,4499,4.716.309.524
02/12/2016 15:00,38.33,55939,952,69,158,3056,20,4255,4.716.309.524
02/12/2016 16:00,39.38,56626,905,80,160,2899,28,4072,4.716.309.524
02/12/2016 17:00,40.4,56949,866,85,163,2704,31,3849,4.716.309.524
02/12/2016 18:00,39.27,56304,797,90,163,2439,21,3510,4.716.309.524
02/12/2016 19:00,37.44,55013,690,95,169,2278,14,3246,4.716.309.524
02/12/2016 20:00,36.46,53161,564,102,172,2121,20,2979,4.716.309.524
02/12/2016 21:00,36.57,52094,450,109,177,1997,23,2756,4.716.309.524
02/12/2016 22:00,35.88,50261,343,116,185,1915,22,2581,4.716.309.524
02/12/2016 23:00,34.49,48097,240,120,201,1873,24,2458,4.716.309.524
03/12/2016 00:00,33.45,45964,183,101,172,1906,23,2385,4.716.309.524
03/12/2016 01:00,32.87,44839,139,110,169,1845,19,2282,4.716.309.524
03/12/2016 02:00,33.45,44259,122,117,172,1758,26,2195,4.716.309.524
03/12/2016 03:00,33.16,44099,135,124,176,1736,36,2207,4.716.309.524
03/12/2016 04:00,33.32,44336,179,126,183,1727,42,2257,4.716.309.524
03/12/2016 05:00,33.35,45084,248,128,196,1659,38,2269,4.716.309.524
03/12/2016 06:00,34.82,46349,320,129,196,1609,34,2288,4.716.309.524
03/12/2016 07:00,34.99,48212,354,127,192,1563,27,2263,4.716.309.524
03/12/2016 08:00,36.27,50049,365,120,182,1532,23,2222,4.716.309.524
03/12/2016 09:00,37.29,51507,388,114,169,1398,18,2087,4.716.309.524
03/12/2016 10:00,37.23,52307,417,112,163,1311,15,2018,4.716.309.524
03/12/2016 11:00,37,52225,440,111,162,1123,15,1851,4.716.309.524
03/12/2016 12:00,35.63,51836,464,111,170,1022,11,1778,4.716.309.524
03/12/2016 13:00,35.47,51614,486,111,176,915,11,1699,4.716.309.524
03/12/2016 14:00,36.15,51907,530,111,178,846,12,1677,4.716.309.524
03/12/2016 15:00,37.48,52985,610,110,177,755,10,1662,4.716.309.524
03/12/2016 16:00,39.1,54284,694,107,172,701,9,1683,4.716.309.524
03/12/2016 17:00,39.81,55020,782,102,167,640,7,1698,4.716.309.524
03/12/2016 18:00,39.23,54471,874,97,164,583,6,1724,4.716.309.524
03/12/2016 19:00,37.48,52987,921,93,161,583,6,1764,4.716.309.524
03/12/2016 20:00,36.89,51418,927,88,156,615,5,1791,4.716.309.524
03/12/2016 21:00,36.63,50370,948,83,151,743,4,1929,4.716.309.524
03/12/2016 22:00,36.29,50686,986,78,144,878,3,2089,4.716.309.524
03/12/2016 23:00,34.32,48735,1030,72,131,1132,3,2368,4.716.309.524
04/12/2016 00:00,34.35,47056,581,83,66,1267,8,2005,4.716.309.524
04/12/2016 01:00,33.44,45671,590,80,65,1459,6,2200,4.716.309.524
04/12/2016 02:00,33.73,44671,598,78,62,1722,7,2467,4.716.309.524
04/12/2016 03:00,33.75,44537,624,72,49,1879,5,2629,4.716.309.524
04/12/2016 04:00,33.28,44575,645,65,40,2096,5,2851,4.716.309.524
04/12/2016 05:00,33.26,44975,638,56,35,2178,6,2913,4.716.309.524
04/12/2016 06:00,33.59,45671,641,45,24,2228,4,2942,4.716.309.524
04/12/2016 07:00,33.61,46927,677,32,21,2430,3,3163,4.716.309.524
04/12/2016 08:00,34.28,48122,706,21,17,2565,3,3312,4.716.309.524
04/12/2016 09:00,34.98,49627,715,14,13,2695,3,3440,4.716.309.524
04/12/2016 10:00,34.89,50873,757,12,11,2781,3,3564,4.716.309.524
04/12/2016 11:00,34.98,51275,835,19,15,2889,6,3764,4.716.309.524
04/12/2016 12:00,34.38,51131,907,38,18,2912,5,3880,4.716.309.524
04/12/2016 13:00,33.92,51019,971,63,30,3021,7,4092,4.716.309.524
04/12/2016 14:00,33.88,51180,1041,87,38,3202,9,4377,4.716.309.524
04/12/2016 15:00,34.58,52105,1103,109,58,3402,10,4682,4.716.309.524
04/12/2016 16:00,36.6,53186,1145,128,82,3534,11,4900,4.716.309.524
04/12/2016 17:00,36.69,53720,1193,152,112,3658,13,5128,4.716.309.524
04/12/2016 18:00,36.22,53312,1225,170,138,3825,15,5373,4.716.309.524
04/12/2016 19:00,35.32,52372,1263,185,163,3976,19,5606,4.716.309.524
04/12/2016 20:00,34.41,50962,1301,195,188,4038,22,5744,4.716.309.524
04/12/2016 21:00,33.97,49632,1330,202,223,4093,25,5873,4.716.309.524
04/12/2016 22:00,33.3,47806,1355,210,251,4117,29,5962,4.716.309.524
04/12/2016 23:00,32.05,45677,1389,216,271,4192,36,6104,4.716.309.524
05/12/2016 00:00,31.44,44301,1464,224,329,4330,38,6385,4.685.833.333
05/12/2016 01:00,30.87,43444,1554,225,358,4321,43,6501,4.685.833.333
05/12/2016 02:00,30.56,43077,1643,228,375,4405,45,6696,4.685.833.333
05/12/2016 03:00,30.57,42858,1682,228,384,4451,48,6793,4.685.833.333
05/12/2016 04:00,31.21,43709,1725,230,391,4513,46,6905,4.685.833.333
05/12/2016 05:00,32.41,46126,1752,233,398,4555,44,6982,4.685.833.333
05/12/2016 06:00,34.46,50654,1777,236,403,4546,44,7006,4.685.833.333
05/12/2016 07:00,36.26,55168,1842,235,408,4446,44,6975,4.685.833.333
05/12/2016 08:00,36.77,54520,1889,230,411,4357,43,6930,4.685.833.333
05/12/2016 09:00,35.84,54619,1919,229,414,4329,43,6934,4.685.833.333
05/12/2016 10:00,35.53,54841,1966,224,417,4249,47,6903,4.685.833.333
05/12/2016 11:00,35.43,54896,2035,216,417,4127,50,6845,4.685.833.333
05/12/2016 12:00,35.54,54812,2108,209,411,4046,51,6825,4.685.833.333
05/12/2016 13:00,36.11,55164,2151,203,405,3885,49,6693,4.685.833.333
05/12/2016 14:00,36.61,55487,2158,200,396,3709,46,6509,4.685.833.333
05/12/2016 15:00,37.42,56338,2142,199,384,3557,45,6327,4.685.833.333
05/12/2016 16:00,38.76,57175,2107,200,364,3496,43,6210,4.685.833.333
05/12/2016 17:00,38.79,57401,2075,197,332,3388,41,6033,4.685.833.333
05/12/2016 18:00,38.32,56643,2019,192,287,3214,38,5750,4.685.833.333
05/12/2016 19:00,37.04,55606,1908,187,255,3145,33,5528,4.685.833.333
05/12/2016 20:00,36.17,53952,1769,178,239,3042,27,5255,4.685.833.333
05/12/2016 21:00,34.98,52434,1616,169,222,2930,22,4959,4.685.833.333
05/12/2016 22:00,33.86,50085,1441,158,212,2747,18,4576,4.685.833.333
05/12/2016 23:00,32.88,47582,1274,145,196,2608,15,4238,4.685.833.333
06/12/2016 00:00,32.22,45889,939,139,164,2350,19,3611,4.685.833.333
06/12/2016 01:00,32.1,45023,795,128,166,2132,22,3243,4.685.833.333
06/12/2016 02:00,32.43,44810,676,125,164,1982,20,2967,4.685.833.333
06/12/2016 03:00,32.63,45046,605,123,165,1813,21,2727,4.685.833.333
06/12/2016 04:00,33.48,45763,505,120,167,1667,27,2486,4.685.833.333
06/12/2016 05:00,34.81,47783,386,114,165,1516,25,2206,4.685.833.333
06/12/2016 06:00,38.44,51960,310,104,164,1378,24,1980,4.685.833.333
06/12/2016 07:00,46.66,56533,250,92,159,1277,22,1800,4.685.833.333
06/12/2016 08:00,53.24,57034,203,71,152,1145,21,1592,4.685.833.333
06/12/2016 09:00,52.6,57081,182,58,144,1020,23,1427,4.685.833.333
06/12/2016 10:00,47.67,57451,160,49,142,1004,20,1375,4.685.833.333
06/12/2016 11:00,46.6,57263,142,41,133,954,17,1287,4.685.833.333
06/12/2016 12:00,45.8,57071,130,36,122,890,13,1191,4.685.833.333
06/12/2016 13:00,46.3,57186,131,34,107,979,11,1262,4.685.833.333
06/12/2016 14:00,46.85,57609,145,33,92,1160,8,1438,4.685.833.333
06/12/2016 15:00,47.53,58602,163,30,81,1374,6,1654,4.685.833.333
06/12/2016 16:00,50.21,59444,176,29,71,1620,4,1900,4.685.833.333
06/12/2016 17:00,54.98,59799,185,26,52,1824,5,2092,4.685.833.333
06/12/2016 18:00,47.59,58918,209,23,32,2064,4,2332,4.685.833.333
06/12/2016 19:00,40.1,57863,248,20,28,2198,4,2498,4.685.833.333
06/12/2016 20:00,38.38,56584,290,18,17,2375,3,2703,4.685.833.333
06/12/2016 21:00,36.84,55233,379,18,14,2566,3,2980,4.685.833.333
06/12/2016 22:00,34.96,52999,513,22,14,2755,4,3308,4.685.833.333
06/12/2016 23:00,33.26,50107,668,27,15,2950,3,3663,4.685.833.333
07/12/2016 00:00,31.64,47512,1302,47,0,3286,3,4638,4.685.833.333
07/12/2016 01:00,30.95,46331,1484,63,0,3434,4,4985,4.685.833.333
07/12/2016 02:00,30.55,45622,1604,82,0,3495,4,5185,4.685.833.333
07/12/2016 03:00,30.39,45511,1679,107,0,3561,5,5352,4.685.833.333
07/12/2016 04:00,30.77,46044,1785,127,0,3594,7,5513,4.685.833.333
07/12/2016 05:00,31.39,48080,1969,149,0,3567,4,5689,4.685.833.333
07/12/2016 06:00,34.03,52205,2140,171,0,3535,5,5851,4.685.833.333
07/12/2016 07:00,36.91,56372,2307,185,0,3482,8,5982,4.685.833.333
07/12/2016 08:00,37.34,56051,2497,188,0,3321,11,6017,4.685.833.333
07/12/2016 09:00,35.75,55746,2705,191,0,3270,16,6182,4.685.833.333
07/12/2016 10:00,35.12,55830,2907,194,0,3284,22,6407,4.685.833.333
07/12/2016 11:00,34.99,55789,3105,197,0,3225,28,6555,4.685.833.333
07/12/2016 12:00,34.98,55685,3290,199,0,3213,35,6737,4.685.833.333
07/12/2016 13:00,34.81,55893,3408,198,0,3201,40,6847,4.685.833.333
07/12/2016 14:00,34.84,56049,3460,195,0,3254,45,6954,4.685.833.333
07/12/2016 15:00,35.58,56396,3508,191,0,3217,44,6960,4.685.833.333
07/12/2016 16:00,35.91,57159,3555,189,0,3260,44,7048,4.685.833.333
07/12/2016 17:00,35.66,57233,3607,180,0,3259,48,7094,4.685.833.333
07/12/2016 18:00,34.64,56249,3654,172,0,3210,52,7088,4.685.833.333
07/12/2016 19:00,33.41,55058,3657,165,0,3166,57,7045,4.685.833.333
07/12/2016 20:00,32.48,53222,3651,156,0,3127,57,6991,4.685.833.333
07/12/2016 21:00,31.49,51375,3681,147,0,3082,57,6967,4.685.833.333
07/12/2016 22:00,30.49,48732,3767,135,0,3037,59,6998,4.685.833.333
07/12/2016 23:00,29.03,45740,3834,120,0,3010,58,7022,4.685.833.333
08/12/2016 00:00,27.75,43480,3874,131,0,2980,60,7045,4.685.833.333
08/12/2016 01:00,27.17,42156,3877,123,0,2991,58,7049,4.685.833.333
08/12/2016 02:00,26.9,41544,3903,103,0,3004,57,7067,4.685.833.333
08/12/2016 03:00,27.05,41453,3918,87,0,3070,56,7131,4.685.833.333
08/12/2016 04:00,27.61,42238,3925,78,0,3112,52,7167,4.685.833.333
08/12/2016 05:00,27.93,44508,3950,69,0,3173,50,7242,4.685.833.333
08/12/2016 06:00,30.51,48797,3981,62,0,3221,49,7313,4.685.833.333
08/12/2016 07:00,32.85,53185,3971,58,0,3235,48,7312,4.685.833.333
08/12/2016 08:00,33.31,54105,3927,51,0,3250,44,7272,4.685.833.333
08/12/2016 09:00,32.9,53209,3864,48,0,3243,46,7201,4.685.833.333
08/12/2016 10:00,32.25,53326,3763,45,0,3322,46,7176,4.685.833.333
08/12/2016 11:00,32.05,53236,3645,43,0,3340,55,7083,4.685.833.333
08/12/2016 12:00,31.91,52588,3514,41,0,3424,53,7032,4.685.833.333
08/12/2016 13:00,32.3,52731,3341,42,0,3481,50,6914,4.685.833.333
08/12/2016 14:00,32.79,52750,3037,46,0,3526,55,6664,4.685.833.333
08/12/2016 15:00,33.05,53729,2662,47,0,3739,56,6504,4.685.833.333
08/12/2016 16:00,33.38,54586,2292,49,0,3990,47,6378,4.685.833.333
08/12/2016 17:00,33.6,54804,2017,47,0,4114,42,6220,4.685.833.333
08/12/2016 18:00,32.98,54152,1870,44,0,4210,33,6157,4.685.833.333
08/12/2016 19:00,32.36,53241,1802,44,0,4194,41,6081,4.685.833.333
08/12/2016 20:00,31.67,51551,1811,46,0,4106,45,6008,4.685.833.333
08/12/2016 21:00,30.63,49941,1842,49,0,3874,40,5805,4.685.833.333
08/12/2016 22:00,29.75,47596,1901,53,0,3747,35,5736,4.685.833.333
08/12/2016 23:00,27.74,45003,2023,56,0,3824,38,5941,4.685.833.333
09/12/2016 00:00,26.77,43205,1593,55,371,3695,44,5758,4.685.833.333
09/12/2016 01:00,26,42153,1595,68,358,3655,41,5717,4.685.833.333
09/12/2016 02:00,25.74,41817,1759,82,340,3699,44,5924,4.685.833.333
09/12/2016 03:00,25.85,41940,1979,96,326,3690,40,6131,4.685.833.333
09/12/2016 04:00,26.57,42729,2144,105,303,3718,42,6312,4.685.833.333
09/12/2016 05:00,28.02,45237,2248,109,276,3789,42,6464,4.685.833.333
09/12/2016 06:00,29.98,49555,2361,110,261,3927,45,6704,4.685.833.333
09/12/2016 07:00,32.86,54047,2473,110,265,3978,38,6864,4.685.833.333
09/12/2016 08:00,33.33,53368,2516,109,268,3903,37,6833,4.685.833.333
09/12/2016 09:00,32.59,53324,2523,115,283,3882,34,6837,4.685.833.333
09/12/2016 10:00,31.97,53578,2495,119,303,3866,36,6819,4.685.833.333
09/12/2016 11:00,31.76,53414,2354,117,325,3828,38,6662,4.685.833.333
09/12/2016 12:00,31.92,53061,2197,115,336,3737,42,6427,4.685.833.333
09/12/2016 13:00,31.85,53011,2092,112,346,3639,42,6231,4.685.833.333
09/12/2016 14:00,32.13,53121,2017,112,348,3510,42,6029,4.685.833.333
09/12/2016 15:00,32.56,53798,1937,113,346,3413,42,5851,4.685.833.333
09/12/2016 16:00,33.43,54645,1849,119,344,3290,37,5639,4.685.833.333
09/12/2016 17:00,33.63,54783,1876,121,328,3068,34,5427,4.685.833.333
09/12/2016 18:00,33.19,54021,1964,120,312,2776,30,5202,4.685.833.333
09/12/2016 19:00,31.94,52674,1936,120,288,2456,24,4824,4.685.833.333
09/12/2016 20:00,30.8,50837,1917,113,275,2207,25,4537,4.685.833.333
09/12/2016 21:00,30.26,49418,2051,106,267,1953,25,4402,4.685.833.333
09/12/2016 22:00,29.29,47651,2267,93,253,1755,25,4393,4.685.833.333
09/12/2016 23:00,28.4,45433,2479,82,241,1622,27,4451,4.685.833.333
10/12/2016 00:00,27.74,43286,2943,96,241,1626,11,4917,4.685.833.333
10/12/2016 01:00,26.75,42164,3005,90,225,1640,8,4968,4.685.833.333
10/12/2016 02:00,26.41,41603,2961,88,206,1651,9,4915,4.685.833.333
10/12/2016 03:00,26.43,41344,2894,83,173,1697,10,4857,4.685.833.333
10/12/2016 04:00,26.69,41591,2822,80,151,1725,7,4785,4.685.833.333
10/12/2016 05:00,27.39,42360,2746,74,137,1723,3,4683,4.685.833.333
10/12/2016 06:00,28.36,43729,2693,63,114,1738,1,4609,4.685.833.333
10/12/2016 07:00,28.44,45468,2692,55,90,1741,0,4578,4.685.833.333
10/12/2016 08:00,29.31,47245,2740,49,48,1757,0,4594,4.685.833.333
10/12/2016 09:00,30.44,47905,2763,45,33,1734,0,4575,4.685.833.333
10/12/2016 10:00,31.04,48992,2747,44,27,1730,0,4548,4.685.833.333
10/12/2016 11:00,31.23,49328,2751,44,23,1654,1,4473,4.685.833.333
10/12/2016 12:00,30.98,49298,2776,42,23,1653,2,4496,4.685.833.333
10/12/2016 13:00,31.08,49373,2706,41,25,1687,2,4461,4.685.833.333
10/12/2016 14:00,31.43,49872,2534,41,28,1718,3,4324,4.685.833.333
10/12/2016 15:00,32.3,51044,2340,38,35,1750,4,4167,4.685.833.333
10/12/2016 16:00,33.25,52347,2182,37,46,1780,4,4049,4.685.833.333
10/12/2016 17:00,33.51,52981,2051,36,59,1823,4,3973,4.685.833.333
10/12/2016 18:00,33.06,52385,1928,34,60,1799,2,3823,4.685.833.333
10/12/2016 19:00,32.29,51018,1824,33,62,1783,2,3704,4.685.833.333
10/12/2016 20:00,31.43,49533,1737,30,70,1679,1,3517,4.685.833.333
10/12/2016 21:00,31.45,48613,1656,28,75,1587,1,3347,4.685.833.333
10/12/2016 22:00,30.99,47215,1626,26,83,1505,2,3242,4.685.833.333
10/12/2016 23:00,30.18,45636,1657,24,85,1412,5,3183,4.685.833.333
11/12/2016 00:00,29.94,44359,1290,32,71,1285,15,2693,4.685.833.333
11/12/2016 01:00,28.78,43399,1298,33,74,1229,12,2646,4.685.833.333
11/12/2016 02:00,28.63,42807,1258,32,74,1216,11,2591,4.685.833.333
11/12/2016 03:00,27.98,42600,1204,29,74,1186,12,2505,4.685.833.333
11/12/2016 04:00,28.07,42731,1193,26,71,1207,13,2510,4.685.833.333
11/12/2016 05:00,28.39,43237,1228,21,67,1173,11,2500,4.685.833.333
11/12/2016 06:00,29.03,44012,1323,17,61,1200,9,2610,4.685.833.333
11/12/2016 07:00,29.06,45383,1512,16,55,1256,10,2849,4.685.833.333
11/12/2016 08:00,29.76,46415,1785,14,49,1291,9,3148,4.685.833.333
11/12/2016 09:00,30.23,47952,2063,14,46,1297,11,3431,4.685.833.333
11/12/2016 10:00,30.81,49217,2291,12,48,1346,10,3707,4.685.833.333
11/12/2016 11:00,31.04,49867,2476,12,49,1386,10,3933,4.685.833.333
11/12/2016 12:00,30.7,50093,2640,13,47,1440,10,4150,4.685.833.333
11/12/2016 13:00,30.69,50193,2707,14,46,1479,10,4256,4.685.833.333
11/12/2016 14:00,30.68,50652,2669,17,46,1534,10,4276,4.685.833.333
11/12/2016 15:00,31.09,51754,2594,23,51,1596,11,4275,4.685.833.333
11/12/2016 16:00,32.18,52941,2447,30,56,1695,11,4239,4.685.833.333
11/12/2016 17:00,32.52,53645,2292,38,65,1828,13,4236,4.685.833.333
11/12/2016 18:00,32.52,53458,2256,45,73,1893,13,4280,4.685.833.333
11/12/2016 19:00,31.87,52855,2280,49,79,1972,14,4394,4.685.833.333
11/12/2016 20:00,31.13,51745,2307,53,91,2098,14,4563,4.685.833.333
11/12/2016 21:00,30.68,50900,2410,57,105,2231,14,4817,4.685.833.333
11/12/2016 22:00,30.21,49424,2430,60,115,2418,14,5037,4.685.833.333
11/12/2016 23:00,29.56,47466,2332,63,123,2511,13,5042,4.685.833.333
12/12/2016 00:00,28.3,46120,1735,72,0,2811,24,4642,4.507.261.905
12/12/2016 01:00,28.59,45463,1713,75,0,2816,24,4628,4.507.261.905
12/12/2016 02:00,28.33,45099,1559,76,0,2715,25,4375,4.507.261.905
12/12/2016 03:00,28.31,45621,1299,75,0,2574,25,3973,4.507.261.905
12/12/2016 04:00,29.15,46653,941,70,0,2394,23,3428,4.507.261.905
12/12/2016 05:00,31.19,49221,664,66,0,2206,19,2955,4.507.261.905
12/12/2016 06:00,35.3,53768,524,58,0,2157,14,2753,4.507.261.905
12/12/2016 07:00,40.21,58342,423,50,0,2079,13,2565,4.507.261.905
12/12/2016 08:00,40.2,59030,351,48,0,1950,9,2358,4.507.261.905
12/12/2016 09:00,40.06,59167,309,55,0,1803,7,2174,4.507.261.905
12/12/2016 10:00,39.03,59473,293,73,0,1685,5,2056,4.507.261.905
12/12/2016 11:00,39.29,59355,300,100,0,1693,3,2096,4.507.261.905
12/12/2016 12:00,39.93,58989,334,127,0,1720,3,2184,4.507.261.905
12/12/2016 13:00,40.56,59013,373,155,0,1771,3,2302,4.507.261.905
12/12/2016 14:00,41.79,59230,388,172,0,1867,3,2430,4.507.261.905
12/12/2016 15:00,43.58,60089,408,184,0,1990,6,2588,4.507.261.905
12/12/2016 16:00,43.01,60816,464,188,0,1989,8,2649,4.507.261.905
12/12/2016 17:00,46.44,60978,556,185,0,1977,12,2730,4.507.261.905
12/12/2016 18:00,42.52,60105,659,177,0,2048,14,2898,4.507.261.905
12/12/2016 19:00,37.67,58941,732,164,0,2004,18,2918,4.507.261.905
12/12/2016 20:00,35.51,57169,779,146,0,1917,17,2859,4.507.261.905
12/12/2016 21:00,34.44,55458,831,129,0,1869,19,2848,4.507.261.905
12/12/2016 22:00,32.6,52906,891,108,0,1841,24,2864,4.507.261.905
12/12/2016 23:00,31.28,50104,924,91,0,1799,28,2842,4.507.261.905
13/12/2016 00:00,31.1,47951,912,55,0,1907,35,2909,4.507.261.905
13/12/2016 01:00,30.59,46815,881,42,0,1921,38,2882,4.507.261.905
13/12/2016 02:00,30.52,46343,822,33,0,2019,34,2908,4.507.261.905
13/12/2016 03:00,30.58,46362,774,27,0,2113,33,2947,4.507.261.905
13/12/2016 04:00,31.06,47070,740,23,0,2090,33,2886,4.507.261.905
13/12/2016 05:00,31.51,49389,727,20,0,2176,32,2955,4.507.261.905
13/12/2016 06:00,33.87,53598,748,18,0,2147,27,2940,4.507.261.905
13/12/2016 07:00,36.65,58268,772,18,0,2277,21,3088,4.507.261.905
13/12/2016 08:00,38.64,59349,776,17,0,2292,15,3100,4.507.261.905
13/12/2016 09:00,36,57640,772,21,0,2334,17,3144,4.507.261.905
13/12/2016 10:00,35.26,57848,734,25,0,2464,15,3238,4.507.261.905
13/12/2016 11:00,34.85,57785,688,26,0,2633,14,3361,4.507.261.905
13/12/2016 12:00,35.02,57622,660,31,0,2650,16,3357,4.507.261.905
13/12/2016 13:00,35.23,57621,593,37,0,2822,20,3472,4.507.261.905
13/12/2016 14:00,35.28,57746,506,42,0,3010,16,3574,4.507.261.905
13/12/2016 15:00,35.74,58457,451,48,0,3184,18,3701,4.507.261.905
13/12/2016 16:00,36.28,59084,428,60,0,3304,27,3819,4.507.261.905
13/12/2016 17:00,36.28,59155,414,69,0,3399,34,3916,4.507.261.905
13/12/2016 18:00,35.77,58271,384,76,0,3413,42,3915,4.507.261.905
13/12/2016 19:00,34.31,57240,324,79,0,3355,42,3800,4.507.261.905
13/12/2016 20:00,33.67,55642,258,82,0,3281,41,3662,4.507.261.905
13/12/2016 21:00,32.88,54087,227,84,0,3286,39,3636,4.507.261.905
13/12/2016 22:00,31.84,51752,205,79,0,3320,31,3635,4.507.261.905
13/12/2016 23:00,31.07,49097,173,70,0,3262,24,3529,4.507.261.905
14/12/2016 00:00,30.93,47188,220,32,276,3331,33,3892,4.507.261.905
14/12/2016 01:00,30.49,46064,220,29,276,3280,33,3838,4.507.261.905
14/12/2016 02:00,30.21,45601,216,27,254,3225,33,3755,4.507.261.905
14/12/2016 03:00,30.64,45577,237,28,240,3150,36,3691,4.507.261.905
14/12/2016 04:00,31.12,45954,261,35,240,3104,42,3682,4.507.261.905
14/12/2016 05:00,32.3,48473,269,46,240,3040,40,3635,4.507.261.905
14/12/2016 06:00,34.53,53024,292,61,246,2933,43,3575,4.507.261.905
14/12/2016 07:00,37.84,57731,304,74,257,2854,41,3530,4.507.261.905
14/12/2016 08:00,40.77,58941,304,83,251,2730,44,3412,4.507.261.905
14/12/2016 09:00,38.49,58334,313,88,239,2585,44,3269,4.507.261.905
14/12/2016 10:00,38.32,58088,329,87,225,2272,42,2955,4.507.261.905
14/12/2016 11:00,38.2,57840,318,82,209,2145,43,2797,4.507.261.905
14/12/2016 12:00,38.29,57552,293,77,196,1997,35,2598,4.507.261.905
14/12/2016 13:00,38.27,57727,285,70,180,1891,35,2461,4.507.261.905
14/12/2016 14:00,38.91,58135,294,61,174,1723,33,2285,4.507.261.905
14/12/2016 15:00,42.92,59024,333,53,170,1596,26,2178,4.507.261.905
14/12/2016 16:00,46.49,59941,387,43,166,1526,28,2150,4.507.261.905
14/12/2016 17:00,45.18,60223,435,34,159,1450,28,2106,4.507.261.905
14/12/2016 18:00,42.72,59486,470,26,150,1367,20,2033,4.507.261.905
14/12/2016 19:00,37.74,58504,474,20,145,1292,15,1946,4.507.261.905
14/12/2016 20:00,35.5,56898,490,17,140,1307,15,1969,4.507.261.905
14/12/2016 21:00,34.66,55307,526,14,132,1281,13,1966,4.507.261.905
14/12/2016 22:00,33.42,53011,554,12,119,1313,7,2005,4.507.261.905
14/12/2016 23:00,32.3,50278,594,12,99,1303,5,2013,4.507.261.905
15/12/2016 00:00,31.7,48467,490,5,0,1418,6,1919,4.507.261.905
15/12/2016 01:00,31.37,47513,491,7,0,1466,5,1969,4.507.261.905
15/12/2016 02:00,31.41,47046,510,9,0,1533,5,2057,4.507.261.905
15/12/2016 03:00,31.48,47085,572,13,0,1715,4,2304,4.507.261.905
15/12/2016 04:00,32.09,47826,649,17,0,1845,3,2514,4.507.261.905
15/12/2016 05:00,32.97,50174,666,20,0,1823,3,2512,4.507.261.905
15/12/2016 06:00,34.81,54433,674,22,0,1779,3,2478,4.507.261.905
15/12/2016 07:00,41.28,58975,722,25,0,1805,3,2555,4.507.261.905
15/12/2016 08:00,43.74,59530,802,28,0,1762,3,2595,4.507.261.905
15/12/2016 09:00,38.3,59187,898,33,0,1797,3,2731,4.507.261.905
15/12/2016 10:00,36.46,59222,991,39,0,1765,3,2798,4.507.261.905
15/12/2016 11:00,36.91,58893,1053,47,0,1798,4,2902,4.507.261.905
15/12/2016 12:00,37.46,58425,1118,53,0,1992,4,3167,4.507.261.905
15/12/2016 13:00,36.89,58223,1166,59,0,2044,4,3273,4.507.261.905
15/12/2016 14:00,36.99,58392,1207,68,0,2164,4,3443,4.507.261.905
15/12/2016 15:00,38.27,59231,1255,79,0,2048,5,3387,4.507.261.905
15/12/2016 16:00,38.02,60047,1299,87,0,2092,6,3484,4.507.261.905
15/12/2016 17:00,38.66,60238,1346,95,0,2181,10,3632,4.507.261.905
15/12/2016 18:00,37.23,59474,1390,101,0,2225,11,3727,4.507.261.905
15/12/2016 19:00,35.38,58340,1457,104,0,2115,13,3689,4.507.261.905
15/12/2016 20:00,33.95,56651,1518,102,0,2179,15,3814,4.507.261.905
15/12/2016 21:00,33.45,55089,1576,103,0,2156,19,3854,4.507.261.905
15/12/2016 22:00,32.55,52621,1601,103,0,2099,23,3826,4.507.261.905
15/12/2016 23:00,31.55,49741,1612,98,0,2049,29,3788,4.507.261.905
16/12/2016 00:00,31.4,47577,1374,83,117,2047,16,3637,4.507.261.905
16/12/2016 01:00,31.04,46480,1331,73,133,1911,19,3467,4.507.261.905
16/12/2016 02:00,30.85,45967,1334,66,149,1753,23,3325,4.507.261.905
16/12/2016 03:00,30.97,45930,1334,61,167,1678,25,3265,4.507.261.905
16/12/2016 04:00,31.54,46637,1227,60,180,1608,22,3097,4.507.261.905
16/12/2016 05:00,32.37,48992,1063,64,190,1530,21,2868,4.507.261.905
16/12/2016 06:00,35.64,53416,925,69,199,1486,21,2700,4.507.261.905
16/12/2016 07:00,40.07,57941,806,73,205,1477,22,2583,4.507.261.905
16/12/2016 08:00,44.02,58664,700,73,208,1424,21,2426,4.507.261.905
16/12/2016 09:00,39.68,58405,606,72,206,1392,21,2297,4.507.261.905
16/12/2016 10:00,39.69,58659,540,70,194,1259,21,2084,4.507.261.905
16/12/2016 11:00,38.46,58540,487,73,188,1214,20,1982,4.507.261.905
16/12/2016 12:00,39.84,57988,428,73,177,1221,17,1916,4.507.261.905
16/12/2016 13:00,39.06,57541,365,71,176,1237,18,1867,4.507.261.905
16/12/2016 14:00,39.74,57778,315,67,172,1295,17,1866,4.507.261.905
16/12/2016 15:00,39.85,58440,281,61,160,1274,18,1794,4.507.261.905
16/12/2016 16:00,40.02,59110,264,53,150,1338,15,1820,4.507.261.905
16/12/2016 17:00,40.7,59226,271,47,137,1331,13,1799,4.507.261.905
16/12/2016 18:00,39.03,58262,265,43,127,1372,14,1821,4.507.261.905
16/12/2016 19:00,37.34,56743,239,38,121,1436,13,1847,4.507.261.905
16/12/2016 20:00,35.23,54774,208,36,117,1502,12,1875,4.507.261.905
16/12/2016 21:00,34.46,53231,195,34,112,1504,13,1858,4.507.261.905
16/12/2016 22:00,33.58,51294,182,32,103,1487,14,1818,4.507.261.905
16/12/2016 23:00,32.68,48924,162,32,89,1483,13,1779,4.507.261.905
17/12/2016 00:00,32.07,46755,161,20,70,1511,8,1770,4.507.261.905
17/12/2016 01:00,31.6,45607,153,20,64,1475,8,1720,4.507.261.905
17/12/2016 02:00,31.41,44989,145,22,52,1400,8,1627,4.507.261.905
17/12/2016 03:00,31.32,44762,170,25,48,1399,8,1650,4.507.261.905
17/12/2016 04:00,31.34,44939,198,29,44,1433,6,1710,4.507.261.905
17/12/2016 05:00,31.61,45647,227,34,40,1529,5,1835,4.507.261.905
17/12/2016 06:00,31.78,46874,276,40,36,1639,5,1996,4.507.261.905
17/12/2016 07:00,31.96,48660,331,43,33,1709,8,2124,4.507.261.905
17/12/2016 08:00,32.61,49673,388,44,35,1756,8,2231,4.507.261.905
17/12/2016 09:00,33.67,51742,457,47,40,1814,7,2365,4.507.261.905
17/12/2016 10:00,33.78,52968,551,51,39,1848,8,2497,4.507.261.905
17/12/2016 11:00,33.71,53369,625,57,41,1861,9,2593,4.507.261.905
17/12/2016 12:00,32.94,53299,676,63,44,1961,10,2754,4.507.261.905
17/12/2016 13:00,32.58,53143,690,68,51,1974,10,2793,4.507.261.905
17/12/2016 14:00,32.72,53285,685,75,58,1980,11,2809,4.507.261.905
17/12/2016 15:00,33.36,54172,714,82,66,1967,13,2842,4.507.261.905
17/12/2016 16:00,34.46,55055,808,86,74,1979,14,2961,4.507.261.905
17/12/2016 17:00,34.79,55473,935,91,82,2072,15,3195,4.507.261.905
17/12/2016 18:00,33.91,54750,1079,93,100,2129,17,3418,4.507.261.905
17/12/2016 19:00,32.91,53204,1213,94,109,2241,18,3675,4.507.261.905
17/12/2016 20:00,31.91,51445,1345,92,117,2331,14,3899,4.507.261.905
17/12/2016 21:00,31.64,50265,1550,87,120,2425,12,4194,4.507.261.905
17/12/2016 22:00,31.09,48713,1773,86,123,2500,16,4498,4.507.261.905
17/12/2016 23:00,30.41,46701,1972,81,125,2594,17,4789,4.507.261.905
18/12/2016 00:00,29.22,44791,2083,73,107,2436,13,4712,4.507.261.905
18/12/2016 01:00,28.34,43783,2120,65,107,2434,14,4740,4.507.261.905
18/12/2016 02:00,28.32,43229,2049,56,108,2408,16,4637,4.507.261.905
18/12/2016 03:00,28.13,43055,1902,49,108,2333,19,4411,4.507.261.905
18/12/2016 04:00,28.52,43213,1656,45,108,2293,16,4118,4.507.261.905
18/12/2016 05:00,29.22,43749,1376,42,105,2195,13,3731,4.507.261.905
18/12/2016 06:00,30.06,44630,1127,41,102,2104,11,3385,4.507.261.905
18/12/2016 07:00,30.64,46064,883,40,92,2005,7,3027,4.507.261.905
18/12/2016 08:00,31.17,47629,660,42,85,1880,4,2671,4.507.261.905
18/12/2016 09:00,32.05,48515,476,44,75,1725,3,2323,4.507.261.905
18/12/2016 10:00,32.62,50070,353,50,64,1646,3,2116,4.507.261.905
18/12/2016 11:00,32.95,50848,287,53,45,1561,4,1950,4.507.261.905
18/12/2016 12:00,32.99,50950,242,56,38,1512,3,1851,4.507.261.905
18/12/2016 13:00,32.88,51088,194,59,35,1475,4,1767,4.507.261.905
18/12/2016 14:00,32.8,51563,150,59,32,1514,5,1760,4.507.261.905
18/12/2016 15:00,33.42,52653,124,56,33,1608,6,1827,4.507.261.905
18/12/2016 16:00,34.41,53885,109,55,36,1655,4,1859,4.507.261.905
18/12/2016 17:00,34.85,54444,102,57,37,1742,4,1942,4.507.261.905
18/12/2016 18:00,34.33,53998,102,57,40,1736,6,1941,4.507.261.905
18/12/2016 19:00,33.76,53141,105,53,41,1797,6,2002,4.507.261.905
18/12/2016 20:00,33.12,51799,112,49,40,1897,5,2103,4.507.261.905
18/12/2016 21:00,32.74,50639,140,45,42,1963,5,2195,4.507.261.905
18/12/2016 22:00,32.11,48753,191,42,44,2078,5,2360,4.507.261.905
18/12/2016 23:00,30.89,46496,254,38,45,2185,5,2527,4.507.261.905
19/12/2016 00:00,30.5,44622,344,68,59,2799,16,3286,4.463.630.952
19/12/2016 01:00,30.22,43676,400,68,66,2843,17,3394,4.463.630.952
19/12/2016 02:00,30.09,43278,434,68,73,2888,21,3484,4.463.630.952
19/12/2016 03:00,30.2,43368,466,69,82,2894,20,3531,4.463.630.952
19/12/2016 04:00,30.63,44178,487,70,92,2889,18,3556,4.463.630.952
19/12/2016 05:00,31.54,46532,494,68,110,2896,18,3586,4.463.630.952
19/12/2016 06:00,32.93,51122,514,67,126,2848,19,3574,4.463.630.952
19/12/2016 07:00,36.14,55775,529,62,146,2747,19,3503,4.463.630.952
19/12/2016 08:00,36.37,55126,555,57,169,2608,19,3408,4.463.630.952
19/12/2016 09:00,34.56,55137,603,52,192,2573,18,3438,4.463.630.952
19/12/2016 10:00,33.63,55409,637,44,220,2534,19,3454,4.463.630.952
19/12/2016 11:00,33.37,55532,639,37,245,2470,21,3412,4.463.630.952
19/12/2016 12:00,33.83,55589,631,32,263,2376,18,3320,4.463.630.952
19/12/2016 13:00,33.9,55610,604,32,266,2299,17,3218,4.463.630.952
19/12/2016 14:00,34.12,55868,575,32,260,2308,17,3192,4.463.630.952
19/12/2016 15:00,35.07,56642,565,31,250,2317,14,3177,4.463.630.952
19/12/2016 16:00,35.56,57191,550,30,232,2325,10,3147,4.463.630.952
19/12/2016 17:00,35.53,57095,555,27,218,2393,10,3203,4.463.630.952
19/12/2016 18:00,34.2,56141,589,25,194,2327,8,3143,4.463.630.952
19/12/2016 19:00,32.94,54852,650,24,170,2401,8,3253,4.463.630.952
19/12/2016 20:00,32.4,53049,703,24,149,2531,5,3412,4.463.630.952
19/12/2016 21:00,31.99,51437,738,27,129,2599,3,3496,4.463.630.952
19/12/2016 22:00,31.46,48912,734,31,114,2706,4,3589,4.463.630.952
19/12/2016 23:00,30.54,46101,698,36,98,2751,2,3585,4.463.630.952
20/12/2016 00:00,29.55,44176,622,16,103,2967,6,3714,4.463.630.952
20/12/2016 01:00,28.88,43057,619,23,88,3107,6,3843,4.463.630.952
20/12/2016 02:00,28.49,42565,617,30,79,3124,5,3855,4.463.630.952
20/12/2016 03:00,28.73,42575,608,37,72,3121,4,3842,4.463.630.952
20/12/2016 04:00,29.64,43413,608,44,66,3018,4,3740,4.463.630.952
20/12/2016 05:00,30.38,45824,605,52,51,3036,4,3748,4.463.630.952
20/12/2016 06:00,31.76,50193,592,59,48,3076,5,3780,4.463.630.952
20/12/2016 07:00,33.47,54845,570,69,42,3007,4,3692,4.463.630.952
20/12/2016 08:00,34.16,54593,566,81,36,2786,4,3473,4.463.630.952
20/12/2016 09:00,33.53,54473,605,97,31,2461,4,3198,4.463.630.952
20/12/2016 10:00,33.1,54557,624,108,30,2241,6,3009,4.463.630.952
20/12/2016 11:00,33.2,54660,603,114,32,2126,5,2880,4.463.630.952
20/12/2016 12:00,33.4,54816,598,115,34,1920,5,2672,4.463.630.952
20/12/2016 13:00,33.71,54849,615,113,38,1892,6,2664,4.463.630.952
20/12/2016 14:00,33.82,55280,650,109,39,2021,7,2826,4.463.630.952
20/12/2016 15:00,34.21,56140,757,103,43,2241,8,3152,4.463.630.952
20/12/2016 16:00,34.25,56885,956,102,44,2231,8,3341,4.463.630.952
20/12/2016 17:00,34.27,57077,1185,101,45,2507,8,3846,4.463.630.952
20/12/2016 18:00,33.48,56369,1466,100,41,2790,11,4408,4.463.630.952
20/12/2016 19:00,32.44,55284,1672,96,37,2926,10,4741,4.463.630.952
20/12/2016 20:00,31.94,53756,1782,92,34,3045,10,4963,4.463.630.952
20/12/2016 21:00,31.35,52216,1916,90,38,3192,12,5248,4.463.630.952
20/12/2016 22:00,30.45,49872,1932,88,45,3261,15,5341,4.463.630.952
20/12/2016 23:00,29.31,47074,1855,82,56,3356,14,5363,4.463.630.952
21/12/2016 00:00,28.11,44710,1999,83,46,3292,14,5434,4.463.630.952
21/12/2016 01:00,27.7,43701,1896,86,48,3344,14,5388,4.463.630.952
21/12/2016 02:00,27.33,43315,1768,89,51,3391,15,5314,4.463.630.952
21/12/2016 03:00,27.66,43424,1711,92,58,3443,18,5322,4.463.630.952
21/12/2016 04:00,28.58,44259,1793,90,68,3483,19,5453,4.463.630.952
21/12/2016 05:00,29.6,46563,1929,86,81,3565,20,5681,4.463.630.952
21/12/2016 06:00,30.37,50822,2022,84,97,3699,21,5923,4.463.630.952
21/12/2016 07:00,31.22,55174,2207,87,117,3814,22,6247,4.463.630.952
21/12/2016 08:00,31.39,55214,2493,90,133,3805,22,6543,4.463.630.952
21/12/2016 09:00,30.79,55084,2738,97,145,3912,24,6916,4.463.630.952
21/12/2016 10:00,30.55,55393,2940,104,154,3988,27,7213,4.463.630.952
21/12/2016 11:00,30.54,55498,3141,110,162,4013,33,7459,4.463.630.952
21/12/2016 12:00,30.56,55423,3327,116,172,3976,38,7629,4.463.630.952
21/12/2016 13:00,30.58,55367,3407,125,188,3961,36,7717,4.463.630.952
21/12/2016 14:00,30.7,55624,3383,136,204,3957,37,7717,4.463.630.952
21/12/2016 15:00,30.86,56383,3332,150,223,4104,36,7845,4.463.630.952
21/12/2016 16:00,30.89,56996,3319,161,236,4250,40,8006,4.463.630.952
21/12/2016 17:00,30.75,57076,3281,171,238,4352,38,8080,4.463.630.952
21/12/2016 18:00,30.65,56126,3197,176,230,4418,39,8060,4.463.630.952
21/12/2016 19:00,30.25,54917,3135,176,227,4458,39,8035,4.463.630.952
21/12/2016 20:00,29.8,53217,3081,171,215,4463,34,7964,4.463.630.952
21/12/2016 21:00,29.6,51513,3046,170,201,4511,34,7962,4.463.630.952
21/12/2016 22:00,29.01,49193,2919,166,185,4546,28,7844,4.463.630.952
21/12/2016 23:00,27.84,46144,2594,160,171,4544,31,7500,4.463.630.952
22/12/2016 00:00,26.38,43593,2458,158,154,4621,33,7424,4.463.630.952
22/12/2016 01:00,26.01,42577,2026,158,141,4583,34,6942,4.463.630.952
22/12/2016 02:00,26.07,42145,1687,156,131,4473,37,6484,4.463.630.952
22/12/2016 03:00,26.61,42222,1432,157,128,4329,38,6084,4.463.630.952
22/12/2016 04:00,27.8,42908,1287,159,127,4230,41,5844,4.463.630.952
22/12/2016 05:00,28.88,44896,1234,163,125,4114,39,5675,4.463.630.952
22/12/2016 06:00,29.67,48920,1229,163,123,4052,31,5598,4.463.630.952
22/12/2016 07:00,30.99,53268,1285,161,122,3995,26,5589,4.463.630.952
22/12/2016 08:00,31.61,53059,1399,159,120,3959,22,5659,4.463.630.952
22/12/2016 09:00,30.85,53260,1532,156,118,3903,20,5729,4.463.630.952
22/12/2016 10:00,30.43,53591,1648,153,114,3871,19,5805,4.463.630.952
22/12/2016 11:00,30.34,53944,1806,145,109,3885,19,5964,4.463.630.952
22/12/2016 12:00,30.61,53974,2019,136,102,3924,16,6197,4.463.630.952
22/12/2016 13:00,30.23,53875,2215,128,90,4020,17,6470,4.463.630.952
22/12/2016 14:00,30.46,54137,2404,122,89,4103,16,6734,4.463.630.952
22/12/2016 15:00,30.57,54968,2578,115,99,4189,18,6999,4.463.630.952
22/12/2016 16:00,30.57,55712,2722,115,104,4271,19,7231,4.463.630.952
22/12/2016 17:00,30.37,56006,2852,117,110,4372,26,7477,4.463.630.952
22/12/2016 18:00,30.01,55151,2959,121,109,4428,28,7645,4.463.630.952
22/12/2016 19:00,29.7,54059,2997,122,110,4523,26,7778,4.463.630.952
22/12/2016 20:00,29.42,52622,2964,125,110,4586,28,7813,4.463.630.952
22/12/2016 21:00,29.15,51187,2903,127,116,4572,32,7750,4.463.630.952
22/12/2016 22:00,28.55,48806,2873,131,121,4559,32,7716,4.463.630.952
22/12/2016 23:00,27.36,46124,2888,125,129,4563,29,7734,4.463.630.952
23/12/2016 00:00,25.63,43325,3209,142,122,4629,27,8129,4.463.630.952
23/12/2016 01:00,24.78,42153,3232,150,126,4598,29,8135,4.463.630.952
23/12/2016 02:00,24.24,41646,3212,155,133,4524,36,8060,4.463.630.952
23/12/2016 03:00,24.54,41765,3137,158,144,4504,40,7983,4.463.630.952
23/12/2016 04:00,25.76,42506,2982,159,158,4554,38,7891,4.463.630.952
23/12/2016 05:00,26.99,44589,2798,157,172,4503,31,7661,4.463.630.952
23/12/2016 06:00,28.31,48557,2596,158,188,4514,34,7490,4.463.630.952
23/12/2016 07:00,29.26,53173,2362,154,203,4494,40,7253,4.463.630.952
23/12/2016 08:00,29.9,51829,2174,151,218,4433,42,7018,4.463.630.952
23/12/2016 09:00,29.69,51965,2016,146,243,4441,38,6884,4.463.630.952
23/12/2016 10:00,29.53,52200,1951,143,262,4429,36,6821,4.463.630.952
23/12/2016 11:00,29.34,52359,1998,142,276,4326,36,6778,4.463.630.952
23/12/2016 12:00,29.35,52343,2143,143,285,4255,41,6867,4.463.630.952
23/12/2016 13:00,29.18,52473,2383,145,289,4153,40,7010,4.463.630.952
23/12/2016 14:00,29.13,52825,2689,145,281,3971,35,7121,4.463.630.952
23/12/2016 15:00,29.29,53568,3022,141,264,3862,34,7323,4.463.630.952
23/12/2016 16:00,29.46,54269,3397,135,249,3790,34,7605,4.463.630.952
23/12/2016 17:00,29.37,54409,3715,133,231,3717,31,7827,4.463.630.952
23/12/2016 18:00,29.07,53723,3972,127,219,3733,24,8075,4.463.630.952
23/12/2016 19:00,28.51,52370,4179,122,214,3802,19,8336,4.463.630.952
23/12/2016 20:00,28.08,50468,4342,114,207,3932,14,8609,4.463.630.952
23/12/2016 21:00,27.8,49105,4454,107,199,4102,13,8875,4.463.630.952
23/12/2016 22:00,27.17,47226,4517,103,193,4266,13,9092,4.463.630.952
23/12/2016 23:00,24.52,45043,4537,103,195,4433,14,9282,4.463.630.952
24/12/2016 00:00,25.34,42146,4497,104,200,4744,20,9565,4.463.630.952
24/12/2016 01:00,23.94,40990,4076,116,215,4979,22,9408,4.463.630.952
24/12/2016 02:00,23.17,40250,3976,136,240,5117,38,9507,4.463.630.952
24/12/2016 03:00,22.72,40067,3851,152,255,5190,56,9504,4.463.630.952
24/12/2016 04:00,23.05,40184,4140,171,285,5182,62,9840,4.463.630.952
24/12/2016 05:00,23.94,40750,4039,187,310,5060,62,9658,4.463.630.952
24/12/2016 06:00,25.1,41995,3954,200,330,4886,63,9433,4.463.630.952
24/12/2016 07:00,25.62,43847,3951,212,350,4764,64,9341,4.463.630.952
24/12/2016 08:00,26.12,46166,4044,221,365,4730,66,9426,4.463.630.952
24/12/2016 09:00,27.51,47610,4165,227,365,4602,67,9426,4.463.630.952
24/12/2016 10:00,27.85,47196,4242,230,365,4523,66,9426,4.463.630.952
24/12/2016 11:00,27.6,47253,4284,229,350,4479,64,9406,4.463.630.952
24/12/2016 12:00,27.19,46985,4270,225,340,4529,64,9428,4.463.630.952
24/12/2016 13:00,27.04,46809,4239,223,320,4527,62,9371,4.463.630.952
24/12/2016 14:00,26.96,47022,4213,221,305,4512,60,9311,4.463.630.952
24/12/2016 15:00,27.33,48029,4192,219,290,4529,57,9287,4.463.630.952
24/12/2016 16:00,27.66,48555,4140,215,285,4537,54,9231,4.463.630.952
24/12/2016 17:00,26.43,47892,4090,208,290,4553,53,9194,4.463.630.952
24/12/2016 18:00,25.37,46083,4077,200,285,4562,54,9178,4.463.630.952
24/12/2016 19:00,25.03,45156,4051,192,285,4563,55,9146,4.463.630.952
24/12/2016 20:00,25.05,44539,4012,183,285,4452,55,8987,4.463.630.952
24/12/2016 21:00,24.92,44444,3949,173,285,4351,54,8812,4.463.630.952
24/12/2016 22:00,25.2,43945,3878,164,285,4341,49,8717,4.463.630.952
24/12/2016 23:00,23.93,43303,3424,152,290,4337,45,8248,4.463.630.952
25/12/2016 00:00,23.51,41292,2774,130,295,4523,23,7745,4.463.630.952
25/12/2016 01:00,21.53,40361,2533,120,295,4527,19,7494,4.463.630.952
25/12/2016 02:00,18.75,39770,2459,116,280,4452,17,7324,4.463.630.952
25/12/2016 03:00,18.62,39600,2365,112,250,4399,13,7139,4.463.630.952
25/12/2016 04:00,18.8,39764,2283,111,235,4331,10,6970,4.463.630.952
25/12/2016 05:00,21.51,40480,2333,113,235,4258,10,6949,4.463.630.952
25/12/2016 06:00,21.11,41284,2180,124,225,4179,12,6720,4.463.630.952
25/12/2016 07:00,23.91,42316,2271,133,240,4089,18,6751,4.463.630.952
25/12/2016 08:00,24.91,43182,2467,146,245,4037,19,6914,4.463.630.952
25/12/2016 09:00,25.94,44345,2465,160,260,3919,22,6826,4.463.630.952
25/12/2016 10:00,25.94,45450,2712,172,280,3793,29,6986,4.463.630.952
25/12/2016 11:00,26.59,46143,3082,176,290,3613,35,7196,4.463.630.952
25/12/2016 12:00,26.35,46182,3447,181,290,3403,38,7359,4.463.630.952
25/12/2016 13:00,26.28,46202,3688,182,285,3213,42,7410,4.463.630.952
25/12/2016 14:00,26.6,46576,3495,179,265,3033,38,7010,4.463.630.952
25/12/2016 15:00,27.54,47529,3823,176,255,3055,35,7344,4.463.630.952
25/12/2016 16:00,28.48,48267,3962,169,245,3045,33,7454,4.463.630.952
25/12/2016 17:00,28.42,48274,3962,159,230,2972,35,7358,4.463.630.952
25/12/2016 18:00,28.17,47750,3967,149,230,2944,34,7324,4.463.630.952
25/12/2016 19:00,27.91,46964,3999,141,210,3021,32,7403,4.463.630.952
25/12/2016 20:00,27.49,46001,4036,136,200,3172,30,7574,4.463.630.952
25/12/2016 21:00,27.63,45233,4058,134,185,3503,27,7907,4.463.630.952
25/12/2016 22:00,26.87,43951,4043,132,180,3764,20,8139,4.463.630.952
25/12/2016 23:00,25.6,42109,3661,126,175,3995,15,7972,4.463.630.952
26/12/2016 00:00,25.5,40982,3749,159,220,4183,44,8355,4.489.404.762
26/12/2016 01:00,22.5,39713,3688,167,220,4181,47,8303,4.489.404.762
26/12/2016 02:00,18.95,38926,3069,175,240,4230,43,7757,4.489.404.762
26/12/2016 03:00,15.93,38589,3042,181,260,4315,42,7840,4.489.404.762
26/12/2016 04:00,16.51,38763,2960,185,285,4410,50,7890,4.489.404.762
26/12/2016 05:00,16.54,39254,2744,184,305,4505,52,7790,4.489.404.762
26/12/2016 06:00,22.75,40029,2611,190,320,4503,49,7673,4.489.404.762
26/12/2016 07:00,24.78,41179,2697,199,330,4522,52,7800,4.489.404.762
26/12/2016 08:00,25.23,42485,2874,205,335,4614,56,8084,4.489.404.762
26/12/2016 09:00,25.7,43060,3541,207,340,4691,55,8834,4.489.404.762
26/12/2016 10:00,26.26,44260,4295,206,355,4770,62,9688,4.489.404.762
26/12/2016 11:00,26.6,44952,4462,208,375,4783,59,9887,4.489.404.762
26/12/2016 12:00,26.38,45128,4525,210,395,4917,37,10084,4.489.404.762
26/12/2016 13:00,25.74,45148,4137,209,395,4935,27,9703,4.489.404.762
26/12/2016 14:00,25.7,45704,4061,201,380,4916,27,9585,4.489.404.762
26/12/2016 15:00,27,46823,3918,195,360,4858,25,9356,4.489.404.762
26/12/2016 16:00,27.4,47569,3737,186,350,4751,36,9060,4.489.404.762
26/12/2016 17:00,27.94,47463,3967,183,350,4715,57,9272,4.489.404.762
26/12/2016 18:00,27.79,46883,3771,176,385,4558,68,8958,4.489.404.762
26/12/2016 19:00,27.44,46686,3395,173,415,4347,66,8396,4.489.404.762
26/12/2016 20:00,27.11,45935,2889,170,415,4297,65,7836,4.489.404.762
26/12/2016 21:00,26.82,45471,2129,167,415,4036,65,6812,4.489.404.762
26/12/2016 22:00,26.65,44386,1827,160,415,3896,63,6361,4.489.404.762
26/12/2016 23:00,25.68,43017,1689,61,415,4019,64,6248,4.489.404.762
27/12/2016 00:00,24.08,42653,2124,114,415,4384,64,7101,4.489.404.762
27/12/2016 01:00,22.52,41868,1905,102,415,4742,59,7223,4.489.404.762
27/12/2016 02:00,20.13,41534,2053,89,415,5018,55,7630,4.489.404.762
27/12/2016 03:00,19.86,41642,2274,75,415,5254,48,8066,4.489.404.762
27/12/2016 04:00,20.09,42418,2549,60,415,5469,38,8531,4.489.404.762
27/12/2016 05:00,23.93,44363,2891,46,410,5602,23,8972,4.489.404.762
27/12/2016 06:00,26.23,47115,3703,40,400,5698,26,9867,4.489.404.762
27/12/2016 07:00,27.76,50391,4442,38,400,5663,39,10582,4.489.404.762
27/12/2016 08:00,28.06,51479,4480,48,415,5605,61,10609,4.489.404.762
27/12/2016 09:00,27.98,51766,4435,64,415,5608,67,10589,4.489.404.762
27/12/2016 10:00,28.05,52191,4329,81,415,5544,68,10437,4.489.404.762
27/12/2016 11:00,28.27,52210,4162,99,415,5472,68,10216,4.489.404.762
27/12/2016 12:00,28.33,52076,3913,119,415,5421,68,9936,4.489.404.762
27/12/2016 13:00,28.43,52165,3627,134,410,5303,69,9543,4.489.404.762
27/12/2016 14:00,28.57,52592,3426,148,410,5171,68,9223,4.489.404.762
27/12/2016 15:00,28.83,53808,3282,160,405,5058,68,8973,4.489.404.762
27/12/2016 16:00,29.51,54715,3179,171,405,4962,67,8784,4.489.404.762
27/12/2016 17:00,29.72,54825,3043,180,405,4859,67,8554,4.489.404.762
27/12/2016 18:00,29.65,54074,2877,187,410,4735,67,8276,4.489.404.762
27/12/2016 19:00,29.39,52943,2748,191,415,4634,65,8053,4.489.404.762
27/12/2016 20:00,29.14,51381,2672,193,415,4498,63,7841,4.489.404.762
27/12/2016 21:00,28.37,50121,2608,193,415,4327,64,7607,4.489.404.762
27/12/2016 22:00,27.24,48436,2501,195,415,4178,65,7354,4.489.404.762
27/12/2016 23:00,25.73,45838,2321,199,415,3980,63,6978,4.489.404.762
28/12/2016 00:00,26.45,43688,1626,215,400,3908,63,6212,4.489.404.762
28/12/2016 01:00,26.26,42887,1508,215,394,3704,61,5882,4.489.404.762
28/12/2016 02:00,26.24,42624,1327,216,386,3473,58,5460,4.489.404.762
28/12/2016 03:00,26.43,42730,1211,215,377,3199,58,5060,4.489.404.762
28/12/2016 04:00,27.26,43554,1183,213,368,2834,58,4656,4.489.404.762
28/12/2016 05:00,28.72,45608,1164,210,362,2571,58,4365,4.489.404.762
28/12/2016 06:00,29.81,49110,1175,206,358,2212,57,4008,4.489.404.762
28/12/2016 07:00,30.64,52734,1181,201,352,1781,58,3573,4.489.404.762
28/12/2016 08:00,31.86,53649,1111,194,350,1443,57,3155,4.489.404.762
28/12/2016 09:00,31.98,54298,1020,187,351,1277,55,2890,4.489.404.762
28/12/2016 10:00,32.09,54799,900,178,348,1142,54,2622,4.489.404.762
28/12/2016 11:00,32.25,54836,780,164,335,1100,54,2433,4.489.404.762
28/12/2016 12:00,32.47,54617,697,148,314,1227,53,2439,4.489.404.762
28/12/2016 13:00,32.73,54612,683,134,293,1412,48,2570,4.489.404.762
28/12/2016 14:00,32.88,54877,698,124,269,1811,45,2947,4.489.404.762
28/12/2016 15:00,33.24,55837,678,111,241,2165,41,3236,4.489.404.762
28/12/2016 16:00,33.88,56854,621,98,220,2359,31,3329,4.489.404.762
28/12/2016 17:00,33.81,57146,583,81,199,2557,26,3446,4.489.404.762
28/12/2016 18:00,32.89,56401,586,63,179,2723,23,3574,4.489.404.762
28/12/2016 19:00,31.9,55290,611,46,161,2874,19,3711,4.489.404.762
28/12/2016 20:00,31.24,53628,675,34,144,3069,15,3937,4.489.404.762
28/12/2016 21:00,30.65,52102,743,24,131,3197,15,4110,4.489.404.762
28/12/2016 22:00,30.02,50109,814,18,119,3369,13,4333,4.489.404.762
28/12/2016 23:00,29.37,47357,919,14,108,3502,10,4553,4.489.404.762
29/12/2016 00:00,29.26,44366,1032,12,64,3691,9,4808,4.489.404.762
29/12/2016 01:00,28.72,43237,1121,19,42,3746,9,4937,4.489.404.762
29/12/2016 02:00,28.29,42606,1198,36,24,3791,12,5061,4.489.404.762
29/12/2016 03:00,28.32,42474,1265,58,18,3828,13,5182,4.489.404.762
29/12/2016 04:00,28.95,42903,1337,86,16,3847,14,5300,4.489.404.762
29/12/2016 05:00,29.88,44635,1423,117,16,3793,16,5365,4.489.404.762
29/12/2016 06:00,30.66,47574,1533,146,18,3784,17,5498,4.489.404.762
29/12/2016 07:00,30.96,50825,1675,163,23,3795,17,5673,4.489.404.762
29/12/2016 08:00,31.27,50563,1810,171,33,3717,18,5749,4.489.404.762
29/12/2016 09:00,31.05,51304,1964,178,48,3716,20,5926,4.489.404.762
29/12/2016 10:00,30.98,51851,2164,176,65,3762,25,6192,4.489.404.762
29/12/2016 11:00,30.97,51961,2368,168,85,3769,35,6425,4.489.404.762
29/12/2016 12:00,31.03,51922,2486,157,109,3715,38,6505,4.489.404.762
29/12/2016 13:00,31.04,51970,2474,148,130,3696,38,6486,4.489.404.762
29/12/2016 14:00,31.08,52130,2470,140,150,3630,35,6425,4.489.404.762
29/12/2016 15:00,31.27,52897,2500,134,165,3721,32,6552,4.489.404.762
29/12/2016 16:00,31.54,53657,2524,131,182,3814,32,6683,4.489.404.762
29/12/2016 17:00,31.47,53808,2563,127,197,3777,31,6695,4.489.404.762
29/12/2016 18:00,30.99,53106,2601,123,210,3752,32,6718,4.489.404.762
29/12/2016 19:00,30.58,51888,2618,121,218,3852,33,6842,4.489.404.762
29/12/2016 20:00,30.28,50357,2622,118,223,3788,35,6786,4.489.404.762
29/12/2016 21:00,30.01,49030,2605,116,225,3746,35,6727,4.489.404.762
29/12/2016 22:00,29.44,47240,2528,113,227,3556,34,6458,4.489.404.762
29/12/2016 23:00,28.76,44855,2412,108,231,3616,36,6403,4.489.404.762
30/12/2016 00:00,28.18,43082,2212,105,237,3507,25,6086,4.489.404.762
30/12/2016 01:00,27.03,42051,2233,99,229,3611,24,6196,4.489.404.762
30/12/2016 02:00,26.47,41623,2260,92,224,3810,23,6409,4.489.404.762
30/12/2016 03:00,26.47,41521,2219,89,217,3975,25,6525,4.489.404.762
30/12/2016 04:00,27.14,41995,2123,89,213,4142,29,6596,4.489.404.762
30/12/2016 05:00,28.33,43715,2055,92,209,4368,29,6753,4.489.404.762
30/12/2016 06:00,29.53,46564,2014,98,216,4517,33,6878,4.489.404.762
30/12/2016 07:00,30.06,49675,2048,105,220,4670,35,7078,4.489.404.762
30/12/2016 08:00,30.28,49867,2147,114,225,4769,33,7288,4.489.404.762
30/12/2016 09:00,30.25,50551,2244,124,232,4858,33,7491,4.489.404.762
30/12/2016 10:00,30.21,50960,2350,135,239,4904,34,7662,4.489.404.762
30/12/2016 11:00,30.2,51007,2482,143,247,4921,33,7826,4.489.404.762
30/12/2016 12:00,30.18,50739,2638,149,253,4889,35,7964,4.489.404.762
30/12/2016 13:00,30.06,50560,2744,156,261,4922,35,8118,4.489.404.762
30/12/2016 14:00,30.12,50621,2761,163,267,4901,37,8129,4.489.404.762
30/12/2016 15:00,30.29,51174,2752,169,272,4916,40,8149,4.489.404.762
30/12/2016 16:00,30.51,51726,2757,175,275,4913,41,8161,4.489.404.762
30/12/2016 17:00,30.39,51714,2761,176,279,4931,43,8190,4.489.404.762
30/12/2016 18:00,30.27,51088,2757,179,281,4862,45,8124,4.489.404.762
30/12/2016 19:00,30.2,49799,2770,181,280,4873,42,8146,4.489.404.762
30/12/2016 20:00,29.56,48067,2812,181,281,4873,45,8192,4.489.404.762
30/12/2016 21:00,28.96,46617,2866,180,277,4903,45,8271,4.489.404.762
30/12/2016 22:00,27.77,44903,2933,178,277,4895,46,8329,4.489.404.762
30/12/2016 23:00,25.95,42947,3010,173,272,4897,44,8396,4.489.404.762
31/12/2016 00:00,25.11,40128,3161,170,289,5079,47,8746,4.489.404.762
31/12/2016 01:00,23.65,39019,3221,164,290,5117,46,8838,4.489.404.762
31/12/2016 02:00,22.99,38389,3288,160,288,5121,45,8902,4.489.404.762
31/12/2016 03:00,22.13,38180,3336,158,286,5122,43,8945,4.489.404.762
31/12/2016 04:00,22.57,38564,3388,160,281,5142,44,9015,4.489.404.762
31/12/2016 05:00,23.47,39794,3450,163,276,5121,46,9056,4.489.404.762
31/12/2016 06:00,25.03,41107,3508,168,274,5134,49,9133,4.489.404.762
31/12/2016 07:00,25.78,42543,3546,172,273,5131,50,9172,4.489.404.762
31/12/2016 08:00,26.82,42780,3571,175,273,5166,50,9235,4.489.404.762
31/12/2016 09:00,27.89,44082,3596,180,272,5150,54,9252,4.489.404.762
31/12/2016 10:00,28.36,45165,3611,183,270,5167,54,9285,4.489.404.762
31/12/2016 11:00,28.47,45658,3622,185,271,5146,56,9280,4.489.404.762
31/12/2016 12:00,28.43,45691,3648,185,275,5112,57,9277,4.489.404.762
31/12/2016 13:00,28.3,45659,3657,184,283,4972,57,9153,4.489.404.762
31/12/2016 14:00,28.52,46166,3646,183,296,4897,58,9080,4.489.404.762
31/12/2016 15:00,29.11,47301,3610,181,308,4825,57,8981,4.489.404.762
31/12/2016 16:00,29.5,48510,3565,179,314,4793,58,8909,4.489.404.762
31/12/2016 17:00,29.57,48296,3519,177,312,4808,56,8872,4.489.404.762
31/12/2016 18:00,29.24,46908,3467,174,307,4669,56,8673,4.489.404.762
31/12/2016 19:00,28.38,45048,3429,170,308,4461,55,8423,4.489.404.762
31/12/2016 20:00,27.98,43567,3410,164,312,4319,53,8258,4.489.404.762
31/12/2016 21:00,27.52,43061,3391,161,313,4189,50,8104,4.489.404.762
31/12/2016 22:00,26.8,42264,3389,153,313,4013,45,7913,4.489.404.762
31/12/2016 23:00,26.71,41137,3405,139,311,3614,44,7513,4.489.404.762
01/01/2017 00:00,25.7,40210,3610,105,365,3779,57,7916,4.489.404.762
01/01/2017 01:00,25.61,39374,3460,93,360,3559,57,7529,4.489.404.762
01/01/2017 02:00,25.49,38886,3215,84,353,3380,57,7089,4.489.404.762
01/01/2017 03:00,25.25,38519,2960,76,343,3250,56,6685,4.489.404.762
01/01/2017 04:00,25.63,38577,2643,67,331,3052,56,6149,4.489.404.762
01/01/2017 05:00,25.88,39216,2309,57,327,2859,55,5607,4.489.404.762
01/01/2017 06:00,26.58,40063,2064,48,325,2693,54,5184,4.489.404.762
01/01/2017 07:00,26.64,40985,1867,42,330,2562,49,4850,4.489.404.762
01/01/2017 08:00,26.7,41798,1712,40,326,2417,39,4534,4.489.404.762
01/01/2017 09:00,26.89,42739,1643,35,321,2321,31,4351,4.489.404.762
01/01/2017 10:00,27.8,44066,1623,33,315,2258,27,4256,4.489.404.762
01/01/2017 11:00,28.1,45098,1620,30,321,2208,23,4202,4.489.404.762
01/01/2017 12:00,28.36,45580,1634,29,316,2153,19,4151,4.489.404.762
01/01/2017 13:00,28.71,45863,1634,27,315,2193,16,4185,4.489.404.762
01/01/2017 14:00,29.65,46927,1583,26,317,2220,14,4160,4.489.404.762
01/01/2017 15:00,30.38,48303,1498,23,319,2189,13,4042,4.489.404.762
01/01/2017 16:00,30.77,49579,1392,21,317,2284,13,4027,4.489.404.762
01/01/2017 17:00,30.92,50127,1252,20,311,2322,12,3917,4.489.404.762
01/01/2017 18:00,30.77,49865,1148,21,309,2397,12,3887,4.489.404.762
01/01/2017 19:00,30.5,49043,1092,21,308,2431,12,3864,4.489.404.762
01/01/2017 20:00,30.19,47905,1111,20,308,2495,11,3945,4.489.404.762
01/01/2017 21:00,29.94,47222,1251,21,306,2450,10,4038,4.489.404.762
01/01/2017 22:00,29.65,45932,1432,24,298,2472,11,4237,4.489.404.762
01/01/2017 23:00,29.36,44341,1559,27,282,2433,11,4312,4.489.404.762
02/01/2017 00:00,29.42,43419,1564,22,171,2637,11,4405,5.445.238.095
02/01/2017 01:00,28.95,42555,1574,24,157,2557,11,4323,5.445.238.095
02/01/2017 02:00,28.22,42308,1600,24,146,2570,13,4353,5.445.238.095
02/01/2017 03:00,28.22,42550,1621,22,138,2579,14,4374,5.445.238.095
02/01/2017 04:00,28.92,44062,1580,22,129,2515,15,4261,5.445.238.095
02/01/2017 05:00,30.47,46268,1495,24,121,2508,16,4164,5.445.238.095
02/01/2017 06:00,32.09,49906,1444,24,118,2577,17,4180,5.445.238.095
02/01/2017 07:00,33.07,53768,1418,26,116,2491,22,4073,5.445.238.095
02/01/2017 08:00,33.92,55396,1373,26,116,2398,25,3938,5.445.238.095
02/01/2017 09:00,34.38,55749,1326,24,120,2278,47,3795,5.445.238.095
02/01/2017 10:00,34.17,56454,1312,20,128,2136,30,3626,5.445.238.095
02/01/2017 11:00,34.05,56445,1288,20,136,2101,26,3571,5.445.238.095
02/01/2017 12:00,33.64,56325,1291,19,144,2012,33,3499,5.445.238.095
02/01/2017 13:00,33.59,56304,1267,20,150,2008,32,3477,5.445.238.095
02/01/2017 14:00,33.81,56837,1126,20,155,1995,35,3331,5.445.238.095
02/01/2017 15:00,34.49,57841,991,20,156,1957,32,3156,5.445.238.095
02/01/2017 16:00,35.16,58725,893,25,154,1951,31,3054,5.445.238.095
02/01/2017 17:00,35.8,59104,830,29,150,1807,31,2847,5.445.238.095
02/01/2017 18:00,34.83,58534,801,30,146,1735,32,2744,5.445.238.095
02/01/2017 19:00,33.93,57365,800,32,150,1698,29,2709,5.445.238.095
02/01/2017 20:00,33.42,55644,835,32,156,1606,27,2656,5.445.238.095
02/01/2017 21:00,33.09,54299,817,35,164,1473,24,2513,5.445.238.095
02/01/2017 22:00,32.12,52402,761,32,173,1298,21,2285,5.445.238.095
02/01/2017 23:00,30.93,50057,768,35,180,1143,20,2146,5.445.238.095
03/01/2017 00:00,30.65,47747,1065,17,169,934,29,2214,5.445.238.095
03/01/2017 01:00,30.37,46919,1153,18,171,801,31,2174,5.445.238.095
03/01/2017 02:00,30.15,46565,1324,19,172,698,31,2244,5.445.238.095
03/01/2017 03:00,30.14,46655,1554,20,171,680,30,2455,5.445.238.095
03/01/2017 04:00,30.41,47646,1692,18,168,664,34,2576,5.445.238.095
03/01/2017 05:00,31.3,49728,1698,16,167,722,35,2638,5.445.238.095
03/01/2017 06:00,32.14,53108,1732,13,159,829,38,2771,5.445.238.095
03/01/2017 07:00,33.72,56999,1819,11,148,1027,33,3038,5.445.238.095
03/01/2017 08:00,34.39,58772,1956,10,141,1241,25,3373,5.445.238.095
03/01/2017 09:00,33.8,59243,2158,10,130,1513,20,3831,5.445.238.095
03/01/2017 10:00,33.24,59764,2543,13,118,1835,17,4526,5.445.238.095
03/01/2017 11:00,32.78,59872,3013,12,102,2080,16,5223,5.445.238.095
03/01/2017 12:00,32.58,59228,3497,13,86,2228,17,5841,5.445.238.095
03/01/2017 13:00,32.2,59037,3963,13,78,2478,17,6549,5.445.238.095
03/01/2017 14:00,32.12,59239,4244,12,72,2785,13,7126,5.445.238.095
03/01/2017 15:00,32.1,59899,4415,12,67,3099,11,7604,5.445.238.095
03/01/2017 16:00,32.31,60605,4490,12,67,3404,11,7984,5.445.238.095
03/01/2017 17:00,32.18,60685,4533,13,71,3576,12,8205,5.445.238.095
03/01/2017 18:00,31.87,59662,4554,17,98,3650,12,8331,5.445.238.095
03/01/2017 19:00,31.29,58293,4557,23,139,3786,12,8517,5.445.238.095
03/01/2017 20:00,30.69,56504,4571,31,172,3978,14,8766,5.445.238.095
03/01/2017 21:00,30.06,55143,4561,42,222,3959,18,8802,5.445.238.095
03/01/2017 22:00,29.27,53055,4554,51,240,3983,21,8849,5.445.238.095
03/01/2017 23:00,28.3,50838,4543,61,279,4006,29,8918,5.445.238.095
04/01/2017 00:00,26.63,48509,4517,88,285,4118,50,9058,5.445.238.095
04/01/2017 01:00,26.2,47684,4061,93,252,4105,45,8556,5.445.238.095
04/01/2017 02:00,25.86,47419,3927,105,246,4096,48,8422,5.445.238.095
04/01/2017 03:00,25.98,47560,3814,118,240,4134,38,8344,5.445.238.095
04/01/2017 04:00,26.36,48291,4198,131,230,4160,41,8760,5.445.238.095
04/01/2017 05:00,27.62,50370,4248,142,227,4107,33,8757,5.445.238.095
04/01/2017 06:00,28.84,54160,4262,150,201,4054,34,8701,5.445.238.095
04/01/2017 07:00,30.43,58475,4277,155,170,4041,35,8678,5.445.238.095
04/01/2017 08:00,31.3,59906,4228,159,151,3970,38,8546,5.445.238.095
04/01/2017 09:00,31.81,60526,4095,162,138,3834,44,8273,5.445.238.095
04/01/2017 10:00,31.95,61016,3988,165,131,3749,53,8086,5.445.238.095
04/01/2017 11:00,32.16,61304,3919,169,129,3727,55,7999,5.445.238.095
04/01/2017 12:00,32.05,61221,3804,169,141,3630,58,7802,5.445.238.095
04/01/2017 13:00,32.08,61403,3612,170,194,3572,60,7608,5.445.238.095
04/01/2017 14:00,32.49,61850,3320,171,245,3462,59,7257,5.445.238.095
04/01/2017 15:00,33.32,62630,3015,172,312,3399,60,6958,5.445.238.095
04/01/2017 16:00,34.1,63430,2862,173,351,3345,61,6792,5.445.238.095
04/01/2017 17:00,34.5,63903,2903,173,375,3319,62,6832,5.445.238.095
04/01/2017 18:00,33.8,63217,3024,174,388,3260,61,6907,5.445.238.095
04/01/2017 19:00,32.8,62077,3073,175,390,3199,60,6897,5.445.238.095
04/01/2017 20:00,32.11,60534,2955,169,391,3091,59,6665,5.445.238.095
04/01/2017 21:00,31.72,59365,2781,166,386,2982,59,6374,5.445.238.095
04/01/2017 22:00,31.36,57500,2593,168,381,2858,56,6056,5.445.238.095
04/01/2017 23:00,30.58,54723,2416,164,375,2800,52,5807,5.445.238.095
05/01/2017 00:00,30.47,53427,2144,186,396,2695,59,5480,5.445.238.095
05/01/2017 01:00,30.18,53302,2053,186,384,2633,56,5312,5.445.238.095
05/01/2017 02:00,29.97,52767,1980,188,377,2600,54,5199,5.445.238.095
05/01/2017 03:00,30.02,52920,1933,189,366,2512,53,5053,5.445.238.095
05/01/2017 04:00,30.57,53695,1876,190,354,2438,54,4912,5.445.238.095
05/01/2017 05:00,31.48,55901,1814,191,345,2370,53,4773,5.445.238.095
05/01/2017 06:00,33.5,59742,1782,191,332,2293,54,4652,5.445.238.095
05/01/2017 07:00,38.08,63897,1727,190,317,2209,54,4497,5.445.238.095
05/01/2017 08:00,41.66,65516,1625,189,305,2126,52,4297,5.445.238.095
05/01/2017 09:00,41.29,65880,1542,186,286,2051,54,4119,5.445.238.095
05/01/2017 10:00,42.26,66196,1476,185,265,1955,54,3935,5.445.238.095
05/01/2017 11:00,42.96,66470,1361,187,248,1829,54,3679,5.445.238.095
05/01/2017 12:00,42.37,66118,1159,185,233,1682,54,3313,5.445.238.095
05/01/2017 13:00,42.83,65905,980,183,220,1538,55,2976,5.445.238.095
05/01/2017 14:00,43.08,66157,845,182,211,1419,53,2710,5.445.238.095
05/01/2017 15:00,44.93,67265,750,179,202,1350,50,2531,5.445.238.095
05/01/2017 16:00,50.64,68403,677,175,192,1260,52,2356,5.445.238.095
05/01/2017 17:00,50.41,68746,623,168,184,1235,52,2262,5.445.238.095
05/01/2017 18:00,48.11,68161,562,162,177,1251,50,2202,5.445.238.095
05/01/2017 19:00,45.75,66888,476,153,163,1294,48,2134,5.445.238.095
05/01/2017 20:00,42.01,65346,397,146,153,1314,47,2057,5.445.238.095
05/01/2017 21:00,37.84,64255,343,136,140,1400,45,2064,5.445.238.095
05/01/2017 22:00,34.95,62568,296,128,131,1488,41,2084,5.445.238.095
05/01/2017 23:00,33.32,60259,260,117,126,1542,36,2081,5.445.238.095
06/01/2017 00:00,33.19,57363,257,89,0,1883,35,2264,5.445.238.095
06/01/2017 01:00,32.76,56414,258,82,0,1987,32,2359,5.445.238.095
06/01/2017 02:00,31.94,55819,281,73,0,2020,29,2403,5.445.238.095
06/01/2017 03:00,31.86,55762,350,66,0,2127,24,2567,5.445.238.095
06/01/2017 04:00,31.79,56217,443,58,0,2239,22,2762,5.445.238.095
06/01/2017 05:00,31.57,57850,536,50,0,2416,18,3020,5.445.238.095
06/01/2017 06:00,32.55,60683,652,40,0,2555,16,3263,5.445.238.095
06/01/2017 07:00,32.94,63847,811,32,0,2761,15,3619,5.445.238.095
06/01/2017 08:00,33.27,65432,986,24,0,2881,13,3904,5.445.238.095
06/01/2017 09:00,33.3,64982,1194,18,0,2989,10,4211,5.445.238.095
06/01/2017 10:00,33.39,65436,1440,13,0,3174,9,4636,5.445.238.095
06/01/2017 11:00,32.98,65321,1646,9,0,3275,9,4939,5.445.238.095
06/01/2017 12:00,32.77,64593,1843,6,0,3321,9,5179,5.445.238.095
06/01/2017 13:00,32.61,64149,2042,5,0,3370,8,5425,5.445.238.095
06/01/2017 14:00,32.39,64160,2208,5,0,3424,6,5643,5.445.238.095
06/01/2017 15:00,32.58,64867,2347,7,0,3496,5,5855,5.445.238.095
06/01/2017 16:00,32.76,65645,2474,11,0,3619,6,6110,5.445.238.095
06/01/2017 17:00,32.76,66026,2608,17,0,3750,6,6381,5.445.238.095
06/01/2017 18:00,32.33,65162,2743,25,0,3905,7,6680,5.445.238.095
06/01/2017 19:00,31.53,63708,2851,34,0,4045,6,6936,5.445.238.095
06/01/2017 20:00,30.95,61706,2944,45,0,4166,6,7161,5.445.238.095
06/01/2017 21:00,30.43,59917,3052,54,0,4305,8,7419,5.445.238.095
06/01/2017 22:00,29.78,57774,3165,67,0,4352,9,7593,5.445.238.095
06/01/2017 23:00,28.86,55778,3265,81,0,4504,14,7864,5.445.238.095
07/01/2017 00:00,29.13,53235,3373,103,0,4700,14,8190,5.445.238.095
07/01/2017 01:00,28.4,51900,3420,123,0,4760,14,8317,5.445.238.095
07/01/2017 02:00,27.89,50993,3404,142,0,4793,15,8354,5.445.238.095
07/01/2017 03:00,27.36,50562,3357,158,0,4772,17,8304,5.445.238.095
07/01/2017 04:00,27.7,50608,3216,171,0,4735,19,8141,5.445.238.095
07/01/2017 05:00,28.25,51101,3000,180,0,4565,20,7765,5.445.238.095
07/01/2017 06:00,28.8,52014,2820,186,0,4389,24,7419,5.445.238.095
07/01/2017 07:00,29.29,53802,2628,190,0,4216,26,7060,5.445.238.095
07/01/2017 08:00,29.85,54824,2451,191,0,3974,28,6644,5.445.238.095
07/01/2017 09:00,30.41,56395,2380,191,0,3749,32,6352,5.445.238.095
07/01/2017 10:00,30.77,57529,2318,188,0,3453,31,5990,5.445.238.095
07/01/2017 11:00,30.94,57921,2173,183,0,3190,32,5578,5.445.238.095
07/01/2017 12:00,30.86,57713,2043,178,0,3109,31,5361,5.445.238.095
07/01/2017 13:00,30.8,57472,1901,171,0,2877,31,4980,5.445.238.095
07/01/2017 14:00,30.98,57631,1710,163,0,2638,31,4542,5.445.238.095
07/01/2017 15:00,31.56,58619,1637,154,0,2663,30,4484,5.445.238.095
07/01/2017 16:00,32.54,60176,1575,142,0,2601,28,4346,5.445.238.095
07/01/2017 17:00,32.92,60780,1411,127,0,2520,25,4083,5.445.238.095
07/01/2017 18:00,32.6,59734,1288,114,0,2463,24,3889,5.445.238.095
07/01/2017 19:00,31.97,57946,1148,103,0,2526,20,3797,5.445.238.095
07/01/2017 20:00,31.44,56033,966,92,0,2455,18,3531,5.445.238.095
07/01/2017 21:00,31.24,54910,793,82,0,2383,16,3274,5.445.238.095
07/01/2017 22:00,30.98,53508,632,75,0,2216,17,2940,5.445.238.095
07/01/2017 23:00,30.5,51611,501,59,0,2028,15,2603,5.445.238.095
08/01/2017 00:00,30.62,50137,355,38,85,1819,9,2306,5.445.238.095
08/01/2017 01:00,30.49,49014,271,35,75,1739,8,2128,5.445.238.095
08/01/2017 02:00,30.28,48486,189,34,68,1622,7,1920,5.445.238.095
08/01/2017 03:00,30.29,48249,136,34,65,1536,7,1778,5.445.238.095
08/01/2017 04:00,30.46,48261,107,36,62,1601,6,1812,5.445.238.095
08/01/2017 05:00,30.54,48681,98,37,60,1870,6,2071,5.445.238.095
08/01/2017 06:00,30.63,49477,95,38,57,1983,6,2179,5.445.238.095
08/01/2017 07:00,30.38,50749,91,38,53,2150,6,2338,5.445.238.095
08/01/2017 08:00,30.6,51850,97,38,42,2385,6,2568,5.445.238.095
08/01/2017 09:00,30.84,53235,127,39,34,2647,6,2853,5.445.238.095
08/01/2017 10:00,31.18,54465,169,40,28,2828,6,3071,5.445.238.095
08/01/2017 11:00,30.91,55090,214,40,24,2910,6,3194,5.445.238.095
08/01/2017 12:00,30.89,55034,251,41,22,2987,6,3307,5.445.238.095
08/01/2017 13:00,30.79,54734,282,45,21,3155,6,3509,5.445.238.095
08/01/2017 14:00,30.75,54759,338,51,23,3284,6,3702,5.445.238.095
08/01/2017 15:00,30.85,55609,431,58,26,3403,6,3924,5.445.238.095
08/01/2017 16:00,31.16,57017,519,67,28,3452,6,4072,5.445.238.095
08/01/2017 17:00,31.38,57638,606,74,29,3455,7,4171,5.445.238.095
08/01/2017 18:00,31.11,57061,686,83,31,3478,7,4285,5.445.238.095
08/01/2017 19:00,30.92,55972,729,90,31,3336,8,4194,5.445.238.095
08/01/2017 20:00,30.69,54439,745,98,32,3226,7,4108,5.445.238.095
08/01/2017 21:00,30.8,53216,752,104,30,3088,7,3981,5.445.238.095
08/01/2017 22:00,30.3,51337,759,106,29,2908,8,3810,5.445.238.095
08/01/2017 23:00,29.72,49137,748,103,28,2788,6,3673,5.445.238.095
09/01/2017 00:00,29.37,46839,890,110,66,2927,17,4010,4.164.464.286
09/01/2017 01:00,28.94,45837,924,102,69,2800,19,3914,4.164.464.286
09/01/2017 02:00,28.81,45440,913,95,72,2724,19,3823,4.164.464.286
09/01/2017 03:00,28.98,45551,924,87,77,2714,18,3820,4.164.464.286
09/01/2017 04:00,29.52,46488,960,80,82,2631,15,3768,4.164.464.286
09/01/2017 05:00,30.23,48972,1003,72,87,2645,14,3821,4.164.464.286
09/01/2017 06:00,30.76,53199,1049,65,91,2633,13,3851,4.164.464.286
09/01/2017 07:00,32.26,57510,1124,60,93,2613,10,3900,4.164.464.286
09/01/2017 08:00,33.01,57280,1232,56,93,2628,9,4018,4.164.464.286
09/01/2017 09:00,32.81,57315,1348,56,91,2594,8,4097,4.164.464.286
09/01/2017 10:00,32.71,57695,1477,57,86,2537,8,4165,4.164.464.286
09/01/2017 11:00,32.19,57827,1636,53,87,2578,8,4362,4.164.464.286
09/01/2017 12:00,31.96,57714,1828,51,88,2484,9,4460,4.164.464.286
09/01/2017 13:00,31.78,57769,2018,50,92,2361,8,4529,4.164.464.286
09/01/2017 14:00,31.61,57903,2188,52,95,2455,7,4797,4.164.464.286
09/01/2017 15:00,31.91,58456,2356,59,103,2495,8,5021,4.164.464.286
09/01/2017 16:00,32.03,59093,2527,67,111,2527,9,5241,4.164.464.286
09/01/2017 17:00,31.95,59214,2721,73,118,2514,11,5437,4.164.464.286
09/01/2017 18:00,31.47,58311,2918,82,122,2540,10,5672,4.164.464.286
09/01/2017 19:00,30.84,57017,3076,86,127,2645,10,5944,4.164.464.286
09/01/2017 20:00,30.33,55073,3182,89,129,2780,11,6191,4.164.464.286
09/01/2017 21:00,29.97,53626,3279,92,130,2916,13,6430,4.164.464.286
09/01/2017 22:00,29.49,51333,3365,94,130,3123,17,6729,4.164.464.286
09/01/2017 23:00,28.69,48761,3404,98,132,3288,21,6943,4.164.464.286
10/01/2017 00:00,26.95,46499,3420,105,116,3403,17,7061,4.164.464.286
10/01/2017 01:00,26.22,45489,3394,109,115,3468,19,7105,4.164.464.286
10/01/2017 02:00,26.25,45186,3315,114,113,3478,21,7041,4.164.464.286
10/01/2017 03:00,26.23,45321,3206,118,112,3466,20,6922,4.164.464.286
10/01/2017 04:00,27.58,46252,3058,120,113,3476,21,6788,4.164.464.286
10/01/2017 05:00,28.84,48619,2831,124,112,3437,23,6527,4.164.464.286
10/01/2017 06:00,29.84,52549,2575,127,114,3447,23,6286,4.164.464.286
10/01/2017 07:00,31.08,56963,2362,131,117,3436,25,6071,4.164.464.286
10/01/2017 08:00,31.35,58125,2222,135,119,3409,27,5912,4.164.464.286
10/01/2017 09:00,31.18,57157,2124,142,115,3453,28,5862,4.164.464.286
10/01/2017 10:00,31.08,57454,2072,143,98,3554,33,5900,4.164.464.286
10/01/2017 11:00,31.02,57526,2035,139,91,3498,35,5798,4.164.464.286
10/01/2017 12:00,30.91,57352,2005,136,93,3466,37,5737,4.164.464.286
10/01/2017 13:00,30.92,57557,1986,130,101,3466,37,5720,4.164.464.286
10/01/2017 14:00,30.93,57693,1976,124,116,3514,33,5763,4.164.464.286
10/01/2017 15:00,30.99,58308,1986,125,130,3643,31,5915,4.164.464.286
10/01/2017 16:00,31.17,59103,2032,128,140,3727,29,6056,4.164.464.286
10/01/2017 17:00,31.2,59376,2083,130,156,3791,30,6190,4.164.464.286
10/01/2017 18:00,30.97,58406,2142,137,163,3883,33,6358,4.164.464.286
10/01/2017 19:00,30.38,57100,2203,139,172,3997,30,6541,4.164.464.286
10/01/2017 20:00,29.68,55246,2269,146,179,4104,30,6728,4.164.464.286
10/01/2017 21:00,29.42,53687,2335,148,185,4217,35,6920,4.164.464.286
10/01/2017 22:00,29.07,51381,2377,152,191,4291,32,7043,4.164.464.286
10/01/2017 23:00,28,48650,2426,150,195,4447,32,7250,4.164.464.286
11/01/2017 00:00,25.35,46240,2890,168,171,4656,33,7918,4.164.464.286
11/01/2017 01:00,24.54,45094,3061,170,175,4737,32,8175,4.164.464.286
11/01/2017 02:00,24.22,44601,3311,172,179,4840,33,8535,4.164.464.286
11/01/2017 03:00,24.23,44770,3572,176,186,4925,32,8891,4.164.464.286
11/01/2017 04:00,24.68,45624,3884,181,197,5009,35,9306,4.164.464.286
11/01/2017 05:00,25.84,47876,4194,187,210,5089,36,9716,4.164.464.286
11/01/2017 06:00,28.01,51965,4399,194,236,5182,37,10048,4.164.464.286
11/01/2017 07:00,28.99,56438,4514,201,256,5313,39,10323,4.164.464.286
11/01/2017 08:00,29.17,56355,4537,205,273,5366,42,10423,4.164.464.286
11/01/2017 09:00,29.19,56505,4464,207,285,5441,45,10442,4.164.464.286
11/01/2017 10:00,29.23,57006,4410,213,297,5489,48,10457,4.164.464.286
11/01/2017 11:00,29.23,57302,4361,217,309,5453,49,10389,4.164.464.286
11/01/2017 12:00,29.24,57395,4326,219,319,5411,52,10327,4.164.464.286
11/01/2017 13:00,29.17,57426,4340,220,329,5439,53,10381,4.164.464.286
11/01/2017 14:00,29.2,57566,4339,220,348,5399,53,10359,4.164.464.286
11/01/2017 15:00,29.27,58157,4319,222,358,5350,54,10303,4.164.464.286
11/01/2017 16:00,29.47,58955,4308,228,379,5216,56,10187,4.164.464.286
11/01/2017 17:00,29.61,59457,4344,232,393,5138,55,10162,4.164.464.286
11/01/2017 18:00,29.4,58570,4407,237,400,5071,56,10171,4.164.464.286
11/01/2017 19:00,29.06,57470,4452,241,402,4911,55,10061,4.164.464.286
11/01/2017 20:00,28.54,55688,4462,243,405,4823,56,9989,4.164.464.286
11/01/2017 21:00,27.86,54116,4470,245,405,4731,57,9908,4.164.464.286
11/01/2017 22:00,26.64,51916,4465,245,405,4634,56,9805,4.164.464.286
11/01/2017 23:00,25.04,49257,4447,244,408,4520,55,9674,4.164.464.286
12/01/2017 00:00,23.48,46913,4414,237,400,4609,54,9714,4.164.464.286
12/01/2017 01:00,23.18,46037,4403,235,390,4449,53,9530,4.164.464.286
12/01/2017 02:00,23.16,45754,4400,234,375,4341,53,9403,4.164.464.286
12/01/2017 03:00,23.2,45944,4405,234,360,4236,52,9287,4.164.464.286
12/01/2017 04:00,23.99,46835,4414,233,345,4165,52,9209,4.164.464.286
12/01/2017 05:00,25.34,49246,4425,233,325,4137,51,9171,4.164.464.286
12/01/2017 06:00,28.39,53449,4440,233,325,4110,50,9158,4.164.464.286
12/01/2017 07:00,29.5,57575,4447,229,320,4013,50,9059,4.164.464.286
12/01/2017 08:00,29.89,57314,4460,229,310,3970,49,9018,4.164.464.286
12/01/2017 09:00,29.64,57600,4483,228,280,3986,48,9025,4.164.464.286
12/01/2017 10:00,29.62,58065,4500,223,250,3938,45,8956,4.164.464.286
12/01/2017 11:00,29.55,58201,4512,218,225,3863,38,8856,4.164.464.286
12/01/2017 12:00,29.51,58054,4508,215,225,3828,31,8807,4.164.464.286
12/01/2017 13:00,29.52,57912,4464,205,250,3746,24,8689,4.164.464.286
12/01/2017 14:00,29.65,57956,4379,196,275,3668,18,8536,4.164.464.286
12/01/2017 15:00,29.85,58535,4251,186,290,3635,17,8379,4.164.464.286
12/01/2017 16:00,30.3,59430,4098,176,330,3570,18,8192,4.164.464.286
12/01/2017 17:00,30.56,59964,3954,167,345,3451,20,7937,4.164.464.286
12/01/2017 18:00,30.37,59222,3815,156,355,3343,21,7690,4.164.464.286
12/01/2017 19:00,29.73,57958,3670,146,360,3244,20,7440,4.164.464.286
12/01/2017 20:00,29.43,56181,3508,139,340,3128,21,7136,4.164.464.286
12/01/2017 21:00,29.35,54670,3295,137,340,2989,23,6784,4.164.464.286
12/01/2017 22:00,29.12,52417,3056,134,340,2803,23,6356,4.164.464.286
12/01/2017 23:00,28.72,49772,2810,125,350,2670,20,5975,4.164.464.286
13/01/2017 00:00,29.01,47726,1162,126,350,2557,29,4224,4.164.464.286
13/01/2017 01:00,28.8,46673,890,124,350,2367,24,3755,4.164.464.286
13/01/2017 02:00,28.9,46291,658,124,350,2197,23,3352,4.164.464.286
13/01/2017 03:00,28.89,46455,519,127,335,2037,23,3041,4.164.464.286
13/01/2017 04:00,29.12,47409,446,129,325,1862,22,2784,4.164.464.286
13/01/2017 05:00,30.38,49914,402,131,305,1674,21,2533,4.164.464.286
13/01/2017 06:00,32,54300,368,134,280,1514,20,2316,4.164.464.286
13/01/2017 07:00,35.47,58906,355,135,240,1341,19,2090,4.164.464.286
13/01/2017 08:00,37.57,59052,370,136,215,1185,19,1925,4.164.464.286
13/01/2017 09:00,37.04,59209,394,139,190,1083,18,1824,4.164.464.286
13/01/2017 10:00,37.12,59503,398,143,180,919,17,1657,4.164.464.286
13/01/2017 11:00,36.01,59316,389,146,170,794,18,1517,4.164.464.286
13/01/2017 12:00,35.53,58774,403,151,170,715,18,1457,4.164.464.286
13/01/2017 13:00,34.45,58071,402,152,170,686,18,1428,4.164.464.286
13/01/2017 14:00,33.48,57795,371,151,170,829,17,1538,4.164.464.286
13/01/2017 15:00,33.4,58287,351,148,170,995,14,1678,4.164.464.286
13/01/2017 16:00,34.77,59369,304,142,170,973,12,1601,4.164.464.286
13/01/2017 17:00,36.09,59993,255,134,165,985,11,1550,4.164.464.286
13/01/2017 18:00,34.16,59141,293,126,160,985,10,1574,4.164.464.286
13/01/2017 19:00,31.99,57583,317,116,160,1030,10,1633,4.164.464.286
13/01/2017 20:00,31.15,55458,313,105,150,1009,9,1586,4.164.464.286
13/01/2017 21:00,30.98,53957,386,93,150,1014,9,1652,4.164.464.286
13/01/2017 22:00,30.61,52066,503,82,150,1050,8,1793,4.164.464.286
13/01/2017 23:00,29.79,49695,665,67,150,1107,8,1997,4.164.464.286
14/01/2017 00:00,29.62,47700,1104,36,100,1218,7,2465,4.164.464.286
14/01/2017 01:00,28.74,46647,1409,33,82,1292,7,2823,4.164.464.286
14/01/2017 02:00,28.32,46060,1658,30,69,1402,7,3166,4.164.464.286
14/01/2017 03:00,28.16,45859,1882,28,64,1480,7,3461,4.164.464.286
14/01/2017 04:00,28.28,46038,2011,23,63,1583,7,3687,4.164.464.286
14/01/2017 05:00,28.48,46846,2029,18,64,1598,7,3716,4.164.464.286
14/01/2017 06:00,29.33,47984,2024,15,62,1596,7,3704,4.164.464.286
14/01/2017 07:00,29.58,49847,2030,12,62,1555,8,3667,4.164.464.286
14/01/2017 08:00,30.52,51211,2048,11,57,1695,7,3818,4.164.464.286
14/01/2017 09:00,30.81,52780,2068,10,52,1675,7,3812,4.164.464.286
14/01/2017 10:00,31.1,53988,2098,9,47,1607,7,3768,4.164.464.286
14/01/2017 11:00,31.12,54350,2135,7,45,1594,8,3789,4.164.464.286
14/01/2017 12:00,31.02,54136,2127,7,45,1561,8,3748,4.164.464.286
14/01/2017 13:00,30.87,53668,2130,7,42,1618,11,3808,4.164.464.286
14/01/2017 14:00,30.88,53733,2191,8,46,1631,11,3887,4.164.464.286
14/01/2017 15:00,31.06,54661,2290,9,44,1691,10,4044,4.164.464.286
14/01/2017 16:00,31.45,56391,2365,11,44,1737,10,4167,4.164.464.286
14/01/2017 17:00,32.13,57342,2428,13,45,1762,9,4257,4.164.464.286
14/01/2017 18:00,31.87,56611,2435,14,42,1818,10,4319,4.164.464.286
14/01/2017 19:00,31.23,55064,2328,15,42,1772,10,4167,4.164.464.286
14/01/2017 20:00,31.06,53308,2224,18,41,1883,10,4176,4.164.464.286
14/01/2017 21:00,30.58,52392,2187,18,45,1970,11,4231,4.164.464.286
14/01/2017 22:00,30.14,51072,2143,20,51,1975,11,4200,4.164.464.286
14/01/2017 23:00,29.41,49516,2065,20,57,2124,9,4275,4.164.464.286
15/01/2017 00:00,28.81,47863,1783,12,22,2129,7,3953,4.164.464.286
15/01/2017 01:00,28.22,47125,1726,15,21,2249,7,4018,4.164.464.286
15/01/2017 02:00,27.87,46625,1666,19,21,2367,7,4080,4.164.464.286
15/01/2017 03:00,27.77,46428,1610,21,22,2498,8,4159,4.164.464.286
15/01/2017 04:00,27.94,46529,1522,23,25,2651,8,4229,4.164.464.286
15/01/2017 05:00,28.49,47043,1379,25,30,2727,7,4168,4.164.464.286
15/01/2017 06:00,28.96,47903,1241,27,33,2746,7,4054,4.164.464.286
15/01/2017 07:00,29.15,49294,1119,30,37,2799,8,3993,4.164.464.286
15/01/2017 08:00,30.4,50574,1003,33,43,2791,7,3877,4.164.464.286
15/01/2017 09:00,31.28,52101,906,36,40,2778,7,3767,4.164.464.286
15/01/2017 10:00,31.36,53398,799,36,37,2757,7,3636,4.164.464.286
15/01/2017 11:00,31.43,53967,727,34,34,2721,7,3523,4.164.464.286
15/01/2017 12:00,31.36,53835,707,31,32,2697,7,3474,4.164.464.286
15/01/2017 13:00,31.33,53691,693,31,31,2671,8,3434,4.164.464.286
15/01/2017 14:00,31.28,53891,648,29,29,2657,8,3371,4.164.464.286
15/01/2017 15:00,31.37,54893,604,27,26,2730,7,3394,4.164.464.286
15/01/2017 16:00,31.97,56544,586,24,29,2836,7,3482,4.164.464.286
15/01/2017 17:00,32.68,57699,578,22,32,2902,7,3541,4.164.464.286
15/01/2017 18:00,32.49,57469,575,20,26,2940,7,3568,4.164.464.286
15/01/2017 19:00,32.02,56460,569,19,22,2944,7,3561,4.164.464.286
15/01/2017 20:00,31.47,55308,542,20,19,2882,8,3471,4.164.464.286
15/01/2017 21:00,31.37,54607,512,19,17,2863,8,3419,4.164.464.286
15/01/2017 22:00,31.31,53052,490,19,19,2817,8,3353,4.164.464.286
15/01/2017 23:00,30.89,51366,459,18,17,2703,7,3204,4.164.464.286
16/01/2017 00:00,30.9,50535,377,11,17,2744,7,3156,4.013.809.524
16/01/2017 01:00,30.7,49644,359,11,15,2576,7,2968,4.013.809.524
16/01/2017 02:00,30.74,49324,348,11,14,2467,7,2847,4.013.809.524
16/01/2017 03:00,30.74,49659,345,10,13,2419,7,2794,4.013.809.524
16/01/2017 04:00,31.22,50944,356,11,13,2341,7,2728,4.013.809.524
16/01/2017 05:00,31.61,53609,393,11,12,2147,7,2570,4.013.809.524
16/01/2017 06:00,33.97,57968,448,11,12,2002,7,2480,4.013.809.524
16/01/2017 07:00,44.48,62539,494,10,12,1897,8,2421,4.013.809.524
16/01/2017 08:00,48.42,62708,531,10,12,1753,9,2315,4.013.809.524
16/01/2017 09:00,51.73,62709,572,9,12,1587,8,2188,4.013.809.524
16/01/2017 10:00,51.51,63043,564,10,11,1405,8,1998,4.013.809.524
16/01/2017 11:00,49.87,62971,496,10,11,1147,9,1673,4.013.809.524
16/01/2017 12:00,46.34,62447,430,9,11,998,8,1456,4.013.809.524
16/01/2017 13:00,43.18,62170,373,8,11,879,8,1279,4.013.809.524
16/01/2017 14:00,47.83,62132,349,8,11,906,9,1283,4.013.809.524
16/01/2017 15:00,46.63,62619,353,9,12,935,7,1316,4.013.809.524
16/01/2017 16:00,62.79,63425,344,9,13,936,7,1309,4.013.809.524
16/01/2017 17:00,81.05,64096,324,9,13,924,9,1279,4.013.809.524
16/01/2017 18:00,59.7,63489,294,9,13,1115,7,1438,4.013.809.524
16/01/2017 19:00,42.01,62355,260,10,14,1251,7,1542,4.013.809.524
16/01/2017 20:00,34,60629,219,11,14,1420,7,1671,4.013.809.524
16/01/2017 21:00,32.45,59239,170,11,14,1690,7,1892,4.013.809.524
16/01/2017 22:00,31.63,56762,126,12,14,1805,7,1964,4.013.809.524
16/01/2017 23:00,30.99,54093,92,11,14,1930,7,2054,4.013.809.524
17/01/2017 00:00,30.64,52529,125,6,14,1933,7,2085,4.013.809.524
17/01/2017 01:00,30.36,51510,106,6,13,2035,7,2167,4.013.809.524
17/01/2017 02:00,30.38,51112,99,6,13,2094,7,2219,4.013.809.524
17/01/2017 03:00,30.37,51193,107,7,12,2112,7,2245,4.013.809.524
17/01/2017 04:00,30.69,52365,127,7,12,2151,7,2304,4.013.809.524
17/01/2017 05:00,31.28,54871,153,7,12,2135,8,2315,4.013.809.524
17/01/2017 06:00,32.06,59137,187,8,12,2160,7,2374,4.013.809.524
17/01/2017 07:00,40.13,63411,218,9,12,2242,7,2488,4.013.809.524
17/01/2017 08:00,41.74,62514,251,9,12,2227,8,2507,4.013.809.524
17/01/2017 09:00,37.16,62370,295,9,12,2256,7,2579,4.013.809.524
17/01/2017 10:00,35.8,62466,357,8,12,2278,7,2662,4.013.809.524
17/01/2017 11:00,33.99,62317,457,9,12,2448,8,2934,4.013.809.524
17/01/2017 12:00,33.2,61829,583,10,12,2545,7,3157,4.013.809.524
17/01/2017 13:00,32.77,61452,703,13,12,2618,8,3354,4.013.809.524
17/01/2017 14:00,32.52,61228,796,17,12,2688,7,3520,4.013.809.524
17/01/2017 15:00,32.56,61595,918,21,13,2748,7,3707,4.013.809.524
17/01/2017 16:00,33.06,62327,1063,28,14,2804,7,3916,4.013.809.524
17/01/2017 17:00,33.14,62808,1174,35,16,2888,8,4121,4.013.809.524
17/01/2017 18:00,32.3,61855,1281,42,18,2928,8,4277,4.013.809.524
17/01/2017 19:00,31.4,60460,1381,49,21,3019,9,4479,4.013.809.524
17/01/2017 20:00,30.74,58573,1471,57,23,3023,10,4584,4.013.809.524
17/01/2017 21:00,30.4,56616,1546,66,27,2974,10,4623,4.013.809.524
17/01/2017 22:00,30.01,54046,1623,75,32,2867,10,4607,4.013.809.524
17/01/2017 23:00,29.56,51296,1720,83,38,2750,11,4602,4.013.809.524
18/01/2017 00:00,28.8,48723,1799,88,33,2447,12,4379,4.013.809.524
18/01/2017 01:00,28.41,47528,1839,91,39,2324,12,4305,4.013.809.524
18/01/2017 02:00,28.29,47109,1861,95,47,2202,14,4219,4.013.809.524
18/01/2017 03:00,28.33,47178,1870,97,50,2138,15,4170,4.013.809.524
18/01/2017 04:00,28.86,47986,1873,99,56,2179,17,4224,4.013.809.524
18/01/2017 05:00,29.64,50405,1861,96,62,2314,17,4350,4.013.809.524
18/01/2017 06:00,30.08,54873,1839,93,70,2505,15,4522,4.013.809.524
18/01/2017 07:00,30.8,59232,1824,91,71,2634,16,4636,4.013.809.524
18/01/2017 08:00,30.91,60293,1808,86,81,2890,17,4882,4.013.809.524
18/01/2017 09:00,30.76,59045,1800,87,89,3108,16,5100,4.013.809.524
18/01/2017 10:00,30.59,59266,1822,86,99,3260,17,5284,4.013.809.524
18/01/2017 11:00,30.45,59262,1876,86,111,3447,17,5537,4.013.809.524
18/01/2017 12:00,30.26,58988,1934,89,149,3568,15,5755,4.013.809.524
18/01/2017 13:00,30.04,59005,1968,89,163,3820,14,6054,4.013.809.524
18/01/2017 14:00,29.91,58905,1973,90,172,3935,13,6183,4.013.809.524
18/01/2017 15:00,29.98,59158,1963,92,169,4045,13,6282,4.013.809.524
18/01/2017 16:00,30.16,59902,1924,100,180,4194,15,6413,4.013.809.524
18/01/2017 17:00,30.28,60296,1860,113,188,4340,17,6518,4.013.809.524
18/01/2017 18:00,29.99,59183,1796,129,199,4390,16,6530,4.013.809.524
18/01/2017 19:00,29.49,57711,1726,140,212,4417,18,6513,4.013.809.524
18/01/2017 20:00,28.96,55633,1656,144,227,4364,21,6412,4.013.809.524
18/01/2017 21:00,28.89,53987,1590,148,236,4338,24,6336,4.013.809.524
18/01/2017 22:00,28.69,51277,1533,148,247,4264,28,6220,4.013.809.524
18/01/2017 23:00,27.84,48358,1474,139,256,4097,29,5995,4.013.809.524
19/01/2017 00:00,26.77,46689,1576,125,293,4032,28,6054,4.013.809.524
19/01/2017 01:00,26.09,45630,1532,119,299,3962,28,5940,4.013.809.524
19/01/2017 02:00,25.93,45319,1506,114,305,3860,27,5812,4.013.809.524
19/01/2017 03:00,26.2,45543,1493,106,307,3735,26,5667,4.013.809.524
19/01/2017 04:00,27.68,46444,1530,99,309,3632,29,5599,4.013.809.524
19/01/2017 05:00,28.65,48824,1548,88,306,3612,31,5585,4.013.809.524
19/01/2017 06:00,29.02,53361,1499,78,301,3701,27,5606,4.013.809.524
19/01/2017 07:00,29.71,57583,1483,73,296,3784,23,5659,4.013.809.524
19/01/2017 08:00,30.05,56946,1498,69,291,4046,18,5922,4.013.809.524
19/01/2017 09:00,29.98,56719,1519,68,286,4149,17,6039,4.013.809.524
19/01/2017 10:00,29.87,56922,1559,70,276,4182,15,6102,4.013.809.524
19/01/2017 11:00,29.7,56747,1649,74,272,4282,18,6295,4.013.809.524
19/01/2017 12:00,29.4,56469,1739,86,275,4372,19,6491,4.013.809.524
19/01/2017 13:00,29.21,56465,1734,99,278,4453,23,6587,4.013.809.524
19/01/2017 14:00,29.13,56281,1679,121,291,4478,24,6593,4.013.809.524
19/01/2017 15:00,29.33,56727,1632,141,295,4538,28,6634,4.013.809.524
19/01/2017 16:00,29.62,57509,1589,156,300,4443,32,6520,4.013.809.524
19/01/2017 17:00,29.76,58160,1542,169,303,4458,31,6503,4.013.809.524
19/01/2017 18:00,29.69,57352,1509,176,305,4313,31,6334,4.013.809.524
19/01/2017 19:00,29.36,56116,1500,171,304,4193,27,6195,4.013.809.524
19/01/2017 20:00,28.78,54313,1501,170,305,4036,28,6040,4.013.809.524
19/01/2017 21:00,28.72,52782,1469,162,299,3839,25,5794,4.013.809.524
19/01/2017 22:00,28.67,50531,1414,154,293,3644,20,5525,4.013.809.524
19/01/2017 23:00,28.19,47891,1379,144,275,3385,18,5201,4.013.809.524
20/01/2017 00:00,27.05,46034,1321,135,186,3185,11,4838,4.013.809.524
20/01/2017 01:00,26.79,45120,1338,126,160,3011,10,4645,4.013.809.524
20/01/2017 02:00,26.61,44756,1382,112,142,2948,9,4593,4.013.809.524
20/01/2017 03:00,26.85,44893,1441,96,123,2941,8,4609,4.013.809.524
20/01/2017 04:00,27.63,45795,1461,87,109,2970,8,4635,4.013.809.524
20/01/2017 05:00,27.84,48146,1446,80,94,3064,7,4691,4.013.809.524
20/01/2017 06:00,28.61,52455,1455,75,85,3146,6,4767,4.013.809.524
20/01/2017 07:00,29.7,56827,1482,68,83,3129,6,4768,4.013.809.524
20/01/2017 08:00,29.97,56459,1468,57,77,3194,9,4805,4.013.809.524
20/01/2017 09:00,29.87,56665,1452,55,76,3270,8,4861,4.013.809.524
20/01/2017 10:00,29.79,56787,1489,52,79,3363,12,4995,4.013.809.524
20/01/2017 11:00,29.67,56489,1562,51,83,3323,14,5033,4.013.809.524
20/01/2017 12:00,29.43,55885,1640,52,89,3225,15,5021,4.013.809.524
20/01/2017 13:00,29.31,55303,1675,56,101,3272,20,5124,4.013.809.524
20/01/2017 14:00,29.08,54862,1662,64,115,3313,29,5183,4.013.809.524
20/01/2017 15:00,29.13,55148,1638,71,134,3349,30,5222,4.013.809.524
20/01/2017 16:00,29.4,56193,1605,74,145,3417,26,5267,4.013.809.524
20/01/2017 17:00,29.61,56972,1561,75,155,3426,27,5244,4.013.809.524
20/01/2017 18:00,29.55,56199,1499,78,162,3319,25,5083,4.013.809.524
20/01/2017 19:00,28.8,54631,1415,80,166,3177,24,4862,4.013.809.524
20/01/2017 20:00,28.25,52454,1334,78,162,3050,22,4646,4.013.809.524
20/01/2017 21:00,28.12,51026,1262,78,161,2924,17,4442,4.013.809.524
20/01/2017 22:00,27.84,49296,1187,82,155,2758,15,4197,4.013.809.524
20/01/2017 23:00,27.36,47124,1093,83,153,2617,15,3961,4.013.809.524
21/01/2017 00:00,27.36,45294,880,104,157,2491,11,3643,4.013.809.524
21/01/2017 01:00,26.83,44130,815,108,133,2361,13,3430,4.013.809.524
21/01/2017 02:00,26.58,43599,736,113,119,2271,11,3250,4.013.809.524
21/01/2017 03:00,26.61,43535,650,116,105,2218,9,3098,4.013.809.524
21/01/2017 04:00,26.84,43796,549,110,93,2193,8,2953,4.013.809.524
21/01/2017 05:00,27.44,44513,450,104,83,2039,9,2685,4.013.809.524
21/01/2017 06:00,27.39,45655,379,98,77,1857,7,2418,4.013.809.524
21/01/2017 07:00,27.97,47442,331,96,63,1698,6,2194,4.013.809.524
21/01/2017 08:00,28.53,48915,300,97,50,1462,6,1915,4.013.809.524
21/01/2017 09:00,28.96,50587,268,98,47,1357,6,1776,4.013.809.524
21/01/2017 10:00,29.25,51766,237,99,40,1270,6,1652,4.013.809.524
21/01/2017 11:00,29.27,52035,222,99,29,1211,6,1567,4.013.809.524
21/01/2017 12:00,29.03,51709,207,98,24,1274,7,1610,4.013.809.524
21/01/2017 13:00,28.95,51300,176,91,22,1274,7,1570,4.013.809.524
21/01/2017 14:00,28.9,51293,132,77,25,1372,7,1613,4.013.809.524
21/01/2017 15:00,29.28,52180,106,63,26,1598,6,1799,4.013.809.524
21/01/2017 16:00,29.69,54033,92,49,27,1690,6,1864,4.013.809.524
21/01/2017 17:00,29.95,55294,85,37,28,1842,6,1998,4.013.809.524
21/01/2017 18:00,29.88,54573,86,30,28,1876,7,2027,4.013.809.524
21/01/2017 19:00,29.63,52922,94,29,26,2033,7,2189,4.013.809.524
21/01/2017 20:00,29.04,51101,104,33,25,2069,8,2239,4.013.809.524
21/01/2017 21:00,28.81,50037,107,40,29,2219,8,2403,4.013.809.524
21/01/2017 22:00,28.35,48654,105,57,37,2350,7,2556,4.013.809.524
21/01/2017 23:00,27.84,46822,107,70,47,2434,6,2664,4.013.809.524
22/01/2017 00:00,28.21,46377,187,93,71,2541,17,2909,4.013.809.524
22/01/2017 01:00,27.59,45393,202,109,89,2575,18,2993,4.013.809.524
22/01/2017 02:00,27.27,44782,227,120,105,2537,18,3007,4.013.809.524
22/01/2017 03:00,27.15,44525,243,128,111,2405,23,2910,4.013.809.524
22/01/2017 04:00,27.23,44674,254,135,122,2378,24,2913,4.013.809.524
22/01/2017 05:00,27.61,45135,262,142,128,2364,23,2919,4.013.809.524
22/01/2017 06:00,27.67,45884,268,144,133,2419,23,2987,4.013.809.524
22/01/2017 07:00,28.14,47117,282,147,138,2457,22,3046,4.013.809.524
22/01/2017 08:00,28.5,48543,306,150,140,2469,19,3084,4.013.809.524
22/01/2017 09:00,28.96,50086,339,151,139,2437,19,3085,4.013.809.524
22/01/2017 10:00,29.5,51272,361,151,146,2364,21,3043,4.013.809.524
22/01/2017 11:00,29.5,51779,369,152,150,2395,24,3090,4.013.809.524
22/01/2017 12:00,29.32,51637,392,152,152,2386,25,3107,4.013.809.524
22/01/2017 13:00,29.32,51508,399,147,155,2361,25,3087,4.013.809.524
22/01/2017 14:00,29.36,51617,367,148,156,2433,27,3131,4.013.809.524
22/01/2017 15:00,29.54,52578,338,144,155,2502,28,3167,4.013.809.524
22/01/2017 16:00,29.77,54095,342,138,154,2622,29,3285,4.013.809.524
22/01/2017 17:00,29.96,55179,369,130,152,2788,32,3471,4.013.809.524
22/01/2017 18:00,29.92,54953,401,124,154,2901,34,3614,4.013.809.524
22/01/2017 19:00,29.74,54049,424,120,156,2938,34,3672,4.013.809.524
22/01/2017 20:00,29.56,52751,419,118,158,2952,34,3681,4.013.809.524
22/01/2017 21:00,29.36,51878,409,118,158,2906,30,3621,4.013.809.524
22/01/2017 22:00,28.88,50245,410,119,157,2954,29,3669,4.013.809.524
22/01/2017 23:00,28.13,48396,420,116,156,3016,30,3738,4.013.809.524
23/01/2017 00:00,27.96,46704,401,109,150,3016,43,3719,3.863.214.286
23/01/2017 01:00,27.48,45837,449,113,140,2973,40,3715,3.863.214.286
23/01/2017 02:00,27.19,45519,492,117,138,2987,35,3769,3.863.214.286
23/01/2017 03:00,27.51,45710,504,122,136,3083,33,3878,3.863.214.286
23/01/2017 04:00,28.21,46683,472,124,136,3104,34,3870,3.863.214.286
23/01/2017 05:00,28.79,49114,463,126,137,3193,36,3955,3.863.214.286
23/01/2017 06:00,29.55,53344,497,129,138,3217,35,4016,3.863.214.286
23/01/2017 07:00,30.27,57579,539,132,141,3215,35,4062,3.863.214.286
23/01/2017 08:00,30.5,58043,581,132,142,3226,32,4113,3.863.214.286
23/01/2017 09:00,30.44,58010,602,138,147,3265,30,4182,3.863.214.286
23/01/2017 10:00,30.19,57958,605,143,152,3185,29,4114,3.863.214.286
23/01/2017 11:00,30.01,57896,617,145,157,3145,32,4096,3.863.214.286
23/01/2017 12:00,29.95,57532,646,143,164,3107,34,4094,3.863.214.286
23/01/2017 13:00,29.86,57653,665,136,168,3089,34,4092,3.863.214.286
23/01/2017 14:00,29.86,57605,667,128,174,3048,34,4051,3.863.214.286
23/01/2017 15:00,29.96,58116,669,120,177,2989,32,3987,3.863.214.286
23/01/2017 16:00,30.23,59109,666,118,181,2941,32,3938,3.863.214.286
23/01/2017 17:00,30.6,59794,683,123,182,2920,31,3939,3.863.214.286
23/01/2017 18:00,30.27,59115,713,129,185,2877,32,3936,3.863.214.286
23/01/2017 19:00,29.84,57912,729,131,185,2768,31,3844,3.863.214.286
23/01/2017 20:00,29.56,56143,734,130,181,2557,30,3632,3.863.214.286
23/01/2017 21:00,29.35,54701,733,129,173,2433,29,3497,3.863.214.286
23/01/2017 22:00,28.84,52417,732,126,166,2324,25,3373,3.863.214.286
23/01/2017 23:00,28.42,49884,728,121,157,2115,23,3144,3.863.214.286
24/01/2017 00:00,28.86,48240,549,126,0,1886,22,2583,3.863.214.286
24/01/2017 01:00,28.75,47202,547,119,0,1683,21,2370,3.863.214.286
24/01/2017 02:00,28.73,46863,542,116,0,1507,19,2184,3.863.214.286
24/01/2017 03:00,28.84,47098,531,113,0,1294,17,1955,3.863.214.286
24/01/2017 04:00,29.34,48047,509,111,0,1096,17,1733,3.863.214.286
24/01/2017 05:00,29.49,50650,495,103,0,914,14,1526,3.863.214.286
24/01/2017 06:00,30.34,54995,494,96,0,813,10,1413,3.863.214.286
24/01/2017 07:00,33.76,59363,479,92,0,713,9,1293,3.863.214.286
24/01/2017 08:00,38.83,60460,452,85,0,605,9,1151,3.863.214.286
24/01/2017 09:00,35.95,59735,456,84,0,557,8,1105,3.863.214.286
24/01/2017 10:00,35.11,59706,495,84,0,496,8,1083,3.863.214.286
24/01/2017 11:00,33.56,59386,525,83,0,468,11,1087,3.863.214.286
24/01/2017 12:00,32.37,59014,517,80,0,500,10,1107,3.863.214.286
24/01/2017 13:00,31.97,58849,488,75,0,560,11,1134,3.863.214.286
24/01/2017 14:00,31.43,58775,478,71,0,701,12,1262,3.863.214.286
24/01/2017 15:00,31.67,59271,494,61,0,860,10,1425,3.863.214.286
24/01/2017 16:00,32.7,60255,520,53,0,1067,11,1651,3.863.214.286
24/01/2017 17:00,33.59,61139,573,46,0,1332,14,1965,3.863.214.286
24/01/2017 18:00,32.48,60390,619,36,0,1472,13,2140,3.863.214.286
24/01/2017 19:00,30.65,59171,628,31,0,1632,14,2305,3.863.214.286
24/01/2017 20:00,29.95,57478,634,26,0,1833,15,2508,3.863.214.286
24/01/2017 21:00,29.59,55958,657,22,0,1892,11,2582,3.863.214.286
24/01/2017 22:00,28.96,53627,708,20,0,1891,9,2628,3.863.214.286
24/01/2017 23:00,28.4,50903,782,17,0,2004,9,2812,3.863.214.286
25/01/2017 00:00,28.65,48385,978,11,36,1924,6,2955,3.863.214.286
25/01/2017 01:00,28.27,47305,1024,11,32,1986,6,3059,3.863.214.286
25/01/2017 02:00,27.95,46869,1075,10,26,2051,5,3167,3.863.214.286
25/01/2017 03:00,27.96,46986,1135,10,20,2161,5,3331,3.863.214.286
25/01/2017 04:00,28.58,47712,1207,11,18,2206,6,3448,3.863.214.286
25/01/2017 05:00,28.75,49971,1272,13,16,2297,5,3603,3.863.214.286
25/01/2017 06:00,29.46,54108,1312,14,15,2423,6,3770,3.863.214.286
25/01/2017 07:00,30.9,58123,1306,16,15,2531,6,3874,3.863.214.286
25/01/2017 08:00,31.37,58883,1283,17,17,2594,6,3917,3.863.214.286
25/01/2017 09:00,30.99,57616,1280,21,17,2734,6,4058,3.863.214.286
25/01/2017 10:00,30.85,57792,1259,25,17,2890,7,4198,3.863.214.286
25/01/2017 11:00,30.51,57838,1186,31,17,3021,8,4263,3.863.214.286
25/01/2017 12:00,30.28,57596,1101,36,17,3064,8,4226,3.863.214.286
25/01/2017 13:00,30.07,57651,1022,43,17,3097,8,4187,3.863.214.286
25/01/2017 14:00,30.02,57453,935,52,19,3204,8,4218,3.863.214.286
25/01/2017 15:00,30.09,57603,844,64,23,3334,8,4273,3.863.214.286
25/01/2017 16:00,30.37,58425,777,77,31,3472,8,4365,3.863.214.286
25/01/2017 17:00,30.75,59128,767,91,46,3534,9,4447,3.863.214.286
25/01/2017 18:00,30.47,58229,766,106,58,3563,12,4505,3.863.214.286
25/01/2017 19:00,29.75,57007,752,117,66,3553,13,4501,3.863.214.286
25/01/2017 20:00,29.12,55072,746,129,75,3619,15,4584,3.863.214.286
25/01/2017 21:00,28.87,53540,716,138,79,3649,17,4599,3.863.214.286
25/01/2017 22:00,28.08,51243,688,147,83,3696,20,4634,3.863.214.286
25/01/2017 23:00,27.41,48571,683,149,86,3753,23,4694,3.863.214.286
26/01/2017 00:00,26.96,46987,765,192,85,3934,24,5000,3.863.214.286
26/01/2017 01:00,26.62,45924,778,199,88,3934,26,5025,3.863.214.286
26/01/2017 02:00,26.42,45502,801,204,92,3876,27,5000,3.863.214.286
26/01/2017 03:00,26.32,45650,808,206,99,3955,28,5096,3.863.214.286
26/01/2017 04:00,26.99,46506,784,198,107,3903,27,5019,3.863.214.286
26/01/2017 05:00,27.99,48854,737,188,119,3835,33,4912,3.863.214.286
26/01/2017 06:00,29.18,53093,684,174,129,3692,37,4716,3.863.214.286
26/01/2017 07:00,30.97,57309,656,160,140,3518,34,4508,3.863.214.286
26/01/2017 08:00,31.29,57366,646,152,147,3506,27,4478,3.863.214.286
26/01/2017 09:00,31.23,57317,629,148,154,3414,24,4369,3.863.214.286
26/01/2017 10:00,31.2,57334,613,146,164,3380,23,4326,3.863.214.286
26/01/2017 11:00,31.09,57132,605,143,175,3207,23,4153,3.863.214.286
26/01/2017 12:00,30.94,56932,616,139,190,3109,26,4080,3.863.214.286
26/01/2017 13:00,30.9,56932,623,131,205,3075,27,4061,3.863.214.286
26/01/2017 14:00,30.94,56764,638,128,219,3086,24,4095,3.863.214.286
26/01/2017 15:00,31.13,57142,663,123,221,3029,19,4055,3.863.214.286
26/01/2017 16:00,31.42,58153,713,120,224,2856,19,3932,3.863.214.286
26/01/2017 17:00,31.74,59174,809,117,226,2765,19,3936,3.863.214.286
26/01/2017 18:00,31.49,58540,933,113,221,2677,19,3963,3.863.214.286
26/01/2017 19:00,30.66,57392,1020,106,216,2527,21,3890,3.863.214.286
26/01/2017 20:00,29.85,55583,1042,96,210,2463,24,3835,3.863.214.286
26/01/2017 21:00,29.67,54034,1042,87,197,2430,21,3777,3.863.214.286
26/01/2017 22:00,29.05,51760,1025,80,184,2296,17,3602,3.863.214.286
26/01/2017 23:00,28.66,49075,992,72,171,2207,15,3457,3.863.214.286
27/01/2017 00:00,28.23,47408,939,58,137,2011,11,3156,3.863.214.286
27/01/2017 01:00,27.76,46352,974,53,126,1914,10,3077,3.863.214.286
27/01/2017 02:00,27.65,45994,1009,48,112,1791,10,2970,3.863.214.286
27/01/2017 03:00,28.01,46118,1020,42,100,1777,10,2949,3.863.214.286
27/01/2017 04:00,28.52,47010,1053,36,91,1691,10,2881,3.863.214.286
27/01/2017 05:00,29.35,49375,1157,28,79,1610,9,2883,3.863.214.286
27/01/2017 06:00,30.52,53671,1307,21,72,1541,8,2949,3.863.214.286
27/01/2017 07:00,32.46,57967,1452,17,64,1467,7,3007,3.863.214.286
27/01/2017 08:00,32.39,59044,1572,12,51,1461,7,3103,3.863.214.286
27/01/2017 09:00,31.98,58589,1699,8,39,1477,6,3229,3.863.214.286
27/01/2017 10:00,31.89,58531,1749,7,29,1485,7,3277,3.863.214.286
27/01/2017 11:00,31.69,57985,1685,6,20,1530,6,3247,3.863.214.286
27/01/2017 12:00,31.32,56823,1597,6,17,1708,4,3332,3.863.214.286
27/01/2017 13:00,31.04,56108,1498,6,13,1721,4,3242,3.863.214.286
27/01/2017 14:00,30.99,55734,1396,6,11,1829,4,3246,3.863.214.286
27/01/2017 15:00,31.07,55969,1317,7,13,1980,4,3321,3.863.214.286
27/01/2017 16:00,31.55,57165,1284,8,13,2103,4,3412,3.863.214.286
27/01/2017 17:00,31.88,58281,1304,10,12,2108,5,3439,3.863.214.286
27/01/2017 18:00,31.72,57701,1287,12,12,2014,4,3329,3.863.214.286
27/01/2017 19:00,30.84,56124,1195,14,10,1928,4,3151,3.863.214.286
27/01/2017 20:00,29.95,54094,1088,15,9,1835,5,2952,3.863.214.286
27/01/2017 21:00,29.68,52611,993,17,8,1725,4,2747,3.863.214.286
27/01/2017 22:00,29.24,50856,886,18,9,1828,5,2746,3.863.214.286
27/01/2017 23:00,28.67,48709,799,20,12,1997,5,2833,3.863.214.286
28/01/2017 00:00,28.55,47083,443,22,10,1985,5,2465,3.863.214.286
28/01/2017 01:00,28.12,46019,417,23,10,2018,5,2473,3.863.214.286
28/01/2017 02:00,27.98,45436,432,26,15,2153,6,2632,3.863.214.286
28/01/2017 03:00,27.9,45274,465,29,15,2163,6,2678,3.863.214.286
28/01/2017 04:00,27.93,45470,523,33,15,2200,6,2777,3.863.214.286
28/01/2017 05:00,28.08,46147,622,36,20,2194,7,2879,3.863.214.286
28/01/2017 06:00,28.44,47337,739,40,20,2228,8,3035,3.863.214.286
28/01/2017 07:00,28.67,48982,848,43,22,2185,9,3107,3.863.214.286
28/01/2017 08:00,29.12,50229,947,46,25,2049,9,3076,3.863.214.286
28/01/2017 09:00,29.6,51843,1022,47,25,1838,10,2942,3.863.214.286
28/01/2017 10:00,29.82,52929,1028,47,25,1583,10,2693,3.863.214.286
28/01/2017 11:00,29.82,53061,961,44,30,1357,10,2402,3.863.214.286
28/01/2017 12:00,29.77,52673,878,43,30,1183,10,2144,3.863.214.286
28/01/2017 13:00,29.6,52111,836,41,30,1074,9,1990,3.863.214.286
28/01/2017 14:00,29.51,51889,860,41,30,987,8,1926,3.863.214.286
28/01/2017 15:00,29.76,52558,930,42,45,1021,7,2045,3.863.214.286
28/01/2017 16:00,30.16,54282,1048,41,55,1071,6,2221,3.863.214.286
28/01/2017 17:00,30.78,55959,1204,41,65,1129,6,2445,3.863.214.286
28/01/2017 18:00,30.39,55645,1372,41,75,1137,7,2632,3.863.214.286
28/01/2017 19:00,29.94,54142,1501,42,88,1209,7,2847,3.863.214.286
28/01/2017 20:00,29.59,52349,1559,44,100,1295,8,3006,3.863.214.286
28/01/2017 21:00,29.34,51313,1571,46,120,1398,8,3143,3.863.214.286
28/01/2017 22:00,28.95,49968,1537,48,120,1545,8,3258,3.863.214.286
28/01/2017 23:00,28.51,48419,1488,48,120,1736,7,3399,3.863.214.286
29/01/2017 00:00,28.61,46757,997,53,130,2032,11,3223,3.863.214.286
29/01/2017 01:00,27.94,45889,935,53,130,2211,13,3342,3.863.214.286
29/01/2017 02:00,27.49,45321,959,56,130,2323,13,3481,3.863.214.286
29/01/2017 03:00,27.25,45154,1025,59,155,2312,14,3565,3.863.214.286
29/01/2017 04:00,27.18,45300,1189,67,165,2351,16,3788,3.863.214.286
29/01/2017 05:00,27.41,45819,1427,76,170,2361,20,4054,3.863.214.286
29/01/2017 06:00,27.32,46553,1639,87,185,2367,22,4300,3.863.214.286
29/01/2017 07:00,27.67,47644,1800,99,200,2508,25,4632,3.863.214.286
29/01/2017 08:00,28.28,48931,1946,109,210,2472,30,4767,3.863.214.286
29/01/2017 09:00,28.75,49982,2071,120,215,2485,36,4927,3.863.214.286
29/01/2017 10:00,28.99,51227,2191,130,215,2481,41,5058,3.863.214.286
29/01/2017 11:00,28.93,51697,2298,139,215,2428,45,5125,3.863.214.286
29/01/2017 12:00,28.8,51617,2392,148,205,2602,46,5393,3.863.214.286
29/01/2017 13:00,28.72,51569,2422,153,195,2715,46,5531,3.863.214.286
29/01/2017 14:00,28.69,51506,2387,155,185,2808,43,5578,3.863.214.286
29/01/2017 15:00,28.86,52263,2381,157,180,2972,38,5728,3.863.214.286
29/01/2017 16:00,29.3,53715,2310,156,175,3115,36,5792,3.863.214.286
29/01/2017 17:00,29.73,54952,2202,157,165,3302,36,5862,3.863.214.286
29/01/2017 18:00,29.61,54730,2152,159,165,3367,39,5882,3.863.214.286
29/01/2017 19:00,29.15,53730,2121,160,165,3518,38,6002,3.863.214.286
29/01/2017 20:00,28.86,52292,2070,161,165,3538,40,5974,3.863.214.286
29/01/2017 21:00,28.7,51231,2018,163,155,3558,38,5932,3.863.214.286
29/01/2017 22:00,28.43,49464,1955,166,130,3631,34,5916,3.863.214.286
29/01/2017 23:00,27.96,47432,1874,161,120,3712,33,5900,3.863.214.286
30/01/2017 00:00,27.42,46101,1058,153,100,3579,38,4928,365.047.619
30/01/2017 01:00,27.01,45232,923,157,100,3532,38,4750,365.047.619
30/01/2017 02:00,26.99,44948,761,164,101,3461,38,4525,365.047.619
30/01/2017 03:00,27.7,45146,636,170,100,3332,37,4275,365.047.619
30/01/2017 04:00,28.57,46137,550,171,100,3224,31,4076,365.047.619
30/01/2017 05:00,29.49,48620,490,167,100,3071,25,3853,365.047.619
30/01/2017 06:00,30.38,53072,449,160,90,2892,21,3612,365.047.619
30/01/2017 07:00,32.06,57421,400,153,85,2800,19,3457,365.047.619
30/01/2017 08:00,32.37,56931,353,144,80,2578,19,3174,365.047.619
30/01/2017 09:00,32.04,57010,326,135,70,2446,18,2995,365.047.619
30/01/2017 10:00,31.91,57328,297,127,60,2329,16,2829,365.047.619
30/01/2017 11:00,31.82,57294,259,118,50,2139,14,2580,365.047.619
30/01/2017 12:00,31.51,57089,221,109,50,2129,13,2522,365.047.619
30/01/2017 13:00,31.55,57095,210,101,45,2014,14,2384,365.047.619
30/01/2017 14:00,31.41,56971,240,95,40,1993,13,2381,365.047.619
30/01/2017 15:00,31.49,57448,310,92,40,2010,12,2464,365.047.619
30/01/2017 16:00,32.18,58488,398,90,40,1970,9,2507,365.047.619
30/01/2017 17:00,33.44,59486,490,86,40,1906,9,2531,365.047.619
30/01/2017 18:00,32.5,58870,598,83,40,1907,9,2637,365.047.619
30/01/2017 19:00,31.34,57742,697,80,40,1906,8,2731,365.047.619
30/01/2017 20:00,30.87,56036,773,75,40,1784,8,2680,365.047.619
30/01/2017 21:00,30.22,54527,838,73,40,1686,6,2643,365.047.619
30/01/2017 22:00,30.02,52189,876,70,40,1508,5,2499,365.047.619
30/01/2017 23:00,29.31,49538,892,66,30,1450,5,2443,365.047.619
31/01/2017 00:00,28.62,47764,1800,70,37,1481,14,3402,365.047.619
31/01/2017 01:00,28.44,46768,1819,66,39,1330,14,3268,365.047.619
31/01/2017 02:00,28.46,46481,1828,63,40,1166,14,3111,365.047.619
31/01/2017 03:00,28.63,46766,1789,58,41,1117,14,3019,365.047.619
31/01/2017 04:00,29.14,47725,1677,52,41,1034,15,2819,365.047.619
31/01/2017 05:00,30.07,50244,1540,45,42,986,14,2627,365.047.619
31/01/2017 06:00,31.5,54794,1448,41,42,982,14,2527,365.047.619
31/01/2017 07:00,34.36,59252,1349,36,43,976,14,2418,365.047.619
31/01/2017 08:00,35.71,60224,1253,33,45,1022,15,2368,365.047.619
31/01/2017 09:00,34.21,59308,1215,29,41,1058,14,2357,365.047.619
31/01/2017 10:00,33.99,59368,1200,26,31,1105,14,2376,365.047.619
31/01/2017 11:00,33.29,59150,1170,23,30,1153,14,2390,365.047.619
31/01/2017 12:00,32.87,58796,1123,21,29,1158,14,2345,365.047.619
31/01/2017 13:00,32.71,58684,1070,19,28,1211,14,2342,365.047.619
31/01/2017 14:00,32.54,58556,997,19,29,1274,14,2333,365.047.619
31/01/2017 15:00,32.69,58864,931,18,33,1335,14,2331,365.047.619
31/01/2017 16:00,34.39,59904,932,18,39,1369,14,2372,365.047.619
31/01/2017 17:00,36.78,60813,947,19,46,1427,15,2454,365.047.619
31/01/2017 18:00,34.23,60065,936,20,52,1466,14,2488,365.047.619
31/01/2017 19:00,31.97,58748,879,22,53,1503,14,2471,365.047.619
31/01/2017 20:00,31.5,56928,764,23,51,1404,15,2257,365.047.619
31/01/2017 21:00,31.26,55277,661,24,45,1356,14,2100,365.047.619
31/01/2017 22:00,30.51,52950,609,25,40,1277,14,1965,365.047.619
31/01/2017 23:00,29.99,50281,593,26,37,1127,13,1796,365.047.619
01/02/2017 00:00,29.11,48066,595,25,22,997,2,1641,365.047.619
01/02/2017 01:00,28.85,47107,546,24,16,917,2,1505,365.047.619
01/02/2017 02:00,28.78,46724,534,24,14,874,2,1448,365.047.619
01/02/2017 03:00,28.86,46929,556,24,13,853,3,1449,365.047.619
01/02/2017 04:00,29.51,47796,610,23,13,845,3,1494,365.047.619
01/02/2017 05:00,30.41,50096,655,23,12,865,2,1557,365.047.619
01/02/2017 06:00,31.51,54295,681,25,14,927,2,1649,365.047.619
01/02/2017 07:00,34.6,58567,757,26,17,968,2,1770,365.047.619
01/02/2017 08:00,35.4,58357,857,28,23,1011,3,1922,365.047.619
01/02/2017 09:00,33.46,58323,960,30,19,1138,2,2149,365.047.619
01/02/2017 10:00,33,58500,1096,32,19,1317,3,2467,365.047.619
01/02/2017 11:00,32.08,58418,1258,34,18,1351,2,2663,365.047.619
01/02/2017 12:00,31.75,58175,1395,33,16,1416,3,2863,365.047.619
01/02/2017 13:00,31.82,58176,1458,29,15,1472,2,2976,365.047.619
01/02/2017 14:00,31.83,57959,1496,24,16,1623,2,3161,365.047.619
01/02/2017 15:00,31.78,58160,1591,21,19,1638,3,3272,365.047.619
01/02/2017 16:00,32.33,59497,1713,19,21,1529,2,3284,365.047.619
01/02/2017 17:00,33.18,60583,1870,18,24,1525,3,3440,365.047.619
01/02/2017 18:00,32.21,59813,2050,19,28,1517,3,3617,365.047.619
01/02/2017 19:00,31.44,58483,2190,21,35,1503,3,3752,365.047.619
01/02/2017 20:00,30.76,56584,2316,25,49,1510,5,3905,365.047.619
01/02/2017 21:00,30.34,55036,2399,30,51,1469,5,3954,365.047.619
01/02/2017 22:00,29.83,52721,2415,33,55,1518,5,4026,365.047.619
01/02/2017 23:00,28.97,50072,2383,35,58,1568,4,4048,365.047.619
02/02/2017 00:00,28.88,48000,2405,28,43,1426,4,3906,365.047.619
02/02/2017 01:00,28.56,46996,2369,29,44,1444,4,3890,365.047.619
02/02/2017 02:00,28.48,46558,2362,28,45,1438,4,3877,365.047.619
02/02/2017 03:00,28.5,46680,2375,29,47,1425,4,3880,365.047.619
02/02/2017 04:00,28.96,47604,2364,30,49,1426,5,3874,365.047.619
02/02/2017 05:00,29.76,49997,2319,33,50,1441,4,3847,365.047.619
02/02/2017 06:00,31.08,54305,2255,36,53,1438,4,3786,365.047.619
02/02/2017 07:00,32.68,58528,2179,38,56,1436,4,3713,365.047.619
02/02/2017 08:00,32.96,57782,2090,41,58,1407,5,3601,365.047.619
02/02/2017 09:00,32.77,57963,1992,42,53,1378,4,3469,365.047.619
02/02/2017 10:00,32.77,59033,1872,43,48,1361,5,3329,365.047.619
02/02/2017 11:00,32.43,58829,1736,42,45,1318,4,3145,365.047.619
02/02/2017 12:00,32.39,58386,1616,41,37,1271,5,2970,365.047.619
02/02/2017 13:00,32.54,58170,1549,41,36,1182,5,2813,365.047.619
02/02/2017 14:00,32.8,58100,1517,41,36,1146,4,2744,365.047.619
02/02/2017 15:00,32.56,58525,1488,41,40,1137,5,2711,365.047.619
02/02/2017 16:00,32.91,59412,1491,40,50,1146,3,2730,365.047.619
02/02/2017 17:00,33.59,60515,1563,38,54,1142,5,2802,365.047.619
02/02/2017 18:00,33.37,59881,1651,35,58,1195,4,2943,365.047.619
02/02/2017 19:00,32.46,58480,1700,34,60,1185,4,2983,365.047.619
02/02/2017 20:00,31.78,56568,1722,32,62,1151,4,2971,365.047.619
02/02/2017 21:00,31.34,54920,1741,30,56,1119,3,2949,365.047.619
02/02/2017 22:00,30.68,52661,1730,31,51,1084,3,2899,365.047.619
02/02/2017 23:00,29.96,50080,1709,30,47,1046,3,2835,365.047.619
03/02/2017 00:00,29.93,47810,1886,22,46,964,1,2919,365.047.619
03/02/2017 01:00,29.6,46852,1880,19,45,921,1,2866,365.047.619
03/02/2017 02:00,29.53,46357,1933,15,43,902,0,2893,365.047.619
03/02/2017 03:00,29.58,46449,2016,11,42,880,1,2950,365.047.619
03/02/2017 04:00,30.21,47270,2066,10,42,865,1,2984,365.047.619
03/02/2017 05:00,31.17,49647,2066,9,41,843,0,2959,365.047.619
03/02/2017 06:00,32.35,54181,2037,9,42,871,0,2959,365.047.619
03/02/2017 07:00,33.98,58731,1982,10,42,873,1,2908,365.047.619
03/02/2017 08:00,34.55,58200,1902,10,39,854,1,2806,365.047.619
03/02/2017 09:00,34.5,58408,1828,11,31,825,1,2696,365.047.619
03/02/2017 10:00,34.36,58720,1713,12,27,734,1,2487,365.047.619
03/02/2017 11:00,33.72,58509,1550,13,23,664,1,2251,365.047.619
03/02/2017 12:00,33.45,57956,1393,13,23,613,1,2043,365.047.619
03/02/2017 13:00,33.41,57489,1235,11,22,613,1,1882,365.047.619
03/02/2017 14:00,33.3,56995,1076,10,21,638,1,1746,365.047.619
03/02/2017 15:00,33.43,57032,931,11,23,666,1,1632,365.047.619
03/02/2017 16:00,33.78,57950,835,11,27,715,0,1588,365.047.619
03/02/2017 17:00,35.58,58962,793,11,31,758,1,1594,365.047.619
03/02/2017 18:00,34.55,58270,788,12,35,789,0,1624,365.047.619
03/02/2017 19:00,33.14,56666,778,13,40,795,1,1627,365.047.619
03/02/2017 20:00,31.9,54447,743,14,45,856,2,1660,365.047.619
03/02/2017 21:00,31.27,52791,714,14,44,847,2,1621,365.047.619
03/02/2017 22:00,30.95,50883,706,13,42,828,2,1591,365.047.619
03/02/2017 23:00,30.59,48691,716,12,43,836,3,1610,365.047.619
04/02/2017 00:00,30.64,46830,1532,5,28,803,1,2369,365.047.619
04/02/2017 01:00,30.08,45633,1577,4,30,832,1,2444,365.047.619
04/02/2017 02:00,29.84,45002,1597,3,34,867,1,2502,365.047.619
04/02/2017 03:00,29.68,44848,1596,3,32,902,1,2534,365.047.619
04/02/2017 04:00,29.91,45084,1558,3,29,947,1,2538,365.047.619
04/02/2017 05:00,30.12,45822,1529,3,29,998,1,2560,365.047.619
04/02/2017 06:00,30.58,47015,1541,3,32,1050,1,2627,365.047.619
04/02/2017 07:00,30.92,48588,1501,3,43,1090,2,2639,365.047.619
04/02/2017 08:00,31.36,50334,1377,3,43,1130,1,2554,365.047.619
04/02/2017 09:00,32.04,51539,1248,3,43,1135,2,2431,365.047.619
04/02/2017 10:00,32.38,52752,1092,3,44,1106,2,2247,365.047.619
04/02/2017 11:00,32.47,53074,922,3,41,1084,2,2052,365.047.619
04/02/2017 12:00,32.24,52904,791,3,40,1062,3,1899,365.047.619
04/02/2017 13:00,32.15,52658,662,3,39,1039,3,1746,365.047.619
04/02/2017 14:00,32.06,52531,530,4,40,1033,2,1609,365.047.619
04/02/2017 15:00,32.26,53060,422,4,45,1011,2,1484,365.047.619
04/02/2017 16:00,33.22,54750,375,5,52,1006,2,1440,365.047.619
04/02/2017 17:00,33.84,56367,386,6,55,1003,2,1452,365.047.619
04/02/2017 18:00,33.7,55861,431,6,62,1005,4,1508,365.047.619
04/02/2017 19:00,33.21,54208,474,6,72,996,4,1552,365.047.619
04/02/2017 20:00,32.11,52369,486,6,73,938,3,1506,365.047.619
04/02/2017 21:00,31.74,51174,511,6,68,940,3,1528,365.047.619
04/02/2017 22:00,31.3,49671,539,7,66,917,3,1532,365.047.619
04/02/2017 23:00,30.8,47999,546,8,68,909,3,1534,365.047.619
05/02/2017 00:00,30.87,46568,443,7,71,976,2,1499,365.047.619
05/02/2017 01:00,30.58,45496,452,7,67,974,2,1502,365.047.619
05/02/2017 02:00,30.33,44892,452,10,65,1005,2,1534,365.047.619
05/02/2017 03:00,30.06,44644,469,15,65,1032,2,1583,365.047.619
05/02/2017 04:00,30.1,44784,514,20,65,1081,2,1682,365.047.619
05/02/2017 05:00,30.3,45266,599,29,66,1155,3,1852,365.047.619
05/02/2017 06:00,30.67,46021,720,36,66,1222,2,2046,365.047.619
05/02/2017 07:00,31.13,47131,862,41,67,1260,3,2233,365.047.619
05/02/2017 08:00,31.17,48417,1007,45,69,1346,2,2469,365.047.619
05/02/2017 09:00,31.65,50086,1140,48,68,1422,3,2681,365.047.619
05/02/2017 10:00,31.92,51387,1239,53,68,1483,2,2845,365.047.619
05/02/2017 11:00,32.01,51930,1297,57,69,1545,2,2970,365.047.619
05/02/2017 12:00,31.91,51930,1371,62,70,1588,3,3094,365.047.619
05/02/2017 13:00,31.84,51748,1426,67,72,1641,4,3210,365.047.619
05/02/2017 14:00,31.73,51755,1448,74,74,1702,4,3302,365.047.619
05/02/2017 15:00,31.78,52295,1471,80,75,1736,4,3366,365.047.619
05/02/2017 16:00,32.36,53783,1508,84,80,1806,4,3482,365.047.619
05/02/2017 17:00,33.37,55368,1578,86,83,1889,3,3639,365.047.619
05/02/2017 18:00,33.29,55454,1673,87,87,1934,5,3786,365.047.619
05/02/2017 19:00,32.44,54553,1777,88,96,1962,5,3928,365.047.619
05/02/2017 20:00,31.8,53241,1899,83,111,1962,5,4060,365.047.619
05/02/2017 21:00,31.61,52143,1977,81,123,1880,8,4069,365.047.619
05/02/2017 22:00,31.17,50464,1958,83,128,1829,10,4008,365.047.619
05/02/2017 23:00,30.62,48564,1897,80,130,1778,10,3895,365.047.619
06/02/2017 00:00,30.36,47187,2010,95,118,1572,25,3820,3.406.488.095
06/02/2017 01:00,29.78,46362,2068,95,128,1547,26,3864,3.406.488.095
06/02/2017 02:00,29.52,46114,2143,95,137,1542,30,3947,3.406.488.095
06/02/2017 03:00,29.82,46413,2219,96,153,1535,34,4037,3.406.488.095
06/02/2017 04:00,30.73,47510,2306,97,160,1546,34,4143,3.406.488.095
06/02/2017 05:00,31.43,50180,2399,96,168,1563,34,4260,3.406.488.095
06/02/2017 06:00,32.88,54927,2469,96,177,1592,35,4369,3.406.488.095
06/02/2017 07:00,35.21,59370,2448,93,186,1568,37,4332,3.406.488.095
06/02/2017 08:00,37.2,59250,2357,87,195,1581,41,4261,3.406.488.095
06/02/2017 09:00,36.46,59521,2278,83,195,1597,42,4195,3.406.488.095
06/02/2017 10:00,35.2,59996,2251,81,196,1563,43,4134,3.406.488.095
06/02/2017 11:00,33.98,60027,2226,76,196,1575,41,4114,3.406.488.095
06/02/2017 12:00,33.88,59908,2190,74,195,1601,43,4103,3.406.488.095
06/02/2017 13:00,33.91,60011,2146,73,196,1616,47,4078,3.406.488.095
06/02/2017 14:00,34.2,59922,2125,76,197,1616,52,4066,3.406.488.095
06/02/2017 15:00,34.46,60256,2148,79,202,1662,53,4144,3.406.488.095
06/02/2017 16:00,34.98,61287,2215,81,210,1695,52,4253,3.406.488.095
06/02/2017 17:00,38.38,62658,2316,84,216,1748,56,4420,3.406.488.095
06/02/2017 18:00,36.55,62294,2390,83,225,1811,56,4565,3.406.488.095
06/02/2017 19:00,34,61149,2431,80,235,1833,56,4635,3.406.488.095
06/02/2017 20:00,33.17,59411,2479,75,240,1823,57,4674,3.406.488.095
06/02/2017 21:00,32.09,57890,2572,71,239,1767,55,4704,3.406.488.095
06/02/2017 22:00,31.61,55542,2654,66,235,1720,54,4729,3.406.488.095
06/02/2017 23:00,31.01,52961,2711,59,235,1683,50,4738,3.406.488.095
07/02/2017 00:00,31.07,50885,2493,72,230,1722,31,4548,3.406.488.095
07/02/2017 01:00,30.91,49981,2521,70,230,1686,32,4539,3.406.488.095
07/02/2017 02:00,30.81,49719,2560,66,230,1707,32,4595,3.406.488.095
07/02/2017 03:00,30.88,50073,2581,64,235,1737,33,4650,3.406.488.095
07/02/2017 04:00,31.34,51135,2634,63,240,1779,35,4751,3.406.488.095
07/02/2017 05:00,32.76,54207,2687,60,245,1858,35,4885,3.406.488.095
07/02/2017 06:00,33.75,58842,2686,61,250,1938,39,4974,3.406.488.095
07/02/2017 07:00,40.1,63191,2676,55,255,1984,35,5005,3.406.488.095
07/02/2017 08:00,42.44,62357,2691,50,260,2050,40,5091,3.406.488.095
07/02/2017 09:00,41.36,62285,2757,45,265,2131,42,5240,3.406.488.095
07/02/2017 10:00,39.94,62516,2854,40,265,2206,43,5408,3.406.488.095
07/02/2017 11:00,36.29,62398,2938,39,270,2235,43,5525,3.406.488.095
07/02/2017 12:00,34.65,62233,3012,38,270,2241,40,5601,3.406.488.095
07/02/2017 13:00,34.92,62287,3067,40,275,2251,42,5675,3.406.488.095
07/02/2017 14:00,35.47,62159,3112,43,275,2249,43,5722,3.406.488.095
07/02/2017 15:00,35.24,62524,3177,46,280,2243,44,5790,3.406.488.095
07/02/2017 16:00,37.35,63648,3235,51,290,2280,41,5897,3.406.488.095
07/02/2017 17:00,42.17,65060,3276,53,290,2368,41,6028,3.406.488.095
07/02/2017 18:00,40.74,64687,3283,53,295,2397,42,6070,3.406.488.095
07/02/2017 19:00,35.58,63540,3231,52,295,2404,40,6022,3.406.488.095
07/02/2017 20:00,33.8,61897,3163,51,295,2329,40,5878,3.406.488.095
07/02/2017 21:00,33.39,60051,3122,48,275,2315,39,5799,3.406.488.095
07/02/2017 22:00,32.89,57756,3067,45,265,2300,35,5712,3.406.488.095
07/02/2017 23:00,32,55051,2982,40,260,2270,33,5585,3.406.488.095
08/02/2017 00:00,31.61,53872,3030,37,290,2382,28,5767,3.406.488.095
08/02/2017 01:00,31.3,52987,2952,34,290,2362,24,5662,3.406.488.095
08/02/2017 02:00,31.19,52532,2883,32,280,2377,24,5596,3.406.488.095
08/02/2017 03:00,31.24,52667,2852,31,280,2383,23,5569,3.406.488.095
08/02/2017 04:00,31.84,53554,2814,32,275,2364,23,5508,3.406.488.095
08/02/2017 05:00,33.42,56319,2774,35,275,2350,22,5456,3.406.488.095
08/02/2017 06:00,34.25,60693,2754,38,270,2298,23,5383,3.406.488.095
08/02/2017 07:00,43.91,64853,2767,37,270,2295,23,5392,3.406.488.095
08/02/2017 08:00,47.02,64037,2791,34,270,2290,22,5407,3.406.488.095
08/02/2017 09:00,47.32,64067,2780,29,260,2300,22,5391,3.406.488.095
08/02/2017 10:00,46.43,65088,2734,25,255,2281,25,5320,3.406.488.095
08/02/2017 11:00,41.74,64584,2666,23,245,2223,26,5183,3.406.488.095
08/02/2017 12:00,37.92,63573,2605,23,235,2171,24,5058,3.406.488.095
08/02/2017 13:00,38.42,63157,2526,25,230,2127,25,4933,3.406.488.095
08/02/2017 14:00,39.5,62910,2464,29,220,2086,24,4823,3.406.488.095
08/02/2017 15:00,38.88,63061,2457,31,220,2043,23,4774,3.406.488.095
08/02/2017 16:00,41.8,63964,2431,34,220,2097,19,4801,3.406.488.095
08/02/2017 17:00,54.74,65222,2348,39,220,2066,19,4692,3.406.488.095
08/02/2017 18:00,52.56,64816,2263,42,220,2027,20,4572,3.406.488.095
08/02/2017 19:00,41.79,63574,2143,41,220,1978,17,4399,3.406.488.095
08/02/2017 20:00,37.71,61740,1978,37,210,1886,19,4130,3.406.488.095
08/02/2017 21:00,35.74,60350,1793,33,200,1791,17,3834,3.406.488.095
08/02/2017 22:00,33.81,58167,1613,30,180,1734,15,3572,3.406.488.095
08/02/2017 23:00,33.14,55692,1463,25,165,1660,13,3326,3.406.488.095
09/02/2017 00:00,32.49,53651,1311,14,156,1609,8,3098,3.406.488.095
09/02/2017 01:00,32.34,52754,1223,13,142,1544,8,2930,3.406.488.095
09/02/2017 02:00,32.25,52371,1152,11,121,1506,8,2798,3.406.488.095
09/02/2017 03:00,32.37,52554,1108,10,114,1492,7,2731,3.406.488.095
09/02/2017 04:00,33.22,53461,1079,8,110,1461,7,2665,3.406.488.095
09/02/2017 05:00,33.63,56166,1044,7,106,1435,6,2598,3.406.488.095
09/02/2017 06:00,37.88,60795,986,8,105,1408,7,2514,3.406.488.095
09/02/2017 07:00,50.14,64963,913,8,104,1359,8,2392,3.406.488.095
09/02/2017 08:00,61.05,63895,829,8,104,1292,9,2242,3.406.488.095
09/02/2017 09:00,61.08,63860,743,7,96,1218,7,2071,3.406.488.095
09/02/2017 10:00,58.09,64070,671,7,92,1101,7,1878,3.406.488.095
09/02/2017 11:00,49.19,63787,617,6,85,1050,6,1764,3.406.488.095
09/02/2017 12:00,49.13,63089,586,5,83,1037,6,1717,3.406.488.095
09/02/2017 13:00,50.12,62917,581,5,82,1025,6,1699,3.406.488.095
09/02/2017 14:00,48.31,62723,592,6,83,1064,7,1752,3.406.488.095
09/02/2017 15:00,47.07,62963,634,8,88,1135,8,1873,3.406.488.095
09/02/2017 16:00,50.1,63829,680,10,94,1201,8,1993,3.406.488.095
09/02/2017 17:00,58.96,65070,719,12,104,1233,10,2078,3.406.488.095
09/02/2017 18:00,57.07,64684,769,15,123,1261,10,2178,3.406.488.095
09/02/2017 19:00,41.9,63506,832,16,135,1242,10,2235,3.406.488.095
09/02/2017 20:00,37.22,61766,892,17,139,1212,10,2270,3.406.488.095
09/02/2017 21:00,34.91,60299,937,17,139,1137,9,2239,3.406.488.095
09/02/2017 22:00,33.53,57986,977,17,137,1120,7,2258,3.406.488.095
09/02/2017 23:00,32.63,55462,1009,17,134,1085,6,2251,3.406.488.095
10/02/2017 00:00,33.1,53231,919,13,109,1053,6,2100,3.406.488.095
10/02/2017 01:00,32.71,52229,993,14,101,1007,5,2120,3.406.488.095
10/02/2017 02:00,32.48,51759,1129,15,99,1038,5,2286,3.406.488.095
10/02/2017 03:00,32.36,51851,1228,16,100,1074,6,2424,3.406.488.095
10/02/2017 04:00,32.61,52620,1328,18,103,1116,7,2572,3.406.488.095
10/02/2017 05:00,33.61,55118,1486,18,107,1157,7,2775,3.406.488.095
10/02/2017 06:00,35.7,59574,1608,18,112,1208,7,2953,3.406.488.095
10/02/2017 07:00,45.65,63555,1680,17,139,1233,7,3076,3.406.488.095
10/02/2017 08:00,50.39,63594,1769,15,127,1270,7,3188,3.406.488.095
10/02/2017 09:00,47.04,63634,1852,13,97,1281,6,3249,3.406.488.095
10/02/2017 10:00,45.9,63319,1872,11,75,1309,6,3273,3.406.488.095
10/02/2017 11:00,39.58,62934,1851,10,68,1338,7,3274,3.406.488.095
10/02/2017 12:00,37.84,61931,1870,10,69,1356,7,3312,3.406.488.095
10/02/2017 13:00,36.7,61345,1956,10,70,1418,8,3462,3.406.488.095
10/02/2017 14:00,36.01,60790,2095,11,73,1477,8,3664,3.406.488.095
10/02/2017 15:00,35.78,60481,2260,13,82,1501,9,3865,3.406.488.095
10/02/2017 16:00,36.47,61210,2374,16,94,1605,7,4096,3.406.488.095
10/02/2017 17:00,38.38,62282,2426,19,103,1709,7,4264,3.406.488.095
10/02/2017 18:00,38.18,61909,2460,24,119,1780,6,4389,3.406.488.095
10/02/2017 19:00,34.45,60378,2450,24,120,1852,6,4452,3.406.488.095
10/02/2017 20:00,33.45,58272,2379,25,114,1877,7,4402,3.406.488.095
10/02/2017 21:00,33.19,56678,2294,25,103,1942,6,4370,3.406.488.095
10/02/2017 22:00,32.85,54755,2226,24,99,1959,5,4313,3.406.488.095
10/02/2017 23:00,32.11,52595,2173,21,99,1916,9,4218,3.406.488.095
11/02/2017 00:00,31.94,51686,2298,10,100,1992,8,4408,3.406.488.095
11/02/2017 01:00,31.59,50553,2359,8,90,1934,8,4399,3.406.488.095
11/02/2017 02:00,31.21,49954,2520,7,85,1942,6,4560,3.406.488.095
11/02/2017 03:00,31.06,49791,2666,6,80,1983,7,4742,3.406.488.095
11/02/2017 04:00,31.09,50045,2753,6,80,2018,6,4863,3.406.488.095
11/02/2017 05:00,31.54,50795,2820,7,80,1956,6,4869,3.406.488.095
11/02/2017 06:00,31.76,51920,2885,7,80,1888,5,4865,3.406.488.095
11/02/2017 07:00,31.91,53324,2928,6,80,1816,6,4836,3.406.488.095
11/02/2017 08:00,32.08,54173,2961,6,75,1819,5,4866,3.406.488.095
11/02/2017 09:00,32.61,55947,3030,5,65,1732,3,4835,3.406.488.095
11/02/2017 10:00,32.82,56935,3137,4,65,1673,3,4882,3.406.488.095
11/02/2017 11:00,32.49,56925,3247,3,65,1509,2,4826,3.406.488.095
11/02/2017 12:00,32.24,56533,3316,4,70,1342,4,4736,3.406.488.095
11/02/2017 13:00,32.04,56064,3338,4,70,1286,4,4702,3.406.488.095
11/02/2017 14:00,31.94,55640,3341,5,70,1336,3,4755,3.406.488.095
11/02/2017 15:00,32.04,55826,3330,6,75,1386,3,4800,3.406.488.095
11/02/2017 16:00,32.42,57315,3267,8,75,1459,3,4812,3.406.488.095
11/02/2017 17:00,33.5,59102,3169,10,80,1551,3,4813,3.406.488.095
11/02/2017 18:00,33.5,59015,3058,13,80,1630,4,4785,3.406.488.095
11/02/2017 19:00,32.9,57552,2967,15,80,1732,4,4798,3.406.488.095
11/02/2017 20:00,32.38,55845,2890,18,80,1762,3,4753,3.406.488.095
11/02/2017 21:00,32.33,54740,2819,20,80,1740,4,4663,3.406.488.095
11/02/2017 22:00,32.1,53323,2757,21,75,1710,4,4567,3.406.488.095
11/02/2017 23:00,31.77,51755,2692,23,75,1705,4,4499,3.406.488.095
12/02/2017 00:00,31.09,50254,2744,24,65,1727,3,4563,3.406.488.095
12/02/2017 01:00,30.65,49391,2745,24,60,1675,3,4507,3.406.488.095
12/02/2017 02:00,30.06,48916,2748,25,55,1665,2,4495,3.406.488.095
12/02/2017 03:00,30.03,48725,2744,26,50,1663,2,4485,3.406.488.095
12/02/2017 04:00,29.52,48925,2717,26,50,1666,2,4461,3.406.488.095
12/02/2017 05:00,29.55,49535,2682,25,45,1704,3,4459,3.406.488.095
12/02/2017 06:00,30.02,50361,2654,25,40,1721,2,4442,3.406.488.095
12/02/2017 07:00,30.48,51229,2625,25,35,1862,4,4551,3.406.488.095
12/02/2017 08:00,31.43,52434,2591,25,30,1952,2,4600,3.406.488.095
12/02/2017 09:00,32.08,54082,2531,27,25,1983,2,4568,3.406.488.095
12/02/2017 10:00,32.34,55132,2443,33,20,2009,2,4507,3.406.488.095
12/02/2017 11:00,32.31,55313,2342,41,15,2090,2,4490,3.406.488.095
12/02/2017 12:00,31.29,54803,2223,48,15,2187,3,4476,3.406.488.095
12/02/2017 13:00,30.69,54297,2103,54,10,2332,3,4502,3.406.488.095
12/02/2017 14:00,30.61,54074,1993,59,10,2468,2,4532,3.406.488.095
12/02/2017 15:00,30.94,54340,1906,63,10,2584,2,4565,3.406.488.095
12/02/2017 16:00,31.91,55796,1802,70,10,2645,2,4529,3.406.488.095
12/02/2017 17:00,33.3,57621,1667,81,10,2712,2,4472,3.406.488.095
12/02/2017 18:00,33.5,57933,1532,93,10,2703,3,4341,3.406.488.095
12/02/2017 19:00,33.21,57082,1363,105,10,2715,4,4197,3.406.488.095
12/02/2017 20:00,32.65,55744,1183,114,10,2765,3,4075,3.406.488.095
12/02/2017 21:00,32.09,54708,1019,122,10,2757,5,3913,3.406.488.095
12/02/2017 22:00,32.17,52994,872,133,10,2739,6,3760,3.406.488.095
12/02/2017 23:00,31.04,51084,744,139,10,2783,7,3683,3.406.488.095
13/02/2017 00:00,29.61,49578,688,154,10,2795,5,3652,3.204.285.714
13/02/2017 01:00,29.53,48786,580,166,15,2837,6,3604,3.204.285.714
13/02/2017 02:00,29.79,48524,494,176,15,2859,6,3550,3.204.285.714
13/02/2017 03:00,29.71,48749,434,185,20,2860,9,3508,3.204.285.714
13/02/2017 04:00,30.38,49746,406,190,25,2861,10,3492,3.204.285.714
13/02/2017 05:00,31.95,52249,394,189,30,2883,10,3506,3.204.285.714
13/02/2017 06:00,33.18,57200,383,189,35,2911,12,3530,3.204.285.714
13/02/2017 07:00,35.23,61263,387,185,40,2943,16,3571,3.204.285.714
13/02/2017 08:00,36.32,62183,406,182,50,2903,20,3561,3.204.285.714
13/02/2017 09:00,36.63,61072,422,173,60,2880,22,3557,3.204.285.714
13/02/2017 10:00,35.17,60932,420,163,70,2836,24,3513,3.204.285.714
13/02/2017 11:00,33.67,60272,393,153,80,2791,28,3445,3.204.285.714
13/02/2017 12:00,33.37,59489,360,142,95,2771,26,3394,3.204.285.714
13/02/2017 13:00,33.3,58998,320,138,95,2727,23,3303,3.204.285.714
13/02/2017 14:00,33.13,58594,288,139,95,2761,19,3302,3.204.285.714
13/02/2017 15:00,33.15,58595,259,140,100,2823,15,3337,3.204.285.714
13/02/2017 16:00,33.56,59319,228,144,110,2936,10,3428,3.204.285.714
13/02/2017 17:00,34.5,60683,220,148,120,3031,8,3527,3.204.285.714
13/02/2017 18:00,34.25,60691,233,153,145,3093,6,3630,3.204.285.714
13/02/2017 19:00,33.55,59464,242,160,155,3162,6,3725,3.204.285.714
13/02/2017 20:00,32.99,57864,243,166,160,3141,7,3717,3.204.285.714
13/02/2017 21:00,32.64,56435,246,172,165,3133,6,3722,3.204.285.714
13/02/2017 22:00,32.02,54147,237,182,170,3087,6,3682,3.204.285.714
13/02/2017 23:00,31.35,51577,225,184,170,3002,7,3588,3.204.285.714
14/02/2017 00:00,30.02,49309,311,187,181,3024,10,3713,3.204.285.714
14/02/2017 01:00,29.68,48317,280,185,186,2973,13,3637,3.204.285.714
14/02/2017 02:00,29.86,48111,238,184,187,2914,14,3537,3.204.285.714
14/02/2017 03:00,29.9,48344,207,180,186,2840,13,3426,3.204.285.714
14/02/2017 04:00,30.09,49295,201,174,180,2775,14,3344,3.204.285.714
14/02/2017 05:00,31.4,51788,220,166,174,2683,15,3258,3.204.285.714
14/02/2017 06:00,32.84,56042,234,156,168,2483,15,3056,3.204.285.714
14/02/2017 07:00,34.63,60015,244,140,157,2300,18,2859,3.204.285.714
14/02/2017 08:00,37.18,59245,265,123,150,2072,17,2627,3.204.285.714
14/02/2017 09:00,35.34,59310,294,109,135,1873,17,2428,3.204.285.714
14/02/2017 10:00,33.96,59390,327,94,114,1631,19,2185,3.204.285.714
14/02/2017 11:00,33.36,59044,361,79,97,1398,19,1954,3.204.285.714
14/02/2017 12:00,33.15,58684,393,66,93,1151,18,1721,3.204.285.714
14/02/2017 13:00,33.36,58065,408,58,86,1007,16,1575,3.204.285.714
14/02/2017 14:00,33.36,57599,392,53,78,867,14,1404,3.204.285.714
14/02/2017 15:00,33.37,57542,355,53,79,854,12,1353,3.204.285.714
14/02/2017 16:00,34.5,58356,340,52,84,872,11,1359,3.204.285.714
14/02/2017 17:00,38.73,59887,379,50,81,931,11,1452,3.204.285.714
14/02/2017 18:00,38.51,60027,456,47,73,921,10,1507,3.204.285.714
14/02/2017 19:00,35.71,59159,506,41,64,943,9,1563,3.204.285.714
14/02/2017 20:00,33.53,57627,535,36,62,907,9,1549,3.204.285.714
14/02/2017 21:00,33.38,56365,534,32,61,805,9,1441,3.204.285.714
14/02/2017 22:00,32.87,54259,500,27,50,633,8,1218,3.204.285.714
14/02/2017 23:00,31.96,51741,481,23,44,534,8,1090,3.204.285.714
15/02/2017 00:00,31.46,49714,464,15,32,419,6,936,3.204.285.714
15/02/2017 01:00,31.56,48704,422,14,27,338,5,806,3.204.285.714
15/02/2017 02:00,31.56,48458,371,14,24,297,5,711,3.204.285.714
15/02/2017 03:00,31.66,48681,326,12,20,304,4,666,3.204.285.714
15/02/2017 04:00,32.42,49670,295,11,17,318,4,645,3.204.285.714
15/02/2017 05:00,32.93,52128,269,8,13,366,3,659,3.204.285.714
15/02/2017 06:00,36.52,56335,256,7,11,499,3,776,3.204.285.714
15/02/2017 07:00,45.63,60137,246,5,9,700,3,963,3.204.285.714
15/02/2017 08:00,50.92,60827,238,5,8,924,3,1178,3.204.285.714
15/02/2017 09:00,46.43,58816,237,5,6,1078,3,1329,3.204.285.714
15/02/2017 10:00,41.61,58667,225,6,6,1162,3,1402,3.204.285.714
15/02/2017 11:00,34.75,58190,210,6,5,1090,3,1314,3.204.285.714
15/02/2017 12:00,33.61,57757,211,7,7,997,3,1225,3.204.285.714
15/02/2017 13:00,33.64,57199,222,10,7,881,3,1123,3.204.285.714
15/02/2017 14:00,34.34,56823,232,15,8,834,3,1092,3.204.285.714
15/02/2017 15:00,33.94,56699,236,23,10,925,4,1198,3.204.285.714
15/02/2017 16:00,35.03,57558,251,31,12,1130,5,1429,3.204.285.714
15/02/2017 17:00,37.56,59007,288,37,15,1403,5,1748,3.204.285.714
15/02/2017 18:00,39.72,59253,348,44,19,1523,5,1939,3.204.285.714
15/02/2017 19:00,34.08,57263,416,50,24,1691,5,2186,3.204.285.714
15/02/2017 20:00,33.14,55813,465,58,36,1801,6,2366,3.204.285.714
15/02/2017 21:00,32.95,54753,520,64,53,1754,7,2398,3.204.285.714
15/02/2017 22:00,31.97,52888,579,69,61,1611,9,2329,3.204.285.714
15/02/2017 23:00,31.01,50577,650,70,71,1483,9,2283,3.204.285.714
16/02/2017 00:00,30.18,48635,813,66,68,1426,13,2386,3.204.285.714
16/02/2017 01:00,29.99,47734,914,67,72,1318,14,2385,3.204.285.714
16/02/2017 02:00,29.96,47408,1029,70,75,1295,12,2481,3.204.285.714
16/02/2017 03:00,30.18,47604,1150,74,77,1306,11,2618,3.204.285.714
16/02/2017 04:00,30.3,48488,1272,74,80,1379,11,2816,3.204.285.714
16/02/2017 05:00,31.2,50830,1420,72,82,1405,12,2991,3.204.285.714
16/02/2017 06:00,31.76,54914,1642,70,83,1588,13,3396,3.204.285.714
16/02/2017 07:00,32.76,58715,1857,67,89,1565,15,3593,3.204.285.714
16/02/2017 08:00,32.94,58415,2051,64,89,1593,15,3812,3.204.285.714
16/02/2017 09:00,32.64,58344,2181,62,87,1643,16,3989,3.204.285.714
16/02/2017 10:00,32.42,58429,2280,61,83,1679,17,4120,3.204.285.714
16/02/2017 11:00,31.94,58150,2418,59,83,1794,17,4371,3.204.285.714
16/02/2017 12:00,31.79,57715,2526,58,85,1833,16,4518,3.204.285.714
16/02/2017 13:00,31.9,57280,2500,58,87,1912,12,4569,3.204.285.714
16/02/2017 14:00,31.94,56868,2349,59,89,2111,13,4621,3.204.285.714
16/02/2017 15:00,31.86,56630,2193,61,85,2255,14,4608,3.204.285.714
16/02/2017 16:00,32.07,57264,2046,64,85,2347,13,4555,3.204.285.714
16/02/2017 17:00,32.58,58575,1901,68,93,2457,15,4534,3.204.285.714
16/02/2017 18:00,32.6,58480,1811,73,98,2536,18,4536,3.204.285.714
16/02/2017 19:00,31.9,57209,1766,75,110,2615,20,4586,3.204.285.714
16/02/2017 20:00,31.36,55287,1696,75,151,2645,22,4589,3.204.285.714
16/02/2017 21:00,31.01,53429,1599,77,156,2734,26,4592,3.204.285.714
16/02/2017 22:00,30.75,51179,1454,79,161,2727,27,4448,3.204.285.714
16/02/2017 23:00,29.98,48612,1268,78,170,2746,23,4285,3.204.285.714
17/02/2017 00:00,29.56,46904,1372,55,201,2764,27,4419,3.204.285.714
17/02/2017 01:00,28.88,45907,1194,55,209,2671,31,4160,3.204.285.714
17/02/2017 02:00,28.81,45474,1008,55,212,2628,28,3931,3.204.285.714
17/02/2017 03:00,28.87,45626,842,58,211,2641,26,3778,3.204.285.714
17/02/2017 04:00,29.92,46454,708,60,206,2742,25,3741,3.204.285.714
17/02/2017 05:00,30.75,48671,604,65,202,2774,23,3668,3.204.285.714
17/02/2017 06:00,31.87,53101,542,65,185,2824,25,3641,3.204.285.714
17/02/2017 07:00,32.45,56982,501,63,182,2811,27,3584,3.204.285.714
17/02/2017 08:00,33.15,56725,506,57,163,2764,23,3513,3.204.285.714
17/02/2017 09:00,32.91,57160,550,54,151,2677,20,3452,3.204.285.714
17/02/2017 10:00,32.69,57611,590,54,147,2548,20,3359,3.204.285.714
17/02/2017 11:00,32.18,57436,608,56,144,2432,17,3257,3.204.285.714
17/02/2017 12:00,32.03,57021,612,60,140,2353,12,3177,3.204.285.714
17/02/2017 13:00,31.98,56192,636,65,133,2284,12,3130,3.204.285.714
17/02/2017 14:00,31.88,55591,671,69,110,2276,11,3137,3.204.285.714
17/02/2017 15:00,31.55,55212,695,74,100,2298,11,3178,3.204.285.714
17/02/2017 16:00,31.75,55801,723,79,94,2311,10,3217,3.204.285.714
17/02/2017 17:00,32.13,57153,752,85,89,2269,7,3202,3.204.285.714
17/02/2017 18:00,32.23,57243,789,91,86,2268,10,3244,3.204.285.714
17/02/2017 19:00,31.76,55862,784,95,80,2309,8,3276,3.204.285.714
17/02/2017 20:00,31.01,53903,725,96,86,2333,8,3248,3.204.285.714
17/02/2017 21:00,30.78,52471,657,97,81,2302,6,3143,3.204.285.714
17/02/2017 22:00,30.75,50478,602,95,76,2377,7,3157,3.204.285.714
17/02/2017 23:00,30.36,48432,575,92,74,2394,6,3141,3.204.285.714
18/02/2017 00:00,30.08,46796,736,84,71,2429,5,3325,3.204.285.714
18/02/2017 01:00,29.87,45784,728,85,70,2391,5,3279,3.204.285.714
18/02/2017 02:00,29.38,45325,692,88,68,2425,5,3278,3.204.285.714
18/02/2017 03:00,29.63,45301,668,91,68,2474,5,3306,3.204.285.714
18/02/2017 04:00,29.93,45663,638,91,68,2521,5,3323,3.204.285.714
18/02/2017 05:00,30.16,46392,617,90,66,2503,5,3281,3.204.285.714
18/02/2017 06:00,30.07,47399,605,90,60,2501,5,3261,3.204.285.714
18/02/2017 07:00,30.41,48631,609,93,58,2455,5,3220,3.204.285.714
18/02/2017 08:00,30.73,50450,636,97,55,2395,5,3188,3.204.285.714
18/02/2017 09:00,31,51409,700,100,49,2270,4,3123,3.204.285.714
18/02/2017 10:00,31.29,52262,804,104,46,2162,5,3121,3.204.285.714
18/02/2017 11:00,31.05,52053,944,111,39,2083,5,3182,3.204.285.714
18/02/2017 12:00,30.76,51585,1146,121,40,1978,5,3290,3.204.285.714
18/02/2017 13:00,30.56,51122,1363,129,46,1949,6,3493,3.204.285.714
18/02/2017 14:00,30.23,50898,1544,131,49,1985,9,3718,3.204.285.714
18/02/2017 15:00,30.08,51129,1784,132,54,2152,8,4130,3.204.285.714
18/02/2017 16:00,30.37,52491,2073,136,58,2351,8,4626,3.204.285.714
18/02/2017 17:00,30.94,54312,2394,138,67,2624,10,5233,3.204.285.714
18/02/2017 18:00,30.94,54610,2709,141,84,2912,12,5858,3.204.285.714
18/02/2017 19:00,30.66,53042,2970,146,95,3121,17,6349,3.204.285.714
18/02/2017 20:00,30.03,51174,3167,151,119,3272,18,6727,3.204.285.714
18/02/2017 21:00,29.64,49903,3334,157,152,3447,20,7110,3.204.285.714
18/02/2017 22:00,29.22,48361,3458,161,180,3640,22,7461,3.204.285.714
18/02/2017 23:00,28.15,46716,3538,162,204,3844,24,7772,3.204.285.714
19/02/2017 00:00,27.78,45194,3499,166,194,3787,33,7679,3.204.285.714
19/02/2017 01:00,26.44,44324,3442,173,218,3907,37,7777,3.204.285.714
19/02/2017 02:00,26.11,43808,3349,180,239,4011,42,7821,3.204.285.714
19/02/2017 03:00,25.7,43603,3222,187,253,4101,42,7805,3.204.285.714
19/02/2017 04:00,25.69,43756,3040,193,264,4099,42,7638,3.204.285.714
19/02/2017 05:00,25.6,44234,2799,199,279,4060,47,7384,3.204.285.714
19/02/2017 06:00,25.95,44797,2539,203,290,4004,51,7087,3.204.285.714
19/02/2017 07:00,26.07,45623,2313,207,303,3897,56,6776,3.204.285.714
19/02/2017 08:00,27.98,46978,2160,210,312,3747,55,6484,3.204.285.714
19/02/2017 09:00,29.91,47620,2061,213,319,3576,55,6224,3.204.285.714
19/02/2017 10:00,30.02,48668,1968,214,326,3401,56,5965,3.204.285.714
19/02/2017 11:00,30.6,48979,1886,214,330,3216,57,5703,3.204.285.714
19/02/2017 12:00,30.16,48873,1859,211,331,3095,55,5551,3.204.285.714
19/02/2017 13:00,30.42,48807,1882,205,330,2933,53,5403,3.204.285.714
19/02/2017 14:00,30.5,48939,1933,196,327,2941,47,5444,3.204.285.714
19/02/2017 15:00,30.34,49216,1980,188,326,3010,44,5548,3.204.285.714
19/02/2017 16:00,30.79,50437,2007,183,324,3108,43,5665,3.204.285.714
19/02/2017 17:00,31.49,52233,2016,182,323,3318,39,5878,3.204.285.714
19/02/2017 18:00,31.61,52766,2018,181,321,3466,37,6023,3.204.285.714
19/02/2017 19:00,31.25,51949,2110,182,317,3613,38,6260,3.204.285.714
19/02/2017 20:00,30.85,50663,2296,185,315,3600,35,6431,3.204.285.714
19/02/2017 21:00,30.56,49755,2484,187,310,3494,30,6505,3.204.285.714
19/02/2017 22:00,30.04,48111,2656,187,306,3387,37,6573,3.204.285.714
19/02/2017 23:00,28.87,46352,2838,182,302,3185,34,6541,3.204.285.714
20/02/2017 00:00,26.95,44651,2757,198,303,3018,35,6311,3.057.202.381
20/02/2017 01:00,26.3,43769,3006,184,302,2954,34,6480,3.057.202.381
20/02/2017 02:00,25.98,43532,3266,164,301,2896,35,6662,3.057.202.381
20/02/2017 03:00,26.1,43784,3515,141,310,2885,41,6892,3.057.202.381
20/02/2017 04:00,27.18,44776,3731,118,310,2886,42,7087,3.057.202.381
20/02/2017 05:00,29.03,47282,3899,100,320,2913,45,7277,3.057.202.381
20/02/2017 06:00,30.53,51506,4011,86,334,2970,46,7447,3.057.202.381
20/02/2017 07:00,31.18,55446,4046,84,348,3022,50,7550,3.057.202.381
20/02/2017 08:00,31.51,56406,4000,78,337,2930,53,7398,3.057.202.381
20/02/2017 09:00,31.42,55003,3950,79,355,2880,53,7317,3.057.202.381
20/02/2017 10:00,31.28,55025,3959,77,374,2872,55,7337,3.057.202.381
20/02/2017 11:00,30.95,54831,3997,73,380,2835,55,7340,3.057.202.381
20/02/2017 12:00,30.87,54658,4037,71,382,2748,53,7291,3.057.202.381
20/02/2017 13:00,30.91,54640,4097,71,384,2700,54,7306,3.057.202.381
20/02/2017 14:00,30.98,54382,4170,68,383,2643,50,7314,3.057.202.381
20/02/2017 15:00,30.88,54301,4250,62,386,2594,49,7341,3.057.202.381
20/02/2017 16:00,31.08,54914,4307,54,387,2585,44,7377,3.057.202.381
20/02/2017 17:00,31.5,56365,4313,48,386,2509,35,7291,3.057.202.381
20/02/2017 18:00,31.54,56623,4319,44,384,2502,33,7282,3.057.202.381
20/02/2017 19:00,30.98,55428,4333,42,381,2575,30,7361,3.057.202.381
20/02/2017 20:00,30.51,53759,4335,43,377,2603,25,7383,3.057.202.381
20/02/2017 21:00,30.03,52303,4320,45,374,2687,26,7452,3.057.202.381
20/02/2017 22:00,29.36,50057,3945,45,371,2839,28,7228,3.057.202.381
20/02/2017 23:00,27.66,47630,3957,43,369,2971,30,7370,3.057.202.381
21/02/2017 00:00,27.02,45445,4232,18,357,3101,34,7742,3.057.202.381
21/02/2017 01:00,26.22,44477,4314,22,346,3159,29,7870,3.057.202.381
21/02/2017 02:00,25.91,44308,4311,33,335,3208,24,7911,3.057.202.381
21/02/2017 03:00,25.5,44668,4309,56,340,3251,20,7976,3.057.202.381
21/02/2017 04:00,26.27,45554,4308,72,345,3306,17,8048,3.057.202.381
21/02/2017 05:00,28.37,48055,4300,76,349,3287,19,8031,3.057.202.381
21/02/2017 06:00,30.35,52350,4295,79,351,3184,21,7930,3.057.202.381
21/02/2017 07:00,31.49,56236,4279,80,352,3023,23,7757,3.057.202.381
21/02/2017 08:00,31.57,57201,4266,81,358,2866,22,7593,3.057.202.381
21/02/2017 09:00,31.48,55939,4279,82,363,2710,22,7456,3.057.202.381
21/02/2017 10:00,31.29,56005,4338,83,366,2460,27,7274,3.057.202.381
21/02/2017 11:00,30.94,55819,4401,82,370,2227,24,7104,3.057.202.381
21/02/2017 12:00,30.74,55641,4425,83,370,2036,24,6938,3.057.202.381
21/02/2017 13:00,30.82,55602,4401,84,366,1839,27,6717,3.057.202.381
21/02/2017 14:00,30.77,55294,4300,86,361,1668,24,6439,3.057.202.381
21/02/2017 15:00,30.91,55081,4075,90,357,1516,26,6064,3.057.202.381
21/02/2017 16:00,31.57,55761,3741,87,347,1409,25,5609,3.057.202.381
21/02/2017 17:00,32.33,57457,3332,84,332,1321,23,5092,3.057.202.381
21/02/2017 18:00,32.89,58123,2909,77,310,1287,25,4608,3.057.202.381
21/02/2017 19:00,32.19,57223,2568,65,282,1338,25,4278,3.057.202.381
21/02/2017 20:00,31.78,55775,2306,52,248,1398,24,4028,3.057.202.381
21/02/2017 21:00,31.48,54536,2163,40,208,1618,19,4048,3.057.202.381
21/02/2017 22:00,30.74,52414,2142,29,176,1747,11,4105,3.057.202.381
21/02/2017 23:00,29.85,49843,2288,20,152,1908,7,4375,3.057.202.381
22/02/2017 00:00,28.56,47699,3088,5,101,2207,2,5403,3.057.202.381
22/02/2017 01:00,26.86,46762,3549,3,80,2413,2,6047,3.057.202.381
22/02/2017 02:00,26.72,46415,3925,3,52,2693,2,6675,3.057.202.381
22/02/2017 03:00,26.66,46626,4211,8,25,2988,2,7234,3.057.202.381
22/02/2017 04:00,27.45,47463,4330,17,17,3302,4,7670,3.057.202.381
22/02/2017 05:00,28.44,49768,4411,30,10,3581,5,8037,3.057.202.381
22/02/2017 06:00,29.78,53682,4523,46,18,3795,9,8391,3.057.202.381
22/02/2017 07:00,30.79,57021,4505,65,59,3897,18,8544,3.057.202.381
22/02/2017 08:00,30.77,56448,4451,87,98,3893,26,8555,3.057.202.381
22/02/2017 09:00,30.63,56396,4428,109,150,3867,34,8588,3.057.202.381
22/02/2017 10:00,30.47,56253,4477,128,186,3890,41,8722,3.057.202.381
22/02/2017 11:00,30.17,56015,4579,144,244,3852,45,8864,3.057.202.381
22/02/2017 12:00,30.02,55577,4647,160,303,3878,50,9038,3.057.202.381
22/02/2017 13:00,29.96,55340,4674,176,336,3893,56,9135,3.057.202.381
22/02/2017 14:00,30.01,55096,4680,190,351,3799,59,9079,3.057.202.381
22/02/2017 15:00,29.9,55032,4685,202,356,3803,62,9108,3.057.202.381
22/02/2017 16:00,30.02,55609,4690,212,352,3786,54,9094,3.057.202.381
22/02/2017 17:00,30.49,57157,4694,214,346,3759,38,9051,3.057.202.381
22/02/2017 18:00,30.56,57538,4677,215,353,3751,24,9020,3.057.202.381
22/02/2017 19:00,30.16,56569,4665,206,363,3710,30,8974,3.057.202.381
22/02/2017 20:00,29.31,54940,4667,193,365,3560,39,8824,3.057.202.381
22/02/2017 21:00,28.7,53588,4663,180,365,3471,49,8728,3.057.202.381
22/02/2017 22:00,27.6,51399,4688,171,371,3374,53,8657,3.057.202.381
22/02/2017 23:00,26.38,48846,4715,157,378,3290,56,8596,3.057.202.381
23/02/2017 00:00,26.11,47178,4372,184,405,3423,58,8442,3.057.202.381
23/02/2017 01:00,25.07,46474,4276,176,410,3497,59,8418,3.057.202.381
23/02/2017 02:00,24.48,46207,4669,169,415,3668,58,8979,3.057.202.381
23/02/2017 03:00,25.11,46292,4555,160,415,3930,60,9120,3.057.202.381
23/02/2017 04:00,26.75,47132,4320,141,415,4097,55,9028,3.057.202.381
23/02/2017 05:00,27.73,49457,3815,122,415,4081,51,8484,3.057.202.381
23/02/2017 06:00,30.25,53677,3118,107,410,3955,49,7639,3.057.202.381
23/02/2017 07:00,31.11,57436,2474,102,405,3811,45,6837,3.057.202.381
23/02/2017 08:00,31.84,57109,1903,104,395,3523,33,5958,3.057.202.381
23/02/2017 09:00,32.06,57277,1353,114,385,3364,27,5243,3.057.202.381
23/02/2017 10:00,32.4,57507,889,124,370,3067,22,4472,3.057.202.381
23/02/2017 11:00,32.16,57368,566,135,355,2880,28,3964,3.057.202.381
23/02/2017 12:00,31.84,57162,371,148,355,2779,42,3695,3.057.202.381
23/02/2017 13:00,31.67,56823,293,163,340,2546,51,3393,3.057.202.381
23/02/2017 14:00,31.23,56590,358,169,300,2347,47,3221,3.057.202.381
23/02/2017 15:00,30.81,56525,550,181,275,2034,47,3087,3.057.202.381
23/02/2017 16:00,30.91,57034,823,181,230,1850,47,3131,3.057.202.381
23/02/2017 17:00,31.93,58793,1124,174,190,1742,42,3272,3.057.202.381
23/02/2017 18:00,32.64,59349,1421,165,145,1956,35,3722,3.057.202.381
23/02/2017 19:00,31.85,58291,1636,158,90,2173,26,4083,3.057.202.381
23/02/2017 20:00,30.47,56691,1796,145,70,2399,26,4436,3.057.202.381
23/02/2017 21:00,30.08,55366,2065,132,60,2627,24,4908,3.057.202.381
23/02/2017 22:00,29.31,53326,2261,115,55,2798,21,5250,3.057.202.381
23/02/2017 23:00,27.82,50963,2280,96,45,3030,11,5462,3.057.202.381
24/02/2017 00:00,28.26,49205,2803,85,55,3453,3,6399,3.057.202.381
24/02/2017 01:00,27.27,48480,2898,78,70,3582,3,6631,3.057.202.381
24/02/2017 02:00,27.07,48280,2562,72,90,3663,3,6390,3.057.202.381
24/02/2017 03:00,27.24,48541,2864,68,100,3681,4,6717,3.057.202.381
24/02/2017 04:00,28.06,49481,2733,62,110,3635,4,6544,3.057.202.381
24/02/2017 05:00,29.42,51825,2305,58,125,3547,5,6040,3.057.202.381
24/02/2017 06:00,30.73,55914,1828,58,150,3451,6,5493,3.057.202.381
24/02/2017 07:00,32.61,59829,1371,65,165,3382,13,4996,3.057.202.381
24/02/2017 08:00,33.34,59679,1088,73,185,3232,20,4598,3.057.202.381
24/02/2017 09:00,33.08,59667,1053,86,180,3191,29,4539,3.057.202.381
24/02/2017 10:00,32.76,59550,1199,97,180,3115,31,4622,3.057.202.381
24/02/2017 11:00,32.24,58859,1429,114,180,3141,32,4896,3.057.202.381
24/02/2017 12:00,31.57,58167,1725,134,190,3268,35,5352,3.057.202.381
24/02/2017 13:00,31.08,57069,1974,147,200,3368,42,5731,3.057.202.381
24/02/2017 14:00,30.86,56308,2068,154,230,3533,44,6029,3.057.202.381
24/02/2017 15:00,30.73,55845,2136,155,230,3640,44,6205,3.057.202.381
24/02/2017 16:00,30.95,56237,2161,154,230,3759,44,6348,3.057.202.381
24/02/2017 17:00,31.64,57985,2079,150,230,3708,41,6208,3.057.202.381
24/02/2017 18:00,32.27,58763,2028,146,230,3727,43,6174,3.057.202.381
24/02/2017 19:00,31.69,57387,1994,140,230,3742,42,6148,3.057.202.381
24/02/2017 20:00,31.13,55465,1910,136,230,3859,40,6175,3.057.202.381
24/02/2017 21:00,30.96,54097,1750,135,240,3818,36,5979,3.057.202.381
24/02/2017 22:00,30.84,52455,1547,136,245,3838,33,5799,3.057.202.381
24/02/2017 23:00,30.46,50711,1361,130,250,3795,34,5570,3.057.202.381
25/02/2017 00:00,30.08,48924,1369,117,270,3814,35,5605,3.057.202.381
25/02/2017 01:00,29.98,48164,1153,112,270,3735,34,5304,3.057.202.381
25/02/2017 02:00,29.88,47800,963,118,265,3645,37,5028,3.057.202.381
25/02/2017 03:00,29.95,47784,797,114,260,3575,33,4779,3.057.202.381
25/02/2017 04:00,30.06,48151,641,118,260,3499,32,4550,3.057.202.381
25/02/2017 05:00,30.1,48959,527,127,260,3398,33,4345,3.057.202.381
25/02/2017 06:00,30.7,49938,486,132,260,3337,25,4240,3.057.202.381
25/02/2017 07:00,30.72,51174,520,137,255,3233,24,4169,3.057.202.381
25/02/2017 08:00,31.04,52321,664,144,255,3108,29,4200,3.057.202.381
25/02/2017 09:00,31.32,54003,868,140,270,2805,34,4117,3.057.202.381
25/02/2017 10:00,31.19,54601,1125,139,295,2545,36,4140,3.057.202.381
25/02/2017 11:00,30.99,54314,1518,147,305,2325,33,4328,3.057.202.381
25/02/2017 12:00,30.07,53490,2058,151,305,2109,34,4657,3.057.202.381
25/02/2017 13:00,29.58,52926,2583,155,305,1986,35,5064,3.057.202.381
25/02/2017 14:00,29.51,52622,2966,160,305,1915,42,5388,3.057.202.381
25/02/2017 15:00,29.59,52625,3228,157,290,1902,41,5618,3.057.202.381
25/02/2017 16:00,30.06,53646,3446,152,260,1970,41,5869,3.057.202.381
25/02/2017 17:00,30.99,55658,3679,150,240,2085,35,6189,3.057.202.381
25/02/2017 18:00,31.02,56311,3882,143,205,2332,28,6590,3.057.202.381
25/02/2017 19:00,30.69,54915,3968,137,185,2562,19,6871,3.057.202.381
25/02/2017 20:00,29.89,53113,3959,131,165,2702,14,6971,3.057.202.381
25/02/2017 21:00,29.58,51867,3936,119,160,2745,15,6975,3.057.202.381
25/02/2017 22:00,29.33,50351,3856,111,145,2736,14,6862,3.057.202.381
25/02/2017 23:00,28.49,48900,3719,94,130,2645,10,6598,3.057.202.381
26/02/2017 00:00,28.54,47080,3796,96,187,2613,20,6712,3.057.202.381
26/02/2017 01:00,27.86,46203,3469,85,210,2464,20,6248,3.057.202.381
26/02/2017 02:00,27.31,45730,3058,81,241,2315,32,5727,3.057.202.381
26/02/2017 03:00,27.27,45554,2654,80,270,2179,40,5223,3.057.202.381
26/02/2017 04:00,27.39,45717,2313,83,294,2026,41,4757,3.057.202.381
26/02/2017 05:00,27.82,46203,2052,90,315,1869,44,4370,3.057.202.381
26/02/2017 06:00,28.41,46830,1851,94,328,1807,42,4122,3.057.202.381
26/02/2017 07:00,28.78,47607,1710,92,334,1715,37,3888,3.057.202.381
26/02/2017 08:00,29.13,48358,1613,82,339,1536,38,3608,3.057.202.381
26/02/2017 09:00,29.31,49895,1531,70,341,1416,33,3391,3.057.202.381
26/02/2017 10:00,29.75,50742,1493,55,341,1263,26,3178,3.057.202.381
26/02/2017 11:00,29.68,50951,1498,42,339,1128,25,3032,3.057.202.381
26/02/2017 12:00,29.49,50717,1532,33,339,1069,25,2998,3.057.202.381
26/02/2017 13:00,29.37,50539,1555,29,338,1012,23,2957,3.057.202.381
26/02/2017 14:00,29.22,50384,1587,25,336,939,23,2910,3.057.202.381
26/02/2017 15:00,29.09,50604,1655,24,326,879,21,2905,3.057.202.381
26/02/2017 16:00,29.46,51543,1806,24,315,852,21,3018,3.057.202.381
26/02/2017 17:00,30.51,53390,2049,25,299,851,21,3245,3.057.202.381
26/02/2017 18:00,31.53,54469,2353,27,285,891,18,3574,3.057.202.381
26/02/2017 19:00,30.87,53763,2515,29,266,943,20,3773,3.057.202.381
26/02/2017 20:00,30.14,52428,2498,29,244,963,17,3751,3.057.202.381
26/02/2017 21:00,29.88,51415,2474,29,230,1023,16,3772,3.057.202.381
26/02/2017 22:00,29.62,49676,2584,29,216,1090,14,3933,3.057.202.381
26/02/2017 23:00,28.67,47756,2780,26,202,1196,12,4216,3.057.202.381
27/02/2017 00:00,28.79,46596,3076,26,184,1359,7,4652,2.869.821.429
27/02/2017 01:00,28.13,45807,3194,22,165,1519,6,4906,2.869.821.429
27/02/2017 02:00,27.82,45593,3284,15,146,1700,5,5150,2.869.821.429
27/02/2017 03:00,27.89,45798,3344,9,115,1933,5,5406,2.869.821.429
27/02/2017 04:00,28.45,46706,3260,5,100,2139,5,5509,2.869.821.429
27/02/2017 05:00,30.34,49265,3059,3,95,2328,4,5489,2.869.821.429
27/02/2017 06:00,31.7,53257,2838,3,90,2520,4,5455,2.869.821.429
27/02/2017 07:00,32.59,57013,2582,3,95,2633,4,5317,2.869.821.429
27/02/2017 08:00,32.97,56918,2324,3,95,2734,4,5160,2.869.821.429
27/02/2017 09:00,32.85,56694,2138,6,100,2711,5,4960,2.869.821.429
27/02/2017 10:00,32.74,56527,2051,8,100,2783,6,4948,2.869.821.429
27/02/2017 11:00,31.93,56054,2022,15,100,2808,7,4952,2.869.821.429
27/02/2017 12:00,30.97,55598,2046,23,100,2815,10,4994,2.869.821.429
27/02/2017 13:00,30.76,55481,2083,32,105,2735,11,4966,2.869.821.429
27/02/2017 14:00,30.84,55196,2155,43,105,2582,11,4896,2.869.821.429
27/02/2017 15:00,31.03,54962,2301,56,100,2457,13,4927,2.869.821.429
27/02/2017 16:00,31.5,55280,2433,72,100,2379,13,4997,2.869.821.429
27/02/2017 17:00,32.36,56677,2512,87,100,2286,15,5000,2.869.821.429
27/02/2017 18:00,32.51,57127,2620,102,110,2272,17,5121,2.869.821.429
27/02/2017 19:00,31.57,56027,2761,111,125,2269,17,5283,2.869.821.429
27/02/2017 20:00,30.54,54085,2857,115,155,2259,16,5402,2.869.821.429
27/02/2017 21:00,29.52,52570,2914,117,175,2255,16,5477,2.869.821.429
27/02/2017 22:00,28.7,50333,2946,116,190,2157,18,5427,2.869.821.429
27/02/2017 23:00,27.58,47871,2956,112,210,2131,19,5428,2.869.821.429
28/02/2017 00:00,27.38,45509,3683,117,222,2177,18,6217,2.869.821.429
28/02/2017 01:00,26.41,44552,3769,120,236,2240,18,6383,2.869.821.429
28/02/2017 02:00,26.19,44212,3841,126,250,2333,20,6570,2.869.821.429
28/02/2017 03:00,25.76,44355,3899,131,257,2481,22,6790,2.869.821.429
28/02/2017 04:00,26.6,45186,3898,137,261,2561,24,6881,2.869.821.429
28/02/2017 05:00,27.8,47441,3862,145,272,2587,25,6891,2.869.821.429
28/02/2017 06:00,29.69,51550,3830,152,274,2622,28,6906,2.869.821.429
28/02/2017 07:00,30.91,55205,3823,157,274,2632,31,6917,2.869.821.429
28/02/2017 08:00,31.37,55270,3874,161,270,2619,33,6957,2.869.821.429
28/02/2017 09:00,31.17,55436,3947,163,243,2640,36,7029,2.869.821.429
28/02/2017 10:00,30.89,55288,4018,166,223,2530,35,6972,2.869.821.429
28/02/2017 11:00,30.5,54833,4073,165,204,2552,32,7026,2.869.821.429
28/02/2017 12:00,30.53,54426,4089,162,187,2565,30,7033,2.869.821.429
28/02/2017 13:00,30.63,54369,4050,160,172,2556,26,6964,2.869.821.429
28/02/2017 14:00,30.71,53992,3959,159,158,2557,26,6859,2.869.821.429
28/02/2017 15:00,30.8,53909,3846,160,183,2554,31,6774,2.869.821.429
28/02/2017 16:00,30.99,54344,3742,163,177,2523,31,6636,2.869.821.429
28/02/2017 17:00,32.41,56043,3651,165,167,2526,31,6540,2.869.821.429
28/02/2017 18:00,32.65,56844,3578,161,153,2622,31,6545,2.869.821.429
28/02/2017 19:00,31.93,55977,3591,158,136,2575,35,6495,2.869.821.429
28/02/2017 20:00,30.97,54040,3612,151,106,2470,36,6375,2.869.821.429
28/02/2017 21:00,30.79,52476,3617,139,102,2367,33,6258,2.869.821.429
28/02/2017 22:00,30.29,50199,3643,125,102,2285,31,6186,2.869.821.429
28/02/2017 23:00,29.55,47642,3665,105,102,2183,30,6085,2.869.821.429
01/03/2017 00:00,28.83,45590,3886,117,101,2328,21,6453,2.869.821.429
01/03/2017 01:00,28.64,44517,3792,107,89,2221,23,6232,2.869.821.429
01/03/2017 02:00,27.92,44203,3607,96,79,2228,23,6033,2.869.821.429
01/03/2017 03:00,27.81,44517,3439,91,83,2256,18,5887,2.869.821.429
01/03/2017 04:00,28.8,45388,3353,90,88,2316,15,5862,2.869.821.429
01/03/2017 05:00,29.86,47658,3327,89,94,2373,16,5899,2.869.821.429
01/03/2017 06:00,30.95,51673,3333,88,105,2386,21,5933,2.869.821.429
01/03/2017 07:00,32.09,55362,3389,83,112,2341,19,5944,2.869.821.429
01/03/2017 08:00,32.34,56217,3488,73,99,2192,13,5865,2.869.821.429
01/03/2017 09:00,32.29,55002,3587,59,82,2142,18,5888,2.869.821.429
01/03/2017 10:00,32.15,55004,3677,48,57,2080,23,5885,2.869.821.429
01/03/2017 11:00,31.89,54787,3776,38,54,2065,27,5960,2.869.821.429
01/03/2017 12:00,30.77,54516,3840,30,74,2183,24,6151,2.869.821.429
01/03/2017 13:00,30.4,54462,3769,26,103,2160,19,6077,2.869.821.429
01/03/2017 14:00,30.46,54323,3603,28,133,2122,17,5903,2.869.821.429
01/03/2017 15:00,30.9,54045,3365,34,151,2133,18,5701,2.869.821.429
01/03/2017 16:00,31.52,54204,3050,43,169,2063,19,5344,2.869.821.429
01/03/2017 17:00,32.3,55649,2658,48,192,2039,21,4958,2.869.821.429
01/03/2017 18:00,33.21,56527,2266,51,192,2026,24,4559,2.869.821.429
01/03/2017 19:00,32.39,55813,1990,54,197,1995,24,4260,2.869.821.429
01/03/2017 20:00,32.08,54402,1795,65,198,1935,26,4019,2.869.821.429
01/03/2017 21:00,31.52,52990,1636,79,199,1890,26,3830,2.869.821.429
01/03/2017 22:00,31.01,50763,1444,94,195,1801,25,3559,2.869.821.429
01/03/2017 23:00,29.93,48135,1213,102,193,1743,24,3275,2.869.821.429
02/03/2017 00:00,29.59,46114,1023,130,155,1757,30,3095,2.869.821.429
02/03/2017 01:00,29.18,45166,933,127,155,1704,27,2946,2.869.821.429
02/03/2017 02:00,27.58,44864,896,129,140,1651,30,2846,2.869.821.429
02/03/2017 03:00,27.6,45127,874,130,135,1595,31,2765,2.869.821.429
02/03/2017 04:00,28.58,46026,824,135,125,1519,28,2631,2.869.821.429
02/03/2017 05:00,29.83,48278,765,136,120,1437,26,2484,2.869.821.429
02/03/2017 06:00,31.15,52260,728,137,120,1344,24,2353,2.869.821.429
02/03/2017 07:00,32.82,56110,676,135,115,1245,19,2190,2.869.821.429
02/03/2017 08:00,33.53,55518,607,132,110,1121,17,1987,2.869.821.429
02/03/2017 09:00,32.31,55679,616,131,100,1007,21,1875,2.869.821.429
02/03/2017 10:00,32.14,55750,698,127,92,854,22,1793,2.869.821.429
02/03/2017 11:00,31.99,55440,851,119,90,770,20,1850,2.869.821.429
02/03/2017 12:00,31.65,54951,1126,109,95,712,21,2063,2.869.821.429
02/03/2017 13:00,31.3,54747,1462,93,120,674,16,2365,2.869.821.429
02/03/2017 14:00,30.83,54429,1827,75,135,667,12,2716,2.869.821.429
02/03/2017 15:00,30.74,54223,2151,63,160,687,14,3075,2.869.821.429
02/03/2017 16:00,30.71,54347,2338,54,180,730,20,3322,2.869.821.429
02/03/2017 17:00,31.99,55745,2439,51,170,817,24,3501,2.869.821.429
02/03/2017 18:00,33.17,56578,2587,47,155,960,26,3775,2.869.821.429
02/03/2017 19:00,32.09,55761,2829,39,140,1092,22,4122,2.869.821.429
02/03/2017 20:00,31.2,54107,3060,30,125,1256,20,4491,2.869.821.429
02/03/2017 21:00,30.47,52762,3226,23,140,1368,16,4773,2.869.821.429
02/03/2017 22:00,29.66,50641,3349,17,155,1506,18,5045,2.869.821.429
02/03/2017 23:00,29.03,48163,3437,12,175,1621,15,5260,2.869.821.429
03/03/2017 00:00,29.07,46338,3321,10,135,1627,4,5097,2.869.821.429
03/03/2017 01:00,28.78,45377,3311,9,130,1730,4,5184,2.869.821.429
03/03/2017 02:00,28.7,45098,3236,10,130,1797,5,5178,2.869.821.429
03/03/2017 03:00,29.08,45302,3154,11,100,1868,6,5139,2.869.821.429
03/03/2017 04:00,29.8,46115,3101,13,115,1914,8,5151,2.869.821.429
03/03/2017 05:00,30.68,48311,3080,18,140,1938,9,5185,2.869.821.429
03/03/2017 06:00,31.67,52295,3072,24,165,1950,9,5220,2.869.821.429
03/03/2017 07:00,32.58,56079,3016,28,185,1948,10,5187,2.869.821.429
03/03/2017 08:00,33.07,56228,2952,32,210,1927,15,5136,2.869.821.429
03/03/2017 09:00,32.88,56248,3024,34,250,1974,19,5301,2.869.821.429
03/03/2017 10:00,32.5,56095,3107,37,300,1972,31,5447,2.869.821.429
03/03/2017 11:00,32.17,55532,3165,44,335,2004,38,5586,2.869.821.429
03/03/2017 12:00,31.95,54861,3176,44,350,1939,38,5547,2.869.821.429
03/03/2017 13:00,31.68,54254,2979,39,360,1837,43,5258,2.869.821.429
03/03/2017 14:00,31.53,53529,2607,38,355,1748,48,4796,2.869.821.429
03/03/2017 15:00,31.38,52989,2195,39,350,1660,48,4292,2.869.821.429
03/03/2017 16:00,31.78,53281,1707,40,335,1510,47,3639,2.869.821.429
03/03/2017 17:00,32.93,54835,1183,44,335,1427,42,3031,2.869.821.429
03/03/2017 18:00,34.82,55708,801,47,330,1437,34,2649,2.869.821.429
03/03/2017 19:00,32.81,54562,606,48,310,1414,24,2402,2.869.821.429
03/03/2017 20:00,31.97,52687,495,44,280,1376,21,2216,2.869.821.429
03/03/2017 21:00,31.71,51262,417,40,255,1318,19,2049,2.869.821.429
03/03/2017 22:00,31.28,49486,364,39,235,1232,15,1885,2.869.821.429
03/03/2017 23:00,30.83,47598,321,42,215,1123,10,1711,2.869.821.429
04/03/2017 00:00,31.2,46136,438,45,169,904,18,1574,2.869.821.429
04/03/2017 01:00,30.15,45224,418,37,163,824,13,1455,2.869.821.429
04/03/2017 02:00,29.91,44747,482,30,154,793,10,1469,2.869.821.429
04/03/2017 03:00,28.82,44668,609,24,44,792,8,1477,2.869.821.429
04/03/2017 04:00,28.61,44958,721,20,70,807,8,1626,2.869.821.429
04/03/2017 05:00,29.65,45705,832,19,56,801,7,1715,2.869.821.429
04/03/2017 06:00,29.12,46622,993,17,76,832,7,1925,2.869.821.429
04/03/2017 07:00,30.01,48056,1128,14,63,848,6,2059,2.869.821.429
04/03/2017 08:00,30.88,49905,1250,12,53,830,6,2151,2.869.821.429
04/03/2017 09:00,31.29,51367,1375,10,22,798,6,2211,2.869.821.429
04/03/2017 10:00,31.41,51870,1461,9,22,768,6,2266,2.869.821.429
04/03/2017 11:00,30.99,51641,1571,8,16,802,5,2402,2.869.821.429
04/03/2017 12:00,30.78,50991,1713,7,14,855,5,2594,2.869.821.429
04/03/2017 13:00,30.54,50356,1778,7,13,1010,5,2813,2.869.821.429
04/03/2017 14:00,30.32,50031,1782,8,12,1204,5,3011,2.869.821.429
04/03/2017 15:00,30.2,50158,1788,8,14,1399,5,3214,2.869.821.429
04/03/2017 16:00,30.51,51031,1814,10,18,1649,5,3496,2.869.821.429
04/03/2017 17:00,31.03,53093,1879,11,25,1945,5,3865,2.869.821.429
04/03/2017 18:00,31.53,54123,2003,15,53,2242,6,4319,2.869.821.429
04/03/2017 19:00,30.94,53083,2121,21,62,2471,8,4683,2.869.821.429
04/03/2017 20:00,30.64,51474,2195,30,78,2632,9,4944,2.869.821.429
04/03/2017 21:00,30.41,50619,2257,40,85,2711,11,5104,2.869.821.429
04/03/2017 22:00,30.13,49386,2265,47,97,2780,12,5201,2.869.821.429
04/03/2017 23:00,29.08,48034,2288,63,104,2812,13,5280,2.869.821.429
05/03/2017 00:00,29.33,46748,2057,65,70,2806,20,5018,2.869.821.429
05/03/2017 01:00,28.58,46051,2100,65,86,2915,23,5189,2.869.821.429
05/03/2017 02:00,28.26,45672,2194,67,104,2997,27,5389,2.869.821.429
05/03/2017 03:00,27.96,45737,2339,68,130,3081,30,5648,2.869.821.429
05/03/2017 04:00,27.65,46024,2469,71,150,3143,34,5867,2.869.821.429
05/03/2017 05:00,27.85,46618,2581,71,170,3229,35,6086,2.869.821.429
05/03/2017 06:00,28.11,47220,2713,70,182,3297,37,6299,2.869.821.429
05/03/2017 07:00,28.45,48130,2704,69,185,3321,45,6324,2.869.821.429
05/03/2017 08:00,29.34,49548,2566,67,188,3285,49,6155,2.869.821.429
05/03/2017 09:00,30.06,50858,2492,67,179,3241,53,6032,2.869.821.429
05/03/2017 10:00,29.96,51519,2473,69,170,3183,53,5948,2.869.821.429
05/03/2017 11:00,29.93,51578,2382,74,168,3104,54,5782,2.869.821.429
05/03/2017 12:00,30.12,51284,2255,80,161,3023,55,5574,2.869.821.429
05/03/2017 13:00,29.73,50894,2087,85,152,2955,57,5336,2.869.821.429
05/03/2017 14:00,29.4,50768,1869,90,142,2883,54,5038,2.869.821.429
05/03/2017 15:00,29.42,51006,1707,92,105,2818,50,4772,2.869.821.429
05/03/2017 16:00,29.58,51875,1534,94,102,2767,48,4545,2.869.821.429
05/03/2017 17:00,30.65,53833,1396,98,107,2759,45,4405,2.869.821.429
05/03/2017 18:00,32.49,55223,1340,102,118,2780,43,4383,2.869.821.429
05/03/2017 19:00,33.02,54856,1322,105,107,2788,41,4363,2.869.821.429
05/03/2017 20:00,32.36,53669,1345,109,87,2741,40,4322,2.869.821.429
05/03/2017 21:00,31.57,52781,1420,111,86,2683,40,4340,2.869.821.429
05/03/2017 22:00,31.15,51285,1494,112,74,2614,35,4329,2.869.821.429
05/03/2017 23:00,30.54,49546,1552,115,67,2555,29,4318,2.869.821.429
06/03/2017 00:00,30.32,48307,1859,111,93,2629,52,4744,265.375
06/03/2017 01:00,29.61,47611,2054,114,89,2613,52,4922,265.375
06/03/2017 02:00,28.85,47458,2273,115,87,2614,50,5139,265.375
06/03/2017 03:00,28.08,47792,2515,114,90,2612,50,5381,265.375
06/03/2017 04:00,29.31,48719,2715,115,90,2621,50,5591,265.375
06/03/2017 05:00,30.68,51215,2861,119,103,2639,51,5773,265.375
06/03/2017 06:00,33.01,55315,2996,124,133,2638,53,5944,265.375
06/03/2017 07:00,38.3,59094,3136,130,154,2641,53,6114,265.375
06/03/2017 08:00,40.02,59460,3274,133,175,2647,55,6284,265.375
06/03/2017 09:00,38.84,59434,3394,139,194,2699,56,6482,265.375
06/03/2017 10:00,35.11,59383,3466,147,213,2730,56,6612,265.375
06/03/2017 11:00,33.83,59084,3500,156,230,2738,57,6681,265.375
06/03/2017 12:00,33.45,58853,3512,166,244,2824,58,6804,265.375
06/03/2017 13:00,33.02,58548,3517,174,264,2876,59,6890,265.375
06/03/2017 14:00,32.86,58176,3521,180,277,2885,59,6922,265.375
06/03/2017 15:00,32.64,57934,3517,184,285,2885,61,6932,265.375
06/03/2017 16:00,32.53,58156,3472,187,291,2879,60,6889,265.375
06/03/2017 17:00,34.21,59678,3374,195,300,2917,59,6845,265.375
06/03/2017 18:00,36.66,60691,3258,197,312,2947,62,6776,265.375
06/03/2017 19:00,33.38,59939,3151,200,323,2958,63,6695,265.375
06/03/2017 20:00,32.44,58326,3060,202,327,2957,64,6610,265.375
06/03/2017 21:00,32.15,57021,2971,203,320,2910,64,6468,265.375
06/03/2017 22:00,31.52,54943,2853,204,309,2846,64,6276,265.375
06/03/2017 23:00,30.97,52719,2703,190,293,2727,63,5976,265.375
07/03/2017 00:00,30.82,50556,2488,216,335,2750,54,5843,265.375
07/03/2017 01:00,30.08,49700,2329,216,281,2667,51,5544,265.375
07/03/2017 02:00,30,49487,2164,214,240,2584,50,5252,265.375
07/03/2017 03:00,30.08,49797,2011,212,206,2554,47,5030,265.375
07/03/2017 04:00,30.82,50719,1889,211,181,2488,47,4816,265.375
07/03/2017 05:00,32.25,53005,1774,208,158,2449,47,4636,265.375
07/03/2017 06:00,34.99,56930,1632,205,150,2432,46,4465,265.375
07/03/2017 07:00,43.76,60702,1475,201,131,2435,44,4286,265.375
07/03/2017 08:00,48.77,60642,1331,195,121,2354,41,4042,265.375
07/03/2017 09:00,48.78,60630,1202,189,113,2308,35,3847,265.375
07/03/2017 10:00,47.79,60528,1033,182,107,2209,31,3562,265.375
07/03/2017 11:00,47.35,60166,842,173,100,2137,25,3277,265.375
07/03/2017 12:00,44.61,59764,710,165,89,2056,22,3042,265.375
07/03/2017 13:00,43.33,59584,653,153,80,1968,17,2871,265.375
07/03/2017 14:00,41.66,59203,621,142,71,1929,15,2778,265.375
07/03/2017 15:00,39.17,58889,583,131,63,1990,14,2781,265.375
07/03/2017 16:00,38.29,59005,532,120,61,1959,12,2684,265.375
07/03/2017 17:00,47.2,60258,462,112,61,1980,12,2627,265.375
07/03/2017 18:00,49.49,61164,400,101,67,1976,13,2557,265.375
07/03/2017 19:00,44.6,60475,332,91,67,1890,16,2396,265.375
07/03/2017 20:00,37.1,58840,263,80,75,1778,17,2213,265.375
07/03/2017 21:00,35.43,57360,214,69,87,1705,18,2093,265.375
07/03/2017 22:00,33.98,55087,187,60,101,1562,18,1928,265.375
07/03/2017 23:00,32.54,52638,175,63,118,1494,22,1872,265.375
08/03/2017 00:00,32.2,50484,171,66,126,1463,24,1850,265.375
08/03/2017 01:00,31.51,49534,232,81,139,1390,28,1870,265.375
08/03/2017 02:00,31.05,49189,279,104,145,1350,28,1906,265.375
08/03/2017 03:00,30.89,49473,281,127,147,1313,35,1903,265.375
08/03/2017 04:00,30.81,50252,289,145,147,1211,34,1826,265.375
08/03/2017 05:00,31.72,52582,343,157,147,1123,31,1801,265.375
08/03/2017 06:00,34.27,56459,490,165,143,1079,26,1903,265.375
08/03/2017 07:00,39.15,59991,620,171,138,1025,28,1982,265.375
08/03/2017 08:00,40.91,60236,715,176,124,957,28,2000,265.375
08/03/2017 09:00,38.16,60148,890,181,104,905,31,2111,265.375
08/03/2017 10:00,34.6,60036,1149,184,102,836,30,2301,265.375
08/03/2017 11:00,33.55,59542,1450,182,104,790,30,2556,265.375
08/03/2017 12:00,32.84,59062,1733,180,103,808,32,2856,265.375
08/03/2017 13:00,32.59,58605,1982,171,94,857,31,3135,265.375
08/03/2017 14:00,32.54,58271,2145,156,80,856,31,3268,265.375
08/03/2017 15:00,32.3,57981,2300,140,69,907,30,3446,265.375
08/03/2017 16:00,32.18,57941,2413,131,62,1019,21,3646,265.375
08/03/2017 17:00,32.66,59165,2457,123,64,1180,16,3840,265.375
08/03/2017 18:00,33.07,60203,2460,115,68,1424,15,4082,265.375
08/03/2017 19:00,32.78,59525,2257,110,69,1668,10,4114,265.375
08/03/2017 20:00,32.4,57672,2005,105,74,1941,9,4134,265.375
08/03/2017 21:00,31.35,55843,1966,97,87,2061,11,4222,265.375
08/03/2017 22:00,31.06,53277,1837,90,97,2066,11,4101,265.375
08/03/2017 23:00,30.1,50613,1589,75,104,2038,10,3816,265.375
09/03/2017 00:00,29.92,48493,1353,86,100,2232,12,3783,265.375
09/03/2017 01:00,29.71,47482,1360,84,100,2206,12,3762,265.375
09/03/2017 02:00,29.53,47001,1373,80,100,2126,11,3690,265.375
09/03/2017 03:00,29.45,47057,1389,78,125,2127,15,3734,265.375
09/03/2017 04:00,29.6,47727,1385,79,125,2096,19,3704,265.375
09/03/2017 05:00,30.9,49792,1294,81,125,2106,20,3626,265.375
09/03/2017 06:00,32.64,53526,1197,86,100,2158,23,3564,265.375
09/03/2017 07:00,33.59,57155,1151,88,90,2104,24,3457,265.375
09/03/2017 08:00,35.22,57421,1118,94,80,1921,23,3236,265.375
09/03/2017 09:00,34.14,57225,1080,99,70,1733,22,3004,265.375
09/03/2017 10:00,33.93,57096,1106,100,80,1677,21,2984,265.375
09/03/2017 11:00,33.36,56760,1145,100,75,1644,20,2984,265.375
09/03/2017 12:00,32.98,56219,1168,97,65,1530,18,2878,265.375
09/03/2017 13:00,32.8,55979,1084,94,55,1507,15,2755,265.375
09/03/2017 14:00,32.57,55424,940,91,35,1453,12,2531,265.375
09/03/2017 15:00,32.57,55558,840,88,35,1387,9,2359,265.375
09/03/2017 16:00,32.63,55465,740,84,30,1326,6,2186,265.375
09/03/2017 17:00,33.05,56729,689,82,25,1324,6,2126,265.375
09/03/2017 18:00,33.63,57744,763,81,25,1288,6,2163,265.375
09/03/2017 19:00,32.74,56844,896,75,25,1275,6,2277,265.375
09/03/2017 20:00,32.02,55121,1144,67,25,1213,6,2455,265.375
09/03/2017 21:00,31.96,53182,1538,57,25,1145,5,2770,265.375
09/03/2017 22:00,30.93,50658,1925,49,25,1104,5,3108,265.375
09/03/2017 23:00,29.72,48172,2284,33,25,1091,5,3438,265.375
10/03/2017 00:00,28.92,46520,2111,15,18,965,5,3114,265.375
10/03/2017 01:00,28.65,45481,2389,10,18,1012,5,3434,265.375
10/03/2017 02:00,28.43,45157,2598,7,18,1071,5,3699,265.375
10/03/2017 03:00,28.47,45289,2771,6,19,1181,5,3982,265.375
10/03/2017 04:00,29.06,46146,2794,5,20,1331,5,4155,265.375
10/03/2017 05:00,30.12,48373,2695,4,22,1472,5,4198,265.375
10/03/2017 06:00,31.79,52243,2613,4,24,1627,5,4273,265.375
10/03/2017 07:00,32.49,55962,2577,3,25,1780,5,4390,265.375
10/03/2017 08:00,33.22,55849,2600,3,25,1799,5,4432,265.375
10/03/2017 09:00,32.53,55868,2629,2,24,1779,6,4440,265.375
10/03/2017 10:00,32.42,55668,2537,2,25,1784,7,4355,265.375
10/03/2017 11:00,32.07,55227,2354,3,25,1815,8,4205,265.375
10/03/2017 12:00,31.41,54538,2168,5,31,1773,6,3983,265.375
10/03/2017 13:00,31.22,53907,1942,7,25,1749,6,3729,265.375
10/03/2017 14:00,31.19,53083,1717,9,27,1700,7,3460,265.375
10/03/2017 15:00,31.45,52530,1498,10,24,1716,9,3257,265.375
10/03/2017 16:00,31.94,52523,1259,11,30,1766,7,3073,265.375
10/03/2017 17:00,32.78,53818,976,14,28,1812,7,2837,265.375
10/03/2017 18:00,34.25,54990,706,16,28,1912,6,2668,265.375
10/03/2017 19:00,32.81,54245,556,17,29,2002,7,2611,265.375
10/03/2017 20:00,32.28,52390,500,20,31,2039,8,2598,265.375
10/03/2017 21:00,32.03,51171,476,20,28,2001,8,2533,265.375
10/03/2017 22:00,31.88,49658,432,21,28,1958,8,2447,265.375
10/03/2017 23:00,31.56,47886,365,17,27,1976,9,2394,265.375
11/03/2017 00:00,30.8,46131,325,14,27,2040,6,2412,265.375
11/03/2017 01:00,29.98,45137,267,13,26,2026,7,2339,265.375
11/03/2017 02:00,29.58,44846,223,12,24,2009,7,2275,265.375
11/03/2017 03:00,29.19,44948,186,12,23,1976,7,2204,265.375
11/03/2017 04:00,28.93,45338,156,11,21,1954,7,2149,265.375
11/03/2017 05:00,29.52,46077,143,12,20,1899,8,2082,265.375
11/03/2017 06:00,30.65,46833,144,12,18,1821,11,2006,265.375
11/03/2017 07:00,31.02,48089,158,12,16,1696,11,1893,265.375
11/03/2017 08:00,31.37,49314,192,11,16,1434,11,1664,265.375
11/03/2017 09:00,31.85,50531,249,11,18,1195,12,1485,265.375
11/03/2017 10:00,31.73,50859,289,11,21,957,11,1289,265.375
11/03/2017 11:00,31.21,50389,313,10,26,760,10,1119,265.375
11/03/2017 12:00,30.77,49461,360,9,30,626,9,1034,265.375
11/03/2017 13:00,29.82,48634,419,10,37,585,9,1060,265.375
11/03/2017 14:00,29.45,48147,442,11,39,645,9,1146,265.375
11/03/2017 15:00,29.64,48113,438,13,43,611,9,1114,265.375
11/03/2017 16:00,30.36,48884,432,13,50,654,8,1157,265.375
11/03/2017 17:00,31.93,50965,455,13,52,848,7,1375,265.375
11/03/2017 18:00,32.78,52641,547,13,58,1066,6,1690,265.375
11/03/2017 19:00,32.26,52045,659,11,62,1301,7,2040,265.375
11/03/2017 20:00,31.29,50574,767,10,62,1471,6,2316,265.375
11/03/2017 21:00,31.01,49591,886,9,62,1633,6,2596,265.375
11/03/2017 22:00,30.75,48381,944,8,63,1787,5,2807,265.375
11/03/2017 23:00,29.66,46911,941,9,62,1924,5,2941,265.375
12/03/2017 00:00,28.85,45172,1084,10,59,2051,6,3210,265.375
12/03/2017 01:00,27.41,44483,1053,9,57,2084,6,3209,265.375
12/03/2017 02:00,26.75,44127,1047,8,56,1948,6,3065,265.375
12/03/2017 03:00,26.48,44020,1078,7,52,1901,6,3044,265.375
12/03/2017 04:00,26.84,44316,1103,6,49,1892,6,3056,265.375
12/03/2017 05:00,27.63,44809,1146,6,43,1860,5,3060,265.375
12/03/2017 06:00,27.83,45282,1219,6,37,1819,6,3087,265.375
12/03/2017 07:00,28.07,46114,1301,6,31,1768,5,3111,265.375
12/03/2017 08:00,28.82,47395,1420,6,27,1675,5,3133,265.375
12/03/2017 09:00,29.08,47848,1580,6,24,1599,5,3214,265.375
12/03/2017 10:00,29.26,48340,1710,7,21,1572,6,3316,265.375
12/03/2017 11:00,28.93,48210,1740,8,20,1556,6,3330,265.375
12/03/2017 12:00,28.9,47785,1741,9,21,1489,6,3266,265.375
12/03/2017 13:00,28.47,47343,1674,10,23,1361,6,3074,265.375
12/03/2017 14:00,28.41,47067,1548,11,24,1306,5,2894,265.375
12/03/2017 15:00,28.38,47124,1497,11,24,1351,5,2888,265.375
12/03/2017 16:00,28.75,47927,1503,12,25,1338,5,2883,265.375
12/03/2017 17:00,29.31,49715,1536,15,26,1337,6,2920,265.375
12/03/2017 18:00,30.84,51382,1572,20,30,1387,5,3014,265.375
12/03/2017 19:00,31.12,51360,1592,25,35,1469,6,3127,265.375
12/03/2017 20:00,30.35,50276,1553,29,36,1507,5,3130,265.375
12/03/2017 21:00,30.28,49411,1484,33,45,1505,5,3072,265.375
12/03/2017 22:00,30.05,47903,1399,35,45,1431,5,2915,265.375
12/03/2017 23:00,29.13,46182,1272,50,45,1332,5,2704,265.375
13/03/2017 00:00,27.9,44876,1076,54,21,1268,4,2423,2.514.880.952
13/03/2017 01:00,27.29,44212,952,54,22,1205,4,2237,2.514.880.952
13/03/2017 02:00,27.26,43976,869,52,22,1183,4,2130,2.514.880.952
13/03/2017 03:00,27.97,44265,817,51,22,1243,4,2137,2.514.880.952
13/03/2017 04:00,28.85,45151,790,51,22,1310,4,2177,2.514.880.952
13/03/2017 05:00,30.32,47466,774,50,22,1410,4,2260,2.514.880.952
13/03/2017 06:00,31.87,51324,741,46,21,1530,4,2342,2.514.880.952
13/03/2017 07:00,34.92,55033,685,40,19,1621,4,2369,2.514.880.952
13/03/2017 08:00,38.38,54723,668,35,13,1607,4,2327,2.514.880.952
13/03/2017 09:00,34.7,54461,682,31,7,1591,5,2316,2.514.880.952
13/03/2017 10:00,33.1,54135,676,29,4,1674,5,2388,2.514.880.952
13/03/2017 11:00,32.12,53597,697,30,4,1721,5,2457,2.514.880.952
13/03/2017 12:00,31.81,53143,749,31,4,1767,4,2555,2.514.880.952
13/03/2017 13:00,31.79,52911,761,32,6,1890,4,2693,2.514.880.952
13/03/2017 14:00,31.52,52570,742,32,7,1962,4,2747,2.514.880.952
13/03/2017 15:00,31.59,52354,697,34,7,1969,5,2712,2.514.880.952
13/03/2017 16:00,31.76,52453,660,37,8,2099,4,2808,2.514.880.952
13/03/2017 17:00,32.08,53727,646,42,10,2149,5,2852,2.514.880.952
13/03/2017 18:00,33.45,54878,621,46,11,2230,5,2913,2.514.880.952
13/03/2017 19:00,32.25,54578,596,50,12,2320,6,2984,2.514.880.952
13/03/2017 20:00,31.48,53003,604,54,14,2369,6,3047,2.514.880.952
13/03/2017 21:00,31.16,51597,643,58,15,2389,6,3111,2.514.880.952
13/03/2017 22:00,30.49,49446,678,61,14,2358,6,3117,2.514.880.952
13/03/2017 23:00,29.94,47056,688,77,13,2368,6,3152,2.514.880.952
14/03/2017 00:00,29.12,44944,604,52,7,2213,8,2884,2.514.880.952
14/03/2017 01:00,28.37,44043,681,55,8,2178,8,2930,2.514.880.952
14/03/2017 02:00,27.75,43800,811,58,10,2161,10,3050,2.514.880.952
14/03/2017 03:00,27.86,44017,919,65,12,2221,10,3227,2.514.880.952
14/03/2017 04:00,28.47,44864,950,67,15,2279,11,3322,2.514.880.952
14/03/2017 05:00,29.13,47042,963,71,18,2311,11,3374,2.514.880.952
14/03/2017 06:00,31.29,50653,1059,75,22,2358,10,3524,2.514.880.952
14/03/2017 07:00,32.19,54201,1227,78,27,2491,11,3834,2.514.880.952
14/03/2017 08:00,32.51,53924,1494,83,35,2575,11,4198,2.514.880.952
14/03/2017 09:00,31.82,53778,1826,91,43,2698,15,4673,2.514.880.952
14/03/2017 10:00,31.42,53621,2130,98,52,2951,20,5251,2.514.880.952
14/03/2017 11:00,31.02,53365,2401,109,60,3337,23,5930,2.514.880.952
14/03/2017 12:00,30.01,53032,2678,123,63,3681,28,6573,2.514.880.952
14/03/2017 13:00,29.51,52942,2912,135,77,3975,34,7133,2.514.880.952
14/03/2017 14:00,29.1,52587,3070,146,90,4214,39,7559,2.514.880.952
14/03/2017 15:00,29.02,52221,3183,158,96,4324,44,7805,2.514.880.952
14/03/2017 16:00,29.35,52199,3249,171,104,4402,42,7968,2.514.880.952
14/03/2017 17:00,29.7,53318,3274,187,112,4369,42,7984,2.514.880.952
14/03/2017 18:00,30.21,54397,3290,203,128,4313,41,7975,2.514.880.952
14/03/2017 19:00,29.94,53969,3367,216,155,4404,43,8185,2.514.880.952
14/03/2017 20:00,29.19,52330,3508,221,177,4547,46,8499,2.514.880.952
14/03/2017 21:00,28.3,50898,3637,226,201,4628,46,8738,2.514.880.952
14/03/2017 22:00,27.52,48639,3737,227,226,4729,46,8965,2.514.880.952
14/03/2017 23:00,25.2,46015,3856,212,253,4785,48,9154,2.514.880.952
15/03/2017 00:00,24.22,43954,4103,222,312,5014,52,9703,2.514.880.952
15/03/2017 01:00,23.51,43014,3738,209,336,5141,50,9474,2.514.880.952
15/03/2017 02:00,23.32,42680,3679,193,349,5212,44,9477,2.514.880.952
15/03/2017 03:00,23.76,42971,3939,179,354,5285,46,9803,2.514.880.952
15/03/2017 04:00,25.12,43842,3964,170,354,5371,47,9906,2.514.880.952
15/03/2017 05:00,27.5,46018,3863,161,355,5388,49,9816,2.514.880.952
15/03/2017 06:00,29.56,49808,3767,150,357,5392,53,9719,2.514.880.952
15/03/2017 07:00,30.54,53702,3754,143,359,5307,57,9620,2.514.880.952
15/03/2017 08:00,30.86,53344,3837,134,367,5244,58,9640,2.514.880.952
15/03/2017 09:00,30.4,53007,3953,133,378,5202,57,9723,2.514.880.952
15/03/2017 10:00,30.1,52661,4025,133,376,5233,57,9824,2.514.880.952
15/03/2017 11:00,29.77,52178,4034,132,375,5270,58,9869,2.514.880.952
15/03/2017 12:00,29.49,51581,3999,129,375,5289,57,9849,2.514.880.952
15/03/2017 13:00,29.22,51435,3907,125,368,5282,56,9738,2.514.880.952
15/03/2017 14:00,29.14,51101,3795,121,364,5305,56,9641,2.514.880.952
15/03/2017 15:00,29.02,50798,3671,119,364,5308,54,9516,2.514.880.952
15/03/2017 16:00,29.43,50738,3492,121,354,5309,47,9323,2.514.880.952
15/03/2017 17:00,30.15,51949,3238,124,334,5271,37,9004,2.514.880.952
15/03/2017 18:00,30.73,53372,3004,127,330,5207,31,8699,2.514.880.952
15/03/2017 19:00,30.57,53428,2886,129,321,5195,30,8561,2.514.880.952
15/03/2017 20:00,30.36,52108,2807,128,311,5168,31,8445,2.514.880.952
15/03/2017 21:00,30.09,50814,2681,124,299,5153,32,8289,2.514.880.952
15/03/2017 22:00,29.26,48650,2559,122,292,5092,34,8099,2.514.880.952
15/03/2017 23:00,28.56,46148,2454,125,284,5067,35,7965,2.514.880.952
16/03/2017 00:00,27.66,44216,2311,109,299,5097,30,7846,2.514.880.952
16/03/2017 01:00,27.36,43352,2154,112,305,4965,37,7573,2.514.880.952
16/03/2017 02:00,27.37,43265,1977,115,302,4770,38,7202,2.514.880.952
16/03/2017 03:00,27.41,43662,1800,117,288,4554,36,6795,2.514.880.952
16/03/2017 04:00,28.39,44637,1626,116,275,4244,30,6291,2.514.880.952
16/03/2017 05:00,29.15,46905,1433,117,262,3853,30,5695,2.514.880.952
16/03/2017 06:00,30.54,50743,1249,116,243,3456,28,5092,2.514.880.952
16/03/2017 07:00,31.94,54382,1092,111,222,2966,29,4420,2.514.880.952
16/03/2017 08:00,34.32,53772,992,108,196,2376,33,3705,2.514.880.952
16/03/2017 09:00,33.74,53423,920,106,178,1886,30,3120,2.514.880.952
16/03/2017 10:00,32.22,53062,932,99,161,1593,22,2807,2.514.880.952
16/03/2017 11:00,31.39,52554,1096,86,144,1484,18,2828,2.514.880.952
16/03/2017 12:00,30.65,51920,1395,73,119,1552,13,3152,2.514.880.952
16/03/2017 13:00,30.1,51646,1808,63,102,1838,10,3821,2.514.880.952
16/03/2017 14:00,29.9,51205,2255,60,91,2324,9,4739,2.514.880.952
16/03/2017 15:00,29.95,50987,2637,57,84,2694,8,5480,2.514.880.952
16/03/2017 16:00,30.2,50968,2849,56,84,3122,6,6117,2.514.880.952
16/03/2017 17:00,30.54,52196,2929,50,80,3518,5,6582,2.514.880.952
16/03/2017 18:00,30.63,53485,2995,48,76,3849,5,6973,2.514.880.952
16/03/2017 19:00,30.24,53369,3072,55,73,4211,7,7418,2.514.880.952
16/03/2017 20:00,29.62,51933,3146,67,70,4525,8,7816,2.514.880.952
16/03/2017 21:00,29.09,50541,3246,82,70,4661,9,8068,2.514.880.952
16/03/2017 22:00,28.54,48204,3303,101,70,4747,12,8233,2.514.880.952
16/03/2017 23:00,27.86,45555,3291,118,74,4765,15,8263,2.514.880.952
17/03/2017 00:00,26.85,43271,3419,159,84,4729,23,8414,2.514.880.952
17/03/2017 01:00,25.02,42249,3212,179,142,4610,28,8171,2.514.880.952
17/03/2017 02:00,24.9,42037,3044,196,169,4350,37,7796,2.514.880.952
17/03/2017 03:00,25.14,42306,3041,209,203,4107,45,7605,2.514.880.952
17/03/2017 04:00,26.17,43199,3121,220,238,3906,50,7535,2.514.880.952
17/03/2017 05:00,27.74,45453,3212,228,268,3802,53,7563,2.514.880.952
17/03/2017 06:00,29.19,49269,3269,231,302,3766,53,7621,2.514.880.952
17/03/2017 07:00,30.35,53137,3412,234,321,3741,54,7762,2.514.880.952
17/03/2017 08:00,30.41,53027,3678,230,341,3667,55,7971,2.514.880.952
17/03/2017 09:00,29.96,53021,3930,228,350,3641,57,8206,2.514.880.952
17/03/2017 10:00,29.67,53011,4054,219,357,3721,56,8407,2.514.880.952
17/03/2017 11:00,29.22,52667,4109,204,361,3773,58,8505,2.514.880.952
17/03/2017 12:00,28.73,52087,4152,186,354,3939,53,8684,2.514.880.952
17/03/2017 13:00,28.34,51295,4150,168,342,4082,36,8778,2.514.880.952
17/03/2017 14:00,28.01,50671,4098,157,326,4163,25,8769,2.514.880.952
17/03/2017 15:00,27.85,50310,4021,148,292,4205,20,8686,2.514.880.952
17/03/2017 16:00,28.01,50403,3861,147,238,4195,20,8461,2.514.880.952
17/03/2017 17:00,29.21,51694,3533,145,188,4191,19,8076,2.514.880.952
17/03/2017 18:00,29.78,52971,3111,145,174,4118,18,7566,2.514.880.952
17/03/2017 19:00,29.71,52430,2752,142,167,4068,18,7147,2.514.880.952
17/03/2017 20:00,29.47,50581,2462,136,159,3987,19,6763,2.514.880.952
17/03/2017 21:00,28.9,49330,2158,131,157,3924,17,6387,2.514.880.952
17/03/2017 22:00,27.79,47717,1889,123,156,3771,13,5952,2.514.880.952
17/03/2017 23:00,25.65,45893,1662,106,155,3639,12,5574,2.514.880.952
18/03/2017 00:00,27.14,44110,1314,111,200,3441,13,5079,2.514.880.952
18/03/2017 01:00,26.29,43226,1028,109,200,3279,15,4631,2.514.880.952
18/03/2017 02:00,25.67,42945,862,106,200,3096,16,4280,2.514.880.952
18/03/2017 03:00,25.99,43082,763,104,200,2894,14,3975,2.514.880.952
18/03/2017 04:00,26.7,43494,704,98,195,2732,15,3744,2.514.880.952
18/03/2017 05:00,26.68,44143,662,92,185,2594,16,3549,2.514.880.952
18/03/2017 06:00,27.13,44975,685,86,185,2481,18,3455,2.514.880.952
18/03/2017 07:00,27.69,46432,764,82,185,2289,16,3336,2.514.880.952
18/03/2017 08:00,28.58,48178,851,80,180,2140,17,3268,2.514.880.952
18/03/2017 09:00,28.84,48642,1097,76,180,2019,19,3391,2.514.880.952
18/03/2017 10:00,28.79,49069,1477,71,180,2017,21,3766,2.514.880.952
18/03/2017 11:00,28.63,48824,1874,66,175,2083,20,4218,2.514.880.952
18/03/2017 12:00,28.39,48309,2250,59,160,2223,17,4709,2.514.880.952
18/03/2017 13:00,27.92,47834,2460,48,110,2311,15,4944,2.514.880.952
18/03/2017 14:00,27.69,47295,2501,37,100,2430,10,5078,2.514.880.952
18/03/2017 15:00,27.6,47119,2552,29,95,2457,9,5142,2.514.880.952
18/03/2017 16:00,27.93,47669,2533,22,90,2459,7,5111,2.514.880.952
18/03/2017 17:00,28.96,49341,2319,19,80,2367,5,4790,2.514.880.952
18/03/2017 18:00,30.55,50795,2048,19,75,2264,3,4409,2.514.880.952
18/03/2017 19:00,30.86,50482,1776,21,75,2203,4,4079,2.514.880.952
18/03/2017 20:00,30.14,49074,1497,24,75,2079,3,3678,2.514.880.952
18/03/2017 21:00,29.91,48226,1209,27,75,1986,3,3300,2.514.880.952
18/03/2017 22:00,29.85,47189,965,28,80,1803,3,2879,2.514.880.952
18/03/2017 23:00,29.17,45866,790,18,85,1687,4,2584,2.514.880.952
19/03/2017 00:00,28.65,44630,1168,6,70,1691,8,2943,2.514.880.952
19/03/2017 01:00,28.09,43944,911,6,70,1473,10,2470,2.514.880.952
19/03/2017 02:00,27.87,43590,677,6,70,1271,12,2036,2.514.880.952
19/03/2017 03:00,27.89,43590,489,7,80,1072,12,1660,2.514.880.952
19/03/2017 04:00,28.09,43954,341,7,95,839,16,1298,2.514.880.952
19/03/2017 05:00,28.55,44518,277,8,115,703,16,1119,2.514.880.952
19/03/2017 06:00,28.57,44949,362,10,120,609,16,1117,2.514.880.952
19/03/2017 07:00,28.58,45974,589,10,125,543,13,1280,2.514.880.952
19/03/2017 08:00,28.6,47335,920,8,130,508,11,1577,2.514.880.952
19/03/2017 09:00,28.94,48330,1296,8,125,542,10,1981,2.514.880.952
19/03/2017 10:00,29.1,48713,1675,7,115,568,9,2374,2.514.880.952
19/03/2017 11:00,29.19,48392,2104,7,100,698,9,2918,2.514.880.952
19/03/2017 12:00,28.95,47831,2659,8,95,904,9,3675,2.514.880.952
19/03/2017 13:00,28.69,47375,2822,9,75,1120,8,4034,2.514.880.952
19/03/2017 14:00,28.49,47123,2776,8,60,1352,6,4202,2.514.880.952
19/03/2017 15:00,28.36,47230,3012,8,35,1657,6,4718,2.514.880.952
19/03/2017 16:00,28.57,47800,2975,8,30,1890,5,4908,2.514.880.952
19/03/2017 17:00,29.02,49304,2659,8,20,2224,5,4916,2.514.880.952
19/03/2017 18:00,29.69,51077,2570,8,15,2558,5,5156,2.514.880.952
19/03/2017 19:00,29.7,51392,2458,8,15,2825,5,5311,2.514.880.952
19/03/2017 20:00,29.36,50498,2238,8,10,2930,4,5190,2.514.880.952
19/03/2017 21:00,28.94,49741,2105,8,10,3007,4,5134,2.514.880.952
19/03/2017 22:00,28.34,48226,1968,10,15,2979,5,4977,2.514.880.952
19/03/2017 23:00,27.05,46444,1773,21,20,2915,5,4734,2.514.880.952
20/03/2017 00:00,26.82,44974,1313,4,10,2759,4,4090,2.365.416.667
20/03/2017 01:00,26.48,44294,1195,4,10,2645,5,3859,2.365.416.667
20/03/2017 02:00,26.4,44057,1080,5,10,2518,5,3618,2.365.416.667
20/03/2017 03:00,26.32,44326,1047,6,15,2532,5,3605,2.365.416.667
20/03/2017 04:00,27.53,45121,886,7,20,2515,6,3434,2.365.416.667
20/03/2017 05:00,29.22,47366,654,8,25,2514,5,3206,2.365.416.667
20/03/2017 06:00,31.08,51380,564,8,30,2478,5,3085,2.365.416.667
20/03/2017 07:00,34.12,55183,586,9,35,2405,5,3040,2.365.416.667
20/03/2017 08:00,37.43,56195,647,10,35,2241,6,2939,2.365.416.667
20/03/2017 09:00,35.54,54794,726,12,55,2187,8,2988,2.365.416.667
20/03/2017 10:00,33.41,54312,810,15,65,2187,9,3086,2.365.416.667
20/03/2017 11:00,32.19,54006,943,18,70,2210,12,3253,2.365.416.667
20/03/2017 12:00,31.82,53632,1173,20,85,2209,15,3502,2.365.416.667
20/03/2017 13:00,31.49,53437,1423,24,100,2130,19,3696,2.365.416.667
20/03/2017 14:00,30.92,53092,1681,27,110,2026,20,3864,2.365.416.667
20/03/2017 15:00,30.62,52743,1962,30,105,1935,24,4056,2.365.416.667
20/03/2017 16:00,30.23,52948,2224,33,95,2040,22,4414,2.365.416.667
20/03/2017 17:00,30.91,53881,2505,37,90,2168,18,4818,2.365.416.667
20/03/2017 18:00,31.31,54864,2734,40,80,2398,15,5267,2.365.416.667
20/03/2017 19:00,30.89,54691,2795,46,75,2682,11,5609,2.365.416.667
20/03/2017 20:00,30.39,52973,2805,56,75,2958,11,5905,2.365.416.667
20/03/2017 21:00,29.11,51551,2886,63,80,3074,11,6114,2.365.416.667
20/03/2017 22:00,28.51,49222,2843,66,90,3147,9,6155,2.365.416.667
20/03/2017 23:00,27.23,46726,2691,69,95,3222,10,6087,2.365.416.667
21/03/2017 00:00,26.41,44644,2920,49,92,3221,9,6291,2.365.416.667
21/03/2017 01:00,25.71,43710,2820,51,129,3225,10,6235,2.365.416.667
21/03/2017 02:00,25.3,43428,2683,55,160,3371,13,6282,2.365.416.667
21/03/2017 03:00,25.23,43582,2644,60,185,3435,19,6343,2.365.416.667
21/03/2017 04:00,26.79,44446,2674,70,205,3495,26,6470,2.365.416.667
21/03/2017 05:00,27.97,46717,2751,85,248,3492,35,6611,2.365.416.667
21/03/2017 06:00,29.57,50370,2861,107,270,3532,41,6811,2.365.416.667
21/03/2017 07:00,30.85,54133,3049,126,295,3601,33,7104,2.365.416.667
21/03/2017 08:00,31.15,53528,3277,137,311,3564,34,7323,2.365.416.667
21/03/2017 09:00,30.63,53560,3456,150,314,3706,32,7658,2.365.416.667
21/03/2017 10:00,29.72,53384,3605,157,306,3840,44,7952,2.365.416.667
21/03/2017 11:00,29.48,52961,3762,154,295,3890,43,8144,2.365.416.667
21/03/2017 12:00,29.03,52822,3918,151,268,3837,37,8211,2.365.416.667
21/03/2017 13:00,28.92,52922,4069,147,248,3794,32,8290,2.365.416.667
21/03/2017 14:00,28.94,52511,4188,134,227,3757,30,8336,2.365.416.667
21/03/2017 15:00,29.04,52199,4283,127,199,3659,33,8301,2.365.416.667
21/03/2017 16:00,29.31,52055,4354,127,169,3566,29,8245,2.365.416.667
21/03/2017 17:00,29.9,53001,4310,132,113,3448,20,8023,2.365.416.667
21/03/2017 18:00,30.48,54058,4222,142,101,3429,18,7912,2.365.416.667
21/03/2017 19:00,30.38,54008,4152,149,91,3420,20,7832,2.365.416.667
21/03/2017 20:00,29.57,52605,4096,153,88,3329,19,7685,2.365.416.667
21/03/2017 21:00,29.08,51263,4043,160,101,3340,17,7661,2.365.416.667
21/03/2017 22:00,28.71,49037,3968,164,101,3307,18,7558,2.365.416.667
21/03/2017 23:00,28.04,46541,3882,167,98,3303,17,7467,2.365.416.667
22/03/2017 00:00,26.75,44134,3812,193,145,3459,23,7632,2.365.416.667
22/03/2017 01:00,25.7,43167,3738,198,174,3472,33,7615,2.365.416.667
22/03/2017 02:00,25.77,42868,3565,202,183,3497,31,7478,2.365.416.667
22/03/2017 03:00,26.38,43028,3339,199,191,3529,28,7286,2.365.416.667
22/03/2017 04:00,28.06,43872,3089,192,208,3467,31,6987,2.365.416.667
22/03/2017 05:00,28.97,46047,2804,189,220,3355,26,6594,2.365.416.667
22/03/2017 06:00,29.97,49740,2500,188,219,3382,29,6318,2.365.416.667
22/03/2017 07:00,31.26,53331,2305,191,217,3312,39,6064,2.365.416.667
22/03/2017 08:00,31.76,54364,2255,193,217,3215,47,5927,2.365.416.667
22/03/2017 09:00,31.35,53026,2231,196,237,3213,53,5930,2.365.416.667
22/03/2017 10:00,31.16,52806,2166,200,255,3244,55,5920,2.365.416.667
22/03/2017 11:00,30.9,52462,2105,204,270,3308,56,5943,2.365.416.667
22/03/2017 12:00,30.8,51942,2067,204,264,3377,54,5966,2.365.416.667
22/03/2017 13:00,30.47,51568,1895,199,253,3542,54,5943,2.365.416.667
22/03/2017 14:00,30.21,51247,1575,191,237,3498,54,5555,2.365.416.667
22/03/2017 15:00,30.17,50990,1239,179,203,3525,49,5195,2.365.416.667
22/03/2017 16:00,30.47,50944,888,166,174,3549,43,4820,2.365.416.667
22/03/2017 17:00,31.08,51842,566,157,138,3597,38,4496,2.365.416.667
22/03/2017 18:00,31.87,52967,355,151,131,3617,33,4287,2.365.416.667
22/03/2017 19:00,31.5,53215,260,150,119,3582,27,4138,2.365.416.667
22/03/2017 20:00,31,52185,229,148,107,3545,26,4055,2.365.416.667
22/03/2017 21:00,30.57,50975,216,146,101,3498,25,3986,2.365.416.667
22/03/2017 22:00,29.72,48933,208,146,97,3391,26,3868,2.365.416.667
22/03/2017 23:00,28.94,46499,195,130,93,3235,27,3680,2.365.416.667
23/03/2017 00:00,28.51,44876,189,143,128,3190,16,3666,2.365.416.667
23/03/2017 01:00,28.09,44100,162,137,124,3015,17,3455,2.365.416.667
23/03/2017 02:00,28.01,43961,162,133,120,2877,16,3308,2.365.416.667
23/03/2017 03:00,28.16,44326,185,130,111,2846,15,3287,2.365.416.667
23/03/2017 04:00,28.6,45306,209,120,100,2745,13,3187,2.365.416.667
23/03/2017 05:00,29.63,47507,238,102,94,2672,10,3116,2.365.416.667
23/03/2017 06:00,31.05,51122,273,83,78,2611,9,3054,2.365.416.667
23/03/2017 07:00,34.64,54823,303,68,71,2517,8,2967,2.365.416.667
23/03/2017 08:00,35.17,55329,319,55,52,2341,10,2777,2.365.416.667
23/03/2017 09:00,33.46,54369,341,49,30,2302,9,2731,2.365.416.667
23/03/2017 10:00,32.21,53836,368,49,28,2224,9,2678,2.365.416.667
23/03/2017 11:00,31.25,53103,398,51,29,2310,10,2798,2.365.416.667
23/03/2017 12:00,30.74,52454,434,54,30,2411,11,2940,2.365.416.667
23/03/2017 13:00,30.76,52008,470,52,29,2580,11,3142,2.365.416.667
23/03/2017 14:00,30.58,51555,518,47,29,2621,8,3223,2.365.416.667
23/03/2017 15:00,30.52,51252,607,44,26,2651,8,3336,2.365.416.667
23/03/2017 16:00,30.6,51150,680,42,23,2628,7,3380,2.365.416.667
23/03/2017 17:00,31.1,51903,673,40,21,2517,5,3256,2.365.416.667
23/03/2017 18:00,32.23,52869,643,42,21,2442,5,3153,2.365.416.667
23/03/2017 19:00,31.86,53110,601,45,20,2396,5,3067,2.365.416.667
23/03/2017 20:00,31.06,52277,520,44,20,2379,4,2967,2.365.416.667
23/03/2017 21:00,30.83,51251,441,42,20,2325,4,2832,2.365.416.667
23/03/2017 22:00,30.26,49287,374,43,19,2266,5,2707,2.365.416.667
23/03/2017 23:00,29.22,47039,324,60,19,2242,4,2649,2.365.416.667
24/03/2017 00:00,28.63,45048,212,64,19,2190,5,2490,2.365.416.667
24/03/2017 01:00,28.59,44255,207,60,17,2114,5,2403,2.365.416.667
24/03/2017 02:00,28.69,44130,210,58,17,2052,5,2342,2.365.416.667
24/03/2017 03:00,28.48,44449,230,62,20,2028,5,2345,2.365.416.667
24/03/2017 04:00,28.62,45393,258,64,21,1926,5,2274,2.365.416.667
24/03/2017 05:00,29.8,47615,279,61,22,1782,5,2149,2.365.416.667
24/03/2017 06:00,31.96,51152,297,59,24,1674,5,2059,2.365.416.667
24/03/2017 07:00,35.9,54625,312,63,29,1458,5,1867,2.365.416.667
24/03/2017 08:00,36.84,54650,298,68,37,1191,4,1598,2.365.416.667
24/03/2017 09:00,35.05,53968,270,77,52,949,4,1352,2.365.416.667
24/03/2017 10:00,32.72,53457,262,85,59,942,6,1354,2.365.416.667
24/03/2017 11:00,31.44,52546,274,97,67,1109,11,1558,2.365.416.667
24/03/2017 12:00,30.7,51498,342,107,71,1298,11,1829,2.365.416.667
24/03/2017 13:00,30.04,50707,443,109,82,1605,15,2254,2.365.416.667
24/03/2017 14:00,29.47,50004,561,106,92,1883,14,2656,2.365.416.667
24/03/2017 15:00,29.73,49467,679,98,91,2233,12,3113,2.365.416.667
24/03/2017 16:00,30.05,49401,756,90,89,2535,9,3479,2.365.416.667
24/03/2017 17:00,30.41,50443,778,84,87,2753,8,3710,2.365.416.667
24/03/2017 18:00,30.71,51738,769,77,82,2904,6,3838,2.365.416.667
24/03/2017 19:00,30.31,51658,759,71,76,3129,4,4039,2.365.416.667
24/03/2017 20:00,29.73,50112,775,67,72,3300,5,4219,2.365.416.667
24/03/2017 21:00,29.36,48822,850,65,69,3363,6,4353,2.365.416.667
24/03/2017 22:00,28.96,47216,999,65,68,3437,8,4577,2.365.416.667
24/03/2017 23:00,28.55,45446,1142,59,66,3529,9,4805,2.365.416.667
25/03/2017 00:00,28.15,43755,1720,71,91,3733,10,5625,2.365.416.667
25/03/2017 01:00,27.62,42854,1900,77,98,3820,13,5908,2.365.416.667
25/03/2017 02:00,27.27,42461,2038,82,106,3857,10,6093,2.365.416.667
25/03/2017 03:00,27.11,42450,2177,82,126,3816,6,6207,2.365.416.667
25/03/2017 04:00,27.03,42735,2294,74,145,3756,7,6276,2.365.416.667
25/03/2017 05:00,27.43,43166,2321,62,162,3659,13,6217,2.365.416.667
25/03/2017 06:00,27.86,43784,2291,53,173,3536,16,6069,2.365.416.667
25/03/2017 07:00,28.55,45109,2261,49,183,3273,19,5785,2.365.416.667
25/03/2017 08:00,28.87,45750,2229,45,191,2926,20,5411,2.365.416.667
25/03/2017 09:00,28.63,46836,2189,44,208,2679,30,5150,2.365.416.667
25/03/2017 10:00,28,47134,2069,45,232,2457,32,4835,2.365.416.667
25/03/2017 11:00,27.46,46794,1865,44,250,2360,30,4549,2.365.416.667
25/03/2017 12:00,27.22,46133,1713,41,246,2369,35,4404,2.365.416.667
25/03/2017 13:00,26.75,45431,1550,41,242,2288,39,4160,2.365.416.667
25/03/2017 14:00,26.48,45041,1396,40,236,2104,43,3819,2.365.416.667
25/03/2017 15:00,26.73,44980,1288,39,217,1918,46,3508,2.365.416.667
25/03/2017 16:00,27.28,45506,1170,36,205,1657,47,3115,2.365.416.667
25/03/2017 17:00,28.32,46944,1019,35,194,1641,43,2932,2.365.416.667
25/03/2017 18:00,29.96,48399,856,34,189,1747,33,2859,2.365.416.667
25/03/2017 19:00,30.12,48267,731,35,185,1866,27,2844,2.365.416.667
25/03/2017 20:00,29.68,46980,640,33,180,2064,21,2938,2.365.416.667
25/03/2017 21:00,29.3,46116,591,28,169,2174,18,2980,2.365.416.667
25/03/2017 22:00,28.91,45011,562,22,159,2316,15,3074,2.365.416.667
25/03/2017 23:00,28.05,43612,520,35,148,2393,12,3108,2.365.416.667
26/03/2017 00:00,28.37,42130,418,14,110,2578,6,3126,2.365.416.667
26/03/2017 01:00,27.37,41227,332,15,97,2663,5,3112,2.365.416.667
26/03/2017 02:00,27.075,40956,315.5,16,87,2776,4,3198.5,2.365.416.667
26/03/2017 03:00,26.78,40685,299,25,66,2893,4,3287,2.365.416.667
26/03/2017 04:00,26.25,40902,270,45,52,2971,5,3343,2.365.416.667
26/03/2017 05:00,25.43,41252,221,65,34,3080,7,3407,2.365.416.667
26/03/2017 06:00,26.79,41491,182,82,25,3213,7,3509,2.365.416.667
26/03/2017 07:00,27.36,42359,157,101,16,3328,10,3612,2.365.416.667
26/03/2017 08:00,27.81,42743,142,125,13,3327,15,3622,2.365.416.667
26/03/2017 09:00,28.22,43891,140,153,14,3195,23,3525,2.365.416.667
26/03/2017 10:00,28.03,44501,158,179,15,3345,33,3730,2.365.416.667
26/03/2017 11:00,27.8,44455,191,201,20,3474,40,3926,2.365.416.667
26/03/2017 12:00,27.17,44085,224,218,56,3602,50,4150,2.365.416.667
26/03/2017 13:00,26.29,43483,259,230,67,3720,51,4327,2.365.416.667
26/03/2017 14:00,25.72,42884,296,234,102,3753,52,4437,2.365.416.667
26/03/2017 15:00,25.38,42677,335,232,133,3733,51,4484,2.365.416.667
26/03/2017 16:00,25.76,43069,400,230,174,3788,43,4635,2.365.416.667
26/03/2017 17:00,27.09,44181,463,226,205,3784,34,4712,2.365.416.667
26/03/2017 18:00,28.46,45737,471,232,245,3738,26,4712,2.365.416.667
26/03/2017 19:00,29.45,46272,445,240,278,3648,19,4630,2.365.416.667
26/03/2017 20:00,29.55,45810,425,241,323,3461,22,4472,2.365.416.667
26/03/2017 21:00,29.22,45102,410,239,327,3321,22,4319,2.365.416.667
26/03/2017 22:00,28.81,43562,407,237,327,3112,15,4098,2.365.416.667
26/03/2017 23:00,28.15,41712,409,234,0,2983,19,3645,2.365.416.667
27/03/2017 00:00,27.86,40115,441,230,0,2758,18,3447,2.278.392.857
27/03/2017 01:00,26.84,39397,476,222,0,2497,17,3212,2.278.392.857
27/03/2017 02:00,26.81,39402,497,199,0,2285,14,2995,2.278.392.857
27/03/2017 03:00,26.63,39792,481,186,0,2156,10,2833,2.278.392.857
27/03/2017 04:00,27.49,40767,485,175,0,2133,9,2802,2.278.392.857
27/03/2017 05:00,28.87,42943,486,161,0,2113,9,2769,2.278.392.857
27/03/2017 06:00,30.21,46832,505,142,0,2216,9,2872,2.278.392.857
27/03/2017 07:00,31.96,50559,558,130,0,2242,8,2938,2.278.392.857
27/03/2017 08:00,33.43,50558,628,126,0,2356,7,3117,2.278.392.857
27/03/2017 09:00,32.42,50344,686,124,0,2548,8,3366,2.278.392.857
27/03/2017 10:00,31.75,50053,760,124,0,2690,12,3586,2.278.392.857
27/03/2017 11:00,30.87,49528,891,131,0,2879,13,3914,2.278.392.857
27/03/2017 12:00,29.93,49094,1075,149,0,3135,17,4376,2.278.392.857
27/03/2017 13:00,29.49,48782,1265,171,0,3326,26,4788,2.278.392.857
27/03/2017 14:00,28.87,48217,1379,188,0,3447,38,5052,2.278.392.857
27/03/2017 15:00,28.7,47794,1456,203,0,3535,43,5237,2.278.392.857
27/03/2017 16:00,28.92,47651,1573,214,0,3773,48,5608,2.278.392.857
27/03/2017 17:00,29.5,48191,1628,224,0,3764,40,5656,2.278.392.857
27/03/2017 18:00,29.71,48845,1607,231,0,3707,28,5573,2.278.392.857
27/03/2017 19:00,29.89,48986,1538,238,0,3648,23,5447,2.278.392.857
27/03/2017 20:00,29.68,48196,1447,246,0,3510,18,5221,2.278.392.857
27/03/2017 21:00,29.59,47116,1378,245,0,3249,21,4893,2.278.392.857
27/03/2017 22:00,29.27,45122,1314,234,0,3078,27,4653,2.278.392.857
27/03/2017 23:00,28.5,42777,1195,225,264,2906,13,4603,2.278.392.857
28/03/2017 00:00,27.81,40670,923,217,228,2758,12,4138,2.278.392.857
28/03/2017 01:00,27.28,39825,767,212,177,2586,10,3752,2.278.392.857
28/03/2017 02:00,27.27,39697,654,191,146,2313,9,3313,2.278.392.857
28/03/2017 03:00,27.5,40104,610,183,119,2086,8,3006,2.278.392.857
28/03/2017 04:00,27.99,41091,580,180,106,2036,10,2912,2.278.392.857
28/03/2017 05:00,28.89,43404,516,173,97,2000,12,2798,2.278.392.857
28/03/2017 06:00,31.17,47467,429,163,89,1938,12,2631,2.278.392.857
28/03/2017 07:00,34.93,51186,351,155,84,1808,13,2411,2.278.392.857
28/03/2017 08:00,41.05,52379,282,152,82,1690,14,2220,2.278.392.857
28/03/2017 09:00,33.91,51038,235,149,84,1637,15,2120,2.278.392.857
28/03/2017 10:00,33,50651,215,144,91,1612,14,2076,2.278.392.857
28/03/2017 11:00,32.5,50169,219,143,100,1497,12,1971,2.278.392.857
28/03/2017 12:00,31.15,49811,235,147,106,1505,12,2005,2.278.392.857
28/03/2017 13:00,30.26,49267,255,155,115,1451,12,1988,2.278.392.857
28/03/2017 14:00,29.78,48726,277,157,115,1399,10,1958,2.278.392.857
28/03/2017 15:00,29.82,48308,306,154,112,1380,8,1960,2.278.392.857
28/03/2017 16:00,29.89,48183,340,151,109,1311,6,1917,2.278.392.857
28/03/2017 17:00,31.22,48884,352,139,98,1227,5,1821,2.278.392.857
28/03/2017 18:00,33.17,49720,341,126,94,1125,4,1690,2.278.392.857
28/03/2017 19:00,33.97,49978,328,112,87,1087,4,1618,2.278.392.857
28/03/2017 20:00,33.85,49387,312,99,77,1102,3,1593,2.278.392.857
28/03/2017 21:00,32.19,48359,297,87,63,1180,4,1631,2.278.392.857
28/03/2017 22:00,30.61,46387,317,69,62,1260,3,1711,2.278.392.857
28/03/2017 23:00,28.9,43871,373,61,56,1248,4,1742,2.278.392.857
29/03/2017 00:00,27.77,41651,498,50,53,1220,3,1824,2.278.392.857
29/03/2017 01:00,27.12,40882,513,41,55,1155,3,1767,2.278.392.857
29/03/2017 02:00,26.87,40692,512,33,56,1198,3,1802,2.278.392.857
29/03/2017 03:00,26.61,40985,500,26,65,1164,3,1758,2.278.392.857
29/03/2017 04:00,27.08,41867,511,20,68,1138,3,1740,2.278.392.857
29/03/2017 05:00,28.65,44016,554,16,72,1102,3,1747,2.278.392.857
29/03/2017 06:00,31.02,47933,630,14,71,1038,3,1756,2.278.392.857
29/03/2017 07:00,33.86,51895,752,13,68,936,3,1772,2.278.392.857
29/03/2017 08:00,34.23,51987,893,14,63,844,5,1819,2.278.392.857
29/03/2017 09:00,33.04,51728,1073,17,58,799,6,1953,2.278.392.857
29/03/2017 10:00,32.13,51382,1316,21,48,813,6,2204,2.278.392.857
29/03/2017 11:00,31.86,51011,1496,23,35,858,5,2417,2.278.392.857
29/03/2017 12:00,31.94,50800,1613,26,31,976,5,2651,2.278.392.857
29/03/2017 13:00,31.7,50648,1689,28,30,1086,6,2839,2.278.392.857
29/03/2017 14:00,31.13,50316,1632,31,32,1186,6,2887,2.278.392.857
29/03/2017 15:00,30.09,49920,1465,37,32,1262,5,2801,2.278.392.857
29/03/2017 16:00,30,49755,1247,41,31,1302,5,2626,2.278.392.857
29/03/2017 17:00,30.56,50286,1031,46,33,1257,5,2372,2.278.392.857
29/03/2017 18:00,31.69,51017,827,50,36,1175,5,2093,2.278.392.857
29/03/2017 19:00,33.01,51231,643,53,41,1072,6,1815,2.278.392.857
29/03/2017 20:00,32.53,50598,456,58,49,1017,6,1586,2.278.392.857
29/03/2017 21:00,31.93,49496,301,65,54,969,7,1396,2.278.392.857
29/03/2017 22:00,30.65,47510,210,67,59,970,7,1313,2.278.392.857
29/03/2017 23:00,29.68,45180,148,53,65,870,5,1141,2.278.392.857
30/03/2017 00:00,28.51,43457,119,49,63,825,4,1060,2.278.392.857
30/03/2017 01:00,27.74,42700,129,46,62,778,5,1020,2.278.392.857
30/03/2017 02:00,27.07,42455,176,45,61,744,5,1031,2.278.392.857
30/03/2017 03:00,27.03,42698,255,41,55,722,4,1077,2.278.392.857
30/03/2017 04:00,27.4,43550,339,33,47,724,4,1147,2.278.392.857
30/03/2017 05:00,28.66,45627,442,24,43,738,4,1251,2.278.392.857
30/03/2017 06:00,31.45,49575,568,15,26,772,3,1384,2.278.392.857
30/03/2017 07:00,35.06,53176,739,9,19,781,3,1551,2.278.392.857
30/03/2017 08:00,35.73,53373,927,8,16,835,4,1790,2.278.392.857
30/03/2017 09:00,35.01,52764,1158,8,13,933,3,2115,2.278.392.857
30/03/2017 10:00,32,52308,1452,10,13,1036,4,2515,2.278.392.857
30/03/2017 11:00,31.77,51718,1663,12,13,1238,3,2929,2.278.392.857
30/03/2017 12:00,30.88,51195,1798,15,13,1426,4,3256,2.278.392.857
30/03/2017 13:00,30.16,51101,1938,19,15,1584,5,3561,2.278.392.857
30/03/2017 14:00,29.56,50820,1984,20,15,1742,5,3766,2.278.392.857
30/03/2017 15:00,29.09,50616,1951,21,15,1805,6,3798,2.278.392.857
30/03/2017 16:00,28.96,50464,1897,23,18,1874,5,3817,2.278.392.857
30/03/2017 17:00,29.68,50975,1826,24,19,2033,6,3908,2.278.392.857
30/03/2017 18:00,30.5,51509,1793,31,25,2073,6,3928,2.278.392.857
30/03/2017 19:00,30.89,51619,1810,41,68,2111,8,4038,2.278.392.857
30/03/2017 20:00,30.23,50834,1869,54,80,2149,14,4166,2.278.392.857
30/03/2017 21:00,29.68,49578,1903,73,90,2158,23,4247,2.278.392.857
30/03/2017 22:00,28.65,47378,1902,75,131,2081,29,4218,2.278.392.857
30/03/2017 23:00,27.87,44983,1794,91,206,1810,21,3922,2.278.392.857
31/03/2017 00:00,26.7,43063,1352,98,255,1710,26,3441,2.278.392.857
31/03/2017 01:00,26.24,41940,1278,95,297,1644,21,3335,2.278.392.857
31/03/2017 02:00,25.72,41493,1223,89,332,1525,21,3190,2.278.392.857
31/03/2017 03:00,25.79,41637,1174,75,338,1417,26,3030,2.278.392.857
31/03/2017 04:00,26.03,42379,1143,58,346,1291,25,2863,2.278.392.857
31/03/2017 05:00,27.69,44492,1101,43,348,1121,26,2639,2.278.392.857
31/03/2017 06:00,30.06,48158,1058,34,342,940,24,2398,2.278.392.857
31/03/2017 07:00,32.94,52044,995,30,335,714,22,2096,2.278.392.857
31/03/2017 08:00,33.83,52221,872,27,321,559,20,1799,2.278.392.857
31/03/2017 09:00,33.38,52023,714,26,298,453,17,1508,2.278.392.857
31/03/2017 10:00,31.8,51632,644,24,271,366,16,1321,2.278.392.857
31/03/2017 11:00,31,51007,678,27,231,331,12,1279,2.278.392.857
31/03/2017 12:00,29.94,50338,767,29,196,345,10,1347,2.278.392.857
31/03/2017 13:00,29.05,49777,881,28,163,395,8,1475,2.278.392.857
31/03/2017 14:00,28.67,48906,1026,24,89,484,7,1630,2.278.392.857
31/03/2017 15:00,28.4,48172,1145,21,96,655,5,1922,2.278.392.857
31/03/2017 16:00,28.42,47893,1248,20,71,910,4,2253,2.278.392.857
31/03/2017 17:00,29.25,48454,1265,18,55,1205,3,2546,2.278.392.857
31/03/2017 18:00,30.47,49182,1207,18,27,1534,3,2789,2.278.392.857
31/03/2017 19:00,30.38,48989,1145,18,25,1813,4,3005,2.278.392.857
31/03/2017 20:00,29.42,47783,992,19,20,2046,3,3080,2.278.392.857
31/03/2017 21:00,28.92,46601,842,21,18,2231,4,3116,2.278.392.857
31/03/2017 22:00,28.41,44920,807,36,18,2262,3,3126,2.278.392.857
31/03/2017 23:00,28.14,43207,730,40,29,2331,5,3135,2.278.392.857
01/04/2017 00:00,27.34,41710,888,49,47,2354,7,3345,2.278.392.857
01/04/2017 01:00,27.06,40613,817,61,71,2311,8,3268,2.278.392.857
01/04/2017 02:00,26.56,40081,743,73,94,2207,9,3126,2.278.392.857
01/04/2017 03:00,26.22,39955,695,84,121,2091,11,3002,2.278.392.857
01/04/2017 04:00,26.33,40045,647,97,148,2039,14,2945,2.278.392.857
01/04/2017 05:00,26.82,40346,583,114,162,1984,16,2859,2.278.392.857
01/04/2017 06:00,27.2,40973,520,132,139,1874,18,2683,2.278.392.857
01/04/2017 07:00,27.15,42325,487,149,117,1698,19,2470,2.278.392.857
01/04/2017 08:00,27.83,44000,467,169,105,1525,21,2287,2.278.392.857
01/04/2017 09:00,28.4,45263,436,184,103,1420,26,2169,2.278.392.857
01/04/2017 10:00,27.98,45525,429,191,107,1354,29,2110,2.278.392.857
01/04/2017 11:00,26.98,45225,428,196,109,1436,35,2204,2.278.392.857
01/04/2017 12:00,26.23,44494,438,200,110,1475,34,2257,2.278.392.857
01/04/2017 13:00,26.08,43971,468,200,109,1513,31,2321,2.278.392.857
01/04/2017 14:00,25.95,43461,480,193,102,1490,28,2293,2.278.392.857
01/04/2017 15:00,25.75,43275,461,183,96,1548,23,2311,2.278.392.857
01/04/2017 16:00,26.04,43706,422,170,92,1525,20,2229,2.278.392.857
01/04/2017 17:00,27.04,44742,354,157,84,1542,14,2151,2.278.392.857
01/04/2017 18:00,28.23,45830,287,148,76,1579,12,2102,2.278.392.857
01/04/2017 19:00,28.43,45602,240,141,71,1594,10,2056,2.278.392.857
01/04/2017 20:00,28.35,44565,205,135,65,1563,8,1976,2.278.392.857
01/04/2017 21:00,28.24,43646,204,127,56,1617,7,2011,2.278.392.857
01/04/2017 22:00,28.02,42429,228,110,48,1600,7,1993,2.278.392.857
01/04/2017 23:00,27.49,41020,240,116,54,1630,6,2046,2.278.392.857
02/04/2017 00:00,27.51,39474,204,104,45,1569,4,1926,2.278.392.857
02/04/2017 01:00,27.03,38681,197,90,38,1474,4,1803,2.278.392.857
02/04/2017 02:00,26.44,38362,167,81,30,1404,3,1685,2.278.392.857
02/04/2017 03:00,26.09,38304,148,76,22,1338,3,1587,2.278.392.857
02/04/2017 04:00,26.15,38539,154,68,17,1261,3,1503,2.278.392.857
02/04/2017 05:00,26.1,38873,167,59,14,1157,3,1400,2.278.392.857
02/04/2017 06:00,26.32,39219,193,48,14,1080,3,1338,2.278.392.857
02/04/2017 07:00,26.77,40077,234,42,13,975,3,1267,2.278.392.857
02/04/2017 08:00,28.01,41061,267,37,9,876,3,1192,2.278.392.857
02/04/2017 09:00,28.45,42504,302,35,5,837,3,1182,2.278.392.857
02/04/2017 10:00,28.36,43371,360,35,4,739,4,1142,2.278.392.857
02/04/2017 11:00,28.03,43431,425,35,5,687,4,1156,2.278.392.857
02/04/2017 12:00,27.23,43243,480,34,10,681,4,1209,2.278.392.857
02/04/2017 13:00,26.54,42723,540,34,15,695,3,1287,2.278.392.857
02/04/2017 14:00,26.16,42331,597,32,19,670,3,1321,2.278.392.857
02/04/2017 15:00,25.94,42054,652,29,24,677,3,1385,2.278.392.857
02/04/2017 16:00,25.73,42359,731,24,29,632,3,1419,2.278.392.857
02/04/2017 17:00,26.96,43191,800,22,35,623,3,1483,2.278.392.857
02/04/2017 18:00,28.2,44365,830,23,42,645,3,1543,2.278.392.857
02/04/2017 19:00,28.7,44990,855,24,47,633,4,1563,2.278.392.857
02/04/2017 20:00,28.93,45069,934,22,54,659,3,1672,2.278.392.857
02/04/2017 21:00,28.52,44449,1052,21,56,682,4,1815,2.278.392.857
02/04/2017 22:00,28.12,42843,1132,21,58,675,5,1891,2.278.392.857
02/04/2017 23:00,27.38,40892,1134,20,97,586,5,1842,2.278.392.857
03/04/2017 00:00,27.93,39351,971,21,85,618,5,1700,2.240.535.714
03/04/2017 01:00,27.68,38550,925,25,77,639,4,1670,2.240.535.714
03/04/2017 02:00,27.58,38464,918,30,66,651,3,1668,2.240.535.714
03/04/2017 03:00,27.45,38837,913,34,63,685,3,1698,2.240.535.714
03/04/2017 04:00,27.96,39769,907,36,44,718,3,1708,2.240.535.714
03/04/2017 05:00,28.86,42014,851,35,33,747,3,1669,2.240.535.714
03/04/2017 06:00,30.81,46103,747,34,26,748,3,1558,2.240.535.714
03/04/2017 07:00,34.22,49859,660,33,20,766,3,1482,2.240.535.714
03/04/2017 08:00,43.04,50341,574,29,16,739,4,1362,2.240.535.714
03/04/2017 09:00,35.69,50335,519,26,16,693,4,1258,2.240.535.714
03/04/2017 10:00,35.18,49993,504,25,18,776,5,1328,2.240.535.714
03/04/2017 11:00,34.13,49292,481,25,20,870,3,1399,2.240.535.714
03/04/2017 12:00,31.69,48702,436,25,23,977,4,1465,2.240.535.714
03/04/2017 13:00,30.82,48330,400,25,25,1062,4,1516,2.240.535.714
03/04/2017 14:00,29.73,47748,377,24,28,1117,6,1552,2.240.535.714
03/04/2017 15:00,29.37,47090,359,23,33,1248,6,1669,2.240.535.714
03/04/2017 16:00,29.32,46798,346,20,37,1379,6,1788,2.240.535.714
03/04/2017 17:00,29.52,47198,312,18,42,1637,5,2014,2.240.535.714
03/04/2017 18:00,30.12,47616,268,15,49,1852,4,2188,2.240.535.714
03/04/2017 19:00,30.41,47880,222,11,51,2026,3,2313,2.240.535.714
03/04/2017 20:00,29.9,47644,185,9,51,2168,3,2416,2.240.535.714
03/04/2017 21:00,29.43,46726,173,8,41,2188,3,2413,2.240.535.714
03/04/2017 22:00,28.59,44704,187,19,33,2242,2,2483,2.240.535.714
03/04/2017 23:00,28.06,42498,211,3,48,2374,7,2643,2.240.535.714
04/04/2017 00:00,27.13,40330,182,4,47,2318,5,2556,2.240.535.714
04/04/2017 01:00,26.79,39472,203,5,32,2400,3,2643,2.240.535.714
04/04/2017 02:00,26.6,39222,213,9,45,2435,3,2705,2.240.535.714
04/04/2017 03:00,26.63,39460,242,13,25,2471,3,2754,2.240.535.714
04/04/2017 04:00,27.03,40193,282,19,28,2502,3,2834,2.240.535.714
04/04/2017 05:00,27.74,42352,333,23,23,2476,4,2859,2.240.535.714
04/04/2017 06:00,28.71,46315,398,25,19,2466,5,2913,2.240.535.714
04/04/2017 07:00,30.25,49908,497,28,17,2477,7,3026,2.240.535.714
04/04/2017 08:00,31.22,49611,570,35,16,2443,11,3075,2.240.535.714
04/04/2017 09:00,30.51,49490,643,44,15,2410,18,3130,2.240.535.714
04/04/2017 10:00,29.72,49285,709,56,15,2411,24,3215,2.240.535.714
04/04/2017 11:00,29.01,48635,835,67,15,2563,24,3504,2.240.535.714
04/04/2017 12:00,28.69,48220,997,74,15,2651,21,3758,2.240.535.714
04/04/2017 13:00,28.36,47951,1198,81,15,2787,25,4106,2.240.535.714
04/04/2017 14:00,28.08,47393,1357,86,15,2882,27,4367,2.240.535.714
04/04/2017 15:00,28,46877,1436,94,16,3127,24,4697,2.240.535.714
04/04/2017 16:00,28.02,46613,1454,105,16,3130,16,4721,2.240.535.714
04/04/2017 17:00,28.37,46999,1290,129,17,3197,12,4645,2.240.535.714
04/04/2017 18:00,28.52,47482,1002,152,18,3214,7,4393,2.240.535.714
04/04/2017 19:00,28.87,47929,866,160,21,3168,4,4219,2.240.535.714
04/04/2017 20:00,28.78,47956,814,163,24,3132,3,4136,2.240.535.714
04/04/2017 21:00,28.46,47024,782,166,27,3139,4,4118,2.240.535.714
04/04/2017 22:00,28.03,44972,788,149,31,3128,4,4100,2.240.535.714
04/04/2017 23:00,27.12,42521,848,158,48,3360,10,4424,2.240.535.714
05/04/2017 00:00,26.34,40118,862,156,54,3295,11,4378,2.240.535.714
05/04/2017 01:00,26.01,39257,904,158,56,3319,11,4448,2.240.535.714
05/04/2017 02:00,25.8,38958,941,155,58,3348,12,4514,2.240.535.714
05/04/2017 03:00,25.77,39226,1048,156,57,3435,11,4707,2.240.535.714
05/04/2017 04:00,25.99,40057,1263,156,54,3366,11,4850,2.240.535.714
05/04/2017 05:00,26.52,42155,1517,156,53,3133,13,4872,2.240.535.714
05/04/2017 06:00,28.04,45836,1770,157,53,2967,15,4962,2.240.535.714
05/04/2017 07:00,28.73,49550,1995,159,53,2798,18,5023,2.240.535.714
05/04/2017 08:00,29.29,50467,2231,161,56,2804,23,5275,2.240.535.714
05/04/2017 09:00,28.92,50113,2557,159,61,2749,29,5555,2.240.535.714
05/04/2017 10:00,28.52,49699,2837,153,71,2721,31,5813,2.240.535.714
05/04/2017 11:00,28.35,49036,3149,146,77,2800,35,6207,2.240.535.714
05/04/2017 12:00,28.08,48451,3426,141,89,2846,34,6536,2.240.535.714
05/04/2017 13:00,27.81,48268,3741,137,100,2922,33,6933,2.240.535.714
05/04/2017 14:00,27.17,47905,4027,127,108,2970,33,7265,2.240.535.714
05/04/2017 15:00,27.07,47501,4204,107,113,2992,24,7440,2.240.535.714
05/04/2017 16:00,27.22,47240,4016,89,111,2976,26,7218,2.240.535.714
05/04/2017 17:00,27.48,47757,4327,79,111,3052,26,7595,2.240.535.714
05/04/2017 18:00,27.65,48214,4350,74,116,3156,24,7720,2.240.535.714
05/04/2017 19:00,27.77,48419,4316,69,123,3346,24,7878,2.240.535.714
05/04/2017 20:00,27.47,48208,4223,66,126,3568,22,8005,2.240.535.714
05/04/2017 21:00,27.18,47377,4093,58,126,3655,21,7953,2.240.535.714
05/04/2017 22:00,26.04,45514,3929,38,124,3733,20,7844,2.240.535.714
05/04/2017 23:00,24.5,43211,3719,22,81,3817,7,7646,2.240.535.714
06/04/2017 00:00,25.06,41375,3385,14,81,3746,5,7231,2.240.535.714
06/04/2017 01:00,24.56,40456,3101,9,72,3550,3,6735,2.240.535.714
06/04/2017 02:00,24.44,40189,2822,8,70,3402,3,6305,2.240.535.714
06/04/2017 03:00,24.61,40441,2499,9,59,3185,3,5755,2.240.535.714
06/04/2017 04:00,25.09,41300,2158,11,51,2968,3,5191,2.240.535.714
06/04/2017 05:00,26.49,43578,1908,12,29,2751,4,4704,2.240.535.714
06/04/2017 06:00,28.39,47284,1672,13,24,2453,5,4167,2.240.535.714
06/04/2017 07:00,30.39,51040,1444,10,17,2164,7,3642,2.240.535.714
06/04/2017 08:00,31.64,51274,1295,11,14,1930,11,3261,2.240.535.714
06/04/2017 09:00,30.98,50903,1332,14,18,1723,18,3105,2.240.535.714
06/04/2017 10:00,30.32,50362,1497,18,25,1660,24,3224,2.240.535.714
06/04/2017 11:00,29.43,49658,1823,22,41,1747,24,3657,2.240.535.714
06/04/2017 12:00,28.87,49026,2226,26,60,1973,21,4306,2.240.535.714
06/04/2017 13:00,28.58,48612,2624,31,73,2228,25,4981,2.240.535.714
06/04/2017 14:00,28.2,48265,2956,32,93,2146,27,5254,2.240.535.714
06/04/2017 15:00,28.17,47861,3271,33,107,2108,24,5543,2.240.535.714
06/04/2017 16:00,28.08,47690,3402,34,118,1965,16,5535,2.240.535.714
06/04/2017 17:00,28.21,48041,3451,35,119,1945,12,5562,2.240.535.714
06/04/2017 18:00,28.26,48364,3553,33,108,1883,7,5584,2.240.535.714
06/04/2017 19:00,28.36,48500,3677,33,97,1858,4,5669,2.240.535.714
06/04/2017 20:00,28.26,48193,3797,33,95,1823,3,5751,2.240.535.714
06/04/2017 21:00,28.03,47366,3882,30,80,1804,4,5800,2.240.535.714
06/04/2017 22:00,27.32,45371,3956,32,65,1806,4,5863,2.240.535.714
06/04/2017 23:00,26.57,43131,3954,31,0,1901,4,5890,2.240.535.714
07/04/2017 00:00,25.73,40976,3810,34,0,1788,4,5636,2.240.535.714
07/04/2017 01:00,25.36,40068,3662,35,0,1627,4,5328,2.240.535.714
07/04/2017 02:00,25.03,39809,3500,31,0,1525,4,5060,2.240.535.714
07/04/2017 03:00,25.17,40033,3319,27,0,1398,4,4748,2.240.535.714
07/04/2017 04:00,25.69,40785,3162,22,0,1302,4,4490,2.240.535.714
07/04/2017 05:00,26.96,42904,3087,19,0,1208,3,4317,2.240.535.714
07/04/2017 06:00,28.38,46631,2990,16,0,1148,3,4157,2.240.535.714
07/04/2017 07:00,29.57,50197,2865,12,0,1042,3,3922,2.240.535.714
07/04/2017 08:00,30.24,50238,2777,11,0,987,4,3779,2.240.535.714
07/04/2017 09:00,29.84,50072,2767,12,0,905,5,3689,2.240.535.714
07/04/2017 10:00,29.41,49611,2853,14,0,937,8,3812,2.240.535.714
07/04/2017 11:00,29.19,48899,2866,17,0,1079,11,3973,2.240.535.714
07/04/2017 12:00,28.83,48055,2822,22,0,1284,14,4142,2.240.535.714
07/04/2017 13:00,28.68,47087,2820,25,0,1367,17,4229,2.240.535.714
07/04/2017 14:00,28.49,46183,2774,28,0,1326,20,4148,2.240.535.714
07/04/2017 15:00,28.29,45459,2713,31,0,1298,26,4068,2.240.535.714
07/04/2017 16:00,28.27,45230,2686,40,0,1256,25,4007,2.240.535.714
07/04/2017 17:00,28.37,45646,2676,57,0,1255,24,4012,2.240.535.714
07/04/2017 18:00,28.5,46019,2648,76,0,1218,23,3965,2.240.535.714
07/04/2017 19:00,28.64,46042,2530,91,0,1155,19,3795,2.240.535.714
07/04/2017 20:00,28.51,45498,2489,102,0,1118,12,3721,2.240.535.714
07/04/2017 21:00,28.29,44744,2419,107,0,1193,9,3728,2.240.535.714
07/04/2017 22:00,27.6,43297,2304,99,0,1167,8,3578,2.240.535.714
07/04/2017 23:00,27.03,41587,2203,123,0,987,6,3319,2.240.535.714
08/04/2017 00:00,27.53,40035,1564,122,0,862,8,2556,2.240.535.714
08/04/2017 01:00,27.36,39086,1501,121,0,733,5,2360,2.240.535.714
08/04/2017 02:00,27.34,38701,1412,115,0,646,5,2178,2.240.535.714
08/04/2017 03:00,27.4,38751,1241,103,0,604,5,1953,2.240.535.714
08/04/2017 04:00,27.52,39064,1180,86,0,582,4,1852,2.240.535.714
08/04/2017 05:00,27.82,39551,1220,69,0,602,5,1896,2.240.535.714
08/04/2017 06:00,27.89,40260,1323,56,0,608,3,1990,2.240.535.714
08/04/2017 07:00,28.32,41614,1456,49,0,558,2,2065,2.240.535.714
08/04/2017 08:00,28.46,43239,1576,51,0,520,2,2149,2.240.535.714
08/04/2017 09:00,28.78,44445,1729,62,0,518,2,2311,2.240.535.714
08/04/2017 10:00,28.81,44491,1860,78,0,587,3,2528,2.240.535.714
08/04/2017 11:00,28.68,43985,1978,95,0,759,4,2836,2.240.535.714
08/04/2017 12:00,28.44,43289,2047,97,0,969,8,3121,2.240.535.714
08/04/2017 13:00,28.02,42609,2104,89,0,1223,12,3428,2.240.535.714
08/04/2017 14:00,27.42,42055,2093,77,0,1400,22,3592,2.240.535.714
08/04/2017 15:00,27.04,41737,2071,63,0,1532,27,3693,2.240.535.714
08/04/2017 16:00,27.33,42128,2039,51,0,1746,29,3865,2.240.535.714
08/04/2017 17:00,27.91,43054,1938,45,0,1967,27,3977,2.240.535.714
08/04/2017 18:00,28,43863,1733,44,0,2126,22,3925,2.240.535.714
08/04/2017 19:00,28.15,43944,1542,40,0,2267,20,3869,2.240.535.714
08/04/2017 20:00,28.16,43642,1439,37,0,2303,17,3796,2.240.535.714
08/04/2017 21:00,28.17,43229,1387,35,0,2399,15,3836,2.240.535.714
08/04/2017 22:00,28.12,42061,1385,50,0,2510,16,3961,2.240.535.714
08/04/2017 23:00,27.59,40654,1277,46,100,2576,20,4019,2.240.535.714
09/04/2017 00:00,26.9,39412,1043,51,111,2578,20,3803,2.240.535.714
09/04/2017 01:00,26.43,38651,1085,45,145,2575,16,3866,2.240.535.714
09/04/2017 02:00,26.19,38388,1084,39,150,2562,12,3847,2.240.535.714
09/04/2017 03:00,26.04,38349,1070,36,150,2524,8,3788,2.240.535.714
09/04/2017 04:00,26.16,38531,1053,33,150,2505,6,3747,2.240.535.714
09/04/2017 05:00,26.17,38840,1013,30,160,2487,7,3697,2.240.535.714
09/04/2017 06:00,26,39165,936,28,160,2469,6,3599,2.240.535.714
09/04/2017 07:00,26.28,39923,867,27,160,2445,9,3508,2.240.535.714
09/04/2017 08:00,27.2,41009,908,31,170,2466,9,3584,2.240.535.714
09/04/2017 09:00,27.76,42351,1036,40,180,2490,12,3758,2.240.535.714
09/04/2017 10:00,27.07,43075,1178,45,195,2480,16,3914,2.240.535.714
09/04/2017 11:00,26.08,42935,1302,54,225,2444,17,4042,2.240.535.714
09/04/2017 12:00,25.68,42520,1410,67,235,2527,18,4257,2.240.535.714
09/04/2017 13:00,24.54,41950,1535,81,240,2594,23,4473,2.240.535.714
09/04/2017 14:00,24.05,41322,1547,95,250,2591,25,4508,2.240.535.714
09/04/2017 15:00,23.75,41141,1488,106,250,2549,26,4419,2.240.535.714
09/04/2017 16:00,24.02,41383,1475,112,240,2479,25,4331,2.240.535.714
09/04/2017 17:00,25.37,42009,1481,118,220,2547,23,4389,2.240.535.714
09/04/2017 18:00,26.96,42828,1435,125,200,2642,20,4422,2.240.535.714
09/04/2017 19:00,27.37,43444,1475,134,185,2730,18,4542,2.240.535.714
09/04/2017 20:00,27.51,43938,1658,141,170,2868,16,4853,2.240.535.714
09/04/2017 21:00,27.29,43764,1920,144,170,2935,15,5184,2.240.535.714
09/04/2017 22:00,26.56,42390,2191,131,170,2955,16,5463,2.240.535.714
09/04/2017 23:00,25.54,40606,2455,128,155,3012,20,5770,2.240.535.714
10/04/2017 00:00,25.18,38683,2441,126,155,3003,18,5743,2.189.345.238
10/04/2017 01:00,24.24,38013,2592,127,155,2944,17,5835,2.189.345.238
10/04/2017 02:00,23.6,37904,2536,131,155,2942,17,5781,2.189.345.238
10/04/2017 03:00,23.1,38227,2468,135,155,2943,19,5720,2.189.345.238
10/04/2017 04:00,23.89,38977,2484,141,130,2941,21,5717,2.189.345.238
10/04/2017 05:00,25.76,40766,2629,145,130,2929,22,5855,2.189.345.238
10/04/2017 06:00,27.54,44089,2886,152,150,2911,26,6125,2.189.345.238
10/04/2017 07:00,28.75,47338,3148,159,160,2897,34,6398,2.189.345.238
10/04/2017 08:00,28.83,48531,3327,174,165,3013,45,6724,2.189.345.238
10/04/2017 09:00,28.62,48005,3497,190,190,3043,52,6972,2.189.345.238
10/04/2017 10:00,28.25,47932,3654,204,222,3238,61,7379,2.189.345.238
10/04/2017 11:00,27.64,47546,3810,217,255,3572,63,7917,2.189.345.238
10/04/2017 12:00,26.64,47215,3966,227,290,3839,63,8385,2.189.345.238
10/04/2017 13:00,26.14,46861,4093,233,320,4031,61,8738,2.189.345.238
10/04/2017 14:00,25,46387,4179,234,335,4055,60,8863,2.189.345.238
10/04/2017 15:00,25.17,45874,4236,233,330,4156,59,9014,2.189.345.238
10/04/2017 16:00,24.94,45554,4274,233,315,4185,45,9052,2.189.345.238
10/04/2017 17:00,25.96,45791,4327,226,300,4190,28,9071,2.189.345.238
10/04/2017 18:00,26.26,45941,4308,211,275,4208,17,9019,2.189.345.238
10/04/2017 19:00,26.69,46138,4235,186,255,4285,11,8972,2.189.345.238
10/04/2017 20:00,26.41,46184,4242,152,240,4447,11,9092,2.189.345.238
10/04/2017 21:00,26.06,45586,4266,124,240,4504,10,9144,2.189.345.238
10/04/2017 22:00,24.45,43784,4300,130,240,4562,8,9240,2.189.345.238
10/04/2017 23:00,22.99,41660,4319,144,284,4695,18,9460,2.189.345.238
11/04/2017 00:00,22.51,39984,4378,136,286,4700,19,9519,2.189.345.238
11/04/2017 01:00,21.03,39199,4382,130,290,4736,19,9557,2.189.345.238
11/04/2017 02:00,20.08,38982,4345,127,298,4769,21,9560,2.189.345.238
11/04/2017 03:00,20.1,39264,4286,123,312,4769,18,9508,2.189.345.238
11/04/2017 04:00,21.67,39991,4222,108,329,4766,19,9444,2.189.345.238
11/04/2017 05:00,23.58,41954,4145,91,342,4725,18,9321,2.189.345.238
11/04/2017 06:00,25.63,45289,3990,75,353,4625,19,9062,2.189.345.238
11/04/2017 07:00,27.49,48539,3767,68,350,4524,19,8728,2.189.345.238
11/04/2017 08:00,27.71,49171,3630,69,350,4476,16,8541,2.189.345.238
11/04/2017 09:00,27.52,49074,3587,76,349,4464,27,8503,2.189.345.238
11/04/2017 10:00,27.4,48975,3594,93,349,4457,35,8528,2.189.345.238
11/04/2017 11:00,27.1,48619,3561,110,362,4392,36,8461,2.189.345.238
11/04/2017 12:00,26.94,48218,3505,132,367,4328,34,8366,2.189.345.238
11/04/2017 13:00,26.81,47657,3500,152,368,4236,37,8293,2.189.345.238
11/04/2017 14:00,26.35,47187,3496,166,362,4138,37,8199,2.189.345.238
11/04/2017 15:00,26.16,46728,3406,176,356,3995,37,7970,2.189.345.238
11/04/2017 16:00,26.48,46410,3258,182,346,3744,30,7560,2.189.345.238
11/04/2017 17:00,27.03,46750,3177,178,322,3252,24,6953,2.189.345.238
11/04/2017 18:00,27.54,47046,2983,175,293,2789,20,6260,2.189.345.238
11/04/2017 19:00,28,47383,2718,170,274,2341,20,5523,2.189.345.238
11/04/2017 20:00,27.92,47607,2688,163,246,2031,22,5150,2.189.345.238
11/04/2017 21:00,27.61,47022,2779,158,234,1940,25,5136,2.189.345.238
11/04/2017 22:00,26.3,45153,2959,130,222,1822,30,5163,2.189.345.238
11/04/2017 23:00,25.42,42920,3133,130,222,1609,16,5110,2.189.345.238
12/04/2017 00:00,25.76,41158,2994,123,211,1502,15,4845,2.189.345.238
12/04/2017 01:00,24.91,40310,3078,111,193,1385,13,4780,2.189.345.238
12/04/2017 02:00,24.88,40021,3070,93,187,1360,10,4720,2.189.345.238
12/04/2017 03:00,25.14,40180,2928,77,184,1340,8,4537,2.189.345.238
12/04/2017 04:00,25.57,41082,2941,63,180,1348,9,4541,2.189.345.238
12/04/2017 05:00,25.76,42886,3001,52,175,1323,7,4558,2.189.345.238
12/04/2017 06:00,28.09,46120,2970,44,165,1325,5,4509,2.189.345.238
12/04/2017 07:00,28.84,49398,2867,38,160,1324,8,4397,2.189.345.238
12/04/2017 08:00,28.89,49559,2800,33,163,1352,10,4358,2.189.345.238
12/04/2017 09:00,28.83,49675,2860,30,179,1365,12,4446,2.189.345.238
12/04/2017 10:00,28.64,49622,3024,29,206,1415,20,4694,2.189.345.238
12/04/2017 11:00,28.07,49414,3118,29,231,1444,21,4843,2.189.345.238
12/04/2017 12:00,27.85,49032,3197,30,247,1473,22,4969,2.189.345.238
12/04/2017 13:00,27.71,48488,3260,22,259,1472,27,5040,2.189.345.238
12/04/2017 14:00,27.34,48084,3285,15,265,1491,23,5079,2.189.345.238
12/04/2017 15:00,27.33,47610,3259,12,268,1468,16,5023,2.189.345.238
12/04/2017 16:00,27.07,47329,3273,12,269,1386,10,4950,2.189.345.238
12/04/2017 17:00,27.44,47442,3366,15,266,1361,7,5015,2.189.345.238
12/04/2017 18:00,28.18,47580,3376,20,265,1271,8,4940,2.189.345.238
12/04/2017 19:00,28.38,47688,3298,25,265,1263,10,4861,2.189.345.238
12/04/2017 20:00,28.19,47659,3312,29,261,1296,11,4909,2.189.345.238
12/04/2017 21:00,27.89,47180,3369,33,247,1347,10,5006,2.189.345.238
12/04/2017 22:00,26.89,45088,3390,48,240,1356,9,5043,2.189.345.238
12/04/2017 23:00,24.72,43202,3363,62,257,1372,16,5070,2.189.345.238
13/04/2017 00:00,25.28,41607,3271,70,237,1366,11,4955,2.189.345.238
13/04/2017 01:00,24.66,40744,3312,83,217,1363,9,4984,2.189.345.238
13/04/2017 02:00,24.46,40477,3296,99,199,1383,9,4986,2.189.345.238
13/04/2017 03:00,24.46,40607,3249,115,181,1394,13,4952,2.189.345.238
13/04/2017 04:00,25.26,41326,3248,122,165,1386,18,4939,2.189.345.238
13/04/2017 05:00,26.29,42814,3197,124,146,1365,18,4850,2.189.345.238
13/04/2017 06:00,27.89,44743,3111,123,130,1312,18,4694,2.189.345.238
13/04/2017 07:00,28.25,46775,3039,122,126,1208,20,4515,2.189.345.238
13/04/2017 08:00,28.58,46636,3017,120,131,1087,25,4380,2.189.345.238
13/04/2017 09:00,28.69,47402,3012,113,137,985,27,4274,2.189.345.238
13/04/2017 10:00,28.64,47881,2986,99,139,861,27,4112,2.189.345.238
13/04/2017 11:00,28.45,47801,2934,81,141,764,24,3944,2.189.345.238
13/04/2017 12:00,27.77,47410,2861,64,141,725,22,3813,2.189.345.238
13/04/2017 13:00,27.51,46736,2794,54,137,663,22,3670,2.189.345.238
13/04/2017 14:00,27.07,46211,2753,47,131,645,19,3595,2.189.345.238
13/04/2017 15:00,27.15,45782,2738,44,121,628,18,3549,2.189.345.238
13/04/2017 16:00,27.6,45746,2751,43,113,640,14,3561,2.189.345.238
13/04/2017 17:00,28.07,46084,2735,40,109,651,9,3544,2.189.345.238
13/04/2017 18:00,28.26,46511,2710,39,102,749,6,3606,2.189.345.238
13/04/2017 19:00,28.34,46711,2743,34,91,831,4,3703,2.189.345.238
13/04/2017 20:00,28.22,46618,2793,30,82,915,3,3823,2.189.345.238
13/04/2017 21:00,27.87,46439,2893,29,68,1064,3,4057,2.189.345.238
13/04/2017 22:00,27.58,45202,3057,25,59,1167,3,4311,2.189.345.238
13/04/2017 23:00,27.11,43230,3188,23,51,1337,4,4603,2.189.345.238
14/04/2017 00:00,26.99,41328,3480,20,26,1386,4,4916,2.189.345.238
14/04/2017 01:00,26.29,40492,3512,20,21,1461,3,5017,2.189.345.238
14/04/2017 02:00,26.19,40200,3485,22,13,1517,2,5039,2.189.345.238
14/04/2017 03:00,26.27,40176,3449,24,11,1566,2,5052,2.189.345.238
14/04/2017 04:00,26.24,40423,3485,22,9,1571,2,5089,2.189.345.238
14/04/2017 05:00,26.39,40706,3400,19,8,1606,3,5036,2.189.345.238
14/04/2017 06:00,26.53,41163,3216,16,8,1615,2,4857,2.189.345.238
14/04/2017 07:00,27.5,42251,2962,15,9,1597,2,4585,2.189.345.238
14/04/2017 08:00,28.48,43356,2745,15,9,1621,2,4392,2.189.345.238
14/04/2017 09:00,28.35,44547,2648,15,8,1622,2,4295,2.189.345.238
14/04/2017 10:00,27.97,45292,2718,17,8,1609,3,4355,2.189.345.238
14/04/2017 11:00,27.88,45301,2665,20,7,1568,2,4262,2.189.345.238
14/04/2017 12:00,27.29,44876,2385,22,8,1456,4,3875,2.189.345.238
14/04/2017 13:00,27.64,44356,2128,23,8,1414,3,3576,2.189.345.238
14/04/2017 14:00,27.26,44044,1937,21,10,1291,5,3264,2.189.345.238
14/04/2017 15:00,27.52,43964,1688,19,14,1157,7,2885,2.189.345.238
14/04/2017 16:00,28.19,44058,1516,18,20,981,6,2541,2.189.345.238
14/04/2017 17:00,28.86,44622,1313,17,35,827,6,2198,2.189.345.238
14/04/2017 18:00,29.37,45148,1057,18,35,699,5,1814,2.189.345.238
14/04/2017 19:00,30.08,45311,837,18,35,606,4,1500,2.189.345.238
14/04/2017 20:00,29.97,45598,683,18,33,603,3,1340,2.189.345.238
14/04/2017 21:00,29.63,45873,609,18,27,615,3,1272,2.189.345.238
14/04/2017 22:00,29.19,44955,601,16,20,657,2,1296,2.189.345.238
14/04/2017 23:00,28.73,43123,580,9,23,625,5,1242,2.189.345.238
15/04/2017 00:00,29.49,41826,416,9,22,626,8,1081,2.189.345.238
15/04/2017 01:00,28.9,40980,426,9,23,656,6,1120,2.189.345.238
15/04/2017 02:00,28.39,40719,435,10,24,696,8,1173,2.189.345.238
15/04/2017 03:00,27.13,40755,442,10,24,731,7,1214,2.189.345.238
15/04/2017 04:00,27.53,41028,448,10,24,779,7,1268,2.189.345.238
15/04/2017 05:00,27.25,41324,477,8,24,815,8,1332,2.189.345.238
15/04/2017 06:00,27.57,41605,569,6,20,856,7,1458,2.189.345.238
15/04/2017 07:00,27.57,42531,724,6,17,885,8,1640,2.189.345.238
15/04/2017 08:00,28.07,44207,900,9,15,948,8,1880,2.189.345.238
15/04/2017 09:00,28.53,45237,1102,14,13,1020,7,2156,2.189.345.238
15/04/2017 10:00,28.62,45615,1520,18,12,1102,7,2659,2.189.345.238
15/04/2017 11:00,28.37,45247,1880,21,12,1192,8,3113,2.189.345.238
15/04/2017 12:00,27.93,44836,2137,23,12,1282,8,3462,2.189.345.238
15/04/2017 13:00,27.63,44400,2458,25,12,1371,6,3872,2.189.345.238
15/04/2017 14:00,27.14,44006,2572,26,14,1373,8,3993,2.189.345.238
15/04/2017 15:00,26.88,43758,2581,26,15,1349,12,3983,2.189.345.238
15/04/2017 16:00,26.82,43923,2597,26,17,1319,13,3972,2.189.345.238
15/04/2017 17:00,27.33,44379,2549,25,23,1270,13,3880,2.189.345.238
15/04/2017 18:00,27.59,44807,2375,24,34,1243,11,3687,2.189.345.238
15/04/2017 19:00,27.8,44961,2230,23,66,1206,7,3532,2.189.345.238
15/04/2017 20:00,28.13,45280,2075,22,86,1149,5,3337,2.189.345.238
15/04/2017 21:00,28.04,45713,1875,21,110,1120,7,3133,2.189.345.238
15/04/2017 22:00,27.45,44825,1640,15,159,1082,5,2901,2.189.345.238
15/04/2017 23:00,27.15,43134,1446,15,0,1086,15,2562,2.189.345.238
16/04/2017 00:00,28.04,41823,722,15,0,1003,13,1753,2.189.345.238
16/04/2017 01:00,27.91,41295,658,14,0,907,13,1592,2.189.345.238
16/04/2017 02:00,27.85,41097,550,14,0,863,13,1440,2.189.345.238
16/04/2017 03:00,27.77,41102,460,15,0,802,11,1288,2.189.345.238
16/04/2017 04:00,27.83,41350,360,18,0,756,8,1142,2.189.345.238
16/04/2017 05:00,28,41560,261,21,0,691,5,978,2.189.345.238
16/04/2017 06:00,28.02,41835,193,26,0,661,4,884,2.189.345.238
16/04/2017 07:00,27.95,42309,147,34,0,559,3,743,2.189.345.238
16/04/2017 08:00,28.17,43216,124,42,0,449,9,624,2.189.345.238
16/04/2017 09:00,28.17,44254,141,49,0,390,11,591,2.189.345.238
16/04/2017 10:00,28.31,44824,196,55,0,363,17,631,2.189.345.238
16/04/2017 11:00,28.52,44630,256,57,0,370,22,705,2.189.345.238
16/04/2017 12:00,28.21,44236,299,53,0,356,20,728,2.189.345.238
16/04/2017 13:00,28.04,43816,369,52,0,339,22,782,2.189.345.238
16/04/2017 14:00,27.65,43484,439,50,0,327,27,843,2.189.345.238
16/04/2017 15:00,27.34,43354,535,50,0,321,35,941,2.189.345.238
16/04/2017 16:00,27.39,43433,691,46,0,317,40,1094,2.189.345.238
16/04/2017 17:00,27.77,44002,799,40,0,324,39,1202,2.189.345.238
16/04/2017 18:00,28.87,44473,827,34,0,362,31,1254,2.189.345.238
16/04/2017 19:00,29.73,44890,907,31,0,419,19,1376,2.189.345.238
16/04/2017 20:00,31.13,45578,952,30,0,489,13,1484,2.189.345.238
16/04/2017 21:00,30.97,45650,936,31,0,587,9,1563,2.189.345.238
16/04/2017 22:00,30.31,44428,932,34,0,682,6,1654,2.189.345.238
16/04/2017 23:00,29.23,42797,900,36,82,667,7,1692,2.189.345.238
17/04/2017 00:00,28.77,41886,938,37,76,663,6,1720,2.079.642.857
17/04/2017 01:00,27.75,41363,941,38,66,652,5,1702,2.079.642.857
17/04/2017 02:00,27.43,41248,907,38,57,638,4,1644,2.079.642.857
17/04/2017 03:00,27.14,41427,892,36,51,637,3,1619,2.079.642.857
17/04/2017 04:00,27.23,41741,919,32,42,651,3,1647,2.079.642.857
17/04/2017 05:00,27.58,42097,924,28,30,686,4,1672,2.079.642.857
17/04/2017 06:00,27.86,42542,893,23,23,720,3,1662,2.079.642.857
17/04/2017 07:00,27.82,43425,888,22,19,727,3,1659,2.079.642.857
17/04/2017 08:00,29.05,44263,940,24,17,781,3,1765,2.079.642.857
17/04/2017 09:00,29.7,45252,1023,26,16,853,3,1921,2.079.642.857
17/04/2017 10:00,29.45,45884,1176,30,16,922,3,2147,2.079.642.857
17/04/2017 11:00,28.91,45862,1267,33,16,945,3,2264,2.079.642.857
17/04/2017 12:00,28.21,45379,1258,33,16,932,4,2243,2.079.642.857
17/04/2017 13:00,28.08,44870,1259,34,16,900,6,2215,2.079.642.857
17/04/2017 14:00,27.54,44375,1311,32,16,842,7,2208,2.079.642.857
17/04/2017 15:00,27.67,44066,1423,31,16,835,8,2313,2.079.642.857
17/04/2017 16:00,27.72,44160,1542,29,17,844,7,2439,2.079.642.857
17/04/2017 17:00,27.69,44657,1527,28,18,862,7,2442,2.079.642.857
17/04/2017 18:00,27.93,45120,1450,26,19,886,6,2387,2.079.642.857
17/04/2017 19:00,29.72,45534,1511,27,22,884,4,2448,2.079.642.857
17/04/2017 20:00,30.47,45875,1606,27,26,898,3,2560,2.079.642.857
17/04/2017 21:00,30.3,46176,1699,29,29,881,4,2642,2.079.642.857
17/04/2017 22:00,29.51,45288,1922,26,38,921,3,2910,2.079.642.857
17/04/2017 23:00,28.95,43700,2002,24,38,960,6,3030,2.079.642.857
18/04/2017 00:00,28.84,42438,1723,22,42,941,5,2733,2.079.642.857
18/04/2017 01:00,28.2,41723,1722,22,51,951,4,2750,2.079.642.857
18/04/2017 02:00,27.61,41659,1660,23,58,970,5,2716,2.079.642.857
18/04/2017 03:00,27.27,42047,1641,25,59,990,5,2720,2.079.642.857
18/04/2017 04:00,27.8,42852,1570,28,62,988,5,2653,2.079.642.857
18/04/2017 05:00,29.66,44446,1475,28,64,994,4,2565,2.079.642.857
18/04/2017 06:00,32.5,48339,1432,28,61,965,4,2490,2.079.642.857
18/04/2017 07:00,39.83,51521,1426,27,52,884,4,2393,2.079.642.857
18/04/2017 08:00,42.46,51863,1448,30,49,823,4,2354,2.079.642.857
18/04/2017 09:00,39.23,51675,1624,34,56,848,4,2566,2.079.642.857
18/04/2017 10:00,38.36,51476,1818,38,66,861,4,2787,2.079.642.857
18/04/2017 11:00,37.25,51082,1839,41,66,823,5,2774,2.079.642.857
18/04/2017 12:00,34.48,50662,1811,40,65,810,8,2734,2.079.642.857
18/04/2017 13:00,32.9,50169,1846,36,65,779,14,2740,2.079.642.857
18/04/2017 14:00,30.5,49654,1851,33,66,764,14,2728,2.079.642.857
18/04/2017 15:00,30.02,49070,1796,30,71,781,13,2691,2.079.642.857
18/04/2017 16:00,29.8,48729,1674,30,78,770,13,2565,2.079.642.857
18/04/2017 17:00,30.19,48832,1513,29,84,747,14,2387,2.079.642.857
18/04/2017 18:00,32.14,48840,1295,30,93,719,15,2152,2.079.642.857
18/04/2017 19:00,34.15,48798,1100,28,97,748,11,1984,2.079.642.857
18/04/2017 20:00,33.82,49066,979,25,91,804,8,1907,2.079.642.857
18/04/2017 21:00,33.2,48727,850,23,90,928,7,1898,2.079.642.857
18/04/2017 22:00,31.13,47009,684,16,90,974,7,1771,2.079.642.857
18/04/2017 23:00,29.76,44576,542,19,111,918,7,1597,2.079.642.857
19/04/2017 00:00,29.32,43372,419,16,104,909,6,1454,2.079.642.857
19/04/2017 01:00,29.06,42549,360,11,98,868,7,1344,2.079.642.857
19/04/2017 02:00,29.09,42332,298,8,92,843,8,1249,2.079.642.857
19/04/2017 03:00,29.36,42517,278,7,88,816,8,1197,2.079.642.857
19/04/2017 04:00,29.96,43154,249,6,83,705,7,1050,2.079.642.857
19/04/2017 05:00,31.19,45257,231,5,79,601,7,923,2.079.642.857
19/04/2017 06:00,34.77,49000,202,3,70,505,7,787,2.079.642.857
19/04/2017 07:00,42.38,52455,158,1,61,419,7,646,2.079.642.857
19/04/2017 08:00,43.66,53186,125,1,58,357,6,547,2.079.642.857
19/04/2017 09:00,40.01,52630,114,1,56,354,6,531,2.079.642.857
19/04/2017 10:00,36.79,51911,134,3,57,363,6,563,2.079.642.857
19/04/2017 11:00,34.69,50981,150,4,55,429,7,645,2.079.642.857
19/04/2017 12:00,34.33,49930,165,6,49,532,9,761,2.079.642.857
19/04/2017 13:00,33.56,49432,230,9,40,649,12,940,2.079.642.857
19/04/2017 14:00,32.09,49109,295,10,40,788,15,1148,2.079.642.857
19/04/2017 15:00,31.61,48630,366,11,39,894,15,1325,2.079.642.857
19/04/2017 16:00,31.91,48213,462,11,41,1033,15,1562,2.079.642.857
19/04/2017 17:00,33.14,48242,467,10,40,1185,14,1716,2.079.642.857
19/04/2017 18:00,34.94,48138,386,10,40,1284,12,1732,2.079.642.857
19/04/2017 19:00,34.43,48157,328,8,53,1495,8,1892,2.079.642.857
19/04/2017 20:00,33.13,48272,299,7,57,1678,6,2047,2.079.642.857
19/04/2017 21:00,33,48245,297,6,61,1895,4,2263,2.079.642.857
19/04/2017 22:00,31.45,46530,316,31,63,2180,3,2593,2.079.642.857
19/04/2017 23:00,29.91,44129,339,7,49,2212,3,2610,2.079.642.857
20/04/2017 00:00,28.81,42290,608,11,42,2331,2,2994,2.079.642.857
20/04/2017 01:00,28.56,41367,692,15,38,2385,2,3132,2.079.642.857
20/04/2017 02:00,28.52,41062,783,21,32,2484,2,3322,2.079.642.857
20/04/2017 03:00,28.5,41215,930,30,28,2553,2,3543,2.079.642.857
20/04/2017 04:00,28.64,41756,1136,39,22,2686,2,3885,2.079.642.857
20/04/2017 05:00,28.93,43611,1316,42,17,2821,2,4198,2.079.642.857
20/04/2017 06:00,30.36,47116,1413,44,11,3001,3,4472,2.079.642.857
20/04/2017 07:00,34.1,50372,1486,50,8,3205,3,4752,2.079.642.857
20/04/2017 08:00,34.5,50325,1530,60,7,3437,4,5038,2.079.642.857
20/04/2017 09:00,31.76,50006,1807,71,7,3653,5,5543,2.079.642.857
20/04/2017 10:00,30.58,49652,2198,83,7,3895,7,6190,2.079.642.857
20/04/2017 11:00,30.02,49330,2522,96,8,4102,9,6737,2.079.642.857
20/04/2017 12:00,29.55,48929,2734,109,11,4261,13,7128,2.079.642.857
20/04/2017 13:00,29.31,48763,2903,118,16,4290,17,7344,2.079.642.857
20/04/2017 14:00,29.08,48347,3007,126,25,4375,22,7555,2.079.642.857
20/04/2017 15:00,28.86,47871,3075,136,41,4458,25,7735,2.079.642.857
20/04/2017 16:00,28.83,47475,3160,148,53,4460,29,7850,2.079.642.857
20/04/2017 17:00,28.87,47481,3179,160,69,4389,31,7828,2.079.642.857
20/04/2017 18:00,28.69,47255,3037,176,80,4328,30,7651,2.079.642.857
20/04/2017 19:00,28.59,47016,2874,188,90,4351,26,7529,2.079.642.857
20/04/2017 20:00,28.52,46826,2764,199,102,4365,27,7457,2.079.642.857
20/04/2017 21:00,28.72,46484,2692,204,120,4383,28,7427,2.079.642.857
20/04/2017 22:00,28.09,44742,2676,196,155,4454,33,7514,2.079.642.857
20/04/2017 23:00,27.27,42538,2704,203,229,4696,47,7879,2.079.642.857
21/04/2017 00:00,26.18,41131,2743,197,258,4671,42,7911,2.079.642.857
21/04/2017 01:00,25.6,40226,2789,189,289,4668,44,7979,2.079.642.857
21/04/2017 02:00,25.24,39987,2714,181,312,4650,51,7908,2.079.642.857
21/04/2017 03:00,25.6,40213,2670,168,332,4635,51,7856,2.079.642.857
21/04/2017 04:00,25.94,40825,2798,152,346,4646,50,7992,2.079.642.857
21/04/2017 05:00,26.52,42518,2940,133,358,4619,53,8103,2.079.642.857
21/04/2017 06:00,27.92,45811,2952,119,364,4608,53,8096,2.079.642.857
21/04/2017 07:00,29.39,49212,2992,106,365,4572,53,8088,2.079.642.857
21/04/2017 08:00,29.59,49199,3024,95,366,4625,51,8161,2.079.642.857
21/04/2017 09:00,29.09,49118,3181,87,365,4797,47,8477,2.079.642.857
21/04/2017 10:00,28.65,48916,3443,80,365,4892,45,8825,2.079.642.857
21/04/2017 11:00,28.17,48493,3695,74,372,4997,44,9182,2.079.642.857
21/04/2017 12:00,27.55,47896,3764,69,374,5045,42,9294,2.079.642.857
21/04/2017 13:00,27.27,47084,3811,66,373,5151,47,9448,2.079.642.857
21/04/2017 14:00,27.18,46561,3935,63,370,5139,42,9549,2.079.642.857
21/04/2017 15:00,26.71,45908,4066,61,365,5182,37,9711,2.079.642.857
21/04/2017 16:00,26.49,45649,4211,57,367,5134,38,9807,2.079.642.857
21/04/2017 17:00,26.68,45983,4407,56,372,5074,38,9947,2.079.642.857
21/04/2017 18:00,26.83,45962,4527,61,373,5041,43,10045,2.079.642.857
21/04/2017 19:00,26.93,45628,4420,65,378,4977,30,9870,2.079.642.857
21/04/2017 20:00,26.98,45376,4323,66,380,4989,35,9793,2.079.642.857
21/04/2017 21:00,27.02,45269,4248,61,375,4997,31,9712,2.079.642.857
21/04/2017 22:00,25.82,44231,4195,63,374,4988,27,9647,2.079.642.857
21/04/2017 23:00,24.44,42746,4226,39,411,4946,49,9671,2.079.642.857
22/04/2017 00:00,25.56,41668,4216,34,412,4892,46,9600,2.079.642.857
22/04/2017 01:00,25.01,40799,4267,43,406,4887,46,9649,2.079.642.857
22/04/2017 02:00,24.3,39882,4161,52,400,4873,43,9529,2.079.642.857
22/04/2017 03:00,24.42,39977,4151,60,395,4861,37,9504,2.079.642.857
22/04/2017 04:00,24.38,40085,4095,67,390,4775,42,9369,2.079.642.857
22/04/2017 05:00,24.74,40407,4085,76,383,4701,45,9290,2.079.642.857
22/04/2017 06:00,24.55,40926,4056,91,381,4667,54,9249,2.079.642.857
22/04/2017 07:00,25.43,42069,4017,95,386,4658,57,9213,2.079.642.857
22/04/2017 08:00,26.36,43168,3917,104,392,4705,54,9172,2.079.642.857
22/04/2017 09:00,26.86,44305,3959,113,394,4715,48,9229,2.079.642.857
22/04/2017 10:00,26.77,44673,4038,123,395,4732,46,9334,2.079.642.857
22/04/2017 11:00,26.48,44446,4078,127,398,4703,45,9351,2.079.642.857
22/04/2017 12:00,26.09,43963,3920,125,396,4737,48,9226,2.079.642.857
22/04/2017 13:00,25.74,43501,3652,121,387,4693,49,8902,2.079.642.857
22/04/2017 14:00,25.32,42956,3628,118,376,4610,52,8784,2.079.642.857
22/04/2017 15:00,25.45,42769,3702,119,360,4535,53,8769,2.079.642.857
22/04/2017 16:00,25.33,42936,3601,124,329,4309,57,8420,2.079.642.857
22/04/2017 17:00,25.84,43595,3424,129,299,3879,57,7788,2.079.642.857
22/04/2017 18:00,26.38,43946,3252,129,258,3463,52,7154,2.079.642.857
22/04/2017 19:00,26.77,43637,3004,130,201,3079,49,6463,2.079.642.857
22/04/2017 20:00,27.3,43604,2857,128,157,2875,46,6063,2.079.642.857
22/04/2017 21:00,27.29,43912,2784,128,138,2764,38,5852,2.079.642.857
22/04/2017 22:00,27.2,43232,2836,111,125,2669,39,5780,2.079.642.857
22/04/2017 23:00,25.9,42005,2921,144,136,2535,19,5755,2.079.642.857
23/04/2017 00:00,26.82,40619,2649,140,130,2482,19,5420,2.079.642.857
23/04/2017 01:00,26.33,39869,2680,136,137,2460,18,5431,2.079.642.857
23/04/2017 02:00,26.05,38892,2677,136,133,2471,14,5431,2.079.642.857
23/04/2017 03:00,26.03,38967,2719,135,130,2382,16,5382,2.079.642.857
23/04/2017 04:00,25.96,39137,2878,128,125,2322,12,5465,2.079.642.857
23/04/2017 05:00,25.95,39316,3010,116,117,2207,9,5459,2.079.642.857
23/04/2017 06:00,25.89,39688,3102,106,107,2118,10,5443,2.079.642.857
23/04/2017 07:00,26.26,40613,3269,101,99,2124,15,5608,2.079.642.857
23/04/2017 08:00,27.21,41831,3421,98,99,2113,16,5747,2.079.642.857
23/04/2017 09:00,28.01,42977,3647,101,123,2174,16,6061,2.079.642.857
23/04/2017 10:00,28.06,43652,3857,107,157,2215,18,6354,2.079.642.857
23/04/2017 11:00,27.98,43670,3992,115,180,2331,20,6638,2.079.642.857
23/04/2017 12:00,27.74,43387,3952,122,185,2402,20,6681,2.079.642.857
23/04/2017 13:00,27.04,43082,3623,123,191,2490,18,6445,2.079.642.857
23/04/2017 14:00,26.48,42725,3451,120,190,2592,15,6368,2.079.642.857
23/04/2017 15:00,26.48,42492,3587,115,159,2669,12,6542,2.079.642.857
23/04/2017 16:00,26.66,42625,3541,106,129,2580,8,6364,2.079.642.857
23/04/2017 17:00,27.12,43094,3803,95,91,2395,5,6389,2.079.642.857
23/04/2017 18:00,27.48,43606,3499,83,77,2180,3,5842,2.079.642.857
23/04/2017 19:00,29.01,43827,2992,76,60,1980,2,5110,2.079.642.857
23/04/2017 20:00,29.84,44142,2589,68,50,1892,3,4602,2.079.642.857
23/04/2017 21:00,30.39,44300,2249,62,53,1848,4,4216,2.079.642.857
23/04/2017 22:00,29.85,43516,2017,61,54,1837,5,3974,2.079.642.857
23/04/2017 23:00,29.06,42077,2006,42,43,1865,6,3962,2.079.642.857
24/04/2017 00:00,28.63,41338,1924,34,44,1664,6,3672,1.938.392.857
24/04/2017 01:00,28.06,40619,2047,31,51,1482,7,3618,1.938.392.857
24/04/2017 02:00,27.94,39953,2262,33,54,1358,7,3714,1.938.392.857
24/04/2017 03:00,27.77,40199,2530,31,58,1266,6,3891,1.938.392.857
24/04/2017 04:00,27.68,40799,2672,25,62,1213,6,3978,1.938.392.857
24/04/2017 05:00,29.12,42577,2894,20,60,1214,6,4194,1.938.392.857
24/04/2017 06:00,30.94,45880,3172,14,60,1271,5,4522,1.938.392.857
24/04/2017 07:00,36.36,49000,3494,13,58,1350,5,4920,1.938.392.857
24/04/2017 08:00,37.27,50054,3677,14,59,1511,5,5266,1.938.392.857
24/04/2017 09:00,33.89,48711,3906,14,63,1730,5,5718,1.938.392.857
24/04/2017 10:00,32.44,48689,4076,15,74,1964,6,6135,1.938.392.857
24/04/2017 11:00,31.47,48505,4243,17,88,2192,7,6547,1.938.392.857
24/04/2017 12:00,30.82,48208,4333,18,103,2314,8,6776,1.938.392.857
24/04/2017 13:00,30.75,47964,4364,17,117,2464,9,6971,1.938.392.857
24/04/2017 14:00,30.06,47668,4414,16,129,2625,12,7196,1.938.392.857
24/04/2017 15:00,29.63,47067,4426,14,138,2735,13,7326,1.938.392.857
24/04/2017 16:00,29.54,46710,4430,15,156,2806,13,7420,1.938.392.857
24/04/2017 17:00,29.99,46858,4474,15,174,2905,11,7579,1.938.392.857
24/04/2017 18:00,31.02,46726,4366,26,198,2881,13,7484,1.938.392.857
24/04/2017 19:00,31.93,46654,3995,39,221,2950,18,7223,1.938.392.857
24/04/2017 20:00,31.13,46752,3710,55,246,2990,22,7023,1.938.392.857
24/04/2017 21:00,30.91,46898,3448,75,270,3037,29,6859,1.938.392.857
24/04/2017 22:00,30.04,45659,3227,84,272,3085,37,6705,1.938.392.857
24/04/2017 23:00,28.89,43775,3029,137,330,3090,47,6633,1.938.392.857
25/04/2017 00:00,28.82,42110,1819,152,330,3111,43,5455,1.938.392.857
25/04/2017 01:00,28.75,41113,1692,161,325,3105,39,5322,1.938.392.857
25/04/2017 02:00,28.65,40741,1507,160,310,3126,25,5128,1.938.392.857
25/04/2017 03:00,28.67,40891,1365,156,280,3148,16,4965,1.938.392.857
25/04/2017 04:00,28.78,41403,1308,152,230,3134,12,4836,1.938.392.857
25/04/2017 05:00,29.32,43119,1284,146,180,3120,12,4742,1.938.392.857
25/04/2017 06:00,35.31,46394,1254,145,145,3093,12,4649,1.938.392.857
25/04/2017 07:00,39.42,49364,1283,144,115,3060,13,4615,1.938.392.857
25/04/2017 08:00,40.1,50635,1340,138,100,2987,14,4579,1.938.392.857
25/04/2017 09:00,40.09,50476,1493,132,90,2907,13,4635,1.938.392.857
25/04/2017 10:00,39.47,50519,1654,123,80,2914,14,4785,1.938.392.857
25/04/2017 11:00,37.7,50252,1746,113,70,2910,14,4853,1.938.392.857
25/04/2017 12:00,36.15,49909,1701,102,70,2957,14,4844,1.938.392.857
25/04/2017 13:00,34.96,49507,1667,92,65,2972,18,4814,1.938.392.857
25/04/2017 14:00,31.15,49104,1648,86,65,3037,23,4859,1.938.392.857
25/04/2017 15:00,30.79,48619,1571,74,60,3073,24,4802,1.938.392.857
25/04/2017 16:00,32.22,48274,1497,62,60,2979,25,4623,1.938.392.857
25/04/2017 17:00,34.57,48332,1373,52,60,2762,27,4274,1.938.392.857
25/04/2017 18:00,37.21,48182,1142,48,60,2600,27,3877,1.938.392.857
25/04/2017 19:00,39.25,48127,1054,48,60,2467,25,3654,1.938.392.857
25/04/2017 20:00,38.79,48128,1042,50,60,2390,26,3568,1.938.392.857
25/04/2017 21:00,39.35,48009,1004,52,65,2406,30,3557,1.938.392.857
25/04/2017 22:00,35.81,46517,1012,69,70,2424,33,3608,1.938.392.857
25/04/2017 23:00,31.36,44482,931,67,90,2456,19,3563,1.938.392.857
26/04/2017 00:00,29.8,42278,1070,79,105,2398,19,3671,1.938.392.857
26/04/2017 01:00,29.54,41129,983,88,125,2377,20,3593,1.938.392.857
26/04/2017 02:00,29.49,40732,832,100,160,2348,20,3460,1.938.392.857
26/04/2017 03:00,29.45,41143,693,114,180,2346,21,3354,1.938.392.857
26/04/2017 04:00,29.62,42009,576,126,200,2259,24,3185,1.938.392.857
26/04/2017 05:00,31.25,43821,472,132,225,2175,27,3031,1.938.392.857
26/04/2017 06:00,39.08,47184,376,133,250,2110,33,2902,1.938.392.857
26/04/2017 07:00,42.86,50671,270,133,270,1987,36,2696,1.938.392.857
26/04/2017 08:00,52.09,50800,171,135,295,1922,38,2561,1.938.392.857
26/04/2017 09:00,45.04,50632,154,141,300,1860,38,2493,1.938.392.857
26/04/2017 10:00,43.33,50385,147,151,300,1707,36,2341,1.938.392.857
26/04/2017 11:00,40.57,49892,150,161,295,1816,30,2452,1.938.392.857
26/04/2017 12:00,41.91,49423,150,171,260,1699,25,2305,1.938.392.857
26/04/2017 13:00,40.59,49194,169,177,230,1722,21,2319,1.938.392.857
26/04/2017 14:00,36.59,48818,198,185,200,1742,18,2343,1.938.392.857
26/04/2017 15:00,36.02,48345,232,186,160,1811,16,2405,1.938.392.857
26/04/2017 16:00,35.98,48002,304,181,115,1763,14,2377,1.938.392.857
26/04/2017 17:00,39.99,48027,319,170,85,1686,12,2272,1.938.392.857
26/04/2017 18:00,39.44,47803,289,155,60,1570,11,2085,1.938.392.857
26/04/2017 19:00,38.91,47622,312,141,40,1488,9,1990,1.938.392.857
26/04/2017 20:00,36.53,47585,335,127,25,1472,8,1967,1.938.392.857
26/04/2017 21:00,38.42,47597,338,116,25,1528,8,2015,1.938.392.857
26/04/2017 22:00,36,46158,341,95,20,1521,7,1984,1.938.392.857
26/04/2017 23:00,31.24,44041,320,108,20,1552,7,2007,1.938.392.857
27/04/2017 00:00,30.53,42295,683,99,21,1689,7,2499,1.938.392.857
27/04/2017 01:00,30.15,41013,788,92,21,1628,7,2536,1.938.392.857
27/04/2017 02:00,29.98,40694,834,86,21,1578,8,2527,1.938.392.857
27/04/2017 03:00,29.96,41004,857,79,21,1541,9,2507,1.938.392.857
27/04/2017 04:00,30.35,41741,823,72,21,1437,9,2362,1.938.392.857
27/04/2017 05:00,31.59,43561,766,62,21,1262,8,2119,1.938.392.857
27/04/2017 06:00,38.77,46920,697,55,19,1134,7,1912,1.938.392.857
27/04/2017 07:00,41.83,50188,585,51,18,946,7,1607,1.938.392.857
27/04/2017 08:00,45.04,49848,511,50,18,815,8,1402,1.938.392.857
27/04/2017 09:00,43.04,49807,585,51,20,770,7,1433,1.938.392.857
27/04/2017 10:00,41.7,49797,701,51,23,791,7,1573,1.938.392.857
27/04/2017 11:00,41.03,49537,836,48,28,824,8,1744,1.938.392.857
27/04/2017 12:00,37.45,49159,993,45,33,842,8,1921,1.938.392.857
27/04/2017 13:00,36.25,49229,1200,39,37,939,10,2225,1.938.392.857
27/04/2017 14:00,33.49,48660,1366,32,39,941,10,2388,1.938.392.857
27/04/2017 15:00,33.14,48169,1458,23,39,927,9,2456,1.938.392.857
27/04/2017 16:00,34.07,47796,1485,18,32,922,9,2466,1.938.392.857
27/04/2017 17:00,35.14,47818,1286,15,28,845,7,2181,1.938.392.857
27/04/2017 18:00,36.57,47567,948,14,25,716,7,1710,1.938.392.857
27/04/2017 19:00,37.48,47316,650,15,23,640,6,1334,1.938.392.857
27/04/2017 20:00,37.58,47107,503,18,21,670,6,1218,1.938.392.857
27/04/2017 21:00,38.64,47018,451,20,20,731,6,1228,1.938.392.857
27/04/2017 22:00,34.41,45471,484,25,19,766,7,1301,1.938.392.857
27/04/2017 23:00,31.39,43247,581,27,11,913,6,1538,1.938.392.857
28/04/2017 00:00,30.9,41875,903,23,12,1019,6,1963,1.938.392.857
28/04/2017 01:00,30.72,41023,898,19,14,1016,5,1952,1.938.392.857
28/04/2017 02:00,30.28,40733,859,14,16,1065,5,1959,1.938.392.857
28/04/2017 03:00,30.34,40916,782,10,18,1121,5,1936,1.938.392.857
28/04/2017 04:00,30.69,41391,708,7,24,1170,5,1914,1.938.392.857
28/04/2017 05:00,31.98,43109,645,3,33,1149,5,1835,1.938.392.857
28/04/2017 06:00,35.52,46360,614,1,36,1143,5,1799,1.938.392.857
28/04/2017 07:00,43.08,49705,601,1,30,1125,4,1761,1.938.392.857
28/04/2017 08:00,44.88,50912,633,1,26,1230,5,1895,1.938.392.857
28/04/2017 09:00,43.92,49394,716,2,28,1353,5,2104,1.938.392.857
28/04/2017 10:00,42.27,49223,834,2,36,1483,6,2361,1.938.392.857
28/04/2017 11:00,42.37,48711,962,4,43,1618,6,2633,1.938.392.857
28/04/2017 12:00,39.78,48176,1064,6,50,1617,6,2743,1.938.392.857
28/04/2017 13:00,38.46,47559,1159,10,60,1623,7,2859,1.938.392.857
28/04/2017 14:00,33.67,46766,1200,17,69,1622,8,2916,1.938.392.857
28/04/2017 15:00,32.52,46137,1205,25,79,1669,8,2986,1.938.392.857
28/04/2017 16:00,33.24,45798,1206,33,91,1689,12,3031,1.938.392.857
28/04/2017 17:00,33.9,45904,1044,41,117,1725,12,2939,1.938.392.857
28/04/2017 18:00,35.29,45913,809,50,132,1724,12,2727,1.938.392.857
28/04/2017 19:00,33.6,45606,638,62,150,1789,14,2653,1.938.392.857
28/04/2017 20:00,33.52,45158,538,70,166,1858,14,2646,1.938.392.857
28/04/2017 21:00,33.59,45100,505,74,178,1886,15,2658,1.938.392.857
28/04/2017 22:00,31.62,44024,527,95,193,1933,18,2766,1.938.392.857
28/04/2017 23:00,30.1,42411,554,125,256,1950,22,2907,1.938.392.857
29/04/2017 00:00,31.3,40851,824,133,250,1950,27,3184,1.938.392.857
29/04/2017 01:00,29.28,39960,846,140,238,1973,34,3231,1.938.392.857
29/04/2017 02:00,29.43,39619,870,147,211,1936,36,3200,1.938.392.857
29/04/2017 03:00,29.43,39526,908,155,192,1903,39,3197,1.938.392.857
29/04/2017 04:00,29.72,39543,965,164,163,1817,41,3150,1.938.392.857
29/04/2017 05:00,30.06,39761,944,174,137,1712,42,3009,1.938.392.857
29/04/2017 06:00,30.9,40265,891,185,118,1625,42,2861,1.938.392.857
29/04/2017 07:00,31.79,41651,879,201,105,1577,39,2801,1.938.392.857
29/04/2017 08:00,31.96,43273,911,217,92,1626,36,2882,1.938.392.857
29/04/2017 09:00,31.84,44353,927,229,92,1685,32,2965,1.938.392.857
29/04/2017 10:00,30.15,44709,864,235,115,1762,22,2998,1.938.392.857
29/04/2017 11:00,29.72,44459,820,235,141,1797,12,3005,1.938.392.857
29/04/2017 12:00,29.63,43946,728,231,168,1816,9,2952,1.938.392.857
29/04/2017 13:00,29.24,43381,619,225,192,1799,8,2843,1.938.392.857
29/04/2017 14:00,28.41,42903,526,215,218,1701,7,2667,1.938.392.857
29/04/2017 15:00,28.18,42678,461,197,246,1633,7,2544,1.938.392.857
29/04/2017 16:00,27.92,42824,430,179,268,1527,6,2410,1.938.392.857
29/04/2017 17:00,29.42,43347,379,155,282,1447,9,2272,1.938.392.857
29/04/2017 18:00,30.97,43595,318,131,276,1329,11,2065,1.938.392.857
29/04/2017 19:00,33.09,43215,249,107,260,1306,16,1938,1.938.392.857
29/04/2017 20:00,32.82,42918,202,84,248,1325,16,1875,1.938.392.857
29/04/2017 21:00,32.86,43137,217,75,232,1432,14,1970,1.938.392.857
29/04/2017 22:00,31.52,42460,273,65,217,1532,16,2103,1.938.392.857
29/04/2017 23:00,30.12,41257,320,63,136,1394,13,1926,1.938.392.857
30/04/2017 00:00,29.61,40028,457,69,131,1493,16,2166,1.938.392.857
30/04/2017 01:00,28.63,39297,491,74,124,1570,16,2275,1.938.392.857
30/04/2017 02:00,28.09,39087,516,82,116,1617,17,2348,1.938.392.857
30/04/2017 03:00,27.87,39099,563,92,98,1682,15,2450,1.938.392.857
30/04/2017 04:00,27.55,39131,572,105,83,1680,13,2453,1.938.392.857
30/04/2017 05:00,27.58,39506,607,115,70,1673,11,2476,1.938.392.857
30/04/2017 06:00,27.33,39937,663,125,61,1694,11,2554,1.938.392.857
30/04/2017 07:00,28.04,40867,654,136,58,1713,11,2572,1.938.392.857
30/04/2017 08:00,28.43,42069,682,148,55,1721,11,2617,1.938.392.857
30/04/2017 09:00,29.35,42913,820,156,52,1705,12,2745,1.938.392.857
30/04/2017 10:00,29.72,43119,1007,159,51,1718,12,2947,1.938.392.857
30/04/2017 11:00,29.51,43071,1217,159,51,1759,11,3197,1.938.392.857
30/04/2017 12:00,29.08,42587,1344,154,46,1815,10,3369,1.938.392.857
30/04/2017 13:00,28.82,42049,1448,143,41,1826,10,3468,1.938.392.857
30/04/2017 14:00,27.86,41637,1637,123,37,1841,9,3647,1.938.392.857
30/04/2017 15:00,27.78,41416,1906,97,34,1822,8,3867,1.938.392.857
30/04/2017 16:00,27.75,41551,2207,76,28,1806,5,4122,1.938.392.857
30/04/2017 17:00,27.73,42034,2418,60,25,1716,5,4224,1.938.392.857
30/04/2017 18:00,28.07,42478,2502,50,27,1621,4,4204,1.938.392.857
30/04/2017 19:00,28.53,42757,2536,54,31,1604,5,4230,1.938.392.857
30/04/2017 20:00,28.94,42953,2553,65,36,1682,6,4342,1.938.392.857
30/04/2017 21:00,29.01,43425,2626,77,43,1822,6,4574,1.938.392.857
30/04/2017 22:00,27.83,42479,2775,80,51,1934,6,4846,1.938.392.857
30/04/2017 23:00,27.03,40872,2815,88,63,2035,5,5006,1.938.392.857
01/05/2017 00:00,27.16,39258,2869,88,70,2100,5,5132,1.919.642.857
01/05/2017 01:00,26.54,38439,2944,86,75,2136,5,5246,1.919.642.857
01/05/2017 02:00,26.37,38246,2985,83,79,2150,4,5301,1.919.642.857
01/05/2017 03:00,26.39,38252,3068,81,84,2122,4,5359,1.919.642.857
01/05/2017 04:00,26.28,38304,3188,76,83,2025,4,5376,1.919.642.857
01/05/2017 05:00,25.96,38585,3214,62,79,1961,4,5320,1.919.642.857
01/05/2017 06:00,26.27,39067,3206,46,70,1835,4,5161,1.919.642.857
01/05/2017 07:00,26.85,40004,3237,36,52,1798,4,5127,1.919.642.857
01/05/2017 08:00,27.69,41063,3398,32,43,1934,4,5411,1.919.642.857
01/05/2017 09:00,28.06,41570,3226,30,37,2123,4,5420,1.919.642.857
01/05/2017 10:00,28.12,42042,3360,26,39,2299,4,5728,1.919.642.857
01/05/2017 11:00,27.57,41999,3571,23,42,2321,5,5962,1.919.642.857
01/05/2017 12:00,27.06,41615,3522,21,46,2478,7,6074,1.919.642.857
01/05/2017 13:00,26.81,41293,3536,21,53,2514,8,6132,1.919.642.857
01/05/2017 14:00,26.23,40977,3535,21,63,2520,8,6147,1.919.642.857
01/05/2017 15:00,26.36,40575,3693,21,71,2528,10,6323,1.919.642.857
01/05/2017 16:00,26.43,40465,3629,20,74,2423,9,6155,1.919.642.857
01/05/2017 17:00,26.8,40899,3790,19,76,2300,10,6195,1.919.642.857
01/05/2017 18:00,27.26,41142,3571,21,81,2187,9,5869,1.919.642.857
01/05/2017 19:00,28.2,41412,3331,25,81,2076,7,5520,1.919.642.857
01/05/2017 20:00,28.97,41643,3125,29,88,2071,5,5318,1.919.642.857
01/05/2017 21:00,29.5,42549,2942,31,94,2085,5,5157,1.919.642.857
01/05/2017 22:00,28.68,42120,2837,32,98,2126,5,5098,1.919.642.857
01/05/2017 23:00,27.1,40440,2774,34,101,2123,6,5038,1.919.642.857
02/05/2017 00:00,27.52,38766,2867,36,91,2121,6,5121,1.919.642.857
02/05/2017 01:00,27.07,37981,2779,33,85,2105,6,5008,1.919.642.857
02/05/2017 02:00,26.84,37954,2663,30,82,2078,6,4859,1.919.642.857
02/05/2017 03:00,26.93,38196,2614,25,81,2104,6,4830,1.919.642.857
02/05/2017 04:00,27.32,38692,2608,18,80,2051,5,4762,1.919.642.857
02/05/2017 05:00,28.15,39972,2566,10,78,1919,5,4578,1.919.642.857
02/05/2017 06:00,31.89,43644,2517,5,71,1778,6,4377,1.919.642.857
02/05/2017 07:00,35.08,46490,2389,4,58,1743,5,4199,1.919.642.857
02/05/2017 08:00,36.73,46145,2411,5,54,1861,6,4337,1.919.642.857
02/05/2017 09:00,34.01,45812,2508,9,65,1895,7,4484,1.919.642.857
02/05/2017 10:00,33.13,45440,2550,16,76,2013,8,4663,1.919.642.857
02/05/2017 11:00,32.21,44878,2711,24,82,2087,10,4914,1.919.642.857
02/05/2017 12:00,31.19,44437,2855,35,82,2146,9,5127,1.919.642.857
02/05/2017 13:00,30.88,43956,2928,40,82,2171,11,5232,1.919.642.857
02/05/2017 14:00,30.14,43531,2989,50,82,2211,12,5344,1.919.642.857
02/05/2017 15:00,30.13,42993,3068,62,83,2259,12,5484,1.919.642.857
02/05/2017 16:00,30.12,42627,3091,71,82,2181,13,5438,1.919.642.857
02/05/2017 17:00,30.8,42648,2987,75,83,2069,12,5226,1.919.642.857
02/05/2017 18:00,30.97,42544,2723,77,85,1960,10,4855,1.919.642.857
02/05/2017 19:00,31.36,42385,2513,78,93,1882,7,4573,1.919.642.857
02/05/2017 20:00,31.21,42295,2312,78,102,1855,6,4353,1.919.642.857
02/05/2017 21:00,31.26,42458,2180,77,111,1912,6,4286,1.919.642.857
02/05/2017 22:00,30.25,41477,2168,75,122,1937,6,4308,1.919.642.857
02/05/2017 23:00,28,39505,2186,75,139,1992,6,4398,1.919.642.857
03/05/2017 00:00,28.21,37925,2167,74,134,1922,7,4304,1.919.642.857
03/05/2017 01:00,27.59,37131,2126,71,125,1843,7,4172,1.919.642.857
03/05/2017 02:00,27.19,37039,2108,65,117,1806,7,4103,1.919.642.857
03/05/2017 03:00,27.3,37265,2254,57,103,1726,7,4147,1.919.642.857
03/05/2017 04:00,28.19,37776,2464,45,89,1639,6,4243,1.919.642.857
03/05/2017 05:00,29.43,39382,2544,31,70,1451,7,4103,1.919.642.857
03/05/2017 06:00,31.25,42385,2508,20,48,1297,7,3880,1.919.642.857
03/05/2017 07:00,32.89,45481,2441,14,28,1176,7,3666,1.919.642.857
03/05/2017 08:00,33.66,46148,2415,15,23,1068,7,3528,1.919.642.857
03/05/2017 09:00,33.25,45771,2391,18,26,1067,8,3510,1.919.642.857
03/05/2017 10:00,32.82,45378,2350,22,30,1084,10,3496,1.919.642.857
03/05/2017 11:00,31.94,45016,2370,24,32,1133,12,3571,1.919.642.857
03/05/2017 12:00,31.69,44582,2386,27,36,1190,13,3652,1.919.642.857
03/05/2017 13:00,31.52,44391,2399,27,40,1228,15,3709,1.919.642.857
03/05/2017 14:00,30.86,43999,2438,26,45,1284,16,3809,1.919.642.857
03/05/2017 15:00,30.5,43458,2484,24,51,1363,16,3938,1.919.642.857
03/05/2017 16:00,30.43,43164,2435,24,56,1426,17,3958,1.919.642.857
03/05/2017 17:00,30.91,43153,2313,24,63,1422,17,3839,1.919.642.857
03/05/2017 18:00,30.98,42920,2077,25,81,1368,20,3571,1.919.642.857
03/05/2017 19:00,31.16,42817,1934,25,116,1311,17,3403,1.919.642.857
03/05/2017 20:00,31.26,42601,1831,28,146,1313,14,3332,1.919.642.857
03/05/2017 21:00,31.18,42631,1756,33,162,1375,13,3339,1.919.642.857
03/05/2017 22:00,30.25,41357,1802,37,170,1480,11,3500,1.919.642.857
03/05/2017 23:00,27.99,39032,1853,34,202,1565,12,3666,1.919.642.857
04/05/2017 00:00,27.37,36810,1901,31,213,1612,12,3769,1.919.642.857
04/05/2017 01:00,26.82,35922,1967,36,221,1681,10,3915,1.919.642.857
04/05/2017 02:00,26.55,35850,2109,41,232,1788,10,4180,1.919.642.857
04/05/2017 03:00,26.62,36089,2388,45,236,1921,10,4600,1.919.642.857
04/05/2017 04:00,26.69,36544,2754,41,246,1983,8,5032,1.919.642.857
04/05/2017 05:00,27.04,38090,2983,31,254,1954,8,5230,1.919.642.857
04/05/2017 06:00,30.16,41524,3091,21,242,1947,8,5309,1.919.642.857
04/05/2017 07:00,32.11,45112,3120,15,229,1969,9,5342,1.919.642.857
04/05/2017 08:00,32.97,45590,3336,17,217,2034,17,5621,1.919.642.857
04/05/2017 09:00,31.98,45249,3509,20,224,2077,23,5853,1.919.642.857
04/05/2017 10:00,31.54,44945,3566,22,230,2136,29,5983,1.919.642.857
04/05/2017 11:00,31.12,44609,3564,24,237,2244,28,6097,1.919.642.857
04/05/2017 12:00,30.77,44219,3526,24,244,2343,27,6164,1.919.642.857
04/05/2017 13:00,30.47,44028,3452,24,248,2416,30,6170,1.919.642.857
04/05/2017 14:00,30.06,43573,3423,23,260,2515,28,6249,1.919.642.857
04/05/2017 15:00,29.81,43035,3408,22,258,2547,26,6261,1.919.642.857
04/05/2017 16:00,29.71,42725,3357,19,251,2588,26,6241,1.919.642.857
04/05/2017 17:00,30.06,42752,3256,17,244,2609,23,6149,1.919.642.857
04/05/2017 18:00,30.34,42523,3058,19,247,2590,23,5937,1.919.642.857
04/05/2017 19:00,30.39,42327,2835,20,243,2617,17,5732,1.919.642.857
04/05/2017 20:00,30.18,42113,2579,21,241,2708,15,5564,1.919.642.857
04/05/2017 21:00,30.23,42169,2382,20,245,2776,14,5437,1.919.642.857
04/05/2017 22:00,29.57,41061,2307,19,244,2888,13,5471,1.919.642.857
04/05/2017 23:00,27.48,38967,2197,14,259,3132,13,5615,1.919.642.857
05/05/2017 00:00,27.95,36890,2605,12,252,3174,13,6056,1.919.642.857
05/05/2017 01:00,27.16,36111,2566,12,248,3213,12,6051,1.919.642.857
05/05/2017 02:00,26.9,35912,2537,13,246,3249,12,6057,1.919.642.857
05/05/2017 03:00,26.91,36060,2543,15,247,3268,11,6084,1.919.642.857
05/05/2017 04:00,27.17,36508,2652,19,243,3214,11,6139,1.919.642.857
05/05/2017 05:00,29.46,38082,2705,20,243,3072,11,6051,1.919.642.857
05/05/2017 06:00,30.47,41279,2680,17,227,2867,11,5802,1.919.642.857
05/05/2017 07:00,32.31,44602,2638,14,211,2688,13,5564,1.919.642.857
05/05/2017 08:00,33.37,44698,2620,18,205,2654,15,5512,1.919.642.857
05/05/2017 09:00,32.04,44374,2536,27,198,2598,15,5374,1.919.642.857
05/05/2017 10:00,31.74,44226,2387,37,190,2568,13,5195,1.919.642.857
05/05/2017 11:00,31.17,43801,2300,47,174,2622,11,5154,1.919.642.857
05/05/2017 12:00,30.88,43261,2249,58,163,2530,10,5010,1.919.642.857
05/05/2017 13:00,30.9,42560,2131,67,160,2497,11,4866,1.919.642.857
05/05/2017 14:00,30.55,41738,1945,76,129,2485,10,4645,1.919.642.857
05/05/2017 15:00,30.33,41160,1716,84,109,2435,10,4354,1.919.642.857
05/05/2017 16:00,30.39,40770,1470,88,68,2422,10,4058,1.919.642.857
05/05/2017 17:00,30.9,40720,1251,91,62,2357,9,3770,1.919.642.857
05/05/2017 18:00,31.23,40699,1057,95,60,2331,9,3552,1.919.642.857
05/05/2017 19:00,31.08,40298,890,98,63,2260,7,3318,1.919.642.857
05/05/2017 20:00,30.6,39717,766,99,70,2336,7,3278,1.919.642.857
05/05/2017 21:00,30.46,39853,651,98,59,2409,7,3224,1.919.642.857
05/05/2017 22:00,30.35,39060,548,95,65,2396,6,3110,1.919.642.857
05/05/2017 23:00,29.84,37442,445,100,0,2332,6,2883,1.919.642.857
06/05/2017 00:00,29.6,35516,405,101,0,2149,6,2661,1.919.642.857
06/05/2017 01:00,29.03,34581,324,100,0,2016,6,2446,1.919.642.857
06/05/2017 02:00,28.83,34195,269,99,0,1850,6,2224,1.919.642.857
06/05/2017 03:00,28.65,34231,235,94,0,1805,7,2141,1.919.642.857
06/05/2017 04:00,28.63,34269,221,77,0,1547,8,1853,1.919.642.857
06/05/2017 05:00,28.92,34426,176,53,0,1315,8,1552,1.919.642.857
06/05/2017 06:00,28.96,34965,125,41,0,1067,7,1240,1.919.642.857
06/05/2017 07:00,30.08,36277,92,39,0,849,7,987,1.919.642.857
06/05/2017 08:00,31.04,38022,69,41,0,684,8,802,1.919.642.857
06/05/2017 09:00,31.75,38584,58,47,0,535,8,648,1.919.642.857
06/05/2017 10:00,31.36,39121,51,53,0,480,8,592,1.919.642.857
06/05/2017 11:00,30.49,38900,55,57,0,492,8,612,1.919.642.857
06/05/2017 12:00,30.63,38455,72,55,0,529,9,665,1.919.642.857
06/05/2017 13:00,30,37965,94,52,0,572,10,728,1.919.642.857
06/05/2017 14:00,29.41,37586,106,48,0,597,11,762,1.919.642.857
06/05/2017 15:00,28.83,37381,126,46,0,659,12,843,1.919.642.857
06/05/2017 16:00,28.83,37502,162,43,0,709,13,927,1.919.642.857
06/05/2017 17:00,30.27,37954,176,40,0,787,13,1016,1.919.642.857
06/05/2017 18:00,31.38,38254,161,40,0,825,13,1039,1.919.642.857
06/05/2017 19:00,31.29,38027,143,44,0,856,11,1054,1.919.642.857
06/05/2017 20:00,31.25,37597,133,46,0,920,10,1109,1.919.642.857
06/05/2017 21:00,31.7,37871,139,49,0,1030,10,1228,1.919.642.857
06/05/2017 22:00,30.96,37361,153,45,0,1037,11,1246,1.919.642.857
06/05/2017 23:00,30.25,36039,140,40,85,1065,8,1338,1.919.642.857
07/05/2017 00:00,28.18,34308,161,38,85,1090,8,1382,1.919.642.857
07/05/2017 01:00,27.17,33283,150,36,90,1018,9,1303,1.919.642.857
07/05/2017 02:00,27.1,32837,155,35,90,992,8,1280,1.919.642.857
07/05/2017 03:00,26.86,32679,196,35,85,920,9,1245,1.919.642.857
07/05/2017 04:00,26.69,32765,195,33,85,927,8,1248,1.919.642.857
07/05/2017 05:00,26.67,32640,184,25,85,898,9,1201,1.919.642.857
07/05/2017 06:00,26.26,33131,176,17,80,859,9,1141,1.919.642.857
07/05/2017 07:00,26.75,33951,192,15,80,859,10,1156,1.919.642.857
07/05/2017 08:00,28.4,35354,240,17,80,890,12,1239,1.919.642.857
07/05/2017 09:00,29.83,36907,284,20,80,1001,14,1399,1.919.642.857
07/05/2017 10:00,30.22,37993,358,23,80,1119,18,1598,1.919.642.857
07/05/2017 11:00,30.08,38270,472,26,110,1198,20,1826,1.919.642.857
07/05/2017 12:00,29.09,38097,516,28,115,1342,20,2021,1.919.642.857
07/05/2017 13:00,28.33,37829,555,32,130,1437,22,2176,1.919.642.857
07/05/2017 14:00,27.19,37432,617,33,140,1613,24,2427,1.919.642.857
07/05/2017 15:00,26.84,37246,680,33,155,1782,26,2676,1.919.642.857
07/05/2017 16:00,26.68,37335,725,31,170,1890,24,2840,1.919.642.857
07/05/2017 17:00,27.38,37948,725,31,185,1853,25,2819,1.919.642.857
07/05/2017 18:00,29.56,38304,714,33,185,1965,24,2921,1.919.642.857
07/05/2017 19:00,30.38,38537,728,35,190,2013,23,2989,1.919.642.857
07/05/2017 20:00,30.91,38413,782,36,190,2136,22,3166,1.919.642.857
07/05/2017 21:00,31.03,38984,933,37,180,2231,22,3403,1.919.642.857
07/05/2017 22:00,30.44,38477,1200,35,165,2388,25,3813,1.919.642.857
07/05/2017 23:00,27.39,36945,1389,25,130,2756,6,4306,1.919.642.857
08/05/2017 00:00,27.05,36192,1532,24,130,2887,6,4579,1.919.047.619
08/05/2017 01:00,26.03,35185,1919,27,120,2937,7,5010,1.919.047.619
08/05/2017 02:00,25.4,34808,2318,32,100,2975,6,5431,1.919.047.619
08/05/2017 03:00,24.94,34649,2698,36,95,3035,6,5870,1.919.047.619
08/05/2017 04:00,25.24,34944,3081,44,90,3063,7,6285,1.919.047.619
08/05/2017 05:00,27.1,36314,3261,54,80,3126,7,6528,1.919.047.619
08/05/2017 06:00,29.9,39392,3370,66,70,3147,9,6662,1.919.047.619
08/05/2017 07:00,30.8,42839,3457,74,70,3177,8,6786,1.919.047.619
08/05/2017 08:00,31.5,43885,3513,84,80,3300,8,6985,1.919.047.619
08/05/2017 09:00,31.75,44270,3338,92,85,3242,10,6767,1.919.047.619
08/05/2017 10:00,31.71,44447,3040,99,110,3182,15,6446,1.919.047.619
08/05/2017 11:00,31.4,44396,2922,103,125,3080,19,6249,1.919.047.619
08/05/2017 12:00,31.18,44122,2911,101,140,2994,21,6167,1.919.047.619
08/05/2017 13:00,31.05,43987,2870,97,155,2844,19,5985,1.919.047.619
08/05/2017 14:00,30.9,43701,2867,98,175,2737,17,5894,1.919.047.619
08/05/2017 15:00,30.56,43333,2879,100,185,2662,19,5845,1.919.047.619
08/05/2017 16:00,30.3,43176,2767,93,190,2437,28,5515,1.919.047.619
08/05/2017 17:00,31.12,43355,2464,87,205,2195,38,4989,1.919.047.619
08/05/2017 18:00,31.41,43257,2095,83,210,1889,42,4319,1.919.047.619
08/05/2017 19:00,32.01,43082,1722,84,230,1509,43,3588,1.919.047.619
08/05/2017 20:00,32.83,42878,1338,79,250,1265,40,2972,1.919.047.619
08/05/2017 21:00,33.88,43014,1058,74,250,1098,39,2519,1.919.047.619
08/05/2017 22:00,32.99,42129,869,52,250,1100,35,2306,1.919.047.619
08/05/2017 23:00,30.99,40064,683,44,190,969,20,1906,1.919.047.619
09/05/2017 00:00,30.45,38835,735,41,180,947,20,1923,1.919.047.619
09/05/2017 01:00,29.72,38012,711,41,159,958,21,1890,1.919.047.619
09/05/2017 02:00,29.18,37677,633,41,137,982,19,1812,1.919.047.619
09/05/2017 03:00,28.9,37691,624,40,125,981,17,1787,1.919.047.619
09/05/2017 04:00,29.64,38047,580,37,116,925,15,1673,1.919.047.619
09/05/2017 05:00,31,39424,510,32,109,812,13,1476,1.919.047.619
09/05/2017 06:00,33.27,42414,459,28,100,720,15,1322,1.919.047.619
09/05/2017 07:00,40.01,45919,408,25,94,653,15,1195,1.919.047.619
09/05/2017 08:00,42.94,46970,429,24,86,591,16,1146,1.919.047.619
09/05/2017 09:00,43.11,46931,449,26,87,608,19,1189,1.919.047.619
09/05/2017 10:00,41.22,46866,459,28,91,636,25,1239,1.919.047.619
09/05/2017 11:00,39.65,46819,503,28,113,639,26,1309,1.919.047.619
09/05/2017 12:00,39.13,46712,556,30,130,675,26,1417,1.919.047.619
09/05/2017 13:00,35.95,46586,620,30,148,679,24,1501,1.919.047.619
09/05/2017 14:00,34.18,46258,702,33,161,692,24,1612,1.919.047.619
09/05/2017 15:00,35.07,45860,814,35,177,639,22,1687,1.919.047.619
09/05/2017 16:00,33.21,45501,945,35,176,586,19,1761,1.919.047.619
09/05/2017 17:00,34.52,45630,1031,34,153,526,16,1760,1.919.047.619
09/05/2017 18:00,33.92,45437,1070,31,137,480,14,1732,1.919.047.619
09/05/2017 19:00,33.68,45107,1030,26,111,458,11,1636,1.919.047.619
09/05/2017 20:00,34.34,44920,927,22,86,476,9,1520,1.919.047.619
09/05/2017 21:00,35.25,44992,835,19,58,514,8,1434,1.919.047.619
09/05/2017 22:00,33.99,43977,768,13,43,564,7,1395,1.919.047.619
09/05/2017 23:00,31.73,41773,714,8,89,579,6,1396,1.919.047.619
10/05/2017 00:00,31.33,40207,1115,7,68,631,6,1827,1.919.047.619
10/05/2017 01:00,30.67,39369,1240,6,51,688,6,1991,1.919.047.619
10/05/2017 02:00,30.33,39002,1272,6,40,736,6,2060,1.919.047.619
10/05/2017 03:00,30.37,38979,1182,6,31,763,7,1989,1.919.047.619
10/05/2017 04:00,30.82,39268,1149,5,22,762,7,1945,1.919.047.619
10/05/2017 05:00,32.46,40504,1069,4,17,743,7,1840,1.919.047.619
10/05/2017 06:00,37.16,43788,958,3,11,765,7,1744,1.919.047.619
10/05/2017 07:00,43.08,47529,902,4,7,766,8,1687,1.919.047.619
10/05/2017 08:00,47.24,48706,881,5,5,772,7,1670,1.919.047.619
10/05/2017 09:00,42.72,47553,850,7,5,779,8,1649,1.919.047.619
10/05/2017 10:00,38.91,47456,794,9,6,749,8,1566,1.919.047.619
10/05/2017 11:00,38.41,47284,747,11,7,724,9,1498,1.919.047.619
10/05/2017 12:00,35.95,46975,731,14,8,690,12,1455,1.919.047.619
10/05/2017 13:00,35.85,46817,710,15,12,673,12,1422,1.919.047.619
10/05/2017 14:00,34.04,46500,702,17,14,636,14,1383,1.919.047.619
10/05/2017 15:00,33.37,46097,703,20,16,640,13,1392,1.919.047.619
10/05/2017 16:00,34.13,45903,703,19,15,635,12,1384,1.919.047.619
10/05/2017 17:00,37.98,45953,673,18,16,668,11,1386,1.919.047.619
10/05/2017 18:00,40.94,45718,642,16,17,702,11,1388,1.919.047.619
10/05/2017 19:00,41.14,45424,607,14,22,710,9,1362,1.919.047.619
10/05/2017 20:00,37.68,45139,548,13,31,764,7,1363,1.919.047.619
10/05/2017 21:00,38.73,45108,492,15,39,837,7,1390,1.919.047.619
10/05/2017 22:00,36.19,44084,477,12,43,843,7,1382,1.919.047.619
10/05/2017 23:00,32.4,41947,472,14,43,879,6,1414,1.919.047.619
11/05/2017 00:00,31.1,40596,216,14,42,900,6,1178,1.919.047.619
11/05/2017 01:00,30.16,39648,219,14,42,892,6,1173,1.919.047.619
11/05/2017 02:00,29.33,39172,214,14,41,877,6,1152,1.919.047.619
11/05/2017 03:00,29.17,39132,198,14,37,878,6,1133,1.919.047.619
11/05/2017 04:00,29.42,39380,192,11,33,854,7,1097,1.919.047.619
11/05/2017 05:00,30.74,40718,172,9,27,832,6,1046,1.919.047.619
11/05/2017 06:00,34.47,43628,148,8,20,840,5,1021,1.919.047.619
11/05/2017 07:00,41.26,46961,143,8,18,821,6,996,1.919.047.619
11/05/2017 08:00,43.83,47637,146,10,16,840,7,1019,1.919.047.619
11/05/2017 09:00,40.13,47803,145,12,16,880,6,1059,1.919.047.619
11/05/2017 10:00,36.76,47812,136,15,16,911,6,1084,1.919.047.619
11/05/2017 11:00,35.84,47720,136,18,16,925,6,1101,1.919.047.619
11/05/2017 12:00,34.87,47544,170,20,17,902,7,1116,1.919.047.619
11/05/2017 13:00,34.45,47223,224,22,19,872,8,1145,1.919.047.619
11/05/2017 14:00,33.1,46897,266,26,22,832,9,1155,1.919.047.619
11/05/2017 15:00,33.14,46524,333,30,23,810,9,1205,1.919.047.619
11/05/2017 16:00,32.9,46202,462,33,26,788,9,1318,1.919.047.619
11/05/2017 17:00,34.14,46178,636,34,27,748,8,1453,1.919.047.619
11/05/2017 18:00,35.18,45861,838,32,29,763,7,1669,1.919.047.619
11/05/2017 19:00,34.91,45592,1062,31,33,817,6,1949,1.919.047.619
11/05/2017 20:00,32.99,45226,1221,30,38,953,5,2247,1.919.047.619
11/05/2017 21:00,31.62,45163,1358,30,45,1108,6,2547,1.919.047.619
11/05/2017 22:00,30.52,44214,1565,29,50,1183,6,2833,1.919.047.619
11/05/2017 23:00,28.76,42169,1723,30,54,1109,7,2923,1.919.047.619
12/05/2017 00:00,29.91,39790,1701,27,61,1083,6,2878,1.919.047.619
12/05/2017 01:00,28.02,38713,1762,24,70,1101,6,2963,1.919.047.619
12/05/2017 02:00,27.47,38192,1805,22,81,1082,7,2997,1.919.047.619
12/05/2017 03:00,27.48,38060,1943,20,88,1096,7,3154,1.919.047.619
12/05/2017 04:00,27.69,38368,2110,16,88,1130,8,3352,1.919.047.619
12/05/2017 05:00,30,39573,2332,10,88,1032,8,3470,1.919.047.619
12/05/2017 06:00,32.86,42183,2490,7,79,1030,8,3614,1.919.047.619
12/05/2017 07:00,35.1,45401,2599,8,70,958,10,3645,1.919.047.619
12/05/2017 08:00,36.42,46104,2809,11,70,948,10,3848,1.919.047.619
12/05/2017 09:00,34.63,46222,2984,15,78,965,8,4050,1.919.047.619
12/05/2017 10:00,33.32,46182,3135,19,114,1033,7,4308,1.919.047.619
12/05/2017 11:00,32.91,45919,3325,23,134,1071,7,4560,1.919.047.619
12/05/2017 12:00,32.6,45599,3394,23,142,1111,7,4677,1.919.047.619
12/05/2017 13:00,31.55,45201,3397,21,150,1148,8,4724,1.919.047.619
12/05/2017 14:00,30.77,44615,3379,18,158,1182,9,4746,1.919.047.619
12/05/2017 15:00,30.33,44094,3384,13,160,1246,10,4813,1.919.047.619
12/05/2017 16:00,30.38,43750,3338,11,160,1249,13,4771,1.919.047.619
12/05/2017 17:00,30.97,43772,3321,9,160,1295,13,4798,1.919.047.619
12/05/2017 18:00,31.32,43734,3347,8,160,1307,11,4833,1.919.047.619
12/05/2017 19:00,31.36,43220,3330,9,171,1355,11,4876,1.919.047.619
12/05/2017 20:00,31.08,42563,3238,12,182,1511,11,4954,1.919.047.619
12/05/2017 21:00,31.07,42471,3159,15,182,1647,14,5017,1.919.047.619
12/05/2017 22:00,30.51,41784,3136,17,195,1750,13,5111,1.919.047.619
12/05/2017 23:00,30.05,40217,3031,32,216,1808,14,5101,1.919.047.619
13/05/2017 00:00,29.37,37707,2858,37,223,1811,14,4943,1.919.047.619
13/05/2017 01:00,28.91,36616,2749,47,224,1775,11,4806,1.919.047.619
13/05/2017 02:00,28.67,36261,2621,54,222,1669,11,4577,1.919.047.619
13/05/2017 03:00,28.46,36207,2440,55,216,1574,13,4298,1.919.047.619
13/05/2017 04:00,28.09,36142,2322,51,203,1404,12,3992,1.919.047.619
13/05/2017 05:00,28.68,36191,2172,40,170,1143,11,3536,1.919.047.619
13/05/2017 06:00,29.02,36628,1944,26,147,977,11,3105,1.919.047.619
13/05/2017 07:00,30.03,37782,1760,22,116,867,11,2776,1.919.047.619
13/05/2017 08:00,31.94,38308,1587,21,104,821,10,2543,1.919.047.619
13/05/2017 09:00,32.96,39617,1478,20,113,808,11,2430,1.919.047.619
13/05/2017 10:00,31.83,40401,1411,17,117,807,12,2364,1.919.047.619
13/05/2017 11:00,30.9,40465,1341,15,118,827,13,2314,1.919.047.619
13/05/2017 12:00,29.89,40186,1274,14,110,808,11,2217,1.919.047.619
13/05/2017 13:00,28.86,39807,1230,12,102,796,10,2150,1.919.047.619
13/05/2017 14:00,28.08,39351,1224,11,96,788,9,2128,1.919.047.619
13/05/2017 15:00,28.03,39148,1227,10,91,786,11,2125,1.919.047.619
13/05/2017 16:00,28.55,39248,1197,10,88,785,13,2093,1.919.047.619
13/05/2017 17:00,29.76,39751,1138,10,87,874,14,2123,1.919.047.619
13/05/2017 18:00,32.17,39930,1058,10,90,978,16,2152,1.919.047.619
13/05/2017 19:00,31.92,39583,966,13,93,1100,12,2184,1.919.047.619
13/05/2017 20:00,31.51,39101,941,19,100,1206,10,2276,1.919.047.619
13/05/2017 21:00,31.26,39225,944,25,104,1296,10,2379,1.919.047.619
13/05/2017 22:00,31.04,38833,908,37,111,1437,10,2503,1.919.047.619
13/05/2017 23:00,30.05,37420,860,49,113,1362,10,2394,1.919.047.619
14/05/2017 00:00,28.08,36303,739,61,115,1308,10,2233,1.919.047.619
14/05/2017 01:00,27.39,35342,687,65,113,1173,9,2047,1.919.047.619
14/05/2017 02:00,26.44,34869,572,64,108,1094,8,1846,1.919.047.619
14/05/2017 03:00,26.06,34637,436,55,92,1015,10,1608,1.919.047.619
14/05/2017 04:00,25.66,34498,368,44,77,871,8,1368,1.919.047.619
14/05/2017 05:00,25.66,34377,339,31,64,732,7,1173,1.919.047.619
14/05/2017 06:00,26.1,34590,325,20,47,655,7,1054,1.919.047.619
14/05/2017 07:00,26.74,35350,322,14,32,588,6,962,1.919.047.619
14/05/2017 08:00,27.77,35691,288,14,24,572,6,904,1.919.047.619
14/05/2017 09:00,28.72,36904,289,17,22,586,6,920,1.919.047.619
14/05/2017 10:00,29.02,37764,340,19,25,583,5,972,1.919.047.619
14/05/2017 11:00,28.91,38080,386,23,26,608,5,1048,1.919.047.619
14/05/2017 12:00,28.75,38073,475,27,24,626,5,1157,1.919.047.619
14/05/2017 13:00,27.99,37787,565,26,22,661,6,1280,1.919.047.619
14/05/2017 14:00,27.76,37497,627,24,24,689,6,1370,1.919.047.619
14/05/2017 15:00,27.84,37363,638,22,21,754,5,1440,1.919.047.619
14/05/2017 16:00,28.29,37428,606,20,19,780,6,1431,1.919.047.619
14/05/2017 17:00,28.98,37959,531,18,21,807,6,1383,1.919.047.619
14/05/2017 18:00,30.45,38354,442,18,34,834,6,1334,1.919.047.619
14/05/2017 19:00,31.57,38517,343,20,53,860,5,1281,1.919.047.619
14/05/2017 20:00,31.78,38455,291,22,75,936,5,1329,1.919.047.619
14/05/2017 21:00,31.64,38803,288,28,100,1000,5,1421,1.919.047.619
14/05/2017 22:00,30.99,38250,325,25,110,1064,6,1530,1.919.047.619
14/05/2017 23:00,30.26,36547,372,16,102,1019,8,1517,1.919.047.619
15/05/2017 00:00,29.29,35003,306,13,113,1023,8,1463,2.354.642.857
15/05/2017 01:00,27.31,34091,312,14,126,978,8,1438,2.354.642.857
15/05/2017 02:00,26.91,33733,314,14,136,946,9,1419,2.354.642.857
15/05/2017 03:00,26.61,33679,322,12,125,905,9,1373,2.354.642.857
15/05/2017 04:00,26.92,34012,355,12,107,895,10,1379,2.354.642.857
15/05/2017 05:00,29.48,35342,394,11,89,848,8,1350,2.354.642.857
15/05/2017 06:00,32.93,38407,388,9,71,758,8,1234,2.354.642.857
15/05/2017 07:00,33.97,42284,392,7,62,712,11,1184,2.354.642.857
15/05/2017 08:00,36.33,43513,442,7,61,765,13,1288,2.354.642.857
15/05/2017 09:00,35.83,43805,469,8,64,737,13,1291,2.354.642.857
15/05/2017 10:00,34.88,43873,485,11,65,678,12,1251,2.354.642.857
15/05/2017 11:00,33.9,43860,518,16,69,639,11,1253,2.354.642.857
15/05/2017 12:00,33.35,43461,563,21,71,616,11,1282,2.354.642.857
15/05/2017 13:00,33.03,43118,582,25,73,616,13,1309,2.354.642.857
15/05/2017 14:00,32.26,42913,566,30,81,650,14,1341,2.354.642.857
15/05/2017 15:00,31.84,42482,580,38,79,664,13,1374,2.354.642.857
15/05/2017 16:00,31.96,42180,593,47,71,672,10,1393,2.354.642.857
15/05/2017 17:00,33.07,42281,540,60,68,684,9,1361,2.354.642.857
15/05/2017 18:00,33.94,42065,412,74,71,702,8,1267,2.354.642.857
15/05/2017 19:00,34.16,41722,271,85,69,734,10,1169,2.354.642.857
15/05/2017 20:00,32.56,41308,178,93,62,826,10,1169,2.354.642.857
15/05/2017 21:00,32.19,41305,145,94,58,986,12,1295,2.354.642.857
15/05/2017 22:00,31.61,40442,172,90,55,1100,13,1430,2.354.642.857
15/05/2017 23:00,30.21,38377,219,103,65,1076,11,1474,2.354.642.857
16/05/2017 00:00,28.62,35704,416,97,65,1094,10,1682,2.354.642.857
16/05/2017 01:00,27.66,34752,530,91,67,1108,7,1803,2.354.642.857
16/05/2017 02:00,27.04,34488,619,86,67,1182,7,1961,2.354.642.857
16/05/2017 03:00,26.86,34524,819,83,67,1134,7,2110,2.354.642.857
16/05/2017 04:00,26.78,34941,1044,80,68,1100,7,2299,2.354.642.857
16/05/2017 05:00,27.94,36352,1214,72,68,1043,7,2404,2.354.642.857
16/05/2017 06:00,30.99,39905,1333,62,66,1053,7,2521,2.354.642.857
16/05/2017 07:00,33.59,43579,1419,49,62,1015,7,2552,2.354.642.857
16/05/2017 08:00,34.85,44957,1492,40,57,1115,8,2712,2.354.642.857
16/05/2017 09:00,33.38,44895,1560,34,50,1181,8,2833,2.354.642.857
16/05/2017 10:00,32.53,44791,1629,29,47,1306,9,3020,2.354.642.857
16/05/2017 11:00,31.95,44624,1732,26,42,1499,9,3308,2.354.642.857
16/05/2017 12:00,31.65,44492,1869,22,38,1679,9,3617,2.354.642.857
16/05/2017 13:00,31.13,44149,1948,19,35,1929,9,3940,2.354.642.857
16/05/2017 14:00,30.72,43759,1924,19,33,1990,9,3975,2.354.642.857
16/05/2017 15:00,30.49,43281,1948,17,31,2052,10,4058,2.354.642.857
16/05/2017 16:00,30.26,43174,1941,15,29,2150,9,4144,2.354.642.857
16/05/2017 17:00,30.64,43226,1920,13,29,2302,8,4272,2.354.642.857
16/05/2017 18:00,30.91,42839,1864,12,31,2352,6,4265,2.354.642.857
16/05/2017 19:00,30.75,42164,1803,12,37,2497,7,4356,2.354.642.857
16/05/2017 20:00,29.91,41465,1706,13,46,2677,7,4449,2.354.642.857
16/05/2017 21:00,29.43,41057,1604,15,54,2812,9,4494,2.354.642.857
16/05/2017 22:00,28.85,40107,1540,20,65,2883,10,4518,2.354.642.857
16/05/2017 23:00,26.95,37847,1452,26,96,2828,10,4412,2.354.642.857
17/05/2017 00:00,24.96,36061,1140,37,107,2728,10,4022,2.354.642.857
17/05/2017 01:00,24.4,35101,1078,47,109,2642,10,3886,2.354.642.857
17/05/2017 02:00,24.22,34654,971,57,118,2494,9,3649,2.354.642.857
17/05/2017 03:00,24.29,34516,860,64,118,2352,8,3402,2.354.642.857
17/05/2017 04:00,24.7,34630,777,63,114,2153,8,3115,2.354.642.857
17/05/2017 05:00,25.2,35776,688,58,91,1899,9,2745,2.354.642.857
17/05/2017 06:00,27.86,38218,569,50,71,1623,8,2321,2.354.642.857
17/05/2017 07:00,29.1,41151,499,45,56,1375,11,1986,2.354.642.857
17/05/2017 08:00,30.48,41728,435,46,45,1175,13,1714,2.354.642.857
17/05/2017 09:00,30.57,42215,388,47,42,1002,13,1492,2.354.642.857
17/05/2017 10:00,30.08,42635,375,48,39,906,14,1382,2.354.642.857
17/05/2017 11:00,29.58,42653,386,49,37,895,15,1382,2.354.642.857
17/05/2017 12:00,28.89,42315,407,49,35,894,16,1401,2.354.642.857
17/05/2017 13:00,28.8,42030,410,48,33,832,18,1341,2.354.642.857
17/05/2017 14:00,28.26,41689,404,44,30,884,16,1378,2.354.642.857
17/05/2017 15:00,28.12,41269,373,41,28,822,14,1278,2.354.642.857
17/05/2017 16:00,28.13,40921,327,41,26,701,11,1106,2.354.642.857
17/05/2017 17:00,29.18,40820,285,42,26,559,10,922,2.354.642.857
17/05/2017 18:00,30.1,40600,258,45,33,543,11,890,2.354.642.857
17/05/2017 19:00,29.46,40228,265,47,45,525,12,894,2.354.642.857
17/05/2017 20:00,28.68,39642,339,46,52,591,12,1040,2.354.642.857
17/05/2017 21:00,28.62,39512,545,48,57,676,11,1337,2.354.642.857
17/05/2017 22:00,27.97,38854,909,44,63,714,10,1740,2.354.642.857
17/05/2017 23:00,26.68,36973,1330,56,63,785,9,2243,2.354.642.857
18/05/2017 00:00,24.7,35174,2465,45,61,860,9,3440,2.354.642.857
18/05/2017 01:00,23.75,33897,2752,33,58,900,6,3749,2.354.642.857
18/05/2017 02:00,22.84,33542,2827,26,57,958,6,3874,2.354.642.857
18/05/2017 03:00,21.15,33505,2860,21,54,982,5,3922,2.354.642.857
18/05/2017 04:00,22.98,33800,2975,18,52,1016,5,4066,2.354.642.857
18/05/2017 05:00,24.78,35308,3016,15,45,1029,5,4110,2.354.642.857
18/05/2017 06:00,27.58,37803,2893,13,30,1058,5,3999,2.354.642.857
18/05/2017 07:00,29.64,41576,2757,11,24,1117,6,3915,2.354.642.857
18/05/2017 08:00,30.31,42040,2652,10,21,1280,6,3969,2.354.642.857
18/05/2017 09:00,29.82,42306,2604,9,19,1458,7,4097,2.354.642.857
18/05/2017 10:00,29.72,42252,2468,11,16,1671,8,4174,2.354.642.857
18/05/2017 11:00,30.27,41779,2239,12,16,1950,9,4226,2.354.642.857
18/05/2017 12:00,29.74,41590,2044,13,16,2142,9,4224,2.354.642.857
18/05/2017 13:00,29.56,41418,1900,13,17,2349,10,4289,2.354.642.857
18/05/2017 14:00,28.85,41410,1655,13,18,2485,9,4180,2.354.642.857
18/05/2017 15:00,28.52,41100,1419,12,24,2567,9,4031,2.354.642.857
18/05/2017 16:00,28.45,40726,1243,12,30,2576,8,3869,2.354.642.857
18/05/2017 17:00,29.17,40643,1030,12,39,2607,7,3695,2.354.642.857
18/05/2017 18:00,29.4,40321,778,15,55,2583,5,3436,2.354.642.857
18/05/2017 19:00,29.1,39959,624,19,73,2603,7,3326,2.354.642.857
18/05/2017 20:00,28.3,39409,458,25,97,2506,7,3093,2.354.642.857
18/05/2017 21:00,28.08,39160,332,31,126,2415,6,2910,2.354.642.857
18/05/2017 22:00,27.59,38300,284,33,147,2257,8,2729,2.354.642.857
18/05/2017 23:00,26.74,36242,256,41,127,1939,10,2373,2.354.642.857
19/05/2017 00:00,25.58,34623,312,45,128,1640,13,2138,2.354.642.857
19/05/2017 01:00,25.01,33370,313,49,126,1396,14,1898,2.354.642.857
19/05/2017 02:00,24.7,32933,291,52,120,1265,14,1742,2.354.642.857
19/05/2017 03:00,25,32843,268,56,113,1164,13,1614,2.354.642.857
19/05/2017 04:00,25.13,33092,270,54,100,1021,13,1458,2.354.642.857
19/05/2017 05:00,26.42,34412,242,48,84,889,13,1276,2.354.642.857
19/05/2017 06:00,27.9,37385,193,41,65,799,11,1109,2.354.642.857
19/05/2017 07:00,31.24,40882,179,37,49,767,12,1044,2.354.642.857
19/05/2017 08:00,32.26,41568,184,37,42,718,12,993,2.354.642.857
19/05/2017 09:00,31.79,41853,189,39,47,678,14,967,2.354.642.857
19/05/2017 10:00,30.89,41643,207,39,55,696,17,1014,2.354.642.857
19/05/2017 11:00,30.73,41340,225,41,57,744,19,1086,2.354.642.857
19/05/2017 12:00,30.42,40806,243,44,56,807,19,1169,2.354.642.857
19/05/2017 13:00,29.72,40586,271,47,55,885,21,1279,2.354.642.857
19/05/2017 14:00,29,40025,289,45,55,866,18,1273,2.354.642.857
19/05/2017 15:00,28.33,39418,292,40,53,871,17,1273,2.354.642.857
19/05/2017 16:00,27.82,38998,309,33,51,912,11,1316,2.354.642.857
19/05/2017 17:00,27.97,38946,318,26,51,995,8,1398,2.354.642.857
19/05/2017 18:00,27.95,38759,321,21,60,1083,6,1491,2.354.642.857
19/05/2017 19:00,27.76,38233,388,19,76,1082,7,1572,2.354.642.857
19/05/2017 20:00,27.52,37395,435,18,84,1198,6,1741,2.354.642.857
19/05/2017 21:00,27.38,37020,460,19,118,1388,7,1992,2.354.642.857
19/05/2017 22:00,26.51,36490,574,21,128,1569,7,2299,2.354.642.857
19/05/2017 23:00,25.06,34912,653,23,101,1796,9,2582,2.354.642.857
20/05/2017 00:00,23.44,32794,588,25,90,1860,11,2574,2.354.642.857
20/05/2017 01:00,23.04,31682,748,25,85,1756,10,2624,2.354.642.857
20/05/2017 02:00,22.18,31173,909,22,74,1713,10,2728,2.354.642.857
20/05/2017 03:00,20.94,30964,1053,18,63,1581,9,2724,2.354.642.857
20/05/2017 04:00,20.84,30923,1180,13,53,1417,7,2670,2.354.642.857
20/05/2017 05:00,22.57,31056,1317,9,42,1222,7,2597,2.354.642.857
20/05/2017 06:00,23.26,31653,1475,7,28,1042,6,2558,2.354.642.857
20/05/2017 07:00,23.78,33010,1575,8,20,931,5,2539,2.354.642.857
20/05/2017 08:00,24.93,34627,1680,12,17,863,6,2578,2.354.642.857
20/05/2017 09:00,25.04,35501,1696,17,16,885,6,2620,2.354.642.857
20/05/2017 10:00,24.27,36302,1704,19,16,905,7,2651,2.354.642.857
20/05/2017 11:00,24.11,36284,1863,21,16,924,7,2831,2.354.642.857
20/05/2017 12:00,23.83,36065,1939,24,16,989,6,2974,2.354.642.857
20/05/2017 13:00,22.83,35775,1881,26,16,1055,8,2986,2.354.642.857
20/05/2017 14:00,21.97,35547,1783,26,16,1097,7,2929,2.354.642.857
20/05/2017 15:00,22.26,35428,1655,26,16,1156,8,2861,2.354.642.857
20/05/2017 16:00,23.88,35769,1541,26,17,1173,6,2763,2.354.642.857
20/05/2017 17:00,25.07,36243,1406,28,18,1192,6,2650,2.354.642.857
20/05/2017 18:00,25.88,36507,1190,30,19,1203,6,2448,2.354.642.857
20/05/2017 19:00,25.83,36194,947,32,22,1191,7,2199,2.354.642.857
20/05/2017 20:00,25.43,35672,759,34,25,1215,6,2039,2.354.642.857
20/05/2017 21:00,25.53,35567,650,37,26,1208,6,1927,2.354.642.857
20/05/2017 22:00,25.5,35298,566,34,27,1302,8,1937,2.354.642.857
20/05/2017 23:00,25.17,34119,515,41,52,1319,10,1937,2.354.642.857
21/05/2017 00:00,23.09,33212,565,35,49,1362,9,2020,2.354.642.857
21/05/2017 01:00,18.12,32146,579,31,46,1388,8,2052,2.354.642.857
21/05/2017 02:00,14.12,31639,586,25,44,1431,8,2094,2.354.642.857
21/05/2017 03:00,12.18,31258,587,21,41,1369,7,2025,2.354.642.857
21/05/2017 04:00,11.65,31027,624,15,39,1295,6,1979,2.354.642.857
21/05/2017 05:00,11.52,30923,663,10,34,1187,7,1901,2.354.642.857
21/05/2017 06:00,11.98,31314,638,6,27,1075,6,1752,2.354.642.857
21/05/2017 07:00,12.36,32235,608,6,23,956,6,1599,2.354.642.857
21/05/2017 08:00,14.04,33117,642,6,23,877,7,1555,2.354.642.857
21/05/2017 09:00,19.2,34699,787,9,23,889,7,1715,2.354.642.857
21/05/2017 10:00,21.22,35762,992,12,30,987,9,2030,2.354.642.857
21/05/2017 11:00,21.01,36183,1089,16,34,1079,9,2227,2.354.642.857
21/05/2017 12:00,18.96,36240,1082,18,43,1162,9,2314,2.354.642.857
21/05/2017 13:00,17.88,36032,1035,18,55,1269,11,2388,2.354.642.857
21/05/2017 14:00,16.14,35773,922,16,67,1332,13,2350,2.354.642.857
21/05/2017 15:00,16.94,35558,815,16,70,1420,13,2334,2.354.642.857
21/05/2017 16:00,18.84,35849,730,15,74,1442,11,2272,2.354.642.857
21/05/2017 17:00,23.05,36317,633,13,77,1410,8,2141,2.354.642.857
21/05/2017 18:00,24.44,36780,535,12,77,1384,7,2015,2.354.642.857
21/05/2017 19:00,26.26,36918,416,12,77,1427,8,1940,2.354.642.857
21/05/2017 20:00,26.22,36718,324,13,75,1481,7,1900,2.354.642.857
21/05/2017 21:00,25.91,36911,276,13,65,1618,7,1979,2.354.642.857
21/05/2017 22:00,25.48,36544,277,21,56,1756,8,2118,2.354.642.857
21/05/2017 23:00,24.04,34948,294,29,79,1883,7,2292,2.354.642.857
22/05/2017 00:00,23.33,33633,296,31,72,1879,7,2285,2.857.916.667
22/05/2017 01:00,23.13,32647,283,28,64,1882,6,2263,2.857.916.667
22/05/2017 02:00,23.02,32379,253,27,57,1836,6,2179,2.857.916.667
22/05/2017 03:00,22.96,32327,237,24,54,1763,7,2085,2.857.916.667
22/05/2017 04:00,23.21,32576,236,18,53,1690,7,2004,2.857.916.667
22/05/2017 05:00,25.09,34029,221,15,52,1469,8,1765,2.857.916.667
22/05/2017 06:00,28.06,37439,190,14,44,1308,9,1565,2.857.916.667
22/05/2017 07:00,31.86,41227,168,17,40,1212,8,1445,2.857.916.667
22/05/2017 08:00,32.07,41698,157,19,40,1207,8,1431,2.857.916.667
22/05/2017 09:00,31.95,41899,159,24,47,1187,10,1427,2.857.916.667
22/05/2017 10:00,30.83,42143,174,33,58,1266,12,1543,2.857.916.667
22/05/2017 11:00,30.51,42161,178,39,76,1357,12,1662,2.857.916.667
22/05/2017 12:00,30.06,42056,204,45,87,1419,14,1769,2.857.916.667
22/05/2017 13:00,30.03,41939,221,51,97,1452,16,1837,2.857.916.667
22/05/2017 14:00,29.1,41529,230,54,112,1546,14,1956,2.857.916.667
22/05/2017 15:00,29.39,41084,263,56,112,1656,13,2100,2.857.916.667
22/05/2017 16:00,29.34,40678,280,53,108,1695,11,2147,2.857.916.667
22/05/2017 17:00,29.17,40732,257,46,101,1694,9,2107,2.857.916.667
22/05/2017 18:00,28.88,40466,199,38,86,1721,8,2052,2.857.916.667
22/05/2017 19:00,28.49,40046,139,38,75,1647,9,1908,2.857.916.667
22/05/2017 20:00,27.92,39409,105,40,68,1648,8,1869,2.857.916.667
22/05/2017 21:00,27.65,39222,85,42,65,1721,8,1921,2.857.916.667
22/05/2017 22:00,27.38,38368,90,37,63,1821,8,2019,2.857.916.667
22/05/2017 23:00,25.8,36295,104,37,60,1572,9,1782,2.857.916.667
23/05/2017 00:00,24.25,34500,147,35,65,1783,8,2038,2.857.916.667
23/05/2017 01:00,23.91,33359,222,30,70,1757,7,2086,2.857.916.667
23/05/2017 02:00,23.37,32931,285,26,75,1765,6,2157,2.857.916.667
23/05/2017 03:00,23.17,32797,280,22,80,1714,6,2102,2.857.916.667
23/05/2017 04:00,23.81,33068,273,17,75,1563,7,1935,2.857.916.667
23/05/2017 05:00,24.92,34498,314,13,70,1268,7,1672,2.857.916.667
23/05/2017 06:00,27.37,37754,349,12,65,1024,6,1456,2.857.916.667
23/05/2017 07:00,29.07,41748,374,10,65,775,6,1230,2.857.916.667
23/05/2017 08:00,30.29,42570,363,12,70,589,7,1041,2.857.916.667
23/05/2017 09:00,29.91,42733,377,14,80,491,7,969,2.857.916.667
23/05/2017 10:00,28.85,42669,436,15,90,421,8,970,2.857.916.667
23/05/2017 11:00,28.44,42520,500,17,120,389,9,1035,2.857.916.667
23/05/2017 12:00,28.16,42329,531,19,135,359,9,1053,2.857.916.667
23/05/2017 13:00,28.27,42165,646,19,140,320,13,1138,2.857.916.667
23/05/2017 14:00,28.04,41894,808,19,135,304,11,1277,2.857.916.667
23/05/2017 15:00,27.71,41483,862,18,125,283,12,1300,2.857.916.667
23/05/2017 16:00,27.63,41044,977,17,110,261,9,1374,2.857.916.667
23/05/2017 17:00,27.54,41053,1094,16,110,284,7,1511,2.857.916.667
23/05/2017 18:00,27.44,40782,1188,15,80,299,7,1589,2.857.916.667
23/05/2017 19:00,27.38,40465,1339,14,65,336,7,1761,2.857.916.667
23/05/2017 20:00,26.93,39787,1477,13,55,440,7,1992,2.857.916.667
23/05/2017 21:00,26.92,39471,1704,14,55,584,8,2365,2.857.916.667
23/05/2017 22:00,26.47,38562,1930,12,50,724,7,2723,2.857.916.667
23/05/2017 23:00,25.6,36421,1990,10,25,694,5,2724,2.857.916.667
24/05/2017 00:00,22.76,34500,2290,9,20,752,5,3076,2.857.916.667
24/05/2017 01:00,21.91,33392,2356,9,15,773,4,3157,2.857.916.667
24/05/2017 02:00,20.55,32880,2370,7,15,770,4,3166,2.857.916.667
24/05/2017 03:00,20.55,32752,2337,4,15,720,4,3080,2.857.916.667
24/05/2017 04:00,21.6,32949,2321,3,10,651,4,2989,2.857.916.667
24/05/2017 05:00,23.92,34291,2316,2,10,558,5,2891,2.857.916.667
24/05/2017 06:00,27.06,37185,2301,2,8,508,6,2825,2.857.916.667
24/05/2017 07:00,28.51,40918,2444,2,8,427,5,2886,2.857.916.667
24/05/2017 08:00,29.14,41670,2452,2,8,422,6,2890,2.857.916.667
24/05/2017 09:00,29.12,41746,2374,3,11,463,8,2859,2.857.916.667
24/05/2017 10:00,28.68,41733,2287,5,15,528,9,2844,2.857.916.667
24/05/2017 11:00,28.4,41453,2183,7,20,612,9,2831,2.857.916.667
24/05/2017 12:00,28.01,41257,2183,9,30,711,10,2943,2.857.916.667
24/05/2017 13:00,27.77,41105,2196,10,35,831,12,3084,2.857.916.667
24/05/2017 14:00,27.3,40816,2182,11,45,954,10,3202,2.857.916.667
24/05/2017 15:00,26.72,40347,2224,12,55,1161,11,3463,2.857.916.667
24/05/2017 16:00,26.82,39862,2265,11,55,1337,8,3676,2.857.916.667
24/05/2017 17:00,27.19,40072,2383,11,55,1464,8,3921,2.857.916.667
24/05/2017 18:00,27.29,39626,2410,12,55,1541,7,4025,2.857.916.667
24/05/2017 19:00,27.26,39303,2239,12,55,1604,6,3916,2.857.916.667
24/05/2017 20:00,26.79,38750,2059,12,55,1667,6,3799,2.857.916.667
24/05/2017 21:00,26.92,38489,1966,12,50,1786,7,3821,2.857.916.667
24/05/2017 22:00,26.93,37703,1984,20,50,1807,7,3868,2.857.916.667
24/05/2017 23:00,25.65,35836,2019,11,72,1784,5,3891,2.857.916.667
25/05/2017 00:00,24.44,33666,2076,11,70,1759,5,3921,2.857.916.667
25/05/2017 01:00,23.91,32504,2139,13,63,1691,4,3910,2.857.916.667
25/05/2017 02:00,23.65,31975,2146,12,56,1623,4,3841,2.857.916.667
25/05/2017 03:00,23.53,31770,2128,13,52,1539,4,3736,2.857.916.667
25/05/2017 04:00,23.06,31594,2101,11,48,1477,5,3642,2.857.916.667
25/05/2017 05:00,24.17,31689,2019,10,40,1392,5,3466,2.857.916.667
25/05/2017 06:00,24.21,32361,1862,9,28,1339,5,3243,2.857.916.667
25/05/2017 07:00,25,33632,1900,13,25,1262,7,3207,2.857.916.667
25/05/2017 08:00,26.03,34763,1919,17,29,1288,10,3263,2.857.916.667
25/05/2017 09:00,26.04,36114,1913,22,45,1237,12,3229,2.857.916.667
25/05/2017 10:00,25.88,36700,1916,29,69,1322,13,3349,2.857.916.667
25/05/2017 11:00,26.11,37044,1946,32,95,1451,15,3539,2.857.916.667
25/05/2017 12:00,25.39,36901,2034,41,121,1627,13,3836,2.857.916.667
25/05/2017 13:00,23.56,36728,2139,47,132,1761,14,4093,2.857.916.667
25/05/2017 14:00,23.25,36376,2214,61,133,1838,14,4260,2.857.916.667
25/05/2017 15:00,22.95,36110,2217,83,133,1926,11,4370,2.857.916.667
25/05/2017 16:00,23.72,36018,2142,95,121,1939,9,4306,2.857.916.667
25/05/2017 17:00,25.77,36385,2083,91,115,1854,6,4149,2.857.916.667
25/05/2017 18:00,26.28,36576,1978,89,101,1727,5,3900,2.857.916.667
25/05/2017 19:00,26.42,36457,1786,87,81,1676,5,3635,2.857.916.667
25/05/2017 20:00,26.33,36059,1679,91,68,1655,6,3499,2.857.916.667
25/05/2017 21:00,26.48,36121,1598,96,59,1710,6,3469,2.857.916.667
25/05/2017 22:00,26.33,35840,1542,93,52,1744,7,3438,2.857.916.667
25/05/2017 23:00,25.42,34426,1435,87,52,1885,5,3464,2.857.916.667
26/05/2017 00:00,24.09,33034,1512,80,46,1933,5,3576,2.857.916.667
26/05/2017 01:00,23.76,32057,1373,74,39,1913,4,3403,2.857.916.667
26/05/2017 02:00,23.55,31716,1238,70,33,1830,3,3174,2.857.916.667
26/05/2017 03:00,23.12,31710,1132,64,28,1657,3,2884,2.857.916.667
26/05/2017 04:00,23.77,31893,1025,53,23,1430,3,2534,2.857.916.667
26/05/2017 05:00,25.07,33191,899,42,20,1245,4,2210,2.857.916.667
26/05/2017 06:00,26.62,34958,742,36,16,1056,8,1858,2.857.916.667
26/05/2017 07:00,28.18,37869,619,34,14,890,3,1560,2.857.916.667
26/05/2017 08:00,28.89,38467,539,38,14,736,4,1331,2.857.916.667
26/05/2017 09:00,28.81,39229,463,43,15,689,5,1215,2.857.916.667
26/05/2017 10:00,28.21,39598,381,53,17,694,6,1151,2.857.916.667
26/05/2017 11:00,27.54,39711,323,65,20,692,6,1106,2.857.916.667
26/05/2017 12:00,26.97,39475,309,81,28,714,5,1137,2.857.916.667
26/05/2017 13:00,26.81,39137,295,90,39,727,8,1159,2.857.916.667
26/05/2017 14:00,26.55,38639,289,98,55,686,8,1136,2.857.916.667
26/05/2017 15:00,26.57,38220,315,104,68,672,11,1170,2.857.916.667
26/05/2017 16:00,26.65,37993,327,105,75,614,12,1133,2.857.916.667
26/05/2017 17:00,27.42,37984,327,100,81,560,11,1079,2.857.916.667
26/05/2017 18:00,28.16,37908,316,94,86,504,8,1008,2.857.916.667
26/05/2017 19:00,27.58,37414,273,88,93,468,6,928,2.857.916.667
26/05/2017 20:00,26.88,36568,225,87,97,478,5,892,2.857.916.667
26/05/2017 21:00,26.82,36254,181,87,97,581,5,951,2.857.916.667
26/05/2017 22:00,26.69,35939,177,73,88,675,6,1019,2.857.916.667
26/05/2017 23:00,26.33,34671,161,75,98,800,6,1140,2.857.916.667
27/05/2017 00:00,25.52,32967,113,68,78,794,5,1058,2.857.916.667
27/05/2017 01:00,24.73,31763,105,65,68,859,4,1101,2.857.916.667
27/05/2017 02:00,24.38,31204,111,61,60,912,5,1149,2.857.916.667
27/05/2017 03:00,24.08,30842,129,49,55,915,6,1154,2.857.916.667
27/05/2017 04:00,23.85,30600,164,34,51,883,4,1136,2.857.916.667
27/05/2017 05:00,23.71,30644,206,19,46,835,4,1110,2.857.916.667
27/05/2017 06:00,24.78,31193,250,11,35,744,3,1043,2.857.916.667
27/05/2017 07:00,26.12,32503,281,7,26,788,3,1105,2.857.916.667
27/05/2017 08:00,26.46,34177,282,7,22,849,4,1164,2.857.916.667
27/05/2017 09:00,26.54,35968,307,8,24,944,5,1288,2.857.916.667
27/05/2017 10:00,26.05,36818,335,10,25,1026,9,1405,2.857.916.667
27/05/2017 11:00,25.56,36816,365,14,29,1134,18,1560,2.857.916.667
27/05/2017 12:00,24.73,36423,401,18,37,1220,23,1699,2.857.916.667
27/05/2017 13:00,24.59,35881,458,23,46,1264,27,1818,2.857.916.667
27/05/2017 14:00,24.31,35517,522,25,57,1308,29,1941,2.857.916.667
27/05/2017 15:00,24.17,35319,575,27,67,1263,37,1969,2.857.916.667
27/05/2017 16:00,24.6,35369,630,22,75,1147,38,1912,2.857.916.667
27/05/2017 17:00,26.23,35782,685,19,79,1074,36,1893,2.857.916.667
27/05/2017 18:00,26.61,35871,746,19,87,1021,28,1901,2.857.916.667
27/05/2017 19:00,26.47,35613,817,20,97,1027,21,1982,2.857.916.667
27/05/2017 20:00,26.3,35062,870,20,113,1116,16,2135,2.857.916.667
27/05/2017 21:00,26.08,34889,1029,20,136,1236,13,2434,2.857.916.667
27/05/2017 22:00,25.26,34724,1303,44,151,1461,11,2970,2.857.916.667
27/05/2017 23:00,24.14,33594,1619,18,163,1698,7,3505,2.857.916.667
28/05/2017 00:00,21.25,31920,1981,17,170,1836,7,4011,2.857.916.667
28/05/2017 01:00,16.08,30838,2147,13,177,2039,6,4382,2.857.916.667
28/05/2017 02:00,18.66,30282,2125,8,184,2180,6,4503,2.857.916.667
28/05/2017 03:00,16.58,29754,2055,6,188,2301,7,4557,2.857.916.667
28/05/2017 04:00,14.25,29395,2096,7,177,2276,7,4563,2.857.916.667
28/05/2017 05:00,9.91,29231,2035,7,144,2198,7,4391,2.857.916.667
28/05/2017 06:00,14.36,29625,1866,9,130,2123,5,4133,2.857.916.667
28/05/2017 07:00,18.27,30725,1694,11,123,2094,5,3927,2.857.916.667
28/05/2017 08:00,19.04,32320,1686,14,114,2101,7,3922,2.857.916.667
28/05/2017 09:00,22.82,33881,1741,17,112,2186,8,4064,2.857.916.667
28/05/2017 10:00,23.56,34897,1811,27,118,2440,11,4407,2.857.916.667
28/05/2017 11:00,23.39,35282,1995,38,122,2532,13,4700,2.857.916.667
28/05/2017 12:00,22.77,35160,2189,61,123,2703,15,5091,2.857.916.667
28/05/2017 13:00,22.45,34895,2401,89,123,2817,21,5451,2.857.916.667
28/05/2017 14:00,21.63,34576,2535,104,118,2826,25,5608,2.857.916.667
28/05/2017 15:00,21.57,34450,2561,122,113,2793,29,5618,2.857.916.667
28/05/2017 16:00,22.49,34578,2658,137,103,2868,31,5797,2.857.916.667
28/05/2017 17:00,23.82,35050,2698,152,102,2915,30,5897,2.857.916.667
28/05/2017 18:00,25.34,35407,2498,166,122,2836,28,5650,2.857.916.667
28/05/2017 19:00,25.75,35386,2241,174,143,2919,32,5509,2.857.916.667
28/05/2017 20:00,25.68,35085,2105,178,185,2956,34,5458,2.857.916.667
28/05/2017 21:00,25.51,35076,1941,178,232,3004,33,5388,2.857.916.667
28/05/2017 22:00,25.07,34742,1807,147,278,2956,33,5221,2.857.916.667
28/05/2017 23:00,24.06,33251,1746,140,301,2798,21,5006,2.857.916.667
29/05/2017 00:00,22.27,31879,1716,109,308,2614,24,4771,3.219.821.429
29/05/2017 01:00,21.45,30961,1680,89,310,2429,19,4527,3.219.821.429
29/05/2017 02:00,21.52,30672,1675,70,295,2148,15,4203,3.219.821.429
29/05/2017 03:00,22.15,30566,1570,58,277,1875,13,3793,3.219.821.429
29/05/2017 04:00,22.81,30955,1467,51,252,1566,11,3347,3.219.821.429
29/05/2017 05:00,25,32449,1213,43,196,1300,12,2764,3.219.821.429
29/05/2017 06:00,27.94,35902,951,40,172,1019,11,2193,3.219.821.429
29/05/2017 07:00,31.81,39612,826,39,161,790,12,1828,3.219.821.429
29/05/2017 08:00,33.69,41183,712,40,158,628,12,1550,3.219.821.429
29/05/2017 09:00,33.02,41784,653,47,163,501,13,1377,3.219.821.429
29/05/2017 10:00,32.04,42178,579,52,168,420,11,1230,3.219.821.429
29/05/2017 11:00,31.68,42441,467,59,169,391,11,1097,3.219.821.429
29/05/2017 12:00,30.11,42444,437,71,169,384,10,1071,3.219.821.429
29/05/2017 13:00,29.85,42498,419,79,162,440,14,1114,3.219.821.429
29/05/2017 14:00,28.92,42258,383,75,149,494,11,1112,3.219.821.429
29/05/2017 15:00,28.93,41905,350,68,134,605,8,1165,3.219.821.429
29/05/2017 16:00,28.84,41475,314,57,154,687,10,1222,3.219.821.429
29/05/2017 17:00,30.43,41427,278,45,103,739,8,1173,3.219.821.429
29/05/2017 18:00,31.71,41078,243,39,72,743,7,1104,3.219.821.429
29/05/2017 19:00,31.57,40550,212,36,62,772,6,1088,3.219.821.429
29/05/2017 20:00,28.89,39773,211,34,55,874,5,1179,3.219.821.429
29/05/2017 21:00,28.66,39362,189,31,51,936,5,1212,3.219.821.429
29/05/2017 22:00,28.33,38521,205,36,47,930,5,1223,3.219.821.429
29/05/2017 23:00,26.78,36571,209,26,53,867,7,1162,3.219.821.429
30/05/2017 00:00,26.64,34239,160,21,49,818,6,1054,3.219.821.429
30/05/2017 01:00,26.4,32959,175,18,45,800,4,1042,3.219.821.429
30/05/2017 02:00,26.2,32381,175,14,41,705,4,939,3.219.821.429
30/05/2017 03:00,26.17,32176,166,12,32,661,4,875,3.219.821.429
30/05/2017 04:00,26.26,32384,173,10,22,621,4,830,3.219.821.429
30/05/2017 05:00,26.73,33795,175,7,17,569,4,772,3.219.821.429
30/05/2017 06:00,29.53,37283,191,4,13,518,3,729,3.219.821.429
30/05/2017 07:00,34.62,41328,219,4,11,502,4,740,3.219.821.429
30/05/2017 08:00,34.48,41225,229,4,11,547,4,795,3.219.821.429
30/05/2017 09:00,34.01,41551,204,6,11,638,5,864,3.219.821.429
30/05/2017 10:00,33.54,41830,203,9,12,717,6,947,3.219.821.429
30/05/2017 11:00,32.91,41960,199,12,12,787,6,1016,3.219.821.429
30/05/2017 12:00,33.07,42000,208,15,13,814,5,1055,3.219.821.429
30/05/2017 13:00,32.6,42027,256,16,13,849,6,1140,3.219.821.429
30/05/2017 14:00,31.06,41717,327,15,14,865,5,1226,3.219.821.429
30/05/2017 15:00,28.55,41273,433,13,14,879,5,1344,3.219.821.429
30/05/2017 16:00,27.88,40859,577,13,15,906,4,1515,3.219.821.429
30/05/2017 17:00,28.98,40828,799,15,16,934,4,1768,3.219.821.429
30/05/2017 18:00,31.74,40628,1089,20,21,953,4,2087,3.219.821.429
30/05/2017 19:00,31.87,40165,1334,27,38,1043,4,2446,3.219.821.429
30/05/2017 20:00,29.74,39531,1462,35,66,1171,5,2739,3.219.821.429
30/05/2017 21:00,28.26,39057,1677,41,105,1316,5,3144,3.219.821.429
30/05/2017 22:00,26.98,38187,2009,66,159,1581,6,3821,3.219.821.429
30/05/2017 23:00,26.11,36236,2230,86,119,1817,9,4261,3.219.821.429
31/05/2017 00:00,25.26,34338,2276,90,137,2096,9,4608,3.219.821.429
31/05/2017 01:00,24.04,33093,2626,90,156,2177,8,5057,3.219.821.429
31/05/2017 02:00,23.73,32500,2931,84,186,2242,10,5453,3.219.821.429
31/05/2017 03:00,23.16,32309,3181,75,211,2355,8,5830,3.219.821.429
31/05/2017 04:00,23.02,32421,3370,71,237,2447,8,6133,3.219.821.429
31/05/2017 05:00,24.26,33852,3537,71,258,2502,9,6377,3.219.821.429
31/05/2017 06:00,26.92,37004,3704,75,274,2560,9,6622,3.219.821.429
31/05/2017 07:00,32.22,40745,3902,84,293,2715,8,7002,3.219.821.429
31/05/2017 08:00,33.58,40974,4217,93,302,2805,9,7426,3.219.821.429
31/05/2017 09:00,29.99,41522,4458,95,325,3013,16,7907,3.219.821.429
31/05/2017 10:00,28.35,41852,4504,90,345,3168,21,8128,3.219.821.429
31/05/2017 11:00,27.99,41986,4451,82,362,3250,29,8174,3.219.821.429
31/05/2017 12:00,27.64,42028,4497,76,377,3327,35,8312,3.219.821.429
31/05/2017 13:00,27.21,42149,4561,73,393,3409,41,8477,3.219.821.429
31/05/2017 14:00,26.63,41859,4551,76,404,3475,43,8549,3.219.821.429
31/05/2017 15:00,26.33,41501,4615,81,411,3474,50,8631,3.219.821.429
31/05/2017 16:00,26.26,40996,4587,93,411,3488,44,8623,3.219.821.429
31/05/2017 17:00,26.48,40887,4626,104,411,3501,46,8688,3.219.821.429
31/05/2017 18:00,26.72,40499,4550,116,400,3293,50,8409,3.219.821.429
31/05/2017 19:00,26.86,40038,4265,122,387,3251,44,8069,3.219.821.429
31/05/2017 20:00,26.32,39343,3954,132,370,3259,33,7748,3.219.821.429
31/05/2017 21:00,26.61,38867,3700,146,347,3214,27,7434,3.219.821.429
31/05/2017 22:00,26.23,38017,3500,142,319,3203,33,7197,3.219.821.429
31/05/2017 23:00,25.61,36056,3320,127,222,3360,7,7036,3.219.821.429
01/06/2017 00:00,22.72,34220,3471,107,206,3418,10,7212,3.219.821.429
01/06/2017 01:00,21.78,33056,3337,91,170,3360,11,6969,3.219.821.429
01/06/2017 02:00,21.3,32625,3254,91,160,3280,18,6803,3.219.821.429
01/06/2017 03:00,21.32,32504,3148,97,149,3171,16,6581,3.219.821.429
01/06/2017 04:00,22.05,32696,2980,105,143,2977,14,6219,3.219.821.429
01/06/2017 05:00,24.05,34068,2765,117,137,2789,13,5821,3.219.821.429
01/06/2017 06:00,27.11,37121,2523,134,125,2646,11,5439,3.219.821.429
01/06/2017 07:00,32.17,40740,2521,150,116,2462,11,5260,3.219.821.429
01/06/2017 08:00,34.28,42519,2402,171,105,2434,9,5121,3.219.821.429
01/06/2017 09:00,32.92,42498,2246,186,109,2417,10,4968,3.219.821.429
01/06/2017 10:00,28.88,42763,2194,196,116,2464,11,4981,3.219.821.429
01/06/2017 11:00,28.63,42855,2174,204,127,2621,18,5144,3.219.821.429
01/06/2017 12:00,27.88,42662,2198,210,153,2777,23,5361,3.219.821.429
01/06/2017 13:00,28.02,42526,2207,212,215,2886,25,5545,3.219.821.429
01/06/2017 14:00,27.86,42193,2215,214,237,2995,24,5685,3.219.821.429
01/06/2017 15:00,28.46,41738,2242,211,254,3023,19,5749,3.219.821.429
01/06/2017 16:00,28.43,41373,2211,208,250,2919,12,5600,3.219.821.429
01/06/2017 17:00,30.03,41267,2129,203,223,2817,8,5380,3.219.821.429
01/06/2017 18:00,30.77,40960,2011,189,144,2573,6,4923,3.219.821.429
01/06/2017 19:00,31.49,40503,1806,175,111,2403,8,4503,3.219.821.429
01/06/2017 20:00,28.84,39809,1586,162,91,2389,11,4239,3.219.821.429
01/06/2017 21:00,28.76,39263,1426,153,69,2413,12,4073,3.219.821.429
01/06/2017 22:00,28.18,38527,1342,131,60,2435,13,3981,3.219.821.429
01/06/2017 23:00,26.57,36704,1299,113,82,2477,11,3982,3.219.821.429
02/06/2017 00:00,26.19,34646,1296,109,89,2534,11,4039,3.219.821.429
02/06/2017 01:00,25.64,33387,1178,112,98,2521,10,3919,3.219.821.429
02/06/2017 02:00,24.5,32969,1063,109,106,2476,10,3764,3.219.821.429
02/06/2017 03:00,24.36,32765,920,114,112,2397,14,3557,3.219.821.429
02/06/2017 04:00,24.37,32916,778,123,111,2241,15,3268,3.219.821.429
02/06/2017 05:00,26.04,34236,613,138,111,2061,17,2940,3.219.821.429
02/06/2017 06:00,28.93,37407,450,156,123,1878,22,2629,3.219.821.429
02/06/2017 07:00,32.45,41156,367,186,137,1708,26,2424,3.219.821.429
02/06/2017 08:00,32.99,43004,305,206,160,1552,26,2249,3.219.821.429
02/06/2017 09:00,32.92,42381,263,217,187,1433,27,2127,3.219.821.429
02/06/2017 10:00,32.42,42672,264,220,216,1282,31,2013,3.219.821.429
02/06/2017 11:00,31.17,42597,269,224,233,1159,33,1918,3.219.821.429
02/06/2017 12:00,30.55,42177,247,224,251,1033,32,1787,3.219.821.429
02/06/2017 13:00,29.88,41775,228,224,259,917,35,1663,3.219.821.429
02/06/2017 14:00,28.89,41192,211,222,263,825,36,1557,3.219.821.429
02/06/2017 15:00,27.82,40536,200,219,260,771,34,1484,3.219.821.429
02/06/2017 16:00,27.91,40091,194,212,245,695,33,1379,3.219.821.429
02/06/2017 17:00,29.17,39875,184,197,222,675,33,1311,3.219.821.429
02/06/2017 18:00,30.37,39615,173,176,170,629,27,1175,3.219.821.429
02/06/2017 19:00,30.22,39049,160,157,131,576,26,1050,3.219.821.429
02/06/2017 20:00,28.68,38096,155,133,108,582,20,998,3.219.821.429
02/06/2017 21:00,28.51,37404,174,120,84,637,17,1032,3.219.821.429
02/06/2017 22:00,28.57,36971,221,97,80,680,15,1093,3.219.821.429
02/06/2017 23:00,26.97,35797,304,98,85,753,10,1250,3.219.821.429
03/06/2017 00:00,26.96,34440,379,108,70,816,10,1383,3.219.821.429
03/06/2017 01:00,26.77,33250,439,113,65,867,9,1493,3.219.821.429
03/06/2017 02:00,26.29,32653,483,107,50,829,9,1478,3.219.821.429
03/06/2017 03:00,26.17,32225,517,97,40,841,8,1503,3.219.821.429
03/06/2017 04:00,25.78,31947,577,89,35,861,6,1568,3.219.821.429
03/06/2017 05:00,24.98,31994,681,86,30,747,6,1550,3.219.821.429
03/06/2017 06:00,25.17,32630,736,82,20,662,4,1504,3.219.821.429
03/06/2017 07:00,26.01,33996,716,82,15,566,5,1384,3.219.821.429
03/06/2017 08:00,26.31,35405,721,86,15,506,6,1334,3.219.821.429
03/06/2017 09:00,26.84,36918,718,96,15,508,7,1344,3.219.821.429
03/06/2017 10:00,27.1,37805,735,111,15,540,9,1410,3.219.821.429
03/06/2017 11:00,26.83,37867,794,126,15,538,11,1484,3.219.821.429
03/06/2017 12:00,26.47,37722,804,133,20,557,11,1525,3.219.821.429
03/06/2017 13:00,26.73,37462,809,133,20,562,12,1536,3.219.821.429
03/06/2017 14:00,26.55,37166,812,126,20,570,12,1540,3.219.821.429
03/06/2017 15:00,26.59,36990,793,118,20,565,10,1506,3.219.821.429
03/06/2017 16:00,26.4,37083,754,107,15,536,11,1423,3.219.821.429
03/06/2017 17:00,26.55,37455,722,92,15,536,8,1373,3.219.821.429
03/06/2017 18:00,27.1,37582,708,73,15,516,5,1317,3.219.821.429
03/06/2017 19:00,27,37363,718,60,10,549,6,1343,3.219.821.429
03/06/2017 20:00,26.45,36797,707,50,10,614,5,1386,3.219.821.429
03/06/2017 21:00,26.43,36408,653,43,10,785,4,1495,3.219.821.429
03/06/2017 22:00,26.48,36236,595,33,15,848,5,1496,3.219.821.429
03/06/2017 23:00,26.21,35352,537,35,15,755,5,1347,3.219.821.429
04/06/2017 00:00,26.31,33659,366,29,20,773,4,1192,3.219.821.429
04/06/2017 01:00,25.67,32612,369,21,30,761,3,1184,3.219.821.429
04/06/2017 02:00,23.77,32039,327,15,40,683,3,1068,3.219.821.429
04/06/2017 03:00,22.88,31555,266,11,45,623,3,948,3.219.821.429
04/06/2017 04:00,21.58,31179,245,8,45,530,3,831,3.219.821.429
04/06/2017 05:00,20.26,30951,255,5,45,425,3,733,3.219.821.429
04/06/2017 06:00,19.99,31272,271,3,40,354,2,670,3.219.821.429
04/06/2017 07:00,22.93,32255,309,3,30,308,2,652,3.219.821.429
04/06/2017 08:00,24.13,33137,379,4,30,308,3,724,3.219.821.429
04/06/2017 09:00,24.99,34584,479,5,30,328,4,846,3.219.821.429
04/06/2017 10:00,26.02,35636,633,6,35,345,5,1024,3.219.821.429
04/06/2017 11:00,25.85,36077,859,7,35,369,6,1276,3.219.821.429
04/06/2017 12:00,26.01,36067,1121,8,35,388,4,1556,3.219.821.429
04/06/2017 13:00,24.84,35940,1419,8,40,416,6,1889,3.219.821.429
04/06/2017 14:00,24.36,35801,1642,9,45,453,5,2154,3.219.821.429
04/06/2017 15:00,24.02,35619,1832,8,50,510,8,2408,3.219.821.429
04/06/2017 16:00,24.38,35681,1980,7,55,576,9,2627,3.219.821.429
04/06/2017 17:00,24.89,36020,2034,7,60,671,9,2781,3.219.821.429
04/06/2017 18:00,25.72,36289,1930,8,65,799,7,2809,3.219.821.429
04/06/2017 19:00,26.36,36277,1765,12,70,901,11,2759,3.219.821.429
04/06/2017 20:00,26.48,36047,1658,18,75,1052,13,2816,3.219.821.429
04/06/2017 21:00,26.43,36042,1588,25,70,1218,9,2910,3.219.821.429
04/06/2017 22:00,27,35751,1590,43,65,1374,10,3082,3.219.821.429
04/06/2017 23:00,26.29,34469,1609,43,110,1374,7,3143,3.219.821.429
05/06/2017 00:00,24.75,32627,1812,46,115,1521,6,3500,3.800.178.571
05/06/2017 01:00,23.94,31672,1786,42,115,1660,4,3607,3.800.178.571
05/06/2017 02:00,22.57,31222,1722,37,130,1753,3,3645,3.800.178.571
05/06/2017 03:00,21.71,30973,1631,32,180,1869,2,3714,3.800.178.571
05/06/2017 04:00,21.71,30886,1536,28,220,1936,2,3722,3.800.178.571
05/06/2017 05:00,23.22,31849,1382,21,250,1926,3,3582,3.800.178.571
05/06/2017 06:00,24.84,33931,1228,16,260,1967,5,3476,3.800.178.571
05/06/2017 07:00,26.01,36278,1166,12,290,2005,7,3480,3.800.178.571
05/06/2017 08:00,26.93,37075,1097,9,290,2061,8,3465,3.800.178.571
05/06/2017 09:00,26.95,38221,1074,9,320,2174,11,3588,3.800.178.571
05/06/2017 10:00,26.18,38960,1115,10,320,2215,15,3675,3.800.178.571
05/06/2017 11:00,26.5,39274,1131,15,300,2310,17,3773,3.800.178.571
05/06/2017 12:00,25.62,39246,1242,22,300,2421,17,4002,3.800.178.571
05/06/2017 13:00,24.94,38965,1463,29,300,2465,24,4281,3.800.178.571
05/06/2017 14:00,24.88,38726,1664,37,290,2349,21,4361,3.800.178.571
05/06/2017 15:00,24.95,38510,1745,48,280,2517,28,4618,3.800.178.571
05/06/2017 16:00,26.11,38337,1637,55,230,2343,19,4284,3.800.178.571
05/06/2017 17:00,26.95,38425,1438,61,175,2160,20,3854,3.800.178.571
05/06/2017 18:00,27.48,38356,1227,64,160,1857,17,3325,3.800.178.571
05/06/2017 19:00,27.55,37989,1046,71,110,1634,13,2874,3.800.178.571
05/06/2017 20:00,26.96,37356,947,82,80,1468,10,2587,3.800.178.571
05/06/2017 21:00,26.85,36956,898,92,70,1460,10,2530,3.800.178.571
05/06/2017 22:00,26.88,36432,939,77,60,1495,11,2582,3.800.178.571
05/06/2017 23:00,26.2,35040,990,85,43,1507,12,2637,3.800.178.571
06/06/2017 00:00,24.56,31935,1239,76,40,1466,9,2830,3.800.178.571
06/06/2017 01:00,20.55,30928,1359,71,37,1447,8,2922,3.800.178.571
06/06/2017 02:00,16.84,30503,1473,64,35,1426,6,3004,3.800.178.571
06/06/2017 03:00,13.48,30295,1584,53,32,1410,5,3084,3.800.178.571
06/06/2017 04:00,13.23,30310,1709,39,29,1343,4,3124,3.800.178.571
06/06/2017 05:00,19.13,31473,1840,24,25,1186,4,3079,3.800.178.571
06/06/2017 06:00,25.4,33871,1846,14,20,1091,3,2974,3.800.178.571
06/06/2017 07:00,27.08,36375,1874,9,14,1174,7,3078,3.800.178.571
06/06/2017 08:00,28.65,37342,2111,8,13,1291,9,3432,3.800.178.571
06/06/2017 09:00,28.31,37877,2555,9,16,1587,9,4176,3.800.178.571
06/06/2017 10:00,27.7,38290,2934,12,21,1803,7,4777,3.800.178.571
06/06/2017 11:00,27.19,38251,3130,14,28,1999,9,5180,3.800.178.571
06/06/2017 12:00,26.23,38113,3268,14,40,2194,9,5525,3.800.178.571
06/06/2017 13:00,24.7,38043,3372,12,56,2196,7,5643,3.800.178.571
06/06/2017 14:00,23.9,37755,3414,10,74,2240,5,5743,3.800.178.571
06/06/2017 15:00,22.91,37304,3490,8,76,2340,6,5920,3.800.178.571
06/06/2017 16:00,22.35,37177,3453,5,92,2400,10,5960,3.800.178.571
06/06/2017 17:00,23.1,37383,3481,4,119,2416,14,6034,3.800.178.571
06/06/2017 18:00,23.79,37349,3447,4,155,2449,17,6072,3.800.178.571
06/06/2017 19:00,23.94,37063,3213,6,204,2548,16,5987,3.800.178.571
06/06/2017 20:00,22.73,36546,2931,13,265,2753,14,5976,3.800.178.571
06/06/2017 21:00,20.88,36343,2562,22,300,2857,16,5757,3.800.178.571
06/06/2017 22:00,20.71,35664,2349,37,296,2924,20,5626,3.800.178.571
06/06/2017 23:00,13.97,34148,2327,49,255,2814,19,5464,3.800.178.571
07/06/2017 00:00,12.93,32686,1774,63,267,2764,23,4891,3.800.178.571
07/06/2017 01:00,10.55,31426,1835,69,284,2648,25,4861,3.800.178.571
07/06/2017 02:00,8.28,31008,1908,69,294,2542,29,4842,3.800.178.571
07/06/2017 03:00,5.04,30871,1889,70,300,2547,31,4837,3.800.178.571
07/06/2017 04:00,5,31028,1959,69,304,2494,38,4864,3.800.178.571
07/06/2017 05:00,9.99,32481,2058,59,307,2340,45,4809,3.800.178.571
07/06/2017 06:00,22.38,35763,2158,56,305,2342,45,4906,3.800.178.571
07/06/2017 07:00,25.17,39462,2247,72,290,2381,43,5033,3.800.178.571
07/06/2017 08:00,25.77,40366,2395,92,281,2464,41,5273,3.800.178.571
07/06/2017 09:00,25.57,40630,2717,107,256,2720,37,5837,3.800.178.571
07/06/2017 10:00,25.14,40887,3075,115,216,3050,26,6482,3.800.178.571
07/06/2017 11:00,24.23,40643,3257,118,166,3292,16,6849,3.800.178.571
07/06/2017 12:00,23.81,40501,3393,116,135,3487,11,7142,3.800.178.571
07/06/2017 13:00,23.65,40504,3464,104,100,3638,10,7316,3.800.178.571
07/06/2017 14:00,23.37,40276,3485,89,53,3668,8,7303,3.800.178.571
07/06/2017 15:00,22.26,39766,3527,77,30,3643,8,7285,3.800.178.571
07/06/2017 16:00,21.86,39372,3500,68,22,3608,5,7203,3.800.178.571
07/06/2017 17:00,21.48,39246,3508,54,18,3533,4,7117,3.800.178.571
07/06/2017 18:00,22.21,38863,3583,45,15,3544,5,7192,3.800.178.571
07/06/2017 19:00,23.9,38388,3553,38,14,3316,5,6926,3.800.178.571
07/06/2017 20:00,22.94,37570,3444,37,15,3287,4,6787,3.800.178.571
07/06/2017 21:00,22.4,36942,3420,41,20,3280,4,6765,3.800.178.571
07/06/2017 22:00,22.13,36199,3455,37,24,3151,6,6673,3.800.178.571
07/06/2017 23:00,19.62,34545,3507,34,31,3193,4,6769,3.800.178.571
08/06/2017 00:00,16.01,33192,3531,33,42,3104,4,6714,3.800.178.571
08/06/2017 01:00,10.45,32041,3573,31,55,2919,3,6581,3.800.178.571
08/06/2017 02:00,10,31532,3610,28,69,2765,3,6475,3.800.178.571
08/06/2017 03:00,10,31242,3577,25,75,2587,2,6266,3.800.178.571
08/06/2017 04:00,9.99,31309,3526,21,75,2436,2,6060,3.800.178.571
08/06/2017 05:00,19.24,32588,3465,17,62,2345,3,5892,3.800.178.571
08/06/2017 06:00,24.4,35529,3331,13,50,2202,3,5599,3.800.178.571
08/06/2017 07:00,27.52,38775,3270,12,50,2110,4,5446,3.800.178.571
08/06/2017 08:00,28.59,39958,3165,11,56,2163,6,5401,3.800.178.571
08/06/2017 09:00,28.68,40468,3006,12,72,2261,8,5359,3.800.178.571
08/06/2017 10:00,29.18,40959,2804,12,85,2354,9,5264,3.800.178.571
08/06/2017 11:00,28.66,41201,2486,12,102,2366,12,4978,3.800.178.571
08/06/2017 12:00,28.02,41076,2219,12,109,2414,16,4770,3.800.178.571
08/06/2017 13:00,28.09,41128,1969,10,108,2417,17,4521,3.800.178.571
08/06/2017 14:00,28.1,40820,1706,11,102,2405,18,4242,3.800.178.571
08/06/2017 15:00,26.94,40413,1516,10,92,2352,17,3987,3.800.178.571
08/06/2017 16:00,27.12,40025,1406,11,79,2161,15,3672,3.800.178.571
08/06/2017 17:00,28.61,40010,1246,10,64,1897,12,3229,3.800.178.571
08/06/2017 18:00,29.02,39647,1102,10,50,1642,10,2814,3.800.178.571
08/06/2017 19:00,29.43,39200,1016,10,46,1436,10,2518,3.800.178.571
08/06/2017 20:00,28.56,38379,997,11,43,1263,8,2322,3.800.178.571
08/06/2017 21:00,28.39,37666,1019,13,42,1138,6,2218,3.800.178.571
08/06/2017 22:00,28.07,36805,1086,8,45,1074,7,2220,3.800.178.571
08/06/2017 23:00,26.43,35072,1170,10,31,940,6,2157,3.800.178.571
09/06/2017 00:00,25.98,33635,1531,12,29,862,6,2440,3.800.178.571
09/06/2017 01:00,25.01,32418,1560,11,29,797,5,2402,3.800.178.571
09/06/2017 02:00,24.74,31840,1506,10,30,766,4,2316,3.800.178.571
09/06/2017 03:00,24.25,31555,1379,10,29,733,4,2155,3.800.178.571
09/06/2017 04:00,24.5,31618,1248,8,27,692,3,1978,3.800.178.571
09/06/2017 05:00,25.38,32991,1134,7,21,672,3,1837,3.800.178.571
09/06/2017 06:00,26.92,36219,978,6,13,624,2,1623,3.800.178.571
09/06/2017 07:00,31.11,39888,806,6,10,570,3,1395,3.800.178.571
09/06/2017 08:00,30.89,40975,654,7,10,558,4,1233,3.800.178.571
09/06/2017 09:00,30.02,41415,567,9,11,571,5,1163,3.800.178.571
09/06/2017 10:00,29.93,41638,590,9,12,576,6,1193,3.800.178.571
09/06/2017 11:00,29.89,41538,636,10,13,567,5,1231,3.800.178.571
09/06/2017 12:00,28.2,41161,687,11,12,614,4,1328,3.800.178.571
09/06/2017 13:00,27.58,40669,720,10,11,649,5,1395,3.800.178.571
09/06/2017 14:00,26.78,40011,653,9,10,710,4,1386,3.800.178.571
09/06/2017 15:00,26.43,39355,661,8,8,807,4,1488,3.800.178.571
09/06/2017 16:00,26.63,38901,776,6,8,848,3,1641,3.800.178.571
09/06/2017 17:00,26.98,38672,889,4,8,934,3,1838,3.800.178.571
09/06/2017 18:00,27.56,38367,1019,4,13,1065,4,2105,3.800.178.571
09/06/2017 19:00,27.92,37681,1151,4,17,1157,5,2334,3.800.178.571
09/06/2017 20:00,26.1,36743,1022,4,24,1252,5,2307,3.800.178.571
09/06/2017 21:00,25.41,36011,841,5,33,1306,5,2190,3.800.178.571
09/06/2017 22:00,24.91,35512,863,4,44,1341,7,2259,3.800.178.571
09/06/2017 23:00,24.68,34222,932,3,44,1421,5,2405,3.800.178.571
10/06/2017 00:00,25.03,32589,1269,3,51,1371,8,2702,3.800.178.571
10/06/2017 01:00,24.47,31286,1273,3,57,1241,5,2579,3.800.178.571
10/06/2017 02:00,24.09,30598,1232,3,62,1108,5,2410,3.800.178.571
10/06/2017 03:00,23.65,30123,1159,3,62,970,5,2199,3.800.178.571
10/06/2017 04:00,23.19,29797,1104,3,59,869,5,2040,3.800.178.571
10/06/2017 05:00,23.67,29862,1038,2,52,803,4,1899,3.800.178.571
10/06/2017 06:00,24,30581,946,2,40,793,3,1784,3.800.178.571
10/06/2017 07:00,24.46,32007,892,2,30,754,3,1681,3.800.178.571
10/06/2017 08:00,25,33648,893,2,23,735,4,1657,3.800.178.571
10/06/2017 09:00,26,35179,874,4,17,761,5,1661,3.800.178.571
10/06/2017 10:00,26.03,36126,828,5,15,788,5,1641,3.800.178.571
10/06/2017 11:00,26.06,36192,779,7,14,793,5,1598,3.800.178.571
10/06/2017 12:00,25.1,35956,844,8,13,819,4,1688,3.800.178.571
10/06/2017 13:00,24.69,35602,895,8,13,857,5,1778,3.800.178.571
10/06/2017 14:00,24.45,35260,858,8,12,892,5,1775,3.800.178.571
10/06/2017 15:00,24.44,35187,811,7,12,869,6,1705,3.800.178.571
10/06/2017 16:00,24.6,35236,753,7,13,866,4,1643,3.800.178.571
10/06/2017 17:00,24.99,35569,642,6,17,864,4,1533,3.800.178.571
10/06/2017 18:00,26.08,35646,498,6,19,840,4,1367,3.800.178.571
10/06/2017 19:00,25.73,35259,370,7,22,810,5,1214,3.800.178.571
10/06/2017 20:00,25.17,34677,286,8,27,806,6,1133,3.800.178.571
10/06/2017 21:00,24.87,34215,268,9,33,852,5,1167,3.800.178.571
10/06/2017 22:00,24.85,34011,322,18,38,879,5,1262,3.800.178.571
10/06/2017 23:00,24.5,33152,417,8,51,1001,5,1482,3.800.178.571
11/06/2017 00:00,25.08,31814,792,10,49,1048,7,1906,3.800.178.571
11/06/2017 01:00,24.3,30749,916,12,46,1034,4,2012,3.800.178.571
11/06/2017 02:00,21.78,30087,999,13,46,1033,5,2096,3.800.178.571
11/06/2017 03:00,18,29616,1067,13,45,992,5,2122,3.800.178.571
11/06/2017 04:00,15.39,29235,1200,12,43,888,5,2148,3.800.178.571
11/06/2017 05:00,12.6,29136,1299,8,40,762,4,2113,3.800.178.571
11/06/2017 06:00,12.84,29535,1372,5,36,708,4,2125,3.800.178.571
11/06/2017 07:00,16.49,30656,1449,3,34,751,3,2240,3.800.178.571
11/06/2017 08:00,18.41,31985,1538,4,34,845,4,2425,3.800.178.571
11/06/2017 09:00,20.85,33498,1637,8,41,1000,6,2692,3.800.178.571
11/06/2017 10:00,21.9,34727,1683,13,59,1169,7,2931,3.800.178.571
11/06/2017 11:00,21.87,35271,1672,20,83,1342,8,3125,3.800.178.571
11/06/2017 12:00,21.63,35353,1735,25,96,1507,10,3373,3.800.178.571
11/06/2017 13:00,21.08,35307,1781,30,99,1621,14,3545,3.800.178.571
11/06/2017 14:00,20.77,35180,1672,37,97,1672,18,3496,3.800.178.571
11/06/2017 15:00,20.2,34989,1553,42,92,1685,21,3393,3.800.178.571
11/06/2017 16:00,21.09,35192,1398,42,79,1648,23,3190,3.800.178.571
11/06/2017 17:00,23.52,35641,1174,41,57,1618,22,2912,3.800.178.571
11/06/2017 18:00,25.03,35936,926,49,44,1604,24,2647,3.800.178.571
11/06/2017 19:00,25.44,35825,761,51,40,1590,23,2465,3.800.178.571
11/06/2017 20:00,25.5,35361,743,56,40,1564,26,2429,3.800.178.571
11/06/2017 21:00,25.47,35160,850,62,41,1575,25,2553,3.800.178.571
11/06/2017 22:00,25.26,34932,1074,59,48,1569,28,2778,3.800.178.571
11/06/2017 23:00,24.28,33837,1147,53,79,1533,16,2828,3.800.178.571
12/06/2017 00:00,24.22,32421,1175,56,102,1545,19,2897,4.296.309.524
12/06/2017 01:00,20.66,31328,1301,63,134,1553,20,3071,4.296.309.524
12/06/2017 02:00,18.15,30846,1505,73,162,1490,25,3255,4.296.309.524
12/06/2017 03:00,14.6,30577,1660,84,181,1460,22,3407,4.296.309.524
12/06/2017 04:00,15.66,30620,1799,90,192,1457,22,3560,4.296.309.524
12/06/2017 05:00,19.88,32300,1982,96,196,1563,30,3867,4.296.309.524
12/06/2017 06:00,25,35654,2217,103,200,1679,35,4234,4.296.309.524
12/06/2017 07:00,28.77,39244,2500,111,206,1791,40,4648,4.296.309.524
12/06/2017 08:00,29.98,40998,2705,123,217,1959,40,5044,4.296.309.524
12/06/2017 09:00,28.41,41136,2968,130,239,2110,42,5489,4.296.309.524
12/06/2017 10:00,26.95,41626,3198,130,255,2327,34,5944,4.296.309.524
12/06/2017 11:00,25.56,41859,3403,121,262,2559,30,6375,4.296.309.524
12/06/2017 12:00,23.84,41809,3634,107,260,2826,24,6851,4.296.309.524
12/06/2017 13:00,23.19,41728,3841,105,260,2972,29,7207,4.296.309.524
12/06/2017 14:00,22.78,41606,3958,105,260,2993,25,7341,4.296.309.524
12/06/2017 15:00,22.44,41160,4003,108,262,3089,21,7483,4.296.309.524
12/06/2017 16:00,22.14,40755,4017,104,266,3142,23,7552,4.296.309.524
12/06/2017 17:00,22.53,40747,4012,90,266,3167,27,7562,4.296.309.524
12/06/2017 18:00,24.52,40387,3941,83,271,3186,30,7511,4.296.309.524
12/06/2017 19:00,24.32,39790,3880,82,281,3207,29,7479,4.296.309.524
12/06/2017 20:00,23.64,38968,3802,83,292,3231,31,7439,4.296.309.524
12/06/2017 21:00,23.42,38104,3786,84,295,3364,26,7555,4.296.309.524
12/06/2017 22:00,22.61,37296,3788,83,308,3363,31,7573,4.296.309.524
12/06/2017 23:00,20.64,35584,3782,85,337,3496,28,7728,4.296.309.524
13/06/2017 00:00,18.34,33554,3743,83,351,3506,31,7714,4.296.309.524
13/06/2017 01:00,11.96,32322,3663,79,365,3517,34,7658,4.296.309.524
13/06/2017 02:00,9.79,31764,3604,75,375,3512,37,7603,4.296.309.524
13/06/2017 03:00,7.99,31548,3526,72,380,3497,42,7517,4.296.309.524
13/06/2017 04:00,8.94,31671,3456,68,382,3465,44,7415,4.296.309.524
13/06/2017 05:00,16.29,33181,3431,64,383,3286,46,7210,4.296.309.524
13/06/2017 06:00,23.89,36574,3421,56,385,3151,44,7057,4.296.309.524
13/06/2017 07:00,26.14,40350,3475,44,386,3079,42,7026,4.296.309.524
13/06/2017 08:00,26.97,40827,3544,37,387,3117,41,7126,4.296.309.524
13/06/2017 09:00,26.46,41268,3575,31,397,3186,44,7233,4.296.309.524
13/06/2017 10:00,26.35,41649,3510,30,407,2978,47,6972,4.296.309.524
13/06/2017 11:00,26.58,41780,3441,33,409,2856,50,6789,4.296.309.524
13/06/2017 12:00,26.21,41785,3452,38,408,2657,51,6606,4.296.309.524
13/06/2017 13:00,26.15,41817,3494,45,407,2453,53,6452,4.296.309.524
13/06/2017 14:00,25.75,41576,3484,54,405,2242,48,6233,4.296.309.524
13/06/2017 15:00,25.42,41163,3478,67,397,2053,48,6043,4.296.309.524
13/06/2017 16:00,25.33,40727,3445,79,388,1830,39,5781,4.296.309.524
13/06/2017 17:00,26.35,40636,3376,89,383,1542,33,5423,4.296.309.524
13/06/2017 18:00,28.44,40339,3236,105,376,1339,32,5088,4.296.309.524
13/06/2017 19:00,28.61,39781,3048,119,368,1208,30,4773,4.296.309.524
13/06/2017 20:00,27.58,38980,2790,128,359,1175,27,4479,4.296.309.524
13/06/2017 21:00,27.21,38299,2542,133,349,1209,27,4260,4.296.309.524
13/06/2017 22:00,26.68,37569,2363,124,336,1300,29,4152,4.296.309.524
13/06/2017 23:00,25.43,35831,2271,154,300,1379,30,4134,4.296.309.524
14/06/2017 00:00,23.99,33480,2152,153,294,1529,29,4157,4.296.309.524
14/06/2017 01:00,23.07,32257,2026,151,287,1535,26,4025,4.296.309.524
14/06/2017 02:00,23.03,31787,1937,145,282,1519,24,3907,4.296.309.524
14/06/2017 03:00,23.05,31611,1901,136,269,1497,27,3830,4.296.309.524
14/06/2017 04:00,23.18,31749,1899,127,253,1385,30,3694,4.296.309.524
14/06/2017 05:00,23.96,33436,1842,116,242,1197,28,3425,4.296.309.524
14/06/2017 06:00,25.99,36810,1786,103,232,1004,22,3147,4.296.309.524
14/06/2017 07:00,30.51,40413,1725,89,224,830,20,2888,4.296.309.524
14/06/2017 08:00,32.02,41044,1613,80,217,711,19,2640,4.296.309.524
14/06/2017 09:00,31.77,41270,1441,78,227,644,18,2408,4.296.309.524
14/06/2017 10:00,31.36,41589,1236,73,231,608,15,2163,4.296.309.524
14/06/2017 11:00,30.54,41665,1093,67,236,664,13,2073,4.296.309.524
14/06/2017 12:00,29.27,41510,1120,63,240,722,13,2158,4.296.309.524
14/06/2017 13:00,28.99,41484,1137,59,245,754,15,2210,4.296.309.524
14/06/2017 14:00,28.74,41266,1079,57,249,835,13,2233,4.296.309.524
14/06/2017 15:00,27.64,40770,1014,53,232,875,11,2185,4.296.309.524
14/06/2017 16:00,27.49,40264,989,49,217,945,10,2210,4.296.309.524
14/06/2017 17:00,28.62,40037,947,45,193,994,8,2187,4.296.309.524
14/06/2017 18:00,29.39,39650,864,42,146,979,7,2038,4.296.309.524
14/06/2017 19:00,29.36,39158,753,38,131,940,7,1869,4.296.309.524
14/06/2017 20:00,27.14,38200,625,36,128,972,6,1767,4.296.309.524
14/06/2017 21:00,25.49,37501,516,35,113,1117,5,1786,4.296.309.524
14/06/2017 22:00,25.48,36777,479,29,90,1230,6,1834,4.296.309.524
14/06/2017 23:00,24.76,35094,473,29,80,1258,4,1844,4.296.309.524
15/06/2017 00:00,25.21,33524,471,27,64,1235,4,1801,4.296.309.524
15/06/2017 01:00,25.02,32345,412,25,53,1205,3,1698,4.296.309.524
15/06/2017 02:00,24.8,31784,366,22,44,1074,3,1509,4.296.309.524
15/06/2017 03:00,24.65,31510,314,18,40,957,4,1333,4.296.309.524
15/06/2017 04:00,24.62,31604,274,13,38,826,4,1155,4.296.309.524
15/06/2017 05:00,25.11,33090,239,8,37,651,4,939,4.296.309.524
15/06/2017 06:00,25.78,36192,202,5,32,465,3,707,4.296.309.524
15/06/2017 07:00,29.23,39520,183,5,28,373,3,592,4.296.309.524
15/06/2017 08:00,30.52,40023,204,8,26,360,4,602,4.296.309.524
15/06/2017 09:00,30.06,40550,245,10,32,391,5,683,4.296.309.524
15/06/2017 10:00,28.09,41058,293,12,40,443,5,793,4.296.309.524
15/06/2017 11:00,28.44,41319,347,13,47,497,6,910,4.296.309.524
15/06/2017 12:00,27.01,41157,411,13,54,558,7,1043,4.296.309.524
15/06/2017 13:00,26.33,41118,497,12,60,576,8,1153,4.296.309.524
15/06/2017 14:00,26.43,40813,592,11,66,608,9,1286,4.296.309.524
15/06/2017 15:00,25.73,40355,661,11,65,646,9,1392,4.296.309.524
15/06/2017 16:00,26.17,39868,760,9,62,633,8,1472,4.296.309.524
15/06/2017 17:00,27.01,39663,859,8,56,550,7,1480,4.296.309.524
15/06/2017 18:00,27.63,39291,963,7,49,490,5,1514,4.296.309.524
15/06/2017 19:00,26.7,38792,1062,7,45,498,4,1616,4.296.309.524
15/06/2017 20:00,25.52,38035,1114,7,42,532,4,1699,4.296.309.524
15/06/2017 21:00,25.25,37424,1319,7,39,628,3,1996,4.296.309.524
15/06/2017 22:00,25.28,36651,1643,8,36,726,4,2417,4.296.309.524
15/06/2017 23:00,24.89,34980,1762,7,16,656,2,2443,4.296.309.524
16/06/2017 00:00,24.85,33217,1482,8,11,725,2,2228,4.296.309.524
16/06/2017 01:00,23.7,31980,1553,11,7,767,3,2341,4.296.309.524
16/06/2017 02:00,22.59,31416,1625,15,6,737,3,2386,4.296.309.524
16/06/2017 03:00,22.01,31105,1691,18,6,688,3,2406,4.296.309.524
16/06/2017 04:00,22.01,31127,1819,16,6,638,3,2482,4.296.309.524
16/06/2017 05:00,22.96,32546,2026,11,6,581,3,2627,4.296.309.524
16/06/2017 06:00,25.39,35778,2277,5,6,527,2,2817,4.296.309.524
16/06/2017 07:00,27.79,39418,2567,2,6,540,3,3118,4.296.309.524
16/06/2017 08:00,27.81,39991,2760,2,7,633,3,3405,4.296.309.524
16/06/2017 09:00,26.79,40678,2996,3,9,692,3,3703,4.296.309.524
16/06/2017 10:00,25.24,41142,3210,3,12,751,3,3979,4.296.309.524
16/06/2017 11:00,24.89,41196,3367,4,14,767,3,4155,4.296.309.524
16/06/2017 12:00,24.7,40966,3503,5,15,770,3,4296,4.296.309.524
16/06/2017 13:00,24.47,40635,3656,6,15,746,3,4426,4.296.309.524
16/06/2017 14:00,23.71,39962,3805,7,15,730,4,4561,4.296.309.524
16/06/2017 15:00,23.04,39344,4010,7,14,749,4,4784,4.296.309.524
16/06/2017 16:00,22.71,38898,4119,7,14,741,4,4885,4.296.309.524
16/06/2017 17:00,22.96,38665,4116,8,19,727,3,4873,4.296.309.524
16/06/2017 18:00,23.04,38340,4023,10,21,701,2,4757,4.296.309.524
16/06/2017 19:00,23.78,37702,3899,12,23,708,2,4644,4.296.309.524
16/06/2017 20:00,23.4,36595,3739,17,23,737,3,4519,4.296.309.524
16/06/2017 21:00,23.15,35830,3636,22,22,787,3,4470,4.296.309.524
16/06/2017 22:00,23.41,35274,3581,24,22,813,2,4442,4.296.309.524
16/06/2017 23:00,22.06,34028,3538,30,21,811,3,4403,4.296.309.524
17/06/2017 00:00,20.26,32205,3576,29,23,862,3,4493,4.296.309.524
17/06/2017 01:00,17.98,30984,3493,26,25,905,3,4452,4.296.309.524
17/06/2017 02:00,17.06,30315,3456,22,25,901,3,4407,4.296.309.524
17/06/2017 03:00,19.44,29896,3354,17,23,917,3,4314,4.296.309.524
17/06/2017 04:00,18.37,29542,3173,12,21,933,3,4142,4.296.309.524
17/06/2017 05:00,19.75,29584,2910,6,18,910,2,3846,4.296.309.524
17/06/2017 06:00,19.09,30299,2659,3,16,836,2,3516,4.296.309.524
17/06/2017 07:00,20.97,31676,2513,1,14,800,2,3330,4.296.309.524
17/06/2017 08:00,23.01,33482,2335,1,13,782,2,3133,4.296.309.524
17/06/2017 09:00,23.49,34704,2153,2,14,777,2,2948,4.296.309.524
17/06/2017 10:00,23.24,35657,1966,3,15,747,2,2733,4.296.309.524
17/06/2017 11:00,23.09,35879,1776,4,17,758,2,2557,4.296.309.524
17/06/2017 12:00,22.82,35699,1598,7,20,787,3,2415,4.296.309.524
17/06/2017 13:00,22.55,35290,1480,8,22,827,3,2340,4.296.309.524
17/06/2017 14:00,22.09,35028,1408,9,24,838,3,2282,4.296.309.524
17/06/2017 15:00,22.22,34921,1376,10,27,870,5,2288,4.296.309.524
17/06/2017 16:00,22.91,34975,1352,11,28,868,8,2267,4.296.309.524
17/06/2017 17:00,23.86,35372,1292,12,30,836,7,2177,4.296.309.524
17/06/2017 18:00,24.25,35496,1160,14,34,791,5,2004,4.296.309.524
17/06/2017 19:00,24.07,35178,1002,17,38,819,8,1884,4.296.309.524
17/06/2017 20:00,23.75,34451,853,19,44,896,3,1815,4.296.309.524
17/06/2017 21:00,23.49,33960,739,22,48,945,3,1757,4.296.309.524
17/06/2017 22:00,23.43,33704,774,29,49,1057,3,1912,4.296.309.524
17/06/2017 23:00,23.07,32868,841,22,49,1266,3,2181,4.296.309.524
18/06/2017 00:00,24.12,31338,886,27,45,1385,3,2346,4.296.309.524
18/06/2017 01:00,23.56,30269,856,31,40,1473,3,2403,4.296.309.524
18/06/2017 02:00,23.29,29612,826,35,35,1540,3,2439,4.296.309.524
18/06/2017 03:00,23.09,29103,823,35,30,1630,4,2522,4.296.309.524
18/06/2017 04:00,22.29,28692,851,29,27,1676,3,2586,4.296.309.524
18/06/2017 05:00,22.68,28616,832,24,22,1728,3,2609,4.296.309.524
18/06/2017 06:00,23.26,29135,789,24,18,1717,4,2552,4.296.309.524
18/06/2017 07:00,23.8,30204,715,29,16,1683,7,2450,4.296.309.524
18/06/2017 08:00,24.18,31761,680,38,18,1758,12,2506,4.296.309.524
18/06/2017 09:00,24.25,33120,708,47,25,1973,20,2773,4.296.309.524
18/06/2017 10:00,24.23,34366,746,59,35,2289,23,3152,4.296.309.524
18/06/2017 11:00,24.14,34907,754,70,47,2614,29,3514,4.296.309.524
18/06/2017 12:00,24.03,34903,811,75,60,2939,32,3917,4.296.309.524
18/06/2017 13:00,23.45,34760,863,78,73,3135,29,4178,4.296.309.524
18/06/2017 14:00,22,34586,854,82,85,3209,27,4257,4.296.309.524
18/06/2017 15:00,22.94,34466,827,83,93,3299,24,4326,4.296.309.524
18/06/2017 16:00,23.58,34628,792,78,97,3319,20,4306,4.296.309.524
18/06/2017 17:00,24.11,35102,780,71,105,3212,17,4185,4.296.309.524
18/06/2017 18:00,24.16,35416,757,65,105,2954,16,3897,4.296.309.524
18/06/2017 19:00,24.3,35363,671,60,99,2743,10,3583,4.296.309.524
18/06/2017 20:00,24.26,34946,562,56,97,2618,6,3339,4.296.309.524
18/06/2017 21:00,24.1,34721,491,56,101,2501,5,3154,4.296.309.524
18/06/2017 22:00,24.95,34401,490,45,110,2430,5,3080,4.296.309.524
18/06/2017 23:00,24.79,33345,505,42,116,2555,9,3227,4.296.309.524
19/06/2017 00:00,24,31848,677,39,116,2512,12,3356,4.632.559.524
19/06/2017 01:00,23.65,30816,619,38,116,2481,14,3268,4.632.559.524
19/06/2017 02:00,23.29,30391,546,35,116,2456,13,3166,4.632.559.524
19/06/2017 03:00,23.23,30177,460,30,116,2311,15,2932,4.632.559.524
19/06/2017 04:00,23.62,30246,397,23,116,2198,12,2746,4.632.559.524
19/06/2017 05:00,24.14,31673,351,17,114,2074,12,2568,4.632.559.524
19/06/2017 06:00,25.08,35030,315,17,106,1981,14,2433,4.632.559.524
19/06/2017 07:00,26.77,38658,280,20,105,1926,17,2348,4.632.559.524
19/06/2017 08:00,27.47,40511,246,25,107,1904,20,2302,4.632.559.524
19/06/2017 09:00,28.44,41169,225,28,118,1889,20,2280,4.632.559.524
19/06/2017 10:00,28.44,41535,237,33,143,2034,20,2467,4.632.559.524
19/06/2017 11:00,28.41,41601,256,43,168,2074,22,2563,4.632.559.524
19/06/2017 12:00,28.07,41377,297,62,180,2153,27,2719,4.632.559.524
19/06/2017 13:00,27.41,41181,357,82,188,2170,29,2826,4.632.559.524
19/06/2017 14:00,27.34,40948,419,93,196,2160,30,2898,4.632.559.524
19/06/2017 15:00,26.35,40515,455,99,180,2162,25,2921,4.632.559.524
19/06/2017 16:00,25.72,40088,491,97,168,2147,20,2923,4.632.559.524
19/06/2017 17:00,26.36,40014,512,87,148,2076,12,2835,4.632.559.524
19/06/2017 18:00,27.08,39648,524,73,116,1852,7,2572,4.632.559.524
19/06/2017 19:00,28.41,39138,543,60,96,1724,4,2427,4.632.559.524
19/06/2017 20:00,26.48,38400,573,50,87,1704,4,2418,4.632.559.524
19/06/2017 21:00,25.55,37781,734,44,79,1706,5,2568,4.632.559.524
19/06/2017 22:00,25.35,36922,1033,57,81,1800,6,2977,4.632.559.524
19/06/2017 23:00,24.81,34659,1201,36,58,1975,6,3276,4.632.559.524
20/06/2017 00:00,24.34,32474,1463,37,66,2109,7,3682,4.632.559.524
20/06/2017 01:00,23.89,31227,1745,45,75,2231,11,4107,4.632.559.524
20/06/2017 02:00,23.19,30613,1944,58,84,2358,14,4458,4.632.559.524
20/06/2017 03:00,22.84,30423,1975,76,97,2482,20,4650,4.632.559.524
20/06/2017 04:00,22.94,30761,2026,89,103,2513,22,4753,4.632.559.524
20/06/2017 05:00,23.91,32391,2136,102,115,2510,33,4896,4.632.559.524
20/06/2017 06:00,25.41,36057,2287,115,131,2564,36,5133,4.632.559.524
20/06/2017 07:00,27.63,39947,2434,124,161,2533,32,5284,4.632.559.524
20/06/2017 08:00,29.57,40690,2501,144,195,2532,22,5394,4.632.559.524
20/06/2017 09:00,29.29,40903,2577,170,229,2572,20,5568,4.632.559.524
20/06/2017 10:00,29.13,41342,2656,188,261,2613,20,5738,4.632.559.524
20/06/2017 11:00,27.91,41496,2749,193,287,2765,17,6011,4.632.559.524
20/06/2017 12:00,27.33,41596,2911,193,302,2962,20,6388,4.632.559.524
20/06/2017 13:00,27.14,41545,3059,196,306,3181,24,6766,4.632.559.524
20/06/2017 14:00,26.39,41301,3192,201,306,3316,28,7043,4.632.559.524
20/06/2017 15:00,24.77,40800,3278,206,293,3382,27,7186,4.632.559.524
20/06/2017 16:00,24.29,40285,3357,208,273,3359,20,7217,4.632.559.524
20/06/2017 17:00,24.47,40197,3378,209,231,3369,13,7200,4.632.559.524
20/06/2017 18:00,24.93,39579,3305,202,161,3238,7,6913,4.632.559.524
20/06/2017 19:00,25.2,39235,3180,191,127,3074,4,6576,4.632.559.524
20/06/2017 20:00,24.47,38624,2969,182,111,3085,3,6350,4.632.559.524
20/06/2017 21:00,24.31,37861,2691,172,93,3103,3,6062,4.632.559.524
20/06/2017 22:00,24.4,37001,2399,154,77,3076,4,5710,4.632.559.524
20/06/2017 23:00,24.03,35225,2210,156,86,3108,9,5569,4.632.559.524
21/06/2017 00:00,23.94,32889,2057,152,74,3132,8,5423,4.632.559.524
21/06/2017 01:00,23.27,31660,1948,145,72,3107,12,5284,4.632.559.524
21/06/2017 02:00,23.07,31078,1846,137,71,3028,16,5098,4.632.559.524
21/06/2017 03:00,22.94,30819,1686,130,76,2932,17,4841,4.632.559.524
21/06/2017 04:00,22.93,30748,1534,129,83,2812,12,4570,4.632.559.524
21/06/2017 05:00,24.13,32331,1472,137,79,2717,10,4415,4.632.559.524
21/06/2017 06:00,25.45,35739,1509,142,79,2625,9,4364,4.632.559.524
21/06/2017 07:00,26.9,39432,1564,146,85,2474,9,4278,4.632.559.524
21/06/2017 08:00,29.34,41346,1371,158,94,2308,10,3941,4.632.559.524
21/06/2017 09:00,29.6,41007,1085,170,172,2217,14,3658,4.632.559.524
21/06/2017 10:00,30.07,41143,926,182,210,2051,16,3385,4.632.559.524
21/06/2017 11:00,29.61,41082,872,187,222,2074,17,3372,4.632.559.524
21/06/2017 12:00,27.57,40830,891,189,236,2159,26,3501,4.632.559.524
21/06/2017 13:00,27.49,40716,921,193,253,2333,34,3734,4.632.559.524
21/06/2017 14:00,27.35,40409,976,194,256,2325,37,3788,4.632.559.524
21/06/2017 15:00,26.49,39993,983,191,258,2361,31,3824,4.632.559.524
21/06/2017 16:00,26.14,39438,997,188,237,2266,21,3709,4.632.559.524
21/06/2017 17:00,27.09,39267,998,180,209,2166,15,3568,4.632.559.524
21/06/2017 18:00,27.4,38832,901,166,141,2096,13,3317,4.632.559.524
21/06/2017 19:00,27.65,38368,772,151,127,1927,11,2988,4.632.559.524
21/06/2017 20:00,27.16,37567,674,138,112,1861,9,2794,4.632.559.524
21/06/2017 21:00,28.42,36951,586,126,97,1818,7,2634,4.632.559.524
21/06/2017 22:00,28.99,36254,509,98,87,1805,7,2506,4.632.559.524
21/06/2017 23:00,26.5,34715,458,90,78,1795,8,2429,4.632.559.524
22/06/2017 00:00,26.09,33139,450,83,74,1792,7,2406,4.632.559.524
22/06/2017 01:00,25.04,32051,414,82,76,1765,5,2342,4.632.559.524
22/06/2017 02:00,24.85,31559,374,78,84,1662,5,2203,4.632.559.524
22/06/2017 03:00,24.72,31280,354,71,87,1549,5,2066,4.632.559.524
22/06/2017 04:00,24.7,31241,354,62,88,1455,4,1963,4.632.559.524
22/06/2017 05:00,25.52,32583,357,56,84,1298,4,1799,4.632.559.524
22/06/2017 06:00,28.36,35786,358,53,83,1172,3,1669,4.632.559.524
22/06/2017 07:00,30.2,39294,360,58,84,1046,3,1551,4.632.559.524
22/06/2017 08:00,30.77,40899,401,71,92,939,5,1508,4.632.559.524
22/06/2017 09:00,30.04,40513,471,87,103,870,7,1538,4.632.559.524
22/06/2017 10:00,29.25,40981,497,102,112,795,8,1514,4.632.559.524
22/06/2017 11:00,28.99,41102,506,115,120,738,12,1491,4.632.559.524
22/06/2017 12:00,28.69,40822,509,121,126,743,17,1516,4.632.559.524
22/06/2017 13:00,27.9,40621,543,124,132,648,18,1465,4.632.559.524
22/06/2017 14:00,27.32,40202,548,123,136,595,15,1417,4.632.559.524
22/06/2017 15:00,27.12,39629,527,117,135,587,14,1380,4.632.559.524
22/06/2017 16:00,27.07,39179,541,107,119,565,10,1342,4.632.559.524
22/06/2017 17:00,28.48,39092,506,94,96,499,7,1202,4.632.559.524
22/06/2017 18:00,28.87,38610,495,80,74,399,5,1053,4.632.559.524
22/06/2017 19:00,29.12,38134,563,72,57,358,4,1054,4.632.559.524
22/06/2017 20:00,27.47,37391,556,67,46,329,4,1002,4.632.559.524
22/06/2017 21:00,27.09,36856,540,63,40,340,3,986,4.632.559.524
22/06/2017 22:00,27.5,36049,626,59,34,358,4,1081,4.632.559.524
22/06/2017 23:00,26.34,34431,694,54,10,387,3,1148,4.632.559.524
23/06/2017 00:00,24.92,32357,680,46,7,396,3,1132,4.632.559.524
23/06/2017 01:00,23.62,30962,712,38,5,403,3,1161,4.632.559.524
23/06/2017 02:00,22.5,30337,733,31,5,370,2,1141,4.632.559.524
23/06/2017 03:00,21.49,29974,775,25,6,356,2,1164,4.632.559.524
23/06/2017 04:00,21.68,29653,861,23,10,331,2,1227,4.632.559.524
23/06/2017 05:00,23.36,30346,871,23,13,284,3,1194,4.632.559.524
23/06/2017 06:00,25.72,32440,824,24,18,239,2,1107,4.632.559.524
23/06/2017 07:00,27.29,35204,830,24,22,220,2,1098,4.632.559.524
23/06/2017 08:00,28.59,36783,895,26,23,226,3,1173,4.632.559.524
23/06/2017 09:00,28.79,36915,980,28,24,248,4,1284,4.632.559.524
23/06/2017 10:00,28.03,37579,1056,29,24,302,5,1416,4.632.559.524
23/06/2017 11:00,27.45,37641,1099,31,24,358,7,1519,4.632.559.524
23/06/2017 12:00,26.94,37498,1177,31,21,431,6,1666,4.632.559.524
23/06/2017 13:00,26.01,37217,1306,30,17,512,8,1873,4.632.559.524
23/06/2017 14:00,25.16,36613,1483,28,16,674,7,2208,4.632.559.524
23/06/2017 15:00,24.64,36071,1715,26,16,845,8,2610,4.632.559.524
23/06/2017 16:00,24.52,35902,2063,24,16,1049,7,3159,4.632.559.524
23/06/2017 17:00,25.42,35845,2271,21,16,1233,7,3548,4.632.559.524
23/06/2017 18:00,25.4,35604,2217,17,14,1432,7,3687,4.632.559.524
23/06/2017 19:00,25.33,35024,2018,14,17,1553,6,3608,4.632.559.524
23/06/2017 20:00,24.69,34345,1751,12,20,1679,6,3468,4.632.559.524
23/06/2017 21:00,24.53,33975,1553,11,23,1806,6,3399,4.632.559.524
23/06/2017 22:00,24.63,33758,1482,18,31,1918,8,3457,4.632.559.524
23/06/2017 23:00,24.42,33025,1509,9,43,1960,5,3526,4.632.559.524
24/06/2017 00:00,24.41,31345,2182,7,43,1968,6,4206,4.632.559.524
24/06/2017 01:00,23.76,30190,2229,6,40,1953,5,4233,4.632.559.524
24/06/2017 02:00,23.21,29439,2184,8,36,1906,4,4138,4.632.559.524
24/06/2017 03:00,22.19,28979,2015,9,31,1882,4,3941,4.632.559.524
24/06/2017 04:00,20.07,28585,1855,10,27,1860,5,3757,4.632.559.524
24/06/2017 05:00,19.71,28524,1727,12,27,1848,6,3620,4.632.559.524
24/06/2017 06:00,22.05,29051,1645,13,34,1929,7,3628,4.632.559.524
24/06/2017 07:00,23.72,30220,1609,15,48,1995,7,3674,4.632.559.524
24/06/2017 08:00,23.98,31878,1708,19,65,2052,8,3852,4.632.559.524
24/06/2017 09:00,23.93,33000,1860,22,80,2197,9,4168,4.632.559.524
24/06/2017 10:00,22.88,34054,1918,27,101,2342,9,4397,4.632.559.524
24/06/2017 11:00,22.37,34383,2043,33,122,2470,13,4681,4.632.559.524
24/06/2017 12:00,22.14,34388,2316,37,139,2526,13,5031,4.632.559.524
24/06/2017 13:00,21.42,34295,2540,40,163,2615,13,5371,4.632.559.524
24/06/2017 14:00,20.6,34158,2743,42,204,2775,14,5778,4.632.559.524
24/06/2017 15:00,19.68,33950,2816,47,203,2879,16,5961,4.632.559.524
24/06/2017 16:00,19.27,33982,2811,51,201,2896,17,5976,4.632.559.524
24/06/2017 17:00,22.07,34425,2841,56,201,2847,17,5962,4.632.559.524
24/06/2017 18:00,23.58,34562,2812,65,177,2762,20,5836,4.632.559.524
24/06/2017 19:00,23.78,34272,2691,71,169,2752,27,5710,4.632.559.524
24/06/2017 20:00,23.69,33717,2495,72,161,2712,23,5463,4.632.559.524
24/06/2017 21:00,23.74,33309,2319,76,151,2606,20,5172,4.632.559.524
24/06/2017 22:00,23.87,33062,2217,82,142,2633,20,5094,4.632.559.524
24/06/2017 23:00,23.49,32271,2157,77,288,2523,32,5077,4.632.559.524
25/06/2017 00:00,23.95,30940,2386,81,296,2531,27,5321,4.632.559.524
25/06/2017 01:00,23.03,29953,2327,80,300,2393,25,5125,4.632.559.524
25/06/2017 02:00,20.79,29295,2218,77,302,2282,23,4902,4.632.559.524
25/06/2017 03:00,18.25,28867,2083,76,280,2160,21,4620,4.632.559.524
25/06/2017 04:00,14.45,28514,1993,80,263,2079,21,4436,4.632.559.524
25/06/2017 05:00,10.25,28394,1943,83,246,2085,24,4381,4.632.559.524
25/06/2017 06:00,10.26,28943,2049,89,250,2179,28,4595,4.632.559.524
25/06/2017 07:00,17.69,29939,2277,96,250,2248,32,4903,4.632.559.524
25/06/2017 08:00,19.26,31460,2614,109,265,2339,34,5361,4.632.559.524
25/06/2017 09:00,21.22,32657,3008,128,273,2424,34,5867,4.632.559.524
25/06/2017 10:00,21.9,33912,3277,143,278,2579,38,6315,4.632.559.524
25/06/2017 11:00,21.87,34525,3385,155,277,2752,36,6605,4.632.559.524
25/06/2017 12:00,21.69,34672,3504,163,270,2913,39,6889,4.632.559.524
25/06/2017 13:00,21.05,34642,3631,167,257,3106,42,7203,4.632.559.524
25/06/2017 14:00,19.97,34578,3742,166,226,3172,42,7348,4.632.559.524
25/06/2017 15:00,19.76,34470,3792,164,183,3179,44,7362,4.632.559.524
25/06/2017 16:00,20.16,34614,3875,159,129,3153,35,7351,4.632.559.524
25/06/2017 17:00,17.42,35009,3879,152,119,2953,35,7138,4.632.559.524
25/06/2017 18:00,21.68,35225,3829,144,131,2889,35,7028,4.632.559.524
25/06/2017 19:00,23.2,35237,3719,139,150,2812,30,6850,4.632.559.524
25/06/2017 20:00,23.21,34928,3576,136,173,2822,28,6735,4.632.559.524
25/06/2017 21:00,23.37,34737,3527,134,190,2862,27,6740,4.632.559.524
25/06/2017 22:00,23.2,34317,3515,120,210,2862,32,6739,4.632.559.524
25/06/2017 23:00,21.8,33196,3570,119,261,2897,21,6868,4.632.559.524
26/06/2017 00:00,21.9,31474,3697,115,262,2872,22,6968,4.846.369.048
26/06/2017 01:00,20.45,30437,3719,108,261,2761,24,6873,4.846.369.048
26/06/2017 02:00,17.68,29943,3789,98,258,2688,25,6858,4.846.369.048
26/06/2017 03:00,17.41,29753,3832,91,227,2694,24,6868,4.846.369.048
26/06/2017 04:00,17.53,29818,3845,92,218,2567,28,6750,4.846.369.048
26/06/2017 05:00,22.61,31256,3788,94,217,2599,35,6733,4.846.369.048
26/06/2017 06:00,23.96,34584,3803,98,237,2566,37,6741,4.846.369.048
26/06/2017 07:00,24.93,38066,3906,111,256,2446,35,6754,4.846.369.048
26/06/2017 08:00,25.5,38760,4034,123,278,2395,42,6872,4.846.369.048
26/06/2017 09:00,25.45,39437,4054,134,304,2453,45,6990,4.846.369.048
26/06/2017 10:00,25.2,39953,4024,144,315,2564,49,7096,4.846.369.048
26/06/2017 11:00,25,40163,3919,148,340,2607,54,7068,4.846.369.048
26/06/2017 12:00,24.86,40048,3934,152,373,2882,58,7399,4.846.369.048
26/06/2017 13:00,24.89,40050,3938,151,397,3000,62,7548,4.846.369.048
26/06/2017 14:00,24.78,39769,3934,144,407,2886,63,7434,4.846.369.048
26/06/2017 15:00,24.64,39368,3910,134,410,3040,62,7556,4.846.369.048
26/06/2017 16:00,24.7,38939,3900,120,404,3071,58,7553,4.846.369.048
26/06/2017 17:00,24.83,38961,3818,99,399,3090,47,7453,4.846.369.048
26/06/2017 18:00,24.87,38535,3730,89,392,2953,44,7208,4.846.369.048
26/06/2017 19:00,24.84,37965,3551,88,385,2858,44,6926,4.846.369.048
26/06/2017 20:00,24.57,37147,3330,92,378,2909,36,6745,4.846.369.048
26/06/2017 21:00,24.59,36609,3124,99,364,2861,30,6478,4.846.369.048
26/06/2017 22:00,24.39,35883,2922,103,349,2986,29,6389,4.846.369.048
26/06/2017 23:00,23.48,34423,2727,125,306,3097,28,6283,4.846.369.048
27/06/2017 00:00,23.29,32410,2669,129,294,3067,32,6191,4.846.369.048
27/06/2017 01:00,23.05,31270,2384,136,291,3074,38,5923,4.846.369.048
27/06/2017 02:00,22.76,30786,2155,136,280,3034,30,5635,4.846.369.048
27/06/2017 03:00,22.73,30650,1943,136,273,2969,26,5347,4.846.369.048
27/06/2017 04:00,22.76,30776,1726,128,270,2898,26,5048,4.846.369.048
27/06/2017 05:00,24.01,32312,1460,123,270,2766,28,4647,4.846.369.048
27/06/2017 06:00,24.92,35623,1265,121,281,2704,28,4399,4.846.369.048
27/06/2017 07:00,27.14,39148,1219,129,295,2634,28,4305,4.846.369.048
27/06/2017 08:00,27.52,40681,1162,133,302,2549,26,4172,4.846.369.048
27/06/2017 09:00,27.74,41212,958,140,308,2354,27,3787,4.846.369.048
27/06/2017 10:00,27.79,41466,720,145,310,2317,27,3519,4.846.369.048
27/06/2017 11:00,27.77,41347,551,150,302,2192,27,3222,4.846.369.048
27/06/2017 12:00,27.19,40931,415,154,284,2134,27,3014,4.846.369.048
27/06/2017 13:00,27.03,40789,318,157,270,2107,26,2878,4.846.369.048
27/06/2017 14:00,26.71,40604,237,158,245,2051,22,2713,4.846.369.048
27/06/2017 15:00,25.93,40060,172,157,188,1954,19,2490,4.846.369.048
27/06/2017 16:00,25.47,39570,127,152,140,1898,14,2331,4.846.369.048
27/06/2017 17:00,25.62,39434,116,147,108,1857,13,2241,4.846.369.048
27/06/2017 18:00,26.04,39001,130,139,69,1753,12,2103,4.846.369.048
27/06/2017 19:00,26.19,38424,159,131,42,1658,10,2000,4.846.369.048
27/06/2017 20:00,25.33,37598,196,124,25,1510,6,1861,4.846.369.048
27/06/2017 21:00,24.83,36956,197,118,17,1473,6,1811,4.846.369.048
27/06/2017 22:00,24.5,36140,210,101,14,1455,6,1786,4.846.369.048
27/06/2017 23:00,24.23,34674,268,97,10,1385,5,1765,4.846.369.048
28/06/2017 00:00,24.25,32887,262,91,8,1388,5,1754,4.846.369.048
28/06/2017 01:00,23.83,31747,367,84,9,1406,5,1871,4.846.369.048
28/06/2017 02:00,23.62,31231,476,75,11,1411,4,1977,4.846.369.048
28/06/2017 03:00,23.58,30998,564,64,18,1390,4,2040,4.846.369.048
28/06/2017 04:00,23.56,31016,668,51,28,1336,4,2087,4.846.369.048
28/06/2017 05:00,23.91,32557,775,40,28,1158,3,2004,4.846.369.048
28/06/2017 06:00,24.84,35796,835,33,28,1037,2,1935,4.846.369.048
28/06/2017 07:00,26.43,39279,914,30,32,946,2,1924,4.846.369.048
28/06/2017 08:00,27.57,40871,1032,30,42,858,3,1965,4.846.369.048
28/06/2017 09:00,27.42,41201,1178,33,53,826,4,2094,4.846.369.048
28/06/2017 10:00,27.35,41457,1373,35,65,835,5,2313,4.846.369.048
28/06/2017 11:00,27.33,41566,1562,34,76,895,5,2572,4.846.369.048
28/06/2017 12:00,26.92,41397,1783,33,82,963,5,2866,4.846.369.048
28/06/2017 13:00,26.75,41178,2025,31,103,1044,7,3210,4.846.369.048
28/06/2017 14:00,26.04,40693,2247,26,138,1151,9,3571,4.846.369.048
28/06/2017 15:00,25.22,40142,2424,22,159,1244,12,3861,4.846.369.048
28/06/2017 16:00,25.22,39642,2603,18,172,1394,16,4203,4.846.369.048
28/06/2017 17:00,25.7,39424,2758,14,180,1490,19,4461,4.846.369.048
28/06/2017 18:00,25.93,38913,2883,12,183,1572,20,4670,4.846.369.048
28/06/2017 19:00,25.81,38400,2971,12,195,1658,19,4855,4.846.369.048
28/06/2017 20:00,24.84,37504,3017,13,215,1746,15,5006,4.846.369.048
28/06/2017 21:00,24.42,36872,3129,17,233,1900,20,5299,4.846.369.048
28/06/2017 22:00,24.13,36159,3309,39,249,2018,24,5639,4.846.369.048
28/06/2017 23:00,23.69,34686,3431,27,243,2108,24,5833,4.846.369.048
29/06/2017 00:00,22.41,33008,3686,31,254,2166,26,6163,4.846.369.048
29/06/2017 01:00,22,31831,3615,34,265,2187,26,6127,4.846.369.048
29/06/2017 02:00,21.97,31282,3575,36,273,2212,25,6121,4.846.369.048
29/06/2017 03:00,21.99,30951,3412,40,271,2255,29,6007,4.846.369.048
29/06/2017 04:00,22.02,30883,3202,43,268,2315,28,5856,4.846.369.048
29/06/2017 05:00,23.07,32518,3008,41,264,2352,33,5698,4.846.369.048
29/06/2017 06:00,24.53,35607,2827,34,255,2373,34,5523,4.846.369.048
29/06/2017 07:00,26.35,39078,2659,37,244,2417,40,5397,4.846.369.048
29/06/2017 08:00,27.78,40858,2571,49,235,2514,46,5415,4.846.369.048
29/06/2017 09:00,27.91,41140,2502,62,222,2587,50,5423,4.846.369.048
29/06/2017 10:00,27.89,41560,2414,83,207,2672,56,5432,4.846.369.048
29/06/2017 11:00,27.33,41669,2187,106,193,2734,55,5275,4.846.369.048
29/06/2017 12:00,26.5,41279,2063,126,195,2809,53,5246,4.846.369.048
29/06/2017 13:00,26.47,41082,1844,139,192,2819,53,5047,4.846.369.048
29/06/2017 14:00,25.89,40695,1674,150,186,2834,53,4897,4.846.369.048
29/06/2017 15:00,25.13,40265,1601,155,170,2880,50,4856,4.846.369.048
29/06/2017 16:00,25.07,39823,1618,159,166,2901,49,4893,4.846.369.048
29/06/2017 17:00,25.2,39688,1600,161,167,2880,48,4856,4.846.369.048
29/06/2017 18:00,25.61,39269,1542,164,163,2871,42,4782,4.846.369.048
29/06/2017 19:00,25.39,38680,1403,168,161,2922,41,4695,4.846.369.048
29/06/2017 20:00,24.88,37826,1312,174,163,2953,43,4645,4.846.369.048
29/06/2017 21:00,24.35,37149,1246,179,159,3002,44,4630,4.846.369.048
29/06/2017 22:00,24.14,36355,1246,163,151,3044,39,4643,4.846.369.048
29/06/2017 23:00,23.57,34757,1203,186,167,2932,32,4520,4.846.369.048
30/06/2017 00:00,23.6,32851,1547,193,160,2998,29,4927,4.846.369.048
30/06/2017 01:00,22.76,31669,1580,200,152,3006,27,4965,4.846.369.048
30/06/2017 02:00,22.26,31083,1610,206,140,3011,22,4989,4.846.369.048
30/06/2017 03:00,22.1,30732,1651,209,130,2954,15,4959,4.846.369.048
30/06/2017 04:00,22.16,30659,1701,211,124,2917,12,4965,4.846.369.048
30/06/2017 05:00,23.32,32276,1648,210,121,2830,12,4821,4.846.369.048
30/06/2017 06:00,24.68,35407,1580,208,120,2738,11,4657,4.846.369.048
30/06/2017 07:00,26.45,39029,1621,202,123,2669,11,4626,4.846.369.048
30/06/2017 08:00,27.44,40423,1759,198,138,2728,13,4836,4.846.369.048
30/06/2017 09:00,26.84,40933,1921,193,167,2816,17,5114,4.846.369.048
30/06/2017 10:00,26.73,41334,2058,189,192,2907,19,5365,4.846.369.048
30/06/2017 11:00,25.92,41239,2036,185,212,2914,19,5366,4.846.369.048
30/06/2017 12:00,25.32,40755,2059,179,235,2935,18,5426,4.846.369.048
30/06/2017 13:00,24.99,40200,1997,174,250,2894,20,5335,4.846.369.048
30/06/2017 14:00,24.57,39614,1874,168,263,2798,20,5123,4.846.369.048
30/06/2017 15:00,23.81,38964,1761,164,273,2755,18,4971,4.846.369.048
30/06/2017 16:00,23.95,38403,1715,157,274,2722,14,4882,4.846.369.048
30/06/2017 17:00,24.32,38212,1699,153,270,2636,14,4772,4.846.369.048
30/06/2017 18:00,24.62,37862,1674,152,268,2504,13,4611,4.846.369.048
30/06/2017 19:00,24.35,37138,1595,147,273,2416,13,4444,4.846.369.048
30/06/2017 20:00,23.93,36025,1562,142,282,2365,8,4359,4.846.369.048
30/06/2017 21:00,23.62,35132,1587,137,293,2295,5,4317,4.846.369.048
30/06/2017 22:00,23.52,34499,1657,146,304,2208,5,4320,4.846.369.048
30/06/2017 23:00,22.99,33421,1646,163,260,2010,5,4084,4.846.369.048
01/07/2017 00:00,24.07,32108,1494,155,265,1967,5,3886,4.846.369.048
01/07/2017 01:00,23.59,30895,1456,151,270,1907,4,3788,4.846.369.048
01/07/2017 02:00,23.27,30200,1350,147,270,1768,3,3538,4.846.369.048
01/07/2017 03:00,23.2,29745,1248,145,270,1630,4,3297,4.846.369.048
01/07/2017 04:00,23.07,29337,1215,144,275,1510,3,3147,4.846.369.048
01/07/2017 05:00,23.24,29419,1190,141,275,1387,4,2997,4.846.369.048
01/07/2017 06:00,23.6,30120,1165,141,270,1283,3,2862,4.846.369.048
01/07/2017 07:00,23.94,31496,1124,142,270,1216,3,2755,4.846.369.048
01/07/2017 08:00,24.39,33393,1103,143,270,1235,5,2756,4.846.369.048
01/07/2017 09:00,24.99,35086,1252,143,270,1257,5,2927,4.846.369.048
01/07/2017 10:00,25.35,36103,1382,142,265,1329,5,3123,4.846.369.048
01/07/2017 11:00,25.41,36172,1337,142,265,1372,6,3122,4.846.369.048
01/07/2017 12:00,24.61,35949,1426,141,265,1306,5,3143,4.846.369.048
01/07/2017 13:00,24.22,35552,1433,137,260,1207,6,3043,4.846.369.048
01/07/2017 14:00,24.2,35176,1341,131,240,1092,5,2809,4.846.369.048
01/07/2017 15:00,23.98,34939,1244,126,220,987,6,2583,4.846.369.048
01/07/2017 16:00,23.97,34914,1244,118,190,934,5,2491,4.846.369.048
01/07/2017 17:00,24.37,35254,1290,111,150,892,5,2448,4.846.369.048
01/07/2017 18:00,24.48,35432,1292,105,130,887,5,2419,4.846.369.048
01/07/2017 19:00,24.43,34970,1181,99,120,961,7,2368,4.846.369.048
01/07/2017 20:00,24.43,34136,1084,95,115,1055,6,2355,4.846.369.048
01/07/2017 21:00,24.35,33671,1127,91,115,1139,5,2477,4.846.369.048
01/07/2017 22:00,24.26,33355,1284,79,105,1233,6,2707,4.846.369.048
01/07/2017 23:00,24.14,32569,1476,88,95,1241,7,2907,4.846.369.048
02/07/2017 00:00,24.14,31212,1645,83,100,1270,8,3106,4.846.369.048
02/07/2017 01:00,22.96,30186,1798,80,100,1301,7,3286,4.846.369.048
02/07/2017 02:00,22.64,29458,1911,79,105,1306,7,3408,4.846.369.048
02/07/2017 03:00,22.55,28990,2043,78,110,1295,7,3533,4.846.369.048
02/07/2017 04:00,20.27,28579,2159,76,110,1262,6,3613,4.846.369.048
02/07/2017 05:00,20.59,28565,2140,69,110,1165,5,3489,4.846.369.048
02/07/2017 06:00,21.41,29145,2140,62,120,1149,5,3476,4.846.369.048
02/07/2017 07:00,22.87,30182,2218,58,140,1229,5,3650,4.846.369.048
02/07/2017 08:00,23.49,31298,2284,53,150,1434,5,3926,4.846.369.048
02/07/2017 09:00,23.8,32872,2327,51,165,1656,6,4205,4.846.369.048
02/07/2017 10:00,23.61,34091,2445,46,180,1982,6,4659,4.846.369.048
02/07/2017 11:00,23.49,34621,2658,42,180,2280,6,5166,4.846.369.048
02/07/2017 12:00,23.12,34753,2925,39,185,2503,6,5658,4.846.369.048
02/07/2017 13:00,22.92,34668,3201,36,195,2699,7,6138,4.846.369.048
02/07/2017 14:00,22.67,34574,3455,31,210,2873,7,6576,4.846.369.048
02/07/2017 15:00,22.37,34486,3620,27,215,2985,8,6855,4.846.369.048
02/07/2017 16:00,22.26,34649,3772,21,215,3047,7,7062,4.846.369.048
02/07/2017 17:00,22.43,35005,3867,17,215,3072,6,7177,4.846.369.048
02/07/2017 18:00,23.51,35260,3897,14,200,3016,6,7133,4.846.369.048
02/07/2017 19:00,23.77,35196,3830,12,195,2947,7,6991,4.846.369.048
02/07/2017 20:00,23.88,34913,3732,11,160,2905,7,6815,4.846.369.048
02/07/2017 21:00,24.12,34797,3606,12,150,2818,6,6592,4.846.369.048
02/07/2017 22:00,24.17,34425,3484,21,150,2818,8,6481,4.846.369.048
02/07/2017 23:00,24.19,33332,3435,16,175,2850,11,6487,4.846.369.048
03/07/2017 00:00,22.83,31384,2877,16,180,2779,12,5864,4.966.190.476
03/07/2017 01:00,22.64,30301,3234,17,190,2702,12,6155,4.966.190.476
03/07/2017 02:00,22.36,29725,3346,16,220,2648,18,6248,4.966.190.476
03/07/2017 03:00,22.35,29529,3277,17,230,2624,20,6168,4.966.190.476
03/07/2017 04:00,22.72,29638,3044,18,230,2621,19,5932,4.966.190.476
03/07/2017 05:00,23.5,31348,2780,16,235,2652,19,5702,4.966.190.476
03/07/2017 06:00,24.52,34396,2704,15,255,2637,18,5629,4.966.190.476
03/07/2017 07:00,25.18,37917,2863,18,270,2584,14,5749,4.966.190.476
03/07/2017 08:00,26.21,39257,2976,23,280,2618,19,5916,4.966.190.476
03/07/2017 09:00,26.28,40150,2998,34,300,2755,21,6108,4.966.190.476
03/07/2017 10:00,26.53,40716,3015,40,320,2829,24,6228,4.966.190.476
03/07/2017 11:00,26.31,40976,2981,47,340,2827,29,6224,4.966.190.476
03/07/2017 12:00,26.08,40520,2969,55,355,2767,30,6176,4.966.190.476
03/07/2017 13:00,25.86,40501,3023,57,360,2797,31,6268,4.966.190.476
03/07/2017 14:00,25.54,40283,3124,57,365,2831,33,6410,4.966.190.476
03/07/2017 15:00,25.48,39870,3085,54,360,2827,35,6361,4.966.190.476
03/07/2017 16:00,25.45,39396,3013,49,350,2774,32,6218,4.966.190.476
03/07/2017 17:00,25.51,39364,2981,44,320,2609,28,5982,4.966.190.476
03/07/2017 18:00,25.41,39056,3003,41,305,2398,22,5769,4.966.190.476
03/07/2017 19:00,25.23,38427,3021,42,285,2241,18,5607,4.966.190.476
03/07/2017 20:00,25.2,37542,2998,48,275,2262,15,5598,4.966.190.476
03/07/2017 21:00,24.93,36908,3035,54,250,2249,13,5601,4.966.190.476
03/07/2017 22:00,24.83,36089,3041,59,240,2323,14,5677,4.966.190.476
03/07/2017 23:00,24.33,34516,3097,74,214,2334,17,5736,4.966.190.476
04/07/2017 00:00,24.5,32524,2798,72,208,2435,15,5528,4.966.190.476
04/07/2017 01:00,23.8,31409,2842,65,204,2521,12,5644,4.966.190.476
04/07/2017 02:00,23.31,30812,2873,58,201,2595,10,5737,4.966.190.476
04/07/2017 03:00,23.17,30516,2805,54,189,2689,7,5744,4.966.190.476
04/07/2017 04:00,23.19,30486,2637,46,178,2800,6,5667,4.966.190.476
04/07/2017 05:00,23.65,32191,2414,39,173,2870,6,5502,4.966.190.476
04/07/2017 06:00,24.96,35160,2322,33,177,3016,6,5554,4.966.190.476
04/07/2017 07:00,26.07,38510,2310,29,186,3014,5,5544,4.966.190.476
04/07/2017 08:00,27.33,39330,2323,26,197,2970,6,5522,4.966.190.476
04/07/2017 09:00,27.98,40109,2377,26,211,2917,6,5537,4.966.190.476
04/07/2017 10:00,28.5,40764,2331,23,232,2899,9,5494,4.966.190.476
04/07/2017 11:00,28.14,40975,2170,23,246,2943,13,5395,4.966.190.476
04/07/2017 12:00,27.88,40690,2093,24,267,2950,14,5348,4.966.190.476
04/07/2017 13:00,27.59,40757,2133,26,283,2999,20,5461,4.966.190.476
04/07/2017 14:00,26.93,40498,2228,35,291,2968,24,5546,4.966.190.476
04/07/2017 15:00,26.7,39992,2305,45,289,2916,27,5582,4.966.190.476
04/07/2017 16:00,26.65,39517,2388,54,284,2857,27,5610,4.966.190.476
04/07/2017 17:00,26.99,39405,2377,60,274,2677,26,5414,4.966.190.476
04/07/2017 18:00,26.87,39062,2308,64,248,2457,23,5100,4.966.190.476
04/07/2017 19:00,26.93,38497,2168,67,227,2358,27,4847,4.966.190.476
04/07/2017 20:00,26.8,37687,1912,72,191,2354,25,4554,4.966.190.476
04/07/2017 21:00,26.37,37092,1692,81,154,2348,25,4300,4.966.190.476
04/07/2017 22:00,26.16,36283,1596,95,134,2361,27,4213,4.966.190.476
04/07/2017 23:00,25.6,34801,1565,110,94,2291,9,4069,4.966.190.476
05/07/2017 00:00,25.98,32882,1264,117,77,2354,10,3822,4.966.190.476
05/07/2017 01:00,25.54,31789,1254,119,67,2327,9,3776,4.966.190.476
05/07/2017 02:00,25.3,31189,1242,121,68,2329,11,3771,4.966.190.476
05/07/2017 03:00,25.13,30851,1217,121,66,2308,12,3724,4.966.190.476
05/07/2017 04:00,25.06,30781,1188,123,63,2273,11,3658,4.966.190.476
05/07/2017 05:00,25.55,32104,1132,124,55,2239,10,3560,4.966.190.476
05/07/2017 06:00,26.52,34962,1087,126,35,2177,9,3434,4.966.190.476
05/07/2017 07:00,28.55,38310,1105,122,30,2111,7,3375,4.966.190.476
05/07/2017 08:00,29.99,39642,1113,117,38,2067,12,3347,4.966.190.476
05/07/2017 09:00,29.73,40455,1106,118,48,2043,18,3333,4.966.190.476
05/07/2017 10:00,29.72,40987,1082,125,57,2002,22,3288,4.966.190.476
05/07/2017 11:00,28.74,41128,1076,138,71,2003,19,3307,4.966.190.476
05/07/2017 12:00,27.98,41006,1093,149,87,2059,16,3404,4.966.190.476
05/07/2017 13:00,27.71,40907,1134,158,101,2051,17,3461,4.966.190.476
05/07/2017 14:00,27.58,40607,1188,160,115,2039,17,3519,4.966.190.476
05/07/2017 15:00,27,40117,1221,158,108,2027,12,3526,4.966.190.476
05/07/2017 16:00,26.99,39628,1236,151,98,2000,7,3492,4.966.190.476
05/07/2017 17:00,27.75,39442,1181,138,84,1954,5,3362,4.966.190.476
05/07/2017 18:00,27.74,39080,1103,125,66,1857,5,3156,4.966.190.476
05/07/2017 19:00,27.74,38571,1041,116,60,1820,5,3042,4.966.190.476
05/07/2017 20:00,27.73,37667,917,112,60,1840,4,2933,4.966.190.476
05/07/2017 21:00,27.66,37072,747,108,59,1853,3,2770,4.966.190.476
05/07/2017 22:00,27.19,36256,719,95,56,1869,4,2743,4.966.190.476
05/07/2017 23:00,26.23,34821,730,88,52,1898,3,2771,4.966.190.476
06/07/2017 00:00,26.19,33264,670,80,45,1926,4,2725,4.966.190.476
06/07/2017 01:00,25.95,32101,626,72,38,1971,3,2710,4.966.190.476
06/07/2017 02:00,25.79,31549,607,63,33,1951,2,2656,4.966.190.476
06/07/2017 03:00,25.69,31235,551,55,30,1901,2,2539,4.966.190.476
06/07/2017 04:00,25.67,31220,468,53,28,1808,3,2360,4.966.190.476
06/07/2017 05:00,25.84,32465,425,55,27,1684,3,2194,4.966.190.476
06/07/2017 06:00,26.83,35267,376,55,21,1520,2,1974,4.966.190.476
06/07/2017 07:00,28.69,38516,336,57,18,1359,3,1773,4.966.190.476
06/07/2017 08:00,29.95,40372,341,62,19,1248,4,1674,4.966.190.476
06/07/2017 09:00,29.72,40778,347,70,25,1159,4,1605,4.966.190.476
06/07/2017 10:00,29.82,41325,358,79,35,1108,6,1586,4.966.190.476
06/07/2017 11:00,28.82,41467,362,92,50,1064,8,1576,4.966.190.476
06/07/2017 12:00,28.26,41370,333,102,69,1065,10,1579,4.966.190.476
06/07/2017 13:00,28.23,41236,336,112,85,1050,12,1595,4.966.190.476
06/07/2017 14:00,28.11,40840,360,118,108,1030,12,1628,4.966.190.476
06/07/2017 15:00,28.1,40362,375,122,115,1003,12,1627,4.966.190.476
06/07/2017 16:00,28.2,39961,359,123,116,1004,10,1612,4.966.190.476
06/07/2017 17:00,29.58,39869,368,114,110,937,8,1537,4.966.190.476
06/07/2017 18:00,30.03,39512,347,104,98,854,5,1408,4.966.190.476
06/07/2017 19:00,30.57,38998,282,91,72,796,4,1245,4.966.190.476
06/07/2017 20:00,30.09,38125,222,82,63,773,4,1144,4.966.190.476
06/07/2017 21:00,29.42,37588,167,77,59,821,4,1128,4.966.190.476
06/07/2017 22:00,28.79,36810,152,60,54,826,5,1097,4.966.190.476
06/07/2017 23:00,26.55,35262,178,61,34,717,8,998,4.966.190.476
07/07/2017 00:00,27.57,33217,145,57,29,734,7,972,4.966.190.476
07/07/2017 01:00,27.03,32008,156,51,25,704,7,943,4.966.190.476
07/07/2017 02:00,26.33,31380,172,46,21,669,8,916,4.966.190.476
07/07/2017 03:00,26.25,31071,186,39,17,562,8,812,4.966.190.476
07/07/2017 04:00,26.12,30987,198,33,16,455,7,709,4.966.190.476
07/07/2017 05:00,26.23,32210,201,30,16,345,6,598,4.966.190.476
07/07/2017 06:00,27.73,35048,181,30,14,267,6,498,4.966.190.476
07/07/2017 07:00,29.13,38341,149,29,12,220,9,419,4.966.190.476
07/07/2017 08:00,30.21,39530,115,29,11,195,10,360,4.966.190.476
07/07/2017 09:00,30.53,40321,94,29,11,200,10,344,4.966.190.476
07/07/2017 10:00,30.52,40828,87,29,13,217,10,356,4.966.190.476
07/07/2017 11:00,30.08,40924,85,28,14,230,13,370,4.966.190.476
07/07/2017 12:00,29.52,40673,83,29,15,269,11,407,4.966.190.476
07/07/2017 13:00,28.84,40220,73,27,14,280,7,401,4.966.190.476
07/07/2017 14:00,28.4,39662,64,25,14,305,6,414,4.966.190.476
07/07/2017 15:00,27.67,39034,67,23,12,343,5,450,4.966.190.476
07/07/2017 16:00,27.56,38542,86,21,11,399,4,521,4.966.190.476
07/07/2017 17:00,27.8,38376,90,18,10,416,3,537,4.966.190.476
07/07/2017 18:00,28.34,38007,89,14,10,427,3,543,4.966.190.476
07/07/2017 19:00,28.21,37213,99,13,12,469,3,596,4.966.190.476
07/07/2017 20:00,27.96,36050,94,11,13,548,3,669,4.966.190.476
07/07/2017 21:00,27.82,35297,77,11,15,685,3,791,4.966.190.476
07/07/2017 22:00,28.01,34728,76,12,17,740,3,848,4.966.190.476
07/07/2017 23:00,27.41,33644,86,13,51,766,3,919,4.966.190.476
08/07/2017 00:00,28.23,32229,281,11,51,797,3,1143,4.966.190.476
08/07/2017 01:00,27.94,31055,353,10,51,735,3,1152,4.966.190.476
08/07/2017 02:00,27.12,30368,416,8,49,714,3,1190,4.966.190.476
08/07/2017 03:00,26.5,29949,515,7,47,605,4,1178,4.966.190.476
08/07/2017 04:00,26.42,29517,636,6,45,528,5,1220,4.966.190.476
08/07/2017 05:00,26.15,29634,733,4,38,458,4,1237,4.966.190.476
08/07/2017 06:00,26.2,30372,821,3,23,411,4,1262,4.966.190.476
08/07/2017 07:00,26.72,31838,985,3,17,438,4,1447,4.966.190.476
08/07/2017 08:00,27.4,33721,1170,4,15,522,4,1715,4.966.190.476
08/07/2017 09:00,27.9,34853,1254,6,15,592,4,1871,4.966.190.476
08/07/2017 10:00,28.09,35912,1409,7,20,685,4,2125,4.966.190.476
08/07/2017 11:00,28.07,36229,1665,9,24,801,4,2503,4.966.190.476
08/07/2017 12:00,27.6,36156,1927,10,25,891,4,2857,4.966.190.476
08/07/2017 13:00,27.07,35924,2147,10,28,959,4,3148,4.966.190.476
08/07/2017 14:00,26.68,35584,2322,8,31,976,4,3341,4.966.190.476
08/07/2017 15:00,26.56,35393,2485,7,31,1058,4,3585,4.966.190.476
08/07/2017 16:00,26.79,35423,2645,7,30,1063,4,3749,4.966.190.476
08/07/2017 17:00,27.46,35766,2730,7,27,1032,3,3799,4.966.190.476
08/07/2017 18:00,27.55,35793,2774,8,24,952,3,3761,4.966.190.476
08/07/2017 19:00,27.44,35275,2766,9,24,974,3,3776,4.966.190.476
08/07/2017 20:00,27.12,34536,2567,9,23,1021,3,3623,4.966.190.476
08/07/2017 21:00,27.02,34134,2231,10,23,1123,4,3391,4.966.190.476
08/07/2017 22:00,26.98,33825,2013,11,24,1205,4,3257,4.966.190.476
08/07/2017 23:00,26.73,32954,1909,10,38,1261,8,3226,4.966.190.476
09/07/2017 00:00,27.11,31399,1873,10,41,1226,6,3156,4.966.190.476
09/07/2017 01:00,26.68,30416,1821,10,41,1154,5,3031,4.966.190.476
09/07/2017 02:00,26.5,29794,1730,11,43,1095,5,2884,4.966.190.476
09/07/2017 03:00,26.4,29364,1628,9,44,1037,6,2724,4.966.190.476
09/07/2017 04:00,26.2,28939,1548,7,44,964,7,2570,4.966.190.476
09/07/2017 05:00,26.24,28943,1405,6,43,804,7,2265,4.966.190.476
09/07/2017 06:00,26.34,29534,1276,5,41,730,9,2061,4.966.190.476
09/07/2017 07:00,26.28,30674,1215,5,41,719,9,1989,4.966.190.476
09/07/2017 08:00,26.6,31229,1179,4,47,745,9,1984,4.966.190.476
09/07/2017 09:00,26.87,32854,1146,4,59,807,10,2026,4.966.190.476
09/07/2017 10:00,27.04,34122,1118,6,78,919,12,2133,4.966.190.476
09/07/2017 11:00,27.25,34695,1028,8,91,1049,14,2190,4.966.190.476
09/07/2017 12:00,27.13,34827,908,10,114,1181,17,2230,4.966.190.476
09/07/2017 13:00,27.08,34848,836,10,120,1290,19,2275,4.966.190.476
09/07/2017 14:00,27.01,34651,790,11,120,1269,18,2208,4.966.190.476
09/07/2017 15:00,27.01,34533,707,11,110,1267,15,2110,4.966.190.476
09/07/2017 16:00,26.74,34651,610,11,105,1257,12,1995,4.966.190.476
09/07/2017 17:00,27.15,34927,535,9,90,1226,10,1870,4.966.190.476
09/07/2017 18:00,27.21,35147,484,7,66,1123,9,1689,4.966.190.476
09/07/2017 19:00,27.97,35024,399,7,56,1073,7,1542,4.966.190.476
09/07/2017 20:00,27.8,34655,287,8,47,1103,7,1452,4.966.190.476
09/07/2017 21:00,27.94,34433,233,8,42,1202,6,1491,4.966.190.476
09/07/2017 22:00,28.08,34089,290,7,37,1216,6,1556,4.966.190.476
09/07/2017 23:00,27.4,33005,353,4,18,1268,6,1649,4.966.190.476
10/07/2017 00:00,27.63,31447,294,5,14,1211,6,1530,5.184.583.333
10/07/2017 01:00,26.84,30485,287,5,13,1181,5,1491,5.184.583.333
10/07/2017 02:00,26.69,30000,287,6,12,1104,4,1413,5.184.583.333
10/07/2017 03:00,26.66,29780,282,6,9,1023,4,1324,5.184.583.333
10/07/2017 04:00,26.66,29721,253,5,9,911,3,1181,5.184.583.333
10/07/2017 05:00,27.21,30889,213,4,9,798,3,1027,5.184.583.333
10/07/2017 06:00,28.35,33767,189,3,6,716,4,918,5.184.583.333
10/07/2017 07:00,28.78,36985,191,3,6,692,5,897,5.184.583.333
10/07/2017 08:00,29.12,37635,208,5,6,671,5,895,5.184.583.333
10/07/2017 09:00,28.98,38561,228,7,6,718,5,964,5.184.583.333
10/07/2017 10:00,28.79,39197,249,10,6,823,6,1094,5.184.583.333
10/07/2017 11:00,28.48,39461,251,12,6,942,5,1216,5.184.583.333
10/07/2017 12:00,28.31,39403,254,15,8,1012,5,1294,5.184.583.333
10/07/2017 13:00,28.22,39428,271,13,11,961,4,1260,5.184.583.333
10/07/2017 14:00,28.07,39138,281,12,14,892,4,1203,5.184.583.333
10/07/2017 15:00,28.01,38654,265,9,20,868,3,1165,5.184.583.333
10/07/2017 16:00,27.96,38284,247,7,27,836,3,1120,5.184.583.333
10/07/2017 17:00,28.09,38261,231,5,37,756,3,1032,5.184.583.333
10/07/2017 18:00,28.2,37935,216,5,61,648,4,934,5.184.583.333
10/07/2017 19:00,28.32,37380,219,6,95,610,7,937,5.184.583.333
10/07/2017 20:00,28.15,36568,210,9,131,644,6,1000,5.184.583.333
10/07/2017 21:00,27.85,35995,167,14,161,629,9,980,5.184.583.333
10/07/2017 22:00,27.93,35261,156,28,187,638,12,1021,5.184.583.333
10/07/2017 23:00,27.12,33799,152,44,246,655,13,1110,5.184.583.333
11/07/2017 00:00,27.02,31834,94,53,257,634,13,1051,5.184.583.333
11/07/2017 01:00,26.77,30708,111,60,258,595,14,1038,5.184.583.333
11/07/2017 02:00,26.6,30155,112,66,263,603,19,1063,5.184.583.333
11/07/2017 03:00,26.39,29918,122,72,252,589,20,1055,5.184.583.333
11/07/2017 04:00,26.41,29823,134,78,225,576,21,1034,5.184.583.333
11/07/2017 05:00,26.67,30945,148,82,140,497,22,889,5.184.583.333
11/07/2017 06:00,27.62,33601,155,84,122,465,21,847,5.184.583.333
11/07/2017 07:00,28.29,36593,155,91,113,501,23,883,5.184.583.333
11/07/2017 08:00,28.64,37510,172,108,121,551,22,974,5.184.583.333
11/07/2017 09:00,28.62,38523,222,126,144,564,19,1075,5.184.583.333
11/07/2017 10:00,28.36,39270,298,140,162,611,17,1228,5.184.583.333
11/07/2017 11:00,28.18,39448,378,150,191,705,14,1438,5.184.583.333
11/07/2017 12:00,28.02,39475,464,155,196,813,10,1638,5.184.583.333
11/07/2017 13:00,27.81,39493,603,156,195,865,9,1828,5.184.583.333
11/07/2017 14:00,27.66,39256,751,150,192,895,8,1996,5.184.583.333
11/07/2017 15:00,27.6,38746,905,143,165,917,8,2138,5.184.583.333
11/07/2017 16:00,27.54,38178,1017,127,133,960,10,2247,5.184.583.333
11/07/2017 17:00,27.81,38034,1042,109,114,961,12,2238,5.184.583.333
11/07/2017 18:00,28.02,37694,1010,97,87,921,14,2129,5.184.583.333
11/07/2017 19:00,28.32,37215,942,92,69,975,18,2096,5.184.583.333
11/07/2017 20:00,28.03,36329,904,86,56,948,16,2010,5.184.583.333
11/07/2017 21:00,27.92,35713,995,87,53,985,20,2140,5.184.583.333
11/07/2017 22:00,28.06,34949,1173,76,50,1041,23,2363,5.184.583.333
11/07/2017 23:00,27.44,33534,1322,52,63,1063,5,2505,5.184.583.333
12/07/2017 00:00,27.43,31438,1158,47,58,1063,4,2330,5.184.583.333
12/07/2017 01:00,27.05,30353,1151,45,58,1065,4,2323,5.184.583.333
12/07/2017 02:00,26.81,29789,1173,45,63,1035,4,2320,5.184.583.333
12/07/2017 03:00,26.7,29538,1174,45,68,1005,5,2297,5.184.583.333
12/07/2017 04:00,26.69,29440,1151,41,60,948,5,2205,5.184.583.333
12/07/2017 05:00,26.86,30556,1150,34,50,907,6,2147,5.184.583.333
12/07/2017 06:00,27.52,33303,1187,29,37,913,6,2172,5.184.583.333
12/07/2017 07:00,28.16,36544,1329,26,34,961,7,2357,5.184.583.333
12/07/2017 08:00,28.39,37700,1523,24,40,1024,10,2621,5.184.583.333
12/07/2017 09:00,28.55,38696,1632,28,53,1109,11,2833,5.184.583.333
12/07/2017 10:00,28.58,39379,1778,33,69,1213,13,3106,5.184.583.333
12/07/2017 11:00,28.52,39698,1903,36,79,1356,17,3391,5.184.583.333
12/07/2017 12:00,28.44,39681,2034,46,77,1411,17,3585,5.184.583.333
12/07/2017 13:00,28.1,39678,2175,48,63,1386,15,3687,5.184.583.333
12/07/2017 14:00,27.94,39369,2281,53,52,1471,15,3872,5.184.583.333
12/07/2017 15:00,27.66,38992,2357,52,41,1604,12,4066,5.184.583.333
12/07/2017 16:00,27.54,38553,2530,47,31,1588,12,4208,5.184.583.333
12/07/2017 17:00,27.61,38446,2691,42,22,1696,10,4461,5.184.583.333
12/07/2017 18:00,27.63,38033,2829,40,16,1718,8,4611,5.184.583.333
12/07/2017 19:00,27.58,37588,2885,38,15,1729,7,4674,5.184.583.333
12/07/2017 20:00,27.2,36708,2888,38,17,1827,5,4775,5.184.583.333
12/07/2017 21:00,27.18,36148,2888,38,23,1924,4,4877,5.184.583.333
12/07/2017 22:00,26.94,35446,2957,41,29,2080,4,5111,5.184.583.333
12/07/2017 23:00,26.51,34106,3033,40,62,2201,4,5340,5.184.583.333
13/07/2017 00:00,24.93,32078,3001,36,65,2250,5,5357,5.184.583.333
13/07/2017 01:00,23.62,31037,2977,32,66,2271,5,5351,5.184.583.333
13/07/2017 02:00,22.12,30568,3008,27,66,2245,4,5350,5.184.583.333
13/07/2017 03:00,23.99,30301,3074,21,64,2271,4,5434,5.184.583.333
13/07/2017 04:00,24.14,30248,3024,15,61,2368,4,5472,5.184.583.333
13/07/2017 05:00,24.93,31393,2863,9,61,2406,4,5343,5.184.583.333
13/07/2017 06:00,26.66,34081,2731,6,73,2416,5,5231,5.184.583.333
13/07/2017 07:00,27.04,37137,2813,5,100,2379,8,5305,5.184.583.333
13/07/2017 08:00,27.42,38037,3014,6,143,2442,12,5617,5.184.583.333
13/07/2017 09:00,27.65,38941,3078,8,200,2578,18,5882,5.184.583.333
13/07/2017 10:00,27.76,39589,3061,16,239,2623,23,5962,5.184.583.333
13/07/2017 11:00,27.64,39862,2984,26,271,2710,26,6017,5.184.583.333
13/07/2017 12:00,27.28,39864,2926,41,294,2833,32,6126,5.184.583.333
13/07/2017 13:00,27.3,39835,2868,57,321,2857,36,6139,5.184.583.333
13/07/2017 14:00,27.2,39496,2843,73,342,2854,38,6150,5.184.583.333
13/07/2017 15:00,27.2,39121,2811,90,351,2875,37,6164,5.184.583.333
13/07/2017 16:00,27.31,38809,2773,101,351,2828,40,6093,5.184.583.333
13/07/2017 17:00,27.7,38707,2683,111,339,2676,40,5849,5.184.583.333
13/07/2017 18:00,27.85,38370,2579,111,303,2512,34,5539,5.184.583.333
13/07/2017 19:00,27.84,37855,2356,111,269,2356,28,5120,5.184.583.333
13/07/2017 20:00,27.81,37006,1979,110,241,2228,24,4582,5.184.583.333
13/07/2017 21:00,27.75,36494,1629,111,212,2277,18,4247,5.184.583.333
13/07/2017 22:00,27.38,35830,1430,104,190,2278,14,4016,5.184.583.333
13/07/2017 23:00,26.96,34427,1319,97,118,2224,9,3767,5.184.583.333
14/07/2017 00:00,27.01,32469,1224,98,114,2115,8,3559,5.184.583.333
14/07/2017 01:00,26.68,31436,1165,95,105,2063,7,3435,5.184.583.333
14/07/2017 02:00,26.46,30888,1106,89,94,1996,6,3291,5.184.583.333
14/07/2017 03:00,26.34,30628,1004,80,74,1901,5,3064,5.184.583.333
14/07/2017 04:00,26.28,30590,883,69,63,1798,5,2818,5.184.583.333
14/07/2017 05:00,26.55,31683,796,60,48,1682,5,2591,5.184.583.333
14/07/2017 06:00,27.31,34241,764,55,29,1590,3,2441,5.184.583.333
14/07/2017 07:00,28.39,37256,764,59,21,1502,3,2349,5.184.583.333
14/07/2017 08:00,28.71,38156,797,58,21,1456,3,2335,5.184.583.333
14/07/2017 09:00,28.62,39047,841,59,35,1455,3,2393,5.184.583.333
14/07/2017 10:00,28.52,39586,894,60,44,1423,3,2424,5.184.583.333
14/07/2017 11:00,28.16,39659,906,59,54,1483,4,2506,5.184.583.333
14/07/2017 12:00,27.8,39411,850,58,62,1566,4,2540,5.184.583.333
14/07/2017 13:00,27.57,39092,844,57,69,1514,4,2488,5.184.583.333
14/07/2017 14:00,27.41,38535,826,55,77,1516,6,2480,5.184.583.333
14/07/2017 15:00,27.18,37961,781,53,77,1573,5,2489,5.184.583.333
14/07/2017 16:00,27.16,37566,746,46,74,1512,4,2382,5.184.583.333
14/07/2017 17:00,27.39,37446,656,41,69,1422,4,2192,5.184.583.333
14/07/2017 18:00,27.7,37155,507,36,57,1250,4,1854,5.184.583.333
14/07/2017 19:00,27.79,36394,397,33,48,1194,4,1676,5.184.583.333
14/07/2017 20:00,27.26,35295,316,33,45,1151,4,1549,5.184.583.333
14/07/2017 21:00,27.02,34722,241,34,42,1176,4,1497,5.184.583.333
14/07/2017 22:00,26.88,34252,225,32,39,1157,4,1457,5.184.583.333
14/07/2017 23:00,26.51,33212,220,25,31,1183,4,1463,5.184.583.333
15/07/2017 00:00,26.91,31969,121,23,27,1211,3,1385,5.184.583.333
15/07/2017 01:00,26.68,30917,122,23,26,1195,3,1369,5.184.583.333
15/07/2017 02:00,26.54,30340,110,23,23,1131,3,1290,5.184.583.333
15/07/2017 03:00,26.4,29961,100,23,22,1087,3,1235,5.184.583.333
15/07/2017 04:00,26.39,29578,97,22,21,988,3,1131,5.184.583.333
15/07/2017 05:00,26.29,29595,90,21,16,796,3,926,5.184.583.333
15/07/2017 06:00,26.37,30172,83,20,8,626,3,740,5.184.583.333
15/07/2017 07:00,26.56,31401,87,20,5,547,3,662,5.184.583.333
15/07/2017 08:00,26.89,32462,111,21,5,522,3,662,5.184.583.333
15/07/2017 09:00,27.15,34079,147,22,6,550,3,728,5.184.583.333
15/07/2017 10:00,27.23,34947,191,22,7,576,3,799,5.184.583.333
15/07/2017 11:00,27.22,35092,243,23,8,613,3,890,5.184.583.333
15/07/2017 12:00,27.1,34996,292,25,10,682,3,1012,5.184.583.333
15/07/2017 13:00,26.94,34755,393,25,14,716,3,1151,5.184.583.333
15/07/2017 14:00,26.79,34408,486,28,18,743,3,1278,5.184.583.333
15/07/2017 15:00,26.68,34224,518,34,22,824,5,1403,5.184.583.333
15/07/2017 16:00,26.76,34325,557,36,25,811,5,1434,5.184.583.333
15/07/2017 17:00,26.91,34592,586,37,25,752,5,1405,5.184.583.333
15/07/2017 18:00,27.06,34580,570,37,23,729,5,1364,5.184.583.333
15/07/2017 19:00,26.99,34133,520,34,26,758,4,1342,5.184.583.333
15/07/2017 20:00,26.79,33478,407,34,29,946,4,1420,5.184.583.333
15/07/2017 21:00,26.74,33228,330,34,28,1206,3,1601,5.184.583.333
15/07/2017 22:00,26.64,32986,406,33,26,1455,3,1923,5.184.583.333
15/07/2017 23:00,26.33,32112,576,29,28,1654,3,2290,5.184.583.333
16/07/2017 00:00,26.62,30948,621,25,25,1836,3,2510,5.184.583.333
16/07/2017 01:00,26.23,29993,770,21,21,1934,4,2750,5.184.583.333
16/07/2017 02:00,26.07,29373,914,18,17,2005,4,2958,5.184.583.333
16/07/2017 03:00,25.52,28945,1054,14,13,2079,3,3163,5.184.583.333
16/07/2017 04:00,24.24,28508,1224,10,9,2107,3,3353,5.184.583.333
16/07/2017 05:00,23.91,28431,1408,6,6,2072,3,3495,5.184.583.333
16/07/2017 06:00,24.41,28930,1612,4,5,2162,3,3786,5.184.583.333
16/07/2017 07:00,24.88,29951,1844,3,4,2243,3,4097,5.184.583.333
16/07/2017 08:00,24.69,31295,2024,4,5,2385,3,4421,5.184.583.333
16/07/2017 09:00,24.93,32142,2013,5,6,2768,3,4795,5.184.583.333
16/07/2017 10:00,25.41,33393,1937,8,7,3053,3,5008,5.184.583.333
16/07/2017 11:00,25.37,34028,1820,9,8,3192,3,5032,5.184.583.333
16/07/2017 12:00,25.15,34254,1779,12,12,3272,3,5078,5.184.583.333
16/07/2017 13:00,24.89,34315,1871,14,17,3237,3,5142,5.184.583.333
16/07/2017 14:00,24.5,34176,1969,15,23,3065,4,5076,5.184.583.333
16/07/2017 15:00,24.38,34100,1959,16,27,2858,4,4864,5.184.583.333
16/07/2017 16:00,25.1,34370,1956,15,31,2671,5,4678,5.184.583.333
16/07/2017 17:00,25.46,34650,1966,13,39,2394,5,4417,5.184.583.333
16/07/2017 18:00,25.82,34835,1996,13,37,2195,4,4245,5.184.583.333
16/07/2017 19:00,26.08,34472,2006,13,36,2120,3,4178,5.184.583.333
16/07/2017 20:00,26.07,34098,1925,16,35,2115,3,4094,5.184.583.333
16/07/2017 21:00,26.28,33967,1831,19,35,2134,3,4022,5.184.583.333
16/07/2017 22:00,26.23,33635,1809,36,36,2173,5,4059,5.184.583.333
16/07/2017 23:00,25.51,32525,1845,45,42,2318,12,4262,5.184.583.333
17/07/2017 00:00,24.63,30787,1717,55,47,2352,16,4187,5.331.369.048
17/07/2017 01:00,23.53,29806,1680,60,55,2349,23,4167,5.331.369.048
17/07/2017 02:00,22.77,29433,1658,63,69,2280,29,4099,5.331.369.048
17/07/2017 03:00,22.62,29268,1568,62,86,2209,37,3962,5.331.369.048
17/07/2017 04:00,22.82,29241,1443,68,121,2237,32,3901,5.331.369.048
17/07/2017 05:00,24.19,30259,1413,80,137,2216,21,3867,5.331.369.048
17/07/2017 06:00,25.47,32946,1483,95,147,2237,22,3984,5.331.369.048
17/07/2017 07:00,26.45,35953,1592,99,147,2261,21,4120,5.331.369.048
17/07/2017 08:00,26.82,36643,1775,101,145,2328,34,4383,5.331.369.048
17/07/2017 09:00,26.98,37675,1930,92,162,2405,34,4623,5.331.369.048
17/07/2017 10:00,26.92,38403,2094,97,215,2479,35,4920,5.331.369.048
17/07/2017 11:00,26.77,38730,2239,107,238,2539,44,5167,5.331.369.048
17/07/2017 12:00,26.63,38782,2340,122,261,2648,44,5415,5.331.369.048
17/07/2017 13:00,26.47,38821,2468,134,287,2676,42,5607,5.331.369.048
17/07/2017 14:00,26.32,38571,2611,135,305,2732,43,5826,5.331.369.048
17/07/2017 15:00,26.08,38199,2717,129,305,2754,44,5949,5.331.369.048
17/07/2017 16:00,26.14,37821,2810,124,291,2722,44,5991,5.331.369.048
17/07/2017 17:00,26.22,37751,2756,111,280,2633,45,5825,5.331.369.048
17/07/2017 18:00,26.38,37493,2629,91,257,2501,37,5515,5.331.369.048
17/07/2017 19:00,26.42,36961,2449,79,228,2454,28,5238,5.331.369.048
17/07/2017 20:00,26.22,36109,2188,75,206,2495,24,4988,5.331.369.048
17/07/2017 21:00,26.08,35634,1952,73,201,2592,20,4838,5.331.369.048
17/07/2017 22:00,25.73,34887,1852,61,197,2647,25,4782,5.331.369.048
17/07/2017 23:00,25.02,33351,1854,69,185,2797,16,4921,5.331.369.048
18/07/2017 00:00,24.38,31517,1804,65,175,2802,16,4862,5.331.369.048
18/07/2017 01:00,23.68,30580,1763,59,170,2751,12,4755,5.331.369.048
18/07/2017 02:00,23.08,30075,1770,56,160,2673,10,4669,5.331.369.048
18/07/2017 03:00,22.98,29860,1781,53,155,2639,12,4640,5.331.369.048
18/07/2017 04:00,22.83,29824,1725,46,135,2511,10,4427,5.331.369.048
18/07/2017 05:00,24.03,30770,1593,43,110,2423,9,4178,5.331.369.048
18/07/2017 06:00,25.71,33225,1459,43,110,2407,8,4027,5.331.369.048
18/07/2017 07:00,26.42,36034,1487,45,130,2397,8,4067,5.331.369.048
18/07/2017 08:00,26.86,37821,1538,52,150,2319,14,4073,5.331.369.048
18/07/2017 09:00,27.03,37261,1432,60,180,2309,18,3999,5.331.369.048
18/07/2017 10:00,27.11,37934,1349,62,205,2359,22,3997,5.331.369.048
18/07/2017 11:00,26.99,38184,1276,65,225,2429,24,4019,5.331.369.048
18/07/2017 12:00,26.85,38245,1236,71,230,2461,25,4023,5.331.369.048
18/07/2017 13:00,26.78,38217,1194,70,230,2550,23,4067,5.331.369.048
18/07/2017 14:00,26.67,37996,1158,66,230,2559,22,4035,5.331.369.048
18/07/2017 15:00,26.64,37573,1116,59,200,2610,18,4003,5.331.369.048
18/07/2017 16:00,26.48,37133,1070,53,180,2527,15,3845,5.331.369.048
18/07/2017 17:00,26.44,37000,955,47,135,2415,14,3566,5.331.369.048
18/07/2017 18:00,26.44,36675,826,46,120,2244,13,3249,5.331.369.048
18/07/2017 19:00,26.42,36203,736,49,85,2179,10,3059,5.331.369.048
18/07/2017 20:00,26.35,35476,608,54,85,2150,8,2905,5.331.369.048
18/07/2017 21:00,26.35,35005,444,61,75,2220,9,2809,5.331.369.048
18/07/2017 22:00,26.17,34369,335,58,70,2230,9,2702,5.331.369.048
18/07/2017 23:00,25.63,33031,293,52,69,2330,8,2752,5.331.369.048
19/07/2017 00:00,24.99,31367,275,46,67,2287,8,2683,5.331.369.048
19/07/2017 01:00,24.36,30370,253,43,66,2232,8,2602,5.331.369.048
19/07/2017 02:00,24.19,29908,224,42,66,2168,7,2507,5.331.369.048
19/07/2017 03:00,24,29690,183,44,62,2149,5,2443,5.331.369.048
19/07/2017 04:00,24.07,29626,141,44,56,2092,4,2337,5.331.369.048
19/07/2017 05:00,24.59,30527,117,43,49,1964,4,2177,5.331.369.048
19/07/2017 06:00,25.81,32755,102,42,44,1786,3,1977,5.331.369.048
19/07/2017 07:00,26.52,35432,116,46,40,1662,4,1868,5.331.369.048
19/07/2017 08:00,26.87,36356,141,53,37,1508,4,1743,5.331.369.048
19/07/2017 09:00,27.1,37209,171,65,36,1392,4,1668,5.331.369.048
19/07/2017 10:00,27.21,37741,218,77,35,1307,6,1643,5.331.369.048
19/07/2017 11:00,27.14,37908,249,85,35,1192,7,1568,5.331.369.048
19/07/2017 12:00,26.9,37802,288,90,35,1083,9,1505,5.331.369.048
19/07/2017 13:00,26.85,37665,362,94,34,1022,9,1521,5.331.369.048
19/07/2017 14:00,26.87,37312,473,94,35,967,8,1577,5.331.369.048
19/07/2017 15:00,26.99,36915,643,92,32,875,7,1649,5.331.369.048
19/07/2017 16:00,26.99,36511,812,85,31,835,6,1769,5.331.369.048
19/07/2017 17:00,26.91,36293,947,72,28,734,5,1786,5.331.369.048
19/07/2017 18:00,26.81,35955,1071,58,27,721,3,1880,5.331.369.048
19/07/2017 19:00,26.6,35573,1220,50,26,674,4,1974,5.331.369.048
19/07/2017 20:00,26.4,34763,1405,45,26,671,3,2150,5.331.369.048
19/07/2017 21:00,26.28,34370,1529,43,27,712,3,2314,5.331.369.048
19/07/2017 22:00,26.03,33725,1686,41,28,747,3,2505,5.331.369.048
19/07/2017 23:00,25.47,32406,1790,41,30,724,3,2588,5.331.369.048
20/07/2017 00:00,25.69,30822,1730,37,35,781,3,2586,5.331.369.048
20/07/2017 01:00,24.31,29782,1770,32,35,806,3,2646,5.331.369.048
20/07/2017 02:00,24.12,29307,1761,29,40,798,3,2631,5.331.369.048
20/07/2017 03:00,24.13,29073,1788,27,40,771,3,2629,5.331.369.048
20/07/2017 04:00,24.06,29019,1783,25,35,724,3,2570,5.331.369.048
20/07/2017 05:00,24.86,29935,1778,22,30,642,3,2475,5.331.369.048
20/07/2017 06:00,26.64,32149,1838,18,25,580,2,2463,5.331.369.048
20/07/2017 07:00,27.2,34661,1875,14,25,538,2,2454,5.331.369.048
20/07/2017 08:00,27.52,35885,1990,12,25,549,3,2579,5.331.369.048
20/07/2017 09:00,27.66,36779,2084,11,20,592,3,2710,5.331.369.048
20/07/2017 10:00,27.8,37483,2068,13,20,600,3,2704,5.331.369.048
20/07/2017 11:00,27.77,37741,1958,16,20,639,3,2636,5.331.369.048
20/07/2017 12:00,27.77,37681,1846,21,20,653,3,2543,5.331.369.048
20/07/2017 13:00,27.72,37459,1724,21,20,678,3,2446,5.331.369.048
20/07/2017 14:00,27.56,37175,1546,22,20,676,2,2266,5.331.369.048
20/07/2017 15:00,27.5,36772,1324,23,20,711,2,2080,5.331.369.048
20/07/2017 16:00,27.49,36478,1144,24,20,755,2,1945,5.331.369.048
20/07/2017 17:00,27.58,36393,1028,21,25,815,2,1891,5.331.369.048
20/07/2017 18:00,27.63,36150,959,18,30,858,3,1868,5.331.369.048
20/07/2017 19:00,27.65,35633,906,15,35,943,4,1903,5.331.369.048
20/07/2017 20:00,27.37,34858,879,13,45,1050,4,1991,5.331.369.048
20/07/2017 21:00,27.37,34477,858,13,55,1180,4,2110,5.331.369.048
20/07/2017 22:00,27.17,33832,832,15,65,1255,4,2171,5.331.369.048
20/07/2017 23:00,26.65,32422,804,15,124,1236,4,2183,5.331.369.048
21/07/2017 00:00,26.74,30541,967,14,120,1192,4,2297,5.331.369.048
21/07/2017 01:00,26.08,29471,944,12,117,1159,4,2236,5.331.369.048
21/07/2017 02:00,25.96,29000,911,10,113,1092,4,2130,5.331.369.048
21/07/2017 03:00,25.41,28778,849,7,109,1058,4,2027,5.331.369.048
21/07/2017 04:00,25.45,28693,800,5,101,1007,4,1917,5.331.369.048
21/07/2017 05:00,26.65,29626,788,3,83,909,3,1786,5.331.369.048
21/07/2017 06:00,27.55,31947,868,2,62,837,2,1771,5.331.369.048
21/07/2017 07:00,27.83,34648,930,2,56,795,2,1785,5.331.369.048
21/07/2017 08:00,27.93,35710,885,3,58,792,2,1740,5.331.369.048
21/07/2017 09:00,28.16,36803,809,5,58,724,3,1599,5.331.369.048
21/07/2017 10:00,28.16,37428,789,7,54,731,3,1584,5.331.369.048
21/07/2017 11:00,28.14,37559,712,9,49,702,3,1475,5.331.369.048
21/07/2017 12:00,27.99,37506,600,12,43,704,3,1362,5.331.369.048
21/07/2017 13:00,27.8,37283,549,15,40,686,5,1295,5.331.369.048
21/07/2017 14:00,27.8,36809,528,18,37,682,6,1271,5.331.369.048
21/07/2017 15:00,27.75,36282,488,19,35,650,8,1200,5.331.369.048
21/07/2017 16:00,27.86,35788,427,20,33,656,9,1145,5.331.369.048
21/07/2017 17:00,27.83,35629,344,21,32,651,12,1060,5.331.369.048
21/07/2017 18:00,27.87,35350,267,19,29,655,14,984,5.331.369.048
21/07/2017 19:00,27.92,34727,218,16,28,652,13,927,5.331.369.048
21/07/2017 20:00,27.71,33804,190,16,34,670,9,919,5.331.369.048
21/07/2017 21:00,27.65,33358,159,15,39,739,7,959,5.331.369.048
21/07/2017 22:00,27.66,32899,142,14,43,781,8,988,5.331.369.048
21/07/2017 23:00,27.45,31759,142,15,30,726,5,918,5.331.369.048
22/07/2017 00:00,27.14,30399,539,13,32,777,5,1366,5.331.369.048
22/07/2017 01:00,26.83,29382,590,12,37,724,5,1368,5.331.369.048
22/07/2017 02:00,26.68,28811,674,12,38,653,5,1382,5.331.369.048
22/07/2017 03:00,26.52,28431,738,12,38,615,4,1407,5.331.369.048
22/07/2017 04:00,26.18,28036,750,10,38,555,4,1357,5.331.369.048
22/07/2017 05:00,26.09,27985,741,7,31,498,4,1281,5.331.369.048
22/07/2017 06:00,26.45,28504,782,6,21,443,3,1255,5.331.369.048
22/07/2017 07:00,26.76,29596,915,6,20,440,4,1385,5.331.369.048
22/07/2017 08:00,27.2,31036,1043,6,20,442,4,1515,5.331.369.048
22/07/2017 09:00,27.41,32580,1071,6,20,450,6,1553,5.331.369.048
22/07/2017 10:00,27.53,33391,1121,7,20,503,5,1656,5.331.369.048
22/07/2017 11:00,27.48,33553,1196,10,14,543,6,1769,5.331.369.048
22/07/2017 12:00,27.18,33463,1299,11,14,562,6,1892,5.331.369.048
22/07/2017 13:00,27.02,33214,1402,13,12,560,6,1993,5.331.369.048
22/07/2017 14:00,26.89,32917,1482,15,12,569,8,2086,5.331.369.048
22/07/2017 15:00,26.95,32787,1546,18,12,593,7,2176,5.331.369.048
22/07/2017 16:00,26.97,32917,1518,20,13,627,7,2185,5.331.369.048
22/07/2017 17:00,27.19,33184,1524,22,19,643,6,2214,5.331.369.048
22/07/2017 18:00,27.31,33255,1593,17,26,641,7,2284,5.331.369.048
22/07/2017 19:00,27.2,32821,1491,14,34,659,6,2204,5.331.369.048
22/07/2017 20:00,27.02,32232,1298,13,46,710,5,2072,5.331.369.048
22/07/2017 21:00,27.01,32044,1226,11,57,787,3,2084,5.331.369.048
22/07/2017 22:00,26.8,31781,1304,12,74,819,3,2212,5.331.369.048
22/07/2017 23:00,26.47,30879,1365,11,69,826,5,2276,5.331.369.048
23/07/2017 00:00,26.74,29813,1685,8,69,838,4,2604,5.331.369.048
23/07/2017 01:00,26.11,28882,1799,7,67,819,3,2695,5.331.369.048
23/07/2017 02:00,25.48,28319,1909,6,65,837,2,2819,5.331.369.048
23/07/2017 03:00,23.54,27949,2018,6,63,851,3,2941,5.331.369.048
23/07/2017 04:00,22.12,27537,2050,5,58,881,3,2997,5.331.369.048
23/07/2017 05:00,22.86,27357,2021,4,49,869,2,2945,5.331.369.048
23/07/2017 06:00,22.37,27789,1944,4,33,863,2,2846,5.331.369.048
23/07/2017 07:00,23.85,28787,1975,4,25,897,3,2904,5.331.369.048
23/07/2017 08:00,25.13,29652,1983,5,25,991,3,3007,5.331.369.048
23/07/2017 09:00,26.09,31080,1878,6,26,1105,3,3018,5.331.369.048
23/07/2017 10:00,26.33,32216,1778,7,31,1200,3,3019,5.331.369.048
23/07/2017 11:00,26.81,32787,1655,9,33,1276,3,2976,5.331.369.048
23/07/2017 12:00,26.73,32947,1589,11,34,1364,4,3002,5.331.369.048
23/07/2017 13:00,25.91,32978,1515,13,34,1416,4,2982,5.331.369.048
23/07/2017 14:00,24.92,32844,1356,13,35,1410,4,2818,5.331.369.048
23/07/2017 15:00,25.27,32798,1259,14,40,1399,5,2717,5.331.369.048
23/07/2017 16:00,25.7,32930,1323,15,44,1415,6,2803,5.331.369.048
23/07/2017 17:00,26.6,33205,1307,17,49,1382,7,2762,5.331.369.048
23/07/2017 18:00,27.1,33404,1281,18,58,1318,7,2682,5.331.369.048
23/07/2017 19:00,27.18,33291,1181,20,74,1269,7,2551,5.331.369.048
23/07/2017 20:00,27.1,32928,947,24,94,1268,6,2339,5.331.369.048
23/07/2017 21:00,27.13,32947,794,26,104,1271,7,2202,5.331.369.048
23/07/2017 22:00,27.01,32637,775,27,120,1282,8,2212,5.331.369.048
23/07/2017 23:00,26.65,31422,765,27,122,1179,12,2105,5.331.369.048
24/07/2017 00:00,26.53,29958,740,21,127,1164,12,2064,5.459.464.286
24/07/2017 01:00,26.05,29030,652,17,130,1149,11,1959,5.459.464.286
24/07/2017 02:00,25.89,28644,571,16,127,1161,13,1888,5.459.464.286
24/07/2017 03:00,25.63,28479,494,15,115,1184,14,1822,5.459.464.286
24/07/2017 04:00,25.65,28452,427,15,106,1202,16,1766,5.459.464.286
24/07/2017 05:00,26.28,29281,375,12,94,1167,14,1662,5.459.464.286
24/07/2017 06:00,27.04,31705,332,11,92,1093,13,1541,5.459.464.286
24/07/2017 07:00,27.63,34536,313,11,88,1042,14,1468,5.459.464.286
24/07/2017 08:00,27.97,35472,305,12,82,989,14,1402,5.459.464.286
24/07/2017 09:00,28.3,36570,295,14,78,970,14,1371,5.459.464.286
24/07/2017 10:00,28.6,37263,296,16,73,925,12,1322,5.459.464.286
24/07/2017 11:00,28.5,37550,333,16,67,883,12,1311,5.459.464.286
24/07/2017 12:00,28.65,37544,344,17,67,881,16,1325,5.459.464.286
24/07/2017 13:00,28.57,37564,359,19,68,856,15,1317,5.459.464.286
24/07/2017 14:00,28.32,37278,397,20,68,835,10,1330,5.459.464.286
24/07/2017 15:00,28.24,36884,467,21,66,853,7,1414,5.459.464.286
24/07/2017 16:00,27.95,36492,518,22,59,849,7,1455,5.459.464.286
24/07/2017 17:00,27.85,36484,534,25,51,801,5,1416,5.459.464.286
24/07/2017 18:00,28,36260,525,24,48,764,4,1365,5.459.464.286
24/07/2017 19:00,27.9,35795,512,26,48,754,5,1345,5.459.464.286
24/07/2017 20:00,27.59,35041,489,30,48,780,4,1351,5.459.464.286
24/07/2017 21:00,27.46,34579,461,31,47,825,4,1368,5.459.464.286
24/07/2017 22:00,27.45,33832,429,30,46,890,3,1398,5.459.464.286
24/07/2017 23:00,26.77,32276,410,21,75,941,10,1457,5.459.464.286
25/07/2017 00:00,27.08,30573,603,18,74,991,11,1697,5.459.464.286
25/07/2017 01:00,26.89,29608,652,18,75,1023,10,1778,5.459.464.286
25/07/2017 02:00,26.33,29115,734,16,77,1038,11,1876,5.459.464.286
25/07/2017 03:00,26.31,28919,827,18,79,1084,9,2017,5.459.464.286
25/07/2017 04:00,25.63,28891,932,16,80,1081,10,2119,5.459.464.286
25/07/2017 05:00,26.19,29779,1036,14,65,1038,11,2164,5.459.464.286
25/07/2017 06:00,27.14,32004,1050,12,54,998,10,2124,5.459.464.286
25/07/2017 07:00,27.41,34638,1073,13,55,1021,12,2174,5.459.464.286
25/07/2017 08:00,27.71,35453,1112,15,59,1025,17,2228,5.459.464.286
25/07/2017 09:00,27.96,36466,1101,18,67,1067,20,2273,5.459.464.286
25/07/2017 10:00,28.13,37205,1108,22,80,1109,23,2342,5.459.464.286
25/07/2017 11:00,28.11,37517,1154,25,92,1160,22,2453,5.459.464.286
25/07/2017 12:00,27.98,37630,1202,25,92,1145,24,2488,5.459.464.286
25/07/2017 13:00,27.77,37421,1248,25,96,1086,25,2480,5.459.464.286
25/07/2017 14:00,27.63,37161,1274,24,105,1035,24,2462,5.459.464.286
25/07/2017 15:00,27.54,36800,1256,24,116,970,24,2390,5.459.464.286
25/07/2017 16:00,27.45,36406,1183,25,124,965,22,2319,5.459.464.286
25/07/2017 17:00,27.5,36346,1138,27,129,909,20,2223,5.459.464.286
25/07/2017 18:00,27.7,36086,1076,31,142,862,18,2129,5.459.464.286
25/07/2017 19:00,27.59,35607,980,31,152,866,18,2047,5.459.464.286
25/07/2017 20:00,27.42,34799,935,31,159,914,17,2056,5.459.464.286
25/07/2017 21:00,27.34,34362,921,35,167,995,19,2137,5.459.464.286
25/07/2017 22:00,27.27,33693,941,40,175,1052,23,2231,5.459.464.286
25/07/2017 23:00,27.02,32294,931,38,191,1148,26,2334,5.459.464.286
26/07/2017 00:00,25.95,30657,932,37,191,1220,26,2406,5.459.464.286
26/07/2017 01:00,24.21,29572,849,38,190,1234,26,2337,5.459.464.286
26/07/2017 02:00,23.33,29080,803,38,187,1234,26,2288,5.459.464.286
26/07/2017 03:00,21.51,28905,792,39,185,1241,26,2283,5.459.464.286
26/07/2017 04:00,21.58,28827,759,38,166,1206,28,2197,5.459.464.286
26/07/2017 05:00,24.91,29656,716,35,132,1115,27,2025,5.459.464.286
26/07/2017 06:00,26.9,31836,650,35,116,1054,31,1886,5.459.464.286
26/07/2017 07:00,27.39,34459,583,38,118,1021,38,1798,5.459.464.286
26/07/2017 08:00,27.79,35472,531,45,129,999,41,1745,5.459.464.286
26/07/2017 09:00,27.94,36508,488,49,135,980,43,1695,5.459.464.286
26/07/2017 10:00,28.15,37213,462,55,135,970,43,1665,5.459.464.286
26/07/2017 11:00,28.05,37505,447,63,122,937,44,1613,5.459.464.286
26/07/2017 12:00,28.06,37531,426,65,116,898,45,1550,5.459.464.286
26/07/2017 13:00,27.93,37327,424,68,109,839,44,1484,5.459.464.286
26/07/2017 14:00,27.95,37016,415,71,97,791,41,1415,5.459.464.286
26/07/2017 15:00,27.71,36654,400,73,74,762,34,1343,5.459.464.286
26/07/2017 16:00,27.52,36322,362,72,67,740,34,1275,5.459.464.286
26/07/2017 17:00,27.35,36187,309,72,59,672,28,1140,5.459.464.286
26/07/2017 18:00,27.34,35889,264,74,52,622,26,1038,5.459.464.286
26/07/2017 19:00,27.28,35442,217,74,47,605,24,967,5.459.464.286
26/07/2017 20:00,27.19,34628,176,74,46,596,18,910,5.459.464.286
26/07/2017 21:00,27.2,34290,153,76,49,611,21,910,5.459.464.286
26/07/2017 22:00,27.2,33653,154,40,50,613,23,880,5.459.464.286
26/07/2017 23:00,26.89,32288,183,76,68,486,8,821,5.459.464.286
27/07/2017 00:00,27.28,30702,174,73,68,472,10,797,5.459.464.286
27/07/2017 01:00,26.01,29616,239,71,69,471,9,859,5.459.464.286
27/07/2017 02:00,23.93,29121,322,69,70,457,8,926,5.459.464.286
27/07/2017 03:00,23.09,28843,426,68,69,432,8,1003,5.459.464.286
27/07/2017 04:00,23.68,28807,539,61,69,412,6,1087,5.459.464.286
27/07/2017 05:00,26.18,29680,583,50,69,373,8,1083,5.459.464.286
27/07/2017 06:00,27.48,31892,563,41,63,334,7,1008,5.459.464.286
27/07/2017 07:00,27.75,34484,592,37,62,324,11,1026,5.459.464.286
27/07/2017 08:00,28.04,35007,614,36,62,315,10,1037,5.459.464.286
27/07/2017 09:00,28.21,36175,597,39,70,321,13,1040,5.459.464.286
27/07/2017 10:00,28.47,37044,654,40,80,363,12,1149,5.459.464.286
27/07/2017 11:00,28.42,37437,680,41,88,403,10,1222,5.459.464.286
27/07/2017 12:00,28.37,37544,661,43,90,445,10,1249,5.459.464.286
27/07/2017 13:00,28.34,37571,697,41,95,458,8,1299,5.459.464.286
27/07/2017 14:00,28.6,37328,732,37,95,440,8,1312,5.459.464.286
27/07/2017 15:00,28.4,36946,769,32,81,429,8,1319,5.459.464.286
27/07/2017 16:00,28.27,36622,807,26,63,457,9,1362,5.459.464.286
27/07/2017 17:00,28.16,36486,795,21,52,429,8,1305,5.459.464.286
27/07/2017 18:00,28.08,36161,761,19,46,430,6,1262,5.459.464.286
27/07/2017 19:00,28.01,35612,679,19,43,396,7,1144,5.459.464.286
27/07/2017 20:00,27.78,34813,555,21,43,491,6,1116,5.459.464.286
27/07/2017 21:00,27.66,34458,443,26,45,572,6,1092,5.459.464.286
27/07/2017 22:00,27.59,33722,407,31,48,622,7,1115,5.459.464.286
27/07/2017 23:00,27.46,32218,416,39,131,581,6,1173,5.459.464.286
28/07/2017 00:00,27.91,30574,524,44,126,564,6,1264,5.459.464.286
28/07/2017 01:00,27.63,29474,505,48,116,540,9,1218,5.459.464.286
28/07/2017 02:00,26.81,28990,498,53,104,523,15,1193,5.459.464.286
28/07/2017 03:00,26.01,28746,517,59,85,525,17,1203,5.459.464.286
28/07/2017 04:00,25.71,28657,555,63,63,513,16,1210,5.459.464.286
28/07/2017 05:00,26.91,29549,603,66,51,486,17,1223,5.459.464.286
28/07/2017 06:00,27.72,31819,585,73,49,467,20,1194,5.459.464.286
28/07/2017 07:00,27.79,34591,556,84,49,517,24,1230,5.459.464.286
28/07/2017 08:00,28.5,35457,643,96,48,571,24,1382,5.459.464.286
28/07/2017 09:00,28.69,36694,782,112,45,601,20,1560,5.459.464.286
28/07/2017 10:00,28.6,37417,910,119,45,671,14,1759,5.459.464.286
28/07/2017 11:00,28.09,37592,1005,116,43,783,15,1962,5.459.464.286
28/07/2017 12:00,27.3,37382,1115,108,43,875,10,2151,5.459.464.286
28/07/2017 13:00,26.64,37162,1264,88,44,954,10,2360,5.459.464.286
28/07/2017 14:00,26.41,36686,1408,69,47,984,8,2516,5.459.464.286
28/07/2017 15:00,26.1,36197,1538,53,47,1034,7,2679,5.459.464.286
28/07/2017 16:00,26.65,35840,1658,41,46,1046,8,2799,5.459.464.286
28/07/2017 17:00,27.54,35696,1659,30,40,1020,8,2757,5.459.464.286
28/07/2017 18:00,27.57,35447,1617,22,37,1003,9,2688,5.459.464.286
28/07/2017 19:00,27.61,34778,1578,20,36,1036,8,2678,5.459.464.286
28/07/2017 20:00,27.07,33784,1531,21,36,1082,8,2678,5.459.464.286
28/07/2017 21:00,27.03,33417,1426,23,38,1127,7,2621,5.459.464.286
28/07/2017 22:00,27.01,32926,1343,23,42,1146,8,2562,5.459.464.286
28/07/2017 23:00,26.35,31729,1322,19,40,1006,5,2392,5.459.464.286
29/07/2017 00:00,26.45,30412,1270,15,45,1073,5,2408,5.459.464.286
29/07/2017 01:00,22.81,29477,1186,12,50,1023,5,2276,5.459.464.286
29/07/2017 02:00,19.18,28976,1110,9,50,984,4,2157,5.459.464.286
29/07/2017 03:00,12.99,28641,1129,7,45,947,4,2132,5.459.464.286
29/07/2017 04:00,9.88,28253,1174,6,45,900,4,2129,5.459.464.286
29/07/2017 05:00,10.76,28166,1296,5,40,861,3,2205,5.459.464.286
29/07/2017 06:00,13.58,28683,1519,5,40,851,3,2418,5.459.464.286
29/07/2017 07:00,21.19,29866,1807,6,45,856,3,2717,5.459.464.286
29/07/2017 08:00,23.66,31513,2172,7,50,984,4,3217,5.459.464.286
29/07/2017 09:00,24.58,32951,2413,8,60,1180,5,3666,5.459.464.286
29/07/2017 10:00,25.47,33878,2637,11,80,1358,6,4092,5.459.464.286
29/07/2017 11:00,25.26,34098,2711,14,90,1578,8,4401,5.459.464.286
29/07/2017 12:00,24.53,33996,2757,18,100,1742,12,4629,5.459.464.286
29/07/2017 13:00,23.3,33816,2984,23,110,1918,16,5051,5.459.464.286
29/07/2017 14:00,22.1,33583,3148,22,110,1913,18,5211,5.459.464.286
29/07/2017 15:00,21.42,33507,3114,25,110,1972,18,5239,5.459.464.286
29/07/2017 16:00,22.07,33554,3021,27,105,1966,18,5137,5.459.464.286
29/07/2017 17:00,24.92,33848,2728,28,75,1831,18,4680,5.459.464.286
29/07/2017 18:00,26.42,33896,2373,28,55,1771,15,4242,5.459.464.286
29/07/2017 19:00,26.69,33466,1932,29,40,1854,15,3870,5.459.464.286
29/07/2017 20:00,26.68,32824,1464,30,35,1879,12,3420,5.459.464.286
29/07/2017 21:00,26.75,32653,1130,32,35,1835,12,3044,5.459.464.286
29/07/2017 22:00,26.94,32396,957,23,40,1795,11,2826,5.459.464.286
29/07/2017 23:00,26.75,31373,779,14,40,1687,7,2527,5.459.464.286
30/07/2017 00:00,25.32,30075,606,19,45,1584,7,2261,5.459.464.286
30/07/2017 01:00,23.26,29123,518,23,50,1451,8,2050,5.459.464.286
30/07/2017 02:00,21.68,28580,461,24,55,1252,9,1801,5.459.464.286
30/07/2017 03:00,22,28244,439,24,55,1091,10,1619,5.459.464.286
30/07/2017 04:00,21.35,27856,450,22,50,954,9,1485,5.459.464.286
30/07/2017 05:00,21.37,27619,524,21,50,802,10,1407,5.459.464.286
30/07/2017 06:00,21.27,28027,708,20,50,681,8,1467,5.459.464.286
30/07/2017 07:00,21.89,28948,983,19,50,663,7,1722,5.459.464.286
30/07/2017 08:00,23.37,30626,1210,21,50,674,7,1962,5.459.464.286
30/07/2017 09:00,23.45,31974,1486,24,55,775,11,2351,5.459.464.286
30/07/2017 10:00,24.8,32838,1918,27,60,856,14,2875,5.459.464.286
30/07/2017 11:00,24.63,33327,2165,31,60,945,15,3216,5.459.464.286
30/07/2017 12:00,24.83,33366,2326,36,60,1040,15,3477,5.459.464.286
30/07/2017 13:00,23.69,33320,2584,40,55,1117,14,3810,5.459.464.286
30/07/2017 14:00,22.96,33245,2655,42,45,1208,13,3963,5.459.464.286
30/07/2017 15:00,21.91,33252,2606,42,35,1269,11,3963,5.459.464.286
30/07/2017 16:00,20.74,33468,2474,39,25,1290,9,3837,5.459.464.286
30/07/2017 17:00,21.99,33944,2285,32,25,1269,9,3620,5.459.464.286
30/07/2017 18:00,23.9,34213,2197,25,20,1260,7,3509,5.459.464.286
30/07/2017 19:00,26.29,34061,1899,21,25,1236,5,3186,5.459.464.286
30/07/2017 20:00,26.73,33716,1577,19,40,1261,5,2902,5.459.464.286
30/07/2017 21:00,27.04,33618,1416,20,65,1309,5,2815,5.459.464.286
30/07/2017 22:00,27.03,33073,1243,28,80,1375,8,2734,5.459.464.286
30/07/2017 23:00,26.36,31740,1091,32,140,1430,17,2710,5.459.464.286
31/07/2017 00:00,25.46,30200,1700,42,135,1387,17,3281,5.634.761.905
31/07/2017 01:00,25.06,29151,1464,49,120,1354,19,3006,5.634.761.905
31/07/2017 02:00,24.85,28726,1197,57,105,1300,18,2677,5.634.761.905
31/07/2017 03:00,23.66,28578,983,67,95,1246,17,2408,5.634.761.905
31/07/2017 04:00,24.29,28632,911,67,80,1227,15,2300,5.634.761.905
31/07/2017 05:00,25.7,29639,956,67,55,1208,13,2299,5.634.761.905
31/07/2017 06:00,26.75,32152,1033,64,40,1247,10,2394,5.634.761.905
31/07/2017 07:00,27.38,35080,1044,62,30,1332,9,2477,5.634.761.905
31/07/2017 08:00,27.67,37269,1079,56,30,1486,10,2661,5.634.761.905
31/07/2017 09:00,27.74,38147,1258,56,35,1653,17,3019,5.634.761.905
31/07/2017 10:00,27.73,38534,1464,65,40,1841,18,3428,5.634.761.905
31/07/2017 11:00,27.65,38411,1602,74,45,2018,22,3761,5.634.761.905
31/07/2017 12:00,27.55,38232,1711,77,50,2134,25,3997,5.634.761.905
31/07/2017 13:00,27.41,38127,1927,85,55,2214,25,4306,5.634.761.905
31/07/2017 14:00,27.31,37862,2097,93,60,2266,27,4543,5.634.761.905
31/07/2017 15:00,27.21,37472,2151,99,60,2297,32,4639,5.634.761.905
31/07/2017 16:00,27.12,36991,2113,96,55,2280,36,4580,5.634.761.905
31/07/2017 17:00,27.18,36871,1937,85,50,2245,35,4352,5.634.761.905
31/07/2017 18:00,27.24,36667,1701,76,45,2142,28,3992,5.634.761.905
31/07/2017 19:00,27.15,36243,1473,73,40,2077,24,3687,5.634.761.905
31/07/2017 20:00,27.06,35436,1214,73,40,2052,21,3400,5.634.761.905
31/07/2017 21:00,27.14,35099,1018,76,45,2085,17,3241,5.634.761.905
31/07/2017 22:00,27.07,34294,910,71,55,2107,15,3158,5.634.761.905
31/07/2017 23:00,26.42,32672,835,74,35,1919,7,2870,5.634.761.905
01/08/2017 00:00,26.41,31013,668,77,26,1738,7,2516,5.634.761.905
01/08/2017 01:00,25.92,29855,607,77,20,1635,7,2346,5.634.761.905
01/08/2017 02:00,25.67,29406,493,72,18,1438,7,2028,5.634.761.905
01/08/2017 03:00,25.02,29264,392,65,18,1341,7,1823,5.634.761.905
01/08/2017 04:00,25.08,29217,333,58,19,1341,7,1758,5.634.761.905
01/08/2017 05:00,25.96,30159,319,48,21,1261,5,1654,5.634.761.905
01/08/2017 06:00,26.61,32566,317,43,21,1219,6,1606,5.634.761.905
01/08/2017 07:00,27.32,35462,276,46,21,1138,9,1490,5.634.761.905
01/08/2017 08:00,27.61,37253,229,59,22,1123,10,1443,5.634.761.905
01/08/2017 09:00,27.77,38127,235,74,30,1067,9,1415,5.634.761.905
01/08/2017 10:00,27.87,38527,257,83,36,1129,10,1515,5.634.761.905
01/08/2017 11:00,27.85,38598,256,87,42,1240,6,1631,5.634.761.905
01/08/2017 12:00,27.77,38428,251,89,44,1191,4,1579,5.634.761.905
01/08/2017 13:00,27.75,38213,274,81,50,1230,5,1640,5.634.761.905
01/08/2017 14:00,27.71,38000,287,75,54,1181,6,1603,5.634.761.905
01/08/2017 15:00,27.7,37532,293,66,55,1116,6,1536,5.634.761.905
01/08/2017 16:00,27.56,37096,283,51,58,981,7,1380,5.634.761.905
01/08/2017 17:00,27.62,37027,245,38,62,802,6,1153,5.634.761.905
01/08/2017 18:00,27.61,36720,210,29,68,676,6,989,5.634.761.905
01/08/2017 19:00,27.6,36231,241,23,85,665,5,1019,5.634.761.905
01/08/2017 20:00,27.36,35441,328,23,97,570,6,1024,5.634.761.905
01/08/2017 21:00,27.18,34998,336,22,110,597,6,1071,5.634.761.905
01/08/2017 22:00,27.09,34204,309,30,128,604,7,1078,5.634.761.905
01/08/2017 23:00,26.7,32533,276,35,119,574,3,1007,5.634.761.905
02/08/2017 00:00,25.92,30770,481,35,127,536,3,1182,5.634.761.905
02/08/2017 01:00,25.1,29698,664,36,155,535,3,1393,5.634.761.905
02/08/2017 02:00,25.01,29169,746,38,200,498,3,1485,5.634.761.905
02/08/2017 03:00,24.5,28968,787,37,230,472,3,1529,5.634.761.905
02/08/2017 04:00,24.83,28967,879,36,230,498,3,1646,5.634.761.905
02/08/2017 05:00,26.26,29909,957,40,226,493,3,1719,5.634.761.905
02/08/2017 06:00,27.49,32239,991,48,216,542,3,1800,5.634.761.905
02/08/2017 07:00,28.04,35071,1101,48,208,629,4,1990,5.634.761.905
02/08/2017 08:00,28.57,36798,1277,57,205,759,4,2302,5.634.761.905
02/08/2017 09:00,28.78,37174,1484,78,205,920,7,2694,5.634.761.905
02/08/2017 10:00,28.78,37933,1602,96,213,1083,12,3006,5.634.761.905
02/08/2017 11:00,28.68,38301,1651,109,220,1292,11,3283,5.634.761.905
02/08/2017 12:00,28.24,38330,1680,122,220,1500,9,3531,5.634.761.905
02/08/2017 13:00,27.97,38141,1651,129,220,1691,18,3709,5.634.761.905
02/08/2017 14:00,27.93,37834,1557,132,220,1760,14,3683,5.634.761.905
02/08/2017 15:00,27.83,37435,1459,137,212,1796,10,3614,5.634.761.905
02/08/2017 16:00,27.61,37021,1333,132,188,1826,12,3491,5.634.761.905
02/08/2017 17:00,27.95,36914,1143,125,158,1785,12,3223,5.634.761.905
02/08/2017 18:00,27.92,36682,900,117,130,1663,13,2823,5.634.761.905
02/08/2017 19:00,27.91,36228,662,117,117,1533,11,2440,5.634.761.905
02/08/2017 20:00,27.65,35458,457,116,114,1486,12,2185,5.634.761.905
02/08/2017 21:00,27.74,35172,363,118,114,1487,12,2094,5.634.761.905
02/08/2017 22:00,27.56,34351,349,100,115,1491,14,2069,5.634.761.905
02/08/2017 23:00,27.04,32709,379,79,80,1374,10,1922,5.634.761.905
03/08/2017 00:00,26.52,30867,384,78,66,1291,11,1830,5.634.761.905
03/08/2017 01:00,25.18,29752,468,74,59,1206,9,1816,5.634.761.905
03/08/2017 02:00,23.92,29244,562,70,51,1127,9,1819,5.634.761.905
03/08/2017 03:00,22.79,29022,680,65,40,1057,7,1849,5.634.761.905
03/08/2017 04:00,22.85,29075,834,60,32,928,7,1861,5.634.761.905
03/08/2017 05:00,24.69,30029,987,57,27,783,6,1860,5.634.761.905
03/08/2017 06:00,26.48,32374,1138,61,26,643,5,1873,5.634.761.905
03/08/2017 07:00,27.23,35349,1349,62,26,518,6,1961,5.634.761.905
03/08/2017 08:00,27.81,36997,1610,68,30,425,6,2139,5.634.761.905
03/08/2017 09:00,28.19,37387,1875,77,34,390,7,2383,5.634.761.905
03/08/2017 10:00,28.34,38247,2095,82,37,413,8,2635,5.634.761.905
03/08/2017 11:00,28.22,38727,2105,83,44,465,10,2707,5.634.761.905
03/08/2017 12:00,27.42,38790,2127,75,49,532,8,2791,5.634.761.905
03/08/2017 13:00,26.71,38578,2267,70,53,598,7,2995,5.634.761.905
03/08/2017 14:00,26.59,38371,2359,58,56,639,6,3118,5.634.761.905
03/08/2017 15:00,26.44,38010,2457,44,64,718,7,3290,5.634.761.905
03/08/2017 16:00,26.09,37577,2623,29,71,791,7,3521,5.634.761.905
03/08/2017 17:00,26.27,37571,2636,19,85,846,6,3592,5.634.761.905
03/08/2017 18:00,26.53,37213,2619,14,95,930,5,3663,5.634.761.905
03/08/2017 19:00,26.88,36619,2591,13,116,1057,6,3783,5.634.761.905
03/08/2017 20:00,26.57,35752,2473,18,130,1213,6,3840,5.634.761.905
03/08/2017 21:00,26.51,35355,2381,27,134,1352,7,3901,5.634.761.905
03/08/2017 22:00,26.25,34482,2450,34,137,1415,7,4043,5.634.761.905
03/08/2017 23:00,25.04,32733,2520,47,125,1396,10,4098,5.634.761.905
04/08/2017 00:00,24.02,31057,2690,52,127,1459,10,4338,5.634.761.905
04/08/2017 01:00,21.68,29919,2660,53,140,1540,9,4402,5.634.761.905
04/08/2017 02:00,20.98,29377,2584,55,165,1598,11,4413,5.634.761.905
04/08/2017 03:00,20.04,29126,2513,56,182,1675,15,4441,5.634.761.905
04/08/2017 04:00,20.06,29079,2465,56,180,1723,27,4451,5.634.761.905
04/08/2017 05:00,23.01,29995,2338,56,172,1779,39,4384,5.634.761.905
04/08/2017 06:00,25.69,32356,2251,58,183,1847,52,4391,5.634.761.905
04/08/2017 07:00,26.23,35555,2215,65,206,1851,64,4401,5.634.761.905
04/08/2017 08:00,26.61,37410,2335,74,228,1851,65,4553,5.634.761.905
04/08/2017 09:00,26.72,38484,2569,85,245,1931,67,4897,5.634.761.905
04/08/2017 10:00,26.51,38990,2851,95,260,2003,69,5278,5.634.761.905
04/08/2017 11:00,25.87,38871,3101,104,267,2088,65,5625,5.634.761.905
04/08/2017 12:00,25.66,38548,3274,123,273,2191,61,5922,5.634.761.905
04/08/2017 13:00,25.51,38191,3471,131,273,2310,63,6248,5.634.761.905
04/08/2017 14:00,25.2,37807,3587,131,269,2439,61,6487,5.634.761.905
04/08/2017 15:00,25.17,37345,3685,126,252,2407,57,6527,5.634.761.905
04/08/2017 16:00,24.58,36814,3770,116,223,2454,58,6621,5.634.761.905
04/08/2017 17:00,24.88,36675,3705,109,203,2463,56,6536,5.634.761.905
04/08/2017 18:00,25.96,36514,3658,100,176,2379,54,6367,5.634.761.905
04/08/2017 19:00,25.88,35862,3611,95,171,2394,51,6322,5.634.761.905
04/08/2017 20:00,25.05,34794,3570,96,181,2415,46,6308,5.634.761.905
04/08/2017 21:00,24.93,34447,3509,96,194,2475,41,6315,5.634.761.905
04/08/2017 22:00,24.55,33759,3498,108,212,2559,36,6413,5.634.761.905
04/08/2017 23:00,23.65,32461,3533,107,208,2918,42,6808,5.634.761.905
05/08/2017 00:00,23.51,30639,3438,100,224,2920,49,6731,5.634.761.905
05/08/2017 01:00,22.07,29564,3365,97,241,2895,45,6643,5.634.761.905
05/08/2017 02:00,21.19,29068,3235,90,256,2898,37,6516,5.634.761.905
05/08/2017 03:00,21.08,28752,3093,87,259,2889,30,6358,5.634.761.905
05/08/2017 04:00,20.44,28491,2980,87,262,2944,30,6303,5.634.761.905
05/08/2017 05:00,20.29,28360,2840,89,263,2930,27,6149,5.634.761.905
05/08/2017 06:00,21.97,28974,2788,91,276,2972,34,6161,5.634.761.905
05/08/2017 07:00,23.08,30325,2736,98,296,2885,33,6048,5.634.761.905
05/08/2017 08:00,24.01,31953,2745,105,304,2802,34,5990,5.634.761.905
05/08/2017 09:00,24.84,33557,2766,110,318,2707,41,5942,5.634.761.905
05/08/2017 10:00,25.15,34484,2785,116,334,2707,49,5991,5.634.761.905
05/08/2017 11:00,25.12,34645,2821,123,344,2699,52,6039,5.634.761.905
05/08/2017 12:00,24.53,34264,2849,126,348,2685,53,6061,5.634.761.905
05/08/2017 13:00,21.95,34084,2897,130,350,2641,51,6069,5.634.761.905
05/08/2017 14:00,22.04,33812,2874,130,350,2595,54,6003,5.634.761.905
05/08/2017 15:00,23.71,33709,2794,127,343,2524,49,5837,5.634.761.905
05/08/2017 16:00,24.56,33847,2670,124,314,2460,45,5613,5.634.761.905
05/08/2017 17:00,25.26,34220,2480,119,285,2365,44,5293,5.634.761.905
05/08/2017 18:00,25.42,34294,2292,115,262,2222,48,4939,5.634.761.905
05/08/2017 19:00,25.43,33813,2006,121,250,2157,47,4581,5.634.761.905
05/08/2017 20:00,25.41,33231,1773,129,226,2084,45,4257,5.634.761.905
05/08/2017 21:00,25.44,33162,1625,132,209,2065,48,4079,5.634.761.905
05/08/2017 22:00,25.28,32710,1591,134,198,2019,51,3993,5.634.761.905
05/08/2017 23:00,24.86,31550,1660,142,153,1881,38,3874,5.634.761.905
06/08/2017 00:00,24.05,30234,1781,142,138,1908,30,3999,5.634.761.905
06/08/2017 01:00,20.41,29217,1827,147,130,1905,26,4035,5.634.761.905
06/08/2017 02:00,17.53,28701,1915,150,128,1918,23,4134,5.634.761.905
06/08/2017 03:00,16.19,28326,2020,154,127,1925,18,4244,5.634.761.905
06/08/2017 04:00,11.98,27998,2149,161,126,1938,18,4392,5.634.761.905
06/08/2017 05:00,10.74,27797,2226,163,126,1985,20,4520,5.634.761.905
06/08/2017 06:00,10.17,28176,2336,166,127,2017,21,4667,5.634.761.905
06/08/2017 07:00,15.98,29203,2420,172,142,2097,29,4860,5.634.761.905
06/08/2017 08:00,20.09,30458,2633,177,158,2142,29,5139,5.634.761.905
06/08/2017 09:00,20.61,31899,2860,182,180,2194,27,5443,5.634.761.905
06/08/2017 10:00,21.6,33070,3049,185,207,2308,31,5780,5.634.761.905
06/08/2017 11:00,21.93,33682,3195,189,236,2401,36,6057,5.634.761.905
06/08/2017 12:00,22.15,33788,3256,189,262,2481,42,6230,5.634.761.905
06/08/2017 13:00,20.37,33815,3316,188,279,2491,40,6314,5.634.761.905
06/08/2017 14:00,20.16,33667,3279,186,293,2487,39,6284,5.634.761.905
06/08/2017 15:00,20.24,33692,3223,179,293,2495,33,6223,5.634.761.905
06/08/2017 16:00,21.24,33859,3100,172,287,2447,37,6043,5.634.761.905
06/08/2017 17:00,21.78,34307,2830,168,277,2362,34,5671,5.634.761.905
06/08/2017 18:00,25.09,34548,2487,165,263,2196,31,5142,5.634.761.905
06/08/2017 19:00,25.4,34410,2076,166,251,2063,27,4583,5.634.761.905
06/08/2017 20:00,25.52,34126,1670,167,239,1960,21,4057,5.634.761.905
06/08/2017 21:00,26.16,34227,1400,164,238,1899,17,3718,5.634.761.905
06/08/2017 22:00,26.05,33729,1282,135,237,1875,16,3545,5.634.761.905
06/08/2017 23:00,25.4,32252,1230,146,228,1797,30,3431,5.634.761.905
07/08/2017 00:00,25.53,31056,1175,143,222,1752,33,3325,5.728.988.095
07/08/2017 01:00,24.97,30032,1078,139,216,1683,31,3147,5.728.988.095
07/08/2017 02:00,24.77,29727,961,134,209,1604,27,2935,5.728.988.095
07/08/2017 03:00,24.2,29524,840,129,197,1532,24,2722,5.728.988.095
07/08/2017 04:00,24.39,29612,786,131,177,1455,23,2572,5.728.988.095
07/08/2017 05:00,25.78,30652,781,130,158,1388,24,2481,5.728.988.095
07/08/2017 06:00,26.67,33216,786,130,157,1324,30,2427,5.728.988.095
07/08/2017 07:00,27.46,36263,806,129,157,1273,30,2395,5.728.988.095
07/08/2017 08:00,27.91,37607,893,126,170,1254,37,2480,5.728.988.095
07/08/2017 09:00,27.86,38460,1202,123,182,1256,36,2799,5.728.988.095
07/08/2017 10:00,27.6,38962,1642,119,185,1267,34,3247,5.728.988.095
07/08/2017 11:00,27.38,39130,1950,116,185,1271,29,3551,5.728.988.095
07/08/2017 12:00,26.96,38955,2178,119,179,1304,31,3811,5.728.988.095
07/08/2017 13:00,26.93,38919,2452,120,170,1322,32,4096,5.728.988.095
07/08/2017 14:00,27.02,38770,2554,117,154,1311,29,4165,5.728.988.095
07/08/2017 15:00,26.99,38296,2462,112,129,1387,25,4115,5.728.988.095
07/08/2017 16:00,26.9,37796,2231,104,111,1414,24,3884,5.728.988.095
07/08/2017 17:00,27.63,37786,1820,94,79,1435,23,3451,5.728.988.095
07/08/2017 18:00,28.62,37537,1362,83,56,1435,19,2955,5.728.988.095
07/08/2017 19:00,28.57,37121,992,72,38,1517,12,2631,5.728.988.095
07/08/2017 20:00,27.4,36365,753,62,27,1636,8,2486,5.728.988.095
07/08/2017 21:00,26.97,35989,636,56,22,1755,6,2475,5.728.988.095
07/08/2017 22:00,26.68,35087,597,45,17,1818,5,2482,5.728.988.095
07/08/2017 23:00,26.11,33275,603,52,15,1783,7,2460,5.728.988.095
08/08/2017 00:00,26.06,31641,396,51,15,1716,7,2185,5.728.988.095
08/08/2017 01:00,25.49,30599,382,49,15,1622,8,2076,5.728.988.095
08/08/2017 02:00,24.68,30029,330,48,15,1576,7,1976,5.728.988.095
08/08/2017 03:00,24.04,29845,299,45,20,1479,7,1850,5.728.988.095
08/08/2017 04:00,24.12,29855,314,38,20,1356,6,1734,5.728.988.095
08/08/2017 05:00,25.97,30861,337,29,20,1197,6,1589,5.728.988.095
08/08/2017 06:00,26.71,33394,309,22,15,1074,5,1425,5.728.988.095
08/08/2017 07:00,27.27,36832,296,19,15,999,5,1334,5.728.988.095
08/08/2017 08:00,28.08,38409,311,18,10,980,7,1326,5.728.988.095
08/08/2017 09:00,28.38,38976,365,20,10,953,6,1354,5.728.988.095
08/08/2017 10:00,28.28,39339,481,22,10,1006,5,1524,5.728.988.095
08/08/2017 11:00,28.25,39540,636,23,10,1112,5,1786,5.728.988.095
08/08/2017 12:00,27.85,39497,805,23,10,1201,4,2043,5.728.988.095
08/08/2017 13:00,27.48,39370,993,22,10,1231,4,2260,5.728.988.095
08/08/2017 14:00,27.37,39094,1150,20,15,1302,4,2491,5.728.988.095
08/08/2017 15:00,27.39,38564,1306,19,20,1340,4,2689,5.728.988.095
08/08/2017 16:00,27.26,38072,1503,17,25,1370,3,2918,5.728.988.095
08/08/2017 17:00,27.37,38000,1608,15,40,1361,3,3027,5.728.988.095
08/08/2017 18:00,27.47,37641,1610,14,60,1333,3,3020,5.728.988.095
08/08/2017 19:00,27.23,37144,1610,13,80,1433,3,3139,5.728.988.095
08/08/2017 20:00,26.65,36462,1555,14,85,1592,4,3250,5.728.988.095
08/08/2017 21:00,26.48,36075,1634,16,110,1762,5,3527,5.728.988.095
08/08/2017 22:00,25.97,34999,1689,25,130,1839,7,3690,5.728.988.095
08/08/2017 23:00,24.57,33191,1785,10,165,1875,7,3842,5.728.988.095
09/08/2017 00:00,24.6,31566,1943,11,172,1888,10,4024,5.728.988.095
09/08/2017 01:00,22.79,30404,2055,15,174,1911,11,4166,5.728.988.095
09/08/2017 02:00,21.45,29855,1898,20,178,1907,12,4015,5.728.988.095
09/08/2017 03:00,19.88,29692,1658,25,183,1894,12,3772,5.728.988.095
09/08/2017 04:00,19.89,29754,1527,30,183,1832,13,3585,5.728.988.095
09/08/2017 05:00,24.08,30833,1414,34,165,1729,17,3359,5.728.988.095
09/08/2017 06:00,26.16,33754,1345,27,150,1638,12,3172,5.728.988.095
09/08/2017 07:00,27,37211,1438,20,150,1486,10,3104,5.728.988.095
09/08/2017 08:00,27.63,39028,1631,26,165,1399,17,3238,5.728.988.095
09/08/2017 09:00,27.75,39714,1850,35,200,1347,25,3457,5.728.988.095
09/08/2017 10:00,27.72,40310,2093,42,230,1271,33,3669,5.728.988.095
09/08/2017 11:00,27.93,40472,2332,46,245,1261,38,3922,5.728.988.095
09/08/2017 12:00,27.11,40394,2598,48,245,1285,36,4212,5.728.988.095
09/08/2017 13:00,26.96,40230,2796,47,240,1285,37,4405,5.728.988.095
09/08/2017 14:00,27,39971,2907,45,220,1302,36,4510,5.728.988.095
09/08/2017 15:00,27.18,39511,2978,41,170,1308,29,4526,5.728.988.095
09/08/2017 16:00,26.62,39032,3055,40,138,1276,25,4534,5.728.988.095
09/08/2017 17:00,27.21,38847,2948,44,117,1219,19,4347,5.728.988.095
09/08/2017 18:00,27.45,38378,2710,53,115,1255,19,4152,5.728.988.095
09/08/2017 19:00,27.31,37923,2352,63,114,1292,19,3840,5.728.988.095
09/08/2017 20:00,26.72,37174,2007,77,107,1302,18,3511,5.728.988.095
09/08/2017 21:00,26.67,36759,1865,88,98,1333,13,3397,5.728.988.095
09/08/2017 22:00,26.32,35474,1870,80,88,1341,10,3389,5.728.988.095
09/08/2017 23:00,25.86,33509,1852,88,63,1410,7,3420,5.728.988.095
10/08/2017 00:00,25.67,32131,1221,85,46,1375,6,2733,5.728.988.095
10/08/2017 01:00,25.29,30877,1099,78,29,1329,5,2540,5.728.988.095
10/08/2017 02:00,25,30383,980,73,21,1301,5,2380,5.728.988.095
10/08/2017 03:00,25.03,30170,895,67,15,1263,4,2244,5.728.988.095
10/08/2017 04:00,24.93,30307,867,57,10,1221,5,2160,5.728.988.095
10/08/2017 05:00,25.57,31470,812,49,10,1158,4,2033,5.728.988.095
10/08/2017 06:00,26.35,34523,779,42,9,1138,3,1971,5.728.988.095
10/08/2017 07:00,27.16,37681,742,36,6,1086,3,1873,5.728.988.095
10/08/2017 08:00,27.82,39515,779,35,6,1109,3,1932,5.728.988.095
10/08/2017 09:00,27.92,40351,827,35,6,1166,3,2037,5.728.988.095
10/08/2017 10:00,27.88,40725,841,38,8,1218,3,2108,5.728.988.095
10/08/2017 11:00,27.59,40768,821,43,8,1225,4,2101,5.728.988.095
10/08/2017 12:00,27.22,40744,822,49,9,1309,4,2193,5.728.988.095
10/08/2017 13:00,27.12,40569,852,50,10,1371,4,2287,5.728.988.095
10/08/2017 14:00,26.96,40247,870,47,13,1384,3,2317,5.728.988.095
10/08/2017 15:00,26.93,39834,901,42,14,1377,4,2338,5.728.988.095
10/08/2017 16:00,26.63,39234,962,37,15,1318,4,2336,5.728.988.095
10/08/2017 17:00,26.9,39179,986,32,17,1200,7,2242,5.728.988.095
10/08/2017 18:00,26.99,38789,961,29,22,1112,6,2130,5.728.988.095
10/08/2017 19:00,27.14,38242,847,30,31,1063,5,1976,5.728.988.095
10/08/2017 20:00,26.67,37635,717,30,37,1030,4,1818,5.728.988.095
10/08/2017 21:00,26.56,37272,632,28,40,1040,5,1745,5.728.988.095
10/08/2017 22:00,26.35,36051,600,31,43,1084,4,1762,5.728.988.095
10/08/2017 23:00,25.87,34024,593,26,30,1127,4,1780,5.728.988.095
11/08/2017 00:00,25.92,32182,590,27,25,1180,4,1826,5.728.988.095
11/08/2017 01:00,25.41,30991,586,26,25,1245,4,1886,5.728.988.095
11/08/2017 02:00,25.15,30526,523,23,25,1264,4,1839,5.728.988.095
11/08/2017 03:00,25.04,30390,454,19,25,1242,4,1744,5.728.988.095
11/08/2017 04:00,25.06,30706,426,13,25,1161,4,1629,5.728.988.095
11/08/2017 05:00,25.66,31910,401,8,25,976,4,1414,5.728.988.095
11/08/2017 06:00,26.37,34800,329,4,20,878,4,1235,5.728.988.095
11/08/2017 07:00,27.97,38545,263,2,15,806,4,1090,5.728.988.095
11/08/2017 08:00,28.48,39933,225,2,15,775,4,1021,5.728.988.095
11/08/2017 09:00,28.69,40998,203,3,15,846,4,1071,5.728.988.095
11/08/2017 10:00,28.77,41536,175,4,10,941,4,1134,5.728.988.095
11/08/2017 11:00,28.6,41470,151,5,10,1079,4,1249,5.728.988.095
11/08/2017 12:00,28.19,40652,134,6,10,1205,5,1360,5.728.988.095
11/08/2017 13:00,27.75,40267,135,6,10,1314,5,1470,5.728.988.095
11/08/2017 14:00,27.35,39625,154,5,10,1364,6,1539,5.728.988.095
11/08/2017 15:00,27.17,38956,180,5,10,1423,6,1624,5.728.988.095
11/08/2017 16:00,26.86,38474,228,4,15,1470,7,1724,5.728.988.095
11/08/2017 17:00,26.91,38468,284,5,15,1467,9,1780,5.728.988.095
11/08/2017 18:00,26.8,38162,305,6,20,1500,9,1840,5.728.988.095
11/08/2017 19:00,26.84,37466,305,9,35,1632,9,1990,5.728.988.095
11/08/2017 20:00,26.34,36549,285,15,55,1725,11,2091,5.728.988.095
11/08/2017 21:00,26.29,36215,271,23,75,1807,13,2189,5.728.988.095
11/08/2017 22:00,26.08,35097,273,34,85,1826,13,2231,5.728.988.095
11/08/2017 23:00,25.57,33428,260,41,138,1858,6,2303,5.728.988.095
12/08/2017 00:00,25.04,31695,415,52,152,1803,7,2429,5.728.988.095
12/08/2017 01:00,22.79,30430,518,59,164,1729,8,2478,5.728.988.095
12/08/2017 02:00,20.84,29877,551,63,173,1644,8,2439,5.728.988.095
12/08/2017 03:00,20.34,29525,501,65,183,1578,8,2335,5.728.988.095
12/08/2017 04:00,19.55,29287,511,63,183,1502,9,2268,5.728.988.095
12/08/2017 05:00,18.36,29223,559,56,174,1441,10,2240,5.728.988.095
12/08/2017 06:00,19.77,29814,588,45,152,1294,11,2090,5.728.988.095
12/08/2017 07:00,22.97,31277,568,43,141,1156,12,1920,5.728.988.095
12/08/2017 08:00,23.97,33038,568,48,133,1054,20,1823,5.728.988.095
12/08/2017 09:00,25.17,34810,617,61,122,844,25,1669,5.728.988.095
12/08/2017 10:00,24.96,35920,662,75,111,841,25,1714,5.728.988.095
12/08/2017 11:00,25.01,36233,667,90,99,905,28,1789,5.728.988.095
12/08/2017 12:00,24.71,36163,689,96,95,946,31,1857,5.728.988.095
12/08/2017 13:00,24.58,35983,812,97,97,961,23,1990,5.728.988.095
12/08/2017 14:00,24.54,35707,1022,96,82,967,22,2189,5.728.988.095
12/08/2017 15:00,23.8,35567,1277,102,65,990,25,2459,5.728.988.095
12/08/2017 16:00,24.44,35611,1510,98,60,1058,24,2750,5.728.988.095
12/08/2017 17:00,24.49,35899,1616,89,62,1169,21,2957,5.728.988.095
12/08/2017 18:00,24.93,35889,1688,93,58,1315,21,3175,5.728.988.095
12/08/2017 19:00,24.93,35292,1748,101,59,1453,22,3383,5.728.988.095
12/08/2017 20:00,25.06,34733,1801,106,74,1570,24,3575,5.728.988.095
12/08/2017 21:00,25,34584,1887,96,85,1761,20,3849,5.728.988.095
12/08/2017 22:00,23.78,33972,2006,86,87,1913,20,4112,5.728.988.095
12/08/2017 23:00,21.97,32733,2198,93,129,2042,14,4476,5.728.988.095
13/08/2017 00:00,22.85,31079,2297,104,127,2091,17,4636,5.728.988.095
13/08/2017 01:00,21.1,29946,2388,108,121,2171,17,4805,5.728.988.095
13/08/2017 02:00,20.11,29451,2420,107,116,2286,17,4946,5.728.988.095
13/08/2017 03:00,17.63,29179,2474,110,104,2394,17,5099,5.728.988.095
13/08/2017 04:00,12.07,28816,2538,107,98,2492,15,5250,5.728.988.095
13/08/2017 05:00,11.23,28651,2504,98,95,2478,11,5186,5.728.988.095
13/08/2017 06:00,11.08,29002,2421,94,99,2600,12,5226,5.728.988.095
13/08/2017 07:00,17.4,30159,2282,95,106,2600,12,5095,5.728.988.095
13/08/2017 08:00,20.95,31049,2279,97,109,2591,14,5090,5.728.988.095
13/08/2017 09:00,21.8,32745,2393,95,119,2578,22,5207,5.728.988.095
13/08/2017 10:00,23.25,33998,2480,89,125,2574,24,5292,5.728.988.095
13/08/2017 11:00,23.74,34670,2568,81,136,2502,32,5319,5.728.988.095
13/08/2017 12:00,23.57,34850,2669,81,152,2427,38,5367,5.728.988.095
13/08/2017 13:00,23.59,34952,2750,86,166,2362,40,5404,5.728.988.095
13/08/2017 14:00,23.48,34836,2741,86,171,2311,39,5348,5.728.988.095
13/08/2017 15:00,23.48,34679,2662,88,165,2310,39,5264,5.728.988.095
13/08/2017 16:00,24.07,34865,2577,86,152,2191,40,5046,5.728.988.095
13/08/2017 17:00,24.75,35214,2386,81,139,2055,39,4700,5.728.988.095
13/08/2017 18:00,25.9,35486,2113,75,133,1925,34,4280,5.728.988.095
13/08/2017 19:00,26.35,35447,1767,74,128,1983,30,3982,5.728.988.095
13/08/2017 20:00,26.59,35400,1466,72,121,2085,23,3767,5.728.988.095
13/08/2017 21:00,26.86,35565,1267,64,117,2252,18,3718,5.728.988.095
13/08/2017 22:00,26.64,34834,1154,49,115,2447,15,3780,5.728.988.095
13/08/2017 23:00,26.01,33147,1032,44,120,2611,11,3818,5.728.988.095
14/08/2017 00:00,25.86,31767,844,46,106,2596,10,3602,5.825.297.619
14/08/2017 01:00,25.12,30823,759,49,95,2505,10,3418,5.825.297.619
14/08/2017 02:00,24.9,30376,678,46,82,2436,10,3252,5.825.297.619
14/08/2017 03:00,24.89,30300,599,41,71,2327,9,3047,5.825.297.619
14/08/2017 04:00,24.96,30537,529,35,67,2205,15,2851,5.825.297.619
14/08/2017 05:00,25.95,31853,484,28,57,2021,14,2604,5.825.297.619
14/08/2017 06:00,27.12,34835,410,25,44,1826,9,2314,5.825.297.619
14/08/2017 07:00,27.99,38281,312,23,36,1683,9,2063,5.825.297.619
14/08/2017 08:00,28.38,40151,250,21,35,1561,10,1877,5.825.297.619
14/08/2017 09:00,28.36,40473,241,20,40,1509,9,1819,5.825.297.619
14/08/2017 10:00,28.39,40974,246,21,44,1474,7,1792,5.825.297.619
14/08/2017 11:00,28.3,41043,244,24,53,1553,8,1882,5.825.297.619
14/08/2017 12:00,28.09,40765,241,29,58,1558,9,1895,5.825.297.619
14/08/2017 13:00,27.99,40607,276,33,61,1501,9,1880,5.825.297.619
14/08/2017 14:00,27.93,40326,309,36,62,1435,9,1851,5.825.297.619
14/08/2017 15:00,27.74,39797,311,37,58,1375,9,1790,5.825.297.619
14/08/2017 16:00,27.7,39270,307,34,53,1357,7,1758,5.825.297.619
14/08/2017 17:00,28.28,39280,315,29,50,1187,6,1587,5.825.297.619
14/08/2017 18:00,28.44,38985,359,25,48,1057,4,1493,5.825.297.619
14/08/2017 19:00,28.97,38654,445,24,45,1047,4,1565,5.825.297.619
14/08/2017 20:00,28.13,38028,595,26,42,1057,4,1724,5.825.297.619
14/08/2017 21:00,27.9,37622,876,28,37,1148,4,2093,5.825.297.619
14/08/2017 22:00,27.19,36329,1218,24,31,1119,3,2395,5.825.297.619
14/08/2017 23:00,26.3,34112,1466,22,20,887,4,2399,5.825.297.619
15/08/2017 00:00,26.33,32631,1335,20,20,853,4,2232,5.825.297.619
15/08/2017 01:00,25.46,31601,1361,19,15,844,4,2243,5.825.297.619
15/08/2017 02:00,24.92,31147,1377,16,15,845,4,2257,5.825.297.619
15/08/2017 03:00,24.51,31096,1448,14,15,872,4,2353,5.825.297.619
15/08/2017 04:00,24.05,31492,1632,12,15,898,5,2562,5.825.297.619
15/08/2017 05:00,25.29,32828,1863,9,15,890,6,2783,5.825.297.619
15/08/2017 06:00,26.89,36009,2049,7,15,887,6,2964,5.825.297.619
15/08/2017 07:00,28.07,39253,2066,5,10,857,4,2942,5.825.297.619
15/08/2017 08:00,29.1,40841,2055,5,10,928,4,3002,5.825.297.619
15/08/2017 09:00,28.94,41222,2144,7,10,1006,5,3172,5.825.297.619
15/08/2017 10:00,28.55,41567,2227,7,15,1051,5,3305,5.825.297.619
15/08/2017 11:00,28.25,41668,2298,8,15,1207,7,3535,5.825.297.619
15/08/2017 12:00,27.93,41549,2418,8,15,1407,7,3855,5.825.297.619
15/08/2017 13:00,27.77,41388,2473,7,15,1540,6,4041,5.825.297.619
15/08/2017 14:00,27.86,41233,2416,8,15,1622,5,4066,5.825.297.619
15/08/2017 15:00,27.75,40728,2339,8,15,1683,6,4051,5.825.297.619
15/08/2017 16:00,27.4,40240,2175,8,15,1717,6,3921,5.825.297.619
15/08/2017 17:00,27.55,40125,1920,9,15,1769,4,3717,5.825.297.619
15/08/2017 18:00,27.94,39744,1615,11,15,1841,4,3486,5.825.297.619
15/08/2017 19:00,27.87,39368,1381,14,20,2019,4,3438,5.825.297.619
15/08/2017 20:00,27.67,38832,1267,17,30,2274,4,3592,5.825.297.619
15/08/2017 21:00,27.55,38447,1243,23,40,2484,4,3794,5.825.297.619
15/08/2017 22:00,26.82,37009,1096,30,50,2579,4,3759,5.825.297.619
15/08/2017 23:00,26.17,34730,984,37,55,2612,5,3693,5.825.297.619
16/08/2017 00:00,26.06,32942,1038,44,60,2547,5,3694,5.825.297.619
16/08/2017 01:00,25.5,31739,1076,51,70,2501,5,3703,5.825.297.619
16/08/2017 02:00,25.31,31304,1059,57,80,2355,5,3556,5.825.297.619
16/08/2017 03:00,25.27,31285,1036,60,85,2158,6,3345,5.825.297.619
16/08/2017 04:00,25.46,31403,1194,56,85,2019,6,3360,5.825.297.619
16/08/2017 05:00,26.33,32602,1339,49,90,1946,6,3430,5.825.297.619
16/08/2017 06:00,27.46,35559,1329,41,75,1847,6,3298,5.825.297.619
16/08/2017 07:00,28.05,39024,1227,31,60,1794,7,3119,5.825.297.619
16/08/2017 08:00,29.4,40277,1177,29,60,1760,10,3036,5.825.297.619
16/08/2017 09:00,29.4,40887,1192,32,60,1827,13,3124,5.825.297.619
16/08/2017 10:00,29.45,41415,1186,37,65,1853,15,3156,5.825.297.619
16/08/2017 11:00,29.14,41614,1151,44,65,1999,19,3278,5.825.297.619
16/08/2017 12:00,28.51,41521,1088,47,55,2032,17,3239,5.825.297.619
16/08/2017 13:00,28.36,41399,991,48,50,1995,14,3098,5.825.297.619
16/08/2017 14:00,28.1,41138,889,48,45,1880,13,2875,5.825.297.619
16/08/2017 15:00,27.79,40715,823,45,40,1861,10,2779,5.825.297.619
16/08/2017 16:00,27.57,40340,766,42,30,1840,9,2687,5.825.297.619
16/08/2017 17:00,27.82,40173,626,39,30,1770,7,2472,5.825.297.619
16/08/2017 18:00,27.96,39763,471,39,30,1525,6,2071,5.825.297.619
16/08/2017 19:00,27.93,39325,330,43,30,1405,6,1814,5.825.297.619
16/08/2017 20:00,27.55,38747,250,48,30,1326,7,1661,5.825.297.619
16/08/2017 21:00,27.59,38472,238,55,25,1338,5,1661,5.825.297.619
16/08/2017 22:00,27.16,37031,293,49,25,1400,5,1772,5.825.297.619
16/08/2017 23:00,26.85,34800,353,44,40,1233,7,1677,5.825.297.619
17/08/2017 00:00,26.23,32791,227,38,35,1173,7,1480,5.825.297.619
17/08/2017 01:00,25.81,31637,285,30,30,1073,7,1425,5.825.297.619
17/08/2017 02:00,25.6,31200,379,24,30,951,7,1391,5.825.297.619
17/08/2017 03:00,25.58,31079,519,21,30,851,6,1427,5.825.297.619
17/08/2017 04:00,25.58,31346,658,18,30,772,6,1484,5.825.297.619
17/08/2017 05:00,25.97,32604,840,14,30,692,6,1582,5.825.297.619
17/08/2017 06:00,27.3,35464,951,10,25,645,5,1636,5.825.297.619
17/08/2017 07:00,27.94,38886,1021,7,25,591,4,1648,5.825.297.619
17/08/2017 08:00,28.91,40053,1078,6,25,560,4,1673,5.825.297.619
17/08/2017 09:00,28.99,40861,1233,7,30,618,7,1895,5.825.297.619
17/08/2017 10:00,29.33,41401,1435,7,40,692,10,2184,5.825.297.619
17/08/2017 11:00,28.9,41629,1660,9,50,730,12,2461,5.825.297.619
17/08/2017 12:00,28.43,41501,1913,12,55,856,8,2844,5.825.297.619
17/08/2017 13:00,28.31,41400,2151,14,60,916,5,3146,5.825.297.619
17/08/2017 14:00,27.89,41070,2254,13,55,1060,5,3387,5.825.297.619
17/08/2017 15:00,27.32,40657,2310,11,45,1097,5,3468,5.825.297.619
17/08/2017 16:00,26.8,40240,2349,10,40,1124,5,3528,5.825.297.619
17/08/2017 17:00,26.98,40256,2216,11,35,1178,4,3444,5.825.297.619
17/08/2017 18:00,27.12,39950,2066,15,30,1314,4,3429,5.825.297.619
17/08/2017 19:00,27.3,39448,1994,16,30,1478,4,3522,5.825.297.619
17/08/2017 20:00,26.69,38911,1853,18,25,1636,4,3536,5.825.297.619
17/08/2017 21:00,26.71,38581,1825,21,25,1779,4,3654,5.825.297.619
17/08/2017 22:00,26.35,37072,1925,26,20,1839,4,3814,5.825.297.619
17/08/2017 23:00,25.74,34764,1870,22,20,1761,7,3680,5.825.297.619
18/08/2017 00:00,25.61,32609,1133,25,25,1668,6,2857,5.825.297.619
18/08/2017 01:00,25.56,31478,1014,23,40,1568,6,2651,5.825.297.619
18/08/2017 02:00,25.36,31031,895,21,55,1470,6,2447,5.825.297.619
18/08/2017 03:00,25.17,30935,756,19,70,1399,7,2251,5.825.297.619
18/08/2017 04:00,25.37,31099,672,17,70,1334,8,2101,5.825.297.619
18/08/2017 05:00,25.58,32391,646,16,75,1212,10,1959,5.825.297.619
18/08/2017 06:00,26.78,35395,668,17,70,1059,12,1826,5.825.297.619
18/08/2017 07:00,27.41,39022,704,21,65,951,14,1755,5.825.297.619
18/08/2017 08:00,28.6,40198,799,25,60,928,16,1828,5.825.297.619
18/08/2017 09:00,28.79,40896,903,31,60,902,16,1912,5.825.297.619
18/08/2017 10:00,28.95,41240,1072,37,55,928,16,2108,5.825.297.619
18/08/2017 11:00,28.97,41356,1325,41,45,1023,17,2451,5.825.297.619
18/08/2017 12:00,28.46,41164,1573,42,45,957,17,2634,5.825.297.619
18/08/2017 13:00,28.01,40787,1794,40,45,1006,17,2902,5.825.297.619
18/08/2017 14:00,27.94,40163,1892,37,45,964,17,2955,5.825.297.619
18/08/2017 15:00,27.62,39529,1886,39,40,933,18,2916,5.825.297.619
18/08/2017 16:00,26.83,38923,1796,42,25,911,15,2789,5.825.297.619
18/08/2017 17:00,27.06,38777,1617,45,25,857,13,2557,5.825.297.619
18/08/2017 18:00,27.13,38414,1522,54,25,812,13,2426,5.825.297.619
18/08/2017 19:00,27.05,37700,1461,56,25,807,11,2360,5.825.297.619
18/08/2017 20:00,26.75,36792,1284,55,30,874,9,2252,5.825.297.619
18/08/2017 21:00,26.76,36440,1138,54,40,870,7,2109,5.825.297.619
18/08/2017 22:00,26.72,35288,1066,50,50,809,7,1982,5.825.297.619
18/08/2017 23:00,25.99,33494,978,34,104,738,4,1858,5.825.297.619
19/08/2017 00:00,26.1,32093,694,29,149,799,4,1675,5.825.297.619
19/08/2017 01:00,24.94,31022,794,29,175,796,5,1799,5.825.297.619
19/08/2017 02:00,24.16,30511,875,31,198,791,6,1901,5.825.297.619
19/08/2017 03:00,23.98,30174,960,38,220,803,9,2030,5.825.297.619
19/08/2017 04:00,23.48,29891,1074,49,237,851,11,2222,5.825.297.619
19/08/2017 05:00,23.26,29857,1198,65,243,953,17,2476,5.825.297.619
19/08/2017 06:00,24.19,30479,1330,88,219,1033,24,2694,5.825.297.619
19/08/2017 07:00,24.61,31963,1407,109,155,1192,25,2888,5.825.297.619
19/08/2017 08:00,25.68,33607,1537,127,143,1351,26,3184,5.825.297.619
19/08/2017 09:00,26.32,35293,1829,141,139,1518,37,3664,5.825.297.619
19/08/2017 10:00,26.52,36321,2010,150,131,1701,39,4031,5.825.297.619
19/08/2017 11:00,26.42,36536,2179,155,116,1864,36,4350,5.825.297.619
19/08/2017 12:00,26.13,36460,2387,150,109,2093,29,4768,5.825.297.619
19/08/2017 13:00,25.83,36269,2256,129,98,2279,12,4774,5.825.297.619
19/08/2017 14:00,24.93,35978,2322,105,92,2478,12,5009,5.825.297.619
19/08/2017 15:00,24.62,35819,2444,87,90,2655,11,5287,5.825.297.619
19/08/2017 16:00,24.83,35878,2721,73,72,2865,11,5742,5.825.297.619
19/08/2017 17:00,24.93,36251,2782,61,60,2823,11,5737,5.825.297.619
19/08/2017 18:00,25.09,36296,2741,53,51,2844,11,5700,5.825.297.619
19/08/2017 19:00,25.71,35775,2592,52,54,2855,11,5564,5.825.297.619
19/08/2017 20:00,25.62,35397,2407,54,50,2869,11,5391,5.825.297.619
19/08/2017 21:00,25.79,35335,2285,57,46,3125,11,5524,5.825.297.619
19/08/2017 22:00,24.67,34464,2260,45,45,3142,11,5503,5.825.297.619
19/08/2017 23:00,23.77,33112,2237,79,46,3221,16,5599,5.825.297.619
20/08/2017 00:00,23.64,31596,1899,76,42,3250,16,5283,5.825.297.619
20/08/2017 01:00,21.87,30591,1920,73,39,3125,15,5172,5.825.297.619
20/08/2017 02:00,20.89,30071,1979,69,37,3131,12,5228,5.825.297.619
20/08/2017 03:00,20.42,29807,2054,62,37,3124,9,5286,5.825.297.619
20/08/2017 04:00,19.39,29550,2105,57,37,3168,9,5376,5.825.297.619
20/08/2017 05:00,18.37,29390,2078,55,36,3137,11,5317,5.825.297.619
20/08/2017 06:00,19.09,29655,2008,56,36,3179,10,5289,5.825.297.619
20/08/2017 07:00,22.17,30727,1859,63,39,3177,10,5148,5.825.297.619
20/08/2017 08:00,23.22,32125,1810,64,44,3151,11,5080,5.825.297.619
20/08/2017 09:00,24.5,33668,1881,63,46,3209,14,5213,5.825.297.619
20/08/2017 10:00,25.16,34822,1995,62,52,3283,16,5408,5.825.297.619
20/08/2017 11:00,25.44,35493,2175,63,57,3283,12,5590,5.825.297.619
20/08/2017 12:00,25.44,35567,2332,60,61,3212,13,5678,5.825.297.619
20/08/2017 13:00,25.22,35439,2428,54,60,3096,12,5650,5.825.297.619
20/08/2017 14:00,25.03,35359,2454,48,56,2960,13,5531,5.825.297.619
20/08/2017 15:00,24.76,35260,2408,44,51,2813,12,5328,5.825.297.619
20/08/2017 16:00,24.71,35473,2673,43,44,2456,12,5228,5.825.297.619
20/08/2017 17:00,25.73,36063,2738,42,35,2219,12,5046,5.825.297.619
20/08/2017 18:00,26.18,36455,2626,40,22,2017,12,4717,5.825.297.619
20/08/2017 19:00,26.38,36424,2443,41,21,1930,10,4445,5.825.297.619
20/08/2017 20:00,26.88,36337,2279,37,20,1916,9,4261,5.825.297.619
20/08/2017 21:00,27.09,36446,2204,33,19,1826,9,4091,5.825.297.619
20/08/2017 22:00,26.65,35364,2247,30,20,1750,10,4057,5.825.297.619
20/08/2017 23:00,25.79,33407,2302,18,14,1544,5,3883,5.825.297.619
21/08/2017 00:00,23.84,32235,2342,14,13,1428,5,3802,5.830.714.286
21/08/2017 01:00,22.68,31382,2399,13,13,1370,5,3800,5.830.714.286
21/08/2017 02:00,22.55,30984,2463,12,13,1331,5,3824,5.830.714.286
21/08/2017 03:00,22.74,30938,2510,12,13,1311,5,3851,5.830.714.286
21/08/2017 04:00,22.49,31296,2572,11,14,1249,5,3851,5.830.714.286
21/08/2017 05:00,23.78,32773,2579,10,14,1157,5,3765,5.830.714.286
21/08/2017 06:00,26.83,36037,2496,8,13,1079,4,3600,5.830.714.286
21/08/2017 07:00,28,39737,2392,8,15,960,5,3380,5.830.714.286
21/08/2017 08:00,29.37,41062,2417,8,17,859,7,3308,5.830.714.286
21/08/2017 09:00,29.81,41731,2557,8,18,920,7,3510,5.830.714.286
21/08/2017 10:00,29.93,42247,2661,8,23,848,8,3548,5.830.714.286
21/08/2017 11:00,29.64,42302,2735,7,24,780,7,3553,5.830.714.286
21/08/2017 12:00,29.47,42040,2787,7,26,786,7,3613,5.830.714.286
21/08/2017 13:00,29.38,41923,2762,7,26,806,6,3607,5.830.714.286
21/08/2017 14:00,29.2,41621,2766,7,26,860,6,3665,5.830.714.286
21/08/2017 15:00,29.23,41056,2753,7,23,915,5,3703,5.830.714.286
21/08/2017 16:00,28.76,40586,2647,7,19,939,5,3617,5.830.714.286
21/08/2017 17:00,29.33,40538,2480,8,17,943,4,3452,5.830.714.286
21/08/2017 18:00,28.98,40149,2346,8,15,995,4,3368,5.830.714.286
21/08/2017 19:00,29.21,39851,2167,8,13,1033,4,3225,5.830.714.286
21/08/2017 20:00,28.69,39460,1944,9,13,1096,4,3066,5.830.714.286
21/08/2017 21:00,28.46,39004,1810,10,13,1211,4,3048,5.830.714.286
21/08/2017 22:00,27.9,37463,1730,9,14,1282,4,3039,5.830.714.286
21/08/2017 23:00,27.04,35238,1671,4,11,1405,4,3095,5.830.714.286
22/08/2017 00:00,27.02,33286,1898,3,11,1464,4,3380,5.830.714.286
22/08/2017 01:00,26.63,32273,1836,2,11,1519,4,3372,5.830.714.286
22/08/2017 02:00,26.52,31833,1790,2,11,1524,4,3331,5.830.714.286
22/08/2017 03:00,26.42,31839,1752,2,10,1518,4,3286,5.830.714.286
22/08/2017 04:00,26.42,32197,1718,2,9,1501,4,3234,5.830.714.286
22/08/2017 05:00,26.96,33569,1625,2,9,1495,4,3135,5.830.714.286
22/08/2017 06:00,27.86,36618,1410,2,9,1449,4,2874,5.830.714.286
22/08/2017 07:00,29.62,40003,1220,2,8,1349,4,2583,5.830.714.286
22/08/2017 08:00,32.36,41584,1127,3,9,1219,4,2362,5.830.714.286
22/08/2017 09:00,32.19,41521,1061,2,10,1101,4,2178,5.830.714.286
22/08/2017 10:00,32.62,42061,974,3,12,1001,5,1995,5.830.714.286
22/08/2017 11:00,32.28,42213,867,4,13,943,6,1833,5.830.714.286
22/08/2017 12:00,31.57,42183,799,6,17,928,8,1758,5.830.714.286
22/08/2017 13:00,31.49,42218,811,8,22,881,9,1731,5.830.714.286
22/08/2017 14:00,30.73,41989,841,9,31,824,11,1716,5.830.714.286
22/08/2017 15:00,30.09,41452,841,9,35,785,13,1683,5.830.714.286
22/08/2017 16:00,29.07,41116,791,11,37,732,13,1584,5.830.714.286
22/08/2017 17:00,29.71,41126,661,12,39,709,14,1435,5.830.714.286
22/08/2017 18:00,29.81,40832,502,11,41,668,14,1236,5.830.714.286
22/08/2017 19:00,30.48,40595,368,10,44,628,12,1062,5.830.714.286
22/08/2017 20:00,29.56,40202,273,10,46,645,11,985,5.830.714.286
22/08/2017 21:00,29.36,39786,242,11,45,657,10,965,5.830.714.286
22/08/2017 22:00,28.87,38194,229,19,44,683,8,983,5.830.714.286
22/08/2017 23:00,27.77,35856,199,8,35,761,7,1010,5.830.714.286
23/08/2017 00:00,27.64,33560,210,8,35,752,8,1013,5.830.714.286
23/08/2017 01:00,27.18,32518,206,10,35,724,9,984,5.830.714.286
23/08/2017 02:00,27.01,32089,171,11,36,685,9,912,5.830.714.286
23/08/2017 03:00,26.99,32098,127,13,39,656,9,844,5.830.714.286
23/08/2017 04:00,27.09,32370,108,12,43,604,9,776,5.830.714.286
23/08/2017 05:00,27.48,34116,101,14,47,520,10,692,5.830.714.286
23/08/2017 06:00,28.87,37433,89,14,44,446,11,604,5.830.714.286
23/08/2017 07:00,34.48,40850,84,16,44,336,13,493,5.830.714.286
23/08/2017 08:00,37.95,41619,76,20,49,294,17,456,5.830.714.286
23/08/2017 09:00,37.88,42016,61,27,63,269,19,439,5.830.714.286
23/08/2017 10:00,37.94,42540,61,33,84,269,18,465,5.830.714.286
23/08/2017 11:00,36.96,42724,62,41,116,269,20,508,5.830.714.286
23/08/2017 12:00,34.98,42164,60,51,146,288,22,567,5.830.714.286
23/08/2017 13:00,34.99,41911,80,60,174,291,25,630,5.830.714.286
23/08/2017 14:00,34.92,41562,105,68,194,287,30,684,5.830.714.286
23/08/2017 15:00,33.16,41094,127,76,206,296,31,736,5.830.714.286
23/08/2017 16:00,31.4,40662,123,87,195,280,26,711,5.830.714.286
23/08/2017 17:00,33.46,40499,123,99,188,278,26,714,5.830.714.286
23/08/2017 18:00,30.89,40034,127,111,184,263,29,714,5.830.714.286
23/08/2017 19:00,30.87,39749,129,124,179,260,27,719,5.830.714.286
23/08/2017 20:00,30.09,39375,155,132,162,283,29,761,5.830.714.286
23/08/2017 21:00,29.86,39041,239,136,155,334,31,895,5.830.714.286
23/08/2017 22:00,29.26,37420,375,143,152,397,32,1099,5.830.714.286
23/08/2017 23:00,27.7,35121,517,165,171,361,38,1252,5.830.714.286
24/08/2017 00:00,28.22,33432,611,167,177,400,36,1391,5.830.714.286
24/08/2017 01:00,28.15,32361,719,170,184,428,34,1535,5.830.714.286
24/08/2017 02:00,27.76,32021,849,174,195,441,34,1693,5.830.714.286
24/08/2017 03:00,27.63,31994,912,180,202,468,38,1800,5.830.714.286
24/08/2017 04:00,27.9,32258,917,182,208,494,41,1842,5.830.714.286
24/08/2017 05:00,28.38,33855,887,183,209,524,40,1843,5.830.714.286
24/08/2017 06:00,28.86,37054,867,181,197,529,42,1816,5.830.714.286
24/08/2017 07:00,31.43,40467,822,180,197,496,45,1740,5.830.714.286
24/08/2017 08:00,32.82,41779,795,178,215,502,48,1738,5.830.714.286
24/08/2017 09:00,33.79,42382,838,174,236,496,48,1792,5.830.714.286
24/08/2017 10:00,34.8,42823,957,170,259,521,45,1952,5.830.714.286
24/08/2017 11:00,33.62,42876,1024,168,281,555,36,2064,5.830.714.286
24/08/2017 12:00,34.48,42170,1005,165,286,605,32,2093,5.830.714.286
24/08/2017 13:00,33.34,41896,1114,163,282,651,30,2240,5.830.714.286
24/08/2017 14:00,33.37,41607,1220,159,268,657,29,2333,5.830.714.286
24/08/2017 15:00,31.74,41228,1380,154,237,645,24,2440,5.830.714.286
24/08/2017 16:00,30.67,40782,1619,150,182,673,22,2646,5.830.714.286
24/08/2017 17:00,31.43,40839,1605,145,141,682,20,2593,5.830.714.286
24/08/2017 18:00,30.97,40542,1572,137,118,698,14,2539,5.830.714.286
24/08/2017 19:00,31.02,40160,1777,125,95,753,9,2759,5.830.714.286
24/08/2017 20:00,30.47,39778,1809,113,73,838,8,2841,5.830.714.286
24/08/2017 21:00,30.58,39399,1769,102,60,939,9,2879,5.830.714.286
24/08/2017 22:00,29.46,37736,1839,75,50,1020,12,2996,5.830.714.286
24/08/2017 23:00,28.65,35406,1941,67,44,1187,8,3247,5.830.714.286
25/08/2017 00:00,29.1,33838,2239,52,47,1285,8,3631,5.830.714.286
25/08/2017 01:00,28.82,32775,2220,43,53,1352,10,3678,5.830.714.286
25/08/2017 02:00,28.72,32362,2191,40,62,1410,9,3712,5.830.714.286
25/08/2017 03:00,28.55,32312,2169,41,70,1489,8,3777,5.830.714.286
25/08/2017 04:00,28.68,32534,2182,42,71,1567,7,3869,5.830.714.286
25/08/2017 05:00,29.07,33924,2142,42,82,1576,7,3849,5.830.714.286
25/08/2017 06:00,29.75,37022,2011,40,85,1610,6,3752,5.830.714.286
25/08/2017 07:00,31.16,40594,1894,34,87,1655,6,3676,5.830.714.286
25/08/2017 08:00,31.88,42315,1911,38,105,1758,8,3820,5.830.714.286
25/08/2017 09:00,31.92,42334,2097,35,167,1801,12,4112,5.830.714.286
25/08/2017 10:00,32.15,42884,2251,36,219,1852,22,4380,5.830.714.286
25/08/2017 11:00,31.91,42924,2332,39,276,1911,19,4577,5.830.714.286
25/08/2017 12:00,31.36,42406,2418,38,321,2041,17,4835,5.830.714.286
25/08/2017 13:00,30.69,41928,2449,35,337,2062,19,4902,5.830.714.286
25/08/2017 14:00,30.27,41288,2479,30,359,2095,23,4986,5.830.714.286
25/08/2017 15:00,29.87,40593,2482,28,354,2107,26,4997,5.830.714.286
25/08/2017 16:00,29.42,40121,2411,32,346,2132,28,4949,5.830.714.286
25/08/2017 17:00,30.07,39972,2200,35,336,2102,17,4690,5.830.714.286
25/08/2017 18:00,30.53,39578,1884,34,318,1914,13,4163,5.830.714.286
25/08/2017 19:00,31,39049,1520,36,298,1937,13,3804,5.830.714.286
25/08/2017 20:00,30.08,38376,1213,39,275,1967,14,3508,5.830.714.286
25/08/2017 21:00,30.06,37860,1062,44,256,2134,13,3509,5.830.714.286
25/08/2017 22:00,29.82,36549,1029,51,235,2208,9,3532,5.830.714.286
25/08/2017 23:00,29.16,34808,972,58,232,2265,16,3543,5.830.714.286
26/08/2017 00:00,29.5,33168,753,60,193,2250,9,3265,5.830.714.286
26/08/2017 01:00,29.25,32079,707,63,147,2279,6,3202,5.830.714.286
26/08/2017 02:00,29.03,31626,673,66,109,2291,6,3145,5.830.714.286
26/08/2017 03:00,28.94,31384,625,63,81,2336,5,3110,5.830.714.286
26/08/2017 04:00,28.81,31243,578,71,58,2321,6,3034,5.830.714.286
26/08/2017 05:00,28.66,31323,492,83,41,2233,9,2858,5.830.714.286
26/08/2017 06:00,28.98,31913,380,94,31,2188,10,2703,5.830.714.286
26/08/2017 07:00,29,33455,309,104,28,2093,9,2543,5.830.714.286
26/08/2017 08:00,29.49,35108,291,118,32,2030,13,2484,5.830.714.286
26/08/2017 09:00,29.81,36730,288,131,44,1986,23,2472,5.830.714.286
26/08/2017 10:00,29.86,37669,258,144,59,1940,24,2425,5.830.714.286
26/08/2017 11:00,29.69,37802,226,153,74,1776,21,2250,5.830.714.286
26/08/2017 12:00,29.3,37603,201,155,83,1608,17,2064,5.830.714.286
26/08/2017 13:00,29.25,37290,191,154,87,1480,14,1926,5.830.714.286
26/08/2017 14:00,29.15,36941,180,150,87,1370,13,1800,5.830.714.286
26/08/2017 15:00,29.18,36732,166,142,81,1290,13,1692,5.830.714.286
26/08/2017 16:00,29.26,36776,145,131,71,1120,12,1479,5.830.714.286
26/08/2017 17:00,29.69,37171,130,119,58,915,9,1231,5.830.714.286
26/08/2017 18:00,30.23,37210,120,104,47,764,8,1043,5.830.714.286
26/08/2017 19:00,30.48,36823,104,90,40,697,7,938,5.830.714.286
26/08/2017 20:00,30.2,36613,111,78,33,706,7,935,5.830.714.286
26/08/2017 21:00,30.72,36403,124,70,26,693,6,919,5.830.714.286
26/08/2017 22:00,30.66,35373,137,59,21,671,6,894,5.830.714.286
26/08/2017 23:00,29.65,33927,134,54,17,684,4,893,5.830.714.286
27/08/2017 00:00,30.08,32734,163,48,15,641,4,871,5.830.714.286
27/08/2017 01:00,29.4,31781,173,42,14,581,4,814,5.830.714.286
27/08/2017 02:00,29.08,31274,153,36,13,543,3,748,5.830.714.286
27/08/2017 03:00,28.97,31101,146,31,13,491,3,684,5.830.714.286
27/08/2017 04:00,28.99,30931,186,26,14,431,4,661,5.830.714.286
27/08/2017 05:00,28.85,30827,230,21,16,383,4,654,5.830.714.286
27/08/2017 06:00,28.74,30989,276,17,14,335,4,646,5.830.714.286
27/08/2017 07:00,29.03,31993,350,13,12,303,4,682,5.830.714.286
27/08/2017 08:00,29.62,33434,407,11,10,265,4,697,5.830.714.286
27/08/2017 09:00,29.66,34986,470,11,10,260,4,755,5.830.714.286
27/08/2017 10:00,30,36027,563,10,9,260,4,846,5.830.714.286
27/08/2017 11:00,30.31,36528,551,11,9,280,4,855,5.830.714.286
27/08/2017 12:00,29.88,36559,558,12,9,304,4,887,5.830.714.286
27/08/2017 13:00,29.52,36445,662,13,10,308,4,997,5.830.714.286
27/08/2017 14:00,29.51,36237,708,14,10,296,4,1032,5.830.714.286
27/08/2017 15:00,29.5,36098,670,15,12,318,4,1019,5.830.714.286
27/08/2017 16:00,29.54,36285,637,15,14,299,4,969,5.830.714.286
27/08/2017 17:00,29.85,36811,569,15,17,329,5,935,5.830.714.286
27/08/2017 18:00,30.42,37202,438,14,25,351,5,833,5.830.714.286
27/08/2017 19:00,31.14,37394,305,14,31,409,6,765,5.830.714.286
27/08/2017 20:00,31.25,37467,225,14,39,471,6,755,5.830.714.286
27/08/2017 21:00,31.54,37364,201,15,50,622,6,894,5.830.714.286
27/08/2017 22:00,31.06,36214,199,13,63,741,7,1023,5.830.714.286
27/08/2017 23:00,30.36,34338,180,16,61,821,8,1086,5.830.714.286
28/08/2017 00:00,30.09,32900,156,15,67,857,7,1102,580.297.619
28/08/2017 01:00,29.62,32164,147,15,73,862,7,1104,580.297.619
28/08/2017 02:00,29.19,31909,134,14,79,798,5,1030,580.297.619
28/08/2017 03:00,28.98,32008,120,13,83,741,5,962,580.297.619
28/08/2017 04:00,29.14,32333,118,13,83,677,4,895,580.297.619
28/08/2017 05:00,29.82,34127,112,12,79,638,5,846,580.297.619
28/08/2017 06:00,32.01,37415,99,11,65,572,4,751,580.297.619
28/08/2017 07:00,38.09,41298,89,8,54,537,4,692,580.297.619
28/08/2017 08:00,40.29,42826,82,9,48,503,3,645,580.297.619
28/08/2017 09:00,41.81,42313,94,10,44,541,3,692,580.297.619
28/08/2017 10:00,41.4,42519,115,11,42,601,3,772,580.297.619
28/08/2017 11:00,41.17,42671,157,12,40,786,4,999,580.297.619
28/08/2017 12:00,39.97,42427,216,13,39,1009,5,1282,580.297.619
28/08/2017 13:00,38.94,42424,314,13,40,1191,4,1562,580.297.619
28/08/2017 14:00,37.89,42203,369,12,41,1284,5,1711,580.297.619
28/08/2017 15:00,35.95,41936,385,11,43,1476,5,1920,580.297.619
28/08/2017 16:00,33.11,41629,364,9,42,1597,4,2016,580.297.619
28/08/2017 17:00,35.6,41597,342,8,42,1654,3,2049,580.297.619
28/08/2017 18:00,38.54,41157,305,7,42,1771,3,2128,580.297.619
28/08/2017 19:00,38.65,40911,244,6,41,1995,3,2289,580.297.619
28/08/2017 20:00,34.95,40581,241,5,41,2120,3,2410,580.297.619
28/08/2017 21:00,32.82,39910,301,4,41,2272,3,2621,580.297.619
28/08/2017 22:00,31.36,37923,403,8,39,2348,3,2801,580.297.619
28/08/2017 23:00,29.78,35404,507,6,21,2522,3,3059,580.297.619
29/08/2017 00:00,29.63,33894,766,7,17,2553,3,3346,580.297.619
29/08/2017 01:00,29.07,32917,841,9,11,2566,3,3430,580.297.619
29/08/2017 02:00,28.9,32494,895,13,9,2593,4,3514,580.297.619
29/08/2017 03:00,28.56,32472,936,18,9,2565,5,3533,580.297.619
29/08/2017 04:00,28.79,32808,1018,20,9,2489,5,3541,580.297.619
29/08/2017 05:00,29.3,34171,1088,21,9,2432,7,3557,580.297.619
29/08/2017 06:00,31.9,37188,1133,23,9,2428,6,3599,580.297.619
29/08/2017 07:00,34.72,40623,1098,22,9,2312,4,3445,580.297.619
29/08/2017 08:00,36.12,40565,1037,28,9,2330,4,3408,580.297.619
29/08/2017 09:00,35.95,41128,1098,38,9,2289,5,3439,580.297.619
29/08/2017 10:00,35.9,41760,1183,42,10,2323,7,3565,580.297.619
29/08/2017 11:00,33.86,42076,1315,49,12,2339,9,3724,580.297.619
29/08/2017 12:00,32.4,42205,1459,54,13,2378,10,3914,580.297.619
29/08/2017 13:00,32.19,42336,1632,55,13,2387,11,4098,580.297.619
29/08/2017 14:00,32.28,42147,1771,57,15,2416,11,4270,580.297.619
29/08/2017 15:00,32.45,41809,1864,58,16,2362,11,4311,580.297.619
29/08/2017 16:00,32.87,41532,1852,57,17,2369,12,4307,580.297.619
29/08/2017 17:00,33.82,41455,1652,59,18,2350,10,4089,580.297.619
29/08/2017 18:00,34.24,41016,1418,63,20,2352,9,3862,580.297.619
29/08/2017 19:00,34.71,40752,1188,66,21,2367,8,3650,580.297.619
29/08/2017 20:00,33.72,40474,972,70,29,2372,8,3451,580.297.619
29/08/2017 21:00,33.6,39794,788,76,46,2371,10,3291,580.297.619
29/08/2017 22:00,32.6,37993,645,87,62,2218,14,3026,580.297.619
29/08/2017 23:00,30.32,35660,552,123,112,1991,17,2795,580.297.619
30/08/2017 00:00,30.14,33896,636,128,126,1900,17,2807,580.297.619
30/08/2017 01:00,29.6,32813,625,130,134,1815,16,2720,580.297.619
30/08/2017 02:00,28.97,32451,531,134,142,1737,19,2563,580.297.619
30/08/2017 03:00,28.55,32417,385,138,147,1770,19,2459,580.297.619
30/08/2017 04:00,28.86,32805,299,143,147,1637,19,2245,580.297.619
30/08/2017 05:00,30.06,34245,249,145,138,1525,20,2077,580.297.619
30/08/2017 06:00,32.77,37512,194,147,120,1375,20,1856,580.297.619
30/08/2017 07:00,36.06,41099,161,152,103,1297,22,1735,580.297.619
30/08/2017 08:00,37.45,41696,147,158,91,1284,25,1705,580.297.619
30/08/2017 09:00,37.42,42133,145,167,88,1340,26,1766,580.297.619
30/08/2017 10:00,37.13,42521,141,175,87,1397,31,1831,580.297.619
30/08/2017 11:00,36.56,42339,146,182,87,1477,36,1928,580.297.619
30/08/2017 12:00,36.4,42116,177,184,92,1641,37,2131,580.297.619
30/08/2017 13:00,35.81,42009,229,178,92,1666,37,2202,580.297.619
30/08/2017 14:00,36.24,41746,292,163,88,1676,37,2256,580.297.619
30/08/2017 15:00,33.46,41437,343,146,80,1644,33,2246,580.297.619
30/08/2017 16:00,32.8,41126,394,131,77,1627,28,2257,580.297.619
30/08/2017 17:00,33.88,41084,469,117,77,1573,22,2258,580.297.619
30/08/2017 18:00,33.81,40744,518,104,88,1507,17,2234,580.297.619
30/08/2017 19:00,33.82,40551,588,92,109,1502,15,2306,580.297.619
30/08/2017 20:00,33.31,40283,691,81,137,1617,14,2540,580.297.619
30/08/2017 21:00,31.97,39681,761,75,156,1687,14,2693,580.297.619
30/08/2017 22:00,30.8,37904,828,84,166,1699,13,2790,580.297.619
30/08/2017 23:00,30.15,35489,862,61,193,1687,14,2817,580.297.619
31/08/2017 00:00,30.07,33467,1182,60,193,1730,15,3180,580.297.619
31/08/2017 01:00,28.97,32409,1236,59,193,1697,14,3199,580.297.619
31/08/2017 02:00,28.83,32050,1211,60,191,1591,11,3064,580.297.619
31/08/2017 03:00,28.08,32033,1084,62,193,1524,11,2874,580.297.619
31/08/2017 04:00,28.53,32430,990,68,195,1425,13,2691,580.297.619
31/08/2017 05:00,29.81,33875,992,74,190,1330,15,2601,580.297.619
31/08/2017 06:00,31.79,37167,892,79,165,1178,14,2328,580.297.619
31/08/2017 07:00,35.09,40738,738,87,139,1026,16,2006,580.297.619
31/08/2017 08:00,36.06,41573,650,91,134,932,18,1825,580.297.619
31/08/2017 09:00,36.83,42120,667,100,140,862,17,1786,580.297.619
31/08/2017 10:00,37.42,42607,786,110,159,813,18,1886,580.297.619
31/08/2017 11:00,36.79,42466,965,117,174,793,22,2071,580.297.619
31/08/2017 12:00,36.39,42294,1071,121,183,786,22,2183,580.297.619
31/08/2017 13:00,35.92,42288,1224,123,196,787,27,2357,580.297.619
31/08/2017 14:00,35.75,42061,1359,122,203,766,32,2482,580.297.619
31/08/2017 15:00,35.07,41699,1471,125,181,820,30,2627,580.297.619
31/08/2017 16:00,34.63,41268,1641,126,165,851,22,2805,580.297.619
31/08/2017 17:00,35.38,41275,1807,129,147,903,20,3006,580.297.619
31/08/2017 18:00,35.65,40907,1765,130,143,979,22,3039,580.297.619
31/08/2017 19:00,35.88,40659,1623,132,144,1040,24,2963,580.297.619
31/08/2017 20:00,35.3,40413,1408,140,142,1119,29,2838,580.297.619
31/08/2017 21:00,34.64,39665,1338,144,130,1214,34,2860,580.297.619
31/08/2017 22:00,32.76,37791,1369,140,124,1324,32,2989,580.297.619
31/08/2017 23:00,31.4,35276,1336,157,84,1452,12,3041,580.297.619
01/09/2017 00:00,31.42,33301,1391,149,76,1479,14,3109,580.297.619
01/09/2017 01:00,30.34,32284,1292,142,67,1465,25,2991,580.297.619
01/09/2017 02:00,29.06,32060,1178,138,65,1460,32,2873,580.297.619
01/09/2017 03:00,28.92,32119,1055,132,64,1523,34,2808,580.297.619
01/09/2017 04:00,29.69,32407,973,127,64,1506,27,2697,580.297.619
01/09/2017 05:00,31.22,33830,905,121,65,1465,18,2574,580.297.619
01/09/2017 06:00,32.57,37022,808,113,57,1369,22,2369,580.297.619
01/09/2017 07:00,35.65,40714,690,107,51,1272,18,2138,580.297.619
01/09/2017 08:00,36.92,41608,577,107,46,1143,13,1886,580.297.619
01/09/2017 09:00,37.02,42231,552,102,42,1028,15,1739,580.297.619
01/09/2017 10:00,36.73,42675,553,90,38,980,16,1677,580.297.619
01/09/2017 11:00,36.38,42689,555,78,33,985,15,1666,580.297.619
01/09/2017 12:00,37.87,42332,532,67,28,950,14,1591,580.297.619
01/09/2017 13:00,35.31,41977,551,60,25,845,13,1494,580.297.619
01/09/2017 14:00,34.47,41294,564,52,22,813,10,1461,580.297.619
01/09/2017 15:00,33.66,40625,575,44,23,819,7,1468,580.297.619
01/09/2017 16:00,33.44,40178,550,40,25,799,5,1419,580.297.619
01/09/2017 17:00,33.92,40149,512,36,27,834,5,1414,580.297.619
01/09/2017 18:00,34.96,39819,439,34,32,827,3,1335,580.297.619
01/09/2017 19:00,35.32,39394,363,31,38,813,3,1248,580.297.619
01/09/2017 20:00,35.06,38812,320,28,43,804,3,1198,580.297.619
01/09/2017 21:00,34.23,38082,305,27,48,881,3,1264,580.297.619
01/09/2017 22:00,32.69,36600,319,25,53,968,3,1368,580.297.619
01/09/2017 23:00,32.27,34671,301,15,65,1070,4,1455,580.297.619
02/09/2017 00:00,31.37,32880,246,16,72,1017,4,1355,580.297.619
02/09/2017 01:00,31.04,31733,267,19,79,975,4,1344,580.297.619
02/09/2017 02:00,30.39,31253,298,20,93,924,5,1340,580.297.619
02/09/2017 03:00,30.18,31037,316,21,98,875,5,1315,580.297.619
02/09/2017 04:00,30.4,30979,343,21,101,794,6,1265,580.297.619
02/09/2017 05:00,30.31,31225,353,21,110,720,8,1212,580.297.619
02/09/2017 06:00,30.69,31779,330,18,119,615,8,1090,580.297.619
02/09/2017 07:00,31.38,33262,316,16,135,495,7,969,580.297.619
02/09/2017 08:00,32.63,35260,301,16,141,423,7,888,580.297.619
02/09/2017 09:00,33.51,36582,309,17,141,334,8,809,580.297.619
02/09/2017 10:00,33.78,37478,325,20,131,297,9,782,580.297.619
02/09/2017 11:00,33.57,37522,336,23,123,294,10,786,580.297.619
02/09/2017 12:00,33.05,37265,331,28,113,298,13,783,580.297.619
02/09/2017 13:00,31.9,36886,342,32,105,330,15,824,580.297.619
02/09/2017 14:00,31.5,36497,357,40,98,326,20,841,580.297.619
02/09/2017 15:00,31.37,36302,369,46,85,343,24,867,580.297.619
02/09/2017 16:00,31.35,36466,369,51,80,367,26,893,580.297.619
02/09/2017 17:00,31.93,36913,371,56,78,404,26,935,580.297.619
02/09/2017 18:00,33.35,37088,339,60,78,433,24,934,580.297.619
02/09/2017 19:00,33.74,36872,281,62,78,465,26,912,580.297.619
02/09/2017 20:00,33.57,36730,237,63,79,502,25,906,580.297.619
02/09/2017 21:00,33.32,36368,232,67,79,535,24,937,580.297.619
02/09/2017 22:00,32.05,35172,242,92,79,565,27,1005,580.297.619
02/09/2017 23:00,31.37,33689,223,107,42,569,31,972,580.297.619
03/09/2017 00:00,31.55,32496,174,109,42,569,30,924,580.297.619
03/09/2017 01:00,30.95,31622,138,109,42,584,29,902,580.297.619
03/09/2017 02:00,30.34,31145,100,108,43,607,27,885,580.297.619
03/09/2017 03:00,30.03,31015,83,104,44,643,26,900,580.297.619
03/09/2017 04:00,30.05,30977,76,105,45,703,26,955,580.297.619
03/09/2017 05:00,29.82,30992,76,107,45,747,24,999,580.297.619
03/09/2017 06:00,30.13,31083,87,112,45,748,22,1014,580.297.619
03/09/2017 07:00,30.74,32137,120,116,45,745,22,1048,580.297.619
03/09/2017 08:00,31.02,33816,145,118,46,749,22,1080,580.297.619
03/09/2017 09:00,31.29,35467,141,120,47,741,20,1069,580.297.619
03/09/2017 10:00,31.35,36430,132,126,47,740,19,1064,580.297.619
03/09/2017 11:00,31.39,36813,99,132,47,828,18,1124,580.297.619
03/09/2017 12:00,31.47,36708,90,137,46,929,16,1218,580.297.619
03/09/2017 13:00,31.09,36504,117,141,44,988,18,1308,580.297.619
03/09/2017 14:00,30.88,36233,144,144,42,1015,19,1364,580.297.619
03/09/2017 15:00,30.97,36152,168,148,40,1028,17,1401,580.297.619
03/09/2017 16:00,31.02,36435,210,151,36,1060,13,1470,580.297.619
03/09/2017 17:00,31.44,36970,240,155,34,1142,15,1586,580.297.619
03/09/2017 18:00,32.21,37317,240,159,32,1238,15,1684,580.297.619
03/09/2017 19:00,33.84,37677,247,160,32,1332,15,1786,580.297.619
03/09/2017 20:00,34.06,37770,272,162,32,1398,18,1882,580.297.619
03/09/2017 21:00,33.68,37533,299,160,32,1566,21,2078,580.297.619
03/09/2017 22:00,31.99,36297,345,162,32,1650,27,2216,580.297.619
03/09/2017 23:00,31.55,34290,389,179,38,1713,13,2332,580.297.619
04/09/2017 00:00,30.55,32836,281,182,37,1728,14,2242,5.812.857.143
04/09/2017 01:00,30.05,32013,295,188,35,1769,20,2307,5.812.857.143
04/09/2017 02:00,28.91,31690,307,192,30,1800,20,2349,5.812.857.143
04/09/2017 03:00,28.9,31836,357,194,26,1827,21,2425,5.812.857.143
04/09/2017 04:00,29.87,32322,431,195,25,1855,19,2525,5.812.857.143
04/09/2017 05:00,30.46,34007,483,195,25,1861,23,2587,5.812.857.143
04/09/2017 06:00,32.31,37350,528,197,26,1878,26,2655,5.812.857.143
04/09/2017 07:00,35.07,41005,583,198,31,1843,34,2689,5.812.857.143
04/09/2017 08:00,38.96,41976,617,197,44,1907,42,2807,5.812.857.143
04/09/2017 09:00,38.98,42540,669,195,59,1905,49,2877,5.812.857.143
04/09/2017 10:00,37.94,42933,721,192,64,2001,52,3030,5.812.857.143
04/09/2017 11:00,37.46,42969,721,192,66,2112,50,3141,5.812.857.143
04/09/2017 12:00,36.8,42838,682,193,66,2249,48,3238,5.812.857.143
04/09/2017 13:00,35.5,42875,657,193,64,2266,44,3224,5.812.857.143
04/09/2017 14:00,35.28,42629,649,194,60,2389,39,3331,5.812.857.143
04/09/2017 15:00,35.87,42232,652,194,59,2431,33,3369,5.812.857.143
04/09/2017 16:00,35.93,41820,678,193,59,2371,37,3338,5.812.857.143
04/09/2017 17:00,36.69,41910,701,193,66,2337,33,3330,5.812.857.143
04/09/2017 18:00,37.36,41658,614,191,82,2266,28,3181,5.812.857.143
04/09/2017 19:00,37.23,41609,466,188,89,2193,27,2963,5.812.857.143
04/09/2017 20:00,36.24,41318,367,185,90,2121,24,2787,5.812.857.143
04/09/2017 21:00,34.99,40360,317,180,90,2163,16,2766,5.812.857.143
04/09/2017 22:00,33.54,38348,301,155,85,2124,13,2678,5.812.857.143
04/09/2017 23:00,31.47,35824,281,169,102,2075,23,2650,5.812.857.143
05/09/2017 00:00,30.72,34029,243,166,99,1989,22,2519,5.812.857.143
05/09/2017 01:00,30.05,33077,222,162,113,1883,20,2400,5.812.857.143
05/09/2017 02:00,29.69,32702,218,159,127,1735,17,2256,5.812.857.143
05/09/2017 03:00,29.78,32707,200,155,138,1682,16,2191,5.812.857.143
05/09/2017 04:00,29.98,33079,182,153,148,1576,18,2077,5.812.857.143
05/09/2017 05:00,30.52,34635,209,150,158,1471,18,2006,5.812.857.143
05/09/2017 06:00,32.27,38223,245,146,164,1371,20,1946,5.812.857.143
05/09/2017 07:00,35.92,41889,255,144,164,1325,20,1908,5.812.857.143
05/09/2017 08:00,38.38,42770,261,143,162,1427,19,2012,5.812.857.143
05/09/2017 09:00,39.94,43045,269,143,159,1370,21,1962,5.812.857.143
05/09/2017 10:00,39.07,43516,308,144,151,1377,20,2000,5.812.857.143
05/09/2017 11:00,39.23,43678,358,144,144,1458,22,2126,5.812.857.143
05/09/2017 12:00,38.48,43272,408,146,136,1430,23,2143,5.812.857.143
05/09/2017 13:00,35.97,43286,493,145,124,1522,21,2305,5.812.857.143
05/09/2017 14:00,36.76,43145,553,143,114,1515,21,2346,5.812.857.143
05/09/2017 15:00,36.2,42846,610,142,107,1478,21,2358,5.812.857.143
05/09/2017 16:00,36.78,42611,648,132,101,1518,24,2423,5.812.857.143
05/09/2017 17:00,36.55,42580,678,123,94,1588,22,2505,5.812.857.143
05/09/2017 18:00,36.25,42251,666,113,84,1621,14,2498,5.812.857.143
05/09/2017 19:00,36.23,42182,667,98,79,1691,9,2544,5.812.857.143
05/09/2017 20:00,34.74,41898,665,89,75,1719,6,2554,5.812.857.143
05/09/2017 21:00,34.36,40866,689,81,64,1764,6,2604,5.812.857.143
05/09/2017 22:00,33.18,38655,773,65,57,1844,5,2744,5.812.857.143
05/09/2017 23:00,31.56,36143,840,64,48,1877,5,2834,5.812.857.143
06/09/2017 00:00,30.22,34114,1228,59,47,1839,5,3178,5.812.857.143
06/09/2017 01:00,29.76,33049,1124,56,48,1744,4,2976,5.812.857.143
06/09/2017 02:00,29.4,32669,1027,53,51,1685,4,2820,5.812.857.143
06/09/2017 03:00,29.61,32657,891,53,52,1627,5,2628,5.812.857.143
06/09/2017 04:00,30.03,33092,765,51,54,1638,6,2514,5.812.857.143
06/09/2017 05:00,30.27,34683,654,49,55,1613,7,2378,5.812.857.143
06/09/2017 06:00,32.28,38323,561,48,42,1635,7,2293,5.812.857.143
06/09/2017 07:00,35.91,42098,495,46,35,1624,5,2205,5.812.857.143
06/09/2017 08:00,38.34,43531,440,46,30,1628,4,2148,5.812.857.143
06/09/2017 09:00,38.66,43023,440,51,27,1679,3,2200,5.812.857.143
06/09/2017 10:00,39,43551,569,51,22,1770,3,2415,5.812.857.143
06/09/2017 11:00,38.09,43667,695,52,19,1758,4,2528,5.812.857.143
06/09/2017 12:00,38.05,43289,788,56,17,1637,3,2501,5.812.857.143
06/09/2017 13:00,35.35,43352,898,61,15,1521,3,2498,5.812.857.143
06/09/2017 14:00,34.93,43088,984,65,15,1432,3,2499,5.812.857.143
06/09/2017 15:00,33.92,42785,1080,64,15,1381,3,2543,5.812.857.143
06/09/2017 16:00,34.16,42826,1230,61,15,1356,3,2665,5.812.857.143
06/09/2017 17:00,33.96,42960,1472,55,15,1394,5,2941,5.812.857.143
06/09/2017 18:00,33.61,42655,1702,51,19,1386,5,3163,5.812.857.143
06/09/2017 19:00,34.47,42509,1874,47,28,1461,7,3417,5.812.857.143
06/09/2017 20:00,32.94,41948,1978,42,33,1522,9,3584,5.812.857.143
06/09/2017 21:00,30.96,40933,2053,40,33,1557,9,3692,5.812.857.143
06/09/2017 22:00,30.44,38901,2172,37,33,1525,8,3775,5.812.857.143
06/09/2017 23:00,29.66,36458,2202,31,40,1490,4,3767,5.812.857.143
07/09/2017 00:00,28.64,34406,2803,26,40,1398,3,4270,5.812.857.143
07/09/2017 01:00,28.3,33472,2749,25,40,1317,3,4134,5.812.857.143
07/09/2017 02:00,27.96,33122,2616,23,40,1219,3,3901,5.812.857.143
07/09/2017 03:00,27.99,33133,2427,21,40,1144,3,3635,5.812.857.143
07/09/2017 04:00,28.23,33569,2385,20,35,1077,3,3520,5.812.857.143
07/09/2017 05:00,28.53,35196,2281,19,35,1010,3,3348,5.812.857.143
07/09/2017 06:00,30.82,38821,2184,18,30,947,3,3182,5.812.857.143
07/09/2017 07:00,33.74,42499,2160,16,25,856,3,3060,5.812.857.143
07/09/2017 08:00,35.17,43250,1999,16,20,774,3,2812,5.812.857.143
07/09/2017 09:00,35.28,43563,1863,16,20,703,3,2605,5.812.857.143
07/09/2017 10:00,35.35,43946,1740,16,15,608,3,2382,5.812.857.143
07/09/2017 11:00,35.79,43944,1584,18,10,518,3,2133,5.812.857.143
07/09/2017 12:00,35.63,43617,1423,21,10,447,3,1904,5.812.857.143
07/09/2017 13:00,34.94,43595,1279,24,10,391,3,1707,5.812.857.143
07/09/2017 14:00,34.95,43379,1126,28,10,365,3,1532,5.812.857.143
07/09/2017 15:00,35.02,43113,969,28,10,351,3,1361,5.812.857.143
07/09/2017 16:00,34.99,42830,826,28,15,364,3,1236,5.812.857.143
07/09/2017 17:00,35.23,43196,683,24,15,387,3,1112,5.812.857.143
07/09/2017 18:00,35.54,43067,572,20,20,411,3,1026,5.812.857.143
07/09/2017 19:00,35.85,42919,523,16,25,449,3,1016,5.812.857.143
07/09/2017 20:00,35.1,42338,510,13,25,524,3,1075,5.812.857.143
07/09/2017 21:00,33.97,41147,520,11,25,586,3,1145,5.812.857.143
07/09/2017 22:00,32.6,39023,553,10,25,623,3,1214,5.812.857.143
07/09/2017 23:00,30.83,36523,586,4,27,563,5,1185,5.812.857.143
08/09/2017 00:00,30.19,34507,691,3,34,605,4,1337,5.812.857.143
08/09/2017 01:00,29.31,33512,728,4,39,656,5,1432,5.812.857.143
08/09/2017 02:00,28.99,33175,777,4,42,690,6,1519,5.812.857.143
08/09/2017 03:00,28.95,33179,863,5,46,732,7,1653,5.812.857.143
08/09/2017 04:00,29.08,33627,992,5,54,798,5,1854,5.812.857.143
08/09/2017 05:00,29.52,35251,1178,5,60,885,3,2131,5.812.857.143
08/09/2017 06:00,30.98,38965,1340,5,60,968,3,2376,5.812.857.143
08/09/2017 07:00,33.59,42629,1558,5,60,1030,4,2657,5.812.857.143
08/09/2017 08:00,34.19,44143,1788,5,60,1075,3,2931,5.812.857.143
08/09/2017 09:00,34.08,43640,2015,7,60,1147,3,3232,5.812.857.143
08/09/2017 10:00,33.43,43873,2335,10,60,1222,3,3630,5.812.857.143
08/09/2017 11:00,32.66,43881,2590,14,62,1305,3,3974,5.812.857.143
08/09/2017 12:00,32.36,43472,2645,18,64,1384,3,4114,5.812.857.143
08/09/2017 13:00,31.64,43167,2508,19,64,1511,4,4106,5.812.857.143
08/09/2017 14:00,31.26,42565,2330,19,67,1666,5,4087,5.812.857.143
08/09/2017 15:00,30.47,41973,2274,16,67,1842,5,4204,5.812.857.143
08/09/2017 16:00,30.96,41895,2178,15,67,1868,5,4133,5.812.857.143
08/09/2017 17:00,31.6,41889,1922,15,72,1898,4,3911,5.812.857.143
08/09/2017 18:00,31.6,41697,1642,17,82,1917,4,3662,5.812.857.143
08/09/2017 19:00,31.85,41393,1492,20,93,1968,5,3578,5.812.857.143
08/09/2017 20:00,31.7,40627,1372,22,111,1917,6,3428,5.812.857.143
08/09/2017 21:00,30.89,39461,1245,25,124,1847,7,3248,5.812.857.143
08/09/2017 22:00,29.94,37804,1152,30,138,1775,8,3103,5.812.857.143
08/09/2017 23:00,29.27,35790,1048,48,146,1737,18,2997,5.812.857.143
09/09/2017 00:00,29.19,33960,979,55,155,1646,18,2853,5.812.857.143
09/09/2017 01:00,28.8,32918,799,63,169,1585,19,2635,5.812.857.143
09/09/2017 02:00,28.41,32438,708,72,181,1515,20,2496,5.812.857.143
09/09/2017 03:00,28.26,32234,646,79,180,1509,22,2436,5.812.857.143
09/09/2017 04:00,28.12,32250,568,90,167,1542,24,2391,5.812.857.143
09/09/2017 05:00,28.25,32522,532,102,155,1565,26,2380,5.812.857.143
09/09/2017 06:00,28.5,33054,527,115,139,1585,30,2396,5.812.857.143
09/09/2017 07:00,29.64,34476,502,127,123,1551,28,2331,5.812.857.143
09/09/2017 08:00,30.26,36776,455,134,107,1544,26,2266,5.812.857.143
09/09/2017 09:00,31.04,38308,410,138,101,1530,26,2205,5.812.857.143
09/09/2017 10:00,31.07,39170,383,141,103,1481,26,2134,5.812.857.143
09/09/2017 11:00,30.81,39247,410,134,113,1469,23,2149,5.812.857.143
09/09/2017 12:00,30.74,38745,466,125,108,1457,23,2179,5.812.857.143
09/09/2017 13:00,30.32,38391,516,113,100,1417,22,2168,5.812.857.143
09/09/2017 14:00,30.04,38082,524,103,93,1463,17,2200,5.812.857.143
09/09/2017 15:00,30.04,37923,539,93,84,1463,13,2192,5.812.857.143
09/09/2017 16:00,30.25,38150,571,90,84,1490,11,2246,5.812.857.143
09/09/2017 17:00,30.58,38674,539,90,87,1523,10,2249,5.812.857.143
09/09/2017 18:00,30.95,38930,503,89,99,1591,8,2290,5.812.857.143
09/09/2017 19:00,30.92,39129,545,86,110,1620,9,2370,5.812.857.143
09/09/2017 20:00,31.13,38931,582,82,122,1662,12,2460,5.812.857.143
09/09/2017 21:00,30.81,37891,552,81,130,1693,15,2471,5.812.857.143
09/09/2017 22:00,30.28,36542,554,60,135,1719,15,2483,5.812.857.143
09/09/2017 23:00,29.87,35043,541,104,156,1530,19,2350,5.812.857.143
10/09/2017 00:00,29.96,33592,409,114,155,1514,21,2213,5.812.857.143
10/09/2017 01:00,28.85,32638,444,116,146,1516,19,2241,5.812.857.143
10/09/2017 02:00,27.65,32135,497,117,139,1527,15,2295,5.812.857.143
10/09/2017 03:00,26.9,31923,543,118,132,1584,11,2388,5.812.857.143
10/09/2017 04:00,26.81,31985,611,120,112,1618,8,2469,5.812.857.143
10/09/2017 05:00,26.8,32045,704,117,81,1597,8,2507,5.812.857.143
10/09/2017 06:00,26.82,32198,777,112,60,1594,7,2550,5.812.857.143
10/09/2017 07:00,27.03,33140,808,101,44,1611,6,2570,5.812.857.143
10/09/2017 08:00,28.81,34796,876,87,33,1596,4,2596,5.812.857.143
10/09/2017 09:00,29.98,36149,1044,73,24,1580,4,2725,5.812.857.143
10/09/2017 10:00,29.97,37202,1289,58,30,1692,3,3072,5.812.857.143
10/09/2017 11:00,29.76,37664,1639,49,33,1780,3,3504,5.812.857.143
10/09/2017 12:00,29.36,37662,1928,41,39,1942,2,3952,5.812.857.143
10/09/2017 13:00,28.46,37600,2182,35,40,2006,2,4265,5.812.857.143
10/09/2017 14:00,28.3,37483,2300,31,28,2065,2,4426,5.812.857.143
10/09/2017 15:00,28.16,37322,2365,29,33,2056,2,4485,5.812.857.143
10/09/2017 16:00,28.33,37624,2438,29,35,2102,2,4606,5.812.857.143
10/09/2017 17:00,29.21,38243,2398,31,36,2154,2,4621,5.812.857.143
10/09/2017 18:00,29.81,38810,2284,35,46,2223,2,4590,5.812.857.143
10/09/2017 19:00,30.37,39312,2196,38,47,2380,2,4663,5.812.857.143
10/09/2017 20:00,30.06,39422,2194,39,54,2499,3,4789,5.812.857.143
10/09/2017 21:00,29.54,38839,2316,41,57,2529,4,4947,5.812.857.143
10/09/2017 22:00,28,37304,2474,60,51,2513,5,5103,5.812.857.143
10/09/2017 23:00,27.35,35345,2609,31,17,2727,4,5388,5.812.857.143
11/09/2017 00:00,26.26,33655,3059,28,17,2630,4,5738,5.938.333.333
11/09/2017 01:00,21.63,32816,3237,25,19,2564,4,5849,5.938.333.333
11/09/2017 02:00,20.87,32536,3026,23,21,2524,4,5598,5.938.333.333
11/09/2017 03:00,21.54,32675,3097,21,27,2502,4,5651,5.938.333.333
11/09/2017 04:00,24.34,33254,3128,20,32,2509,4,5693,5.938.333.333
11/09/2017 05:00,26.28,34955,3494,20,34,2443,5,5996,5.938.333.333
11/09/2017 06:00,29.73,38347,3483,19,33,2415,4,5954,5.938.333.333
11/09/2017 07:00,30.68,41940,3406,17,29,2427,4,5883,5.938.333.333
11/09/2017 08:00,31.2,43313,3232,16,28,2544,6,5826,5.938.333.333
11/09/2017 09:00,31.34,42666,3065,15,32,2624,6,5742,5.938.333.333
11/09/2017 10:00,31.41,43158,2985,15,40,2741,7,5788,5.938.333.333
11/09/2017 11:00,31.12,43337,3051,16,43,2802,8,5920,5.938.333.333
11/09/2017 12:00,30.89,43314,3158,20,44,2796,8,6026,5.938.333.333
11/09/2017 13:00,30.6,43144,3148,22,45,2798,11,6024,5.938.333.333
11/09/2017 14:00,30.51,42972,3206,23,47,2734,11,6021,5.938.333.333
11/09/2017 15:00,30.3,42690,3299,24,49,2662,10,6044,5.938.333.333
11/09/2017 16:00,30.4,42450,3236,27,52,2580,10,5905,5.938.333.333
11/09/2017 17:00,30.79,42567,3156,33,54,2519,13,5775,5.938.333.333
11/09/2017 18:00,30.88,42440,3037,41,58,2496,15,5647,5.938.333.333
11/09/2017 19:00,30.92,42595,2892,48,60,2508,20,5528,5.938.333.333
11/09/2017 20:00,30.73,42224,2760,53,68,2482,35,5398,5.938.333.333
11/09/2017 21:00,29.89,40947,2827,60,71,2453,31,5442,5.938.333.333
11/09/2017 22:00,28.77,38778,2901,53,54,2422,34,5464,5.938.333.333
11/09/2017 23:00,27.67,36165,2906,42,50,2466,3,5467,5.938.333.333
12/09/2017 00:00,26.91,33971,3025,44,50,2446,3,5568,5.938.333.333
12/09/2017 01:00,25.68,33121,2944,48,50,2441,3,5486,5.938.333.333
12/09/2017 02:00,24.49,32811,2851,51,55,2475,3,5435,5.938.333.333
12/09/2017 03:00,24.22,32820,2705,55,55,2521,3,5339,5.938.333.333
12/09/2017 04:00,24.95,33375,2546,58,45,2576,3,5228,5.938.333.333
12/09/2017 05:00,27.07,35058,2427,58,40,2597,4,5126,5.938.333.333
12/09/2017 06:00,30.16,38540,2290,62,35,2655,5,5047,5.938.333.333
12/09/2017 07:00,31.01,42056,2180,65,35,2542,6,4828,5.938.333.333
12/09/2017 08:00,31.7,42302,2230,71,30,2464,7,4802,5.938.333.333
12/09/2017 09:00,31.69,42700,2390,77,30,2454,7,4958,5.938.333.333
12/09/2017 10:00,31.55,43098,2567,80,25,2399,7,5078,5.938.333.333
12/09/2017 11:00,31.3,43229,2817,77,20,2416,6,5336,5.938.333.333
12/09/2017 12:00,31.06,43220,2933,69,20,2376,5,5403,5.938.333.333
12/09/2017 13:00,30.67,43074,2927,53,20,2378,4,5382,5.938.333.333
12/09/2017 14:00,30.46,42826,2908,38,20,2401,4,5371,5.938.333.333
12/09/2017 15:00,30.44,42455,2962,26,20,2411,4,5423,5.938.333.333
12/09/2017 16:00,30.75,42197,2947,21,15,2365,5,5353,5.938.333.333
12/09/2017 17:00,31.04,42164,2875,21,15,2322,4,5237,5.938.333.333
12/09/2017 18:00,31.24,41911,2723,21,20,2332,4,5100,5.938.333.333
12/09/2017 19:00,31.69,41983,2487,20,25,2389,4,4925,5.938.333.333
12/09/2017 20:00,31.09,41719,2265,20,30,2333,4,4652,5.938.333.333
12/09/2017 21:00,30.59,40481,2258,20,30,2343,3,4654,5.938.333.333
12/09/2017 22:00,29.86,38310,2287,25,40,2324,6,4682,5.938.333.333
12/09/2017 23:00,28.47,35780,2200,15,40,2208,6,4469,5.938.333.333
13/09/2017 00:00,28.76,33866,2025,16,50,2126,6,4223,5.938.333.333
13/09/2017 01:00,26.59,32880,1863,17,50,1999,6,3935,5.938.333.333
13/09/2017 02:00,25.6,32563,1758,18,50,1905,5,3736,5.938.333.333
13/09/2017 03:00,25.45,32635,1747,19,55,1851,5,3677,5.938.333.333
13/09/2017 04:00,26.34,33174,1828,20,55,1800,5,3708,5.938.333.333
13/09/2017 05:00,28.45,34918,1978,19,55,1779,6,3837,5.938.333.333
13/09/2017 06:00,30.57,38368,2116,20,55,1756,6,3953,5.938.333.333
13/09/2017 07:00,32.12,41864,2323,19,55,1706,5,4108,5.938.333.333
13/09/2017 08:00,32.59,42438,2543,22,70,1693,7,4335,5.938.333.333
13/09/2017 09:00,32.37,42790,2853,24,100,1687,9,4673,5.938.333.333
13/09/2017 10:00,31.92,43212,3283,25,115,1646,10,5079,5.938.333.333
13/09/2017 11:00,31.76,43416,3592,28,130,1666,9,5425,5.938.333.333
13/09/2017 12:00,31.55,43422,3723,29,145,1711,7,5615,5.938.333.333
13/09/2017 13:00,31.13,43248,3548,27,155,1718,6,5454,5.938.333.333
13/09/2017 14:00,31.08,42885,3224,24,155,1751,6,5160,5.938.333.333
13/09/2017 15:00,30.82,42582,2994,22,135,1800,8,4959,5.938.333.333
13/09/2017 16:00,30.9,42357,2878,22,125,1803,9,4837,5.938.333.333
13/09/2017 17:00,31.04,42402,2645,25,140,1844,7,4661,5.938.333.333
13/09/2017 18:00,30.81,42351,2466,32,160,1850,8,4516,5.938.333.333
13/09/2017 19:00,30.87,42446,2422,39,215,1869,9,4554,5.938.333.333
13/09/2017 20:00,30.61,42169,2417,46,270,1836,10,4579,5.938.333.333
13/09/2017 21:00,30.14,40952,2495,53,290,1793,11,4642,5.938.333.333
13/09/2017 22:00,28.05,38776,2594,81,310,1678,14,4677,5.938.333.333
13/09/2017 23:00,26.5,36280,2529,84,364,1463,37,4477,5.938.333.333
14/09/2017 00:00,26.95,34199,2162,92,372,1479,35,4140,5.938.333.333
14/09/2017 01:00,26.49,33217,2098,96,375,1491,31,4091,5.938.333.333
14/09/2017 02:00,25.91,32910,2010,101,381,1505,29,4026,5.938.333.333
14/09/2017 03:00,26.5,32943,1886,104,386,1512,32,3920,5.938.333.333
14/09/2017 04:00,27.58,33459,1782,108,392,1516,40,3838,5.938.333.333
14/09/2017 05:00,28.16,35193,1695,109,397,1490,51,3742,5.938.333.333
14/09/2017 06:00,30.57,38725,1531,112,401,1413,56,3513,5.938.333.333
14/09/2017 07:00,32,42277,1326,119,408,1301,58,3212,5.938.333.333
14/09/2017 08:00,32.67,43283,1179,130,411,1190,56,2966,5.938.333.333
14/09/2017 09:00,32.75,43687,1111,142,415,1107,56,2831,5.938.333.333
14/09/2017 10:00,32.64,44009,1090,157,415,1034,53,2749,5.938.333.333
14/09/2017 11:00,32.44,44009,1070,165,413,920,50,2618,5.938.333.333
14/09/2017 12:00,32.04,43794,1038,164,408,924,45,2579,5.938.333.333
14/09/2017 13:00,31.68,43631,1105,163,406,950,39,2663,5.938.333.333
14/09/2017 14:00,31.61,43382,1236,163,401,961,25,2786,5.938.333.333
14/09/2017 15:00,31.32,43099,1409,167,390,969,19,2954,5.938.333.333
14/09/2017 16:00,31.41,42778,1563,167,382,964,17,3093,5.938.333.333
14/09/2017 17:00,31.79,42936,1755,166,377,993,17,3308,5.938.333.333
14/09/2017 18:00,32.09,42842,1855,166,374,1036,17,3448,5.938.333.333
14/09/2017 19:00,32.47,42977,1865,167,370,1070,23,3495,5.938.333.333
14/09/2017 20:00,32,42602,1840,166,361,1055,22,3444,5.938.333.333
14/09/2017 21:00,31.53,41276,1968,160,351,1036,19,3534,5.938.333.333
14/09/2017 22:00,30.16,39034,2129,118,335,1046,14,3642,5.938.333.333
14/09/2017 23:00,28.19,36524,2146,104,292,942,20,3504,5.938.333.333
15/09/2017 00:00,28.18,34457,2183,100,292,942,19,3536,5.938.333.333
15/09/2017 01:00,28.02,33494,2231,91,296,963,20,3601,5.938.333.333
15/09/2017 02:00,27.37,33187,2262,76,302,994,20,3654,5.938.333.333
15/09/2017 03:00,27.04,33221,2249,64,311,1035,14,3673,5.938.333.333
15/09/2017 04:00,27.88,33703,2167,52,319,1042,14,3594,5.938.333.333
15/09/2017 05:00,29.04,35514,2047,43,321,1066,16,3493,5.938.333.333
15/09/2017 06:00,31.5,39070,1859,40,324,1060,18,3301,5.938.333.333
15/09/2017 07:00,32.94,42808,1669,37,325,1063,21,3115,5.938.333.333
15/09/2017 08:00,33.34,43252,1628,36,325,994,20,3003,5.938.333.333
15/09/2017 09:00,33.41,43705,1683,37,325,933,21,2999,5.938.333.333
15/09/2017 10:00,33.36,44105,1635,44,325,942,30,2976,5.938.333.333
15/09/2017 11:00,33.09,43982,1531,53,323,944,31,2882,5.938.333.333
15/09/2017 12:00,33.12,43632,1382,61,316,960,31,2750,5.938.333.333
15/09/2017 13:00,32.32,42899,1352,67,304,1012,31,2766,5.938.333.333
15/09/2017 14:00,32.23,42260,1353,69,299,1083,31,2835,5.938.333.333
15/09/2017 15:00,31.66,41627,1306,64,294,1155,29,2848,5.938.333.333
15/09/2017 16:00,31.8,41339,1256,62,294,1215,23,2850,5.938.333.333
15/09/2017 17:00,32.04,41446,1215,63,289,1335,16,2918,5.938.333.333
15/09/2017 18:00,32.78,41373,1092,65,277,1452,10,2896,5.938.333.333
15/09/2017 19:00,32.84,41446,937,66,272,1464,7,2746,5.938.333.333
15/09/2017 20:00,32.4,40930,835,63,261,1650,5,2814,5.938.333.333
15/09/2017 21:00,31.91,39599,823,58,251,1709,6,2847,5.938.333.333
15/09/2017 22:00,30.97,37774,836,47,246,1764,7,2900,5.938.333.333
15/09/2017 23:00,30.22,35715,848,57,210,1827,17,2959,5.938.333.333
16/09/2017 00:00,30.51,33960,699,60,202,1784,16,2761,5.938.333.333
16/09/2017 01:00,30.39,32856,682,60,189,1691,15,2637,5.938.333.333
16/09/2017 02:00,30.02,32395,621,59,182,1624,15,2501,5.938.333.333
16/09/2017 03:00,29.6,32259,548,65,180,1567,14,2374,5.938.333.333
16/09/2017 04:00,29.62,32389,484,75,173,1485,14,2231,5.938.333.333
16/09/2017 05:00,30.19,32833,444,80,168,1406,12,2110,5.938.333.333
16/09/2017 06:00,30.64,33488,416,88,157,1311,12,1984,5.938.333.333
16/09/2017 07:00,31.12,34888,394,95,133,1154,14,1790,5.938.333.333
16/09/2017 08:00,31.68,38033,389,94,121,1079,19,1702,5.938.333.333
16/09/2017 09:00,32.08,39301,384,95,115,1000,22,1616,5.938.333.333
16/09/2017 10:00,32.34,39820,367,100,109,925,19,1520,5.938.333.333
16/09/2017 11:00,31.83,39426,372,103,108,832,20,1435,5.938.333.333
16/09/2017 12:00,32.02,38793,374,110,104,720,18,1326,5.938.333.333
16/09/2017 13:00,31.43,38349,353,108,89,647,13,1210,5.938.333.333
16/09/2017 14:00,31.25,38000,311,100,74,541,9,1035,5.938.333.333
16/09/2017 15:00,31.24,37764,280,87,61,454,6,888,5.938.333.333
16/09/2017 16:00,31.4,38024,259,72,52,403,5,791,5.938.333.333
16/09/2017 17:00,32.13,38635,220,61,51,367,4,703,5.938.333.333
16/09/2017 18:00,32.73,39089,168,53,51,341,4,617,5.938.333.333
16/09/2017 19:00,32.75,39276,121,49,49,312,5,536,5.938.333.333
16/09/2017 20:00,32.75,38870,101,46,50,309,5,511,5.938.333.333
16/09/2017 21:00,32.1,37988,92,42,50,301,4,489,5.938.333.333
16/09/2017 22:00,31.39,36612,84,40,48,299,4,475,5.938.333.333
16/09/2017 23:00,31.05,35056,76,30,26,218,4,354,5.938.333.333
17/09/2017 00:00,31.26,33622,127,23,23,223,4,400,5.938.333.333
17/09/2017 01:00,30.19,32636,107,19,23,230,4,383,5.938.333.333
17/09/2017 02:00,30,32228,98,16,22,251,3,390,5.938.333.333
17/09/2017 03:00,29.66,32058,90,13,22,261,4,390,5.938.333.333
17/09/2017 04:00,29.61,32143,91,10,24,263,4,392,5.938.333.333
17/09/2017 05:00,29.66,32311,107,7,26,300,4,444,5.938.333.333
17/09/2017 06:00,30.02,32658,118,5,25,316,5,469,5.938.333.333
17/09/2017 07:00,30.03,33598,134,3,22,289,5,453,5.938.333.333
17/09/2017 08:00,31.35,27876,146,2,20,247,4,419,5.938.333.333
17/09/2017 09:00,31.73,31318,143,2,21,213,4,383,5.938.333.333
17/09/2017 10:00,31.75,34083,162,1,23,192,4,382,5.938.333.333
17/09/2017 11:00,31.91,36187,163,1,26,182,4,376,5.938.333.333
17/09/2017 12:00,31.75,37836,155,2,28,210,4,399,5.938.333.333
17/09/2017 13:00,31.53,37626,165,3,31,227,5,431,5.938.333.333
17/09/2017 14:00,31.09,37479,160,5,31,237,6,439,5.938.333.333
17/09/2017 15:00,31.18,37473,150,8,31,258,8,455,5.938.333.333
17/09/2017 16:00,31.51,37732,137,11,34,294,8,484,5.938.333.333
17/09/2017 17:00,31.79,38381,142,15,42,340,9,548,5.938.333.333
17/09/2017 18:00,32.92,39137,158,22,53,398,8,639,5.938.333.333
17/09/2017 19:00,33.27,39882,165,29,67,458,9,728,5.938.333.333
17/09/2017 20:00,33.25,39774,167,34,85,488,9,783,5.938.333.333
17/09/2017 21:00,32.7,38973,166,38,102,531,10,847,5.938.333.333
17/09/2017 22:00,31.85,37413,167,50,112,562,13,904,5.938.333.333
17/09/2017 23:00,31.52,35484,158,53,140,534,15,900,5.938.333.333
18/09/2017 00:00,31.19,33914,58,58,157,566,17,856,5.917.797.619
18/09/2017 01:00,31.01,33135,49,69,170,577,25,890,5.917.797.619
18/09/2017 02:00,30.38,32955,40,80,190,601,34,945,5.917.797.619
18/09/2017 03:00,29.94,33147,37,96,202,628,44,1007,5.917.797.619
18/09/2017 04:00,30.41,33757,42,114,206,650,52,1064,5.917.797.619
18/09/2017 05:00,31.45,35662,52,128,200,692,58,1130,5.917.797.619
18/09/2017 06:00,33,39349,55,140,203,674,61,1133,5.917.797.619
18/09/2017 07:00,35.62,42986,65,153,208,650,62,1138,5.917.797.619
18/09/2017 08:00,38.3,44597,69,165,204,640,64,1142,5.917.797.619
18/09/2017 09:00,36.24,44788,56,175,201,619,65,1116,5.917.797.619
18/09/2017 10:00,36.21,45252,48,185,213,593,65,1104,5.917.797.619
18/09/2017 11:00,35.18,44657,53,195,234,625,64,1171,5.917.797.619
18/09/2017 12:00,35.78,44278,58,204,278,675,63,1278,5.917.797.619
18/09/2017 13:00,35.01,44041,65,210,333,731,62,1401,5.917.797.619
18/09/2017 14:00,34.89,43701,66,212,368,771,62,1479,5.917.797.619
18/09/2017 15:00,35.01,43352,63,213,386,837,62,1561,5.917.797.619
18/09/2017 16:00,34.74,43107,59,211,390,931,63,1654,5.917.797.619
18/09/2017 17:00,34.98,43368,54,208,389,1035,64,1750,5.917.797.619
18/09/2017 18:00,35.55,43383,50,206,371,1192,63,1882,5.917.797.619
18/09/2017 19:00,35.43,43648,55,203,342,1314,61,1975,5.917.797.619
18/09/2017 20:00,34.66,43110,52,197,312,1414,57,2032,5.917.797.619
18/09/2017 21:00,33.2,41722,52,186,294,1529,50,2111,5.917.797.619
18/09/2017 22:00,32.01,39439,64,148,273,1479,43,2007,5.917.797.619
18/09/2017 23:00,31.57,36948,107,113,185,1646,15,2066,5.917.797.619
19/09/2017 00:00,30.62,34946,383,102,164,1708,13,2370,5.917.797.619
19/09/2017 01:00,29.7,34031,471,94,152,1681,10,2408,5.917.797.619
19/09/2017 02:00,29.43,33669,588,84,145,1636,11,2464,5.917.797.619
19/09/2017 03:00,29.42,33707,724,75,132,1651,11,2593,5.917.797.619
19/09/2017 04:00,29.68,34273,844,64,120,1647,12,2687,5.917.797.619
19/09/2017 05:00,31.19,36139,934,55,113,1714,11,2827,5.917.797.619
19/09/2017 06:00,32.65,40003,1013,44,109,1713,13,2892,5.917.797.619
19/09/2017 07:00,34.63,43590,1034,32,109,1645,13,2833,5.917.797.619
19/09/2017 08:00,35.73,44688,1040,23,109,1676,13,2861,5.917.797.619
19/09/2017 09:00,35.52,44923,1129,16,116,1562,13,2836,5.917.797.619
19/09/2017 10:00,35.37,44925,1356,12,123,1533,18,3042,5.917.797.619
19/09/2017 11:00,34.96,44757,1538,10,126,1523,24,3221,5.917.797.619
19/09/2017 12:00,34.59,44475,1540,11,130,1416,23,3120,5.917.797.619
19/09/2017 13:00,33.83,44257,1568,10,130,1343,22,3073,5.917.797.619
19/09/2017 14:00,33.74,43989,1584,10,127,1278,17,3016,5.917.797.619
19/09/2017 15:00,33.71,43724,1573,10,114,1238,13,2948,5.917.797.619
19/09/2017 16:00,34.05,43601,1450,13,92,1202,12,2769,5.917.797.619
19/09/2017 17:00,34.43,43740,1280,16,79,1180,13,2568,5.917.797.619
19/09/2017 18:00,35.02,43746,1122,23,68,1182,14,2409,5.917.797.619
19/09/2017 19:00,35.8,44045,1010,25,64,1286,12,2397,5.917.797.619
19/09/2017 20:00,35.17,43516,914,29,62,1309,11,2325,5.917.797.619
19/09/2017 21:00,33.65,42074,866,27,61,1266,9,2229,5.917.797.619
19/09/2017 22:00,32.28,39877,851,15,60,1272,10,2208,5.917.797.619
19/09/2017 23:00,31.55,37313,855,7,78,1272,11,2223,5.917.797.619
20/09/2017 00:00,29.4,35226,1037,7,74,1332,11,2461,5.917.797.619
20/09/2017 01:00,29.09,34204,1029,7,70,1330,12,2448,5.917.797.619
20/09/2017 02:00,28.46,33888,1018,6,65,1380,13,2482,5.917.797.619
20/09/2017 03:00,28.4,33977,990,6,62,1435,12,2505,5.917.797.619
20/09/2017 04:00,28.92,34584,975,7,60,1468,12,2522,5.917.797.619
20/09/2017 05:00,29.96,36596,937,10,55,1488,11,2501,5.917.797.619
20/09/2017 06:00,33.3,40274,850,10,46,1465,10,2381,5.917.797.619
20/09/2017 07:00,35.98,43897,771,13,30,1471,9,2294,5.917.797.619
20/09/2017 08:00,36.3,45171,748,15,21,1415,9,2208,5.917.797.619
20/09/2017 09:00,36.17,45302,710,16,19,1344,10,2099,5.917.797.619
20/09/2017 10:00,36.23,45465,683,19,16,1294,13,2025,5.917.797.619
20/09/2017 11:00,35.37,45290,665,18,15,1267,15,1980,5.917.797.619
20/09/2017 12:00,35.82,44910,638,15,15,1199,13,1880,5.917.797.619
20/09/2017 13:00,34.96,44701,605,14,14,1203,12,1848,5.917.797.619
20/09/2017 14:00,34.34,44449,569,14,11,1114,8,1716,5.917.797.619
20/09/2017 15:00,34.45,44121,550,14,10,1109,6,1689,5.917.797.619
20/09/2017 16:00,35.11,43916,557,16,10,1071,5,1659,5.917.797.619
20/09/2017 17:00,35.87,44006,540,17,12,1007,5,1581,5.917.797.619
20/09/2017 18:00,37.31,44114,455,22,19,986,5,1487,5.917.797.619
20/09/2017 19:00,37.17,44468,363,24,22,976,5,1390,5.917.797.619
20/09/2017 20:00,35.67,43978,299,28,23,982,5,1337,5.917.797.619
20/09/2017 21:00,33.58,42620,255,30,25,958,4,1272,5.917.797.619
20/09/2017 22:00,32.12,40401,237,30,26,936,4,1233,5.917.797.619
20/09/2017 23:00,31.55,37860,242,24,32,914,6,1218,5.917.797.619
21/09/2017 00:00,30.73,35664,178,26,37,847,7,1095,5.917.797.619
21/09/2017 01:00,29.71,34723,180,29,39,805,7,1060,5.917.797.619
21/09/2017 02:00,29.23,34441,183,30,41,781,6,1041,5.917.797.619
21/09/2017 03:00,29,34458,177,31,45,771,6,1030,5.917.797.619
21/09/2017 04:00,29.51,34977,167,32,49,759,7,1014,5.917.797.619
21/09/2017 05:00,30.88,36888,160,33,53,787,9,1042,5.917.797.619
21/09/2017 06:00,33.77,40485,167,33,53,805,8,1066,5.917.797.619
21/09/2017 07:00,37.03,44100,190,32,43,753,8,1026,5.917.797.619
21/09/2017 08:00,38.01,45333,208,33,41,643,10,935,5.917.797.619
21/09/2017 09:00,37.17,45420,240,37,46,592,11,926,5.917.797.619
21/09/2017 10:00,37.19,45485,279,44,51,544,14,932,5.917.797.619
21/09/2017 11:00,36.34,45277,296,53,55,578,21,1003,5.917.797.619
21/09/2017 12:00,35.36,44849,292,69,62,588,26,1037,5.917.797.619
21/09/2017 13:00,34.5,44586,278,83,69,638,31,1099,5.917.797.619
21/09/2017 14:00,33.86,44296,248,96,80,645,26,1095,5.917.797.619
21/09/2017 15:00,33.79,43954,236,106,82,717,28,1169,5.917.797.619
21/09/2017 16:00,33.89,43728,250,115,79,750,31,1225,5.917.797.619
21/09/2017 17:00,35.17,43880,283,120,79,827,34,1343,5.917.797.619
21/09/2017 18:00,35.05,44015,313,123,80,974,34,1524,5.917.797.619
21/09/2017 19:00,35.46,44331,349,126,81,1082,30,1668,5.917.797.619
21/09/2017 20:00,33.78,43703,387,127,81,1174,25,1794,5.917.797.619
21/09/2017 21:00,32.03,42270,421,127,81,1260,21,1910,5.917.797.619
21/09/2017 22:00,30.86,40091,455,113,83,1281,15,1947,5.917.797.619
21/09/2017 23:00,30.51,37619,470,121,96,1306,15,2008,5.917.797.619
22/09/2017 00:00,30.07,35569,345,124,92,1266,15,1842,5.917.797.619
22/09/2017 01:00,29.45,34519,350,122,90,1273,16,1851,5.917.797.619
22/09/2017 02:00,28.98,34106,357,118,89,1268,14,1846,5.917.797.619
22/09/2017 03:00,29,34173,345,110,88,1279,13,1835,5.917.797.619
22/09/2017 04:00,29.58,34696,336,100,84,1287,12,1819,5.917.797.619
22/09/2017 05:00,30.77,36695,337,90,82,1335,13,1857,5.917.797.619
22/09/2017 06:00,32.21,40566,334,85,79,1367,13,1878,5.917.797.619
22/09/2017 07:00,34.18,44111,313,77,76,1344,13,1823,5.917.797.619
22/09/2017 08:00,35.17,45338,290,68,70,1355,18,1801,5.917.797.619
22/09/2017 09:00,35.1,45288,265,63,66,1299,16,1709,5.917.797.619
22/09/2017 10:00,34.63,45337,275,58,59,1271,16,1679,5.917.797.619
22/09/2017 11:00,34.26,44912,303,57,53,1182,17,1612,5.917.797.619
22/09/2017 12:00,34.11,44255,283,60,48,1144,19,1554,5.917.797.619
22/09/2017 13:00,33.23,43606,237,63,45,1110,19,1474,5.917.797.619
22/09/2017 14:00,32.11,43010,190,63,44,1081,19,1397,5.917.797.619
22/09/2017 15:00,31.91,42444,163,66,42,990,15,1276,5.917.797.619
22/09/2017 16:00,31.98,42240,153,70,41,974,13,1251,5.917.797.619
22/09/2017 17:00,32.39,42446,157,74,42,958,9,1240,5.917.797.619
22/09/2017 18:00,33.2,42525,161,75,43,987,7,1273,5.917.797.619
22/09/2017 19:00,33.05,42604,167,75,43,968,7,1260,5.917.797.619
22/09/2017 20:00,31.98,41648,175,69,44,852,7,1147,5.917.797.619
22/09/2017 21:00,31.4,40220,171,64,44,829,8,1116,5.917.797.619
22/09/2017 22:00,30.81,38385,168,57,44,791,7,1067,5.917.797.619
22/09/2017 23:00,30.65,36323,157,52,65,717,6,997,5.917.797.619
23/09/2017 00:00,30.63,34308,80,50,70,661,6,867,5.917.797.619
23/09/2017 01:00,30.45,33247,61,51,75,575,6,768,5.917.797.619
23/09/2017 02:00,30.07,32736,54,52,95,513,6,720,5.917.797.619
23/09/2017 03:00,30.01,32525,52,53,105,483,6,699,5.917.797.619
23/09/2017 04:00,30,32672,55,52,115,457,6,685,5.917.797.619
23/09/2017 05:00,30.11,33200,59,47,120,450,6,682,5.917.797.619
23/09/2017 06:00,30.63,33890,64,40,125,443,6,678,5.917.797.619
23/09/2017 07:00,30.89,35180,70,34,125,412,6,647,5.917.797.619
23/09/2017 08:00,31.4,37065,74,31,130,397,6,638,5.917.797.619
23/09/2017 09:00,31.26,38504,75,32,125,372,8,612,5.917.797.619
23/09/2017 10:00,31.39,39242,86,33,120,324,10,573,5.917.797.619
23/09/2017 11:00,31.35,39184,96,37,120,335,11,599,5.917.797.619
23/09/2017 12:00,30.71,38818,88,44,120,299,12,563,5.917.797.619
23/09/2017 13:00,30.75,38424,97,47,120,339,11,614,5.917.797.619
23/09/2017 14:00,30.72,38064,102,52,125,373,11,663,5.917.797.619
23/09/2017 15:00,30.68,37924,108,56,130,427,11,732,5.917.797.619
23/09/2017 16:00,30.81,38214,113,62,140,483,12,810,5.917.797.619
23/09/2017 17:00,31.08,38963,127,70,160,559,9,925,5.917.797.619
23/09/2017 18:00,31.52,39583,130,74,170,670,8,1052,5.917.797.619
23/09/2017 19:00,31.81,39920,139,76,170,737,9,1131,5.917.797.619
23/09/2017 20:00,31.29,39166,161,74,190,770,8,1203,5.917.797.619
23/09/2017 21:00,30.75,38044,199,71,160,801,8,1239,5.917.797.619
23/09/2017 22:00,30.66,36627,234,62,150,819,8,1273,5.917.797.619
23/09/2017 23:00,30.42,35114,249,59,140,841,7,1296,5.917.797.619
24/09/2017 00:00,30.49,33559,233,59,135,828,9,1264,5.917.797.619
24/09/2017 01:00,30.03,32590,236,58,130,822,9,1255,5.917.797.619
24/09/2017 02:00,29.99,32174,244,57,125,842,8,1276,5.917.797.619
24/09/2017 03:00,29.78,31955,244,56,125,866,8,1299,5.917.797.619
24/09/2017 04:00,29.8,32010,244,53,125,899,9,1330,5.917.797.619
24/09/2017 05:00,30,32265,260,46,130,930,8,1374,5.917.797.619
24/09/2017 06:00,30.02,32558,278,38,135,909,8,1368,5.917.797.619
24/09/2017 07:00,30.16,33391,289,31,120,888,7,1335,5.917.797.619
24/09/2017 08:00,30.81,35161,290,27,120,812,6,1255,5.917.797.619
24/09/2017 09:00,31.13,36728,299,25,110,759,7,1200,5.917.797.619
24/09/2017 10:00,31.09,37682,323,28,110,727,10,1198,5.917.797.619
24/09/2017 11:00,31.27,37883,378,30,120,725,9,1262,5.917.797.619
24/09/2017 12:00,31.01,37730,429,30,135,729,8,1331,5.917.797.619
24/09/2017 13:00,30.61,37432,451,31,145,724,7,1358,5.917.797.619
24/09/2017 14:00,30.46,37344,504,33,145,712,7,1401,5.917.797.619
24/09/2017 15:00,30.32,37322,573,38,145,679,9,1444,5.917.797.619
24/09/2017 16:00,30.54,37648,604,46,160,747,9,1566,5.917.797.619
24/09/2017 17:00,31.11,38435,611,58,180,850,8,1707,5.917.797.619
24/09/2017 18:00,31.52,39367,593,65,180,1007,10,1855,5.917.797.619
24/09/2017 19:00,32.32,40194,623,68,190,1156,12,2049,5.917.797.619
24/09/2017 20:00,31.65,39730,708,66,210,1213,12,2209,5.917.797.619
24/09/2017 21:00,30.97,38754,812,63,210,1259,11,2355,5.917.797.619
24/09/2017 22:00,30.57,37157,885,56,210,1250,12,2413,5.917.797.619
24/09/2017 23:00,29.68,35132,944,59,210,1160,9,2382,5.917.797.619
25/09/2017 00:00,29.39,33624,1056,59,205,1112,9,2441,5.885.833.333
25/09/2017 01:00,28.98,32822,1039,58,200,1135,11,2443,5.885.833.333
25/09/2017 02:00,28.82,32574,1053,56,195,1161,12,2477,5.885.833.333
25/09/2017 03:00,29.04,32693,1041,54,195,1203,11,2504,5.885.833.333
25/09/2017 04:00,29.3,33337,1025,52,195,1284,11,2567,5.885.833.333
25/09/2017 05:00,30.5,35424,1122,47,190,1361,11,2731,5.885.833.333
25/09/2017 06:00,31.27,39194,1301,39,160,1425,12,2937,5.885.833.333
25/09/2017 07:00,32.77,42738,1515,31,165,1460,11,3182,5.885.833.333
25/09/2017 08:00,33.17,44444,1651,27,165,1493,10,3346,5.885.833.333
25/09/2017 09:00,33.01,44671,1735,26,165,1528,10,3464,5.885.833.333
25/09/2017 10:00,32.83,44625,1916,29,175,1562,12,3694,5.885.833.333
25/09/2017 11:00,32.51,44388,2084,32,180,1560,13,3869,5.885.833.333
25/09/2017 12:00,32.3,43912,2209,31,190,1550,14,3994,5.885.833.333
25/09/2017 13:00,31.75,43613,2213,31,190,1537,13,3984,5.885.833.333
25/09/2017 14:00,31.39,43231,2300,32,190,1505,12,4039,5.885.833.333
25/09/2017 15:00,31.47,42922,2369,35,185,1485,12,4086,5.885.833.333
25/09/2017 16:00,31.8,42657,2309,43,170,1481,11,4014,5.885.833.333
25/09/2017 17:00,31.9,43020,2184,54,155,1536,12,3941,5.885.833.333
25/09/2017 18:00,32.45,43393,1981,63,145,1668,12,3869,5.885.833.333
25/09/2017 19:00,32.83,43905,1837,67,140,1674,14,3732,5.885.833.333
25/09/2017 20:00,31.86,43045,1857,65,130,1644,15,3711,5.885.833.333
25/09/2017 21:00,30.94,41509,1902,61,125,1618,14,3720,5.885.833.333
25/09/2017 22:00,30.5,39240,1914,55,125,1551,12,3657,5.885.833.333
25/09/2017 23:00,29.51,36502,1870,54,211,1498,13,3646,5.885.833.333
26/09/2017 00:00,29.74,34859,1615,48,201,1434,12,3310,5.885.833.333
26/09/2017 01:00,29.11,33874,1602,45,189,1392,10,3238,5.885.833.333
26/09/2017 02:00,29.05,33498,1597,40,177,1371,9,3194,5.885.833.333
26/09/2017 03:00,29.13,33595,1593,38,170,1390,9,3200,5.885.833.333
26/09/2017 04:00,29.74,34211,1536,36,164,1411,9,3156,5.885.833.333
26/09/2017 05:00,30.67,36271,1489,35,157,1471,9,3161,5.885.833.333
26/09/2017 06:00,31.94,40087,1502,31,149,1472,9,3163,5.885.833.333
26/09/2017 07:00,33.46,43696,1497,22,140,1408,7,3074,5.885.833.333
26/09/2017 08:00,34.08,44352,1515,17,134,1342,7,3015,5.885.833.333
26/09/2017 09:00,33.93,44329,1555,18,115,1351,8,3047,5.885.833.333
26/09/2017 10:00,33.68,44425,1637,18,101,1256,9,3021,5.885.833.333
26/09/2017 11:00,33.18,44112,1697,20,93,1213,10,3033,5.885.833.333
26/09/2017 12:00,32.96,43613,1744,21,92,1190,10,3057,5.885.833.333
26/09/2017 13:00,32.2,43324,1760,21,92,1170,8,3051,5.885.833.333
26/09/2017 14:00,31.92,42906,1782,22,96,1148,8,3056,5.885.833.333
26/09/2017 15:00,31.98,42597,1778,23,101,1170,8,3080,5.885.833.333
26/09/2017 16:00,32.59,42502,1794,28,107,1187,7,3123,5.885.833.333
26/09/2017 17:00,32.99,42746,1739,34,114,1296,8,3191,5.885.833.333
26/09/2017 18:00,33.35,43037,1567,40,131,1392,8,3138,5.885.833.333
26/09/2017 19:00,33.32,43479,1475,43,152,1449,9,3128,5.885.833.333
26/09/2017 20:00,32.07,42756,1501,42,165,1485,9,3202,5.885.833.333
26/09/2017 21:00,30.9,41380,1538,41,168,1492,9,3248,5.885.833.333
26/09/2017 22:00,30.6,39130,1542,37,169,1406,8,3162,5.885.833.333
26/09/2017 23:00,29.8,36606,1503,41,140,1327,9,3020,5.885.833.333
27/09/2017 00:00,30.43,34833,1360,38,126,1326,8,2858,5.885.833.333
27/09/2017 01:00,30.06,33785,1299,36,122,1280,7,2744,5.885.833.333
27/09/2017 02:00,30.01,33476,1270,36,121,1236,8,2671,5.885.833.333
27/09/2017 03:00,30.08,33554,1238,34,121,1231,8,2632,5.885.833.333
27/09/2017 04:00,30.47,34136,1237,30,121,1248,9,2645,5.885.833.333
27/09/2017 05:00,31.13,36188,1302,26,121,1257,10,2716,5.885.833.333
27/09/2017 06:00,33.41,39733,1408,22,121,1252,10,2813,5.885.833.333
27/09/2017 07:00,35.39,43152,1469,17,113,1270,9,2878,5.885.833.333
27/09/2017 08:00,36.72,44089,1450,15,111,1275,8,2859,5.885.833.333
27/09/2017 09:00,35.13,44052,1489,13,104,1284,9,2899,5.885.833.333
27/09/2017 10:00,34.57,44086,1645,13,104,1321,10,3093,5.885.833.333
27/09/2017 11:00,33.74,43745,1845,14,111,1383,12,3365,5.885.833.333
27/09/2017 12:00,32.61,43207,2062,14,125,1433,14,3648,5.885.833.333
27/09/2017 13:00,31.58,42979,2143,15,130,1440,12,3740,5.885.833.333
27/09/2017 14:00,31.46,42677,2220,17,130,1450,11,3828,5.885.833.333
27/09/2017 15:00,31.95,42364,2396,18,120,1463,10,4007,5.885.833.333
27/09/2017 16:00,32.8,42161,2543,23,120,1487,8,4181,5.885.833.333
27/09/2017 17:00,33.25,42478,2509,26,124,1607,7,4273,5.885.833.333
27/09/2017 18:00,32.95,42927,2388,29,134,1758,8,4317,5.885.833.333
27/09/2017 19:00,33.38,43465,2380,30,140,1846,9,4405,5.885.833.333
27/09/2017 20:00,31.96,42665,2475,28,140,1882,10,4535,5.885.833.333
27/09/2017 21:00,31.05,41211,2516,26,134,1859,10,4545,5.885.833.333
27/09/2017 22:00,30.54,39089,2489,26,123,1816,8,4462,5.885.833.333
27/09/2017 23:00,29.38,36648,2506,27,133,1765,7,4438,5.885.833.333
28/09/2017 00:00,29.25,34817,2144,24,117,1690,8,3983,5.885.833.333
28/09/2017 01:00,29.05,33825,2098,22,104,1636,8,3868,5.885.833.333
28/09/2017 02:00,28.94,33537,2088,20,93,1627,8,3836,5.885.833.333
28/09/2017 03:00,29.03,33593,2090,19,84,1641,8,3842,5.885.833.333
28/09/2017 04:00,29.5,34145,2065,17,79,1659,8,3828,5.885.833.333
28/09/2017 05:00,30.38,36159,2099,17,78,1713,8,3915,5.885.833.333
28/09/2017 06:00,32.13,39738,2194,17,73,1757,7,4048,5.885.833.333
28/09/2017 07:00,33.24,43200,2268,17,55,1771,7,4118,5.885.833.333
28/09/2017 08:00,33.37,44206,2255,16,38,1837,7,4153,5.885.833.333
28/09/2017 09:00,32.69,44194,2298,16,31,1876,7,4228,5.885.833.333
28/09/2017 10:00,32.25,44169,2463,14,33,1926,8,4444,5.885.833.333
28/09/2017 11:00,32.04,43862,2559,14,40,1971,10,4594,5.885.833.333
28/09/2017 12:00,31.74,43356,2606,14,44,1951,10,4625,5.885.833.333
28/09/2017 13:00,31.35,43115,2513,14,48,1869,9,4453,5.885.833.333
28/09/2017 14:00,31.14,42802,2583,13,52,1802,9,4459,5.885.833.333
28/09/2017 15:00,31.47,42579,2660,12,55,1744,9,4480,5.885.833.333
28/09/2017 16:00,31.93,42449,2579,14,58,1674,10,4335,5.885.833.333
28/09/2017 17:00,32.12,42822,2328,15,65,1742,11,4161,5.885.833.333
28/09/2017 18:00,33.05,43201,2078,16,76,1862,12,4044,5.885.833.333
28/09/2017 19:00,33.44,43647,1917,16,83,1937,11,3964,5.885.833.333
28/09/2017 20:00,31.77,42847,1865,15,99,1880,10,3869,5.885.833.333
28/09/2017 21:00,30.88,41296,1823,13,95,1804,10,3745,5.885.833.333
28/09/2017 22:00,30.56,39016,1740,15,93,1736,9,3593,5.885.833.333
28/09/2017 23:00,29.81,36458,1636,18,100,1698,9,3461,5.885.833.333
29/09/2017 00:00,29.92,34787,1527,15,94,1626,9,3271,5.885.833.333
29/09/2017 01:00,29.78,33723,1476,12,89,1582,10,3169,5.885.833.333
29/09/2017 02:00,29.67,33404,1465,11,84,1542,9,3111,5.885.833.333
29/09/2017 03:00,29.73,33430,1503,11,82,1533,9,3138,5.885.833.333
29/09/2017 04:00,29.9,34008,1544,11,81,1549,10,3195,5.885.833.333
29/09/2017 05:00,30.1,36140,1584,12,81,1534,10,3221,5.885.833.333
29/09/2017 06:00,31.77,39809,1632,11,81,1542,9,3275,5.885.833.333
29/09/2017 07:00,32.43,43337,1673,9,71,1574,8,3335,5.885.833.333
29/09/2017 08:00,32.84,44517,1678,7,60,1586,7,3338,5.885.833.333
29/09/2017 09:00,32.69,44547,1692,5,56,1617,7,3377,5.885.833.333
29/09/2017 10:00,32.37,44566,1821,4,55,1662,7,3549,5.885.833.333
29/09/2017 11:00,32.06,44184,1918,4,61,1684,7,3674,5.885.833.333
29/09/2017 12:00,31.62,43543,2048,4,65,1700,7,3824,5.885.833.333
29/09/2017 13:00,30.91,42905,2110,4,63,1698,7,3882,5.885.833.333
29/09/2017 14:00,30.4,42276,2234,5,61,1661,7,3968,5.885.833.333
29/09/2017 15:00,30.31,41762,2325,6,58,1671,6,4066,5.885.833.333
29/09/2017 16:00,30.37,41591,2326,8,56,1696,6,4092,5.885.833.333
29/09/2017 17:00,30.62,41956,2253,9,58,1757,6,4083,5.885.833.333
29/09/2017 18:00,30.97,42352,2201,10,69,1815,6,4101,5.885.833.333
29/09/2017 19:00,30.97,42513,2324,12,81,1894,7,4318,5.885.833.333
29/09/2017 20:00,30.03,41258,2584,14,91,1896,6,4591,5.885.833.333
29/09/2017 21:00,29.44,39737,2785,13,92,1899,6,4795,5.885.833.333
29/09/2017 22:00,28.49,37951,2885,12,92,1889,6,4884,5.885.833.333
29/09/2017 23:00,27.96,35840,3025,9,88,1884,6,5012,5.885.833.333
30/09/2017 00:00,26.33,34301,3281,8,77,1854,5,5225,5.885.833.333
30/09/2017 01:00,25.29,33313,3270,7,73,1854,6,5210,5.885.833.333
30/09/2017 02:00,25.08,32794,3203,7,73,1864,6,5153,5.885.833.333
30/09/2017 03:00,25.31,32609,3200,7,78,1853,6,5144,5.885.833.333
30/09/2017 04:00,26.01,32792,3170,6,84,1875,6,5141,5.885.833.333
30/09/2017 05:00,27.03,33393,3025,6,90,1932,6,5059,5.885.833.333
30/09/2017 06:00,27.44,34190,2883,7,93,1993,6,4982,5.885.833.333
30/09/2017 07:00,27.97,35509,2780,6,70,2031,6,4893,5.885.833.333
30/09/2017 08:00,28.34,37398,2706,5,47,2094,6,4858,5.885.833.333
30/09/2017 09:00,29.01,39074,2552,5,49,2175,6,4787,5.885.833.333
30/09/2017 10:00,29.29,39847,2476,5,49,2245,6,4781,5.885.833.333
30/09/2017 11:00,29.16,39759,2355,5,50,2279,6,4695,5.885.833.333
30/09/2017 12:00,28.82,39433,2229,4,58,2295,7,4593,5.885.833.333
30/09/2017 13:00,28.62,39062,2036,4,65,2275,7,4387,5.885.833.333
30/09/2017 14:00,28.54,38763,1952,4,68,2223,7,4254,5.885.833.333
30/09/2017 15:00,28.61,38668,1890,4,66,2206,8,4174,5.885.833.333
30/09/2017 16:00,29.09,38989,1768,5,64,2176,7,4020,5.885.833.333
30/09/2017 17:00,29.6,39998,1602,7,67,2179,7,3862,5.885.833.333
30/09/2017 18:00,30.04,40792,1491,11,83,2218,7,3810,5.885.833.333
30/09/2017 19:00,30.46,40972,1469,12,98,2250,8,3837,5.885.833.333
30/09/2017 20:00,29.52,39982,1499,14,110,2225,8,3856,5.885.833.333
30/09/2017 21:00,28.62,38833,1497,17,112,2205,8,3839,5.885.833.333
30/09/2017 22:00,28.26,37489,1470,24,114,2170,9,3787,5.885.833.333
30/09/2017 23:00,27.85,35909,1489,21,137,2249,9,3905,5.885.833.333
01/10/2017 00:00,26.03,34501,1487,20,138,2205,9,3859,5.885.833.333
01/10/2017 01:00,25.53,33513,1868,21,138,2190,9,4226,5.885.833.333
01/10/2017 02:00,24.41,32996,1756,21,134,2206,9,4126,5.885.833.333
01/10/2017 03:00,24.35,32790,1561,20,133,2244,9,3967,5.885.833.333
01/10/2017 04:00,24.36,32851,1313,21,139,2262,9,3744,5.885.833.333
01/10/2017 05:00,25.12,33173,1085,23,143,2285,9,3545,5.885.833.333
01/10/2017 06:00,25.81,33618,929,24,147,2328,9,3437,5.885.833.333
01/10/2017 07:00,27.2,34480,825,24,119,2339,9,3316,5.885.833.333
01/10/2017 08:00,27.91,36183,735,23,110,2331,9,3208,5.885.833.333
01/10/2017 09:00,28.39,37857,721,22,100,2273,9,3125,5.885.833.333
01/10/2017 10:00,28.45,38826,741,21,97,2232,9,3100,5.885.833.333
01/10/2017 11:00,28.46,39069,798,21,95,2167,9,3090,5.885.833.333
01/10/2017 12:00,28.44,38877,843,20,100,2111,9,3083,5.885.833.333
01/10/2017 13:00,28.16,38733,857,20,100,2091,9,3077,5.885.833.333
01/10/2017 14:00,27.19,38607,901,19,99,1979,9,3007,5.885.833.333
01/10/2017 15:00,27.23,38558,1008,20,99,1896,9,3032,5.885.833.333
01/10/2017 16:00,27.74,38849,1135,22,99,1889,9,3154,5.885.833.333
01/10/2017 17:00,28.45,39709,1232,26,111,1978,9,3356,5.885.833.333
01/10/2017 18:00,28.95,40876,1315,32,127,2129,9,3612,5.885.833.333
01/10/2017 19:00,29.21,41430,1474,36,142,2274,9,3935,5.885.833.333
01/10/2017 20:00,28.45,40729,1807,39,153,2406,9,4414,5.885.833.333
01/10/2017 21:00,27.82,39613,2111,43,162,2508,9,4833,5.885.833.333
01/10/2017 22:00,27.02,38075,2306,57,165,2598,18,5144,5.885.833.333
01/10/2017 23:00,24.06,36086,2609,45,167,2763,14,5598,5.885.833.333
02/10/2017 00:00,22.54,34749,3404,50,169,2945,16,6584,604.5
02/10/2017 01:00,19.84,33936,3625,56,179,3074,15,6949,604.5
02/10/2017 02:00,18.89,33708,3794,63,180,3334,15,7386,604.5
02/10/2017 03:00,15.94,33811,3977,71,188,3576,17,7829,604.5
02/10/2017 04:00,19.2,34492,4013,75,196,3882,18,8184,604.5
02/10/2017 05:00,24.18,36540,3956,83,206,4152,17,8414,604.5
02/10/2017 06:00,27.78,40300,3823,91,211,4406,18,8549,604.5
02/10/2017 07:00,28.81,43789,3598,101,220,4618,26,8563,604.5
02/10/2017 08:00,28.81,44987,3445,112,229,4861,27,8674,604.5
02/10/2017 09:00,28.66,45247,3098,128,251,5043,30,8550,604.5
02/10/2017 10:00,28.57,45376,2837,143,259,5122,30,8391,604.5
02/10/2017 11:00,28.56,45180,2948,153,279,5103,40,8523,604.5
02/10/2017 12:00,28.52,44945,3203,161,300,5043,41,8748,604.5
02/10/2017 13:00,28.27,44875,3328,167,306,4950,44,8795,604.5
02/10/2017 14:00,28.21,44614,3469,168,322,4802,46,8807,604.5
02/10/2017 15:00,28.08,44335,3665,169,330,4662,47,8873,604.5
02/10/2017 16:00,28.08,44203,3600,169,339,4524,44,8676,604.5
02/10/2017 17:00,28.86,44470,3427,173,340,4424,48,8412,604.5
02/10/2017 18:00,29.35,44825,3374,180,357,4255,52,8218,604.5
02/10/2017 19:00,29.72,45015,3375,189,369,4212,53,8198,604.5
02/10/2017 20:00,28.54,43882,3430,196,368,4123,51,8168,604.5
02/10/2017 21:00,26.66,42260,3367,199,367,3990,50,7973,604.5
02/10/2017 22:00,25.74,40100,3123,201,366,3900,49,7639,604.5
02/10/2017 23:00,20.41,37574,3083,211,0,3801,51,7146,604.5
03/10/2017 00:00,14.66,35505,2453,212,0,3638,49,6352,604.5
03/10/2017 01:00,15.25,34552,2391,211,0,3513,48,6163,604.5
03/10/2017 02:00,13.97,34193,2376,211,0,3374,45,6006,604.5
03/10/2017 03:00,16.28,34292,2322,212,0,3288,45,5867,604.5
03/10/2017 04:00,19.93,34928,2346,213,0,3228,42,5829,604.5
03/10/2017 05:00,26.65,36928,2412,214,0,3234,40,5900,604.5
03/10/2017 06:00,28.09,40645,2406,215,0,3210,32,5863,604.5
03/10/2017 07:00,30.62,44066,2386,211,0,3221,27,5845,604.5
03/10/2017 08:00,30.9,45181,2491,208,0,3282,23,6004,604.5
03/10/2017 09:00,30.7,45224,2682,202,0,3285,20,6189,604.5
03/10/2017 10:00,29.96,45354,2973,195,0,3353,16,6537,604.5
03/10/2017 11:00,29.67,45112,3246,188,0,3407,15,6856,604.5
03/10/2017 12:00,28.5,44765,3428,185,0,3431,15,7059,604.5
03/10/2017 13:00,28.01,44725,3585,182,0,3452,16,7235,604.5
03/10/2017 14:00,27.65,44394,3825,176,0,3489,16,7506,604.5
03/10/2017 15:00,27.55,44150,4109,174,0,3506,15,7804,604.5
03/10/2017 16:00,27.42,43967,4126,169,0,3519,16,7830,604.5
03/10/2017 17:00,28.12,44385,3887,161,0,3564,19,7631,604.5
03/10/2017 18:00,29.29,44782,3619,153,0,3530,23,7325,604.5
03/10/2017 19:00,29.76,45113,3515,147,0,3549,23,7234,604.5
03/10/2017 20:00,28.63,43987,3563,144,0,3524,22,7253,604.5
03/10/2017 21:00,27.69,42368,3526,141,0,3491,21,7179,604.5
03/10/2017 22:00,27.12,40198,3417,141,0,3470,24,7052,604.5
03/10/2017 23:00,24.3,37736,3376,153,202,3544,20,7295,604.5
04/10/2017 00:00,10.79,35951,3358,161,225,3513,24,7281,604.5
04/10/2017 01:00,9.29,35022,3265,165,244,3519,24,7217,604.5
04/10/2017 02:00,9.91,34764,3154,164,262,3535,22,7137,604.5
04/10/2017 03:00,9.92,34879,3086,165,279,3591,20,7141,604.5
04/10/2017 04:00,13.97,35456,3050,162,294,3656,23,7185,604.5
04/10/2017 05:00,19.24,37520,2995,161,303,3682,24,7165,604.5
04/10/2017 06:00,27.95,41189,2948,157,303,3663,25,7096,604.5
04/10/2017 07:00,30.15,44747,2952,154,308,3501,27,6942,604.5
04/10/2017 08:00,30.97,45716,3080,153,318,3443,30,7024,604.5
04/10/2017 09:00,30.66,45649,3239,155,332,3542,31,7299,604.5
04/10/2017 10:00,30.74,45790,3394,156,349,3469,34,7402,604.5
04/10/2017 11:00,29.5,45566,3587,158,359,3314,34,7452,604.5
04/10/2017 12:00,28.63,45256,3733,162,365,3251,33,7544,604.5
04/10/2017 13:00,28.38,45256,3888,162,367,3248,31,7696,604.5
04/10/2017 14:00,28.38,45088,4101,157,370,3256,31,7915,604.5
04/10/2017 15:00,28.35,44864,4309,157,370,3298,26,8160,604.5
04/10/2017 16:00,28.16,44741,4228,149,363,3196,24,7960,604.5
04/10/2017 17:00,29.41,45155,3949,135,355,3176,20,7635,604.5
04/10/2017 18:00,30.59,45557,3711,122,355,3133,17,7338,604.5
04/10/2017 19:00,31.63,45924,3600,111,360,3117,17,7205,604.5
04/10/2017 20:00,29.27,44973,3613,99,363,3067,18,7160,604.5
04/10/2017 21:00,27.26,43511,3582,92,370,3117,16,7177,604.5
04/10/2017 22:00,25.35,41402,3555,74,374,3085,15,7103,604.5
04/10/2017 23:00,17.11,39028,3606,82,384,3188,30,7290,604.5
05/10/2017 00:00,19.99,36841,3673,80,378,3174,27,7332,604.5
05/10/2017 01:00,11.94,36037,3576,81,374,3129,24,7184,604.5
05/10/2017 02:00,11.98,35790,3322,74,367,3012,23,6798,604.5
05/10/2017 03:00,20.02,35861,2950,74,370,2916,20,6330,604.5
05/10/2017 04:00,22.94,36370,2457,66,372,2804,19,5718,604.5
05/10/2017 05:00,26.36,38340,2001,54,374,2653,19,5101,604.5
05/10/2017 06:00,29.88,41979,1581,43,374,2278,15,4291,604.5
05/10/2017 07:00,33.69,45461,1179,36,371,2058,18,3662,604.5
05/10/2017 08:00,36.71,46646,869,30,362,1919,17,3197,604.5
05/10/2017 09:00,34.1,46709,757,28,358,1852,19,3014,604.5
05/10/2017 10:00,34.22,46715,897,25,348,1642,25,2937,604.5
05/10/2017 11:00,33.02,46301,1162,21,336,1519,29,3067,604.5
05/10/2017 12:00,32.23,45733,1522,26,308,1394,46,3296,604.5
05/10/2017 13:00,31.83,45382,2089,25,288,1385,38,3825,604.5
05/10/2017 14:00,31.19,44975,2538,23,233,1411,25,4230,604.5
05/10/2017 15:00,30.46,44698,2862,20,179,1457,20,4538,604.5
05/10/2017 16:00,30.2,44576,3041,21,129,1534,18,4743,604.5
05/10/2017 17:00,30.69,45122,2950,19,95,1653,14,4731,604.5
05/10/2017 18:00,31.36,45579,2764,18,70,1782,14,4648,604.5
05/10/2017 19:00,32.4,45928,2761,18,57,1884,13,4733,604.5
05/10/2017 20:00,30.69,45071,2845,16,46,1851,11,4769,604.5
05/10/2017 21:00,29.44,43537,2869,14,50,1825,11,4769,604.5
05/10/2017 22:00,27.89,41415,2809,11,51,1750,11,4632,604.5
05/10/2017 23:00,26.12,38989,2700,15,55,1700,15,4485,604.5
06/10/2017 00:00,26.13,36781,2587,12,64,1699,16,4378,604.5
06/10/2017 01:00,25.08,35845,2440,11,80,1675,16,4222,604.5
06/10/2017 02:00,24.91,35616,2303,10,95,1716,14,4138,604.5
06/10/2017 03:00,25.05,35760,2226,8,107,1752,16,4109,604.5
06/10/2017 04:00,26.04,36443,2162,10,125,1790,17,4104,604.5
06/10/2017 05:00,27.76,38594,2039,10,135,1840,18,4042,604.5
06/10/2017 06:00,30.35,42417,1940,9,146,1833,18,3946,604.5
06/10/2017 07:00,33.95,45999,1836,8,157,1769,17,3787,604.5
06/10/2017 08:00,34.86,47190,1707,8,174,1682,20,3591,604.5
06/10/2017 09:00,34.59,47496,1627,11,187,1623,22,3470,604.5
06/10/2017 10:00,33.59,47409,1686,14,198,1607,23,3528,604.5
06/10/2017 11:00,33.09,46673,1722,15,225,1628,23,3613,604.5
06/10/2017 12:00,32.34,45771,1715,18,248,1629,21,3631,604.5
06/10/2017 13:00,31.06,45009,1862,22,254,1666,22,3826,604.5
06/10/2017 14:00,30.12,44245,1964,26,267,1696,25,3978,604.5
06/10/2017 15:00,29.94,43515,1966,30,272,1762,23,4053,604.5
06/10/2017 16:00,30.96,43406,1931,32,260,1863,18,4104,604.5
06/10/2017 17:00,31.92,43999,1848,33,210,1949,14,4054,604.5
06/10/2017 18:00,33.13,44664,1728,31,174,2027,11,3971,604.5
06/10/2017 19:00,32.86,44665,1735,31,159,2100,11,4036,604.5
06/10/2017 20:00,30.98,43160,1899,31,137,2052,12,4131,604.5
06/10/2017 21:00,29.25,41651,2155,30,132,1993,10,4320,604.5
06/10/2017 22:00,28.38,39920,2402,39,119,1901,10,4471,604.5
06/10/2017 23:00,26.91,38027,2650,25,150,1699,12,4536,604.5
07/10/2017 00:00,27.24,36113,2634,19,135,1579,10,4377,604.5
07/10/2017 01:00,26.41,35108,2682,15,125,1467,11,4300,604.5
07/10/2017 02:00,25.34,34728,2634,14,115,1417,10,4190,604.5
07/10/2017 03:00,25.05,34640,2651,13,115,1486,11,4276,604.5
07/10/2017 04:00,25.5,34843,2661,13,105,1518,10,4307,604.5
07/10/2017 05:00,26.57,35550,2575,13,95,1496,10,4189,604.5
07/10/2017 06:00,27.2,36511,2427,16,90,1486,13,4032,604.5
07/10/2017 07:00,27.48,37886,2257,20,85,1415,12,3789,604.5
07/10/2017 08:00,27.65,39888,2126,22,85,1313,10,3556,604.5
07/10/2017 09:00,28.54,41455,1890,26,90,1272,9,3287,604.5
07/10/2017 10:00,28.95,42321,1704,34,90,1331,11,3170,604.5
07/10/2017 11:00,28.9,42207,1571,38,125,1320,9,3063,604.5
07/10/2017 12:00,28.68,41938,1534,42,140,1235,9,2960,604.5
07/10/2017 13:00,28.52,41609,1605,38,145,1168,10,2966,604.5
07/10/2017 14:00,28.39,41243,1636,32,155,1042,15,2880,604.5
07/10/2017 15:00,28.42,41130,1747,28,170,946,19,2910,604.5
07/10/2017 16:00,28.58,41632,1836,25,180,891,18,2950,604.5
07/10/2017 17:00,29.19,42645,1741,26,185,934,19,2905,604.5
07/10/2017 18:00,29.88,43495,1612,38,195,935,20,2800,604.5
07/10/2017 19:00,29.82,43391,1596,48,200,989,20,2853,604.5
07/10/2017 20:00,28.67,42001,1653,62,210,1057,18,3000,604.5
07/10/2017 21:00,27.97,40839,1698,77,230,1186,16,3207,604.5
07/10/2017 22:00,27.27,39576,1716,85,240,1327,13,3381,604.5
07/10/2017 23:00,26.6,38104,1682,118,295,1542,12,3649,604.5
08/10/2017 00:00,27.38,36380,1260,119,295,1764,16,3454,604.5
08/10/2017 01:00,26.97,35544,1340,114,310,1861,18,3643,604.5
08/10/2017 02:00,26.51,35166,1431,106,320,1919,17,3793,604.5
08/10/2017 03:00,26.33,35045,1426,96,335,1993,17,3867,604.5
08/10/2017 04:00,26.38,35194,1449,96,340,2056,22,3963,604.5
08/10/2017 05:00,26.4,35657,1463,106,345,2098,21,4033,604.5
08/10/2017 06:00,26.38,36215,1413,117,335,2187,19,4071,604.5
08/10/2017 07:00,26.67,36881,1346,127,320,2246,17,4056,604.5
08/10/2017 08:00,27.99,38219,1287,134,310,2286,8,4025,604.5
08/10/2017 09:00,29.22,39841,1166,134,295,2392,8,3995,604.5
08/10/2017 10:00,30.55,41007,1176,130,270,2497,10,4083,604.5
08/10/2017 11:00,31.28,41208,1289,127,235,2584,13,4248,604.5
08/10/2017 12:00,29.6,40950,1393,122,220,2731,16,4482,604.5
08/10/2017 13:00,28.22,40747,1527,118,205,2852,17,4719,604.5
08/10/2017 14:00,27.43,40625,1602,114,190,2890,20,4816,604.5
08/10/2017 15:00,27.36,40624,1555,106,185,2868,13,4727,604.5
08/10/2017 16:00,28.15,41135,1406,93,165,2882,9,4555,604.5
08/10/2017 17:00,29.96,42153,1236,87,150,2911,8,4392,604.5
08/10/2017 18:00,32.59,43267,1078,84,140,2885,7,4194,604.5
08/10/2017 19:00,32.89,43660,1024,82,145,2897,7,4155,604.5
08/10/2017 20:00,31.89,42683,1078,80,135,2896,7,4196,604.5
08/10/2017 21:00,30.24,41483,1071,77,145,2867,6,4166,604.5
08/10/2017 22:00,29.53,39915,1039,59,155,2870,6,4129,604.5
08/10/2017 23:00,28.79,37840,1043,65,0,3023,11,4142,604.5
09/10/2017 00:00,29.31,36487,1012,62,0,3019,13,4106,6.054.107.143
09/10/2017 01:00,29.15,35848,1002,57,0,3010,14,4083,6.054.107.143
09/10/2017 02:00,29.08,35678,1018,53,0,2990,13,4074,6.054.107.143
09/10/2017 03:00,29.13,35813,1009,49,0,2970,14,4042,6.054.107.143
09/10/2017 04:00,29.26,36549,978,43,0,2949,16,3986,6.054.107.143
09/10/2017 05:00,29.99,38737,972,38,0,2902,16,3928,6.054.107.143
09/10/2017 06:00,33.96,43314,972,34,0,2839,20,3865,6.054.107.143
09/10/2017 07:00,37.21,47140,955,29,0,2776,20,3780,6.054.107.143
09/10/2017 08:00,39.53,48282,955,26,0,2737,19,3737,6.054.107.143
09/10/2017 09:00,38.38,48365,875,25,0,2691,19,3610,6.054.107.143
09/10/2017 10:00,38.01,48394,816,27,0,2655,19,3517,6.054.107.143
09/10/2017 11:00,37.16,48137,787,31,0,2596,18,3432,6.054.107.143
09/10/2017 12:00,36.11,47633,780,37,0,2575,15,3407,6.054.107.143
09/10/2017 13:00,34.09,47409,826,46,0,2507,14,3393,6.054.107.143
09/10/2017 14:00,34.9,46937,822,48,0,2430,14,3314,6.054.107.143
09/10/2017 15:00,36,46545,794,51,0,2314,12,3171,6.054.107.143
09/10/2017 16:00,35.72,46434,736,53,0,2265,10,3064,6.054.107.143
09/10/2017 17:00,37,47001,619,57,0,2236,9,2921,6.054.107.143
09/10/2017 18:00,38.83,47326,502,63,0,2187,8,2760,6.054.107.143
09/10/2017 19:00,41.17,47498,429,62,0,2160,8,2659,6.054.107.143
09/10/2017 20:00,36.02,46168,353,63,0,2099,8,2523,6.054.107.143
09/10/2017 21:00,33.36,44569,261,60,0,2037,7,2365,6.054.107.143
09/10/2017 22:00,32.2,42506,206,78,0,2029,7,2320,6.054.107.143
09/10/2017 23:00,30.26,40020,186,74,188,1923,9,2380,6.054.107.143
10/10/2017 00:00,29.89,37935,190,68,164,1862,9,2293,6.054.107.143
10/10/2017 01:00,29.74,36983,170,63,144,1823,10,2210,6.054.107.143
10/10/2017 02:00,29.75,36625,147,59,147,1777,11,2141,6.054.107.143
10/10/2017 03:00,29.76,36779,128,58,153,1779,10,2128,6.054.107.143
10/10/2017 04:00,29.96,37397,131,54,162,1811,10,2168,6.054.107.143
10/10/2017 05:00,30.65,39516,140,51,167,1871,10,2239,6.054.107.143
10/10/2017 06:00,32.41,43820,141,46,171,1961,9,2328,6.054.107.143
10/10/2017 07:00,34.97,47527,162,45,169,1950,8,2334,6.054.107.143
10/10/2017 08:00,35.78,48252,213,49,168,1951,9,2390,6.054.107.143
10/10/2017 09:00,35.09,48066,272,51,175,1915,10,2423,6.054.107.143
10/10/2017 10:00,33.28,48014,355,54,183,1865,12,2469,6.054.107.143
10/10/2017 11:00,33.03,47626,453,56,198,1773,13,2493,6.054.107.143
10/10/2017 12:00,32.34,47107,597,58,212,1810,17,2694,6.054.107.143
10/10/2017 13:00,32.25,46873,825,57,242,1729,19,2872,6.054.107.143
10/10/2017 14:00,31.98,46496,1015,57,251,1693,20,3036,6.054.107.143
10/10/2017 15:00,31.68,46304,1284,59,266,1610,21,3240,6.054.107.143
10/10/2017 16:00,31.48,46263,1702,58,273,1566,20,3619,6.054.107.143
10/10/2017 17:00,32.12,46833,1838,60,281,1509,20,3708,6.054.107.143
10/10/2017 18:00,33.94,47187,1780,60,266,1460,20,3586,6.054.107.143
10/10/2017 19:00,33.8,47317,1976,63,229,1439,18,3725,6.054.107.143
10/10/2017 20:00,31.42,45981,2160,62,211,1445,16,3894,6.054.107.143
10/10/2017 21:00,30.24,44372,2203,65,197,1454,12,3931,6.054.107.143
10/10/2017 22:00,29.71,42352,2116,67,179,1458,10,3830,6.054.107.143
10/10/2017 23:00,28.56,39907,1842,119,160,1493,24,3638,6.054.107.143
11/10/2017 00:00,27.26,37702,1946,119,159,1466,22,3712,6.054.107.143
11/10/2017 01:00,26.75,36843,1688,116,148,1436,18,3406,6.054.107.143
11/10/2017 02:00,26.67,36627,1441,110,128,1347,16,3042,6.054.107.143
11/10/2017 03:00,26.85,36761,1190,101,111,1267,13,2682,6.054.107.143
11/10/2017 04:00,28.08,37316,1014,89,107,1145,10,2365,6.054.107.143
11/10/2017 05:00,29.77,39347,889,71,107,1048,8,2123,6.054.107.143
11/10/2017 06:00,32.11,43107,802,65,111,941,7,1926,6.054.107.143
11/10/2017 07:00,37.54,46638,740,66,121,827,12,1766,6.054.107.143
11/10/2017 08:00,39.76,47823,750,62,154,675,9,1650,6.054.107.143
11/10/2017 09:00,38.38,47874,912,60,165,651,7,1795,6.054.107.143
11/10/2017 10:00,37.67,48076,1217,52,178,594,8,2049,6.054.107.143
11/10/2017 11:00,37.2,47722,1556,51,182,530,10,2329,6.054.107.143
11/10/2017 12:00,34.07,47167,1849,50,183,555,11,2648,6.054.107.143
11/10/2017 13:00,33.36,46806,2041,46,187,622,15,2911,6.054.107.143
11/10/2017 14:00,33.04,46536,2124,42,186,701,14,3067,6.054.107.143
11/10/2017 15:00,32.24,46329,2304,39,178,856,13,3390,6.054.107.143
11/10/2017 16:00,31.89,46299,2733,41,157,1059,10,4000,6.054.107.143
11/10/2017 17:00,32.15,46865,2993,38,138,1282,9,4460,6.054.107.143
11/10/2017 18:00,32.44,47295,3132,38,114,1588,8,4880,6.054.107.143
11/10/2017 19:00,32.01,47269,3381,37,92,1901,8,5419,6.054.107.143
11/10/2017 20:00,30.92,45791,3442,34,72,2204,8,5760,6.054.107.143
11/10/2017 21:00,29.85,44067,3343,32,64,2383,8,5830,6.054.107.143
11/10/2017 22:00,28.92,41871,3194,39,59,2475,8,5775,6.054.107.143
11/10/2017 23:00,27.11,39443,3103,28,50,2674,7,5862,6.054.107.143
12/10/2017 00:00,26.95,37136,3466,23,50,2716,8,6263,6.054.107.143
12/10/2017 01:00,26.19,36000,3374,20,65,2769,8,6236,6.054.107.143
12/10/2017 02:00,26.05,35635,3179,18,90,2794,9,6090,6.054.107.143
12/10/2017 03:00,25.98,35627,3123,17,130,2827,11,6108,6.054.107.143
12/10/2017 04:00,26.18,36137,3220,18,165,2828,19,6250,6.054.107.143
12/10/2017 05:00,27.56,38229,3336,21,205,2827,25,6414,6.054.107.143
12/10/2017 06:00,29.3,42421,3465,28,225,2867,24,6609,6.054.107.143
12/10/2017 07:00,30.92,46295,3493,39,245,2893,32,6702,6.054.107.143
12/10/2017 08:00,31.44,47470,3558,53,263,3030,37,6941,6.054.107.143
12/10/2017 09:00,30.36,47413,3603,72,292,3014,36,7017,6.054.107.143
12/10/2017 10:00,29.8,47243,3722,83,313,3113,38,7269,6.054.107.143
12/10/2017 11:00,29.33,46951,3963,87,324,3167,41,7582,6.054.107.143
12/10/2017 12:00,29.25,46573,4167,88,339,3348,42,7984,6.054.107.143
12/10/2017 13:00,29.15,46370,4299,97,351,3431,49,8227,6.054.107.143
12/10/2017 14:00,29.06,46210,4322,105,363,3507,50,8347,6.054.107.143
12/10/2017 15:00,28.97,45963,4331,115,376,3681,52,8555,6.054.107.143
12/10/2017 16:00,28.9,45996,4268,123,387,3774,54,8606,6.054.107.143
12/10/2017 17:00,29.28,46781,4044,120,393,3743,53,8353,6.054.107.143
12/10/2017 18:00,29.9,47137,3745,117,396,3804,47,8109,6.054.107.143
12/10/2017 19:00,29.93,47047,3590,108,398,3776,45,7917,6.054.107.143
12/10/2017 20:00,29.35,45609,3426,98,400,3718,40,7682,6.054.107.143
12/10/2017 21:00,28.99,44024,3197,84,400,3658,46,7385,6.054.107.143
12/10/2017 22:00,28,41856,2940,54,400,3593,51,7038,6.054.107.143
12/10/2017 23:00,27.63,39354,2723,50,399,3639,59,6870,6.054.107.143
13/10/2017 00:00,26.58,36799,2450,45,398,3536,60,6489,6.054.107.143
13/10/2017 01:00,26.25,35843,2124,38,397,3321,60,5940,6.054.107.143
13/10/2017 02:00,26.44,35526,1823,32,394,3076,60,5385,6.054.107.143
13/10/2017 03:00,26.92,35668,1586,31,392,2763,61,4833,6.054.107.143
13/10/2017 04:00,27.81,36339,1356,39,390,2429,63,4277,6.054.107.143
13/10/2017 05:00,28.54,38578,1144,57,380,2067,65,3713,6.054.107.143
13/10/2017 06:00,30.31,42660,910,93,367,1701,65,3136,6.054.107.143
13/10/2017 07:00,34.26,46516,761,120,359,1370,65,2675,6.054.107.143
13/10/2017 08:00,37.48,47630,756,133,361,1068,65,2383,6.054.107.143
13/10/2017 09:00,36.9,47561,752,148,360,832,63,2155,6.054.107.143
13/10/2017 10:00,36.69,47639,824,152,357,678,61,2072,6.054.107.143
13/10/2017 11:00,34.81,46964,980,147,352,612,57,2148,6.054.107.143
13/10/2017 12:00,32.02,46135,1224,140,353,589,55,2361,6.054.107.143
13/10/2017 13:00,30.88,45465,1492,129,350,608,53,2632,6.054.107.143
13/10/2017 14:00,30.27,44659,1606,115,349,654,51,2775,6.054.107.143
13/10/2017 15:00,29.72,44076,1699,101,340,759,44,2943,6.054.107.143
13/10/2017 16:00,29.75,44204,1872,88,320,967,40,3287,6.054.107.143
13/10/2017 17:00,30.66,45037,2012,76,300,1360,32,3780,6.054.107.143
13/10/2017 18:00,31.79,45815,2008,66,282,1822,23,4201,6.054.107.143
13/10/2017 19:00,30.63,45548,2170,56,250,2248,17,4741,6.054.107.143
13/10/2017 20:00,28.95,43651,2307,45,200,2624,13,5189,6.054.107.143
13/10/2017 21:00,28.14,41887,2419,34,132,2905,11,5501,6.054.107.143
13/10/2017 22:00,27.61,40040,2522,38,106,3123,9,5798,6.054.107.143
13/10/2017 23:00,26.63,37956,2645,27,114,3295,7,6088,6.054.107.143
14/10/2017 00:00,26.76,36279,2605,22,98,3374,7,6106,6.054.107.143
14/10/2017 01:00,25.92,35080,2564,18,88,3401,7,6078,6.054.107.143
14/10/2017 02:00,25.4,34453,2453,15,78,3297,7,5850,6.054.107.143
14/10/2017 03:00,25.33,34176,2307,13,68,3149,8,5545,6.054.107.143
14/10/2017 04:00,25.54,34261,2256,12,68,3008,8,5352,6.054.107.143
14/10/2017 05:00,26.1,34863,2262,11,65,2868,8,5214,6.054.107.143
14/10/2017 06:00,26.5,35830,2172,11,50,2727,11,4971,6.054.107.143
14/10/2017 07:00,26.72,37029,2100,16,59,2625,15,4815,6.054.107.143
14/10/2017 08:00,27.34,38725,2144,24,99,2589,18,4874,6.054.107.143
14/10/2017 09:00,27.83,40342,2174,35,136,2525,21,4891,6.054.107.143
14/10/2017 10:00,27.83,41282,2165,51,171,2522,20,4929,6.054.107.143
14/10/2017 11:00,27.26,41221,2247,70,197,2512,17,5043,6.054.107.143
14/10/2017 12:00,26.53,40904,2335,86,223,2460,17,5121,6.054.107.143
14/10/2017 13:00,25.9,40600,2312,88,238,2386,23,5047,6.054.107.143
14/10/2017 14:00,25.95,40153,2121,90,251,2438,27,4927,6.054.107.143
14/10/2017 15:00,26.42,40026,1976,81,270,2534,28,4889,6.054.107.143
14/10/2017 16:00,27.34,40405,1901,69,281,2533,22,4806,6.054.107.143
14/10/2017 17:00,28.24,41649,1790,83,289,2594,25,4781,6.054.107.143
14/10/2017 18:00,28.98,42690,1709,113,296,2720,26,4864,6.054.107.143
14/10/2017 19:00,28.9,42389,1775,134,300,2769,26,5004,6.054.107.143
14/10/2017 20:00,28.04,40808,1855,138,300,2821,29,5143,6.054.107.143
14/10/2017 21:00,27.57,39506,1906,136,300,2840,31,5213,6.054.107.143
14/10/2017 22:00,26.92,38192,1848,116,300,2855,29,5148,6.054.107.143
14/10/2017 23:00,26.03,36656,1749,128,326,3079,36,5318,6.054.107.143
15/10/2017 00:00,25.72,35206,1392,128,327,3132,36,5015,6.054.107.143
15/10/2017 01:00,25.08,34250,1348,130,324,3111,35,4948,6.054.107.143
15/10/2017 02:00,25.09,33555,1232,130,320,3097,41,4820,6.054.107.143
15/10/2017 03:00,25.34,33659,1073,124,311,2976,34,4518,6.054.107.143
15/10/2017 04:00,25.99,33789,927,114,302,2863,29,4235,6.054.107.143
15/10/2017 05:00,26.06,34254,829,102,291,2766,30,4018,6.054.107.143
15/10/2017 06:00,25.57,34921,770,93,278,2618,26,3785,6.054.107.143
15/10/2017 07:00,25.71,35844,721,81,265,2448,26,3541,6.054.107.143
15/10/2017 08:00,26.89,37349,699,75,249,2248,22,3293,6.054.107.143
15/10/2017 09:00,27.78,38948,715,75,242,2011,24,3067,6.054.107.143
15/10/2017 10:00,27.89,40060,925,75,230,1898,21,3149,6.054.107.143
15/10/2017 11:00,27.79,40264,1297,75,207,1737,19,3335,6.054.107.143
15/10/2017 12:00,26.53,40118,1707,76,182,1704,17,3686,6.054.107.143
15/10/2017 13:00,25.91,39669,1960,73,155,1729,15,3932,6.054.107.143
15/10/2017 14:00,25.94,39535,2015,68,136,1601,15,3835,6.054.107.143
15/10/2017 15:00,26.62,39635,2077,63,111,1749,16,4016,6.054.107.143
15/10/2017 16:00,27.21,40199,2154,57,99,1886,14,4210,6.054.107.143
15/10/2017 17:00,28.55,41319,2146,50,87,2183,12,4478,6.054.107.143
15/10/2017 18:00,28.91,42417,2106,48,74,2478,11,4717,6.054.107.143
15/10/2017 19:00,28.83,42684,2232,46,73,2799,11,5161,6.054.107.143
15/10/2017 20:00,27.78,41502,2323,43,81,3051,11,5509,6.054.107.143
15/10/2017 21:00,26.87,40292,2284,41,96,3193,10,5624,6.054.107.143
15/10/2017 22:00,25.78,38511,2276,41,106,3313,13,5749,6.054.107.143
15/10/2017 23:00,21.72,36243,2134,29,93,3564,10,5830,6.054.107.143
16/10/2017 00:00,22.99,34718,1812,36,105,3707,12,5672,6.091.488.095
16/10/2017 01:00,21.26,33816,1582,51,112,3748,13,5506,6.091.488.095
16/10/2017 02:00,21.86,33510,1407,73,122,3850,18,5470,6.091.488.095
16/10/2017 03:00,21.79,33616,1275,100,131,3893,16,5415,6.091.488.095
16/10/2017 04:00,22.93,34291,1218,112,141,4042,15,5528,6.091.488.095
16/10/2017 05:00,26.15,36460,1134,116,151,4078,14,5493,6.091.488.095
16/10/2017 06:00,28.11,40507,999,121,161,4089,18,5388,6.091.488.095
16/10/2017 07:00,29.17,44013,917,126,164,4009,19,5235,6.091.488.095
16/10/2017 08:00,29.63,44959,843,131,170,3976,22,5142,6.091.488.095
16/10/2017 09:00,29.61,45252,779,139,173,3947,27,5065,6.091.488.095
16/10/2017 10:00,29.4,45448,769,145,184,3803,33,4934,6.091.488.095
16/10/2017 11:00,29.12,45226,740,150,192,3609,37,4728,6.091.488.095
16/10/2017 12:00,28.81,44740,690,149,195,3452,38,4524,6.091.488.095
16/10/2017 13:00,28.74,44553,572,149,205,3293,40,4259,6.091.488.095
16/10/2017 14:00,28.78,44301,455,145,224,3165,33,4022,6.091.488.095
16/10/2017 15:00,28.46,44031,345,138,237,3028,24,3772,6.091.488.095
16/10/2017 16:00,29.07,44064,279,131,240,2952,18,3620,6.091.488.095
16/10/2017 17:00,29.74,44770,262,121,240,2832,15,3470,6.091.488.095
16/10/2017 18:00,30.25,45478,303,113,233,2778,12,3439,6.091.488.095
16/10/2017 19:00,30.04,45557,521,107,224,2694,11,3557,6.091.488.095
16/10/2017 20:00,28.79,44290,739,99,206,2656,11,3711,6.091.488.095
16/10/2017 21:00,28.04,42816,961,90,187,2653,10,3901,6.091.488.095
16/10/2017 22:00,27.07,40810,1213,104,164,2609,10,4100,6.091.488.095
16/10/2017 23:00,26.06,38349,1456,77,110,2486,6,4135,6.091.488.095
17/10/2017 00:00,25.93,36485,1879,66,85,2426,6,4462,6.091.488.095
17/10/2017 01:00,25.08,35500,2202,61,75,2432,7,4777,6.091.488.095
17/10/2017 02:00,24.63,35202,2392,58,65,2438,7,4960,6.091.488.095
17/10/2017 03:00,24.6,35252,2478,57,55,2469,8,5067,6.091.488.095
17/10/2017 04:00,25.29,35851,2621,57,55,2472,8,5213,6.091.488.095
17/10/2017 05:00,26.42,37794,2739,57,55,2567,8,5426,6.091.488.095
17/10/2017 06:00,28.05,41923,2737,57,50,2592,9,5445,6.091.488.095
17/10/2017 07:00,29.35,45222,2781,53,55,2587,11,5487,6.091.488.095
17/10/2017 08:00,29.82,46288,2917,54,65,2577,14,5627,6.091.488.095
17/10/2017 09:00,29.52,45769,3104,59,80,2656,20,5919,6.091.488.095
17/10/2017 10:00,29.49,45909,3298,67,130,2715,40,6250,6.091.488.095
17/10/2017 11:00,29.13,45542,3515,82,160,2708,51,6516,6.091.488.095
17/10/2017 12:00,28.68,45099,3646,112,185,2754,52,6749,6.091.488.095
17/10/2017 13:00,28.52,44897,3741,139,185,2836,50,6951,6.091.488.095
17/10/2017 14:00,28.38,44697,3710,162,200,2895,49,7016,6.091.488.095
17/10/2017 15:00,28.29,44735,3736,182,220,2905,47,7090,6.091.488.095
17/10/2017 16:00,28.15,44951,3728,189,235,2879,47,7078,6.091.488.095
17/10/2017 17:00,28.67,45835,3585,193,250,2907,47,6982,6.091.488.095
17/10/2017 18:00,29.65,46448,3440,196,260,2936,50,6882,6.091.488.095
17/10/2017 19:00,29.34,46123,3401,196,270,3037,50,6954,6.091.488.095
17/10/2017 20:00,28.1,44677,3415,196,280,3159,46,7096,6.091.488.095
17/10/2017 21:00,27.35,43079,3414,200,280,3316,42,7252,6.091.488.095
17/10/2017 22:00,26.39,40929,3277,185,280,3387,38,7167,6.091.488.095
17/10/2017 23:00,25.26,38427,3073,211,280,3527,35,7126,6.091.488.095
18/10/2017 00:00,25.44,36294,3156,216,280,3528,37,7217,6.091.488.095
18/10/2017 01:00,22.48,35360,3052,221,280,3600,39,7192,6.091.488.095
18/10/2017 02:00,21.52,35035,2896,223,290,3540,43,6992,6.091.488.095
18/10/2017 03:00,21.81,35144,2699,224,305,3443,48,6719,6.091.488.095
18/10/2017 04:00,25.16,35817,2503,222,305,3361,48,6439,6.091.488.095
18/10/2017 05:00,27.09,38077,2205,213,315,3290,48,6071,6.091.488.095
18/10/2017 06:00,28.57,42011,1778,192,315,3062,46,5393,6.091.488.095
18/10/2017 07:00,30.29,45780,1414,167,310,2855,44,4790,6.091.488.095
18/10/2017 08:00,31.3,47120,1101,150,305,2680,43,4279,6.091.488.095
18/10/2017 09:00,32.17,47117,818,129,305,2435,40,3727,6.091.488.095
18/10/2017 10:00,32.46,47211,632,112,300,2210,35,3289,6.091.488.095
18/10/2017 11:00,32.3,46881,501,98,290,2028,30,2947,6.091.488.095
18/10/2017 12:00,31.68,46486,421,85,260,1941,23,2730,6.091.488.095
18/10/2017 13:00,31.09,46085,322,81,230,1883,23,2539,6.091.488.095
18/10/2017 14:00,30.92,45794,223,88,195,1896,17,2419,6.091.488.095
18/10/2017 15:00,31.02,45604,133,90,150,1911,13,2297,6.091.488.095
18/10/2017 16:00,31.41,45925,106,94,115,1956,11,2282,6.091.488.095
18/10/2017 17:00,35.4,46916,91,101,90,2021,8,2311,6.091.488.095
18/10/2017 18:00,35.34,47629,80,106,80,2099,8,2373,6.091.488.095
18/10/2017 19:00,35.52,47293,90,103,65,2122,8,2388,6.091.488.095
18/10/2017 20:00,32.12,45838,97,95,50,2197,8,2447,6.091.488.095
18/10/2017 21:00,30.92,44389,108,88,45,2178,7,2426,6.091.488.095
18/10/2017 22:00,29.57,42372,120,60,35,2162,7,2384,6.091.488.095
18/10/2017 23:00,28.37,40007,150,95,58,2237,7,2547,6.091.488.095
19/10/2017 00:00,28.64,38185,347,86,50,2140,7,2630,6.091.488.095
19/10/2017 01:00,28.03,37279,398,80,46,2048,7,2579,6.091.488.095
19/10/2017 02:00,27.99,37006,444,72,43,1983,6,2548,6.091.488.095
19/10/2017 03:00,28.05,37187,487,66,39,1907,6,2505,6.091.488.095
19/10/2017 04:00,28.46,37955,520,59,37,1861,6,2483,6.091.488.095
19/10/2017 05:00,29.32,40288,562,52,35,1814,6,2469,6.091.488.095
19/10/2017 06:00,31.26,44568,644,46,28,1699,6,2423,6.091.488.095
19/10/2017 07:00,35.32,48347,756,38,25,1528,6,2353,6.091.488.095
19/10/2017 08:00,36.26,49172,836,34,25,1326,6,2227,6.091.488.095
19/10/2017 09:00,36.42,49000,927,33,28,1128,6,2122,6.091.488.095
19/10/2017 10:00,36.76,48912,1079,34,32,896,6,2047,6.091.488.095
19/10/2017 11:00,34,48420,1193,35,32,721,6,1987,6.091.488.095
19/10/2017 12:00,34.02,47669,1238,34,31,624,6,1933,6.091.488.095
19/10/2017 13:00,32.87,47057,1345,34,31,583,6,1999,6.091.488.095
19/10/2017 14:00,32.8,46712,1467,32,27,629,6,2161,6.091.488.095
19/10/2017 15:00,31.99,46625,1601,29,24,697,6,2357,6.091.488.095
19/10/2017 16:00,31.66,46917,1722,25,24,829,6,2606,6.091.488.095
19/10/2017 17:00,33.67,47893,1776,23,28,959,6,2792,6.091.488.095
19/10/2017 18:00,34.28,48894,1821,21,30,1110,6,2988,6.091.488.095
19/10/2017 19:00,32.53,48763,1929,17,30,1238,6,3220,6.091.488.095
19/10/2017 20:00,30.23,47246,2027,14,35,1266,6,3348,6.091.488.095
19/10/2017 21:00,29.16,45770,2054,11,40,1305,8,3418,6.091.488.095
19/10/2017 22:00,28.45,43711,2064,10,45,1294,8,3421,6.091.488.095
19/10/2017 23:00,27.81,41284,2052,10,67,1260,5,3394,6.091.488.095
20/10/2017 00:00,28.75,39480,2160,8,69,1252,5,3494,6.091.488.095
20/10/2017 01:00,28.44,38519,2112,7,70,1272,6,3467,6.091.488.095
20/10/2017 02:00,28.11,38117,2056,6,73,1296,6,3437,6.091.488.095
20/10/2017 03:00,28.14,38185,2039,6,76,1356,6,3483,6.091.488.095
20/10/2017 04:00,28.5,38807,2075,6,77,1377,6,3541,6.091.488.095
20/10/2017 05:00,29.16,41012,2108,5,77,1386,6,3582,6.091.488.095
20/10/2017 06:00,31.07,45084,2131,5,78,1448,7,3669,6.091.488.095
20/10/2017 07:00,34.19,48572,2119,5,78,1456,8,3666,6.091.488.095
20/10/2017 08:00,35.1,49396,2111,4,78,1507,8,3708,6.091.488.095
20/10/2017 09:00,35.23,49190,2136,3,78,1506,7,3730,6.091.488.095
20/10/2017 10:00,34.46,49271,2066,3,78,1478,9,3634,6.091.488.095
20/10/2017 11:00,33.5,48777,2047,3,75,1452,10,3587,6.091.488.095
20/10/2017 12:00,31.9,48106,1956,5,71,1423,11,3466,6.091.488.095
20/10/2017 13:00,30.97,47530,1907,6,71,1447,14,3445,6.091.488.095
20/10/2017 14:00,30.74,46775,1786,6,71,1503,15,3381,6.091.488.095
20/10/2017 15:00,30.22,46193,1664,8,78,1592,17,3359,6.091.488.095
20/10/2017 16:00,30.2,46367,1553,11,88,1687,18,3357,6.091.488.095
20/10/2017 17:00,31.12,47307,1489,14,94,1787,24,3408,6.091.488.095
20/10/2017 18:00,31.94,48038,1414,17,100,1921,28,3480,6.091.488.095
20/10/2017 19:00,30.91,47309,1376,18,105,1997,23,3519,6.091.488.095
20/10/2017 20:00,29.38,45111,1350,21,110,2014,29,3524,6.091.488.095
20/10/2017 21:00,28.8,43604,1276,25,110,1988,30,3429,6.091.488.095
20/10/2017 22:00,28.5,41964,1201,27,110,1977,30,3345,6.091.488.095
20/10/2017 23:00,27.91,40132,1145,21,120,1982,13,3281,6.091.488.095
21/10/2017 00:00,29.07,38529,998,19,122,1996,13,3148,6.091.488.095
21/10/2017 01:00,28.81,37413,948,15,122,2020,15,3120,6.091.488.095
21/10/2017 02:00,28.55,36909,895,12,124,2041,15,3087,6.091.488.095
21/10/2017 03:00,28.43,36713,831,12,129,2085,17,3074,6.091.488.095
21/10/2017 04:00,28.41,36881,774,13,137,2090,17,3031,6.091.488.095
21/10/2017 05:00,28.99,37508,731,14,147,2076,15,2983,6.091.488.095
21/10/2017 06:00,29.01,38709,735,15,158,2125,18,3051,6.091.488.095
21/10/2017 07:00,28.75,40047,764,16,167,2121,18,3086,6.091.488.095
21/10/2017 08:00,29.09,41649,771,15,175,2118,17,3096,6.091.488.095
21/10/2017 09:00,29.36,43107,771,15,181,2146,17,3130,6.091.488.095
21/10/2017 10:00,29.54,44004,810,15,186,2116,20,3147,6.091.488.095
21/10/2017 11:00,29.46,43959,919,13,189,2093,22,3236,6.091.488.095
21/10/2017 12:00,29.31,43669,1048,12,193,2045,23,3321,6.091.488.095
21/10/2017 13:00,29.16,43278,1255,11,189,2074,19,3548,6.091.488.095
21/10/2017 14:00,29.07,43030,1435,11,185,2065,17,3713,6.091.488.095
21/10/2017 15:00,29.06,43116,1635,11,182,2107,14,3949,6.091.488.095
21/10/2017 16:00,29.21,43762,1726,12,183,2137,12,4070,6.091.488.095
21/10/2017 17:00,29.64,45161,1754,11,188,2223,12,4188,6.091.488.095
21/10/2017 18:00,29.99,46062,1867,12,193,2279,12,4363,6.091.488.095
21/10/2017 19:00,29.54,45351,2039,13,199,2301,14,4566,6.091.488.095
21/10/2017 20:00,29.08,43756,2171,16,202,2306,14,4709,6.091.488.095
21/10/2017 21:00,28.55,42458,2238,19,197,2259,12,4725,6.091.488.095
21/10/2017 22:00,27.45,41056,2236,19,192,2234,11,4692,6.091.488.095
21/10/2017 23:00,26,39625,2129,17,0,2174,9,4329,6.091.488.095
22/10/2017 00:00,27.9,38455,1721,17,0,2111,8,3857,6.091.488.095
22/10/2017 01:00,27.43,37448,1593,16,0,2042,8,3659,6.091.488.095
22/10/2017 02:00,27.07,36535,1491,14,0,1987,7,3499,6.091.488.095
22/10/2017 03:00,27.06,36896,1431,12,0,1938,7,3388,6.091.488.095
22/10/2017 04:00,27,36966,1436,11,0,1883,7,3337,6.091.488.095
22/10/2017 05:00,27.03,37432,1437,10,0,1834,7,3288,6.091.488.095
22/10/2017 06:00,27.58,38124,1396,10,0,1785,7,3198,6.091.488.095
22/10/2017 07:00,27.85,39026,1341,10,0,1739,7,3097,6.091.488.095
22/10/2017 08:00,28.39,40587,1284,9,0,1639,8,2940,6.091.488.095
22/10/2017 09:00,28.87,42249,1303,9,0,1554,7,2873,6.091.488.095
22/10/2017 10:00,29.29,43362,1321,9,0,1496,7,2833,6.091.488.095
22/10/2017 11:00,29.34,43786,1336,9,0,1416,9,2770,6.091.488.095
22/10/2017 12:00,29.12,43703,1328,9,0,1370,10,2717,6.091.488.095
22/10/2017 13:00,28.91,43523,1327,9,0,1350,11,2697,6.091.488.095
22/10/2017 14:00,28.84,43507,1292,10,0,1369,12,2683,6.091.488.095
22/10/2017 15:00,29.05,43766,1214,11,0,1449,11,2685,6.091.488.095
22/10/2017 16:00,29.34,44625,1154,13,0,1506,10,2683,6.091.488.095
22/10/2017 17:00,30.41,46007,1090,17,0,1574,9,2690,6.091.488.095
22/10/2017 18:00,31.81,46843,983,20,0,1617,9,2629,6.091.488.095
22/10/2017 19:00,31.23,46629,897,23,0,1675,9,2604,6.091.488.095
22/10/2017 20:00,30.56,45445,813,25,0,1700,11,2549,6.091.488.095
22/10/2017 21:00,29.99,44395,740,25,0,1718,13,2496,6.091.488.095
22/10/2017 22:00,29.85,42785,739,21,0,1743,13,2516,6.091.488.095
22/10/2017 23:00,28.97,40670,697,21,0,1663,18,2399,6.091.488.095
23/10/2017 00:00,28.6,39032,222,21,0,1693,17,1953,6.106.130.952
23/10/2017 01:00,27.85,38268,283,20,0,1717,17,2037,6.106.130.952
23/10/2017 02:00,27.07,38086,322,25,0,1748,17,2112,6.106.130.952
23/10/2017 03:00,27.05,38309,328,31,0,1793,20,2172,6.106.130.952
23/10/2017 04:00,27.84,39085,335,38,0,1839,22,2234,6.106.130.952
23/10/2017 05:00,29.7,41378,353,43,0,1856,24,2276,6.106.130.952
23/10/2017 06:00,31.61,45721,401,42,0,1862,22,2327,6.106.130.952
23/10/2017 07:00,35.09,49492,471,39,0,1840,21,2371,6.106.130.952
23/10/2017 08:00,37.17,50706,511,34,0,1789,21,2355,6.106.130.952
23/10/2017 09:00,36.34,50825,588,28,0,1732,22,2370,6.106.130.952
23/10/2017 10:00,36.1,50953,644,27,0,1747,28,2446,6.106.130.952
23/10/2017 11:00,34.91,50812,694,28,0,1754,33,2509,6.106.130.952
23/10/2017 12:00,33.97,50403,708,31,0,1746,30,2515,6.106.130.952
23/10/2017 13:00,33.73,50353,784,33,0,1730,26,2573,6.106.130.952
23/10/2017 14:00,32.97,50123,805,35,0,1695,25,2560,6.106.130.952
23/10/2017 15:00,32.47,49976,766,36,0,1664,25,2491,6.106.130.952
23/10/2017 16:00,32.91,50241,724,38,0,1627,19,2408,6.106.130.952
23/10/2017 17:00,35,51027,659,40,0,1609,17,2325,6.106.130.952
23/10/2017 18:00,35.62,51445,659,41,0,1602,19,2321,6.106.130.952
23/10/2017 19:00,34.23,50868,715,40,0,1565,22,2342,6.106.130.952
23/10/2017 20:00,32.19,49286,740,38,0,1529,21,2328,6.106.130.952
23/10/2017 21:00,31.06,47742,739,36,0,1516,17,2308,6.106.130.952
23/10/2017 22:00,30.01,45644,826,42,0,1488,16,2372,6.106.130.952
23/10/2017 23:00,29.57,43217,853,27,187,1425,14,2506,6.106.130.952
24/10/2017 00:00,29.65,41263,1213,25,182,1370,13,2803,6.106.130.952
24/10/2017 01:00,29.49,40195,1223,23,177,1376,12,2811,6.106.130.952
24/10/2017 02:00,29,39828,1287,22,172,1399,13,2893,6.106.130.952
24/10/2017 03:00,28.92,39924,1440,22,164,1464,12,3102,6.106.130.952
24/10/2017 04:00,29.14,40484,1625,22,157,1558,12,3374,6.106.130.952
24/10/2017 05:00,29.89,42552,1789,23,148,1650,12,3622,6.106.130.952
24/10/2017 06:00,30.99,46600,1922,24,143,1760,12,3861,6.106.130.952
24/10/2017 07:00,32.37,50173,1997,25,138,1899,12,4071,6.106.130.952
24/10/2017 08:00,33.95,51293,2065,24,134,1949,13,4185,6.106.130.952
24/10/2017 09:00,33.26,51208,2223,24,129,1960,14,4350,6.106.130.952
24/10/2017 10:00,32.49,51246,2424,23,122,2032,15,4616,6.106.130.952
24/10/2017 11:00,31.94,51013,2615,22,120,2092,17,4866,6.106.130.952
24/10/2017 12:00,31.54,50592,2674,23,112,2210,25,5044,6.106.130.952
24/10/2017 13:00,31.34,50387,2757,23,105,2326,24,5235,6.106.130.952
24/10/2017 14:00,31.27,50197,2653,24,100,2469,23,5269,6.106.130.952
24/10/2017 15:00,31.3,50304,2547,32,100,2652,25,5356,6.106.130.952
24/10/2017 16:00,31.34,50537,2408,38,105,3075,25,5651,6.106.130.952
24/10/2017 17:00,31.9,51450,2260,47,114,3295,26,5742,6.106.130.952
24/10/2017 18:00,31.89,51910,2086,56,130,3570,22,5864,6.106.130.952
24/10/2017 19:00,31.62,51359,2035,63,153,3703,24,5978,6.106.130.952
24/10/2017 20:00,30.52,49710,2106,70,170,3765,30,6141,6.106.130.952
24/10/2017 21:00,29.84,48010,2217,74,181,3874,38,6384,6.106.130.952
24/10/2017 22:00,29.05,45687,2369,89,188,3946,33,6625,6.106.130.952
24/10/2017 23:00,27.19,43141,2408,73,196,3535,27,6239,6.106.130.952
25/10/2017 00:00,25.87,41048,2354,76,206,4255,26,6917,6.106.130.952
25/10/2017 01:00,21.95,39924,2297,82,216,4191,28,6814,6.106.130.952
25/10/2017 02:00,21.12,39480,2113,89,225,4121,29,6577,6.106.130.952
25/10/2017 03:00,21.79,39498,1860,96,239,4022,34,6251,6.106.130.952
25/10/2017 04:00,23.98,40041,1647,102,254,3952,34,5989,6.106.130.952
25/10/2017 05:00,27.37,42123,1441,109,267,3793,30,5640,6.106.130.952
25/10/2017 06:00,29.83,46090,1246,120,287,3656,36,5345,6.106.130.952
25/10/2017 07:00,31.83,49797,1181,131,302,3445,43,5102,6.106.130.952
25/10/2017 08:00,31.93,50551,1307,141,317,3319,46,5130,6.106.130.952
25/10/2017 09:00,31.1,50468,1688,152,334,3196,47,5417,6.106.130.952
25/10/2017 10:00,30.59,50491,1943,163,350,3092,49,5597,6.106.130.952
25/10/2017 11:00,30.29,50256,2273,168,364,2987,52,5844,6.106.130.952
25/10/2017 12:00,29.93,49834,2503,174,371,2902,54,6004,6.106.130.952
25/10/2017 13:00,29.75,49583,2769,196,375,2810,55,6205,6.106.130.952
25/10/2017 14:00,29.95,49369,3035,201,380,2819,56,6491,6.106.130.952
25/10/2017 15:00,29.89,49234,3090,208,380,2859,58,6595,6.106.130.952
25/10/2017 16:00,30.06,49502,2918,215,380,2906,58,6477,6.106.130.952
25/10/2017 17:00,30.88,50286,2861,220,378,2948,60,6467,6.106.130.952
25/10/2017 18:00,31.59,50569,2763,224,373,2937,62,6359,6.106.130.952
25/10/2017 19:00,30.88,50066,2758,224,364,2959,61,6366,6.106.130.952
25/10/2017 20:00,29.87,48565,2773,222,357,2995,52,6399,6.106.130.952
25/10/2017 21:00,29.43,47026,2749,217,344,2985,45,6340,6.106.130.952
25/10/2017 22:00,28.22,44848,2727,200,337,2987,45,6296,6.106.130.952
25/10/2017 23:00,27.1,42378,2594,210,365,2834,52,6055,6.106.130.952
26/10/2017 00:00,26.27,40252,2595,201,378,2774,65,6013,6.106.130.952
26/10/2017 01:00,25.12,39222,2522,184,388,2738,65,5897,6.106.130.952
26/10/2017 02:00,25.04,38971,2464,158,393,2625,61,5701,6.106.130.952
26/10/2017 03:00,25.39,39074,2402,133,390,2532,61,5518,6.106.130.952
26/10/2017 04:00,26.38,39662,2391,115,385,2413,59,5363,6.106.130.952
26/10/2017 05:00,28.47,41765,2385,98,378,2269,56,5186,6.106.130.952
26/10/2017 06:00,29.77,45896,2238,81,371,2144,52,4886,6.106.130.952
26/10/2017 07:00,31.82,49795,2061,68,363,2025,51,4568,6.106.130.952
26/10/2017 08:00,32.93,50931,2051,63,354,1898,49,4415,6.106.130.952
26/10/2017 09:00,31.92,50907,2120,61,355,1801,47,4384,6.106.130.952
26/10/2017 10:00,31.49,50833,2328,55,357,1718,48,4506,6.106.130.952
26/10/2017 11:00,31.03,50464,2586,51,358,1670,45,4710,6.106.130.952
26/10/2017 12:00,30.73,49912,2818,48,357,1638,43,4904,6.106.130.952
26/10/2017 13:00,30.65,49538,3005,42,355,1507,40,4949,6.106.130.952
26/10/2017 14:00,30.47,49263,3122,36,352,1402,38,4950,6.106.130.952
26/10/2017 15:00,30.34,49250,3175,33,339,1283,33,4863,6.106.130.952
26/10/2017 16:00,30.44,49694,3180,33,318,1261,20,4812,6.106.130.952
26/10/2017 17:00,31.51,50695,3271,32,303,1153,12,4771,6.106.130.952
26/10/2017 18:00,31.97,51005,3302,30,276,1117,11,4736,6.106.130.952
26/10/2017 19:00,31.61,50615,3326,30,248,1087,9,4700,6.106.130.952
26/10/2017 20:00,30,49150,3363,32,217,1092,7,4711,6.106.130.952
26/10/2017 21:00,29.6,47558,3393,36,183,1117,6,4735,6.106.130.952
26/10/2017 22:00,29.05,45370,3454,39,151,1140,6,4790,6.106.130.952
26/10/2017 23:00,27.64,42868,3471,50,95,1061,6,4683,6.106.130.952
27/10/2017 00:00,26.6,40401,3358,46,75,1095,5,4579,6.106.130.952
27/10/2017 01:00,25.59,39364,3339,44,60,1163,5,4611,6.106.130.952
27/10/2017 02:00,25.63,39089,3207,44,50,1260,5,4566,6.106.130.952
27/10/2017 03:00,25.42,39311,3095,47,40,1382,5,4569,6.106.130.952
27/10/2017 04:00,26.03,40078,3021,52,35,1485,5,4598,6.106.130.952
27/10/2017 05:00,27.99,42290,2895,56,30,1537,5,4523,6.106.130.952
27/10/2017 06:00,29.76,46357,2711,58,30,1619,5,4423,6.106.130.952
27/10/2017 07:00,31.62,50084,2474,54,30,1647,6,4211,6.106.130.952
27/10/2017 08:00,32.22,51520,2206,49,35,1607,5,3902,6.106.130.952
27/10/2017 09:00,32.05,51570,2074,44,40,1600,5,3763,6.106.130.952
27/10/2017 10:00,32.08,51531,1942,38,55,1606,6,3647,6.106.130.952
27/10/2017 11:00,31.32,50995,1884,31,65,1738,6,3724,6.106.130.952
27/10/2017 12:00,29.87,50209,1932,29,80,1847,6,3894,6.106.130.952
27/10/2017 13:00,29.31,49508,2142,28,85,1904,6,4165,6.106.130.952
27/10/2017 14:00,28.85,48869,2303,29,85,2020,8,4445,6.106.130.952
27/10/2017 15:00,28.56,48462,2507,29,85,2217,8,4846,6.106.130.952
27/10/2017 16:00,29.35,48819,2685,24,85,2390,8,5192,6.106.130.952
27/10/2017 17:00,29.7,49727,2762,14,80,2602,7,5465,6.106.130.952
27/10/2017 18:00,29.97,50187,2882,9,70,2796,7,5764,6.106.130.952
27/10/2017 19:00,29.42,49240,3075,6,60,2944,8,6093,6.106.130.952
27/10/2017 20:00,28.08,47284,3221,5,55,3076,8,6365,6.106.130.952
27/10/2017 21:00,26.91,45653,3272,5,50,3234,8,6569,6.106.130.952
27/10/2017 22:00,25.75,43830,3307,12,50,3364,7,6740,6.106.130.952
27/10/2017 23:00,20.1,41826,3440,9,25,2934,6,6414,6.106.130.952
28/10/2017 00:00,23.66,39595,3869,16,24,3764,6,7679,6.106.130.952
28/10/2017 01:00,24.29,38492,3949,28,25,3850,6,7858,6.106.130.952
28/10/2017 02:00,22.06,37974,3973,43,29,3882,7,7934,6.106.130.952
28/10/2017 03:00,20.05,37760,3667,59,39,3928,7,7700,6.106.130.952
28/10/2017 04:00,15.94,37794,3814,78,56,3914,9,7871,6.106.130.952
28/10/2017 05:00,19.09,38400,3588,95,80,3899,10,7672,6.106.130.952
28/10/2017 06:00,23.15,39564,3663,110,121,3852,13,7759,6.106.130.952
28/10/2017 07:00,24.9,40998,4277,122,169,3870,15,8453,6.106.130.952
28/10/2017 08:00,25.2,42503,4302,134,200,3912,17,8565,6.106.130.952
28/10/2017 09:00,25.99,44113,4137,144,237,4061,20,8599,6.106.130.952
28/10/2017 10:00,26.15,45100,3869,151,262,4047,16,8345,6.106.130.952
28/10/2017 11:00,25.96,45248,4069,152,290,4111,15,8637,6.106.130.952
28/10/2017 12:00,25.04,44837,3790,151,302,4158,18,8419,6.106.130.952
28/10/2017 13:00,23.52,44468,3825,143,311,4094,20,8393,6.106.130.952
28/10/2017 14:00,23.34,44052,3712,130,307,3913,16,8078,6.106.130.952
28/10/2017 15:00,23.46,44092,3794,113,274,3755,12,7948,6.106.130.952
28/10/2017 16:00,25.3,44804,3640,101,244,3541,11,7537,6.106.130.952
28/10/2017 17:00,27.37,46319,3881,92,235,3346,10,7564,6.106.130.952
28/10/2017 18:00,28.11,47107,3781,85,247,3120,11,7244,6.106.130.952
28/10/2017 19:00,27.61,46267,3745,77,249,2886,12,6969,6.106.130.952
28/10/2017 20:00,26.6,44775,3938,71,247,2804,13,7073,6.106.130.952
28/10/2017 21:00,24.33,43685,3701,67,235,2747,18,6768,6.106.130.952
28/10/2017 22:00,22.09,42437,3845,63,226,2761,17,6912,6.106.130.952
28/10/2017 23:00,20.06,40991,3660,58,271,2157,24,6170,6.106.130.952
29/10/2017 00:00,23.23,39285,3823,61,241,2833,24,6982,6.106.130.952
29/10/2017 01:00,20.07,38474,3670,68,193,3186,16,7133,6.106.130.952
29/10/2017 02:00,17.07,37837,3600.5,69,169,3391,16,7245.5,6.106.130.952
29/10/2017 03:00,10.75,38162,3606,67,109,3749,16,7547,6.106.130.952
29/10/2017 04:00,15.14,38404,3645,71,64,4107,14,7901,6.106.130.952
29/10/2017 05:00,14.93,39030,3667,72,50,4402,11,8202,6.106.130.952
29/10/2017 06:00,20,39876,3654,73,47,4571,9,8354,6.106.130.952
29/10/2017 07:00,20.92,40901,3660,79,55,4668,11,8473,6.106.130.952
29/10/2017 08:00,21.01,42427,4026,75,62,4750,16,8929,6.106.130.952
29/10/2017 09:00,25.36,43899,3656,72,78,4753,16,8575,6.106.130.952
29/10/2017 10:00,25.91,44737,3618,73,139,4768,22,8620,6.106.130.952
29/10/2017 11:00,25.28,44989,3663,76,175,4816,33,8763,6.106.130.952
29/10/2017 12:00,24.5,44892,3784,79,227,4857,40,8987,6.106.130.952
29/10/2017 13:00,22.81,44717,3785,86,289,4883,47,9090,6.106.130.952
29/10/2017 14:00,21.96,44785,3667,98,314,4852,53,8984,6.106.130.952
29/10/2017 15:00,23.78,45223,3472,106,328,4773,58,8737,6.106.130.952
29/10/2017 16:00,25.54,46364,3288,112,348,4800,60,8608,6.106.130.952
29/10/2017 17:00,27.14,47919,3157,119,357,4935,61,8629,6.106.130.952
29/10/2017 18:00,27.63,48417,3051,125,362,5000,63,8601,6.106.130.952
29/10/2017 19:00,28.23,48073,2894,129,371,5012,65,8471,6.106.130.952
29/10/2017 20:00,25.35,47045,2847,135,375,5019,66,8442,6.106.130.952
29/10/2017 21:00,23.92,46159,2794,142,375,5013,65,8389,6.106.130.952
29/10/2017 22:00,22.44,44614,2772,149,374,4986,65,8346,6.106.130.952
29/10/2017 23:00,20.03,42672,2745,169,373,4966,65,8318,6.106.130.952
30/10/2017 00:00,19.29,41122,2918,173,333,4346,44,7814,608.125
30/10/2017 01:00,17.3,40506,2844,182,321,5034,48,8429,608.125
30/10/2017 02:00,17.27,40260,2757,186,317,5016,52,8328,608.125
30/10/2017 03:00,17.32,40579,2668,188,322,4957,56,8191,608.125
30/10/2017 04:00,19.55,41708,2669,190,330,4895,58,8142,608.125
30/10/2017 05:00,25.51,44091,2661,194,337,4865,60,8117,608.125
30/10/2017 06:00,28.36,48717,2712,197,340,4807,61,8117,608.125
30/10/2017 07:00,30.24,52530,2641,200,344,4645,61,7891,608.125
30/10/2017 08:00,30.9,53475,2473,202,348,4474,60,7557,608.125
30/10/2017 09:00,30.78,53285,2087,206,360,4234,59,6946,608.125
30/10/2017 10:00,30.04,52890,1980,208,371,4114,61,6734,608.125
30/10/2017 11:00,29.74,52410,1883,209,380,4055,61,6588,608.125
30/10/2017 12:00,29.93,51656,1825,210,381,3829,60,6305,608.125
30/10/2017 13:00,30.25,51481,1813,212,381,3657,56,6119,608.125
30/10/2017 14:00,30.59,51428,1824,216,379,3467,58,5944,608.125
30/10/2017 15:00,30.57,51736,1837,220,375,3315,59,5806,608.125
30/10/2017 16:00,31.14,52654,1769,225,366,3146,59,5565,608.125
30/10/2017 17:00,32.71,53984,1666,228,363,3034,59,5350,608.125
30/10/2017 18:00,32.24,54048,1616,228,359,2861,59,5123,608.125
30/10/2017 19:00,30.99,53259,1502,227,355,2651,60,4795,608.125
30/10/2017 20:00,29.97,51601,1401,226,351,2375,57,4410,608.125
30/10/2017 21:00,29.75,50045,1271,227,344,2140,52,4034,608.125
30/10/2017 22:00,29.3,48077,1142,226,337,1918,46,3669,608.125
30/10/2017 23:00,28.5,45719,1039,202,329,1713,43,3326,608.125
31/10/2017 00:00,28.8,43356,820,221,313,1408,41,2803,608.125
31/10/2017 01:00,28.64,42503,763,221,309,1536,40,2869,608.125
31/10/2017 02:00,28.61,42248,738,221,301,1402,39,2701,608.125
31/10/2017 03:00,28.44,42396,740,220,292,1331,39,2622,608.125
31/10/2017 04:00,28.94,43024,799,219,284,1313,37,2652,608.125
31/10/2017 05:00,29.88,45066,871,213,274,1370,38,2766,608.125
31/10/2017 06:00,31.27,49075,969,205,261,1431,39,2905,608.125
31/10/2017 07:00,33.94,52652,1001,192,243,1403,36,2875,608.125
31/10/2017 08:00,35.57,53319,926,178,237,1332,30,2703,608.125
31/10/2017 09:00,34.38,53025,802,167,234,1154,25,2382,608.125
31/10/2017 10:00,34,52854,836,156,234,1116,21,2363,608.125
31/10/2017 11:00,33.47,52375,864,139,243,1167,24,2437,608.125
31/10/2017 12:00,32.64,51849,884,123,253,1199,19,2478,608.125
31/10/2017 13:00,32,51622,922,110,253,1305,20,2610,608.125
31/10/2017 14:00,31.85,51401,955,99,253,1387,23,2717,608.125
31/10/2017 15:00,31.98,51706,1004,93,240,1445,32,2814,608.125
31/10/2017 16:00,33.19,52483,1021,88,235,1496,32,2872,608.125
31/10/2017 17:00,34.54,53642,995,84,235,1512,25,2851,608.125
31/10/2017 18:00,34.74,53469,960,80,235,1528,18,2821,608.125
31/10/2017 19:00,33.54,52628,884,71,230,1579,11,2775,608.125
31/10/2017 20:00,31.24,50999,897,64,220,1524,8,2713,608.125
31/10/2017 21:00,30.4,49371,940,58,209,1443,5,2655,608.125
31/10/2017 22:00,29.67,47146,963,51,199,1370,4,2587,608.125
31/10/2017 23:00,28.95,44740,942,43,189,1288,4,2466,608.125
01/11/2017 00:00,28.29,42656,1169,23,85,1108,7,2392,608.125
01/11/2017 01:00,27.47,41570,1251,22,85,1235,9,2602,608.125
01/11/2017 02:00,26.76,41201,1348,24,85,1232,11,2700,608.125
01/11/2017 03:00,26.26,41217,1440,26,95,1221,11,2793,608.125
01/11/2017 04:00,26.78,41767,1626,27,95,1194,15,2957,608.125
01/11/2017 05:00,27.89,43725,1811,29,115,1173,21,3149,608.125
01/11/2017 06:00,29.38,47577,1972,28,125,1178,19,3322,608.125
01/11/2017 07:00,31.12,51222,2184,27,130,1155,19,3515,608.125
01/11/2017 08:00,32,51830,2349,22,130,1137,18,3656,608.125
01/11/2017 09:00,31.46,51636,2541,19,135,1171,17,3883,608.125
01/11/2017 10:00,30.98,51528,2828,18,140,1286,20,4292,608.125
01/11/2017 11:00,30.28,51265,3156,18,150,1391,24,4739,608.125
01/11/2017 12:00,29.92,50795,3420,18,150,1544,23,5155,608.125
01/11/2017 13:00,29.35,50366,3517,18,135,1739,21,5430,608.125
01/11/2017 14:00,29.36,50176,3559,17,130,1981,21,5708,608.125
01/11/2017 15:00,29.52,50293,3562,17,120,2293,19,6011,608.125
01/11/2017 16:00,29.96,50819,3551,18,120,2606,17,6312,608.125
01/11/2017 17:00,30.59,51564,3564,21,125,2813,15,6538,608.125
01/11/2017 18:00,30.24,51238,3539,24,130,2954,13,6660,608.125
01/11/2017 19:00,29.39,50339,3485,27,135,2992,11,6650,608.125
01/11/2017 20:00,28.61,48704,3537,30,135,3026,11,6739,608.125
01/11/2017 21:00,27.51,47127,3567,34,140,3010,12,6763,608.125
01/11/2017 22:00,26.41,44922,3577,40,150,2932,12,6711,608.125
01/11/2017 23:00,23.95,42481,3553,37,180,2840,11,6621,608.125
02/11/2017 00:00,22.98,40830,3338,34,200,2744,6,6322,608.125
02/11/2017 01:00,20.72,39748,3283,37,210,2669,6,6205,608.125
02/11/2017 02:00,19.75,39481,3206,40,220,2570,7,6043,608.125
02/11/2017 03:00,19.5,39574,3154,42,260,2426,8,5890,608.125
02/11/2017 04:00,24.37,40314,3216,47,270,2340,10,5883,608.125
02/11/2017 05:00,26.37,42390,3177,50,270,2302,11,5810,608.125
02/11/2017 06:00,28.56,46379,2765,51,270,2309,10,5405,608.125
02/11/2017 07:00,29.69,50022,2608,51,265,2409,9,5342,608.125
02/11/2017 08:00,29.92,50778,2569,49,260,2503,8,5389,608.125
02/11/2017 09:00,29.43,50581,2890,46,250,2695,7,5888,608.125
02/11/2017 10:00,29.25,50417,2933,42,225,2927,7,6134,608.125
02/11/2017 11:00,29.1,50140,2887,39,211,3082,6,6225,608.125
02/11/2017 12:00,29.21,49697,2804,37,196,3176,6,6219,608.125
02/11/2017 13:00,29.24,49448,2698,36,175,3202,5,6116,608.125
02/11/2017 14:00,29.36,49312,2562,38,155,3117,5,5877,608.125
02/11/2017 15:00,29.44,49616,2394,39,130,2986,5,5554,608.125
02/11/2017 16:00,30.21,50447,2147,41,130,2958,6,5282,608.125
02/11/2017 17:00,31.51,51530,1874,40,130,2825,5,4874,608.125
02/11/2017 18:00,31.52,51508,1661,36,110,2733,6,4546,608.125
02/11/2017 19:00,30.72,50942,1388,33,85,2659,8,4173,608.125
02/11/2017 20:00,29.88,49607,1185,29,80,2509,9,3812,608.125
02/11/2017 21:00,29.63,48134,989,27,75,2346,9,3446,608.125
02/11/2017 22:00,29.29,45996,786,24,70,2194,9,3083,608.125
02/11/2017 23:00,28.85,43502,610,20,70,2032,9,2741,608.125
03/11/2017 00:00,28.3,40902,475,7,65,1718,10,2275,608.125
03/11/2017 01:00,27.95,40068,466,7,65,1625,11,2174,608.125
03/11/2017 02:00,27.89,39974,502,8,65,1637,9,2221,608.125
03/11/2017 03:00,27.86,40358,559,11,65,1668,7,2310,608.125
03/11/2017 04:00,28.32,41200,627,15,65,1706,7,2420,608.125
03/11/2017 05:00,29.15,43487,681,23,60,1797,7,2568,608.125
03/11/2017 06:00,29.94,47305,787,29,55,1957,7,2835,608.125
03/11/2017 07:00,31.66,50584,835,32,50,2126,6,3049,608.125
03/11/2017 08:00,33.48,51555,861,26,50,2153,5,3095,608.125
03/11/2017 09:00,31.77,51298,888,21,50,2184,6,3149,608.125
03/11/2017 10:00,30.86,50996,994,16,50,2207,6,3273,608.125
03/11/2017 11:00,30.51,50368,1108,15,45,2273,6,3447,608.125
03/11/2017 12:00,30.01,49562,1240,17,45,2353,6,3661,608.125
03/11/2017 13:00,29.65,48886,1282,20,45,2468,6,3821,608.125
03/11/2017 14:00,29.5,48373,1216,21,50,2641,7,3935,608.125
03/11/2017 15:00,29.43,48587,1132,22,55,2864,7,4080,608.125
03/11/2017 16:00,29.78,49717,1088,23,55,3034,8,4208,608.125
03/11/2017 17:00,30.27,50465,1109,30,50,3134,8,4331,608.125
03/11/2017 18:00,30.1,49895,1211,42,45,3247,8,4553,608.125
03/11/2017 19:00,29.13,48532,1304,53,45,3268,8,4678,608.125
03/11/2017 20:00,28.46,46604,1366,64,45,3263,8,4746,608.125
03/11/2017 21:00,28.15,45343,1405,76,45,3279,9,4814,608.125
03/11/2017 22:00,27.9,43582,1437,86,55,3193,10,4781,608.125
03/11/2017 23:00,27.1,41545,1491,102,65,3069,12,4739,608.125
04/11/2017 00:00,26.96,39600,1946,105,125,3141,16,5333,608.125
04/11/2017 01:00,26.56,38647,1864,108,130,3027,17,5146,608.125
04/11/2017 02:00,26.17,38175,1730,113,130,2995,19,4987,608.125
04/11/2017 03:00,26.22,38124,1666,124,130,2943,26,4889,608.125
04/11/2017 04:00,26.32,38354,1664,127,130,2889,25,4835,608.125
04/11/2017 05:00,26.94,39020,1649,128,133,2842,20,4772,608.125
04/11/2017 06:00,27.52,40014,1570,130,141,2803,19,4663,608.125
04/11/2017 07:00,27.67,41257,1554,129,152,2692,20,4547,608.125
04/11/2017 08:00,28.13,42716,1657,135,160,2536,20,4508,608.125
04/11/2017 09:00,28.47,44187,1850,145,166,2439,19,4619,608.125
04/11/2017 10:00,28.69,44992,1911,151,173,2301,17,4553,608.125
04/11/2017 11:00,28.66,44847,1866,152,173,2163,19,4373,608.125
04/11/2017 12:00,28.57,44390,1829,154,173,1993,17,4166,608.125
04/11/2017 13:00,28.42,44039,1814,154,161,1877,16,4022,608.125
04/11/2017 14:00,28.44,43890,1822,152,156,1871,14,4015,608.125
04/11/2017 15:00,28.45,44535,1827,148,148,1943,16,4082,608.125
04/11/2017 16:00,28.88,45928,1917,144,147,2093,18,4319,608.125
04/11/2017 17:00,29.44,47100,2120,143,147,2190,15,4615,608.125
04/11/2017 18:00,29.25,46768,2339,146,148,2391,18,5042,608.125
04/11/2017 19:00,28.79,45460,2323,147,152,2493,19,5134,608.125
04/11/2017 20:00,28.26,43917,2275,150,157,2406,20,5008,608.125
04/11/2017 21:00,27.05,42751,2184,149,158,2299,20,4810,608.125
04/11/2017 22:00,26.53,41506,1994,146,159,2166,20,4485,608.125
04/11/2017 23:00,24.96,40099,1817,131,159,1950,19,4076,608.125
05/11/2017 00:00,25.02,38878,2156,134,158,1993,16,4457,608.125
05/11/2017 01:00,24.34,37842,2052,132,160,1882,14,4240,608.125
05/11/2017 02:00,23.6,36579,2029,120,165,1801,13,4128,608.125
05/11/2017 03:00,23,37041,2358,107,168,1735,12,4380,608.125
05/11/2017 04:00,23.24,37082,2390,104,173,1723,13,4403,608.125
05/11/2017 05:00,24.4,37468,2147,106,179,1706,14,4152,608.125
05/11/2017 06:00,24.97,38188,1950,111,193,1759,16,4029,608.125
05/11/2017 07:00,25.46,39025,1778,113,198,1751,16,3856,608.125
05/11/2017 08:00,27.62,40553,1562,113,198,1739,18,3630,608.125
05/11/2017 09:00,28.36,42124,1474,114,190,1709,21,3508,608.125
05/11/2017 10:00,28.76,43113,1366,111,175,1656,21,3329,608.125
05/11/2017 11:00,28.79,43468,1273,108,168,1653,22,3224,608.125
05/11/2017 12:00,28.61,43388,1173,103,158,1655,22,3111,608.125
05/11/2017 13:00,28.57,43236,1083,102,148,1632,22,2987,608.125
05/11/2017 14:00,28.61,43350,1015,103,142,1604,18,2882,608.125
05/11/2017 15:00,28.85,44010,943,109,142,1663,17,2874,608.125
05/11/2017 16:00,29.52,45289,902,116,142,1681,16,2857,608.125
05/11/2017 17:00,30.23,46588,887,123,142,1705,16,2873,608.125
05/11/2017 18:00,30.05,46681,857,129,142,1755,18,2901,608.125
05/11/2017 19:00,29.59,46065,821,128,142,1783,19,2893,608.125
05/11/2017 20:00,29.08,44862,852,123,142,1807,18,2942,608.125
05/11/2017 21:00,28.75,43893,838,115,142,1807,18,2920,608.125
05/11/2017 22:00,28.38,42357,826,109,136,1798,18,2887,608.125
05/11/2017 23:00,28.03,40392,828,94,132,1817,18,2889,608.125
06/11/2017 00:00,27.79,38804,957,88,140,1702,12,2899,5.999.702.381
06/11/2017 01:00,27.14,38000,1031,87,136,1764,11,3029,5.999.702.381
06/11/2017 02:00,26.96,37917,1125,91,132,1832,11,3191,5.999.702.381
06/11/2017 03:00,26.93,38102,1232,96,126,1889,10,3353,5.999.702.381
06/11/2017 04:00,27.41,39028,1404,102,119,2013,12,3650,5.999.702.381
06/11/2017 05:00,28.24,41412,1390,109,113,2158,12,3782,5.999.702.381
06/11/2017 06:00,29.28,45814,1307,115,110,2291,13,3836,5.999.702.381
06/11/2017 07:00,30.59,49731,1165,115,105,2328,12,3725,5.999.702.381
06/11/2017 08:00,31.45,50995,1089,112,96,2308,11,3616,5.999.702.381
06/11/2017 09:00,31.35,50937,1037,106,82,2314,9,3548,5.999.702.381
06/11/2017 10:00,31.28,50712,1015,89,73,2262,9,3448,5.999.702.381
06/11/2017 11:00,30.7,50219,1042,69,63,2171,8,3353,5.999.702.381
06/11/2017 12:00,30.34,49574,1067,60,59,2054,7,3247,5.999.702.381
06/11/2017 13:00,30.28,49318,1027,58,54,1963,5,3107,5.999.702.381
06/11/2017 14:00,30.39,49305,906,56,50,1984,5,3001,5.999.702.381
06/11/2017 15:00,30.94,49799,726,60,48,2027,6,2867,5.999.702.381
06/11/2017 16:00,31.95,50848,584,65,48,2090,6,2793,5.999.702.381
06/11/2017 17:00,33.41,52068,479,64,48,2180,5,2776,5.999.702.381
06/11/2017 18:00,32.64,52002,415,60,49,2219,5,2748,5.999.702.381
06/11/2017 19:00,31.42,51128,352,59,51,2260,5,2727,5.999.702.381
06/11/2017 20:00,30.69,49662,312,60,51,2303,5,2731,5.999.702.381
06/11/2017 21:00,29.84,48320,309,59,49,2289,5,2711,5.999.702.381
06/11/2017 22:00,29.03,46191,324,55,45,2267,6,2697,5.999.702.381
06/11/2017 23:00,28.25,43691,358,55,39,2263,5,2720,5.999.702.381
07/11/2017 00:00,28.41,41599,555,60,36,2336,6,2993,5.999.702.381
07/11/2017 01:00,28.03,40759,596,59,29,2351,6,3041,5.999.702.381
07/11/2017 02:00,27.9,40492,622,57,24,2295,6,3004,5.999.702.381
07/11/2017 03:00,27.96,40655,664,53,17,2182,6,2922,5.999.702.381
07/11/2017 04:00,28.36,41411,851,49,15,2152,6,3073,5.999.702.381
07/11/2017 05:00,29.21,43752,1006,43,13,2009,6,3077,5.999.702.381
07/11/2017 06:00,29.98,47843,1171,39,12,1894,5,3121,5.999.702.381
07/11/2017 07:00,32.33,51592,1244,34,12,1831,5,3126,5.999.702.381
07/11/2017 08:00,34.14,52360,1239,29,12,1651,5,2936,5.999.702.381
07/11/2017 09:00,32.28,52008,1314,25,12,1503,5,2859,5.999.702.381
07/11/2017 10:00,31.79,51841,1353,22,12,1446,5,2838,5.999.702.381
07/11/2017 11:00,31.62,51212,1316,20,12,1287,5,2640,5.999.702.381
07/11/2017 12:00,31.76,50530,1288,20,12,1172,5,2497,5.999.702.381
07/11/2017 13:00,31.67,50205,1327,21,14,1070,5,2437,5.999.702.381
07/11/2017 14:00,31.59,50220,1374,24,15,1132,5,2550,5.999.702.381
07/11/2017 15:00,31.71,51021,1388,30,19,1316,5,2758,5.999.702.381
07/11/2017 16:00,33.15,52121,1441,38,24,1384,5,2892,5.999.702.381
07/11/2017 17:00,35.27,53174,1484,42,30,1413,5,2974,5.999.702.381
07/11/2017 18:00,34.55,52899,1506,44,40,1493,5,3088,5.999.702.381
07/11/2017 19:00,31.78,51980,1475,45,49,1608,5,3182,5.999.702.381
07/11/2017 20:00,30.78,50299,1457,45,60,1621,6,3189,5.999.702.381
07/11/2017 21:00,29.94,48721,1432,46,64,1683,5,3230,5.999.702.381
07/11/2017 22:00,29.06,46420,1365,46,68,1713,6,3198,5.999.702.381
07/11/2017 23:00,28.3,43909,1315,51,70,1743,7,3186,5.999.702.381
08/11/2017 00:00,28.8,42252,1045,54,70,1775,8,2952,5.999.702.381
08/11/2017 01:00,28.52,41306,944,53,72,1861,7,2937,5.999.702.381
08/11/2017 02:00,28.46,40978,802,49,74,1853,7,2785,5.999.702.381
08/11/2017 03:00,28.51,41102,725,47,77,1856,7,2712,5.999.702.381
08/11/2017 04:00,28.97,41827,592,44,81,1863,8,2588,5.999.702.381
08/11/2017 05:00,29.55,44176,477,40,85,1836,8,2446,5.999.702.381
08/11/2017 06:00,30.7,48487,412,37,88,1864,7,2408,5.999.702.381
08/11/2017 07:00,35.36,52238,405,35,90,1909,8,2447,5.999.702.381
08/11/2017 08:00,39.91,53498,374,34,89,1935,8,2440,5.999.702.381
08/11/2017 09:00,34.81,52995,310,34,86,1888,8,2326,5.999.702.381
08/11/2017 10:00,33.14,52790,262,31,85,1880,6,2264,5.999.702.381
08/11/2017 11:00,32.38,52403,219,32,85,1814,6,2156,5.999.702.381
08/11/2017 12:00,32.59,52026,188,32,90,1710,6,2026,5.999.702.381
08/11/2017 13:00,32.75,51233,170,32,99,1702,6,2009,5.999.702.381
08/11/2017 14:00,32.67,51164,161,31,105,1735,6,2038,5.999.702.381
08/11/2017 15:00,32.98,51638,139,32,109,1780,7,2067,5.999.702.381
08/11/2017 16:00,35.15,52809,124,35,112,1851,7,2129,5.999.702.381
08/11/2017 17:00,37.3,53656,138,37,113,1889,7,2184,5.999.702.381
08/11/2017 18:00,35.26,53120,169,42,112,1952,7,2282,5.999.702.381
08/11/2017 19:00,32.03,52022,254,48,114,2030,8,2454,5.999.702.381
08/11/2017 20:00,30.85,50311,250,52,115,2072,7,2496,5.999.702.381
08/11/2017 21:00,30.18,48729,232,57,112,2084,7,2492,5.999.702.381
08/11/2017 22:00,29.37,46373,257,62,109,2152,8,2588,5.999.702.381
08/11/2017 23:00,28.57,43835,360,74,99,2248,8,2789,5.999.702.381
09/11/2017 00:00,29.02,41474,470,75,105,2277,8,2935,5.999.702.381
09/11/2017 01:00,28.44,40437,544,76,95,2379,9,3103,5.999.702.381
09/11/2017 02:00,27.99,40171,663,78,90,2525,10,3366,5.999.702.381
09/11/2017 03:00,27.61,40276,781,80,90,2742,11,3704,5.999.702.381
09/11/2017 04:00,28.12,41043,1022,84,85,2972,10,4173,5.999.702.381
09/11/2017 05:00,28.96,43491,1393,90,85,3106,10,4684,5.999.702.381
09/11/2017 06:00,30.29,48191,1744,95,85,3416,11,5351,5.999.702.381
09/11/2017 07:00,30.81,51999,2034,99,85,3697,12,5927,5.999.702.381
09/11/2017 08:00,30.8,52424,2347,100,85,3900,12,6444,5.999.702.381
09/11/2017 09:00,30.35,52133,2737,104,85,4098,14,7038,5.999.702.381
09/11/2017 10:00,30.06,52061,3115,113,85,4298,18,7629,5.999.702.381
09/11/2017 11:00,29.74,51769,3290,121,90,4460,18,7979,5.999.702.381
09/11/2017 12:00,29.6,51411,3509,132,95,4583,22,8341,5.999.702.381
09/11/2017 13:00,29.6,50975,3398,144,95,4684,23,8344,5.999.702.381
09/11/2017 14:00,29.77,50924,3011,156,95,4692,26,7980,5.999.702.381
09/11/2017 15:00,30.03,51296,2816,167,95,4556,25,7659,5.999.702.381
09/11/2017 16:00,30.32,52452,2657,179,95,4412,24,7367,5.999.702.381
09/11/2017 17:00,30.6,53214,2524,188,120,4220,24,7076,5.999.702.381
09/11/2017 18:00,30.55,52685,2534,193,130,4050,24,6931,5.999.702.381
09/11/2017 19:00,30.02,51575,2530,195,145,3917,27,6814,5.999.702.381
09/11/2017 20:00,29.42,49877,2374,195,150,3995,30,6744,5.999.702.381
09/11/2017 21:00,28.91,48306,2258,195,155,3995,28,6631,5.999.702.381
09/11/2017 22:00,28.12,45937,2173,193,165,3956,29,6516,5.999.702.381
09/11/2017 23:00,26.03,43264,2057,198,170,3858,32,6315,5.999.702.381
10/11/2017 00:00,26.53,40993,2196,207,205,3993,35,6636,5.999.702.381
10/11/2017 01:00,25.41,40025,2115,197,220,3937,36,6505,5.999.702.381
10/11/2017 02:00,26.07,39871,2100,178,235,3795,33,6341,5.999.702.381
10/11/2017 03:00,26.78,40159,2080,151,240,3725,19,6215,5.999.702.381
10/11/2017 04:00,27.18,40887,2184,135,245,3585,15,6164,5.999.702.381
10/11/2017 05:00,28.92,43289,2385,130,245,3503,12,6275,5.999.702.381
10/11/2017 06:00,30.36,47656,2696,126,235,3326,12,6395,5.999.702.381
10/11/2017 07:00,31.58,51705,3003,118,210,3167,12,6510,5.999.702.381
10/11/2017 08:00,31.73,52367,3203,111,200,2973,12,6499,5.999.702.381
10/11/2017 09:00,30.99,52172,3301,108,195,2878,13,6495,5.999.702.381
10/11/2017 10:00,30.89,52097,3323,100,185,2813,15,6436,5.999.702.381
10/11/2017 11:00,30.74,51621,3416,91,180,2539,18,6244,5.999.702.381
10/11/2017 12:00,30.65,50888,3535,88,170,2354,19,6166,5.999.702.381
10/11/2017 13:00,30.59,50390,3720,85,165,2160,19,6149,5.999.702.381
10/11/2017 14:00,30.32,50030,3859,82,160,2167,19,6287,5.999.702.381
10/11/2017 15:00,30.3,50526,3977,82,165,2109,13,6346,5.999.702.381
10/11/2017 16:00,30.76,51587,4055,86,185,2026,12,6364,5.999.702.381
10/11/2017 17:00,31.2,52392,4047,89,195,1931,13,6275,5.999.702.381
10/11/2017 18:00,30.96,51668,4023,95,225,1796,17,6156,5.999.702.381
10/11/2017 19:00,30.35,50179,4077,105,255,1838,16,6291,5.999.702.381
10/11/2017 20:00,29.42,48104,4026,116,280,1865,21,6308,5.999.702.381
10/11/2017 21:00,28.31,46731,3924,127,305,1931,28,6315,5.999.702.381
10/11/2017 22:00,27.37,44865,3809,135,315,2044,33,6336,5.999.702.381
10/11/2017 23:00,26.01,42913,3768,131,325,2205,38,6467,5.999.702.381
11/11/2017 00:00,27.94,40835,4344,124,0,2379,33,6880,5.999.702.381
11/11/2017 01:00,27.14,39774,4294,125,0,2485,34,6938,5.999.702.381
11/11/2017 02:00,26.93,39379,4275,129,0,2597,32,7033,5.999.702.381
11/11/2017 03:00,26.74,39257,3725,133,0,2733,27,6618,5.999.702.381
11/11/2017 04:00,26.28,39518,3520,134,0,2765,24,6443,5.999.702.381
11/11/2017 05:00,26.24,40289,3452,131,0,2832,17,6432,5.999.702.381
11/11/2017 06:00,27.58,41650,3228,134,0,2890,13,6265,5.999.702.381
11/11/2017 07:00,27.62,43499,3069,139,0,2976,12,6196,5.999.702.381
11/11/2017 08:00,28.45,45105,2901,143,0,3012,15,6071,5.999.702.381
11/11/2017 09:00,28.89,46671,2793,148,0,2991,27,5959,5.999.702.381
11/11/2017 10:00,29.05,47626,3048,153,0,2963,29,6193,5.999.702.381
11/11/2017 11:00,29.03,47468,3325,154,0,2899,32,6410,5.999.702.381
11/11/2017 12:00,28.87,47201,3382,157,0,2860,34,6433,5.999.702.381
11/11/2017 13:00,28.77,46948,3396,160,0,2819,34,6409,5.999.702.381
11/11/2017 14:00,28.88,46972,3361,160,0,2745,30,6296,5.999.702.381
11/11/2017 15:00,29.78,47744,3281,165,0,2641,34,6121,5.999.702.381
11/11/2017 16:00,30.73,49245,3222,167,0,2569,36,5994,5.999.702.381
11/11/2017 17:00,31.17,50474,3159,171,0,2556,37,5923,5.999.702.381
11/11/2017 18:00,30.9,50133,2979,174,0,2543,38,5734,5.999.702.381
11/11/2017 19:00,30.36,48580,2855,170,0,2512,37,5574,5.999.702.381
11/11/2017 20:00,29.9,47026,2780,163,0,2433,36,5412,5.999.702.381
11/11/2017 21:00,29.74,45924,2636,161,0,2334,36,5167,5.999.702.381
11/11/2017 22:00,29.48,44680,2617,158,0,2285,34,5094,5.999.702.381
11/11/2017 23:00,28.29,43337,2679,152,0,2255,36,5122,5.999.702.381
12/11/2017 00:00,28.46,41900,3126,165,359,2094,37,5781,5.999.702.381
12/11/2017 01:00,27.97,40881,3077,164,359,2039,29,5668,5.999.702.381
12/11/2017 02:00,27.82,40090,3057,151,349,2000,23,5580,5.999.702.381
12/11/2017 03:00,27.68,40295,2916,154,343,1966,20,5399,5.999.702.381
12/11/2017 04:00,27.72,40442,2735,150,337,1928,16,5166,5.999.702.381
12/11/2017 05:00,27.9,40910,2441,146,324,1955,15,4881,5.999.702.381
12/11/2017 06:00,28.06,41729,2169,135,307,1948,15,4574,5.999.702.381
12/11/2017 07:00,28.58,42754,1983,126,296,1878,18,4301,5.999.702.381
12/11/2017 08:00,29.57,44378,1784,118,293,1799,22,4016,5.999.702.381
12/11/2017 09:00,30.59,45982,1663,115,282,1709,27,3796,5.999.702.381
12/11/2017 10:00,30.93,46973,1611,114,281,1580,30,3616,5.999.702.381
12/11/2017 11:00,31.04,47024,1289,115,274,1497,32,3207,5.999.702.381
12/11/2017 12:00,30.92,46695,1125,122,276,1414,30,2967,5.999.702.381
12/11/2017 13:00,30.84,46455,1023,127,263,1378,28,2819,5.999.702.381
12/11/2017 14:00,30.85,46750,924,129,254,1440,26,2773,5.999.702.381
12/11/2017 15:00,31.02,47748,824,126,245,1585,20,2800,5.999.702.381
12/11/2017 16:00,31.96,49645,861,120,237,1689,15,2922,5.999.702.381
12/11/2017 17:00,32.69,50999,729,121,228,1745,12,2835,5.999.702.381
12/11/2017 18:00,32.18,50894,742,122,219,1781,10,2874,5.999.702.381
12/11/2017 19:00,31.47,50187,889,122,212,1849,10,3082,5.999.702.381
12/11/2017 20:00,30.94,48711,1020,121,203,1843,8,3195,5.999.702.381
12/11/2017 21:00,30.66,47870,825,122,190,1881,9,3027,5.999.702.381
12/11/2017 22:00,30.23,46353,763,117,158,1915,8,2961,5.999.702.381
12/11/2017 23:00,29.71,44446,741,110,137,1971,8,2967,5.999.702.381
13/11/2017 00:00,29.83,42974,781,111,138,1927,7,2964,5.874.642.857
13/11/2017 01:00,29.66,42164,883,107,133,2004,6,3133,5.874.642.857
13/11/2017 02:00,29.62,41986,1316,102,123,2018,7,3566,5.874.642.857
13/11/2017 03:00,29.63,42250,1399,98,108,2029,7,3641,5.874.642.857
13/11/2017 04:00,29.76,43225,1465,88,83,2105,7,3748,5.874.642.857
13/11/2017 05:00,30.9,45672,1442,81,75,2137,6,3741,5.874.642.857
13/11/2017 06:00,33.58,50099,1319,72,68,2173,6,3638,5.874.642.857
13/11/2017 07:00,37.3,54121,1366,65,62,2268,6,3767,5.874.642.857
13/11/2017 08:00,38.2,55005,1361,59,56,2236,7,3719,5.874.642.857
13/11/2017 09:00,36.64,54806,1227,51,45,2097,6,3426,5.874.642.857
13/11/2017 10:00,35.82,54505,1006,42,38,1966,5,3057,5.874.642.857
13/11/2017 11:00,35.2,54080,812,35,29,1847,5,2728,5.874.642.857
13/11/2017 12:00,34.57,53408,609,29,22,1682,5,2347,5.874.642.857
13/11/2017 13:00,34.89,53034,500,24,16,1710,5,2255,5.874.642.857
13/11/2017 14:00,34.97,53047,442,21,13,1796,5,2277,5.874.642.857
13/11/2017 15:00,36.65,53684,418,19,12,1950,5,2404,5.874.642.857
13/11/2017 16:00,40.05,54855,424,20,13,2104,5,2566,5.874.642.857
13/11/2017 17:00,47.05,55707,409,20,12,2152,5,2598,5.874.642.857
13/11/2017 18:00,40.08,55374,466,20,12,2166,6,2670,5.874.642.857
13/11/2017 19:00,35.58,54351,540,19,12,2198,6,2775,5.874.642.857
13/11/2017 20:00,33.3,52718,613,16,13,2103,5,2750,5.874.642.857
13/11/2017 21:00,32.42,51230,651,17,15,1991,5,2679,5.874.642.857
13/11/2017 22:00,31.07,48937,648,16,18,1968,5,2655,5.874.642.857
13/11/2017 23:00,30.37,46360,658,22,24,1933,5,2642,5.874.642.857
14/11/2017 00:00,30.87,44743,819,23,31,1885,7,2765,5.874.642.857
14/11/2017 01:00,30.62,43842,936,26,36,1852,7,2857,5.874.642.857
14/11/2017 02:00,30.4,43562,1151,32,39,1839,7,3068,5.874.642.857
14/11/2017 03:00,30.14,43674,1426,35,39,1823,7,3330,5.874.642.857
14/11/2017 04:00,30.4,44421,1476,37,39,1751,7,3310,5.874.642.857
14/11/2017 05:00,31.08,46874,1546,41,40,1712,8,3347,5.874.642.857
14/11/2017 06:00,32.85,51066,1767,43,42,1643,8,3503,5.874.642.857
14/11/2017 07:00,35.42,54895,2070,45,44,1624,8,3791,5.874.642.857
14/11/2017 08:00,36.45,55947,2473,50,44,1590,10,4167,5.874.642.857
14/11/2017 09:00,33.55,55773,2896,53,46,1549,8,4552,5.874.642.857
14/11/2017 10:00,32.7,55649,2977,59,48,1514,9,4607,5.874.642.857
14/11/2017 11:00,32.33,55341,3187,69,55,1474,12,4797,5.874.642.857
14/11/2017 12:00,32.13,54918,3765,71,67,1462,16,5381,5.874.642.857
14/11/2017 13:00,32.29,54625,3846,70,78,1432,16,5442,5.874.642.857
14/11/2017 14:00,32.36,54531,3629,70,88,1580,15,5382,5.874.642.857
14/11/2017 15:00,32.45,55146,3343,68,98,1652,13,5174,5.874.642.857
14/11/2017 16:00,33.39,56080,2977,72,117,1729,11,4906,5.874.642.857
14/11/2017 17:00,35.01,56649,2759,73,145,1752,10,4739,5.874.642.857
14/11/2017 18:00,33.91,55984,2474,70,170,1813,12,4539,5.874.642.857
14/11/2017 19:00,32.41,54838,2096,64,187,1783,9,4139,5.874.642.857
14/11/2017 20:00,31.84,52977,1881,64,206,1763,9,3923,5.874.642.857
14/11/2017 21:00,31.44,51344,1766,71,223,1742,8,3810,5.874.642.857
14/11/2017 22:00,30.67,48924,1741,78,231,1801,8,3859,5.874.642.857
14/11/2017 23:00,29.74,46273,1714,88,247,1866,10,3925,5.874.642.857
15/11/2017 00:00,29.92,43869,1454,66,271,1883,18,3692,5.874.642.857
15/11/2017 01:00,29.56,42858,1409,64,271,1927,12,3683,5.874.642.857
15/11/2017 02:00,29.49,42496,1355,62,261,2045,9,3732,5.874.642.857
15/11/2017 03:00,29.46,42625,1431,61,246,2128,9,3875,5.874.642.857
15/11/2017 04:00,29.72,43391,1468,60,234,2205,8,3975,5.874.642.857
15/11/2017 05:00,30.58,45675,1438,59,216,2367,11,4091,5.874.642.857
15/11/2017 06:00,31.46,49935,1393,63,208,2551,16,4231,5.874.642.857
15/11/2017 07:00,32.51,54013,1411,65,199,2798,17,4490,5.874.642.857
15/11/2017 08:00,32.7,54762,1411,67,191,2886,16,4571,5.874.642.857
15/11/2017 09:00,31.9,54502,1387,68,186,2951,24,4616,5.874.642.857
15/11/2017 10:00,31.57,54476,1307,71,186,3191,27,4782,5.874.642.857
15/11/2017 11:00,31.43,54187,1314,75,186,3369,33,4977,5.874.642.857
15/11/2017 12:00,31.46,53568,1323,81,193,3264,44,4905,5.874.642.857
15/11/2017 13:00,31.67,53285,1258,91,204,3294,53,4900,5.874.642.857
15/11/2017 14:00,31.65,53384,1093,101,218,3361,55,4828,5.874.642.857
15/11/2017 15:00,32.1,53958,943,111,230,3520,53,4857,5.874.642.857
15/11/2017 16:00,34.05,54964,776,114,251,3532,52,4725,5.874.642.857
15/11/2017 17:00,37.43,55768,742,119,271,3633,50,4815,5.874.642.857
15/11/2017 18:00,34.9,55340,801,132,285,3604,53,4875,5.874.642.857
15/11/2017 19:00,32.41,54265,812,148,287,3533,51,4831,5.874.642.857
15/11/2017 20:00,31.57,52503,721,158,287,3446,49,4661,5.874.642.857
15/11/2017 21:00,31.24,50956,601,163,276,3358,49,4447,5.874.642.857
15/11/2017 22:00,30.57,48629,506,165,255,3267,47,4240,5.874.642.857
15/11/2017 23:00,29.66,46067,447,164,232,3140,45,4028,5.874.642.857
16/11/2017 00:00,29.91,44193,363,163,221,3037,21,3805,5.874.642.857
16/11/2017 01:00,29.46,43247,389,160,187,2927,20,3683,5.874.642.857
16/11/2017 02:00,29.4,43029,550,157,162,2832,16,3717,5.874.642.857
16/11/2017 03:00,29.33,43202,583,149,145,2700,14,3591,5.874.642.857
16/11/2017 04:00,29.89,43980,641,149,136,2627,13,3566,5.874.642.857
16/11/2017 05:00,30.56,46229,738,143,127,2533,14,3555,5.874.642.857
16/11/2017 06:00,31.48,50621,882,134,119,2403,12,3550,5.874.642.857
16/11/2017 07:00,36.07,54600,1066,119,114,2255,11,3565,5.874.642.857
16/11/2017 08:00,36.24,55288,1310,108,107,2051,11,3587,5.874.642.857
16/11/2017 09:00,33.45,55015,1655,106,100,1948,9,3818,5.874.642.857
16/11/2017 10:00,32.95,54932,1930,105,100,1785,10,3930,5.874.642.857
16/11/2017 11:00,32.15,54564,2226,101,96,1773,11,4207,5.874.642.857
16/11/2017 12:00,32.01,53985,2645,96,96,1794,13,4644,5.874.642.857
16/11/2017 13:00,31.82,53759,2910,89,97,1922,12,5030,5.874.642.857
16/11/2017 14:00,31.29,53844,3094,80,99,2282,11,5566,5.874.642.857
16/11/2017 15:00,31.36,54483,3290,70,102,2720,9,6191,5.874.642.857
16/11/2017 16:00,31.39,55493,3252,58,109,3032,9,6460,5.874.642.857
16/11/2017 17:00,31.43,55994,3153,52,118,3394,8,6725,5.874.642.857
16/11/2017 18:00,31.05,55306,3337,57,130,3627,8,7159,5.874.642.857
16/11/2017 19:00,30.4,54176,3228,70,142,3906,9,7355,5.874.642.857
16/11/2017 20:00,29.86,52342,3082,82,156,4008,10,7338,5.874.642.857
16/11/2017 21:00,29.45,50622,3185,94,171,4074,16,7540,5.874.642.857
16/11/2017 22:00,28.66,48190,3079,112,189,4043,23,7446,5.874.642.857
16/11/2017 23:00,27.57,45534,2876,134,208,3965,33,7216,5.874.642.857
17/11/2017 00:00,27.92,43289,3256,141,196,3836,30,7459,5.874.642.857
17/11/2017 01:00,27.51,42326,3126,156,215,3818,37,7352,5.874.642.857
17/11/2017 02:00,27.34,42052,2797,173,236,3755,39,7000,5.874.642.857
17/11/2017 03:00,27.21,42341,2676,189,262,3687,42,6856,5.874.642.857
17/11/2017 04:00,27.79,43109,2598,200,283,3750,52,6883,5.874.642.857
17/11/2017 05:00,28.5,45346,2564,208,299,3874,55,7000,5.874.642.857
17/11/2017 06:00,29.75,49514,2432,211,309,3969,44,6965,5.874.642.857
17/11/2017 07:00,30.8,53632,2293,210,307,3982,41,6833,5.874.642.857
17/11/2017 08:00,30.93,54611,2299,210,305,3950,39,6803,5.874.642.857
17/11/2017 09:00,30.57,54432,2457,205,294,3993,44,6993,5.874.642.857
17/11/2017 10:00,30.17,54394,2700,205,273,3952,46,7176,5.874.642.857
17/11/2017 11:00,29.96,53903,2955,205,251,3970,51,7432,5.874.642.857
17/11/2017 12:00,29.92,53176,3179,197,235,3994,45,7650,5.874.642.857
17/11/2017 13:00,29.95,52640,3306,190,223,4039,41,7799,5.874.642.857
17/11/2017 14:00,29.98,52300,3373,183,209,4108,40,7913,5.874.642.857
17/11/2017 15:00,30.07,52671,3341,182,196,4155,35,7909,5.874.642.857
17/11/2017 16:00,30.47,53574,3302,183,181,4228,39,7933,5.874.642.857
17/11/2017 17:00,30.74,54021,3307,186,173,4250,46,7962,5.874.642.857
17/11/2017 18:00,30.46,53256,3343,188,178,4258,49,8016,5.874.642.857
17/11/2017 19:00,29.75,51779,3428,191,184,4244,51,8098,5.874.642.857
17/11/2017 20:00,28.97,49793,3503,196,190,4209,51,8149,5.874.642.857
17/11/2017 21:00,28.59,48329,3577,200,199,4166,50,8192,5.874.642.857
17/11/2017 22:00,27.94,46479,3652,203,210,4121,50,8236,5.874.642.857
17/11/2017 23:00,27.58,44441,3699,190,224,4029,51,8193,5.874.642.857
18/11/2017 00:00,27.34,42683,3661,187,210,3872,26,7956,5.874.642.857
18/11/2017 01:00,26.82,41751,3727,181,210,3685,27,7830,5.874.642.857
18/11/2017 02:00,26.47,41320,3928,175,220,3502,31,7856,5.874.642.857
18/11/2017 03:00,26.32,41180,3971,169,230,3329,29,7728,5.874.642.857
18/11/2017 04:00,26.74,41398,3884,165,235,3118,28,7430,5.874.642.857
18/11/2017 05:00,27.08,42103,3728,162,240,2883,31,7044,5.874.642.857
18/11/2017 06:00,27.62,43244,3625,163,245,2652,35,6720,5.874.642.857
18/11/2017 07:00,28.15,44953,3579,166,255,2458,40,6498,5.874.642.857
18/11/2017 08:00,28.21,46392,3462,172,265,2331,44,6274,5.874.642.857
18/11/2017 09:00,28.59,47925,3395,176,280,2187,47,6085,5.874.642.857
18/11/2017 10:00,28.77,48798,3573,175,290,2030,51,6119,5.874.642.857
18/11/2017 11:00,28.61,48874,3706,177,300,1888,52,6123,5.874.642.857
18/11/2017 12:00,28.44,48739,3759,179,300,1795,49,6082,5.874.642.857
18/11/2017 13:00,28.35,48553,3891,177,305,1765,39,6177,5.874.642.857
18/11/2017 14:00,28.46,48819,3974,178,315,1713,32,6212,5.874.642.857
18/11/2017 15:00,28.87,49786,3923,180,315,1748,20,6186,5.874.642.857
18/11/2017 16:00,29.48,51173,3930,174,315,1782,11,6212,5.874.642.857
18/11/2017 17:00,29.76,52148,3954,171,315,1756,6,6202,5.874.642.857
18/11/2017 18:00,29.69,51726,4061,171,320,1794,6,6352,5.874.642.857
18/11/2017 19:00,28.91,50430,4180,173,325,1827,6,6511,5.874.642.857
18/11/2017 20:00,28.43,48841,4248,171,325,1884,7,6635,5.874.642.857
18/11/2017 21:00,28.46,47884,4275,166,305,1891,7,6644,5.874.642.857
18/11/2017 22:00,28.1,46496,4312,158,290,1921,7,6688,5.874.642.857
18/11/2017 23:00,27.88,44881,4313,154,290,1943,8,6708,5.874.642.857
19/11/2017 00:00,27.77,43797,4285,186,255,2120,37,6883,5.874.642.857
19/11/2017 01:00,27.54,42824,4250,180,210,2165,34,6839,5.874.642.857
19/11/2017 02:00,27.43,42264,4230,172,175,2231,32,6840,5.874.642.857
19/11/2017 03:00,26.84,42240,4121,157,160,2323,29,6790,5.874.642.857
19/11/2017 04:00,27.3,42141,4009,133,155,2399,27,6723,5.874.642.857
19/11/2017 05:00,27.07,42549,3929,113,150,2425,22,6639,5.874.642.857
19/11/2017 06:00,27.24,43371,3597,98,150,2543,16,6404,5.874.642.857
19/11/2017 07:00,27.7,44518,3609,88,155,2625,16,6493,5.874.642.857
19/11/2017 08:00,28.13,45929,3343,79,155,2706,13,6296,5.874.642.857
19/11/2017 09:00,28.42,47432,3324,72,165,2785,14,6360,5.874.642.857
19/11/2017 10:00,28.52,48532,3645,63,165,2853,14,6740,5.874.642.857
19/11/2017 11:00,28.67,49157,3619,56,145,2878,12,6710,5.874.642.857
19/11/2017 12:00,28.6,49189,3383,49,130,2805,12,6379,5.874.642.857
19/11/2017 13:00,28.44,49159,3225,46,130,2866,10,6277,5.874.642.857
19/11/2017 14:00,28.76,49504,2977,42,130,2880,8,6037,5.874.642.857
19/11/2017 15:00,29.21,50431,2595,40,155,2910,8,5708,5.874.642.857
19/11/2017 16:00,29.7,51876,2455,38,150,2917,8,5568,5.874.642.857
19/11/2017 17:00,30.32,52834,2075,38,145,2848,8,5114,5.874.642.857
19/11/2017 18:00,30.36,52614,1682,38,140,2732,9,4601,5.874.642.857
19/11/2017 19:00,29.93,51882,1617,34,135,2593,8,4387,5.874.642.857
19/11/2017 20:00,29.6,50787,1401,32,125,2494,8,4060,5.874.642.857
19/11/2017 21:00,29.38,49970,1230,33,120,2400,9,3792,5.874.642.857
19/11/2017 22:00,29.18,48472,1210,31,115,2268,13,3637,5.874.642.857
19/11/2017 23:00,28.67,46524,1345,26,110,2218,15,3714,5.874.642.857
20/11/2017 00:00,28.66,44774,1762,12,100,2228,8,4110,5.761.904.762
20/11/2017 01:00,28.13,44004,1823,11,85,2132,7,4058,5.761.904.762
20/11/2017 02:00,28.2,43705,1848,11,75,2040,8,3982,5.761.904.762
20/11/2017 03:00,28.48,43871,1883,12,75,2025,9,4004,5.761.904.762
20/11/2017 04:00,28.98,44768,1811,12,65,1909,9,3806,5.761.904.762
20/11/2017 05:00,29.91,47246,1707,12,60,1768,9,3556,5.761.904.762
20/11/2017 06:00,33.53,51743,1578,12,55,1638,8,3291,5.761.904.762
20/11/2017 07:00,39.34,55874,1332,12,50,1551,8,2953,5.761.904.762
20/11/2017 08:00,43.37,56895,1087,11,50,1395,9,2552,5.761.904.762
20/11/2017 09:00,42.65,56941,880,12,45,1207,8,2152,5.761.904.762
20/11/2017 10:00,40.26,56784,734,10,40,1046,8,1838,5.761.904.762
20/11/2017 11:00,40,56436,600,10,40,922,8,1580,5.761.904.762
20/11/2017 12:00,42.57,56016,479,12,45,852,8,1396,5.761.904.762
20/11/2017 13:00,43.81,55842,370,15,60,828,7,1280,5.761.904.762
20/11/2017 14:00,48.01,55937,249,15,70,812,6,1152,5.761.904.762
20/11/2017 15:00,48.95,56686,160,15,60,794,6,1035,5.761.904.762
20/11/2017 16:00,53.86,57815,112,13,60,790,6,981,5.761.904.762
20/11/2017 17:00,64.61,58557,87,11,55,773,7,933,5.761.904.762
20/11/2017 18:00,51.03,58071,80,9,55,722,10,876,5.761.904.762
20/11/2017 19:00,40.84,56995,89,9,55,699,7,859,5.761.904.762
20/11/2017 20:00,36.37,55298,115,10,55,631,10,821,5.761.904.762
20/11/2017 21:00,35.01,53843,131,9,50,614,10,814,5.761.904.762
20/11/2017 22:00,33.1,51534,138,9,50,599,9,805,5.761.904.762
20/11/2017 23:00,31.55,48947,193,9,50,579,8,839,5.761.904.762
21/11/2017 00:00,32.53,47055,151,11,25,495,6,688,5.761.904.762
21/11/2017 01:00,31.76,46092,115,11,25,477,7,635,5.761.904.762
21/11/2017 02:00,31.8,45775,78,11,27,485,7,608,5.761.904.762
21/11/2017 03:00,31.78,46031,81,10,36,488,6,621,5.761.904.762
21/11/2017 04:00,33.05,46816,85,9,38,479,6,617,5.761.904.762
21/11/2017 05:00,34.64,49296,100,8,38,485,5,636,5.761.904.762
21/11/2017 06:00,40.21,53760,119,7,38,497,5,666,5.761.904.762
21/11/2017 07:00,65.28,58110,137,6,38,470,5,656,5.761.904.762
21/11/2017 08:00,64.47,58917,139,5,39,452,7,642,5.761.904.762
21/11/2017 09:00,51.39,58607,117,4,41,404,6,572,5.761.904.762
21/11/2017 10:00,50.48,58503,137,5,42,372,6,562,5.761.904.762
21/11/2017 11:00,53.68,58136,152,6,43,353,5,559,5.761.904.762
21/11/2017 12:00,50.44,57663,173,6,44,339,7,569,5.761.904.762
21/11/2017 13:00,53.61,57418,195,7,46,364,6,618,5.761.904.762
21/11/2017 14:00,54.99,57461,221,8,47,401,6,683,5.761.904.762
21/11/2017 15:00,55.96,58181,266,9,47,488,6,816,5.761.904.762
21/11/2017 16:00,53.12,59349,374,10,49,583,5,1021,5.761.904.762
21/11/2017 17:00,56.23,59906,596,10,49,628,5,1288,5.761.904.762
21/11/2017 18:00,53.95,59217,969,8,50,696,7,1730,5.761.904.762
21/11/2017 19:00,39.73,58113,1381,7,50,738,5,2181,5.761.904.762
21/11/2017 20:00,34.65,56405,1866,6,49,794,5,2720,5.761.904.762
21/11/2017 21:00,32.77,54853,2425,6,48,863,5,3347,5.761.904.762
21/11/2017 22:00,31.36,52447,2867,6,47,959,5,3884,5.761.904.762
21/11/2017 23:00,29.76,49719,3304,12,46,1081,5,4448,5.761.904.762
22/11/2017 00:00,29.26,47889,3502,6,58,1174,7,4747,5.761.904.762
22/11/2017 01:00,28.91,46946,3534,5,56,1318,7,4920,5.761.904.762
22/11/2017 02:00,28.65,46447,3429,5,54,1495,6,4989,5.761.904.762
22/11/2017 03:00,28.55,46501,3434,4,50,1707,6,5201,5.761.904.762
22/11/2017 04:00,28.8,47654,3379,4,50,1933,6,5372,5.761.904.762
22/11/2017 05:00,29.34,49894,3404,4,52,2178,6,5644,5.761.904.762
22/11/2017 06:00,31.23,54070,3441,5,60,2405,5,5916,5.761.904.762
22/11/2017 07:00,35.87,58044,3335,7,68,2522,6,5938,5.761.904.762
22/11/2017 08:00,37.6,58714,3127,7,73,2643,8,5858,5.761.904.762
22/11/2017 09:00,32.57,58233,2847,5,78,2702,8,5640,5.761.904.762
22/11/2017 10:00,32.04,58396,2584,7,83,2743,9,5426,5.761.904.762
22/11/2017 11:00,31.86,58155,2447,11,86,2799,12,5355,5.761.904.762
22/11/2017 12:00,31.17,57508,2387,15,94,2811,15,5322,5.761.904.762
22/11/2017 13:00,31.59,57199,2382,16,112,2865,16,5391,5.761.904.762
22/11/2017 14:00,33.18,57288,2478,18,139,2962,15,5612,5.761.904.762
22/11/2017 15:00,34.62,57771,2693,22,157,3044,20,5936,5.761.904.762
22/11/2017 16:00,34.49,58540,3055,29,184,3167,23,6458,5.761.904.762
22/11/2017 17:00,34.14,58764,3417,37,204,3339,30,7027,5.761.904.762
22/11/2017 18:00,32.5,57966,3763,47,225,3588,38,7661,5.761.904.762
22/11/2017 19:00,31.1,56642,3990,56,241,3667,38,7992,5.761.904.762
22/11/2017 20:00,30.08,54710,4083,64,250,3879,40,8316,5.761.904.762
22/11/2017 21:00,29.78,53029,4119,69,265,4035,40,8528,5.761.904.762
22/11/2017 22:00,28.67,50467,4126,75,270,4288,35,8794,5.761.904.762
22/11/2017 23:00,27.01,47770,4119,91,270,4400,35,8915,5.761.904.762
23/11/2017 00:00,27.15,45590,4202,92,247,4620,34,9195,5.761.904.762
23/11/2017 01:00,26.43,44497,4214,101,245,4781,35,9376,5.761.904.762
23/11/2017 02:00,26.09,43995,4238,110,243,4750,37,9378,5.761.904.762
23/11/2017 03:00,25.47,44052,4195,121,251,4845,39,9451,5.761.904.762
23/11/2017 04:00,26.1,44637,4189,131,252,4870,41,9483,5.761.904.762
23/11/2017 05:00,26.96,46804,4227,143,252,4919,42,9583,5.761.904.762
23/11/2017 06:00,28.57,50959,4226,155,249,4968,41,9639,5.761.904.762
23/11/2017 07:00,31.21,54913,4212,164,244,4976,41,9637,5.761.904.762
23/11/2017 08:00,31.25,55594,4171,175,241,4935,41,9563,5.761.904.762
23/11/2017 09:00,29.9,55224,4242,184,238,4954,42,9660,5.761.904.762
23/11/2017 10:00,28.99,55250,4365,188,238,4968,43,9802,5.761.904.762
23/11/2017 11:00,28.87,55014,4476,194,245,4986,45,9946,5.761.904.762
23/11/2017 12:00,28.91,54644,4522,198,255,4961,47,9983,5.761.904.762
23/11/2017 13:00,28.91,54475,4513,200,265,4970,47,9995,5.761.904.762
23/11/2017 14:00,28.96,54593,4472,204,277,4920,46,9919,5.761.904.762
23/11/2017 15:00,30.12,55147,4362,208,289,4964,44,9867,5.761.904.762
23/11/2017 16:00,30.91,55962,4245,210,304,5105,43,9907,5.761.904.762
23/11/2017 17:00,30.99,56177,4137,213,315,5103,45,9813,5.761.904.762
23/11/2017 18:00,30.3,55450,4009,216,325,5155,45,9750,5.761.904.762
23/11/2017 19:00,29.64,54337,4001,217,324,5137,46,9725,5.761.904.762
23/11/2017 20:00,28.78,52567,4049,217,315,5001,40,9622,5.761.904.762
23/11/2017 21:00,28.56,50908,4135,219,302,4902,43,9601,5.761.904.762
23/11/2017 22:00,27.35,48536,4076,218,291,4852,41,9478,5.761.904.762
23/11/2017 23:00,26.05,46024,4092,215,278,4849,39,9473,5.761.904.762
24/11/2017 00:00,27.12,44420,3671,219,235,4691,33,8849,5.761.904.762
24/11/2017 01:00,27.1,43368,3416,216,203,4699,32,8566,5.761.904.762
24/11/2017 02:00,27.27,43148,2974,213,170,4723,28,8108,5.761.904.762
24/11/2017 03:00,27.1,43460,2630,210,157,4682,26,7705,5.761.904.762
24/11/2017 04:00,28.19,44183,2259,202,147,4516,20,7144,5.761.904.762
24/11/2017 05:00,29.44,46438,1932,190,134,4311,18,6585,5.761.904.762
24/11/2017 06:00,31.29,50698,1645,179,132,4038,18,6012,5.761.904.762
24/11/2017 07:00,33.08,55053,1338,166,128,3755,19,5406,5.761.904.762
24/11/2017 08:00,35.91,55926,1079,157,118,3506,15,4875,5.761.904.762
24/11/2017 09:00,34.17,55761,761,147,107,3253,14,4282,5.761.904.762
24/11/2017 10:00,33.3,55791,542,139,94,3104,14,3893,5.761.904.762
24/11/2017 11:00,32.81,55400,448,129,84,2810,11,3482,5.761.904.762
24/11/2017 12:00,32.66,54829,407,115,82,2582,9,3195,5.761.904.762
24/11/2017 13:00,32.72,54435,382,105,83,2482,8,3060,5.761.904.762
24/11/2017 14:00,33.15,54162,378,103,103,2451,8,3043,5.761.904.762
24/11/2017 15:00,34.59,54598,410,103,128,2426,7,3074,5.761.904.762
24/11/2017 16:00,35.34,55427,424,102,150,2387,5,3068,5.761.904.762
24/11/2017 17:00,35.82,55790,521,97,189,2471,5,3283,5.761.904.762
24/11/2017 18:00,34.72,54961,680,95,225,2477,7,3484,5.761.904.762
24/11/2017 19:00,32.16,53432,732,94,266,2464,7,3563,5.761.904.762
24/11/2017 20:00,31.35,51562,746,92,287,2408,8,3541,5.761.904.762
24/11/2017 21:00,30.99,50069,830,92,290,2413,11,3636,5.761.904.762
24/11/2017 22:00,29.97,48258,865,100,293,2355,15,3628,5.761.904.762
24/11/2017 23:00,29.13,46039,857,89,295,2291,10,3542,5.761.904.762
25/11/2017 00:00,29.93,44122,1007,65,198,2409,7,3686,5.761.904.762
25/11/2017 01:00,29.5,43027,1144,67,146,2328,6,3691,5.761.904.762
25/11/2017 02:00,29.33,42607,1229,65,104,2203,6,3607,5.761.904.762
25/11/2017 03:00,29.27,42673,1320,65,72,2081,6,3544,5.761.904.762
25/11/2017 04:00,29.47,42959,1385,63,54,1967,7,3476,5.761.904.762
25/11/2017 05:00,29.67,43707,1343,60,45,1905,6,3359,5.761.904.762
25/11/2017 06:00,29.89,44922,1288,55,41,1880,6,3270,5.761.904.762
25/11/2017 07:00,30.03,46636,1236,51,37,1836,6,3166,5.761.904.762
25/11/2017 08:00,30.18,48319,1207,51,32,1833,5,3128,5.761.904.762
25/11/2017 09:00,30.75,49978,1146,49,29,1786,6,3016,5.761.904.762
25/11/2017 10:00,31.39,50822,1065,42,26,1764,5,2902,5.761.904.762
25/11/2017 11:00,31.42,50772,1084,36,25,1679,4,2828,5.761.904.762
25/11/2017 12:00,31.17,50352,1171,36,25,1607,4,2843,5.761.904.762
25/11/2017 13:00,30.99,50070,1097,37,28,1608,4,2774,5.761.904.762
25/11/2017 14:00,30.91,50349,1005,37,36,1660,4,2742,5.761.904.762
25/11/2017 15:00,31.38,51508,930,35,39,1722,4,2730,5.761.904.762
25/11/2017 16:00,32.38,53109,944,33,49,1745,4,2775,5.761.904.762
25/11/2017 17:00,33.65,53883,1007,30,66,1767,6,2876,5.761.904.762
25/11/2017 18:00,32.59,53311,839,30,87,1784,4,2744,5.761.904.762
25/11/2017 19:00,31.29,51868,799,30,100,1789,4,2722,5.761.904.762
25/11/2017 20:00,30.69,50163,916,31,113,1737,4,2801,5.761.904.762
25/11/2017 21:00,30.13,49011,1101,33,136,1723,4,2997,5.761.904.762
25/11/2017 22:00,29.32,47511,1290,35,139,1738,5,3207,5.761.904.762
25/11/2017 23:00,28.24,45856,1500,44,140,1744,6,3434,5.761.904.762
26/11/2017 00:00,28.62,43945,2199,55,253,1744,14,4265,5.761.904.762
26/11/2017 01:00,28.2,43039,2416,65,257,1717,11,4466,5.761.904.762
26/11/2017 02:00,28.02,42556,2662,76,257,1730,8,4733,5.761.904.762
26/11/2017 03:00,27.68,42378,2899,88,268,1755,11,5021,5.761.904.762
26/11/2017 04:00,27.37,42440,2929,96,307,1791,13,5136,5.761.904.762
26/11/2017 05:00,27.34,42698,2926,94,329,1829,32,5210,5.761.904.762
26/11/2017 06:00,27.8,43422,2948,91,348,1844,37,5268,5.761.904.762
26/11/2017 07:00,28.1,44553,2826,91,335,1932,34,5218,5.761.904.762
26/11/2017 08:00,28.21,45924,2775,105,295,2002,36,5213,5.761.904.762
26/11/2017 09:00,28.49,47663,2897,130,254,2036,24,5341,5.761.904.762
26/11/2017 10:00,29.03,48833,3127,153,245,2017,20,5562,5.761.904.762
26/11/2017 11:00,29.06,49258,3309,162,205,2001,18,5695,5.761.904.762
26/11/2017 12:00,29.03,49161,3471,160,182,1952,16,5781,5.761.904.762
26/11/2017 13:00,28.83,49018,3608,148,164,1955,15,5890,5.761.904.762
26/11/2017 14:00,28.81,49401,3709,130,145,1987,13,5984,5.761.904.762
26/11/2017 15:00,28.97,50412,3774,116,140,2030,11,6071,5.761.904.762
26/11/2017 16:00,29.72,51785,3884,108,146,2066,10,6214,5.761.904.762
26/11/2017 17:00,30.04,52556,3993,105,178,2109,9,6394,5.761.904.762
26/11/2017 18:00,29.79,52275,4091,103,210,2135,11,6550,5.761.904.762
26/11/2017 19:00,29.51,51356,4126,110,222,2157,13,6628,5.761.904.762
26/11/2017 20:00,29.07,50061,4110,116,209,2134,15,6584,5.761.904.762
26/11/2017 21:00,29.01,48920,4111,123,199,2122,18,6573,5.761.904.762
26/11/2017 22:00,28.37,47119,4114,129,197,2126,21,6587,5.761.904.762
26/11/2017 23:00,28.01,45144,4088,126,192,1992,23,6421,5.761.904.762
27/11/2017 00:00,27.4,43822,3709,140,190,2041,21,6101,5.579.464.286
27/11/2017 01:00,27.33,42924,3534,153,190,2013,23,5913,5.579.464.286
27/11/2017 02:00,27.27,42618,3257,162,198,1985,21,5623,5.579.464.286
27/11/2017 03:00,27.24,42767,2967,169,221,1958,23,5338,5.579.464.286
27/11/2017 04:00,27.66,43675,2665,171,236,1900,23,4995,5.579.464.286
27/11/2017 05:00,28.91,46046,2443,172,240,1814,25,4694,5.579.464.286
27/11/2017 06:00,32.13,50516,2431,172,244,1743,30,4620,5.579.464.286
27/11/2017 07:00,34.94,54790,2457,173,255,1672,30,4587,5.579.464.286
27/11/2017 08:00,39.08,55815,2312,170,259,1550,34,4325,5.579.464.286
27/11/2017 09:00,35.57,55634,2267,170,255,1406,34,4132,5.579.464.286
27/11/2017 10:00,34.06,55663,2474,170,256,1317,33,4250,5.579.464.286
27/11/2017 11:00,33.71,55452,2751,170,257,1237,32,4447,5.579.464.286
27/11/2017 12:00,32.47,55158,3035,170,243,1175,30,4653,5.579.464.286
27/11/2017 13:00,32.72,55109,3126,171,241,1161,29,4728,5.579.464.286
27/11/2017 14:00,33.77,55304,3090,175,239,1192,28,4724,5.579.464.286
27/11/2017 15:00,35.9,56065,3115,179,243,1236,27,4800,5.579.464.286
27/11/2017 16:00,39.24,57014,3019,182,235,1350,25,4811,5.579.464.286
27/11/2017 17:00,41.93,57437,2778,182,224,1488,27,4699,5.579.464.286
27/11/2017 18:00,39.08,56698,2600,177,212,1586,28,4603,5.579.464.286
27/11/2017 19:00,35.22,55575,2414,171,209,1650,28,4472,5.579.464.286
27/11/2017 20:00,34.02,53825,2175,167,208,1682,25,4257,5.579.464.286
27/11/2017 21:00,31.36,52274,2002,162,207,1686,24,4081,5.579.464.286
27/11/2017 22:00,30,49917,1991,156,223,1662,20,4052,5.579.464.286
27/11/2017 23:00,28.62,47340,2245,147,236,1632,19,4279,5.579.464.286
28/11/2017 00:00,28.73,45094,1659,139,257,1624,27,3706,5.579.464.286
28/11/2017 01:00,28.46,44049,1638,138,278,1556,27,3637,5.579.464.286
28/11/2017 02:00,28.26,43684,1688,131,309,1466,26,3620,5.579.464.286
28/11/2017 03:00,28.08,43822,1801,125,325,1405,27,3683,5.579.464.286
28/11/2017 04:00,28.68,44573,1778,124,333,1380,29,3644,5.579.464.286
28/11/2017 05:00,29.54,46874,1800,124,341,1400,31,3696,5.579.464.286
28/11/2017 06:00,32.87,51346,1763,125,343,1415,35,3681,5.579.464.286
28/11/2017 07:00,37.95,55714,1551,127,347,1448,37,3510,5.579.464.286
28/11/2017 08:00,39.19,56631,1493,130,347,1492,40,3502,5.579.464.286
28/11/2017 09:00,36.63,56094,1488,134,343,1539,41,3545,5.579.464.286
28/11/2017 10:00,35.84,56155,1614,138,333,1601,40,3726,5.579.464.286
28/11/2017 11:00,36.05,56001,1612,144,324,1642,38,3760,5.579.464.286
28/11/2017 12:00,40.55,55781,1627,148,309,1658,36,3778,5.579.464.286
28/11/2017 13:00,45.01,55663,1633,152,303,1690,31,3809,5.579.464.286
28/11/2017 14:00,44.46,55856,1601,162,298,1708,30,3799,5.579.464.286
28/11/2017 15:00,47.08,56611,1514,169,283,1773,32,3771,5.579.464.286
28/11/2017 16:00,51.97,57610,1396,174,280,1804,35,3689,5.579.464.286
28/11/2017 17:00,58.27,57763,1317,177,271,1851,34,3650,5.579.464.286
28/11/2017 18:00,48.02,57057,1255,178,265,1870,34,3602,5.579.464.286
28/11/2017 19:00,36.83,55846,1171,177,257,1885,31,3521,5.579.464.286
28/11/2017 20:00,34.98,54188,1111,173,240,1902,28,3454,5.579.464.286
28/11/2017 21:00,33.58,52606,1063,166,229,1907,25,3390,5.579.464.286
28/11/2017 22:00,32.22,50261,1003,159,220,1861,21,3264,5.579.464.286
28/11/2017 23:00,30.82,47642,889,144,204,1796,17,3050,5.579.464.286
29/11/2017 00:00,30.48,45629,732,151,241,1681,20,2825,5.579.464.286
29/11/2017 01:00,30.04,44520,664,147,227,1625,19,2682,5.579.464.286
29/11/2017 02:00,29.8,44039,522,140,205,1578,19,2464,5.579.464.286
29/11/2017 03:00,30.21,44153,459,133,190,1515,18,2315,5.579.464.286
29/11/2017 04:00,31.13,44927,440,126,176,1464,16,2222,5.579.464.286
29/11/2017 05:00,33.05,47215,426,120,158,1418,14,2136,5.579.464.286
29/11/2017 06:00,38.66,51561,416,115,141,1370,15,2057,5.579.464.286
29/11/2017 07:00,59.17,56193,404,110,132,1308,19,1973,5.579.464.286
29/11/2017 08:00,73.71,57237,375,102,123,1240,18,1858,5.579.464.286
29/11/2017 09:00,56.74,56896,364,100,113,1204,18,1799,5.579.464.286
29/11/2017 10:00,52.01,56881,439,98,102,1112,16,1767,5.579.464.286
29/11/2017 11:00,48.03,56730,455,96,95,1059,17,1722,5.579.464.286
29/11/2017 12:00,48.04,56402,470,94,89,1020,17,1690,5.579.464.286
29/11/2017 13:00,55.05,56271,459,92,83,963,17,1614,5.579.464.286
29/11/2017 14:00,57.46,56557,426,88,84,944,17,1559,5.579.464.286
29/11/2017 15:00,81.07,57260,356,85,78,913,15,1447,5.579.464.286
29/11/2017 16:00,100.89,58264,261,84,78,945,15,1383,5.579.464.286
29/11/2017 17:00,127.32,58561,237,81,70,926,15,1329,5.579.464.286
29/11/2017 18:00,76.92,57874,228,76,65,938,14,1321,5.579.464.286
29/11/2017 19:00,45.96,56628,220,72,59,947,14,1312,5.579.464.286
29/11/2017 20:00,37.71,55020,208,68,55,940,9,1280,5.579.464.286
29/11/2017 21:00,36.03,53458,192,64,52,950,9,1267,5.579.464.286
29/11/2017 22:00,33.44,51088,176,59,50,964,9,1258,5.579.464.286
29/11/2017 23:00,32.18,48584,176,62,46,968,9,1261,5.579.464.286
30/11/2017 00:00,31.73,46900,291,59,0,927,9,1286,5.579.464.286
30/11/2017 01:00,30.84,45751,236,55,0,939,8,1238,5.579.464.286
30/11/2017 02:00,30.65,45310,173,49,0,932,8,1162,5.579.464.286
30/11/2017 03:00,30.86,45438,193,44,0,942,8,1187,5.579.464.286
30/11/2017 04:00,31.97,46320,176,42,0,941,8,1167,5.579.464.286
30/11/2017 05:00,33.25,48975,184,40,0,911,8,1143,5.579.464.286
30/11/2017 06:00,37.99,53474,245,37,0,856,7,1145,5.579.464.286
30/11/2017 07:00,55.3,57901,190,36,0,828,10,1064,5.579.464.286
30/11/2017 08:00,70.43,59029,186,34,0,781,10,1011,5.579.464.286
30/11/2017 09:00,53.26,58677,171,31,0,802,9,1013,5.579.464.286
30/11/2017 10:00,52.03,58663,191,26,0,773,9,999,5.579.464.286
30/11/2017 11:00,50.03,58301,208,25,0,713,10,956,5.579.464.286
30/11/2017 12:00,50.2,57939,282,24,0,694,9,1009,5.579.464.286
30/11/2017 13:00,50.53,57853,343,24,0,684,10,1061,5.579.464.286
30/11/2017 14:00,49.49,58018,410,25,0,710,9,1154,5.579.464.286
30/11/2017 15:00,59.97,58874,475,30,0,760,10,1275,5.579.464.286
30/11/2017 16:00,68.65,59743,512,34,0,807,11,1364,5.579.464.286
30/11/2017 17:00,61.66,59917,637,36,0,869,12,1554,5.579.464.286
30/11/2017 18:00,49.62,59323,746,36,0,932,12,1726,5.579.464.286
30/11/2017 19:00,39.94,58256,816,40,0,977,8,1841,5.579.464.286
30/11/2017 20:00,35.72,56496,861,43,0,1041,9,1954,5.579.464.286
30/11/2017 21:00,34.38,54984,892,50,0,1073,11,2026,5.579.464.286
30/11/2017 22:00,32.88,52624,873,58,0,1138,14,2083,5.579.464.286
30/11/2017 23:00,30.92,49935,819,59,0,1208,18,2104,5.579.464.286
01/12/2017 00:00,31.24,48217,947,72,177,1235,15,2446,5.579.464.286
01/12/2017 01:00,30.02,47090,958,90,153,1329,19,2549,5.579.464.286
01/12/2017 02:00,29.76,46709,967,110,126,1402,19,2624,5.579.464.286
01/12/2017 03:00,29.77,46913,974,128,113,1482,16,2713,5.579.464.286
01/12/2017 04:00,30.4,47751,967,144,97,1546,13,2767,5.579.464.286
01/12/2017 05:00,31.83,50111,988,150,82,1605,13,2838,5.579.464.286
01/12/2017 06:00,35.57,54295,1047,147,74,1663,12,2943,5.579.464.286
01/12/2017 07:00,45.12,58630,1220,142,66,1709,11,3148,5.579.464.286
01/12/2017 08:00,50.85,59649,1249,134,60,1662,9,3114,5.579.464.286
01/12/2017 09:00,53.29,59382,1160,122,60,1626,8,2976,5.579.464.286
01/12/2017 10:00,47.02,59409,1129,108,60,1464,7,2768,5.579.464.286
01/12/2017 11:00,47.51,58984,1058,92,60,1307,7,2524,5.579.464.286
01/12/2017 12:00,47.36,58371,929,74,68,1450,8,2529,5.579.464.286
01/12/2017 13:00,44.36,57834,852,56,83,1453,6,2450,5.579.464.286
01/12/2017 14:00,44.16,57640,771,42,101,1459,7,2380,5.579.464.286
01/12/2017 15:00,43.32,58091,619,32,128,1486,7,2272,5.579.464.286
01/12/2017 16:00,50.07,58849,476,26,140,1530,9,2181,5.579.464.286
01/12/2017 17:00,63.41,59019,437,23,140,1501,9,2110,5.579.464.286
01/12/2017 18:00,48.07,58236,411,23,140,1559,9,2142,5.579.464.286
01/12/2017 19:00,40.28,56792,404,26,144,1611,10,2195,5.579.464.286
01/12/2017 20:00,35.2,54900,386,33,160,1592,13,2184,5.579.464.286
01/12/2017 21:00,33.95,53562,397,40,170,1705,20,2332,5.579.464.286
01/12/2017 22:00,32.46,51755,492,46,173,1778,22,2511,5.579.464.286
01/12/2017 23:00,30.97,49717,704,60,173,1865,27,2829,5.579.464.286
02/12/2017 00:00,31.37,47813,578,48,169,2031,13,2839,5.579.464.286
02/12/2017 01:00,30.52,46860,764,51,165,2063,18,3061,5.579.464.286
02/12/2017 02:00,29.88,46272,1011,53,163,2132,20,3379,5.579.464.286
02/12/2017 03:00,29.77,46139,1066,56,176,2181,20,3499,5.579.464.286
02/12/2017 04:00,29.79,46339,1078,60,166,2262,24,3590,5.579.464.286
02/12/2017 05:00,30.25,46979,1102,70,139,2312,26,3649,5.579.464.286
02/12/2017 06:00,30.75,48161,1143,76,117,2368,19,3723,5.579.464.286
02/12/2017 07:00,30.85,49854,1260,70,93,2388,13,3824,5.579.464.286
02/12/2017 08:00,30.88,51645,1423,59,72,2418,10,3982,5.579.464.286
02/12/2017 09:00,31.46,53174,1601,62,62,2491,9,4225,5.579.464.286
02/12/2017 10:00,31.81,54033,1665,75,63,2576,9,4388,5.579.464.286
02/12/2017 11:00,31.58,53630,1882,84,75,2625,11,4677,5.579.464.286
02/12/2017 12:00,31.06,53119,2056,97,92,2667,12,4924,5.579.464.286
02/12/2017 13:00,30.7,52700,2178,110,100,2760,13,5161,5.579.464.286
02/12/2017 14:00,30.67,52858,2253,123,100,2972,14,5462,5.579.464.286
02/12/2017 15:00,31,53919,2289,138,116,3245,14,5802,5.579.464.286
02/12/2017 16:00,31.6,55324,2464,144,117,3518,13,6256,5.579.464.286
02/12/2017 17:00,31.82,55688,2557,147,115,3740,13,6572,5.579.464.286
02/12/2017 18:00,31.2,54568,2647,149,117,3915,15,6843,5.579.464.286
02/12/2017 19:00,29.98,52883,2717,149,129,4028,16,7039,5.579.464.286
02/12/2017 20:00,29.39,50956,2651,151,148,4094,20,7064,5.579.464.286
02/12/2017 21:00,28.8,49665,2548,150,174,4115,19,7006,5.579.464.286
02/12/2017 22:00,28.34,48056,2476,150,189,4127,17,6959,5.579.464.286
02/12/2017 23:00,27.9,46377,2534,150,204,4115,20,7023,5.579.464.286
03/12/2017 00:00,28.12,44767,2562,170,199,4426,27,7384,5.579.464.286
03/12/2017 01:00,27.72,43679,2636,174,202,4393,26,7431,5.579.464.286
03/12/2017 02:00,27.78,43036,2583,180,218,4289,31,7301,5.579.464.286
03/12/2017 03:00,27.57,42684,2516,187,237,4128,35,7103,5.579.464.286
03/12/2017 04:00,27.74,42697,2536,194,255,3975,36,6996,5.579.464.286
03/12/2017 05:00,27.96,43055,2567,202,270,3941,39,7019,5.579.464.286
03/12/2017 06:00,28.01,43874,2610,210,283,3939,43,7085,5.579.464.286
03/12/2017 07:00,27.72,45151,2639,217,286,3813,46,7001,5.579.464.286
03/12/2017 08:00,28.35,46455,2571,223,293,3719,47,6853,5.579.464.286
03/12/2017 09:00,28.77,48056,2520,229,308,3684,49,6790,5.579.464.286
03/12/2017 10:00,29.25,49383,2625,233,317,3557,51,6783,5.579.464.286
03/12/2017 11:00,29.57,50098,2786,236,326,3451,52,6851,5.579.464.286
03/12/2017 12:00,29.72,50156,2916,240,331,3291,53,6831,5.579.464.286
03/12/2017 13:00,29.61,50131,2994,229,344,3187,22,6776,5.579.464.286
03/12/2017 14:00,29.72,50616,3033,229,345,3114,22,6743,5.579.464.286
03/12/2017 15:00,30.2,51707,3063,228,333,3104,22,6750,5.579.464.286
03/12/2017 16:00,30.92,53063,3076,223,341,3100,22,6762,5.579.464.286
03/12/2017 17:00,31.31,53858,3087,214,343,3115,22,6781,5.579.464.286
03/12/2017 18:00,31.05,53677,3184,201,348,3125,22,6880,5.579.464.286
03/12/2017 19:00,30.64,52812,3304,183,350,3193,22,7052,5.579.464.286
03/12/2017 20:00,30.18,51567,3403,164,338,3143,22,7070,5.579.464.286
03/12/2017 21:00,30.14,50659,3463,143,333,3065,22,7026,5.579.464.286
03/12/2017 22:00,29.39,49029,3311,122,324,3070,22,6849,5.579.464.286
03/12/2017 23:00,28.24,47112,3113,91,300,3083,22,6609,5.579.464.286
04/12/2017 00:00,27.32,45938,3240,75,257,3095,8,6675,5.515.952.381
04/12/2017 01:00,27.01,45073,3183,64,214,3040,6,6507,5.515.952.381
04/12/2017 02:00,26.96,44919,3178,56,174,2983,4,6395,5.515.952.381
04/12/2017 03:00,27.15,45200,2974,48,134,2924,4,6084,5.515.952.381
04/12/2017 04:00,27.72,46194,2712,39,112,2844,4,5711,5.515.952.381
04/12/2017 05:00,28.62,48789,2606,32,96,2749,4,5487,5.515.952.381
04/12/2017 06:00,32.47,53669,2638,25,83,2644,5,5395,5.515.952.381
04/12/2017 07:00,36.07,58164,2663,21,67,2521,5,5277,5.515.952.381
04/12/2017 08:00,39.4,58997,2519,18,52,2290,5,4884,5.515.952.381
04/12/2017 09:00,39.64,58568,2424,17,42,2115,7,4605,5.515.952.381
04/12/2017 10:00,36.17,58520,2343,16,35,2063,6,4463,5.515.952.381
04/12/2017 11:00,37.16,58203,2350,17,35,2068,6,4476,5.515.952.381
04/12/2017 12:00,37.79,57751,2318,21,41,2117,9,4506,5.515.952.381
04/12/2017 13:00,37.52,57680,2219,27,48,2260,9,4563,5.515.952.381
04/12/2017 14:00,37.68,57999,2072,37,55,2400,9,4573,5.515.952.381
04/12/2017 15:00,40.18,59244,1975,46,50,2547,10,4628,5.515.952.381
04/12/2017 16:00,45.05,60298,1867,55,65,2659,11,4657,5.515.952.381
04/12/2017 17:00,45.02,60616,1721,57,77,2730,13,4598,5.515.952.381
04/12/2017 18:00,42.75,59937,1531,57,98,2713,15,4414,5.515.952.381
04/12/2017 19:00,36.16,58622,1380,56,114,2711,16,4277,5.515.952.381
04/12/2017 20:00,33.95,56862,1247,55,126,2716,17,4161,5.515.952.381
04/12/2017 21:00,33.26,55414,1206,56,142,2667,16,4087,5.515.952.381
04/12/2017 22:00,32.26,53140,1423,56,150,2660,11,4300,5.515.952.381
04/12/2017 23:00,29.83,50406,1569,64,151,2659,9,4452,5.515.952.381
05/12/2017 00:00,28.68,48113,2106,47,178,2619,10,4960,5.515.952.381
05/12/2017 01:00,28.16,47014,2232,40,165,2641,9,5087,5.515.952.381
05/12/2017 02:00,27.82,46648,2494,37,143,2595,8,5277,5.515.952.381
05/12/2017 03:00,27.93,46783,2855,39,112,2634,8,5648,5.515.952.381
05/12/2017 04:00,28.23,47564,3201,47,106,2717,8,6079,5.515.952.381
05/12/2017 05:00,30.03,50159,3527,53,101,2821,8,6510,5.515.952.381
05/12/2017 06:00,32.38,54416,3780,56,99,3030,10,6975,5.515.952.381
05/12/2017 07:00,35.76,58840,3889,57,97,3248,12,7303,5.515.952.381
05/12/2017 08:00,35.57,59670,3946,55,96,3310,13,7420,5.515.952.381
05/12/2017 09:00,34.32,59483,4021,53,100,3349,13,7536,5.515.952.381
05/12/2017 10:00,32.8,59159,4128,50,106,3448,18,7750,5.515.952.381
05/12/2017 11:00,32.45,58687,4245,46,113,3568,20,7992,5.515.952.381
05/12/2017 12:00,32.27,58139,4426,43,132,3770,21,8392,5.515.952.381
05/12/2017 13:00,31.69,57899,4422,41,152,4073,26,8714,5.515.952.381
05/12/2017 14:00,31.82,58114,4381,42,181,4303,31,8938,5.515.952.381
05/12/2017 15:00,32.44,58791,4327,47,196,4484,26,9080,5.515.952.381
05/12/2017 16:00,32.85,59525,4383,50,240,4510,37,9220,5.515.952.381
05/12/2017 17:00,33.08,59499,4382,50,273,4496,46,9247,5.515.952.381
05/12/2017 18:00,32.61,58651,4378,51,290,4356,51,9126,5.515.952.381
05/12/2017 19:00,31.04,57418,4359,54,310,4242,57,9022,5.515.952.381
05/12/2017 20:00,30.03,55721,4297,61,327,4114,57,8856,5.515.952.381
05/12/2017 21:00,29.28,54048,4313,68,345,3958,53,8737,5.515.952.381
05/12/2017 22:00,28.08,51376,4397,74,353,3726,59,8609,5.515.952.381
05/12/2017 23:00,27.07,48506,4466,80,363,3590,58,8557,5.515.952.381
06/12/2017 00:00,27.02,46120,4395,103,342,3435,42,8317,5.515.952.381
06/12/2017 01:00,26.79,44838,4385,87,335,3436,36,8279,5.515.952.381
06/12/2017 02:00,26.54,44403,4410,76,264,3350,28,8128,5.515.952.381
06/12/2017 03:00,26.47,44556,4375,71,210,3312,21,7989,5.515.952.381
06/12/2017 04:00,27.19,45218,4379,71,158,3134,15,7757,5.515.952.381
06/12/2017 05:00,27.66,47337,4394,77,108,3055,12,7646,5.515.952.381
06/12/2017 06:00,29.55,51308,4366,80,68,2953,12,7479,5.515.952.381
06/12/2017 07:00,32.41,56090,4410,82,44,2803,11,7350,5.515.952.381
06/12/2017 08:00,33.17,57283,4411,84,35,2686,9,7225,5.515.952.381
06/12/2017 09:00,32.97,57078,4352,84,28,2491,10,6965,5.515.952.381
06/12/2017 10:00,32.36,57215,4336,84,24,2382,10,6836,5.515.952.381
06/12/2017 11:00,32.59,57013,4364,88,26,2186,9,6673,5.515.952.381
06/12/2017 12:00,32.48,56776,4437,92,31,2062,9,6631,5.515.952.381
06/12/2017 13:00,32.25,56674,4391,92,37,1956,9,6485,5.515.952.381
06/12/2017 14:00,32.88,56997,4322,88,39,1790,10,6249,5.515.952.381
06/12/2017 15:00,34.34,57882,4225,82,38,1652,10,6007,5.515.952.381
06/12/2017 16:00,36.15,58830,4197,78,38,1491,11,5815,5.515.952.381
06/12/2017 17:00,36.81,58841,4119,70,36,1392,9,5626,5.515.952.381
06/12/2017 18:00,36.1,57792,4099,59,34,1297,8,5497,5.515.952.381
06/12/2017 19:00,33.58,56614,4155,49,34,1299,5,5542,5.515.952.381
06/12/2017 20:00,32.35,55234,4249,38,33,1438,5,5763,5.515.952.381
06/12/2017 21:00,31.74,53778,4277,29,39,1645,5,5995,5.515.952.381
06/12/2017 22:00,29.99,51078,4236,24,45,1893,7,6205,5.515.952.381
06/12/2017 23:00,27.94,48508,4310,29,48,2134,8,6529,5.515.952.381
07/12/2017 00:00,27.43,46598,4497,6,57,2519,5,7084,5.515.952.381
07/12/2017 01:00,26.86,45222,4543,5,66,2763,6,7383,5.515.952.381
07/12/2017 02:00,26.59,44612,4615,5,78,3007,6,7711,5.515.952.381
07/12/2017 03:00,26.53,44615,4579,9,106,3214,7,7915,5.515.952.381
07/12/2017 04:00,26.88,45358,4597,15,144,3385,7,8148,5.515.952.381
07/12/2017 05:00,27.84,47613,4602,22,197,3592,10,8423,5.515.952.381
07/12/2017 06:00,29.52,51784,4553,30,269,3797,11,8660,5.515.952.381
07/12/2017 07:00,31.49,55922,4569,43,310,4048,22,8992,5.515.952.381
07/12/2017 08:00,31.87,56696,4547,59,317,4225,22,9170,5.515.952.381
07/12/2017 09:00,31.08,56181,4482,80,334,4396,23,9315,5.515.952.381
07/12/2017 10:00,30.09,56153,4506,101,347,4531,25,9510,5.515.952.381
07/12/2017 11:00,30.01,56048,4562,115,357,4673,24,9731,5.515.952.381
07/12/2017 12:00,29.77,55700,4616,130,361,4868,23,9998,5.515.952.381
07/12/2017 13:00,29.61,55689,4613,142,354,4973,29,10111,5.515.952.381
07/12/2017 14:00,29.39,55841,4585,147,343,5089,32,10196,5.515.952.381
07/12/2017 15:00,29.5,56431,4547,147,326,5205,33,10258,5.515.952.381
07/12/2017 16:00,29.83,57064,4577,149,320,5301,33,10380,5.515.952.381
07/12/2017 17:00,30.01,57028,4521,148,310,5304,33,10316,5.515.952.381
07/12/2017 18:00,29.69,56303,4462,152,302,5337,34,10287,5.515.952.381
07/12/2017 19:00,28.78,55240,4467,160,297,5260,37,10221,5.515.952.381
07/12/2017 20:00,27.8,53627,4513,170,295,5158,42,10178,5.515.952.381
07/12/2017 21:00,27.48,52104,4508,180,297,5072,43,10100,5.515.952.381
07/12/2017 22:00,26.41,49721,4425,188,296,4997,43,9949,5.515.952.381
07/12/2017 23:00,24.64,46973,4360,196,293,4981,41,9871,5.515.952.381
08/12/2017 00:00,24.76,44720,4038,201,249,5060,46,9594,5.515.952.381
08/12/2017 01:00,23.66,43580,4088,197,239,5057,43,9624,5.515.952.381
08/12/2017 02:00,22.69,43258,4085,195,238,4998,41,9557,5.515.952.381
08/12/2017 03:00,23.95,43476,3939,194,256,5004,39,9432,5.515.952.381
08/12/2017 04:00,25.17,44352,3697,191,254,4958,38,9138,5.515.952.381
08/12/2017 05:00,26.11,46740,3585,187,252,4940,37,9001,5.515.952.381
08/12/2017 06:00,28.63,51008,3582,183,252,4945,37,8999,5.515.952.381
08/12/2017 07:00,30.63,55367,3726,180,253,4845,35,9039,5.515.952.381
08/12/2017 08:00,30.67,56687,3803,172,247,4726,30,8978,5.515.952.381
08/12/2017 09:00,30.11,56296,3904,165,239,4605,24,8937,5.515.952.381
08/12/2017 10:00,29.9,56326,4077,159,226,4561,19,9042,5.515.952.381
08/12/2017 11:00,29.69,55950,4217,152,208,4522,19,9118,5.515.952.381
08/12/2017 12:00,29.25,55416,4363,144,193,4441,19,9160,5.515.952.381
08/12/2017 13:00,29.08,55107,4386,135,178,4293,19,9011,5.515.952.381
08/12/2017 14:00,29.06,55047,4301,132,172,4275,17,8897,5.515.952.381
08/12/2017 15:00,29.62,55427,4205,129,162,4258,15,8769,5.515.952.381
08/12/2017 16:00,30.05,56192,4181,130,161,4212,13,8697,5.515.952.381
08/12/2017 17:00,30.05,56280,4159,131,178,4197,12,8677,5.515.952.381
08/12/2017 18:00,29.81,55556,4156,137,186,4147,11,8637,5.515.952.381
08/12/2017 19:00,28.85,54125,4183,140,202,4050,11,8586,5.515.952.381
08/12/2017 20:00,28.2,52226,4248,142,214,3920,12,8536,5.515.952.381
08/12/2017 21:00,27.8,50833,4292,144,234,3827,12,8509,5.515.952.381
08/12/2017 22:00,26.92,49045,4297,146,252,3714,15,8424,5.515.952.381
08/12/2017 23:00,26.06,46782,4312,158,259,3580,14,8323,5.515.952.381
09/12/2017 00:00,26.6,44733,4446,178,284,3211,24,8143,5.515.952.381
09/12/2017 01:00,26.23,43699,4519,179,293,3104,18,8113,5.515.952.381
09/12/2017 02:00,26.03,43188,4511,179,295,2977,17,7979,5.515.952.381
09/12/2017 03:00,25.9,43059,4328,179,295,2860,19,7681,5.515.952.381
09/12/2017 04:00,26,43313,4270,183,298,2746,22,7519,5.515.952.381
09/12/2017 05:00,26.25,43987,4295,186,305,2643,24,7453,5.515.952.381
09/12/2017 06:00,26.48,45197,4303,191,307,2483,27,7311,5.515.952.381
09/12/2017 07:00,26.91,47084,4274,195,307,2360,29,7165,5.515.952.381
09/12/2017 08:00,27.2,48861,4114,196,311,2272,33,6926,5.515.952.381
09/12/2017 09:00,27.28,50415,4075,197,319,2179,33,6803,5.515.952.381
09/12/2017 10:00,27.4,51467,4167,198,325,2132,37,6859,5.515.952.381
09/12/2017 11:00,27.41,51650,4289,200,338,2038,45,6910,5.515.952.381
09/12/2017 12:00,27.37,51414,4376,202,343,1981,49,6951,5.515.952.381
09/12/2017 13:00,27.31,51100,4346,202,343,1991,52,6934,5.515.952.381
09/12/2017 14:00,27.36,51523,4233,203,328,1977,53,6794,5.515.952.381
09/12/2017 15:00,27.71,52644,4117,206,321,2004,52,6700,5.515.952.381
09/12/2017 16:00,28.3,54039,4000,208,321,1979,49,6557,5.515.952.381
09/12/2017 17:00,29.9,54518,3858,208,321,1994,45,6426,5.515.952.381
09/12/2017 18:00,28.45,53883,3727,209,321,1998,40,6295,5.515.952.381
09/12/2017 19:00,27.79,52495,3633,209,316,1960,34,6152,5.515.952.381
09/12/2017 20:00,27.33,50899,3555,207,305,1962,32,6061,5.515.952.381
09/12/2017 21:00,27.14,49775,3407,205,301,1952,29,5894,5.515.952.381
09/12/2017 22:00,26.82,48312,3115,203,292,1910,28,5548,5.515.952.381
09/12/2017 23:00,26.79,46747,2634,179,277,1894,26,5010,5.515.952.381
10/12/2017 00:00,27.27,45505,2529,150,188,1747,25,4639,5.515.952.381
10/12/2017 01:00,27.05,44405,2495,147,189,1703,24,4558,5.515.952.381
10/12/2017 02:00,26.91,43888,2398,144,192,1678,22,4434,5.515.952.381
10/12/2017 03:00,26.85,43738,2276,141,190,1677,18,4302,5.515.952.381
10/12/2017 04:00,26.87,43954,2177,138,189,1621,14,4139,5.515.952.381
10/12/2017 05:00,27.12,44413,2103,132,186,1589,14,4024,5.515.952.381
10/12/2017 06:00,27.38,45247,2033,125,186,1599,11,3954,5.515.952.381
10/12/2017 07:00,27.43,46529,1939,117,190,1555,10,3811,5.515.952.381
10/12/2017 08:00,27.85,48095,2011,106,197,1481,8,3803,5.515.952.381
10/12/2017 09:00,28.56,49696,1891,98,197,1451,9,3646,5.515.952.381
10/12/2017 10:00,29.15,51007,1737,91,196,1445,8,3477,5.515.952.381
10/12/2017 11:00,29.57,51652,1680,85,220,1420,7,3412,5.515.952.381
10/12/2017 12:00,29.26,51574,1864,78,230,1420,7,3599,5.515.952.381
10/12/2017 13:00,28.94,51584,1660,71,228,1403,8,3370,5.515.952.381
10/12/2017 14:00,28.94,52148,1491,68,221,1418,9,3207,5.515.952.381
10/12/2017 15:00,29.44,53247,1541,68,197,1455,11,3272,5.515.952.381
10/12/2017 16:00,30.27,54583,1613,71,198,1454,15,3351,5.515.952.381
10/12/2017 17:00,29.96,55276,1676,76,208,1529,16,3505,5.515.952.381
10/12/2017 18:00,29.46,55050,1859,82,213,1492,16,3662,5.515.952.381
10/12/2017 19:00,29.27,54266,1946,84,208,1437,18,3693,5.515.952.381
10/12/2017 20:00,28.71,53084,1993,85,182,1367,22,3649,5.515.952.381
10/12/2017 21:00,28.43,52130,2036,85,161,1307,26,3615,5.515.952.381
10/12/2017 22:00,27.93,50561,1989,84,157,1245,27,3502,5.515.952.381
10/12/2017 23:00,27.52,48606,1933,78,161,1152,24,3348,5.515.952.381
11/12/2017 00:00,27.25,46558,1600,66,258,1097,20,3041,5.300.238.095
11/12/2017 01:00,26.94,45773,1385,63,273,1092,19,2832,5.300.238.095
11/12/2017 02:00,26.81,45540,1313,62,291,1096,20,2782,5.300.238.095
11/12/2017 03:00,26.92,45752,1242,63,291,1061,22,2679,5.300.238.095
11/12/2017 04:00,27.81,46708,1179,64,277,1057,21,2598,5.300.238.095
11/12/2017 05:00,29.45,49130,1032,63,269,1029,26,2419,5.300.238.095
11/12/2017 06:00,33.84,53666,862,62,262,1004,26,2216,5.300.238.095
11/12/2017 07:00,51.1,58338,871,62,245,976,24,2178,5.300.238.095
11/12/2017 08:00,59.75,59708,1003,63,234,925,19,2244,5.300.238.095
11/12/2017 09:00,56.63,59451,1003,64,227,911,15,2220,5.300.238.095
11/12/2017 10:00,50.95,59343,988,64,209,883,14,2158,5.300.238.095
11/12/2017 11:00,51.05,59029,928,62,211,792,13,2006,5.300.238.095
11/12/2017 12:00,50.31,58682,848,62,211,811,11,1943,5.300.238.095
11/12/2017 13:00,49.02,58713,912,62,217,773,9,1973,5.300.238.095
11/12/2017 14:00,52.44,59028,1018,65,222,764,8,2077,5.300.238.095
11/12/2017 15:00,50.04,59865,1243,69,203,834,7,2356,5.300.238.095
11/12/2017 16:00,49.91,60563,1477,71,200,902,7,2657,5.300.238.095
11/12/2017 17:00,49.06,60568,1816,72,195,970,6,3059,5.300.238.095
11/12/2017 18:00,41.75,59694,2089,71,184,985,7,3336,5.300.238.095
11/12/2017 19:00,37.75,58519,2199,75,170,1020,5,3469,5.300.238.095
11/12/2017 20:00,33.9,56800,2229,78,157,1051,5,3520,5.300.238.095
11/12/2017 21:00,32.31,55279,2159,82,155,972,5,3373,5.300.238.095
11/12/2017 22:00,30.57,52883,2155,88,141,966,6,3356,5.300.238.095
11/12/2017 23:00,28.21,50193,2168,96,127,1008,7,3406,5.300.238.095
12/12/2017 00:00,27.96,48016,2313,103,278,1087,17,3798,5.300.238.095
12/12/2017 01:00,27.4,46891,2552,108,288,1112,20,4080,5.300.238.095
12/12/2017 02:00,27.14,46569,2631,114,288,1148,28,4209,5.300.238.095
12/12/2017 03:00,27.03,46734,2652,117,278,1202,29,4278,5.300.238.095
12/12/2017 04:00,27.38,47570,2691,122,278,1250,33,4374,5.300.238.095
12/12/2017 05:00,28.03,50061,2757,135,278,1261,35,4466,5.300.238.095
12/12/2017 06:00,30.4,54715,2613,151,282,1305,37,4388,5.300.238.095
12/12/2017 07:00,33.01,59285,2689,163,285,1311,41,4489,5.300.238.095
12/12/2017 08:00,35.43,60354,2668,171,287,1333,44,4503,5.300.238.095
12/12/2017 09:00,35.33,59772,2419,179,294,1336,46,4274,5.300.238.095
12/12/2017 10:00,34.75,59844,2416,189,300,1377,49,4331,5.300.238.095
12/12/2017 11:00,35.56,59650,2409,195,302,1430,49,4385,5.300.238.095
12/12/2017 12:00,36.2,59201,2364,201,302,1512,46,4425,5.300.238.095
12/12/2017 13:00,36.24,59093,2216,206,320,1563,44,4349,5.300.238.095
12/12/2017 14:00,37.33,59408,2095,209,350,1672,51,4377,5.300.238.095
12/12/2017 15:00,38.74,59963,2007,213,365,1763,50,4398,5.300.238.095
12/12/2017 16:00,43.2,60826,1940,212,378,1830,48,4408,5.300.238.095
12/12/2017 17:00,41.67,60939,1944,207,385,1840,55,4431,5.300.238.095
12/12/2017 18:00,38.59,60238,1991,201,390,1847,59,4488,5.300.238.095
12/12/2017 19:00,34.8,59265,2156,192,393,1907,59,4707,5.300.238.095
12/12/2017 20:00,33.08,57702,2386,179,397,1885,59,4906,5.300.238.095
12/12/2017 21:00,31.5,56175,2537,165,400,1896,59,5057,5.300.238.095
12/12/2017 22:00,29.78,53838,2685,154,402,1913,58,5212,5.300.238.095
12/12/2017 23:00,27.96,51141,2920,151,400,2069,56,5596,5.300.238.095
13/12/2017 00:00,27.48,48939,3388,151,400,2469,38,6446,5.300.238.095
13/12/2017 01:00,27.25,47952,3494,172,388,2662,45,6761,5.300.238.095
13/12/2017 02:00,27.24,47587,3562,187,375,2835,41,7000,5.300.238.095
13/12/2017 03:00,27.24,47723,3604,203,359,2997,36,7199,5.300.238.095
13/12/2017 04:00,27.35,48551,3637,205,339,3079,32,7292,5.300.238.095
13/12/2017 05:00,27.8,50816,3709,192,317,3208,30,7456,5.300.238.095
13/12/2017 06:00,29.42,55045,3691,179,273,3377,22,7542,5.300.238.095
13/12/2017 07:00,31.59,59376,3809,168,258,3529,20,7784,5.300.238.095
13/12/2017 08:00,32.17,60284,3913,165,277,3596,17,7968,5.300.238.095
13/12/2017 09:00,31.65,59710,3982,164,306,3538,16,8006,5.300.238.095
13/12/2017 10:00,30.52,59609,4057,154,316,3649,18,8194,5.300.238.095
13/12/2017 11:00,29.82,59334,4069,151,299,3688,26,8233,5.300.238.095
13/12/2017 12:00,29.97,58851,3955,159,285,3686,37,8122,5.300.238.095
13/12/2017 13:00,30.21,58736,3777,164,271,3603,38,7853,5.300.238.095
13/12/2017 14:00,30.68,58986,3470,170,265,3659,41,7605,5.300.238.095
13/12/2017 15:00,31.51,59612,3084,179,253,3668,43,7227,5.300.238.095
13/12/2017 16:00,31.98,60211,2875,191,254,3630,42,6992,5.300.238.095
13/12/2017 17:00,32.55,60076,2753,202,263,3531,39,6788,5.300.238.095
13/12/2017 18:00,31.71,59183,2681,212,267,3498,38,6696,5.300.238.095
13/12/2017 19:00,30.24,57944,2704,217,275,3366,43,6605,5.300.238.095
13/12/2017 20:00,29.08,56148,2754,219,280,3310,46,6609,5.300.238.095
13/12/2017 21:00,27.98,54545,2790,218,284,3135,45,6472,5.300.238.095
13/12/2017 22:00,27.24,52047,2716,216,287,2862,47,6128,5.300.238.095
13/12/2017 23:00,26.49,49316,2627,200,288,2756,48,5919,5.300.238.095
14/12/2017 00:00,26.23,47889,2561,208,264,2617,44,5694,5.300.238.095
14/12/2017 01:00,25.9,46709,2454,205,307,2407,44,5417,5.300.238.095
14/12/2017 02:00,25.71,46244,2401,202,323,2203,45,5174,5.300.238.095
14/12/2017 03:00,25.96,46260,2498,199,335,2058,46,5136,5.300.238.095
14/12/2017 04:00,26.47,47130,2562,197,338,1946,49,5092,5.300.238.095
14/12/2017 05:00,27.37,49558,2650,196,342,1844,50,5082,5.300.238.095
14/12/2017 06:00,29.76,53936,2565,195,345,1758,50,4913,5.300.238.095
14/12/2017 07:00,32.87,57880,2671,195,345,1698,52,4961,5.300.238.095
14/12/2017 08:00,36.21,59106,2591,195,343,1614,51,4794,5.300.238.095
14/12/2017 09:00,34,58696,2377,194,343,1555,46,4515,5.300.238.095
14/12/2017 10:00,32.08,58742,2348,190,331,1420,44,4333,5.300.238.095
14/12/2017 11:00,31.81,58577,2621,186,325,1412,42,4586,5.300.238.095
14/12/2017 12:00,31.77,58346,2818,181,320,1471,39,4829,5.300.238.095
14/12/2017 13:00,31.72,58438,2870,179,309,1545,35,4938,5.300.238.095
14/12/2017 14:00,32.18,58709,2970,176,278,1583,28,5035,5.300.238.095
14/12/2017 15:00,33.8,59454,2881,174,224,1596,24,4899,5.300.238.095
14/12/2017 16:00,34.85,60250,2863,170,193,1588,21,4835,5.300.238.095
14/12/2017 17:00,35.53,60366,2803,167,184,1683,19,4856,5.300.238.095
14/12/2017 18:00,33.12,59578,2609,162,170,1751,16,4708,5.300.238.095
14/12/2017 19:00,31.59,58430,2483,157,179,1829,14,4662,5.300.238.095
14/12/2017 20:00,30.44,56752,2388,150,209,1875,11,4633,5.300.238.095
14/12/2017 21:00,30.07,55282,2332,141,238,1926,10,4647,5.300.238.095
14/12/2017 22:00,29.42,52805,2214,132,250,1936,10,4542,5.300.238.095
14/12/2017 23:00,28.26,49959,1999,126,250,1908,11,4294,5.300.238.095
15/12/2017 00:00,28.64,48371,1563,114,237,1893,18,3825,5.300.238.095
15/12/2017 01:00,28.39,47086,1487,101,243,1878,15,3724,5.300.238.095
15/12/2017 02:00,28.24,46614,1317,88,248,1822,13,3488,5.300.238.095
15/12/2017 03:00,28.26,46760,1130,82,260,1759,11,3242,5.300.238.095
15/12/2017 04:00,28.88,47655,1026,73,263,1708,10,3080,5.300.238.095
15/12/2017 05:00,30.23,50083,887,67,260,1675,10,2899,5.300.238.095
15/12/2017 06:00,35.02,54358,766,64,263,1661,12,2766,5.300.238.095
15/12/2017 07:00,48.11,58898,789,68,254,1628,13,2752,5.300.238.095
15/12/2017 08:00,53.01,60258,808,78,253,1567,15,2721,5.300.238.095
15/12/2017 09:00,52.94,59786,829,91,247,1537,17,2721,5.300.238.095
15/12/2017 10:00,46.84,59808,811,104,229,1505,17,2666,5.300.238.095
15/12/2017 11:00,45.13,59465,782,115,208,1421,17,2543,5.300.238.095
15/12/2017 12:00,46.04,58938,776,122,208,1312,18,2436,5.300.238.095
15/12/2017 13:00,42.01,58518,808,125,202,1287,19,2441,5.300.238.095
15/12/2017 14:00,42.08,58573,818,129,189,1271,20,2427,5.300.238.095
15/12/2017 15:00,41.67,59096,851,136,170,1263,24,2444,5.300.238.095
15/12/2017 16:00,45,59787,941,143,155,1236,27,2502,5.300.238.095
15/12/2017 17:00,42.24,59816,1012,148,138,1173,29,2500,5.300.238.095
15/12/2017 18:00,38.65,58970,1101,149,122,1124,26,2522,5.300.238.095
15/12/2017 19:00,33.12,57420,1214,147,112,1113,21,2607,5.300.238.095
15/12/2017 20:00,31.21,55466,1326,140,105,1070,20,2661,5.300.238.095
15/12/2017 21:00,30.52,53927,1479,132,98,1073,22,2804,5.300.238.095
15/12/2017 22:00,29.74,52067,1539,125,100,1073,24,2861,5.300.238.095
15/12/2017 23:00,29.03,49740,1464,131,112,1074,22,2803,5.300.238.095
16/12/2017 00:00,29.94,47907,1046,161,70,815,17,2109,5.300.238.095
16/12/2017 01:00,29.08,46780,1056,151,70,786,16,2079,5.300.238.095
16/12/2017 02:00,28.97,46189,1026,142,75,796,15,2054,5.300.238.095
16/12/2017 03:00,28.9,46052,1048,131,90,782,13,2064,5.300.238.095
16/12/2017 04:00,29,46289,1056,117,95,770,11,2049,5.300.238.095
16/12/2017 05:00,29.28,47051,998,104,100,769,11,1982,5.300.238.095
16/12/2017 06:00,30.2,48265,864,86,105,750,9,1814,5.300.238.095
16/12/2017 07:00,30.63,50103,904,69,110,739,9,1831,5.300.238.095
16/12/2017 08:00,30.71,51970,798,56,110,744,9,1717,5.300.238.095
16/12/2017 09:00,31.15,53613,724,46,100,746,9,1625,5.300.238.095
16/12/2017 10:00,31.75,54580,735,40,90,732,8,1605,5.300.238.095
16/12/2017 11:00,32.1,54748,729,36,85,715,7,1572,5.300.238.095
16/12/2017 12:00,31.56,54428,774,33,80,722,7,1616,5.300.238.095
16/12/2017 13:00,31.29,54174,866,30,80,769,6,1751,5.300.238.095
16/12/2017 14:00,31.5,54577,1031,27,80,820,6,1964,5.300.238.095
16/12/2017 15:00,32.37,55686,1126,25,80,890,6,2127,5.300.238.095
16/12/2017 16:00,35.6,56962,1181,23,85,951,6,2246,5.300.238.095
16/12/2017 17:00,37.24,57525,1227,19,95,971,6,2318,5.300.238.095
16/12/2017 18:00,33.52,56917,1239,16,100,1048,6,2409,5.300.238.095
16/12/2017 19:00,31.75,55515,1183,14,100,1128,6,2431,5.300.238.095
16/12/2017 20:00,30.7,53801,1199,12,100,1179,6,2496,5.300.238.095
16/12/2017 21:00,30.55,52626,1185,11,100,1263,6,2565,5.300.238.095
16/12/2017 22:00,30.09,51114,1108,10,100,1318,6,2542,5.300.238.095
16/12/2017 23:00,29.02,49490,1052,8,100,1305,6,2471,5.300.238.095
17/12/2017 00:00,28.9,48216,1191,3,120,1387,6,2707,5.300.238.095
17/12/2017 01:00,28.2,47146,1221,4,115,1441,6,2787,5.300.238.095
17/12/2017 02:00,28.2,46756,1139,4,90,1516,6,2755,5.300.238.095
17/12/2017 03:00,27.94,46647,971,4,90,1542,6,2613,5.300.238.095
17/12/2017 04:00,28.22,46921,811,5,90,1567,6,2479,5.300.238.095
17/12/2017 05:00,28.38,47525,686,7,90,1552,6,2341,5.300.238.095
17/12/2017 06:00,28.58,48469,512,10,95,1577,6,2200,5.300.238.095
17/12/2017 07:00,29.4,50025,430,11,100,1519,6,2066,5.300.238.095
17/12/2017 08:00,30.33,51735,317,12,100,1495,7,1931,5.300.238.095
17/12/2017 09:00,31.36,53436,238,14,95,1423,8,1778,5.300.238.095
17/12/2017 10:00,31.82,54784,214,14,90,1379,8,1705,5.300.238.095
17/12/2017 11:00,32.61,55307,216,14,85,1406,8,1729,5.300.238.095
17/12/2017 12:00,32.13,55188,333,14,80,1404,8,1839,5.300.238.095
17/12/2017 13:00,31.91,55161,488,15,80,1380,8,1971,5.300.238.095
17/12/2017 14:00,31.81,55464,634,16,85,1551,8,2294,5.300.238.095
17/12/2017 15:00,32.58,56527,725,18,90,1627,8,2468,5.300.238.095
17/12/2017 16:00,33.65,57851,882,16,90,1705,7,2700,5.300.238.095
17/12/2017 17:00,33.69,58440,1001,14,90,1772,7,2884,5.300.238.095
17/12/2017 18:00,32.72,58144,1196,13,80,1869,6,3164,5.300.238.095
17/12/2017 19:00,31.62,57155,1434,13,80,1867,7,3401,5.300.238.095
17/12/2017 20:00,30.7,55695,1762,14,80,1950,7,3813,5.300.238.095
17/12/2017 21:00,30.27,54698,2122,19,80,2040,6,4267,5.300.238.095
17/12/2017 22:00,29.68,52883,2442,23,80,2079,6,4630,5.300.238.095
17/12/2017 23:00,28.59,50843,2607,32,80,2038,6,4763,5.300.238.095
18/12/2017 00:00,28.22,49417,2036,48,70,2297,7,4458,5.189.583.333
18/12/2017 01:00,27.9,48456,2100,52,65,2297,7,4521,5.189.583.333
18/12/2017 02:00,27.55,47989,2042,53,60,2221,7,4383,5.189.583.333
18/12/2017 03:00,27.39,48032,2047,52,50,2185,7,4341,5.189.583.333
18/12/2017 04:00,28.04,49160,1971,52,45,2137,7,4212,5.189.583.333
18/12/2017 05:00,29.94,51475,1775,53,45,2089,6,3968,5.189.583.333
18/12/2017 06:00,32.14,56001,1590,54,45,2051,6,3746,5.189.583.333
18/12/2017 07:00,42.11,60720,1512,54,40,2105,6,3717,5.189.583.333
18/12/2017 08:00,45.07,62051,1464,54,40,2096,6,3660,5.189.583.333
18/12/2017 09:00,45.08,61479,1495,53,40,2137,8,3733,5.189.583.333
18/12/2017 10:00,38.96,61333,1473,53,40,2153,6,3725,5.189.583.333
18/12/2017 11:00,36.67,60896,1289,52,40,2147,6,3534,5.189.583.333
18/12/2017 12:00,39.95,60473,1120,52,35,2264,9,3480,5.189.583.333
18/12/2017 13:00,39.16,60433,978,53,30,2219,7,3287,5.189.583.333
18/12/2017 14:00,42.05,60553,878,54,35,2273,7,3247,5.189.583.333
18/12/2017 15:00,50.01,61217,814,56,40,2324,8,3242,5.189.583.333
18/12/2017 16:00,52.06,61807,763,56,40,2299,8,3166,5.189.583.333
18/12/2017 17:00,55.47,61760,679,57,45,2280,9,3070,5.189.583.333
18/12/2017 18:00,48.01,60867,629,57,45,2205,9,2945,5.189.583.333
18/12/2017 19:00,39.61,59648,556,58,50,2180,9,2853,5.189.583.333
18/12/2017 20:00,34.11,57794,503,58,55,2112,7,2735,5.189.583.333
18/12/2017 21:00,33.18,56165,470,58,60,1988,7,2583,5.189.583.333
18/12/2017 22:00,31.46,53431,429,57,65,1889,6,2446,5.189.583.333
18/12/2017 23:00,30.43,50630,385,55,65,1674,6,2185,5.189.583.333
19/12/2017 00:00,30.34,48848,660,63,43,1511,10,2287,5.189.583.333
19/12/2017 01:00,29.36,47600,587,52,44,1239,10,1932,5.189.583.333
19/12/2017 02:00,29.29,47292,523,39,47,1149,9,1767,5.189.583.333
19/12/2017 03:00,29.38,47525,466,28,50,970,8,1522,5.189.583.333
19/12/2017 04:00,30.93,48331,393,20,49,786,9,1257,5.189.583.333
19/12/2017 05:00,31.98,50880,335,17,44,690,7,1093,5.189.583.333
19/12/2017 06:00,36.21,55379,319,14,44,627,8,1012,5.189.583.333
19/12/2017 07:00,66.43,60063,271,11,42,595,8,927,5.189.583.333
19/12/2017 08:00,70.09,61443,220,9,40,670,7,946,5.189.583.333
19/12/2017 09:00,66.54,60815,209,8,37,865,9,1128,5.189.583.333
19/12/2017 10:00,46.42,60742,187,7,35,1068,9,1306,5.189.583.333
19/12/2017 11:00,44.41,60452,213,5,35,1285,10,1548,5.189.583.333
19/12/2017 12:00,47.93,59979,240,4,34,1578,10,1866,5.189.583.333
19/12/2017 13:00,48.07,59874,265,4,38,1792,9,2108,5.189.583.333
19/12/2017 14:00,46.71,59927,284,4,43,2043,9,2383,5.189.583.333
19/12/2017 15:00,50.18,60587,263,4,65,2150,8,2490,5.189.583.333
19/12/2017 16:00,51.32,61187,256,3,74,2294,8,2635,5.189.583.333
19/12/2017 17:00,56.78,61124,307,2,87,2259,8,2663,5.189.583.333
19/12/2017 18:00,40.34,60250,362,3,97,2256,6,2724,5.189.583.333
19/12/2017 19:00,33.94,59008,391,2,98,2311,5,2807,5.189.583.333
19/12/2017 20:00,31.96,57237,365,2,99,2328,5,2799,5.189.583.333
19/12/2017 21:00,31.03,55480,343,3,99,2329,5,2779,5.189.583.333
19/12/2017 22:00,29.82,52897,331,4,100,2316,5,2756,5.189.583.333
19/12/2017 23:00,29.06,50013,364,19,101,2449,6,2939,5.189.583.333
20/12/2017 00:00,29.09,47829,439,8,79,2513,5,3044,5.189.583.333
20/12/2017 01:00,28.45,46386,505,9,82,2570,5,3171,5.189.583.333
20/12/2017 02:00,28.05,45788,534,10,82,2439,5,3070,5.189.583.333
20/12/2017 03:00,28.07,45808,543,14,64,2434,5,3060,5.189.583.333
20/12/2017 04:00,28.75,46596,574,17,60,2411,5,3067,5.189.583.333
20/12/2017 05:00,29.56,48838,611,20,47,2396,5,3079,5.189.583.333
20/12/2017 06:00,31.29,53043,695,25,40,2409,5,3174,5.189.583.333
20/12/2017 07:00,35.83,57413,724,31,33,2334,6,3128,5.189.583.333
20/12/2017 08:00,39.57,58510,830,38,31,2298,6,3203,5.189.583.333
20/12/2017 09:00,39.53,57955,901,45,30,2275,6,3257,5.189.583.333
20/12/2017 10:00,35.47,57856,931,52,27,2282,6,3298,5.189.583.333
20/12/2017 11:00,34.95,57620,1028,59,22,2314,7,3430,5.189.583.333
20/12/2017 12:00,35.1,57295,1093,69,19,2390,7,3578,5.189.583.333
20/12/2017 13:00,34.92,57281,1110,81,17,2536,8,3752,5.189.583.333
20/12/2017 14:00,35.36,57527,1057,96,18,2684,8,3863,5.189.583.333
20/12/2017 15:00,35.51,58112,1011,112,25,2881,9,4038,5.189.583.333
20/12/2017 16:00,35.51,58595,1031,132,29,3033,11,4236,5.189.583.333
20/12/2017 17:00,36.28,58545,1100,151,34,2981,12,4278,5.189.583.333
20/12/2017 18:00,33.56,57702,1214,167,43,2957,14,4395,5.189.583.333
20/12/2017 19:00,31.71,56585,1282,178,57,2874,16,4407,5.189.583.333
20/12/2017 20:00,30.89,54962,1352,185,73,2888,17,4515,5.189.583.333
20/12/2017 21:00,30.03,53478,1494,191,94,2859,17,4655,5.189.583.333
20/12/2017 22:00,29.04,50935,1648,194,110,2808,21,4781,5.189.583.333
20/12/2017 23:00,28,48184,1753,190,127,2737,22,4829,5.189.583.333
21/12/2017 00:00,27.57,46206,1677,215,180,2654,32,4758,5.189.583.333
21/12/2017 01:00,27.08,45128,1694,211,195,2583,34,4717,5.189.583.333
21/12/2017 02:00,26.98,44804,1690,203,205,2535,36,4669,5.189.583.333
21/12/2017 03:00,26.95,45038,1659,189,205,2600,39,4692,5.189.583.333
21/12/2017 04:00,27.36,46080,1538,164,220,2722,38,4682,5.189.583.333
21/12/2017 05:00,27.99,48472,1463,135,230,2994,32,4854,5.189.583.333
21/12/2017 06:00,29.43,52831,1496,114,230,3242,22,5104,5.189.583.333
21/12/2017 07:00,31.59,57290,1573,95,230,3500,17,5415,5.189.583.333
21/12/2017 08:00,31.79,58620,1597,83,225,3639,12,5556,5.189.583.333
21/12/2017 09:00,31.2,58287,1620,76,220,3700,9,5625,5.189.583.333
21/12/2017 10:00,30.47,58124,1677,73,200,3698,8,5656,5.189.583.333
21/12/2017 11:00,30.48,57812,1753,64,180,3720,9,5726,5.189.583.333
21/12/2017 12:00,30.22,57441,1844,53,155,3698,10,5760,5.189.583.333
21/12/2017 13:00,30.15,57320,2028,44,125,3700,10,5907,5.189.583.333
21/12/2017 14:00,30.64,57539,2127,36,100,3706,11,5980,5.189.583.333
21/12/2017 15:00,31.04,58358,2213,29,75,3742,8,6067,5.189.583.333
21/12/2017 16:00,31.24,59034,2341,26,70,3779,6,6222,5.189.583.333
21/12/2017 17:00,31.34,59158,2318,27,70,3802,9,6226,5.189.583.333
21/12/2017 18:00,30.99,58519,2282,32,75,3816,9,6214,5.189.583.333
21/12/2017 19:00,30.05,57398,2343,37,80,3821,11,6292,5.189.583.333
21/12/2017 20:00,29.54,55880,2401,36,80,3734,13,6264,5.189.583.333
21/12/2017 21:00,29.15,54542,2439,33,80,3712,13,6277,5.189.583.333
21/12/2017 22:00,28.04,52302,2487,34,80,3660,13,6274,5.189.583.333
21/12/2017 23:00,27.3,48967,2433,35,75,3736,11,6290,5.189.583.333
22/12/2017 00:00,27.12,46538,2239,30,87,3879,11,6246,5.189.583.333
22/12/2017 01:00,26.47,45400,2303,30,78,3904,9,6324,5.189.583.333
22/12/2017 02:00,26.23,45004,2367,31,71,3923,11,6403,5.189.583.333
22/12/2017 03:00,26.38,45073,2380,32,78,3932,9,6431,5.189.583.333
22/12/2017 04:00,26.95,45843,2324,37,80,3907,10,6358,5.189.583.333
22/12/2017 05:00,27.61,47906,2255,41,93,3952,10,6351,5.189.583.333
22/12/2017 06:00,28.92,51981,2168,45,108,3948,10,6279,5.189.583.333
22/12/2017 07:00,30.64,56509,2234,51,115,3991,11,6402,5.189.583.333
22/12/2017 08:00,31.7,58007,2282,57,115,3921,13,6388,5.189.583.333
22/12/2017 09:00,31.36,57734,2301,67,120,3992,14,6494,5.189.583.333
22/12/2017 10:00,30.83,57543,2397,71,122,4002,14,6606,5.189.583.333
22/12/2017 11:00,30.63,57054,2530,71,132,3983,20,6736,5.189.583.333
22/12/2017 12:00,30.16,56375,2613,72,137,4010,29,6861,5.189.583.333
22/12/2017 13:00,29.88,55927,2675,78,144,4039,28,6964,5.189.583.333
22/12/2017 14:00,30,55851,2685,83,158,3988,28,6942,5.189.583.333
22/12/2017 15:00,30.49,56399,2551,86,165,3968,28,6798,5.189.583.333
22/12/2017 16:00,30.9,57217,2521,88,168,3792,27,6596,5.189.583.333
22/12/2017 17:00,31.22,57319,2481,91,160,3545,28,6305,5.189.583.333
22/12/2017 18:00,30.87,56535,2421,92,158,3180,28,5879,5.189.583.333
22/12/2017 19:00,29.91,54918,2383,95,163,3001,29,5671,5.189.583.333
22/12/2017 20:00,29.14,52966,2293,96,175,2818,34,5416,5.189.583.333
22/12/2017 21:00,28.85,51407,2283,95,188,2718,30,5314,5.189.583.333
22/12/2017 22:00,27.82,49414,2443,91,189,2835,26,5584,5.189.583.333
22/12/2017 23:00,26.94,47237,2716,93,174,3012,23,6018,5.189.583.333
23/12/2017 00:00,26.15,45096,3301,67,157,3542,12,7079,5.189.583.333
23/12/2017 01:00,24.63,43832,3629,54,133,3909,9,7734,5.189.583.333
23/12/2017 02:00,22.55,43115,3872,43,119,4326,8,8368,5.189.583.333
23/12/2017 03:00,20.98,42737,4039,37,112,4687,7,8882,5.189.583.333
23/12/2017 04:00,21.03,42918,4142,33,111,4968,7,9261,5.189.583.333
23/12/2017 05:00,20.41,43805,4200,41,120,5003,8,9372,5.189.583.333
23/12/2017 06:00,21.05,45014,4213,66,137,5204,9,9629,5.189.583.333
23/12/2017 07:00,22.39,46642,4171,101,167,5321,11,9771,5.189.583.333
23/12/2017 08:00,24.01,48148,4201,141,219,5416,18,9995,5.189.583.333
23/12/2017 09:00,24.37,49295,4175,176,254,5423,29,10057,5.189.583.333
23/12/2017 10:00,24.83,50219,4146,200,301,5509,43,10199,5.189.583.333
23/12/2017 11:00,24.18,50280,4193,217,328,5472,54,10264,5.189.583.333
23/12/2017 12:00,24.06,49680,4301,224,352,5356,56,10289,5.189.583.333
23/12/2017 13:00,23.49,49356,4437,217,358,5435,56,10503,5.189.583.333
23/12/2017 14:00,23.61,49461,4562,209,358,5447,52,10628,5.189.583.333
23/12/2017 15:00,24.74,50389,4573,215,342,5478,49,10657,5.189.583.333
23/12/2017 16:00,25.49,51315,4602,225,345,5429,45,10646,5.189.583.333
23/12/2017 17:00,25.75,51653,4528,219,348,5255,46,10396,5.189.583.333
23/12/2017 18:00,25.33,51054,4524,206,350,5114,48,10242,5.189.583.333
23/12/2017 19:00,25.03,49727,4536,198,356,4979,50,10119,5.189.583.333
23/12/2017 20:00,24.65,48097,4474,198,358,5006,49,10085,5.189.583.333
23/12/2017 21:00,23.14,46913,4477,202,358,4928,47,10012,5.189.583.333
23/12/2017 22:00,22.12,45483,4519,205,370,4864,43,10001,5.189.583.333
23/12/2017 23:00,20.08,43940,4477,203,374,4676,45,9775,5.189.583.333
24/12/2017 00:00,20.08,42331,4019,219,406,4518,30,9192,5.189.583.333
24/12/2017 01:00,19.67,41223,3979,222,405,4283,31,8920,5.189.583.333
24/12/2017 02:00,19.29,40790,4204,228,395,4084,35,8946,5.189.583.333
24/12/2017 03:00,19.55,40756,4063,235,343,3930,33,8604,5.189.583.333
24/12/2017 04:00,20.01,40942,3910,240,309,3801,33,8293,5.189.583.333
24/12/2017 05:00,21.16,41769,3740,244,303,3773,32,8092,5.189.583.333
24/12/2017 06:00,23.09,43166,3446,244,271,3814,26,7801,5.189.583.333
24/12/2017 07:00,25.09,44980,3171,243,235,3792,19,7460,5.189.583.333
24/12/2017 08:00,25.83,47076,3035,242,216,3702,15,7210,5.189.583.333
24/12/2017 09:00,26.56,48557,3086,239,194,3494,12,7025,5.189.583.333
24/12/2017 10:00,26.92,49517,3152,233,170,3457,11,7023,5.189.583.333
24/12/2017 11:00,26.84,49797,3291,228,145,3334,15,7013,5.189.583.333
24/12/2017 12:00,26.54,49442,3488,222,126,3150,12,6998,5.189.583.333
24/12/2017 13:00,26.54,48963,3833,208,137,3051,12,7241,5.189.583.333
24/12/2017 14:00,26.43,49008,4198,186,182,2888,14,7468,5.189.583.333
24/12/2017 15:00,26.75,49753,4354,161,209,2735,13,7472,5.189.583.333
24/12/2017 16:00,27.09,50172,4390,139,222,2668,10,7429,5.189.583.333
24/12/2017 17:00,26.84,49219,4285,118,216,2621,8,7248,5.189.583.333
24/12/2017 18:00,26.21,47674,4261,96,202,2604,7,7170,5.189.583.333
24/12/2017 19:00,25.81,46736,4140,81,177,2579,10,6987,5.189.583.333
24/12/2017 20:00,25.45,46101,3846,70,138,2580,13,6647,5.189.583.333
24/12/2017 21:00,25.93,45939,3597,64,109,2588,17,6375,5.189.583.333
24/12/2017 22:00,25.9,45447,3470,58,99,2530,20,6177,5.189.583.333
24/12/2017 23:00,25.65,44669,3336,64,99,2503,30,6032,5.189.583.333
25/12/2017 00:00,25.79,42871,3197,50,35,2481,9,5772,5.099.761.905
25/12/2017 01:00,25.02,42152,3085,45,28,2494,7,5659,5.099.761.905
25/12/2017 02:00,24.34,41669,3080,43,27,2525,7,5682,5.099.761.905
25/12/2017 03:00,23.71,41503,3140,40,38,2582,6,5806,5.099.761.905
25/12/2017 04:00,23.43,41596,3196,36,36,2539,5,5812,5.099.761.905
25/12/2017 05:00,24.23,42117,3353,31,33,2522,5,5944,5.099.761.905
25/12/2017 06:00,24.6,42900,3630,27,32,2553,5,6247,5.099.761.905
25/12/2017 07:00,25.34,43887,3963,25,33,2582,5,6608,5.099.761.905
25/12/2017 08:00,25.46,45143,4212,26,36,2648,6,6928,5.099.761.905
25/12/2017 09:00,25.64,46244,4267,30,40,2659,7,7003,5.099.761.905
25/12/2017 10:00,26.03,47387,4268,38,53,2761,7,7127,5.099.761.905
25/12/2017 11:00,26.11,47942,4283,50,93,2809,8,7243,5.099.761.905
25/12/2017 12:00,26.07,47991,4330,61,148,2849,9,7397,5.099.761.905
25/12/2017 13:00,25.98,47909,4383,69,220,2903,12,7587,5.099.761.905
25/12/2017 14:00,26.02,48038,4271,78,288,3018,20,7675,5.099.761.905
25/12/2017 15:00,26.39,48795,4020,91,320,3039,30,7500,5.099.761.905
25/12/2017 16:00,26.66,49416,3907,102,339,3100,38,7486,5.099.761.905
25/12/2017 17:00,26.75,49464,3786,111,348,3154,51,7450,5.099.761.905
25/12/2017 18:00,27.13,48941,3787,121,361,3292,56,7617,5.099.761.905
25/12/2017 19:00,26.97,48246,3825,131,370,3339,57,7722,5.099.761.905
25/12/2017 20:00,26.27,47461,3795,140,380,3321,57,7693,5.099.761.905
25/12/2017 21:00,26.05,46953,3814,149,382,3231,56,7632,5.099.761.905
25/12/2017 22:00,25.84,45571,3791,156,384,3084,57,7472,5.099.761.905
25/12/2017 23:00,25.22,43750,3723,165,381,2963,58,7290,5.099.761.905
26/12/2017 00:00,25.82,41942,3817,195,398,2929,57,7396,5.099.761.905
26/12/2017 01:00,24.94,41236,3839,195,392,2800,57,7283,5.099.761.905
26/12/2017 02:00,23.81,41088,3796,192,375,2685,56,7104,5.099.761.905
26/12/2017 03:00,23.68,41089,3804,184,342,2643,54,7027,5.099.761.905
26/12/2017 04:00,24.29,41331,3829,172,324,2584,51,6960,5.099.761.905
26/12/2017 05:00,25.04,42223,3867,157,304,2539,49,6916,5.099.761.905
26/12/2017 06:00,25.26,44145,3944,140,278,2558,51,6971,5.099.761.905
26/12/2017 07:00,25.79,46684,4039,127,254,2548,50,7018,5.099.761.905
26/12/2017 08:00,25.77,48030,4185,120,242,2660,45,7252,5.099.761.905
26/12/2017 09:00,26.34,48677,4240,117,229,2754,42,7382,5.099.761.905
26/12/2017 10:00,26.17,49168,4282,116,202,2855,38,7493,5.099.761.905
26/12/2017 11:00,26.39,49388,4341,117,187,2990,40,7675,5.099.761.905
26/12/2017 12:00,26.26,49291,4380,120,174,3140,43,7857,5.099.761.905
26/12/2017 13:00,26,49290,4464,123,180,3313,48,8128,5.099.761.905
26/12/2017 14:00,25.86,49526,4517,126,213,3495,50,8401,5.099.761.905
26/12/2017 15:00,26.32,50448,4324,131,241,3597,53,8346,5.099.761.905
26/12/2017 16:00,27.24,51092,4210,138,271,3796,56,8471,5.099.761.905
26/12/2017 17:00,27.15,51013,4110,147,286,3957,57,8557,5.099.761.905
26/12/2017 18:00,26.97,50412,4079,157,299,4101,57,8693,5.099.761.905
26/12/2017 19:00,26.42,49726,4026,166,303,4190,58,8743,5.099.761.905
26/12/2017 20:00,26.08,48799,3982,173,309,4254,59,8777,5.099.761.905
26/12/2017 21:00,25.93,47937,3938,179,326,4329,59,8831,5.099.761.905
26/12/2017 22:00,25.21,46504,3813,187,336,4404,57,8797,5.099.761.905
26/12/2017 23:00,24.51,44969,3645,175,362,4520,55,8757,5.099.761.905
27/12/2017 00:00,25.26,44289,3362,185,215,4408,40,8210,5.099.761.905
27/12/2017 01:00,24.22,43254,3026,184,200,4421,43,7874,5.099.761.905
27/12/2017 02:00,22.73,42843,2504,180,180,4331,42,7237,5.099.761.905
27/12/2017 03:00,22.45,43002,2043,176,170,4293,40,6722,5.099.761.905
27/12/2017 04:00,24.23,43694,1768,168,160,4191,38,6325,5.099.761.905
27/12/2017 05:00,25.71,45641,1642,161,150,4031,34,6018,5.099.761.905
27/12/2017 06:00,26.44,49070,1657,156,145,3938,30,5926,5.099.761.905
27/12/2017 07:00,28.23,52403,1681,156,135,3687,31,5690,5.099.761.905
27/12/2017 08:00,29.74,53804,1677,157,135,3426,34,5429,5.099.761.905
27/12/2017 09:00,30.08,54366,1669,160,125,3206,29,5189,5.099.761.905
27/12/2017 10:00,30.36,54811,1619,161,115,2970,29,4894,5.099.761.905
27/12/2017 11:00,31.46,54737,1378,159,105,2757,25,4424,5.099.761.905
27/12/2017 12:00,31.98,54632,1283,155,90,2587,23,4138,5.099.761.905
27/12/2017 13:00,32.87,54570,1311,144,90,2362,19,3926,5.099.761.905
27/12/2017 14:00,35.05,54937,1319,136,100,2164,13,3732,5.099.761.905
27/12/2017 15:00,37.12,55875,1311,127,125,2037,11,3611,5.099.761.905
27/12/2017 16:00,38.67,56589,1337,118,140,1900,9,3504,5.099.761.905
27/12/2017 17:00,39.16,56686,1291,112,150,1844,11,3408,5.099.761.905
27/12/2017 18:00,37.78,55837,1250,109,170,1763,10,3302,5.099.761.905
27/12/2017 19:00,33.94,54603,1119,107,185,1685,11,3107,5.099.761.905
27/12/2017 20:00,31.32,52910,954,104,190,1595,11,2854,5.099.761.905
27/12/2017 21:00,30.37,51629,872,101,205,1534,9,2721,5.099.761.905
27/12/2017 22:00,29.38,49844,760,91,225,1455,12,2543,5.099.761.905
27/12/2017 23:00,28.22,47280,721,82,225,1368,13,2409,5.099.761.905
28/12/2017 00:00,28.81,45261,639,70,255,1300,16,2280,5.099.761.905
28/12/2017 01:00,28.06,44296,586,69,250,1180,19,2104,5.099.761.905
28/12/2017 02:00,27.12,43824,519,70,250,1149,19,2007,5.099.761.905
28/12/2017 03:00,26.36,43868,480,74,240,1126,19,1939,5.099.761.905
28/12/2017 04:00,27.13,44509,509,80,240,1139,20,1988,5.099.761.905
28/12/2017 05:00,28.78,46323,580,84,230,1144,19,2057,5.099.761.905
28/12/2017 06:00,30.65,49495,688,87,220,1134,20,2149,5.099.761.905
28/12/2017 07:00,32.78,52966,735,92,215,1133,20,2195,5.099.761.905
28/12/2017 08:00,35.75,54435,787,98,210,1104,19,2218,5.099.761.905
28/12/2017 09:00,36.76,54750,813,101,205,1049,20,2188,5.099.761.905
28/12/2017 10:00,36.79,55112,835,103,205,1027,21,2191,5.099.761.905
28/12/2017 11:00,37.03,55085,834,106,205,967,20,2132,5.099.761.905
28/12/2017 12:00,36.71,54946,838,109,205,962,24,2138,5.099.761.905
28/12/2017 13:00,35.52,54917,841,113,205,949,24,2132,5.099.761.905
28/12/2017 14:00,35.66,55156,836,114,205,931,23,2109,5.099.761.905
28/12/2017 15:00,36.73,55978,880,117,220,945,23,2185,5.099.761.905
28/12/2017 16:00,37.04,56744,998,121,225,984,24,2352,5.099.761.905
28/12/2017 17:00,36.76,56824,1172,124,235,1010,28,2569,5.099.761.905
28/12/2017 18:00,35.03,55980,1296,131,235,1079,28,2769,5.099.761.905
28/12/2017 19:00,30.93,54687,1417,141,235,1073,25,2891,5.099.761.905
28/12/2017 20:00,29.03,53065,1502,148,230,1087,25,2992,5.099.761.905
28/12/2017 21:00,28.28,51797,1551,152,215,1066,26,3010,5.099.761.905
28/12/2017 22:00,27.47,49832,1567,159,215,1110,27,3078,5.099.761.905
28/12/2017 23:00,26.82,47327,1653,153,190,1168,26,3190,5.099.761.905
29/12/2017 00:00,26.33,45425,2182,165,231,1138,25,3741,5.099.761.905
29/12/2017 01:00,25.63,44285,2207,169,204,1201,29,3810,5.099.761.905
29/12/2017 02:00,25.38,43778,2225,174,184,1245,32,3860,5.099.761.905
29/12/2017 03:00,25.44,43911,2213,178,160,1334,33,3918,5.099.761.905
29/12/2017 04:00,26.03,44469,2210,177,134,1415,29,3965,5.099.761.905
29/12/2017 05:00,26.83,45949,2277,176,110,1509,24,4096,5.099.761.905
29/12/2017 06:00,27.26,48712,2305,174,87,1582,20,4168,5.099.761.905
29/12/2017 07:00,27.94,52118,2246,171,72,1616,14,4119,5.099.761.905
29/12/2017 08:00,29.17,53780,2204,164,70,1583,10,4031,5.099.761.905
29/12/2017 09:00,30.08,54283,2154,150,70,1599,7,3980,5.099.761.905
29/12/2017 10:00,29.83,54687,2108,128,74,1616,6,3932,5.099.761.905
29/12/2017 11:00,29.48,54636,2092,97,76,1568,6,3839,5.099.761.905
29/12/2017 12:00,29.3,54398,2033,73,81,1545,6,3738,5.099.761.905
29/12/2017 13:00,29.52,54245,1876,59,86,1466,5,3492,5.099.761.905
29/12/2017 14:00,30.13,54346,1694,51,87,1414,5,3251,5.099.761.905
29/12/2017 15:00,31.37,55078,1521,46,87,1388,4,3046,5.099.761.905
29/12/2017 16:00,33.02,55890,1362,42,95,1356,5,2860,5.099.761.905
29/12/2017 17:00,34.1,56172,1393,40,104,1375,5,2917,5.099.761.905
29/12/2017 18:00,32.12,55623,1457,38,107,1418,4,3024,5.099.761.905
29/12/2017 19:00,29.81,54414,1421,39,116,1483,5,3064,5.099.761.905
29/12/2017 20:00,28.49,52784,1445,42,128,1527,5,3147,5.099.761.905
29/12/2017 21:00,27.73,51418,1471,44,144,1535,6,3200,5.099.761.905
29/12/2017 22:00,26.9,49706,1396,49,151,1526,6,3128,5.099.761.905
29/12/2017 23:00,26.68,48124,1352,42,173,1503,9,3079,5.099.761.905
30/12/2017 00:00,27.3,46596,1571,54,131,1517,10,3283,5.099.761.905
30/12/2017 01:00,26.86,45589,1595,69,120,1472,10,3266,5.099.761.905
30/12/2017 02:00,26.39,45029,1632,76,120,1447,9,3284,5.099.761.905
30/12/2017 03:00,26.06,44836,1726,77,132,1410,7,3352,5.099.761.905
30/12/2017 04:00,26.06,45120,1855,77,121,1413,7,3473,5.099.761.905
30/12/2017 05:00,26.37,45942,1925,76,102,1406,7,3516,5.099.761.905
30/12/2017 06:00,26.79,46867,1966,77,82,1458,6,3589,5.099.761.905
30/12/2017 07:00,26.71,48419,1950,78,72,1497,7,3604,5.099.761.905
30/12/2017 08:00,26.95,50099,1963,79,69,1617,6,3734,5.099.761.905
30/12/2017 09:00,27.35,51688,1948,78,64,1662,6,3758,5.099.761.905
30/12/2017 10:00,27.45,52919,1908,75,54,1722,6,3765,5.099.761.905
30/12/2017 11:00,27.44,53299,1932,69,53,1729,5,3788,5.099.761.905
30/12/2017 12:00,27.34,53022,2079,63,48,1772,5,3967,5.099.761.905
30/12/2017 13:00,27.31,52828,2135,59,53,1786,4,4037,5.099.761.905
30/12/2017 14:00,27.34,52968,2176,58,67,1855,4,4160,5.099.761.905
30/12/2017 15:00,27.51,53993,2209,56,94,1955,4,4318,5.099.761.905
30/12/2017 16:00,27.84,55306,2237,55,134,2009,4,4439,5.099.761.905
30/12/2017 17:00,27.93,55794,2261,57,177,2039,5,4539,5.099.761.905
30/12/2017 18:00,27.65,55203,2332,57,228,2097,5,4719,5.099.761.905
30/12/2017 19:00,27.34,53811,2374,60,258,2156,6,4854,5.099.761.905
30/12/2017 20:00,26.55,52271,2479,63,271,1973,7,4793,5.099.761.905
30/12/2017 21:00,26.23,51084,2586,68,281,1938,8,4881,5.099.761.905
30/12/2017 22:00,25.96,49703,2636,75,295,2014,10,5030,5.099.761.905
30/12/2017 23:00,25.59,48023,2683,80,301,1907,11,4982,5.099.761.905
31/12/2017 00:00,26.98,45510,1110,96,314,1305,38,2863,5.099.761.905
31/12/2017 01:00,26.44,44492,1108,99,331,1213,41,2792,5.099.761.905
31/12/2017 02:00,26.2,43920,965,99,336,1123,44,2567,5.099.761.905
31/12/2017 03:00,25.9,43817,877,98,342,1067,46,2430,5.099.761.905
31/12/2017 04:00,25.37,44030,721,94,339,1066,44,2264,5.099.761.905
31/12/2017 05:00,25.49,44801,707,93,330,1058,44,2232,5.099.761.905
31/12/2017 06:00,25.97,45899,848,93,314,986,41,2282,5.099.761.905
31/12/2017 07:00,26.01,47327,948,92,286,977,36,2339,5.099.761.905
31/12/2017 08:00,26.38,48642,1212,89,256,966,34,2557,5.099.761.905
31/12/2017 09:00,26.97,49844,1536,86,215,997,32,2866,5.099.761.905
31/12/2017 10:00,27.49,50924,1899,81,211,981,28,3200,5.099.761.905
31/12/2017 11:00,27.53,51299,2430,75,232,1032,20,3789,5.099.761.905
31/12/2017 12:00,27.48,51165,2997,68,251,1087,15,4418,5.099.761.905
31/12/2017 13:00,27.34,51111,3497,63,239,1287,9,5095,5.099.761.905
31/12/2017 14:00,27.39,51612,3678,60,186,1534,6,5464,5.099.761.905
31/12/2017 15:00,27.66,52458,3542,58,191,1839,8,5638,5.099.761.905
31/12/2017 16:00,27.98,53412,3354,62,197,2125,8,5746,5.099.761.905
31/12/2017 17:00,27.92,53409,3002,69,202,2332,9,5614,5.099.761.905
31/12/2017 18:00,27.56,52177,2651,70,203,2398,9,5331,5.099.761.905
31/12/2017 19:00,26.75,50314,2378,74,214,2458,6,5130,5.099.761.905
31/12/2017 20:00,26.08,48762,2293,78,244,2419,4,5038,5.099.761.905
31/12/2017 21:00,25.83,48126,2289,83,287,2422,4,5085,5.099.761.905
31/12/2017 22:00,25.78,47369,2326,88,304,2357,5,5080,5.099.761.905
31/12/2017 23:00,25.43,46400,2292,97,301,2315,7,5012,5.099.761.905
01/01/2018 00:00,26.31,45015,1792,165,316,2206,21,4500,4.321.190.476
01/01/2018 01:00,26.43,44230,1701,169,319,2197,25,4411,4.321.190.476
01/01/2018 02:00,26.09,43534,1944,174,307,2245,27,4697,4.321.190.476
01/01/2018 03:00,24.63,43211,2197,178,289,2182,28,4874,4.321.190.476
01/01/2018 04:00,24.67,43062,2365,177,289,2154,26,5011,4.321.190.476
01/01/2018 05:00,24.24,43251,2642,176,302,2204,22,5346,4.321.190.476
01/01/2018 06:00,24.18,43775,2829,174,326,2246,20,5595,4.321.190.476
01/01/2018 07:00,24.29,44572,2805,171,338,2302,14,5630,4.321.190.476
01/01/2018 08:00,24.15,45388,2827,164,338,2390,13,5732,4.321.190.476
01/01/2018 09:00,24.26,46416,2847,150,338,2456,15,5806,4.321.190.476
01/01/2018 10:00,25.84,47773,3033,128,329,2500,13,6003,4.321.190.476
01/01/2018 11:00,26.06,48622,3256,97,313,2455,10,6131,4.321.190.476
01/01/2018 12:00,25.86,48929,3442,73,285,2483,10,6293,4.321.190.476
01/01/2018 13:00,25.96,49183,3612,59,277,2439,8,6395,4.321.190.476
01/01/2018 14:00,26.03,49668,3623,51,278,2377,9,6338,4.321.190.476
01/01/2018 15:00,26.43,50808,3414,46,280,2443,9,6192,4.321.190.476
01/01/2018 16:00,27.02,51687,3083,42,284,2439,11,5859,4.321.190.476
01/01/2018 17:00,27.43,52113,2747,40,298,2483,14,5582,4.321.190.476
01/01/2018 18:00,27.3,51602,2536,38,325,2513,20,5432,4.321.190.476
01/01/2018 19:00,26.97,50705,2421,39,337,2516,29,5342,4.321.190.476
01/01/2018 20:00,26.69,49675,2318,42,339,2481,37,5217,4.321.190.476
01/01/2018 21:00,26.45,48900,2227,44,353,2423,36,5083,4.321.190.476
01/01/2018 22:00,26.07,47324,2086,49,357,2356,28,4876,4.321.190.476
01/01/2018 23:00,25.02,45411,1907,153,366,2285,29,4740,4.321.190.476
02/01/2018 00:00,25.74,45108,1996,165,283,2092,54,4590,4.321.190.476
02/01/2018 01:00,25.13,44271,1938,169,274,2006,53,4440,4.321.190.476
02/01/2018 02:00,25.4,44145,1805,174,276,1954,51,4260,4.321.190.476
02/01/2018 03:00,25.49,44266,1623,178,277,1903,50,4031,4.321.190.476
02/01/2018 04:00,25.66,45181,1387,177,270,1860,48,3742,4.321.190.476
02/01/2018 05:00,26.75,47336,1240,176,246,1803,46,3511,4.321.190.476
02/01/2018 06:00,27.69,49932,1187,174,224,1761,45,3391,4.321.190.476
02/01/2018 07:00,30.73,53857,1161,171,210,1713,44,3299,4.321.190.476
02/01/2018 08:00,33.77,55381,1197,164,205,1640,45,3251,4.321.190.476
02/01/2018 09:00,34.04,55666,1236,150,188,1534,43,3151,4.321.190.476
02/01/2018 10:00,35.07,56152,1229,128,163,1448,40,3008,4.321.190.476
02/01/2018 11:00,35.24,56429,1190,97,140,1365,39,2831,4.321.190.476
02/01/2018 12:00,34.57,56386,1139,73,124,1282,37,2655,4.321.190.476
02/01/2018 13:00,34.1,56305,1168,59,124,1261,35,2647,4.321.190.476
02/01/2018 14:00,36.02,56504,1198,51,125,1291,30,2695,4.321.190.476
02/01/2018 15:00,38.06,57299,1128,46,143,1333,24,2674,4.321.190.476
02/01/2018 16:00,41.68,58160,1143,42,148,1374,21,2728,4.321.190.476
02/01/2018 17:00,42.4,58474,1231,40,148,1411,20,2850,4.321.190.476
02/01/2018 18:00,39.05,57763,1353,38,147,1459,16,3013,4.321.190.476
02/01/2018 19:00,35.02,56499,1402,39,143,1416,15,3015,4.321.190.476
02/01/2018 20:00,30.88,54840,1518,42,136,1378,14,3088,4.321.190.476
02/01/2018 21:00,28.81,53464,1759,44,131,1344,11,3289,4.321.190.476
02/01/2018 22:00,27.95,51684,1965,49,119,1269,10,3412,4.321.190.476
02/01/2018 23:00,27.55,48897,2182,97,106,1244,10,3639,4.321.190.476
03/01/2018 00:00,27.05,46037,2478,103,61,1057,9,3708,4.321.190.476
03/01/2018 01:00,26.52,44995,2850,113,51,1042,9,4065,4.321.190.476
03/01/2018 02:00,25.96,44529,3234,120,46,1089,8,4497,4.321.190.476
03/01/2018 03:00,25.52,44612,3623,125,46,1135,7,4936,4.321.190.476
03/01/2018 04:00,25.8,45366,3800,128,47,1250,8,5233,4.321.190.476
03/01/2018 05:00,26.68,47515,3905,129,54,1438,8,5534,4.321.190.476
03/01/2018 06:00,27.65,51116,3977,129,62,1600,8,5776,4.321.190.476
03/01/2018 07:00,28.52,54873,3890,126,70,1761,9,5856,4.321.190.476
03/01/2018 08:00,28.83,56530,3723,121,78,1956,9,5887,4.321.190.476
03/01/2018 09:00,28.89,56943,3499,117,92,2119,8,5835,4.321.190.476
03/01/2018 10:00,29.09,57424,3117,110,103,2365,10,5705,4.321.190.476
03/01/2018 11:00,29.14,57618,2517,101,111,2390,12,5131,4.321.190.476
03/01/2018 12:00,29.22,57336,1938,93,118,2489,13,4651,4.321.190.476
03/01/2018 13:00,29.49,57180,1660,90,130,2480,15,4375,4.321.190.476
03/01/2018 14:00,29.85,57413,1601,90,142,2462,17,4312,4.321.190.476
03/01/2018 15:00,30.5,58086,1481,94,160,2406,18,4159,4.321.190.476
03/01/2018 16:00,31.11,58768,1305,105,187,2373,21,3991,4.321.190.476
03/01/2018 17:00,31.43,58902,1182,117,224,2329,26,3878,4.321.190.476
03/01/2018 18:00,30.78,58014,1153,130,248,2216,33,3780,4.321.190.476
03/01/2018 19:00,30.14,56832,1059,142,292,2124,38,3655,4.321.190.476
03/01/2018 20:00,29.37,55006,1023,150,323,2003,39,3538,4.321.190.476
03/01/2018 21:00,28.93,53594,1101,157,334,1898,39,3529,4.321.190.476
03/01/2018 22:00,28.12,51433,1133,168,341,1835,37,3514,4.321.190.476
03/01/2018 23:00,27.31,48868,1230,174,344,1777,37,3562,4.321.190.476
04/01/2018 00:00,27.05,46177,1149,191,341,1788,25,3494,4.321.190.476
04/01/2018 01:00,26.78,45123,1352,192,339,1788,25,3696,4.321.190.476
04/01/2018 02:00,26.47,44680,1405,194,329,1744,21,3693,4.321.190.476
04/01/2018 03:00,26.49,44738,1596,193,284,1743,23,3839,4.321.190.476
04/01/2018 04:00,26.59,45532,1740,192,270,1750,24,3976,4.321.190.476
04/01/2018 05:00,26.97,47615,1829,191,262,1724,22,4028,4.321.190.476
04/01/2018 06:00,28.02,51201,1908,188,252,1715,22,4085,4.321.190.476
04/01/2018 07:00,30.59,55005,1786,182,259,1689,21,3937,4.321.190.476
04/01/2018 08:00,33.44,56670,1619,179,273,1650,21,3742,4.321.190.476
04/01/2018 09:00,35.49,56821,1470,178,288,1643,21,3600,4.321.190.476
04/01/2018 10:00,37.56,57233,1340,175,295,1611,20,3441,4.321.190.476
04/01/2018 11:00,36.07,57423,1270,172,296,1672,19,3429,4.321.190.476
04/01/2018 12:00,35.63,57160,1217,169,307,1665,19,3377,4.321.190.476
04/01/2018 13:00,35.43,57194,1176,169,319,1699,17,3380,4.321.190.476
04/01/2018 14:00,35.93,57324,1181,171,315,1714,16,3397,4.321.190.476
04/01/2018 15:00,38.03,57960,1080,172,319,1752,16,3339,4.321.190.476
04/01/2018 16:00,39.71,58802,879,176,319,1850,16,3240,4.321.190.476
04/01/2018 17:00,39.03,58929,672,177,325,1964,18,3156,4.321.190.476
04/01/2018 18:00,37.23,58160,590,175,325,2004,18,3112,4.321.190.476
04/01/2018 19:00,32.9,56897,541,171,320,2007,21,3060,4.321.190.476
04/01/2018 20:00,30.98,55078,481,169,317,1963,23,2953,4.321.190.476
04/01/2018 21:00,30.49,53631,424,164,322,2004,25,2939,4.321.190.476
04/01/2018 22:00,29.72,51675,377,155,313,1990,27,2862,4.321.190.476
04/01/2018 23:00,28.07,49193,331,0,297,2033,31,2692,4.321.190.476
05/01/2018 00:00,27.88,46837,287,127,271,1980,22,2687,4.321.190.476
05/01/2018 01:00,26.91,45893,308,117,244,2008,22,2699,4.321.190.476
05/01/2018 02:00,26.44,45612,340,107,242,2023,23,2735,4.321.190.476
05/01/2018 03:00,26.45,45820,447,96,245,2034,22,2844,4.321.190.476
05/01/2018 04:00,26.83,46736,445,85,262,2053,20,2865,4.321.190.476
05/01/2018 05:00,27.63,48964,468,74,270,2038,18,2868,4.321.190.476
05/01/2018 06:00,28.62,52584,580,62,280,2046,19,2987,4.321.190.476
05/01/2018 07:00,30.45,56538,552,56,289,2096,23,3016,4.321.190.476
05/01/2018 08:00,32.91,58194,571,52,290,2094,24,3031,4.321.190.476
05/01/2018 09:00,34.01,58434,599,51,295,2081,26,3052,4.321.190.476
05/01/2018 10:00,34.79,58746,581,47,283,2035,25,2971,4.321.190.476
05/01/2018 11:00,34.31,58721,559,44,260,2043,23,2929,4.321.190.476
05/01/2018 12:00,33.91,58259,543,42,225,2040,26,2876,4.321.190.476
05/01/2018 13:00,34.23,57793,396,43,212,2045,26,2722,4.321.190.476
05/01/2018 14:00,33.91,57818,285,46,227,2041,27,2626,4.321.190.476
05/01/2018 15:00,35.11,58581,271,50,231,2034,26,2612,4.321.190.476
05/01/2018 16:00,38.06,59500,270,51,241,2004,28,2594,4.321.190.476
05/01/2018 17:00,39.43,59691,276,51,246,1933,35,2541,4.321.190.476
05/01/2018 18:00,37.57,58931,278,53,250,1932,38,2551,4.321.190.476
05/01/2018 19:00,33.71,57334,279,52,279,1882,45,2537,4.321.190.476
05/01/2018 20:00,31.97,55496,324,52,300,1864,45,2585,4.321.190.476
05/01/2018 21:00,31.64,54114,307,51,309,1858,36,2561,4.321.190.476
05/01/2018 22:00,30.61,52342,249,52,313,1859,38,2511,4.321.190.476
05/01/2018 23:00,29.66,50291,226,60,292,1896,37,2511,4.321.190.476
06/01/2018 00:00,29.45,48207,120,54,297,1856,8,2335,4.321.190.476
06/01/2018 01:00,28.55,47133,117,69,289,1852,9,2336,4.321.190.476
06/01/2018 02:00,28.18,46390,111,76,288,1881,12,2368,4.321.190.476
06/01/2018 03:00,28,46297,120,77,266,1935,12,2410,4.321.190.476
06/01/2018 04:00,28.15,46757,134,77,247,2020,10,2488,4.321.190.476
06/01/2018 05:00,28.7,47518,150,76,202,2028,10,2466,4.321.190.476
06/01/2018 06:00,29.49,48824,189,77,187,2157,12,2622,4.321.190.476
06/01/2018 07:00,30.37,50787,229,78,182,2251,12,2752,4.321.190.476
06/01/2018 08:00,30.49,52646,263,79,181,2326,9,2858,4.321.190.476
06/01/2018 09:00,31.38,54244,315,78,180,2414,7,2994,4.321.190.476
06/01/2018 10:00,32.94,55539,382,75,169,2352,7,2985,4.321.190.476
06/01/2018 11:00,34.23,55957,473,69,164,2435,8,3149,4.321.190.476
06/01/2018 12:00,33.34,55690,555,63,150,2605,8,3381,4.321.190.476
06/01/2018 13:00,32.55,55432,596,59,132,2666,10,3463,4.321.190.476
06/01/2018 14:00,32.42,55659,631,58,131,2841,9,3670,4.321.190.476
06/01/2018 15:00,33.93,56793,713,56,97,2968,9,3843,4.321.190.476
06/01/2018 16:00,36.83,57988,802,55,92,3070,9,4028,4.321.190.476
06/01/2018 17:00,39.03,58780,916,57,88,3097,11,4169,4.321.190.476
06/01/2018 18:00,35.84,58186,1034,57,83,3226,14,4414,4.321.190.476
06/01/2018 19:00,32.41,57039,1192,60,83,3224,17,4576,4.321.190.476
06/01/2018 20:00,31.07,55466,1270,63,100,3394,18,4845,4.321.190.476
06/01/2018 21:00,30.72,54291,1270,68,111,3454,19,4922,4.321.190.476
06/01/2018 22:00,29.98,52779,1252,75,122,3456,19,4924,4.321.190.476
06/01/2018 23:00,29.03,51023,1178,80,122,3471,18,4869,4.321.190.476
07/01/2018 00:00,27.89,48940,667,96,144,3358,20,4285,4.321.190.476
07/01/2018 01:00,27.2,48088,596,99,145,3222,23,4085,4.321.190.476
07/01/2018 02:00,26.62,47565,540,99,145,3145,29,3958,4.321.190.476
07/01/2018 03:00,26.59,47458,480,98,139,3043,25,3785,4.321.190.476
07/01/2018 04:00,26.57,47811,422,94,121,2951,17,3605,4.321.190.476
07/01/2018 05:00,27.13,48347,384,93,109,2782,12,3380,4.321.190.476
07/01/2018 06:00,27.41,49262,392,93,104,2701,12,3302,4.321.190.476
07/01/2018 07:00,27.68,50682,399,92,87,2753,12,3343,4.321.190.476
07/01/2018 08:00,27.93,52399,394,89,70,2720,15,3288,4.321.190.476
07/01/2018 09:00,28.33,53673,392,86,54,2902,14,3448,4.321.190.476
07/01/2018 10:00,28.79,54749,417,81,42,3162,11,3713,4.321.190.476
07/01/2018 11:00,28.95,55249,469,75,33,3444,11,4032,4.321.190.476
07/01/2018 12:00,28.96,54930,463,68,27,3718,13,4289,4.321.190.476
07/01/2018 13:00,28.27,54774,500,63,27,3869,18,4477,4.321.190.476
07/01/2018 14:00,28.29,54991,580,60,32,3903,15,4590,4.321.190.476
07/01/2018 15:00,28.61,55982,679,58,38,4096,16,4887,4.321.190.476
07/01/2018 16:00,29.33,57428,776,62,59,4211,19,5127,4.321.190.476
07/01/2018 17:00,30.88,58010,847,69,104,4259,28,5307,4.321.190.476
07/01/2018 18:00,31.54,57323,935,70,161,4373,38,5577,4.321.190.476
07/01/2018 19:00,31.12,56114,963,74,223,4438,47,5745,4.321.190.476
07/01/2018 20:00,29.97,54538,893,78,269,4426,54,5720,4.321.190.476
07/01/2018 21:00,28.94,53469,827,83,309,4399,57,5675,4.321.190.476
07/01/2018 22:00,28.94,51794,858,88,328,4238,58,5570,4.321.190.476
07/01/2018 23:00,27.75,50251,856,0,350,4065,56,5327,4.321.190.476
08/01/2018 00:00,26.47,49319,892,145,426,3767,57,5287,4.865.416.667
08/01/2018 01:00,25.41,48376,851,148,420,3558,53,5030,4.865.416.667
08/01/2018 02:00,25.42,48142,755,148,401,3249,48,4601,4.865.416.667
08/01/2018 03:00,25.59,48375,617,146,372,3009,40,4184,4.865.416.667
08/01/2018 04:00,25.99,49280,506,140,326,2789,32,3793,4.865.416.667
08/01/2018 05:00,27.75,52469,396,136,270,2565,32,3399,4.865.416.667
08/01/2018 06:00,29.63,56528,337,131,223,2524,32,3247,4.865.416.667
08/01/2018 07:00,33.53,60737,229,125,190,2412,27,2983,4.865.416.667
08/01/2018 08:00,39.89,61936,168,121,171,2316,20,2796,4.865.416.667
08/01/2018 09:00,38.76,60901,131,116,146,2280,18,2691,4.865.416.667
08/01/2018 10:00,36.91,60979,123,116,135,2293,18,2685,4.865.416.667
08/01/2018 11:00,35.54,60695,136,117,135,2277,20,2685,4.865.416.667
08/01/2018 12:00,34.21,60193,126,115,132,2236,21,2630,4.865.416.667
08/01/2018 13:00,34,60031,143,108,123,2233,18,2625,4.865.416.667
08/01/2018 14:00,35.17,60066,232,98,109,2290,13,2742,4.865.416.667
08/01/2018 15:00,36.95,60745,360,89,97,2383,11,2940,4.865.416.667
08/01/2018 16:00,37.67,61569,513,86,85,2468,9,3161,4.865.416.667
08/01/2018 17:00,37.27,61911,693,83,71,2532,9,3388,4.865.416.667
08/01/2018 18:00,33.88,61031,984,78,60,2580,7,3709,4.865.416.667
08/01/2018 19:00,31.31,59764,1226,74,59,2534,7,3900,4.865.416.667
08/01/2018 20:00,29.71,57901,1384,65,65,2547,6,4067,4.865.416.667
08/01/2018 21:00,28.92,56369,1556,64,71,2544,5,4240,4.865.416.667
08/01/2018 22:00,28.53,54107,1692,58,85,2525,5,4365,4.865.416.667
08/01/2018 23:00,28.11,51687,1776,53,104,2535,7,4475,4.865.416.667
09/01/2018 00:00,27.45,49899,2040,145,127,2307,17,4636,4.865.416.667
09/01/2018 01:00,26.91,48765,2260,148,147,2295,15,4865,4.865.416.667
09/01/2018 02:00,26.62,48446,2334,148,149,2293,15,4939,4.865.416.667
09/01/2018 03:00,26.89,48684,2542,146,150,2269,15,5122,4.865.416.667
09/01/2018 04:00,27.21,49604,2771,140,139,2230,12,5292,4.865.416.667
09/01/2018 05:00,28.18,51914,3072,136,124,2229,9,5570,4.865.416.667
09/01/2018 06:00,29,56058,3299,131,110,2242,9,5791,4.865.416.667
09/01/2018 07:00,32.04,60289,3550,125,94,2297,9,6075,4.865.416.667
09/01/2018 08:00,33.11,61496,3723,121,78,2322,9,6253,4.865.416.667
09/01/2018 09:00,32.9,61071,3840,116,67,2283,10,6316,4.865.416.667
09/01/2018 10:00,32.59,61181,3928,116,64,2292,10,6410,4.865.416.667
09/01/2018 11:00,32.82,61078,4003,117,65,2340,9,6534,4.865.416.667
09/01/2018 12:00,32.31,60605,4095,115,59,2353,8,6630,4.865.416.667
09/01/2018 13:00,32.05,60334,4153,108,51,2340,8,6660,4.865.416.667
09/01/2018 14:00,31.81,60346,4301,98,46,2485,8,6938,4.865.416.667
09/01/2018 15:00,31.91,60890,4370,89,42,2654,8,7163,4.865.416.667
09/01/2018 16:00,33.06,61840,4364,86,43,2681,6,7180,4.865.416.667
09/01/2018 17:00,33.99,62245,4351,83,49,2657,7,7147,4.865.416.667
09/01/2018 18:00,33.28,61536,4361,78,68,2692,6,7205,4.865.416.667
09/01/2018 19:00,31.65,60436,4180,74,86,2655,4,6999,4.865.416.667
09/01/2018 20:00,30.73,58689,3710,65,99,2708,3,6585,4.865.416.667
09/01/2018 21:00,30.21,57150,3343,64,111,2689,4,6211,4.865.416.667
09/01/2018 22:00,29.29,54882,3107,58,127,2490,5,5787,4.865.416.667
09/01/2018 23:00,28.6,52271,2867,53,141,2472,6,5539,4.865.416.667
10/01/2018 00:00,28.85,50014,2600,216,90,2363,5,5274,4.865.416.667
10/01/2018 01:00,28.27,48913,2381,219,103,2316,5,5024,4.865.416.667
10/01/2018 02:00,28,48408,2116,222,115,2273,5,4731,4.865.416.667
10/01/2018 03:00,27.69,48662,1931,223,121,2222,4,4501,4.865.416.667
10/01/2018 04:00,28.14,49447,1768,223,135,2174,4,4304,4.865.416.667
10/01/2018 05:00,30.13,51875,1600,224,154,2122,4,4104,4.865.416.667
10/01/2018 06:00,33.88,56055,1501,221,177,2080,4,3983,4.865.416.667
10/01/2018 07:00,44.01,60287,1460,212,202,2062,5,3941,4.865.416.667
10/01/2018 08:00,47.98,61253,1412,203,228,2020,6,3869,4.865.416.667
10/01/2018 09:00,47.98,61001,1321,193,248,2018,8,3788,4.865.416.667
10/01/2018 10:00,48.04,61060,1226,183,259,1982,7,3657,4.865.416.667
10/01/2018 11:00,47.78,61049,1080,172,259,1928,7,3446,4.865.416.667
10/01/2018 12:00,47.09,60579,1001,161,263,1896,9,3330,4.865.416.667
10/01/2018 13:00,44.08,60380,966,154,264,1903,8,3295,4.865.416.667
10/01/2018 14:00,45.88,60461,967,143,276,1872,8,3266,4.865.416.667
10/01/2018 15:00,47.25,60988,996,129,312,1869,10,3316,4.865.416.667
10/01/2018 16:00,48.91,61703,956,111,312,1819,11,3209,4.865.416.667
10/01/2018 17:00,52.03,62007,864,95,302,1760,12,3033,4.865.416.667
10/01/2018 18:00,52.43,61089,774,85,285,1673,11,2828,4.865.416.667
10/01/2018 19:00,44.95,59788,723,80,256,1583,11,2653,4.865.416.667
10/01/2018 20:00,39.82,57891,683,84,230,1464,8,2469,4.865.416.667
10/01/2018 21:00,35.82,56533,623,87,206,1389,7,2312,4.865.416.667
10/01/2018 22:00,31.98,54193,548,84,191,1405,8,2236,4.865.416.667
10/01/2018 23:00,30.37,51756,493,84,179,1399,9,2164,4.865.416.667
11/01/2018 00:00,31,49700,576,69,184,1302,7,2138,4.865.416.667
11/01/2018 01:00,30.03,48501,588,75,178,1288,7,2136,4.865.416.667
11/01/2018 02:00,29.85,48046,598,76,180,1234,7,2095,4.865.416.667
11/01/2018 03:00,29.97,48199,582,71,175,1242,7,2077,4.865.416.667
11/01/2018 04:00,30.85,49160,562,67,172,1241,7,2049,4.865.416.667
11/01/2018 05:00,32.77,51569,541,68,160,1230,7,2006,4.865.416.667
11/01/2018 06:00,35.83,55807,502,68,153,1239,6,1968,4.865.416.667
11/01/2018 07:00,50.21,60096,424,66,137,1272,7,1906,4.865.416.667
11/01/2018 08:00,55.24,61207,347,66,111,1342,7,1873,4.865.416.667
11/01/2018 09:00,55.82,60961,302,66,83,1293,10,1754,4.865.416.667
11/01/2018 10:00,55.21,61066,310,62,69,1333,9,1783,4.865.416.667
11/01/2018 11:00,54.7,60989,294,57,59,1286,10,1706,4.865.416.667
11/01/2018 12:00,50.57,60584,324,51,54,1329,9,1767,4.865.416.667
11/01/2018 13:00,46.85,60416,409,47,60,1388,8,1912,4.865.416.667
11/01/2018 14:00,49.51,60436,491,45,90,1361,8,1995,4.865.416.667
11/01/2018 15:00,50.91,61003,585,44,148,1458,8,2243,4.865.416.667
11/01/2018 16:00,53.69,61792,637,38,179,1538,10,2402,4.865.416.667
11/01/2018 17:00,51.43,62137,649,33,193,1628,12,2515,4.865.416.667
11/01/2018 18:00,50.5,61256,654,28,196,1704,14,2596,4.865.416.667
11/01/2018 19:00,39.94,59978,680,25,198,1760,15,2678,4.865.416.667
11/01/2018 20:00,35.4,58084,726,23,197,1799,14,2759,4.865.416.667
11/01/2018 21:00,33.9,56589,812,23,198,1890,14,2937,4.865.416.667
11/01/2018 22:00,31.22,54170,850,23,194,1931,14,3012,4.865.416.667
11/01/2018 23:00,30.05,51559,860,23,182,1897,14,2976,4.865.416.667
12/01/2018 00:00,30.05,50077,1085,17,126,1958,6,3192,4.865.416.667
12/01/2018 01:00,29.51,48762,1168,17,117,1959,6,3267,4.865.416.667
12/01/2018 02:00,29.29,48365,1251,16,110,1841,6,3224,4.865.416.667
12/01/2018 03:00,29.27,48564,1325,15,106,1764,6,3216,4.865.416.667
12/01/2018 04:00,29.71,49441,1400,14,100,1673,6,3193,4.865.416.667
12/01/2018 05:00,31.22,51711,1514,11,98,1630,5,3258,4.865.416.667
12/01/2018 06:00,33.56,55882,1631,9,93,1571,6,3310,4.865.416.667
12/01/2018 07:00,44.17,60279,1670,8,85,1468,6,3237,4.865.416.667
12/01/2018 08:00,47.06,61719,1752,7,76,1357,6,3198,4.865.416.667
12/01/2018 09:00,44.37,61732,1783,6,66,1333,8,3196,4.865.416.667
12/01/2018 10:00,43.57,61715,1766,6,67,1280,6,3125,4.865.416.667
12/01/2018 11:00,42.37,61447,1563,6,76,1225,6,2876,4.865.416.667
12/01/2018 12:00,39.28,60784,1503,6,85,1153,5,2752,4.865.416.667
12/01/2018 13:00,37.4,60293,1506,5,84,1105,5,2705,4.865.416.667
12/01/2018 14:00,36.76,59969,1539,5,90,1106,6,2746,4.865.416.667
12/01/2018 15:00,36.76,60387,1632,6,96,1058,6,2798,4.865.416.667
12/01/2018 16:00,40.86,61304,1718,6,100,1028,5,2857,4.865.416.667
12/01/2018 17:00,42.08,61601,1749,6,111,999,7,2872,4.865.416.667
12/01/2018 18:00,40.03,60683,1721,5,114,1014,6,2860,4.865.416.667
12/01/2018 19:00,32.98,58975,1749,5,116,978,5,2853,4.865.416.667
12/01/2018 20:00,31.55,56857,1722,6,120,937,5,2790,4.865.416.667
12/01/2018 21:00,31.31,55343,1700,7,118,877,5,2707,4.865.416.667
12/01/2018 22:00,30.32,53390,1742,8,116,824,5,2695,4.865.416.667
12/01/2018 23:00,29.53,50892,1697,7,115,786,5,2610,4.865.416.667
13/01/2018 00:00,30.08,48909,1731,40,114,768,5,2658,4.865.416.667
13/01/2018 01:00,29.63,47817,1769,38,99,774,6,2686,4.865.416.667
13/01/2018 02:00,29.16,47284,1846,36,86,749,6,2723,4.865.416.667
13/01/2018 03:00,28.93,47141,1811,37,79,767,5,2699,4.865.416.667
13/01/2018 04:00,28.79,47244,1841,37,69,807,5,2759,4.865.416.667
13/01/2018 05:00,28.98,47915,1891,40,64,862,5,2862,4.865.416.667
13/01/2018 06:00,29.35,49088,1956,48,56,967,6,3033,4.865.416.667
13/01/2018 07:00,30.18,50855,1995,61,52,1065,5,3178,4.865.416.667
13/01/2018 08:00,30.81,52633,2088,71,55,1146,5,3365,4.865.416.667
13/01/2018 09:00,31.38,54209,2045,79,58,1178,5,3365,4.865.416.667
13/01/2018 10:00,31.84,55339,2002,87,54,1208,5,3356,4.865.416.667
13/01/2018 11:00,31.92,55737,1883,93,46,1239,5,3266,4.865.416.667
13/01/2018 12:00,31.89,55508,1815,99,37,1243,5,3199,4.865.416.667
13/01/2018 13:00,31.73,55221,1772,103,35,1265,5,3180,4.865.416.667
13/01/2018 14:00,31.39,55396,1709,105,40,1275,5,3134,4.865.416.667
13/01/2018 15:00,31.51,56316,1776,106,51,1362,4,3299,4.865.416.667
13/01/2018 16:00,34.01,57756,1865,109,67,1471,6,3518,4.865.416.667
13/01/2018 17:00,37.45,58608,1897,111,77,1599,5,3689,4.865.416.667
13/01/2018 18:00,35.02,57959,2056,116,88,1696,6,3962,4.865.416.667
13/01/2018 19:00,31.94,56572,2265,119,93,1715,6,4198,4.865.416.667
13/01/2018 20:00,30.55,54877,2344,121,95,1765,6,4331,4.865.416.667
13/01/2018 21:00,29.79,53623,2280,124,100,1834,6,4344,4.865.416.667
13/01/2018 22:00,29.33,52211,2238,127,100,1860,5,4330,4.865.416.667
13/01/2018 23:00,28.79,50464,2097,129,89,1884,5,4204,4.865.416.667
14/01/2018 00:00,28.83,48713,1982,133,82,1951,5,4153,4.865.416.667
14/01/2018 01:00,28.4,47695,1890,146,72,2018,6,4132,4.865.416.667
14/01/2018 02:00,28.15,47180,1820,153,63,2054,6,4096,4.865.416.667
14/01/2018 03:00,28.04,47013,1754,157,62,2087,5,4065,4.865.416.667
14/01/2018 04:00,27.84,47181,1864,162,62,2103,5,4196,4.865.416.667
14/01/2018 05:00,28,47727,1985,162,68,2138,5,4358,4.865.416.667
14/01/2018 06:00,28.34,48546,1992,165,77,2194,5,4433,4.865.416.667
14/01/2018 07:00,28.55,49914,1910,168,72,2269,6,4425,4.865.416.667
14/01/2018 08:00,28.83,51387,1992,172,57,2268,6,4495,4.865.416.667
14/01/2018 09:00,29.41,52995,2056,177,50,2311,6,4600,4.865.416.667
14/01/2018 10:00,29.74,54358,2057,180,47,2356,6,4646,4.865.416.667
14/01/2018 11:00,30.13,55108,1993,181,47,2388,6,4615,4.865.416.667
14/01/2018 12:00,29.81,55089,1925,180,46,2401,7,4559,4.865.416.667
14/01/2018 13:00,29.44,55045,1897,179,47,2419,8,4550,4.865.416.667
14/01/2018 14:00,29.94,55217,1843,170,57,2458,7,4535,4.865.416.667
14/01/2018 15:00,31.31,56147,1962,174,72,2501,6,4715,4.865.416.667
14/01/2018 16:00,33.23,57664,2092,176,94,2569,5,4936,4.865.416.667
14/01/2018 17:00,33.9,58563,2240,184,113,2758,6,5301,4.865.416.667
14/01/2018 18:00,32.69,58053,2539,183,124,2936,7,5789,4.865.416.667
14/01/2018 19:00,31.35,56981,2715,198,137,3146,8,6204,4.865.416.667
14/01/2018 20:00,30.55,55493,2664,197,144,3272,9,6286,4.865.416.667
14/01/2018 21:00,29.69,54373,2663,200,159,3431,10,6463,4.865.416.667
14/01/2018 22:00,29.33,52565,2729,203,165,3580,10,6687,4.865.416.667
14/01/2018 23:00,28.82,50944,2646,198,169,3622,10,6645,4.865.416.667
15/01/2018 00:00,27.41,49351,3125,16,195,3889,16,7241,4.616.607.143
15/01/2018 01:00,26.73,48535,3170,13,199,3960,14,7356,4.616.607.143
15/01/2018 02:00,26.54,48265,3291,12,203,4049,14,7569,4.616.607.143
15/01/2018 03:00,26.43,48483,3369,9,200,4099,15,7692,4.616.607.143
15/01/2018 04:00,27.31,49400,3454,8,206,4157,15,7840,4.616.607.143
15/01/2018 05:00,28.64,51830,3594,8,220,4343,18,8183,4.616.607.143
15/01/2018 06:00,30.05,56282,3697,8,226,4489,18,8438,4.616.607.143
15/01/2018 07:00,32.79,60486,3765,8,227,4618,21,8639,4.616.607.143
15/01/2018 08:00,33.53,61677,3913,7,223,4703,22,8868,4.616.607.143
15/01/2018 09:00,32.67,61259,3950,6,218,4794,22,8990,4.616.607.143
15/01/2018 10:00,31.78,61404,3907,5,213,4937,28,9090,4.616.607.143
15/01/2018 11:00,30.46,61377,3868,4,219,5016,33,9140,4.616.607.143
15/01/2018 12:00,29.68,61029,3911,3,220,5113,35,9282,4.616.607.143
15/01/2018 13:00,29.45,60927,4006,3,239,5169,35,9452,4.616.607.143
15/01/2018 14:00,29.65,61052,4023,3,269,5229,34,9558,4.616.607.143
15/01/2018 15:00,29.39,61694,4062,3,303,5307,31,9706,4.616.607.143
15/01/2018 16:00,29.45,62541,4149,4,326,5349,28,9856,4.616.607.143
15/01/2018 17:00,30.15,62956,4184,5,344,5451,33,10017,4.616.607.143
15/01/2018 18:00,29.57,62069,4238,6,356,5532,35,10167,4.616.607.143
15/01/2018 19:00,29.11,60745,4330,7,364,5593,35,10329,4.616.607.143
15/01/2018 20:00,28.74,58939,4267,8,370,5563,35,10243,4.616.607.143
15/01/2018 21:00,28.25,57245,4085,8,379,5585,38,10095,4.616.607.143
15/01/2018 22:00,27.32,54897,4060,9,383,5613,39,10104,4.616.607.143
15/01/2018 23:00,25.69,52287,3850,10,408,5536,39,9843,4.616.607.143
16/01/2018 00:00,26.74,49784,3687,16,434,5558,50,9745,4.616.607.143
16/01/2018 01:00,26.05,48686,3496,13,439,5601,50,9599,4.616.607.143
16/01/2018 02:00,25.81,48316,3308,12,446,5543,50,9359,4.616.607.143
16/01/2018 03:00,25.23,48451,3107,9,448,5555,51,9170,4.616.607.143
16/01/2018 04:00,25.41,49375,2988,8,448,5529,51,9024,4.616.607.143
16/01/2018 05:00,27.56,51863,2905,8,454,5540,52,8959,4.616.607.143
16/01/2018 06:00,29.08,55933,2700,8,458,5436,56,8658,4.616.607.143
16/01/2018 07:00,31.75,60146,2382,8,459,5208,57,8114,4.616.607.143
16/01/2018 08:00,32.99,61114,2154,7,460,4954,58,7633,4.616.607.143
16/01/2018 09:00,32.94,60856,2046,6,461,4792,59,7364,4.616.607.143
16/01/2018 10:00,32.61,61029,1988,5,462,4616,60,7131,4.616.607.143
16/01/2018 11:00,32.64,61016,1943,4,462,4322,60,6791,4.616.607.143
16/01/2018 12:00,32.57,60736,1963,3,459,4141,61,6627,4.616.607.143
16/01/2018 13:00,32.69,60442,1903,3,458,3947,62,6373,4.616.607.143
16/01/2018 14:00,32.68,60487,1817,3,458,3717,61,6056,4.616.607.143
16/01/2018 15:00,33.4,61063,1695,3,455,3443,61,5657,4.616.607.143
16/01/2018 16:00,35.81,61936,1546,4,456,3306,60,5372,4.616.607.143
16/01/2018 17:00,38.22,62283,1485,5,452,3238,61,5241,4.616.607.143
16/01/2018 18:00,38.87,61429,1597,6,450,3048,60,5161,4.616.607.143
16/01/2018 19:00,33.01,60179,1690,7,446,2892,58,5093,4.616.607.143
16/01/2018 20:00,31.73,58410,1715,8,441,2784,56,5004,4.616.607.143
16/01/2018 21:00,30.52,56784,1625,8,434,2631,55,4753,4.616.607.143
16/01/2018 22:00,29.36,54461,1595,9,421,2443,52,4520,4.616.607.143
16/01/2018 23:00,28.05,51817,1650,10,413,2366,51,4490,4.616.607.143
17/01/2018 00:00,28.14,49638,1341,64,438,2497,43,4383,4.616.607.143
17/01/2018 01:00,27.74,48502,1374,70,426,2348,39,4257,4.616.607.143
17/01/2018 02:00,27.53,48183,1251,75,417,2282,35,4060,4.616.607.143
17/01/2018 03:00,27.46,48324,1033,78,391,2276,34,3812,4.616.607.143
17/01/2018 04:00,27.91,49217,1028,85,374,2180,31,3698,4.616.607.143
17/01/2018 05:00,29.11,51695,1171,92,344,2140,29,3776,4.616.607.143
17/01/2018 06:00,31.84,55994,1285,99,290,2104,26,3804,4.616.607.143
17/01/2018 07:00,41.49,60296,1204,110,259,1846,23,3442,4.616.607.143
17/01/2018 08:00,44.62,61292,1184,120,235,1811,18,3368,4.616.607.143
17/01/2018 09:00,41.61,61134,1162,128,209,1715,19,3233,4.616.607.143
17/01/2018 10:00,39.92,61316,1072,132,187,1583,18,2992,4.616.607.143
17/01/2018 11:00,39.16,61283,1116,137,165,1408,15,2841,4.616.607.143
17/01/2018 12:00,35.7,60882,1213,139,150,1320,13,2835,4.616.607.143
17/01/2018 13:00,33.05,60614,1298,140,146,1260,10,2854,4.616.607.143
17/01/2018 14:00,32.97,60730,1301,141,144,1198,9,2793,4.616.607.143
17/01/2018 15:00,34.48,61329,1229,143,143,1194,9,2718,4.616.607.143
17/01/2018 16:00,40.96,62249,1119,148,140,1165,8,2580,4.616.607.143
17/01/2018 17:00,41.32,62891,1099,154,140,1225,8,2626,4.616.607.143
17/01/2018 18:00,39.75,62032,1212,158,139,1209,6,2724,4.616.607.143
17/01/2018 19:00,33.86,60892,1283,162,138,1155,6,2744,4.616.607.143
17/01/2018 20:00,31.05,59177,1331,166,140,1137,4,2778,4.616.607.143
17/01/2018 21:00,30.5,57670,1430,169,143,1045,3,2790,4.616.607.143
17/01/2018 22:00,29.89,55242,1535,173,145,1017,3,2873,4.616.607.143
17/01/2018 23:00,29.31,52544,1592,177,147,938,3,2857,4.616.607.143
18/01/2018 00:00,29.12,50026,1203,183,67,883,3,2339,4.616.607.143
18/01/2018 01:00,28.6,48906,1187,188,81,883,3,2342,4.616.607.143
18/01/2018 02:00,28.46,48558,1171,193,84,874,3,2325,4.616.607.143
18/01/2018 03:00,28.34,48790,1250,197,88,869,3,2407,4.616.607.143
18/01/2018 04:00,28.75,49671,1236,200,93,830,3,2362,4.616.607.143
18/01/2018 05:00,29.97,52028,1127,203,92,778,3,2203,4.616.607.143
18/01/2018 06:00,31.91,56125,1132,207,97,739,3,2178,4.616.607.143
18/01/2018 07:00,45.08,60291,1064,209,100,743,3,2119,4.616.607.143
18/01/2018 08:00,44.41,61463,1001,212,100,667,3,1983,4.616.607.143
18/01/2018 09:00,43.32,61285,1015,215,99,640,6,1975,4.616.607.143
18/01/2018 10:00,44.98,61366,803,212,105,626,5,1751,4.616.607.143
18/01/2018 11:00,42.26,61250,479,213,103,593,5,1393,4.616.607.143
18/01/2018 12:00,40.75,60822,406,213,111,603,6,1339,4.616.607.143
18/01/2018 13:00,37.85,60574,447,215,114,602,5,1383,4.616.607.143
18/01/2018 14:00,37.44,60635,479,217,132,640,5,1473,4.616.607.143
18/01/2018 15:00,40.25,61198,528,220,147,698,6,1599,4.616.607.143
18/01/2018 16:00,43.04,62082,520,217,164,710,6,1617,4.616.607.143
18/01/2018 17:00,46.07,62522,458,215,169,702,7,1551,4.616.607.143
18/01/2018 18:00,43.63,61677,414,216,175,691,7,1503,4.616.607.143
18/01/2018 19:00,41.52,60428,379,211,181,667,8,1446,4.616.607.143
18/01/2018 20:00,38.93,58713,393,206,197,599,6,1401,4.616.607.143
18/01/2018 21:00,34.3,57267,388,201,221,565,6,1381,4.616.607.143
18/01/2018 22:00,32.57,55108,347,196,251,528,6,1328,4.616.607.143
18/01/2018 23:00,30.45,52408,244,190,264,497,6,1201,4.616.607.143
19/01/2018 00:00,30.03,50031,198,193,265,374,7,1037,4.616.607.143
19/01/2018 01:00,30.02,49045,159,189,248,343,8,947,4.616.607.143
19/01/2018 02:00,29.54,48705,161,185,238,320,8,912,4.616.607.143
19/01/2018 03:00,29.51,48822,139,180,220,301,8,848,4.616.607.143
19/01/2018 04:00,30,49667,130,176,207,295,9,817,4.616.607.143
19/01/2018 05:00,32.48,52058,135,170,184,287,10,786,4.616.607.143
19/01/2018 06:00,41.38,56244,141,166,166,274,8,755,4.616.607.143
19/01/2018 07:00,54.95,60558,165,162,143,274,8,752,4.616.607.143
19/01/2018 08:00,55.01,62027,227,156,113,265,7,768,4.616.607.143
19/01/2018 09:00,53.48,61931,266,150,87,266,9,778,4.616.607.143
19/01/2018 10:00,53.06,61987,281,142,73,261,7,764,4.616.607.143
19/01/2018 11:00,49.95,61752,293,133,64,250,7,747,4.616.607.143
19/01/2018 12:00,45.01,60990,347,123,58,250,8,786,4.616.607.143
19/01/2018 13:00,41.84,60261,423,118,58,284,6,889,4.616.607.143
19/01/2018 14:00,41.82,59863,452,114,62,362,6,996,4.616.607.143
19/01/2018 15:00,45.06,60143,478,111,69,465,6,1129,4.616.607.143
19/01/2018 16:00,53.79,60988,555,106,74,576,9,1320,4.616.607.143
19/01/2018 17:00,61.17,61631,633,101,72,656,9,1471,4.616.607.143
19/01/2018 18:00,52.31,60772,732,93,72,706,6,1609,4.616.607.143
19/01/2018 19:00,41.84,59222,783,86,66,781,6,1722,4.616.607.143
19/01/2018 20:00,39.96,57060,791,82,61,801,4,1739,4.616.607.143
19/01/2018 21:00,36.98,55552,812,79,56,800,4,1751,4.616.607.143
19/01/2018 22:00,36.54,53648,881,76,50,818,4,1829,4.616.607.143
19/01/2018 23:00,32.79,51512,840,72,46,802,4,1764,4.616.607.143
20/01/2018 00:00,30.81,49795,829,13,23,900,4,1769,4.616.607.143
20/01/2018 01:00,29.71,48651,809,13,20,928,4,1774,4.616.607.143
20/01/2018 02:00,29.3,48112,815,14,15,916,4,1764,4.616.607.143
20/01/2018 03:00,29.01,47940,754,13,14,936,4,1721,4.616.607.143
20/01/2018 04:00,28.98,48130,734,12,14,955,3,1718,4.616.607.143
20/01/2018 05:00,29.23,48892,715,10,13,966,3,1707,4.616.607.143
20/01/2018 06:00,29.68,50226,740,9,12,999,4,1764,4.616.607.143
20/01/2018 07:00,30.77,52046,722,9,8,999,4,1742,4.616.607.143
20/01/2018 08:00,32.21,53700,683,10,7,966,4,1670,4.616.607.143
20/01/2018 09:00,33.82,55229,711,10,7,936,6,1670,4.616.607.143
20/01/2018 10:00,34.44,56297,670,8,7,892,5,1582,4.616.607.143
20/01/2018 11:00,34.9,56498,447,6,6,803,4,1266,4.616.607.143
20/01/2018 12:00,34.12,56109,402,6,6,751,5,1170,4.616.607.143
20/01/2018 13:00,33.43,55710,436,5,7,741,4,1193,4.616.607.143
20/01/2018 14:00,33.29,55634,412,5,8,748,4,1177,4.616.607.143
20/01/2018 15:00,34.39,56426,456,5,9,777,5,1252,4.616.607.143
20/01/2018 16:00,36.35,57919,385,5,11,831,5,1237,4.616.607.143
20/01/2018 17:00,38.07,59011,361,5,14,858,6,1244,4.616.607.143
20/01/2018 18:00,38.34,58319,367,6,16,863,6,1258,4.616.607.143
20/01/2018 19:00,34.93,56848,361,7,19,849,6,1242,4.616.607.143
20/01/2018 20:00,32.43,55028,339,8,21,846,4,1218,4.616.607.143
20/01/2018 21:00,32.53,53819,345,8,23,803,4,1183,4.616.607.143
20/01/2018 22:00,32.31,52431,354,8,25,715,4,1106,4.616.607.143
20/01/2018 23:00,31.64,50746,316,8,26,685,4,1039,4.616.607.143
21/01/2018 00:00,31.54,49588,340,10,20,595,4,969,4.616.607.143
21/01/2018 01:00,30.35,48560,291,11,19,574,4,899,4.616.607.143
21/01/2018 02:00,29.21,47943,261,12,20,569,4,866,4.616.607.143
21/01/2018 03:00,28.68,47816,264,13,24,557,4,862,4.616.607.143
21/01/2018 04:00,28.78,48011,258,14,25,540,4,841,4.616.607.143
21/01/2018 05:00,29.01,48543,227,14,25,512,4,782,4.616.607.143
21/01/2018 06:00,29.45,49417,211,15,25,476,4,731,4.616.607.143
21/01/2018 07:00,30.67,50914,188,16,23,462,4,693,4.616.607.143
21/01/2018 08:00,31.71,52372,167,16,20,443,4,650,4.616.607.143
21/01/2018 09:00,32.55,53943,149,16,16,408,4,593,4.616.607.143
21/01/2018 10:00,33.72,55189,144,16,13,356,4,533,4.616.607.143
21/01/2018 11:00,34.62,56220,92,17,11,298,5,423,4.616.607.143
21/01/2018 12:00,34.53,56159,77,17,10,271,4,379,4.616.607.143
21/01/2018 13:00,33.8,55906,91,17,10,272,4,394,4.616.607.143
21/01/2018 14:00,33.08,55957,109,19,10,289,4,431,4.616.607.143
21/01/2018 15:00,33.75,56934,166,22,11,328,4,531,4.616.607.143
21/01/2018 16:00,34.71,58524,234,25,12,367,4,642,4.616.607.143
21/01/2018 17:00,40.9,59711,362,30,12,395,6,805,4.616.607.143
21/01/2018 18:00,42.75,59415,507,34,12,417,6,976,4.616.607.143
21/01/2018 19:00,39.12,58361,684,36,12,439,6,1177,4.616.607.143
21/01/2018 20:00,35.86,56897,878,38,12,451,4,1383,4.616.607.143
21/01/2018 21:00,32.54,55934,1057,44,12,471,4,1588,4.616.607.143
21/01/2018 22:00,32.24,54318,1191,49,14,488,4,1746,4.616.607.143
21/01/2018 23:00,30.52,52591,1341,53,20,495,4,1913,4.616.607.143
22/01/2018 00:00,29.3,51161,1339,29,17,460,7,1852,4.404.166.667
22/01/2018 01:00,28.6,50278,1445,31,22,459,8,1965,4.404.166.667
22/01/2018 02:00,28.42,50002,1574,30,28,462,8,2102,4.404.166.667
22/01/2018 03:00,28.51,50132,1746,31,42,471,8,2298,4.404.166.667
22/01/2018 04:00,28.81,51087,1905,31,53,477,8,2474,4.404.166.667
22/01/2018 05:00,30.54,53593,2039,31,54,484,8,2616,4.404.166.667
22/01/2018 06:00,36.39,57861,2118,30,60,494,17,2719,4.404.166.667
22/01/2018 07:00,51.95,62072,2163,27,61,502,8,2761,4.404.166.667
22/01/2018 08:00,51.96,63192,2257,24,56,541,9,2887,4.404.166.667
22/01/2018 09:00,51.9,62924,2303,23,56,505,10,2897,4.404.166.667
22/01/2018 10:00,49.75,62942,2254,21,50,496,9,2830,4.404.166.667
22/01/2018 11:00,51.87,62747,2079,20,45,527,9,2680,4.404.166.667
22/01/2018 12:00,51.87,62230,2019,18,44,536,10,2627,4.404.166.667
22/01/2018 13:00,52.48,61991,1955,16,42,548,11,2572,4.404.166.667
22/01/2018 14:00,51.2,62038,1798,17,53,511,12,2391,4.404.166.667
22/01/2018 15:00,49.68,62523,1738,22,70,517,11,2358,4.404.166.667
22/01/2018 16:00,50.6,63420,1658,26,92,542,14,2332,4.404.166.667
22/01/2018 17:00,52.53,64185,1499,26,103,582,15,2225,4.404.166.667
22/01/2018 18:00,49.09,63413,1361,25,115,606,13,2120,4.404.166.667
22/01/2018 19:00,48,62165,1230,22,120,603,13,1988,4.404.166.667
22/01/2018 20:00,42.75,60381,1125,19,115,608,12,1879,4.404.166.667
22/01/2018 21:00,37.5,58829,1024,16,114,613,11,1778,4.404.166.667
22/01/2018 22:00,35.07,56558,895,14,119,602,11,1641,4.404.166.667
22/01/2018 23:00,33.06,54023,798,12,119,615,10,1554,4.404.166.667
23/01/2018 00:00,32.99,52298,748,0,56,637,7,1448,4.404.166.667
23/01/2018 01:00,31.62,51171,711,0,54,683,7,1455,4.404.166.667
23/01/2018 02:00,30.81,50818,744,0,54,732,7,1537,4.404.166.667
23/01/2018 03:00,30.47,51040,810,0,63,806,7,1686,4.404.166.667
23/01/2018 04:00,31.01,52004,877,0,68,898,7,1850,4.404.166.667
23/01/2018 05:00,33.36,54333,956,0,74,1005,10,2045,4.404.166.667
23/01/2018 06:00,42.68,58573,1050,0,78,1155,18,2301,4.404.166.667
23/01/2018 07:00,74.82,62701,1230,0,68,1285,18,2601,4.404.166.667
23/01/2018 08:00,77.73,63648,1499,0,63,1446,19,3027,4.404.166.667
23/01/2018 09:00,62.33,63097,1751,0,52,1569,16,3388,4.404.166.667
23/01/2018 10:00,55.89,63025,1939,0,48,1693,20,3700,4.404.166.667
23/01/2018 11:00,46.96,62802,1990,0,48,1822,20,3880,4.404.166.667
23/01/2018 12:00,42.58,62173,2035,0,43,1981,18,4077,4.404.166.667
23/01/2018 13:00,40.94,61867,2106,0,54,2172,20,4352,4.404.166.667
23/01/2018 14:00,39.21,61673,2176,0,70,2292,23,4561,4.404.166.667
23/01/2018 15:00,39.14,61974,2369,0,88,2459,25,4941,4.404.166.667
23/01/2018 16:00,41.67,62719,2628,0,117,2624,34,5403,4.404.166.667
23/01/2018 17:00,46.92,63250,2947,0,134,2822,35,5938,4.404.166.667
23/01/2018 18:00,37.1,62324,3286,0,145,2957,33,6421,4.404.166.667
23/01/2018 19:00,32.99,60970,3569,0,157,3098,35,6859,4.404.166.667
23/01/2018 20:00,31.27,59084,3875,0,172,3254,35,7336,4.404.166.667
23/01/2018 21:00,29.75,57347,3934,0,200,3458,36,7628,4.404.166.667
23/01/2018 22:00,28.78,54839,3818,0,233,3617,41,7709,4.404.166.667
23/01/2018 23:00,28.08,52140,3573,0,270,3864,45,7752,4.404.166.667
24/01/2018 00:00,27.24,49567,3928,32,239,4146,36,8381,4.404.166.667
24/01/2018 01:00,26.62,48346,3886,28,258,4272,39,8483,4.404.166.667
24/01/2018 02:00,25.73,47749,3651,26,279,4298,41,8295,4.404.166.667
24/01/2018 03:00,25.39,47746,3417,22,281,4284,43,8047,4.404.166.667
24/01/2018 04:00,25.99,48470,3117,18,300,4200,44,7679,4.404.166.667
24/01/2018 05:00,27.4,50779,2904,15,311,4027,45,7302,4.404.166.667
24/01/2018 06:00,28.94,54914,2674,12,331,3881,47,6945,4.404.166.667
24/01/2018 07:00,32.18,59038,2623,11,334,3671,49,6688,4.404.166.667
24/01/2018 08:00,33.08,59853,2876,12,337,3459,51,6735,4.404.166.667
24/01/2018 09:00,32.34,59577,3171,14,343,3215,51,6794,4.404.166.667
24/01/2018 10:00,30.91,59579,3572,16,340,3166,53,7147,4.404.166.667
24/01/2018 11:00,30.16,59320,4056,22,317,3133,53,7581,4.404.166.667
24/01/2018 12:00,30.06,58834,4334,29,295,3100,49,7807,4.404.166.667
24/01/2018 13:00,29.56,58468,4455,38,275,3172,41,7981,4.404.166.667
24/01/2018 14:00,29.46,58500,4360,51,255,3331,40,8037,4.404.166.667
24/01/2018 15:00,29.51,58957,4379,68,245,3577,39,8308,4.404.166.667
24/01/2018 16:00,29.67,59785,4413,88,249,3823,41,8614,4.404.166.667
24/01/2018 17:00,30.07,60251,4385,102,266,4139,35,8927,4.404.166.667
24/01/2018 18:00,29.55,59236,4242,119,276,4377,35,9049,4.404.166.667
24/01/2018 19:00,28.86,57706,4012,131,284,4592,34,9053,4.404.166.667
24/01/2018 20:00,28.41,55676,3936,141,283,4740,36,9136,4.404.166.667
24/01/2018 21:00,28.07,53862,3652,149,299,4843,45,8988,4.404.166.667
24/01/2018 22:00,27.16,51497,3361,156,307,4946,50,8820,4.404.166.667
24/01/2018 23:00,25.5,48794,3035,163,340,4963,47,8548,4.404.166.667
25/01/2018 00:00,26.19,46889,4055,170,397,5012,50,9684,4.404.166.667
25/01/2018 01:00,25.22,45709,3913,176,399,5005,50,9543,4.404.166.667
25/01/2018 02:00,24.05,45369,3748,180,396,4919,51,9294,4.404.166.667
25/01/2018 03:00,23.89,45542,3651,186,388,4841,51,9117,4.404.166.667
25/01/2018 04:00,23.68,46311,3424,193,387,4762,50,8816,4.404.166.667
25/01/2018 05:00,26.09,48741,3222,202,385,4695,49,8553,4.404.166.667
25/01/2018 06:00,28.2,52971,3046,209,385,4585,49,8274,4.404.166.667
25/01/2018 07:00,30.9,57353,2925,213,375,4517,48,8078,4.404.166.667
25/01/2018 08:00,31.57,58473,2926,218,366,4374,47,7931,4.404.166.667
25/01/2018 09:00,31.46,58186,2903,222,352,4252,44,7773,4.404.166.667
25/01/2018 10:00,31.17,58067,2886,226,334,4135,40,7621,4.404.166.667
25/01/2018 11:00,30.91,57837,2869,228,310,4118,38,7563,4.404.166.667
25/01/2018 12:00,30.57,57329,2990,228,287,4116,35,7656,4.404.166.667
25/01/2018 13:00,30.6,57078,2952,225,268,4082,35,7562,4.404.166.667
25/01/2018 14:00,30.63,57002,2763,219,256,4087,33,7358,4.404.166.667
25/01/2018 15:00,31.06,57460,2504,209,240,4099,33,7085,4.404.166.667
25/01/2018 16:00,32.08,58430,2148,204,230,4081,32,6695,4.404.166.667
25/01/2018 17:00,36.26,59218,1863,200,221,3971,27,6282,4.404.166.667
25/01/2018 18:00,34.47,58541,1640,198,208,3993,25,6064,4.404.166.667
25/01/2018 19:00,32.18,57273,1532,199,192,3952,22,5897,4.404.166.667
25/01/2018 20:00,31.49,55528,1500,203,171,3869,22,5765,4.404.166.667
25/01/2018 21:00,30.73,53916,1480,212,157,3695,21,5565,4.404.166.667
25/01/2018 22:00,29.71,51694,1396,220,138,3516,16,5286,4.404.166.667
25/01/2018 23:00,28.98,48986,1244,227,117,3425,14,5027,4.404.166.667
26/01/2018 00:00,29.12,46762,1011,243,81,3241,14,4590,4.404.166.667
26/01/2018 01:00,28.8,45802,898,245,71,2977,14,4205,4.404.166.667
26/01/2018 02:00,28.75,45599,790,247,67,2731,12,3847,4.404.166.667
26/01/2018 03:00,28.95,45783,664,247,67,2679,12,3669,4.404.166.667
26/01/2018 04:00,29.47,46624,595,246,63,2583,11,3498,4.404.166.667
26/01/2018 05:00,30.13,49050,554,243,58,2403,11,3269,4.404.166.667
26/01/2018 06:00,32.12,53195,532,237,56,2282,11,3118,4.404.166.667
26/01/2018 07:00,35.91,57424,549,230,53,2213,11,3056,4.404.166.667
26/01/2018 08:00,39.68,58601,586,226,51,2162,10,3035,4.404.166.667
26/01/2018 09:00,39.92,58467,619,223,50,2077,11,2980,4.404.166.667
26/01/2018 10:00,39.89,58469,613,219,45,1978,10,2865,4.404.166.667
26/01/2018 11:00,37.09,58046,600,216,37,1842,9,2704,4.404.166.667
26/01/2018 12:00,34.33,57337,630,215,29,1730,9,2613,4.404.166.667
26/01/2018 13:00,33.98,56782,662,215,25,1617,8,2527,4.404.166.667
26/01/2018 14:00,33.97,56413,660,213,23,1524,8,2428,4.404.166.667
26/01/2018 15:00,33.84,56676,629,210,24,1494,8,2365,4.404.166.667
26/01/2018 16:00,35.7,57609,664,210,24,1542,8,2448,4.404.166.667
26/01/2018 17:00,47.06,58412,698,210,24,1496,9,2437,4.404.166.667
26/01/2018 18:00,41.86,57755,710,208,24,1557,9,2508,4.404.166.667
26/01/2018 19:00,34.31,56205,753,207,22,1561,8,2551,4.404.166.667
26/01/2018 20:00,32.18,54189,782,204,21,1551,7,2565,4.404.166.667
26/01/2018 21:00,31.22,52698,780,198,20,1571,7,2576,4.404.166.667
26/01/2018 22:00,30.48,50948,775,191,20,1587,8,2581,4.404.166.667
26/01/2018 23:00,30.08,48917,773,180,20,1533,8,2514,4.404.166.667
27/01/2018 00:00,30.68,46763,767,9,0,1410,6,2192,4.404.166.667
27/01/2018 01:00,30.17,45729,750,7,0,1328,6,2091,4.404.166.667
27/01/2018 02:00,29.98,45222,665,6,0,1292,6,1969,4.404.166.667
27/01/2018 03:00,29.96,45189,561,7,0,1265,5,1838,4.404.166.667
27/01/2018 04:00,30.17,45513,478,8,0,1226,5,1717,4.404.166.667
27/01/2018 05:00,30.64,46353,425,8,0,1185,5,1623,4.404.166.667
27/01/2018 06:00,30.64,47651,397,9,0,1186,6,1598,4.404.166.667
27/01/2018 07:00,30.71,49416,400,11,0,1109,6,1526,4.404.166.667
27/01/2018 08:00,31.57,51207,443,11,0,1014,7,1475,4.404.166.667
27/01/2018 09:00,32.96,52842,536,9,0,937,8,1490,4.404.166.667
27/01/2018 10:00,34.37,53804,694,8,0,805,10,1517,4.404.166.667
27/01/2018 11:00,33.58,53875,874,7,0,730,11,1622,4.404.166.667
27/01/2018 12:00,32.55,53407,1086,7,0,638,14,1745,4.404.166.667
27/01/2018 13:00,31.85,52949,1412,7,0,614,13,2046,4.404.166.667
27/01/2018 14:00,31.32,52890,1753,8,0,590,11,2362,4.404.166.667
27/01/2018 15:00,31.04,53615,2142,10,0,650,9,2811,4.404.166.667
27/01/2018 16:00,31.49,55262,2538,11,0,778,8,3335,4.404.166.667
27/01/2018 17:00,33.9,56729,3040,12,0,957,8,4017,4.404.166.667
27/01/2018 18:00,32.25,56262,3429,12,0,1222,8,4671,4.404.166.667
27/01/2018 19:00,31.15,54844,3752,10,0,1549,7,5318,4.404.166.667
27/01/2018 20:00,29.86,53114,4107,9,0,1859,7,5982,4.404.166.667
27/01/2018 21:00,28.9,51995,4246,10,0,2189,8,6453,4.404.166.667
27/01/2018 22:00,28.6,50570,4260,11,0,2508,9,6788,4.404.166.667
27/01/2018 23:00,28.01,48803,4180,12,0,2787,10,6989,4.404.166.667
28/01/2018 00:00,27.99,46985,4312,6,191,3293,11,7813,4.404.166.667
28/01/2018 01:00,27.22,45890,4218,7,235,3346,15,7821,4.404.166.667
28/01/2018 02:00,25.31,45237,4266,8,252,3341,18,7885,4.404.166.667
28/01/2018 03:00,25.56,44939,4236,10,261,3325,22,7854,4.404.166.667
28/01/2018 04:00,25.96,44959,4136,10,284,3296,28,7754,4.404.166.667
28/01/2018 05:00,27,45422,4090,11,321,3250,37,7709,4.404.166.667
28/01/2018 06:00,27.09,46146,4022,12,350,3227,44,7655,4.404.166.667
28/01/2018 07:00,27.35,47390,4063,12,367,3199,46,7687,4.404.166.667
28/01/2018 08:00,27.83,48688,4205,11,405,3257,48,7926,4.404.166.667
28/01/2018 09:00,27.97,50152,4214,9,419,3195,48,7885,4.404.166.667
28/01/2018 10:00,28.63,51215,4315,9,421,3234,35,8014,4.404.166.667
28/01/2018 11:00,28.67,51599,4389,8,421,3247,37,8102,4.404.166.667
28/01/2018 12:00,28.61,51541,4343,10,420,3256,44,8073,4.404.166.667
28/01/2018 13:00,28.32,51290,4231,11,420,3267,42,7971,4.404.166.667
28/01/2018 14:00,27.99,51252,3985,13,423,3297,45,7763,4.404.166.667
28/01/2018 15:00,28.44,51954,3936,15,418,3305,41,7715,4.404.166.667
28/01/2018 16:00,28.74,53367,3764,17,420,3309,42,7552,4.404.166.667
28/01/2018 17:00,29.21,54530,3625,18,420,3280,40,7383,4.404.166.667
28/01/2018 18:00,29.25,54231,3375,19,422,3222,44,7082,4.404.166.667
28/01/2018 19:00,28.97,53206,3108,20,419,3097,42,6686,4.404.166.667
28/01/2018 20:00,28.79,51830,2852,20,420,2976,41,6309,4.404.166.667
28/01/2018 21:00,28.57,50949,2540,20,415,2871,41,5887,4.404.166.667
28/01/2018 22:00,27.94,49443,2324,22,411,2753,40,5550,4.404.166.667
28/01/2018 23:00,27.57,47801,2068,23,408,2603,37,5139,4.404.166.667
29/01/2018 00:00,27.66,46709,2177,166,468,2298,42,5151,4.166.190.476
29/01/2018 01:00,27.1,45742,2411,157,466,2084,37,5155,4.166.190.476
29/01/2018 02:00,26.33,45424,2741,150,459,1839,36,5225,4.166.190.476
29/01/2018 03:00,27.07,45688,3156,142,435,1558,37,5328,4.166.190.476
29/01/2018 04:00,27.52,46617,3552,134,420,1363,33,5502,4.166.190.476
29/01/2018 05:00,28.52,49128,3985,124,397,1219,27,5752,4.166.190.476
29/01/2018 06:00,29.99,53428,4164,115,374,1119,26,5798,4.166.190.476
29/01/2018 07:00,31.6,57627,4347,107,336,1134,23,5947,4.166.190.476
29/01/2018 08:00,31.59,58828,4515,101,295,1234,19,6164,4.166.190.476
29/01/2018 09:00,31.11,58710,4485,94,259,1369,17,6224,4.166.190.476
29/01/2018 10:00,31.03,58747,4527,87,215,1484,18,6331,4.166.190.476
29/01/2018 11:00,30.99,58582,4508,79,192,1526,18,6323,4.166.190.476
29/01/2018 12:00,30.88,58188,4370,70,151,1581,12,6184,4.166.190.476
29/01/2018 13:00,30.81,58094,4251,62,147,1678,12,6150,4.166.190.476
29/01/2018 14:00,30.83,58152,3939,58,198,1712,31,5938,4.166.190.476
29/01/2018 15:00,31.27,58524,3865,56,221,1790,40,5972,4.166.190.476
29/01/2018 16:00,31.36,59313,3883,56,273,1870,49,6131,4.166.190.476
29/01/2018 17:00,33.64,60158,3898,53,333,1827,58,6169,4.166.190.476
29/01/2018 18:00,35.11,59690,3904,50,377,1765,59,6155,4.166.190.476
29/01/2018 19:00,31.01,58432,3956,48,396,1738,58,6196,4.166.190.476
29/01/2018 20:00,30.06,56684,4106,47,414,1641,59,6267,4.166.190.476
29/01/2018 21:00,29.36,55343,4126,45,429,1657,59,6316,4.166.190.476
29/01/2018 22:00,28.82,53185,4095,43,434,1623,58,6253,4.166.190.476
29/01/2018 23:00,28.33,50600,4065,38,435,1607,50,6195,4.166.190.476
30/01/2018 00:00,27.89,48654,4602,20,477,1814,13,6926,4.166.190.476
30/01/2018 01:00,27.67,47611,4545,22,477,1823,15,6882,4.166.190.476
30/01/2018 02:00,27.18,47414,4515,21,478,1813,19,6846,4.166.190.476
30/01/2018 03:00,27.39,47760,4443,24,475,1769,29,6740,4.166.190.476
30/01/2018 04:00,27.8,48715,4241,25,467,1714,29,6476,4.166.190.476
30/01/2018 05:00,28.71,51204,4181,28,465,1630,24,6328,4.166.190.476
30/01/2018 06:00,31.46,55364,3985,31,457,1539,25,6037,4.166.190.476
30/01/2018 07:00,33.36,59586,3833,30,447,1463,22,5795,4.166.190.476
30/01/2018 08:00,33.95,60778,3815,24,442,1407,21,5709,4.166.190.476
30/01/2018 09:00,33.6,60584,3675,19,438,1398,25,5555,4.166.190.476
30/01/2018 10:00,33.55,60604,3600,15,437,1354,29,5435,4.166.190.476
30/01/2018 11:00,32.87,60350,3519,14,438,1386,30,5387,4.166.190.476
30/01/2018 12:00,32.6,59712,3400,14,437,1397,32,5280,4.166.190.476
30/01/2018 13:00,32.42,59414,3335,15,431,1364,32,5177,4.166.190.476
30/01/2018 14:00,32.48,59288,3043,14,422,1378,31,4888,4.166.190.476
30/01/2018 15:00,32.96,59378,2883,16,407,1408,29,4743,4.166.190.476
30/01/2018 16:00,34.5,60436,2707,19,390,1419,27,4562,4.166.190.476
30/01/2018 17:00,46.02,61441,2484,26,370,1425,22,4327,4.166.190.476
30/01/2018 18:00,42.41,60971,2172,29,356,1432,18,4007,4.166.190.476
30/01/2018 19:00,37.5,59887,1828,31,327,1375,16,3577,4.166.190.476
30/01/2018 20:00,33.18,58218,1653,31,302,1318,14,3318,4.166.190.476
30/01/2018 21:00,32.44,56702,1668,38,276,1296,13,3291,4.166.190.476
30/01/2018 22:00,31.18,54447,1850,42,236,1274,11,3413,4.166.190.476
30/01/2018 23:00,30.14,51801,2029,46,190,1353,8,3626,4.166.190.476
31/01/2018 00:00,29.87,49446,2775,48,106,1546,5,4480,4.166.190.476
31/01/2018 01:00,29.27,48335,2860,55,83,1679,5,4682,4.166.190.476
31/01/2018 02:00,28.36,47890,2968,62,70,1755,4,4859,4.166.190.476
31/01/2018 03:00,28.11,48017,3086,69,59,1846,4,5064,4.166.190.476
31/01/2018 04:00,28.11,48794,3154,76,49,1978,3,5260,4.166.190.476
31/01/2018 05:00,28.75,51152,3350,82,41,2108,3,5584,4.166.190.476
31/01/2018 06:00,31.19,55188,3338,89,40,2233,11,5711,4.166.190.476
31/01/2018 07:00,34.72,59272,3459,95,41,2380,7,5982,4.166.190.476
31/01/2018 08:00,34.95,60077,3649,96,47,2405,4,6201,4.166.190.476
31/01/2018 09:00,32.31,59831,3681,95,59,2565,5,6405,4.166.190.476
31/01/2018 10:00,31.8,59797,3618,94,74,2808,7,6601,4.166.190.476
31/01/2018 11:00,30.95,59622,3541,92,92,2935,8,6668,4.166.190.476
31/01/2018 12:00,30.38,59184,3383,86,106,3038,9,6622,4.166.190.476
31/01/2018 13:00,30.04,58854,3307,76,125,3128,10,6646,4.166.190.476
31/01/2018 14:00,30.24,58856,3062,67,153,3162,11,6455,4.166.190.476
31/01/2018 15:00,30.17,59164,2716,63,188,3257,13,6237,4.166.190.476
31/01/2018 16:00,30.94,59915,2301,60,242,3252,16,5871,4.166.190.476
31/01/2018 17:00,34.57,60808,2203,58,304,3230,20,5815,4.166.190.476
31/01/2018 18:00,35.31,60179,2255,55,361,3175,20,5866,4.166.190.476
31/01/2018 19:00,32.32,58896,2354,51,401,3207,23,6036,4.166.190.476
31/01/2018 20:00,30.15,57088,2419,46,412,3207,26,6110,4.166.190.476
31/01/2018 21:00,28.98,55521,2438,42,415,3122,26,6043,4.166.190.476
31/01/2018 22:00,28.47,53306,2446,39,414,3091,28,6018,4.166.190.476
31/01/2018 23:00,27.7,50817,2446,36,408,3055,29,5974,4.166.190.476
01/02/2018 00:00,28.12,48444,3052,34,398,3080,32,6596,4.166.190.476
01/02/2018 01:00,27.96,47417,3109,30,390,3021,31,6581,4.166.190.476
01/02/2018 02:00,27.81,47058,3182,25,385,3011,31,6634,4.166.190.476
01/02/2018 03:00,27.06,47233,3314,19,377,2999,31,6740,4.166.190.476
01/02/2018 04:00,27.06,48103,3398,13,365,3039,32,6847,4.166.190.476
01/02/2018 05:00,28.96,50445,3532,9,347,3137,32,7057,4.166.190.476
01/02/2018 06:00,30.86,54512,3510,5,318,3020,30,6883,4.166.190.476
01/02/2018 07:00,33.61,58694,3366,4,270,3046,23,6709,4.166.190.476
01/02/2018 08:00,33.7,59668,3274,4,213,3022,19,6532,4.166.190.476
01/02/2018 09:00,33.27,59378,3237,6,158,3103,16,6520,4.166.190.476
01/02/2018 10:00,33.15,59324,3339,10,140,3079,13,6581,4.166.190.476
01/02/2018 11:00,31.97,59090,3422,13,133,3084,13,6665,4.166.190.476
01/02/2018 12:00,31.29,58741,3457,15,141,3130,14,6757,4.166.190.476
01/02/2018 13:00,31.85,58554,3478,22,134,3099,16,6749,4.166.190.476
01/02/2018 14:00,32.05,58528,3255,27,120,3030,15,6447,4.166.190.476
01/02/2018 15:00,32.14,58914,3150,39,117,3062,15,6383,4.166.190.476
01/02/2018 16:00,32.92,59799,3129,53,114,3093,14,6403,4.166.190.476
01/02/2018 17:00,34.08,60727,3150,67,111,3042,13,6383,4.166.190.476
01/02/2018 18:00,34.29,60194,2915,81,110,3067,15,6188,4.166.190.476
01/02/2018 19:00,32.53,59157,2622,90,109,2947,15,5783,4.166.190.476
01/02/2018 20:00,31.81,57491,2484,97,111,2869,17,5578,4.166.190.476
01/02/2018 21:00,31.68,56000,2306,104,120,2801,16,5347,4.166.190.476
01/02/2018 22:00,30.94,53838,2075,110,120,2812,16,5133,4.166.190.476
01/02/2018 23:00,29.53,51319,1858,115,123,2794,16,4906,4.166.190.476
02/02/2018 00:00,30.12,49459,2297,150,20,2793,5,5265,4.166.190.476
02/02/2018 01:00,29.87,48617,2206,160,21,2770,4,5161,4.166.190.476
02/02/2018 02:00,29.79,48457,2167,169,23,2734,4,5097,4.166.190.476
02/02/2018 03:00,29.74,48729,2135,176,31,2686,4,5032,4.166.190.476
02/02/2018 04:00,30.1,49623,2112,181,32,2533,4,4862,4.166.190.476
02/02/2018 05:00,32.13,52030,2189,184,38,2533,5,4949,4.166.190.476
02/02/2018 06:00,33.66,56405,2269,184,44,2488,4,4989,4.166.190.476
02/02/2018 07:00,40.24,60797,2333,182,45,2404,5,4969,4.166.190.476
02/02/2018 08:00,42.49,62199,2322,179,40,2459,4,5004,4.166.190.476
02/02/2018 09:00,41.34,62198,2173,173,33,2375,4,4758,4.166.190.476
02/02/2018 10:00,42.47,62216,2069,166,33,2280,4,4552,4.166.190.476
02/02/2018 11:00,36.85,61926,1892,153,33,2239,3,4320,4.166.190.476
02/02/2018 12:00,35.17,61253,1709,141,32,2165,3,4050,4.166.190.476
02/02/2018 13:00,35.16,60768,1513,126,34,2108,4,3785,4.166.190.476
02/02/2018 14:00,35.89,60398,1327,109,42,2095,3,3576,4.166.190.476
02/02/2018 15:00,35.52,60482,1273,97,55,2179,4,3608,4.166.190.476
02/02/2018 16:00,41.01,61432,1238,92,60,2238,4,3632,4.166.190.476
02/02/2018 17:00,45.04,62467,1177,89,69,2345,5,3685,4.166.190.476
02/02/2018 18:00,42.54,62001,1075,85,76,2417,5,3658,4.166.190.476
02/02/2018 19:00,36.64,60633,951,81,75,2380,5,3492,4.166.190.476
02/02/2018 20:00,34.03,58709,903,78,69,2329,4,3383,4.166.190.476
02/02/2018 21:00,33.31,57191,821,76,63,2350,4,3314,4.166.190.476
02/02/2018 22:00,32.83,55512,750,75,57,2334,5,3221,4.166.190.476
02/02/2018 23:00,31.9,53524,709,68,44,2271,4,3096,4.166.190.476
03/02/2018 00:00,32.69,51419,1036,28,57,2411,5,3537,4.166.190.476
03/02/2018 01:00,32.09,50616,962,25,57,2356,5,3405,4.166.190.476
03/02/2018 02:00,31.94,50147,918,24,46,2337,5,3330,4.166.190.476
03/02/2018 03:00,31.94,50019,892,22,45,2370,4,3333,4.166.190.476
03/02/2018 04:00,32.08,50233,881,21,45,2337,4,3288,4.166.190.476
03/02/2018 05:00,32.65,50982,862,22,40,2282,5,3211,4.166.190.476
03/02/2018 06:00,32.73,52263,829,27,40,2348,5,3249,4.166.190.476
03/02/2018 07:00,33.26,54014,849,32,35,2341,4,3261,4.166.190.476
03/02/2018 08:00,33.67,55815,934,38,34,2438,4,3448,4.166.190.476
03/02/2018 09:00,34.93,57519,1025,44,27,2359,4,3459,4.166.190.476
03/02/2018 10:00,36.49,58495,1066,51,23,2406,4,3550,4.166.190.476
03/02/2018 11:00,36.07,58499,978,63,23,2430,3,3497,4.166.190.476
03/02/2018 12:00,34.45,58115,916,68,18,2415,4,3421,4.166.190.476
03/02/2018 13:00,33.7,57581,991,66,18,2377,4,3456,4.166.190.476
03/02/2018 14:00,33.33,57353,1058,64,18,2324,4,3468,4.166.190.476
03/02/2018 15:00,33.38,57724,1162,62,33,2325,4,3586,4.166.190.476
03/02/2018 16:00,35.68,59205,1318,64,45,2404,4,3835,4.166.190.476
03/02/2018 17:00,42.39,60766,1495,64,61,2492,5,4117,4.166.190.476
03/02/2018 18:00,39,60375,1635,65,77,2524,5,4306,4.166.190.476
03/02/2018 19:00,34.62,58903,1785,65,82,2547,5,4484,4.166.190.476
03/02/2018 20:00,33.33,57199,1966,64,82,2602,5,4719,4.166.190.476
03/02/2018 21:00,32.89,55980,2020,61,88,2606,5,4780,4.166.190.476
03/02/2018 22:00,32.65,54674,2074,57,93,2578,5,4807,4.166.190.476
03/02/2018 23:00,32.12,53220,2117,53,106,2487,5,4768,4.166.190.476
04/02/2018 00:00,32.5,51530,2521,62,85,2451,4,5123,4.166.190.476
04/02/2018 01:00,31.3,50604,2597,61,92,2401,4,5155,4.166.190.476
04/02/2018 02:00,30.96,50109,2672,61,103,2338,4,5178,4.166.190.476
04/02/2018 03:00,30.99,49987,2603,65,115,2295,5,5083,4.166.190.476
04/02/2018 04:00,30.83,50066,2589,69,115,2275,5,5053,4.166.190.476
04/02/2018 05:00,30.79,50624,2645,74,108,2253,7,5087,4.166.190.476
04/02/2018 06:00,30.84,51493,2685,87,102,2239,9,5122,4.166.190.476
04/02/2018 07:00,31.22,52740,2709,101,97,2172,12,5091,4.166.190.476
04/02/2018 08:00,31.6,54166,2766,116,87,2067,14,5050,4.166.190.476
04/02/2018 09:00,32.37,55802,2756,127,87,1984,17,4971,4.166.190.476
04/02/2018 10:00,33.08,56868,2734,132,103,1912,19,4900,4.166.190.476
04/02/2018 11:00,34.43,57212,2478,129,121,1793,18,4539,4.166.190.476
04/02/2018 12:00,33.39,57008,2284,118,140,1674,18,4234,4.166.190.476
04/02/2018 13:00,32.07,56667,2174,98,167,1582,18,4039,4.166.190.476
04/02/2018 14:00,31.83,56410,1949,80,200,1535,19,3783,4.166.190.476
04/02/2018 15:00,32.14,56892,1815,68,205,1526,20,3634,4.166.190.476
04/02/2018 16:00,34.09,58494,1727,64,211,1558,22,3582,4.166.190.476
04/02/2018 17:00,38.51,60193,1679,61,199,1566,26,3531,4.166.190.476
04/02/2018 18:00,41.94,60403,1650,56,177,1653,27,3563,4.166.190.476
04/02/2018 19:00,39.57,59398,1643,52,160,1633,25,3513,4.166.190.476
04/02/2018 20:00,36.03,58110,1616,45,133,1571,24,3389,4.166.190.476
04/02/2018 21:00,34.86,57172,1488,42,111,1595,22,3258,4.166.190.476
04/02/2018 22:00,34.11,55600,1265,40,105,1567,19,2996,4.166.190.476
04/02/2018 23:00,32.78,53953,1149,39,99,1488,21,2796,4.166.190.476
05/02/2018 00:00,32.06,53308,1141,49,100,1422,11,2723,3.892.440.476
05/02/2018 01:00,31.16,52477,1057,45,101,1420,13,2636,3.892.440.476
05/02/2018 02:00,30.91,52320,997,44,100,1304,15,2460,3.892.440.476
05/02/2018 03:00,30.92,52654,939,42,98,1232,14,2325,3.892.440.476
05/02/2018 04:00,31.54,53632,838,41,97,1135,17,2128,3.892.440.476
05/02/2018 05:00,34.67,56451,714,41,108,1081,15,1959,3.892.440.476
05/02/2018 06:00,41.52,61436,622,42,120,1020,14,1818,3.892.440.476
05/02/2018 07:00,65.03,65844,560,41,126,953,14,1694,3.892.440.476
05/02/2018 08:00,74.98,66999,546,37,126,855,14,1578,3.892.440.476
05/02/2018 09:00,74.91,66563,495,31,127,776,15,1444,3.892.440.476
05/02/2018 10:00,60.44,66136,381,28,121,671,19,1220,3.892.440.476
05/02/2018 11:00,50.37,65229,283,26,110,622,24,1065,3.892.440.476
05/02/2018 12:00,47.62,64145,227,26,107,576,26,962,3.892.440.476
05/02/2018 13:00,47.61,63468,186,26,101,520,28,861,3.892.440.476
05/02/2018 14:00,47.62,63126,159,26,96,502,28,811,3.892.440.476
05/02/2018 15:00,48.04,63172,139,26,86,502,28,781,3.892.440.476
05/02/2018 16:00,55.13,64421,130,25,86,538,27,806,3.892.440.476
05/02/2018 17:00,75.09,65958,138,24,81,549,26,818,3.892.440.476
05/02/2018 18:00,70.05,65775,153,24,81,585,26,869,3.892.440.476
05/02/2018 19:00,50.06,64580,168,24,75,594,23,884,3.892.440.476
05/02/2018 20:00,46.71,62702,152,24,65,572,15,828,3.892.440.476
05/02/2018 21:00,38.76,61206,150,23,59,578,11,821,3.892.440.476
05/02/2018 22:00,37.8,59030,143,22,53,533,9,760,3.892.440.476
05/02/2018 23:00,34.9,56546,120,20,43,508,7,698,3.892.440.476
06/02/2018 00:00,35.81,55086,136,134,31,514,7,822,3.892.440.476
06/02/2018 01:00,34.52,53937,162,137,25,503,6,833,3.892.440.476
06/02/2018 02:00,34.25,53657,158,136,25,479,5,803,3.892.440.476
06/02/2018 03:00,34.6,53963,155,138,27,506,4,830,3.892.440.476
06/02/2018 04:00,35.88,55068,154,136,28,493,4,815,3.892.440.476
06/02/2018 05:00,35.85,57433,162,138,28,494,3,825,3.892.440.476
06/02/2018 06:00,41.42,61853,165,139,26,521,3,854,3.892.440.476
06/02/2018 07:00,55.43,66060,173,140,28,571,3,915,3.892.440.476
06/02/2018 08:00,64.2,67018,191,143,34,588,3,959,3.892.440.476
06/02/2018 09:00,60.5,66577,248,145,44,627,3,1067,3.892.440.476
06/02/2018 10:00,58.01,66072,264,147,67,699,3,1180,3.892.440.476
06/02/2018 11:00,48.27,65416,224,146,84,762,3,1219,3.892.440.476
06/02/2018 12:00,44.08,64770,207,144,118,811,4,1284,3.892.440.476
06/02/2018 13:00,44.59,64362,216,141,150,869,5,1381,3.892.440.476
06/02/2018 14:00,46.92,64149,209,137,182,968,6,1502,3.892.440.476
06/02/2018 15:00,48.1,64293,223,133,210,980,7,1553,3.892.440.476
06/02/2018 16:00,49.94,65513,251,128,218,984,6,1587,3.892.440.476
06/02/2018 17:00,58.06,66562,284,122,203,1010,6,1625,3.892.440.476
06/02/2018 18:00,64.54,66265,308,117,185,963,6,1579,3.892.440.476
06/02/2018 19:00,55.41,64922,359,110,180,895,7,1551,3.892.440.476
06/02/2018 20:00,44.21,63041,394,103,178,847,8,1530,3.892.440.476
06/02/2018 21:00,39.91,61538,451,94,172,731,9,1457,3.892.440.476
06/02/2018 22:00,36.54,59089,494,86,167,636,11,1394,3.892.440.476
06/02/2018 23:00,33.7,56294,501,75,176,578,11,1341,3.892.440.476
07/02/2018 00:00,33.08,54113,788,64,219,587,10,1668,3.892.440.476
07/02/2018 01:00,32.88,52935,825,58,231,582,11,1707,3.892.440.476
07/02/2018 02:00,32.62,52512,713,52,233,605,11,1614,3.892.440.476
07/02/2018 03:00,32.83,52701,665,46,232,636,11,1590,3.892.440.476
07/02/2018 04:00,33.07,53813,650,42,221,646,10,1569,3.892.440.476
07/02/2018 05:00,33.98,56379,623,37,203,651,9,1523,3.892.440.476
07/02/2018 06:00,40.75,60744,649,32,189,670,9,1549,3.892.440.476
07/02/2018 07:00,55.49,64891,697,24,167,677,9,1574,3.892.440.476
07/02/2018 08:00,58.43,65653,743,17,142,698,9,1609,3.892.440.476
07/02/2018 09:00,56.53,65209,734,14,124,695,9,1576,3.892.440.476
07/02/2018 10:00,56.81,64723,714,12,106,669,9,1510,3.892.440.476
07/02/2018 11:00,45.98,64156,734,11,96,633,10,1484,3.892.440.476
07/02/2018 12:00,42.7,63398,844,10,85,679,8,1626,3.892.440.476
07/02/2018 13:00,49,62893,872,10,71,685,9,1647,3.892.440.476
07/02/2018 14:00,48,62689,878,11,60,695,10,1654,3.892.440.476
07/02/2018 15:00,48.08,62806,847,13,57,769,11,1697,3.892.440.476
07/02/2018 16:00,54.89,63800,812,17,63,864,10,1766,3.892.440.476
07/02/2018 17:00,60.31,65146,803,21,77,1001,10,1912,3.892.440.476
07/02/2018 18:00,57.5,64826,793,24,87,1096,9,2009,3.892.440.476
07/02/2018 19:00,48.12,63644,798,26,92,1150,11,2077,3.892.440.476
07/02/2018 20:00,41.16,61711,773,29,83,1206,10,2101,3.892.440.476
07/02/2018 21:00,39.69,60332,753,29,77,1271,11,2141,3.892.440.476
07/02/2018 22:00,35.16,58135,714,31,70,1270,10,2095,3.892.440.476
07/02/2018 23:00,32.74,55314,675,34,57,1260,9,2035,3.892.440.476
08/02/2018 00:00,33.19,53034,787,43,40,1233,6,2109,3.892.440.476
08/02/2018 01:00,32.92,51937,836,48,39,1245,6,2174,3.892.440.476
08/02/2018 02:00,32.54,51530,855,52,39,1285,5,2236,3.892.440.476
08/02/2018 03:00,32.31,51603,897,57,41,1333,5,2333,3.892.440.476
08/02/2018 04:00,33.07,52460,904,59,41,1393,5,2402,3.892.440.476
08/02/2018 05:00,34.08,54784,897,59,39,1399,5,2399,3.892.440.476
08/02/2018 06:00,38.45,58875,936,63,38,1455,5,2497,3.892.440.476
08/02/2018 07:00,51.51,62850,966,64,30,1593,5,2658,3.892.440.476
08/02/2018 08:00,59.94,63773,965,63,24,1588,5,2645,3.892.440.476
08/02/2018 09:00,56.31,63384,980,61,15,1679,4,2739,3.892.440.476
08/02/2018 10:00,49.07,63111,1055,62,11,1714,4,2846,3.892.440.476
08/02/2018 11:00,40.35,62560,1213,72,10,1739,3,3037,3.892.440.476
08/02/2018 12:00,36.97,61803,1388,81,10,1767,3,3249,3.892.440.476
08/02/2018 13:00,36.52,61253,1460,89,10,1737,3,3299,3.892.440.476
08/02/2018 14:00,36.11,60956,1525,89,11,1811,3,3439,3.892.440.476
08/02/2018 15:00,36.34,60927,1541,83,15,1904,3,3546,3.892.440.476
08/02/2018 16:00,38.85,61858,1532,85,21,2035,3,3676,3.892.440.476
08/02/2018 17:00,48.08,63059,1506,81,28,2140,3,3758,3.892.440.476
08/02/2018 18:00,41.2,62808,1454,80,35,2213,3,3785,3.892.440.476
08/02/2018 19:00,36.15,61713,1519,84,38,2296,4,3941,3.892.440.476
08/02/2018 20:00,33.98,59839,1612,89,34,2253,4,3992,3.892.440.476
08/02/2018 21:00,32.8,58341,1663,94,29,2192,4,3982,3.892.440.476
08/02/2018 22:00,31.74,56143,1692,102,25,2181,3,4003,3.892.440.476
08/02/2018 23:00,30.91,53372,1690,105,26,2112,3,3936,3.892.440.476
09/02/2018 00:00,31.04,51252,2360,103,14,2250,4,4731,3.892.440.476
09/02/2018 01:00,30.67,50238,2379,106,14,2260,4,4763,3.892.440.476
09/02/2018 02:00,30.34,49948,2408,105,16,2280,4,4813,3.892.440.476
09/02/2018 03:00,30.42,50158,2368,101,22,2344,3,4838,3.892.440.476
09/02/2018 04:00,30.62,51036,2401,101,25,2350,3,4880,3.892.440.476
09/02/2018 05:00,31.56,53463,2481,97,25,2352,3,4958,3.892.440.476
09/02/2018 06:00,32.3,57786,2510,93,23,2494,3,5123,3.892.440.476
09/02/2018 07:00,34.39,61945,2524,91,21,2503,3,5142,3.892.440.476
09/02/2018 08:00,35.33,63145,2520,86,18,2466,3,5093,3.892.440.476
09/02/2018 09:00,34.94,63040,2482,84,15,2419,3,5003,3.892.440.476
09/02/2018 10:00,34.39,62721,2620,80,12,2293,3,5008,3.892.440.476
09/02/2018 11:00,33.13,61858,2569,73,10,2334,3,4989,3.892.440.476
09/02/2018 12:00,32.64,60733,2470,63,11,2307,3,4854,3.892.440.476
09/02/2018 13:00,32.46,59722,2258,54,12,2364,3,4691,3.892.440.476
09/02/2018 14:00,32.61,59125,2125,50,17,2300,3,4495,3.892.440.476
09/02/2018 15:00,32.6,59120,2114,50,23,2357,3,4547,3.892.440.476
09/02/2018 16:00,33.07,60106,2115,52,35,2471,3,4676,3.892.440.476
09/02/2018 17:00,35.74,61452,2120,53,55,2575,3,4806,3.892.440.476
09/02/2018 18:00,36.06,61463,2097,53,72,2686,3,4911,3.892.440.476
09/02/2018 19:00,33.01,60020,2048,52,72,2694,3,4869,3.892.440.476
09/02/2018 20:00,31.98,57870,1843,49,60,2642,3,4597,3.892.440.476
09/02/2018 21:00,31.83,56247,1552,46,50,2610,4,4262,3.892.440.476
09/02/2018 22:00,31.55,54355,1282,42,42,2511,4,3881,3.892.440.476
09/02/2018 23:00,31.17,52156,1046,37,35,2417,4,3539,3.892.440.476
10/02/2018 00:00,31.49,50684,1139,8,13,2448,4,3612,3.892.440.476
10/02/2018 01:00,31.23,49623,969,8,10,2302,4,3293,3.892.440.476
10/02/2018 02:00,31.05,49128,939,7,9,2257,4,3216,3.892.440.476
10/02/2018 03:00,31.1,49059,912,7,10,2185,4,3118,3.892.440.476
10/02/2018 04:00,31.37,49410,905,8,11,2166,4,3094,3.892.440.476
10/02/2018 05:00,31.69,50233,906,9,12,2097,5,3029,3.892.440.476
10/02/2018 06:00,31.7,51407,894,9,11,2129,5,3048,3.892.440.476
10/02/2018 07:00,31.37,53092,949,9,8,2160,4,3130,3.892.440.476
10/02/2018 08:00,31.76,54791,962,9,5,2134,4,3114,3.892.440.476
10/02/2018 09:00,32.49,56349,963,10,5,2127,4,3109,3.892.440.476
10/02/2018 10:00,33.12,57149,962,12,3,2097,5,3079,3.892.440.476
10/02/2018 11:00,32.96,56947,921,16,2,2001,4,2944,3.892.440.476
10/02/2018 12:00,32.44,56338,847,20,3,1954,3,2827,3.892.440.476
10/02/2018 13:00,32.17,55703,800,26,2,1885,3,2716,3.892.440.476
10/02/2018 14:00,31.95,55451,818,34,1,1845,3,2701,3.892.440.476
10/02/2018 15:00,32.29,55811,895,43,2,1794,3,2737,3.892.440.476
10/02/2018 16:00,33.22,57371,957,49,3,1883,3,2895,3.892.440.476
10/02/2018 17:00,35.86,59098,1015,54,4,2034,5,3112,3.892.440.476
10/02/2018 18:00,35.59,59001,1189,59,3,2175,5,3431,3.892.440.476
10/02/2018 19:00,32.96,57440,1363,63,2,2237,5,3670,3.892.440.476
10/02/2018 20:00,32.04,55667,1594,67,3,2285,3,3952,3.892.440.476
10/02/2018 21:00,31.86,54454,1709,71,4,2306,3,4093,3.892.440.476
10/02/2018 22:00,31.55,53083,1765,74,4,2322,3,4168,3.892.440.476
10/02/2018 23:00,29.96,51489,1855,75,6,2260,3,4199,3.892.440.476
11/02/2018 00:00,29.53,49519,2445,73,6,2316,3,4843,3.892.440.476
11/02/2018 01:00,29.27,48560,2545,79,7,2316,3,4950,3.892.440.476
11/02/2018 02:00,28.83,48165,2766,86,9,2354,3,5218,3.892.440.476
11/02/2018 03:00,28.55,47931,2996,93,18,2317,3,5427,3.892.440.476
11/02/2018 04:00,28.64,48123,3258,97,20,2346,3,5724,3.892.440.476
11/02/2018 05:00,28.53,48758,3578,102,25,2341,4,6050,3.892.440.476
11/02/2018 06:00,28.38,49606,3832,106,30,2418,4,6390,3.892.440.476
11/02/2018 07:00,28.49,50604,4144,108,33,2490,4,6779,3.892.440.476
11/02/2018 08:00,29.03,52089,4258,111,33,2568,4,6974,3.892.440.476
11/02/2018 09:00,29.42,53572,4216,114,33,2551,4,6918,3.892.440.476
11/02/2018 10:00,29.46,54492,4311,122,37,2552,5,7027,3.892.440.476
11/02/2018 11:00,29.95,54784,4265,122,40,2653,7,7087,3.892.440.476
11/02/2018 12:00,29.81,54678,4282,120,42,2755,8,7207,3.892.440.476
11/02/2018 13:00,29.63,54226,4351,123,50,2791,8,7323,3.892.440.476
11/02/2018 14:00,29.47,54300,4285,125,62,2824,8,7304,3.892.440.476
11/02/2018 15:00,29.85,54808,4186,126,81,2902,7,7302,3.892.440.476
11/02/2018 16:00,30.26,56438,3938,127,99,2966,7,7137,3.892.440.476
11/02/2018 17:00,30.81,57951,3929,128,128,3119,7,7311,3.892.440.476
11/02/2018 18:00,31.29,58075,3853,130,160,3194,9,7346,3.892.440.476
11/02/2018 19:00,30.97,56929,3728,130,188,3249,10,7305,3.892.440.476
11/02/2018 20:00,30.1,55492,3884,130,200,3238,10,7462,3.892.440.476
11/02/2018 21:00,29.53,54383,3825,128,209,3258,12,7432,3.892.440.476
11/02/2018 22:00,29.35,52736,3586,130,217,3228,12,7173,3.892.440.476
11/02/2018 23:00,28.87,50925,3630,127,216,3212,12,7197,3.892.440.476
12/02/2018 00:00,28.73,49199,4494,29,183,2991,12,7709,3.624.107.143
12/02/2018 01:00,28.44,48323,4455,27,183,3018,13,7696,3.624.107.143
12/02/2018 02:00,28.41,48039,4527,27,186,3055,13,7808,3.624.107.143
12/02/2018 03:00,28.71,48224,4417,27,179,3087,13,7723,3.624.107.143
12/02/2018 04:00,28.81,49112,4345,24,179,3141,13,7702,3.624.107.143
12/02/2018 05:00,29.45,51599,4384,23,170,3218,14,7809,3.624.107.143
12/02/2018 06:00,30.86,55927,4280,22,162,3234,14,7712,3.624.107.143
12/02/2018 07:00,32.63,59995,4376,21,150,3250,14,7811,3.624.107.143
12/02/2018 08:00,33.12,61178,4352,17,140,3210,14,7733,3.624.107.143
12/02/2018 09:00,33.35,61255,4321,12,124,3200,16,7673,3.624.107.143
12/02/2018 10:00,33.25,61289,4512,8,115,3226,16,7877,3.624.107.143
12/02/2018 11:00,32.5,60974,4536,6,102,3209,15,7868,3.624.107.143
12/02/2018 12:00,31.87,60324,4432,4,85,3155,16,7692,3.624.107.143
12/02/2018 13:00,32.11,59911,4294,5,75,3118,14,7506,3.624.107.143
12/02/2018 14:00,32.06,59839,4088,5,70,3048,13,7224,3.624.107.143
12/02/2018 15:00,32.37,59909,3816,7,62,3071,12,6968,3.624.107.143
12/02/2018 16:00,33.12,60555,3491,10,54,3122,12,6689,3.624.107.143
12/02/2018 17:00,39.34,61733,3231,14,53,3067,12,6377,3.624.107.143
12/02/2018 18:00,39.35,61645,2878,18,50,3042,13,6001,3.624.107.143
12/02/2018 19:00,34.22,60340,2549,20,44,2960,11,5584,3.624.107.143
12/02/2018 20:00,32.55,58297,2483,20,48,2816,12,5379,3.624.107.143
12/02/2018 21:00,31.94,56792,2301,20,47,2762,11,5141,3.624.107.143
12/02/2018 22:00,31.16,54551,2133,18,44,2604,8,4807,3.624.107.143
12/02/2018 23:00,31.02,51920,2025,18,40,2441,8,4532,3.624.107.143
13/02/2018 00:00,30.8,49763,1971,45,99,2440,16,4571,3.624.107.143
13/02/2018 01:00,30.58,48661,1796,50,99,2289,15,4249,3.624.107.143
13/02/2018 02:00,30.51,48457,1685,56,94,2132,16,3983,3.624.107.143
13/02/2018 03:00,30.79,48780,1485,60,93,2062,15,3715,3.624.107.143
13/02/2018 04:00,31.09,49756,1345,65,85,1942,15,3452,3.624.107.143
13/02/2018 05:00,32.6,52306,1291,71,74,1855,12,3303,3.624.107.143
13/02/2018 06:00,36.53,56532,1287,80,66,1734,10,3177,3.624.107.143
13/02/2018 07:00,45.01,60572,1426,90,51,1618,9,3194,3.624.107.143
13/02/2018 08:00,44.65,61546,1495,99,34,1487,7,3122,3.624.107.143
13/02/2018 09:00,43.32,61339,1528,106,24,1421,9,3088,3.624.107.143
13/02/2018 10:00,41.02,61228,1575,110,18,1308,7,3018,3.624.107.143
13/02/2018 11:00,36.44,60798,1503,113,15,1143,5,2779,3.624.107.143
13/02/2018 12:00,34.23,60193,1420,113,13,1038,6,2590,3.624.107.143
13/02/2018 13:00,33.95,59691,1421,117,12,902,6,2458,3.624.107.143
13/02/2018 14:00,35.35,59366,1361,120,10,824,6,2321,3.624.107.143
13/02/2018 15:00,35.84,59309,1244,125,9,765,5,2148,3.624.107.143
13/02/2018 16:00,40.22,60032,1225,130,8,783,6,2152,3.624.107.143
13/02/2018 17:00,48.06,61258,1279,133,8,836,7,2263,3.624.107.143
13/02/2018 18:00,48.09,61369,1385,134,9,880,7,2415,3.624.107.143
13/02/2018 19:00,39.26,60291,1464,133,10,894,7,2508,3.624.107.143
13/02/2018 20:00,33.87,58588,1581,130,9,858,4,2582,3.624.107.143
13/02/2018 21:00,33.09,57022,1604,124,9,860,4,2601,3.624.107.143
13/02/2018 22:00,32.15,54645,1541,118,9,887,4,2559,3.624.107.143
13/02/2018 23:00,31.14,51986,1545,111,9,886,4,2555,3.624.107.143
14/02/2018 00:00,32.06,49742,1197,122,6,744,4,2073,3.624.107.143
14/02/2018 01:00,31.71,48753,1097,124,8,759,4,1992,3.624.107.143
14/02/2018 02:00,31.52,48473,1037,130,11,884,3,2065,3.624.107.143
14/02/2018 03:00,31.59,48644,935,135,14,938,3,2025,3.624.107.143
14/02/2018 04:00,32.43,49436,929,137,16,1015,3,2100,3.624.107.143
14/02/2018 05:00,33.56,51811,985,136,16,1102,3,2242,3.624.107.143
14/02/2018 06:00,35.53,55874,1058,131,15,1243,3,2450,3.624.107.143
14/02/2018 07:00,44.05,59829,1169,124,13,1425,3,2734,3.624.107.143
14/02/2018 08:00,48.1,60682,1164,117,9,1490,3,2783,3.624.107.143
14/02/2018 09:00,45.46,60462,1149,108,6,1495,5,2763,3.624.107.143
14/02/2018 10:00,40.04,60122,1280,99,6,1565,4,2954,3.624.107.143
14/02/2018 11:00,36.87,59440,1471,91,6,1576,4,3148,3.624.107.143
14/02/2018 12:00,35.29,58533,1687,85,5,1602,3,3382,3.624.107.143
14/02/2018 13:00,34.22,58109,1825,78,6,1625,3,3537,3.624.107.143
14/02/2018 14:00,34.83,57976,1922,71,6,1561,4,3564,3.624.107.143
14/02/2018 15:00,34.35,57917,1999,66,8,1567,4,3644,3.624.107.143
14/02/2018 16:00,35.28,58692,2055,63,11,1633,5,3767,3.624.107.143
14/02/2018 17:00,38.9,60075,2221,61,15,1863,6,4166,3.624.107.143
14/02/2018 18:00,39.09,60356,2517,59,18,2005,6,4605,3.624.107.143
14/02/2018 19:00,34.03,59503,2734,57,20,2168,6,4985,3.624.107.143
14/02/2018 20:00,32.87,57884,3020,53,21,2304,4,5402,3.624.107.143
14/02/2018 21:00,32.57,56459,3172,49,21,2392,4,5638,3.624.107.143
14/02/2018 22:00,31.17,54420,3275,44,21,2541,4,5885,3.624.107.143
14/02/2018 23:00,29.74,52066,3442,39,21,2669,4,6175,3.624.107.143
15/02/2018 00:00,30.13,49819,3885,28,26,2991,4,6934,3.624.107.143
15/02/2018 01:00,30.03,48919,3966,26,26,3098,4,7120,3.624.107.143
15/02/2018 02:00,30.04,48719,4103,23,27,3148,4,7305,3.624.107.143
15/02/2018 03:00,29.66,48889,4079,21,29,3186,3,7318,3.624.107.143
15/02/2018 04:00,30.08,49720,4105,20,31,3201,3,7360,3.624.107.143
15/02/2018 05:00,30.93,51991,4238,19,36,3285,3,7581,3.624.107.143
15/02/2018 06:00,31.56,55838,4212,18,37,3403,3,7673,3.624.107.143
15/02/2018 07:00,33.07,59561,4279,16,34,3452,3,7784,3.624.107.143
15/02/2018 08:00,34.56,60622,4247,13,26,3411,3,7700,3.624.107.143
15/02/2018 09:00,33.79,60306,4254,10,21,3499,6,7790,3.624.107.143
15/02/2018 10:00,33.02,60099,4412,7,19,3645,4,8087,3.624.107.143
15/02/2018 11:00,32.89,59662,4487,5,18,3716,4,8230,3.624.107.143
15/02/2018 12:00,32.84,59014,4410,4,18,3823,4,8259,3.624.107.143
15/02/2018 13:00,33.1,58644,4290,4,18,3851,4,8167,3.624.107.143
15/02/2018 14:00,33.38,58532,4094,5,22,3775,5,7901,3.624.107.143
15/02/2018 15:00,33.61,58610,3881,6,27,3652,5,7571,3.624.107.143
15/02/2018 16:00,34.44,59281,3716,9,48,3795,5,7573,3.624.107.143
15/02/2018 17:00,36.55,60591,3469,13,83,3882,6,7453,3.624.107.143
15/02/2018 18:00,38.2,60595,3116,17,120,3944,7,7204,3.624.107.143
15/02/2018 19:00,35.61,59520,2667,19,133,3993,5,6817,3.624.107.143
15/02/2018 20:00,33.93,57842,2381,18,137,3942,6,6484,3.624.107.143
15/02/2018 21:00,33.98,56415,2125,18,147,3844,7,6141,3.624.107.143
15/02/2018 22:00,33.09,54349,2006,18,147,3734,8,5913,3.624.107.143
15/02/2018 23:00,32.22,51951,1911,17,145,3442,8,5523,3.624.107.143
16/02/2018 00:00,32.04,49852,1765,12,129,3206,6,5118,3.624.107.143
16/02/2018 01:00,31.84,48871,1689,12,129,2888,6,4724,3.624.107.143
16/02/2018 02:00,31.76,48542,1753,12,129,2613,7,4514,3.624.107.143
16/02/2018 03:00,31.49,48644,1695,13,130,2390,7,4235,3.624.107.143
16/02/2018 04:00,31.97,49398,1718,15,135,2188,7,4063,3.624.107.143
16/02/2018 05:00,33.07,51683,1865,18,142,2015,7,4047,3.624.107.143
16/02/2018 06:00,35.38,55707,1988,20,152,1908,6,4074,3.624.107.143
16/02/2018 07:00,39.79,59440,2152,21,151,1748,7,4079,3.624.107.143
16/02/2018 08:00,41.1,60700,2360,19,138,1545,6,4068,3.624.107.143
16/02/2018 09:00,41.65,60667,2554,16,124,1417,8,4119,3.624.107.143
16/02/2018 10:00,41.62,60495,2723,13,112,1350,7,4205,3.624.107.143
16/02/2018 11:00,38.75,59969,2791,11,99,1247,7,4155,3.624.107.143
16/02/2018 12:00,35.13,59138,2758,10,85,1147,8,4008,3.624.107.143
16/02/2018 13:00,35.12,58442,2689,11,73,1077,7,3857,3.624.107.143
16/02/2018 14:00,34.82,58020,2599,13,67,1035,7,3721,3.624.107.143
16/02/2018 15:00,35.05,57635,2388,17,67,1008,7,3487,3.624.107.143
16/02/2018 16:00,36.71,58123,2161,21,67,1066,7,3322,3.624.107.143
16/02/2018 17:00,45.95,59321,1966,25,70,1100,8,3169,3.624.107.143
16/02/2018 18:00,48.78,59295,1714,29,72,1088,8,2911,3.624.107.143
16/02/2018 19:00,39.11,58023,1527,31,91,1089,6,2744,3.624.107.143
16/02/2018 20:00,35.84,56071,1473,30,122,1034,6,2665,3.624.107.143
16/02/2018 21:00,34.97,54522,1317,28,145,967,6,2463,3.624.107.143
16/02/2018 22:00,33.59,52811,1107,28,160,891,6,2192,3.624.107.143
16/02/2018 23:00,32.97,50901,1032,27,169,843,6,2077,3.624.107.143
17/02/2018 00:00,34.67,49043,838,11,0,780,4,1633,3.624.107.143
17/02/2018 01:00,33.97,48024,765,12,0,717,4,1498,3.624.107.143
17/02/2018 02:00,33.97,47558,670,16,0,640,3,1329,3.624.107.143
17/02/2018 03:00,33.61,47460,569,20,0,575,3,1167,3.624.107.143
17/02/2018 04:00,33.62,47810,491,23,0,533,3,1050,3.624.107.143
17/02/2018 05:00,33.86,48626,360,27,0,471,3,861,3.624.107.143
17/02/2018 06:00,34.59,49718,255,31,0,433,3,722,3.624.107.143
17/02/2018 07:00,35.49,51154,211,28,0,397,3,639,3.624.107.143
17/02/2018 08:00,36.9,52967,209,24,0,360,3,596,3.624.107.143
17/02/2018 09:00,40.66,54515,207,20,0,323,5,555,3.624.107.143
17/02/2018 10:00,44.6,55340,210,14,0,289,4,517,3.624.107.143
17/02/2018 11:00,42.4,55258,223,10,0,251,4,488,3.624.107.143
17/02/2018 12:00,40.64,54612,198,8,0,207,5,418,3.624.107.143
17/02/2018 13:00,38.01,53943,189,9,0,184,3,385,3.624.107.143
17/02/2018 14:00,35.97,53743,214,9,0,173,3,399,3.624.107.143
17/02/2018 15:00,35.91,53897,236,9,0,172,3,420,3.624.107.143
17/02/2018 16:00,37.99,55192,218,9,0,171,3,401,3.624.107.143
17/02/2018 17:00,44.83,56975,184,9,0,193,5,391,3.624.107.143
17/02/2018 18:00,49.61,57321,185,10,0,225,5,425,3.624.107.143
17/02/2018 19:00,47.31,56094,212,10,0,240,5,467,3.624.107.143
17/02/2018 20:00,39,54516,287,9,0,254,4,554,3.624.107.143
17/02/2018 21:00,37.7,53431,343,9,0,273,4,629,3.624.107.143
17/02/2018 22:00,35.86,52161,363,8,0,274,4,649,3.624.107.143
17/02/2018 23:00,34.89,50643,415,7,0,293,4,719,3.624.107.143
18/02/2018 00:00,34.91,49067,521,5,61,276,2,865,3.624.107.143
18/02/2018 01:00,34.82,48175,586,6,67,279,3,941,3.624.107.143
18/02/2018 02:00,33.98,47757,656,6,72,317,3,1054,3.624.107.143
18/02/2018 03:00,33.89,47657,683,7,76,359,3,1128,3.624.107.143
18/02/2018 04:00,33.83,47833,686,7,79,382,2,1156,3.624.107.143
18/02/2018 05:00,33.99,48361,742,9,74,403,2,1230,3.624.107.143
18/02/2018 06:00,33.51,49062,845,10,74,424,3,1356,3.624.107.143
18/02/2018 07:00,33.56,50067,969,12,63,429,2,1475,3.624.107.143
18/02/2018 08:00,34.23,51486,1085,13,47,426,1,1572,3.624.107.143
18/02/2018 09:00,35.42,52892,1216,13,33,432,1,1695,3.624.107.143
18/02/2018 10:00,35.75,53771,1377,13,30,449,1,1870,3.624.107.143
18/02/2018 11:00,35.97,53974,1529,13,35,501,1,2079,3.624.107.143
18/02/2018 12:00,34.71,53694,1586,14,42,519,1,2162,3.624.107.143
18/02/2018 13:00,35,53303,1591,14,47,530,1,2183,3.624.107.143
18/02/2018 14:00,34.38,53205,1500,16,47,522,1,2086,3.624.107.143
18/02/2018 15:00,34.94,53413,1412,21,46,505,1,1985,3.624.107.143
18/02/2018 16:00,36.24,54601,1333,27,45,506,1,1912,3.624.107.143
18/02/2018 17:00,41.35,56288,1231,33,43,566,4,1877,3.624.107.143
18/02/2018 18:00,47.45,56843,1103,37,41,600,4,1785,3.624.107.143
18/02/2018 19:00,44.04,55922,1039,41,36,585,4,1705,3.624.107.143
18/02/2018 20:00,40,54503,1043,42,30,602,3,1720,3.624.107.143
18/02/2018 21:00,36.96,53521,992,43,27,586,2,1650,3.624.107.143
18/02/2018 22:00,35.36,51927,918,44,27,546,2,1537,3.624.107.143
18/02/2018 23:00,33.77,50054,761,44,30,514,2,1351,3.624.107.143
19/02/2018 00:00,33.75,48940,643,23,0,515,1,1182,333.202.381
19/02/2018 01:00,33.55,48143,530,24,0,470,1,1025,333.202.381
19/02/2018 02:00,33.77,47985,460,25,0,422,1,908,333.202.381
19/02/2018 03:00,33.93,48315,395,28,0,403,1,827,333.202.381
19/02/2018 04:00,35.1,49657,330,32,0,392,1,755,333.202.381
19/02/2018 05:00,39.58,52174,243,34,0,405,1,683,333.202.381
19/02/2018 06:00,45.47,56490,219,36,0,434,1,690,333.202.381
19/02/2018 07:00,56.11,60481,220,35,0,451,1,707,333.202.381
19/02/2018 08:00,61.59,61370,194,33,0,464,1,692,333.202.381
19/02/2018 09:00,66.53,61232,162,31,0,498,3,694,333.202.381
19/02/2018 10:00,64.83,61178,146,29,0,539,2,716,333.202.381
19/02/2018 11:00,57.33,60793,140,26,0,604,2,772,333.202.381
19/02/2018 12:00,53.64,60209,142,23,0,686,3,854,333.202.381
19/02/2018 13:00,51.98,59896,147,22,0,752,2,923,333.202.381
19/02/2018 14:00,52.68,59774,186,22,0,818,2,1028,333.202.381
19/02/2018 15:00,49.23,59759,252,22,0,885,2,1161,333.202.381
19/02/2018 16:00,49.13,60293,327,24,0,966,2,1319,333.202.381
19/02/2018 17:00,60.09,61592,423,25,0,1058,3,1509,333.202.381
19/02/2018 18:00,66.46,61845,510,25,0,1150,3,1688,333.202.381
19/02/2018 19:00,50.83,60806,637,25,0,1205,3,1870,333.202.381
19/02/2018 20:00,43.49,59198,817,23,0,1163,2,2005,333.202.381
19/02/2018 21:00,40.75,57567,858,23,0,1138,2,2021,333.202.381
19/02/2018 22:00,38.12,55340,898,22,0,1107,1,2028,333.202.381
19/02/2018 23:00,35.77,52909,1019,22,0,1067,1,2109,333.202.381
20/02/2018 00:00,37.27,51235,788,12,11,1023,1,1835,333.202.381
20/02/2018 01:00,36.43,50383,810,11,12,960,1,1794,333.202.381
20/02/2018 02:00,36.06,50258,793,11,13,915,1,1733,333.202.381
20/02/2018 03:00,35.65,50543,782,12,20,884,1,1699,333.202.381
20/02/2018 04:00,36.79,52009,794,12,23,836,2,1667,333.202.381
20/02/2018 05:00,42.6,54646,857,14,24,789,2,1686,333.202.381
20/02/2018 06:00,49.02,58997,859,15,24,757,2,1657,333.202.381
20/02/2018 07:00,61.08,62993,889,15,24,698,2,1628,333.202.381
20/02/2018 08:00,60.1,63782,897,13,19,605,2,1536,333.202.381
20/02/2018 09:00,60.09,63678,948,11,17,565,4,1545,333.202.381
20/02/2018 10:00,57.14,63326,916,10,15,497,3,1441,333.202.381
20/02/2018 11:00,54.6,62810,860,11,12,408,3,1294,333.202.381
20/02/2018 12:00,54.53,62227,741,11,9,345,4,1110,333.202.381
20/02/2018 13:00,54.6,61797,688,12,9,300,3,1012,333.202.381
20/02/2018 14:00,51.68,61418,672,14,11,278,3,978,333.202.381
20/02/2018 15:00,54.59,61325,683,17,11,261,3,975,333.202.381
20/02/2018 16:00,54.57,61913,636,18,15,264,4,937,333.202.381
20/02/2018 17:00,60.04,63267,553,20,20,284,5,882,333.202.381
20/02/2018 18:00,63.76,63721,461,23,31,313,5,833,333.202.381
20/02/2018 19:00,57.9,62731,418,24,35,310,5,792,333.202.381
20/02/2018 20:00,46.77,61080,397,25,34,293,4,753,333.202.381
20/02/2018 21:00,42.46,59467,337,25,33,278,4,677,333.202.381
20/02/2018 22:00,40.84,57160,287,24,33,262,2,608,333.202.381
20/02/2018 23:00,37.41,54559,247,22,33,234,2,538,333.202.381
21/02/2018 00:00,37.45,52532,230,14,13,162,0,419,333.202.381
21/02/2018 01:00,37.04,51656,206,15,13,159,0,393,333.202.381
21/02/2018 02:00,36.77,51386,172,15,12,156,0,355,333.202.381
21/02/2018 03:00,36.64,51664,160,15,12,160,0,347,333.202.381
21/02/2018 04:00,37.31,53032,155,16,12,168,0,351,333.202.381
21/02/2018 05:00,41.15,55548,153,16,13,186,0,368,333.202.381
21/02/2018 06:00,46.04,59653,163,15,13,200,0,391,333.202.381
21/02/2018 07:00,60.04,63504,164,14,12,193,0,383,333.202.381
21/02/2018 08:00,63.92,64292,162,12,8,178,0,360,333.202.381
21/02/2018 09:00,65.1,63993,144,10,5,186,2,347,333.202.381
21/02/2018 10:00,60.07,63535,158,8,4,221,1,392,333.202.381
21/02/2018 11:00,48.08,63004,171,7,3,243,1,425,333.202.381
21/02/2018 12:00,46.87,62177,153,6,3,252,2,416,333.202.381
21/02/2018 13:00,45.8,61499,122,6,4,288,1,421,333.202.381
21/02/2018 14:00,46.05,61218,107,6,6,312,1,432,333.202.381
21/02/2018 15:00,45.25,61143,113,6,9,349,1,478,333.202.381
21/02/2018 16:00,49.07,61572,109,6,14,399,1,529,333.202.381
21/02/2018 17:00,58.6,63123,101,6,24,487,3,621,333.202.381
21/02/2018 18:00,62.63,63700,108,6,39,584,3,740,333.202.381
21/02/2018 19:00,53.25,62849,121,7,54,643,4,829,333.202.381
21/02/2018 20:00,46.96,61234,126,7,67,662,3,865,333.202.381
21/02/2018 21:00,42.51,59695,129,7,84,693,3,916,333.202.381
21/02/2018 22:00,39.94,57531,115,7,91,678,2,893,333.202.381
21/02/2018 23:00,37.34,55060,109,7,89,638,2,845,333.202.381
22/02/2018 00:00,39.17,53504,294,6,75,553,1,929,333.202.381
22/02/2018 01:00,38.31,52754,300,5,73,524,1,903,333.202.381
22/02/2018 02:00,37.95,52562,334,6,69,468,1,878,333.202.381
22/02/2018 03:00,38.04,52844,310,6,66,447,1,830,333.202.381
22/02/2018 04:00,39.05,54186,290,7,65,410,1,773,333.202.381
22/02/2018 05:00,42.69,56603,302,7,60,385,1,755,333.202.381
22/02/2018 06:00,47.74,60750,274,6,58,364,1,703,333.202.381
22/02/2018 07:00,61.12,64339,258,5,50,328,1,642,333.202.381
22/02/2018 08:00,66.59,65277,255,4,29,267,1,556,333.202.381
22/02/2018 09:00,62.06,64756,289,4,19,225,3,540,333.202.381
22/02/2018 10:00,57.01,64233,293,3,13,179,2,490,333.202.381
22/02/2018 11:00,47.01,63522,285,3,9,164,2,463,333.202.381
22/02/2018 12:00,43.72,62615,272,3,7,136,3,421,333.202.381
22/02/2018 13:00,43.46,61910,247,4,6,128,2,387,333.202.381
22/02/2018 14:00,44.57,61418,242,5,6,141,2,396,333.202.381
22/02/2018 15:00,46.03,61139,247,5,8,190,2,452,333.202.381
22/02/2018 16:00,48.79,61657,267,6,8,209,2,492,333.202.381
22/02/2018 17:00,63.9,63088,256,5,13,273,2,549,333.202.381
22/02/2018 18:00,64.72,63629,252,6,19,346,2,625,333.202.381
22/02/2018 19:00,52.77,62910,257,6,19,384,3,669,333.202.381
22/02/2018 20:00,45.46,61383,290,6,16,421,2,735,333.202.381
22/02/2018 21:00,43.17,59568,325,6,10,428,3,772,333.202.381
22/02/2018 22:00,42.39,57462,348,5,9,477,3,842,333.202.381
22/02/2018 23:00,38.21,54983,370,5,8,557,2,942,333.202.381
23/02/2018 00:00,38.64,53530,324,3,8,553,2,890,333.202.381
23/02/2018 01:00,37.55,52600,304,2,7,602,2,917,333.202.381
23/02/2018 02:00,37.28,52264,274,3,7,653,2,939,333.202.381
23/02/2018 03:00,37.16,52440,246,3,7,673,1,930,333.202.381
23/02/2018 04:00,37.57,53232,230,4,6,697,2,939,333.202.381
23/02/2018 05:00,39.94,55561,205,4,6,680,3,898,333.202.381
23/02/2018 06:00,47.4,59544,183,5,8,686,3,885,333.202.381
23/02/2018 07:00,66.19,63223,181,6,13,632,4,836,333.202.381
23/02/2018 08:00,68.08,64290,154,6,14,585,4,763,333.202.381
23/02/2018 09:00,58.41,63995,145,5,14,464,8,636,333.202.381
23/02/2018 10:00,52.86,63724,145,6,17,438,8,614,333.202.381
23/02/2018 11:00,46.03,63083,154,6,20,406,10,596,333.202.381
23/02/2018 12:00,42.11,62040,154,7,25,429,15,630,333.202.381
23/02/2018 13:00,40.8,61097,134,8,37,410,20,609,333.202.381
23/02/2018 14:00,39.7,60488,107,9,46,444,22,628,333.202.381
23/02/2018 15:00,40,59898,96,12,52,511,22,693,333.202.381
23/02/2018 16:00,43.02,60183,93,16,67,571,25,772,333.202.381
23/02/2018 17:00,49.07,61545,93,21,85,694,29,922,333.202.381
23/02/2018 18:00,49.25,62114,105,29,116,825,29,1104,333.202.381
23/02/2018 19:00,46.69,61126,129,38,129,901,34,1231,333.202.381
23/02/2018 20:00,41.54,59266,170,48,121,964,34,1337,333.202.381
23/02/2018 21:00,38.71,57764,227,57,120,1046,33,1483,333.202.381
23/02/2018 22:00,37.78,56119,254,65,141,1098,33,1591,333.202.381
23/02/2018 23:00,36.05,54314,319,72,176,1129,32,1728,333.202.381
24/02/2018 00:00,37.62,52679,474,18,0,1148,18,1658,333.202.381
24/02/2018 01:00,37.06,51910,548,18,0,1139,16,1721,333.202.381
24/02/2018 02:00,36.83,51621,746,17,0,1113,13,1889,333.202.381
24/02/2018 03:00,36.71,51631,1006,17,0,1094,12,2129,333.202.381
24/02/2018 04:00,36.84,52072,1250,18,0,1099,9,2376,333.202.381
24/02/2018 05:00,36.95,52861,1428,19,0,1108,7,2562,333.202.381
24/02/2018 06:00,37.32,53933,1515,19,0,1092,6,2632,333.202.381
24/02/2018 07:00,37.94,55355,1626,17,0,1042,5,2690,333.202.381
24/02/2018 08:00,37.8,57065,1713,16,0,970,5,2704,333.202.381
24/02/2018 09:00,38.49,58399,1792,15,0,957,5,2769,333.202.381
24/02/2018 10:00,38.7,58803,1799,16,0,907,6,2728,333.202.381
24/02/2018 11:00,38.14,58560,1767,20,0,792,7,2586,333.202.381
24/02/2018 12:00,37.92,57744,1665,29,0,725,5,2424,333.202.381
24/02/2018 13:00,36.93,56995,1556,38,0,691,5,2290,333.202.381
24/02/2018 14:00,36.72,56912,1452,43,0,704,5,2204,333.202.381
24/02/2018 15:00,36.79,57067,1353,43,0,659,4,2059,333.202.381
24/02/2018 16:00,37.72,58052,1303,43,0,666,4,2016,333.202.381
24/02/2018 17:00,40.94,59969,1157,43,0,752,6,1958,333.202.381
24/02/2018 18:00,43.24,60684,944,40,0,850,6,1840,333.202.381
24/02/2018 19:00,40.76,59565,922,37,0,913,6,1878,333.202.381
24/02/2018 20:00,38.81,58029,970,34,0,919,4,1927,333.202.381
24/02/2018 21:00,37.89,56929,908,33,0,968,4,1913,333.202.381
24/02/2018 22:00,37.41,55772,782,32,0,1011,4,1829,333.202.381
24/02/2018 23:00,36.93,54440,609,31,0,979,5,1624,333.202.381
25/02/2018 00:00,37.66,52810,424,29,67,944,5,1469,333.202.381
25/02/2018 01:00,37.51,52066,383,28,58,949,5,1423,333.202.381
25/02/2018 02:00,37.21,51718,336,28,55,960,5,1384,333.202.381
25/02/2018 03:00,36.87,51657,343,26,57,1016,5,1447,333.202.381
25/02/2018 04:00,36.78,51941,341,25,57,1069,5,1497,333.202.381
25/02/2018 05:00,37.19,52494,371,22,62,1166,5,1626,333.202.381
25/02/2018 06:00,37.63,53228,453,20,67,1275,6,1821,333.202.381
25/02/2018 07:00,38.11,54260,587,17,62,1364,5,2035,333.202.381
25/02/2018 08:00,38.43,55670,668,15,48,1372,5,2108,333.202.381
25/02/2018 09:00,39.13,57077,791,12,41,1404,5,2253,333.202.381
25/02/2018 10:00,39.33,57573,921,11,39,1423,5,2399,333.202.381
25/02/2018 11:00,38.93,57578,1100,10,38,1419,6,2573,333.202.381
25/02/2018 12:00,38.27,57176,1201,11,40,1394,5,2651,333.202.381
25/02/2018 13:00,37.41,56837,1314,11,49,1382,5,2761,333.202.381
25/02/2018 14:00,36.6,56740,1481,11,52,1444,5,2993,333.202.381
25/02/2018 15:00,36.68,56939,1735,11,51,1496,4,3297,333.202.381
25/02/2018 16:00,37.39,58034,1945,11,52,1598,4,3610,333.202.381
25/02/2018 17:00,41.77,59850,2006,11,56,1755,5,3833,333.202.381
25/02/2018 18:00,45.77,60927,1927,12,60,1935,5,3939,333.202.381
25/02/2018 19:00,43.38,60168,1935,13,61,2059,5,4073,333.202.381
25/02/2018 20:00,39.91,58924,2115,13,60,2156,3,4347,333.202.381
25/02/2018 21:00,37.98,57919,2085,13,53,2258,4,4413,333.202.381
25/02/2018 22:00,37.77,56292,2033,13,46,2308,4,4404,333.202.381
25/02/2018 23:00,36.48,54665,2017,13,39,2361,3,4433,333.202.381
26/02/2018 00:00,35.96,54068,2023,47,19,2384,5,4478,3.028.988.095
26/02/2018 01:00,36.09,53518,1926,59,19,2399,5,4408,3.028.988.095
26/02/2018 02:00,36.01,53455,1802,65,20,2381,5,4273,3.028.988.095
26/02/2018 03:00,36.02,53767,1721,73,31,2413,5,4243,3.028.988.095
26/02/2018 04:00,36.71,54675,1668,78,36,2450,5,4237,3.028.988.095
26/02/2018 05:00,39.56,57249,1667,76,44,2478,5,4270,3.028.988.095
26/02/2018 06:00,48.01,61687,1713,70,50,2499,6,4338,3.028.988.095
26/02/2018 07:00,69.92,65453,1840,60,40,2436,6,4382,3.028.988.095
26/02/2018 08:00,65.15,66376,1913,53,29,2301,6,4302,3.028.988.095
26/02/2018 09:00,54.59,66002,2016,50,19,2164,5,4254,3.028.988.095
26/02/2018 10:00,48.09,65599,2042,48,16,2004,6,4116,3.028.988.095
26/02/2018 11:00,43.58,64634,1962,50,17,1837,6,3872,3.028.988.095
26/02/2018 12:00,41.79,63811,1902,50,16,1778,7,3753,3.028.988.095
26/02/2018 13:00,41.41,63294,1891,53,15,1794,6,3759,3.028.988.095
26/02/2018 14:00,42,62967,1981,60,15,2035,6,4097,3.028.988.095
26/02/2018 15:00,43.26,62833,2012,70,16,2140,7,4245,3.028.988.095
26/02/2018 16:00,47.01,63139,2068,78,17,2343,7,4513,3.028.988.095
26/02/2018 17:00,55.27,64495,1988,79,20,2614,9,4710,3.028.988.095
26/02/2018 18:00,72.09,65261,1865,84,23,2851,9,4832,3.028.988.095
26/02/2018 19:00,57.7,64540,1843,85,30,3065,10,5033,3.028.988.095
26/02/2018 20:00,46.97,63075,1923,83,35,3179,8,5228,3.028.988.095
26/02/2018 21:00,43.16,61772,1961,82,39,3224,7,5313,3.028.988.095
26/02/2018 22:00,40.11,59757,2019,81,45,3334,7,5486,3.028.988.095
26/02/2018 23:00,38.98,57578,2053,77,56,3383,7,5576,3.028.988.095
27/02/2018 00:00,39.71,54800,2119,66,32,3451,8,5676,3.028.988.095
27/02/2018 01:00,38.27,54038,2112,62,33,3488,9,5704,3.028.988.095
27/02/2018 02:00,37.65,53865,2150,60,46,3552,10,5818,3.028.988.095
27/02/2018 03:00,37.68,54297,2276,58,96,3656,12,6098,3.028.988.095
27/02/2018 04:00,38.67,55600,2393,59,121,3728,14,6315,3.028.988.095
27/02/2018 05:00,41.92,58627,2613,60,145,3923,13,6754,3.028.988.095
27/02/2018 06:00,46.42,62894,2757,61,175,4047,14,7054,3.028.988.095
27/02/2018 07:00,66.1,66939,2986,65,176,3913,14,7154,3.028.988.095
27/02/2018 08:00,57.52,67712,3320,69,171,3900,14,7474,3.028.988.095
27/02/2018 09:00,50.72,67626,3586,73,162,3850,14,7685,3.028.988.095
27/02/2018 10:00,48.07,67189,3692,79,163,3841,15,7790,3.028.988.095
27/02/2018 11:00,43.2,66757,3691,88,165,3842,14,7800,3.028.988.095
27/02/2018 12:00,41.93,66076,3718,96,173,3763,15,7765,3.028.988.095
27/02/2018 13:00,41.9,65676,3828,103,186,3696,15,7828,3.028.988.095
27/02/2018 14:00,42.19,65550,4016,113,196,3607,17,7949,3.028.988.095
27/02/2018 15:00,43.18,65560,4173,119,196,3518,17,8023,3.028.988.095
27/02/2018 16:00,43.9,66316,4278,127,208,3476,17,8106,3.028.988.095
27/02/2018 17:00,52.35,68065,4385,133,239,3465,19,8241,3.028.988.095
27/02/2018 18:00,57.67,68901,4462,137,272,3440,18,8329,3.028.988.095
27/02/2018 19:00,48.03,67968,4493,134,287,3429,18,8361,3.028.988.095
27/02/2018 20:00,42.95,66297,4591,127,287,3419,15,8439,3.028.988.095
27/02/2018 21:00,40.17,64861,4547,122,285,3363,15,8332,3.028.988.095
27/02/2018 22:00,38.74,62816,4389,122,281,3228,14,8034,3.028.988.095
27/02/2018 23:00,37.72,60546,4128,120,273,3028,14,7563,3.028.988.095
28/02/2018 00:00,37.94,58805,3814,105,297,2942,15,7173,3.028.988.095
28/02/2018 01:00,37.66,57981,3681,104,304,2852,14,6955,3.028.988.095
28/02/2018 02:00,37.66,57814,3553,103,306,2800,13,6775,3.028.988.095
28/02/2018 03:00,37.81,58361,3468,103,299,2738,14,6622,3.028.988.095
28/02/2018 04:00,38.06,59157,3353,106,297,2684,14,6454,3.028.988.095
28/02/2018 05:00,40.44,61569,3336,113,296,2659,14,6418,3.028.988.095
28/02/2018 06:00,54.53,65627,3314,122,293,2587,14,6330,3.028.988.095
28/02/2018 07:00,85.08,69253,3424,130,276,2472,22,6324,3.028.988.095
28/02/2018 08:00,81.84,69772,3487,130,249,2390,24,6280,3.028.988.095
28/02/2018 09:00,60.06,69528,3583,128,220,2337,24,6292,3.028.988.095
28/02/2018 10:00,51.3,69054,3611,127,204,2305,24,6271,3.028.988.095
28/02/2018 11:00,46.09,68527,3638,125,205,2281,16,6265,3.028.988.095
28/02/2018 12:00,41.59,67648,3630,127,202,2231,17,6207,3.028.988.095
28/02/2018 13:00,41.18,67106,3659,132,200,2217,15,6223,3.028.988.095
28/02/2018 14:00,41.58,66887,3791,134,204,2186,16,6331,3.028.988.095
28/02/2018 15:00,42.89,66855,3852,139,206,2165,17,6379,3.028.988.095
28/02/2018 16:00,43.31,67269,3933,137,218,2235,17,6540,3.028.988.095
28/02/2018 17:00,55.05,68609,3926,134,245,2281,19,6605,3.028.988.095
28/02/2018 18:00,60.39,69415,3819,131,274,2309,19,6552,3.028.988.095
28/02/2018 19:00,51.08,68752,3799,122,274,2325,19,6539,3.028.988.095
28/02/2018 20:00,40.95,67104,3798,110,265,2277,16,6466,3.028.988.095
28/02/2018 21:00,39.61,65721,3727,102,240,2293,14,6376,3.028.988.095
28/02/2018 22:00,38.61,63560,3674,95,220,2281,13,6283,3.028.988.095
28/02/2018 23:00,37.73,61192,3491,89,188,2238,12,6018,3.028.988.095
01/03/2018 00:00,39.45,59116,3507,83,160,2081,13,5844,3.028.988.095
01/03/2018 01:00,39.02,58132,3328,82,148,2057,11,5626,3.028.988.095
01/03/2018 02:00,38.5,57886,3135,80,141,2085,11,5452,3.028.988.095
01/03/2018 03:00,38.33,58090,3111,80,137,2104,10,5442,3.028.988.095
01/03/2018 04:00,39.53,58973,3141,82,137,2067,9,5436,3.028.988.095
01/03/2018 05:00,43.21,61238,3036,86,136,2020,9,5287,3.028.988.095
01/03/2018 06:00,55.03,64914,3062,87,138,2002,9,5298,3.028.988.095
01/03/2018 07:00,103.47,68300,3235,84,130,1928,25,5402,3.028.988.095
01/03/2018 08:00,198.29,69059,3272,78,113,1784,26,5273,3.028.988.095
01/03/2018 09:00,120.01,68667,3385,74,99,1715,26,5299,3.028.988.095
01/03/2018 10:00,87.38,68211,3403,73,91,1616,26,5209,3.028.988.095
01/03/2018 11:00,76.92,67594,3469,75,89,1575,26,5234,3.028.988.095
01/03/2018 12:00,60,66640,3487,79,86,1562,19,5233,3.028.988.095
01/03/2018 13:00,59.43,65911,3346,83,88,1543,13,5073,3.028.988.095
01/03/2018 14:00,53.03,65492,3384,87,90,1576,15,5152,3.028.988.095
01/03/2018 15:00,55.02,65158,3435,91,90,1601,16,5233,3.028.988.095
01/03/2018 16:00,53.1,65490,3512,96,104,1673,18,5403,3.028.988.095
01/03/2018 17:00,60.56,66920,3485,102,127,1773,24,5511,3.028.988.095
01/03/2018 18:00,98.07,67597,3364,105,149,1849,33,5500,3.028.988.095
01/03/2018 19:00,74.97,66866,3268,105,164,1860,27,5424,3.028.988.095
01/03/2018 20:00,50.64,65269,3335,101,170,1828,19,5453,3.028.988.095
01/03/2018 21:00,45.93,63861,3294,96,173,1777,18,5358,3.028.988.095
01/03/2018 22:00,41.2,61673,3263,89,167,1768,16,5303,3.028.988.095
01/03/2018 23:00,39.09,59224,3084,77,151,1723,15,5050,3.028.988.095
02/03/2018 00:00,39.75,57548,2893,60,129,1900,12,4994,3.028.988.095
02/03/2018 01:00,38.82,56729,2794,56,115,1858,10,4833,3.028.988.095
02/03/2018 02:00,38.67,56522,2668,56,114,1827,9,4674,3.028.988.095
02/03/2018 03:00,39.09,56716,2567,57,117,1815,7,4563,3.028.988.095
02/03/2018 04:00,39.91,57465,2595,61,119,1809,6,4590,3.028.988.095
02/03/2018 05:00,42.15,59591,2661,63,119,1801,5,4649,3.028.988.095
02/03/2018 06:00,55.43,63250,2763,60,121,1806,5,4755,3.028.988.095
02/03/2018 07:00,75.01,66804,2956,56,115,1758,21,4906,3.028.988.095
02/03/2018 08:00,86.3,67714,3079,47,106,1676,13,4921,3.028.988.095
02/03/2018 09:00,82.49,67385,3165,38,99,1641,13,4956,3.028.988.095
02/03/2018 10:00,60.56,66943,3161,36,92,1623,13,4925,3.028.988.095
02/03/2018 11:00,59.41,66251,3108,36,84,1589,5,4822,3.028.988.095
02/03/2018 12:00,51.12,65312,3104,37,79,1548,6,4774,3.028.988.095
02/03/2018 13:00,51.08,64382,3075,40,80,1531,5,4731,3.028.988.095
02/03/2018 14:00,46.61,63760,3195,42,82,1492,5,4816,3.028.988.095
02/03/2018 15:00,45.33,63292,3173,44,83,1447,5,4752,3.028.988.095
02/03/2018 16:00,47.86,63391,3092,50,95,1456,5,4698,3.028.988.095
02/03/2018 17:00,60.52,64807,2947,57,120,1486,6,4616,3.028.988.095
02/03/2018 18:00,80.04,65487,2792,63,146,1504,6,4511,3.028.988.095
02/03/2018 19:00,68.61,64316,2686,67,149,1478,6,4386,3.028.988.095
02/03/2018 20:00,50.09,62401,2665,66,130,1398,4,4263,3.028.988.095
02/03/2018 21:00,45.28,60840,2578,64,106,1434,4,4186,3.028.988.095
02/03/2018 22:00,42.02,59015,2505,61,95,1337,4,4002,3.028.988.095
02/03/2018 23:00,39.81,56985,2340,58,85,1209,4,3696,3.028.988.095
03/03/2018 00:00,41.24,55003,2057,73,131,898,6,3165,3.028.988.095
03/03/2018 01:00,40.12,54125,1873,72,131,827,6,2909,3.028.988.095
03/03/2018 02:00,39.22,53660,1718,66,131,807,6,2728,3.028.988.095
03/03/2018 03:00,39.3,53538,1605,62,131,802,6,2606,3.028.988.095
03/03/2018 04:00,39.32,53769,1582,62,127,779,6,2556,3.028.988.095
03/03/2018 05:00,40.12,54442,1562,60,118,778,6,2524,3.028.988.095
03/03/2018 06:00,41.3,55278,1551,59,112,743,6,2471,3.028.988.095
03/03/2018 07:00,42.36,56569,1687,54,100,721,6,2568,3.028.988.095
03/03/2018 08:00,43.92,58140,1755,49,79,670,6,2559,3.028.988.095
03/03/2018 09:00,48.03,59481,1837,44,66,639,6,2592,3.028.988.095
03/03/2018 10:00,47.47,59908,1926,42,61,594,8,2631,3.028.988.095
03/03/2018 11:00,44.33,59440,1977,43,61,568,8,2657,3.028.988.095
03/03/2018 12:00,41.73,58897,1938,43,66,531,9,2587,3.028.988.095
03/03/2018 13:00,40.58,58295,1778,45,75,481,8,2387,3.028.988.095
03/03/2018 14:00,40.19,57943,1615,47,84,463,9,2218,3.028.988.095
03/03/2018 15:00,39.91,57866,1578,50,77,445,10,2160,3.028.988.095
03/03/2018 16:00,40.85,58636,1598,53,90,417,11,2169,3.028.988.095
03/03/2018 17:00,47.1,60508,1569,57,112,405,12,2155,3.028.988.095
03/03/2018 18:00,54.17,61440,1505,59,137,425,12,2138,3.028.988.095
03/03/2018 19:00,45.06,60291,1524,59,149,442,11,2185,3.028.988.095
03/03/2018 20:00,40.9,58633,1593,55,140,430,8,2226,3.028.988.095
03/03/2018 21:00,39.91,57488,1577,50,137,423,8,2195,3.028.988.095
03/03/2018 22:00,39.04,56215,1580,46,137,407,7,2177,3.028.988.095
03/03/2018 23:00,38.41,54735,1625,40,139,377,7,2188,3.028.988.095
04/03/2018 00:00,40,53327,1569,46,103,297,3,2018,3.028.988.095
04/03/2018 01:00,39.78,52523,1577,45,104,269,3,1998,3.028.988.095
04/03/2018 02:00,39.39,52211,1616,47,115,253,3,2034,3.028.988.095
04/03/2018 03:00,39.25,52046,1628,51,126,259,3,2067,3.028.988.095
04/03/2018 04:00,39.1,52246,1682,54,124,262,3,2125,3.028.988.095
04/03/2018 05:00,39.24,52734,1690,57,111,279,3,2140,3.028.988.095
04/03/2018 06:00,39.64,53380,1703,59,96,296,3,2157,3.028.988.095
04/03/2018 07:00,39.85,54305,1857,56,74,301,3,2291,3.028.988.095
04/03/2018 08:00,41.23,55772,2089,51,53,282,3,2478,3.028.988.095
04/03/2018 09:00,41.17,57091,2384,47,35,285,2,2753,3.028.988.095
04/03/2018 10:00,41.56,57630,2471,46,20,307,3,2847,3.028.988.095
04/03/2018 11:00,41.44,57508,2601,47,16,329,3,2996,3.028.988.095
04/03/2018 12:00,41.22,57024,2653,50,11,345,4,3063,3.028.988.095
04/03/2018 13:00,40.39,56482,2612,53,11,365,3,3044,3.028.988.095
04/03/2018 14:00,40.21,56314,2636,56,11,375,3,3081,3.028.988.095
04/03/2018 15:00,39.46,56397,2580,59,9,408,2,3058,3.028.988.095
04/03/2018 16:00,39.99,57137,2607,64,7,488,4,3170,3.028.988.095
04/03/2018 17:00,42.75,58880,2686,71,7,574,5,3343,3.028.988.095
04/03/2018 18:00,46.36,60102,2841,76,7,711,5,3640,3.028.988.095
04/03/2018 19:00,43.4,59626,2811,78,5,825,4,3723,3.028.988.095
04/03/2018 20:00,40.43,58466,2850,77,4,878,2,3811,3.028.988.095
04/03/2018 21:00,39.36,57534,2800,72,4,913,2,3791,3.028.988.095
04/03/2018 22:00,38.66,56037,2750,64,4,943,2,3763,3.028.988.095
04/03/2018 23:00,38.17,54350,2630,56,5,957,2,3650,3.028.988.095
05/03/2018 00:00,37.72,53187,2675,74,7,1000,1,3757,275.75
05/03/2018 01:00,37.19,52558,2733,75,9,1033,1,3851,275.75
05/03/2018 02:00,37.15,52581,2933,74,10,1067,2,4086,275.75
05/03/2018 03:00,37.51,52986,3129,77,19,1136,2,4363,275.75
05/03/2018 04:00,38.03,53907,3296,77,21,1232,2,4628,275.75
05/03/2018 05:00,38.96,56231,3395,78,31,1377,2,4883,275.75
05/03/2018 06:00,46.67,60547,3442,75,41,1510,2,5070,275.75
05/03/2018 07:00,60.08,64669,3515,67,46,1641,2,5271,275.75
05/03/2018 08:00,65.2,65697,3424,56,48,1710,2,5240,275.75
05/03/2018 09:00,64.49,65121,3218,48,50,1827,2,5145,275.75
05/03/2018 10:00,60.05,64615,2998,44,55,1905,3,5005,275.75
05/03/2018 11:00,56.95,63832,2735,43,69,1853,3,4703,275.75
05/03/2018 12:00,50.74,63024,2432,44,82,1903,5,4466,275.75
05/03/2018 13:00,49.83,62451,2121,46,102,1856,4,4129,275.75
05/03/2018 14:00,52.89,62176,1802,50,132,1800,4,3788,275.75
05/03/2018 15:00,53.81,62074,1616,52,152,1727,4,3551,275.75
05/03/2018 16:00,54.18,62122,1409,56,184,1729,5,3383,275.75
05/03/2018 17:00,69.67,63746,1169,58,216,1727,6,3176,275.75
05/03/2018 18:00,82.97,64630,955,58,243,1728,7,2991,275.75
05/03/2018 19:00,81.61,63656,796,56,251,1674,8,2785,275.75
05/03/2018 20:00,59.59,62015,719,52,238,1600,6,2615,275.75
05/03/2018 21:00,49.8,60455,670,46,227,1524,7,2474,275.75
05/03/2018 22:00,43.69,58179,629,38,224,1388,6,2285,275.75
05/03/2018 23:00,40.4,55637,469,31,213,1289,5,2007,275.75
06/03/2018 00:00,38.93,53421,836,7,202,1253,7,2305,275.75
06/03/2018 01:00,37.95,52446,671,7,186,1237,6,2107,275.75
06/03/2018 02:00,37.38,52194,469,6,171,1254,5,1905,275.75
06/03/2018 03:00,36.74,52411,350,8,159,1285,5,1807,275.75
06/03/2018 04:00,37.41,53176,324,9,149,1312,5,1799,275.75
06/03/2018 05:00,39.71,55264,338,10,144,1325,4,1821,275.75
06/03/2018 06:00,46.78,59070,343,11,143,1375,3,1875,275.75
06/03/2018 07:00,58.25,62749,386,11,117,1346,3,1863,275.75
06/03/2018 08:00,65.17,63695,520,9,85,1250,4,1868,275.75
06/03/2018 09:00,64.99,63364,621,8,59,1138,3,1829,275.75
06/03/2018 10:00,63.24,63010,714,7,48,968,3,1740,275.75
06/03/2018 11:00,55.26,62449,825,7,46,890,3,1771,275.75
06/03/2018 12:00,52.39,61848,941,7,46,820,3,1817,275.75
06/03/2018 13:00,50.07,61357,1056,6,45,785,3,1895,275.75
06/03/2018 14:00,49.18,61032,1132,8,66,795,3,2004,275.75
06/03/2018 15:00,48.76,60765,1218,10,92,861,2,2183,275.75
06/03/2018 16:00,48.24,60907,1331,16,124,979,2,2452,275.75
06/03/2018 17:00,53.99,62050,1509,26,156,1162,4,2857,275.75
06/03/2018 18:00,59.24,62735,1821,40,188,1401,4,3454,275.75
06/03/2018 19:00,55.21,62076,1995,49,199,1560,5,3808,275.75
06/03/2018 20:00,45.99,60549,2282,53,199,1492,3,4029,275.75
06/03/2018 21:00,42.86,59106,2394,53,187,1474,3,4111,275.75
06/03/2018 22:00,40.58,56981,2404,53,182,1436,3,4078,275.75
06/03/2018 23:00,38.6,54563,2062,51,177,1399,3,3692,275.75
07/03/2018 00:00,38.13,52348,1585,62,170,1409,2,3228,275.75
07/03/2018 01:00,37.66,51467,1399,65,175,1411,2,3052,275.75
07/03/2018 02:00,37.1,51169,1305,64,191,1403,2,2965,275.75
07/03/2018 03:00,36.91,51309,1213,66,197,1483,3,2962,275.75
07/03/2018 04:00,37.54,52088,1200,67,208,1611,3,3089,275.75
07/03/2018 05:00,39.88,54159,1254,66,213,1707,3,3243,275.75
07/03/2018 06:00,45.2,58025,1184,66,218,1790,3,3261,275.75
07/03/2018 07:00,54.49,61695,1115,63,218,1832,4,3232,275.75
07/03/2018 08:00,60.3,62704,1030,56,208,1807,4,3105,275.75
07/03/2018 09:00,58.5,62445,999,51,197,1704,6,2957,275.75
07/03/2018 10:00,55.14,62120,987,45,187,1638,10,2867,275.75
07/03/2018 11:00,54.74,61720,937,41,182,1568,11,2739,275.75
07/03/2018 12:00,50.05,61164,849,39,183,1503,13,2587,275.75
07/03/2018 13:00,47.8,60790,790,38,193,1477,12,2510,275.75
07/03/2018 14:00,46.51,60441,706,40,209,1471,12,2438,275.75
07/03/2018 15:00,46.75,60251,627,43,231,1479,12,2392,275.75
07/03/2018 16:00,47.71,60430,565,46,242,1568,10,2431,275.75
07/03/2018 17:00,53.15,61558,522,50,242,1708,11,2533,275.75
07/03/2018 18:00,60.84,62256,535,52,243,1814,10,2654,275.75
07/03/2018 19:00,56.9,61573,502,52,243,1813,10,2620,275.75
07/03/2018 20:00,46.04,59974,528,53,232,1758,7,2578,275.75
07/03/2018 21:00,42.26,58423,548,52,221,1635,6,2462,275.75
07/03/2018 22:00,39.87,56253,559,50,216,1519,6,2350,275.75
07/03/2018 23:00,37.29,53894,564,49,200,1416,7,2236,275.75
08/03/2018 00:00,37.37,52144,396,51,148,1362,5,1962,275.75
08/03/2018 01:00,35.89,51175,345,48,138,1297,5,1833,275.75
08/03/2018 02:00,35.73,50928,302,46,132,1221,5,1706,275.75
08/03/2018 03:00,35.63,51134,257,45,127,1181,5,1615,275.75
08/03/2018 04:00,36.09,51894,215,45,120,1128,5,1513,275.75
08/03/2018 05:00,36.97,54011,194,45,112,1100,6,1457,275.75
08/03/2018 06:00,40.48,57596,177,46,103,1077,5,1408,275.75
08/03/2018 07:00,46.2,61355,185,44,87,1042,5,1363,275.75
08/03/2018 08:00,46.96,62552,191,38,61,952,6,1248,275.75
08/03/2018 09:00,44.91,62252,214,35,48,965,7,1269,275.75
08/03/2018 10:00,42.4,61971,279,35,43,935,8,1300,275.75
08/03/2018 11:00,41.51,61513,300,39,44,899,7,1289,275.75
08/03/2018 12:00,40.49,61122,345,43,45,861,7,1301,275.75
08/03/2018 13:00,40.34,60802,406,47,45,796,5,1299,275.75
08/03/2018 14:00,39.51,60417,435,52,46,811,5,1349,275.75
08/03/2018 15:00,39.47,60168,415,59,45,826,5,1350,275.75
08/03/2018 16:00,40.51,60356,407,72,46,882,6,1413,275.75
08/03/2018 17:00,42.99,61480,510,80,47,966,7,1610,275.75
08/03/2018 18:00,47.71,62154,680,88,50,1068,7,1893,275.75
08/03/2018 19:00,44.23,61514,824,88,59,1134,8,2113,275.75
08/03/2018 20:00,38.75,60008,962,84,75,1077,6,2204,275.75
08/03/2018 21:00,37.71,58488,1024,76,90,1041,6,2237,275.75
08/03/2018 22:00,36.51,56312,946,72,100,1033,6,2157,275.75
08/03/2018 23:00,35.57,53867,852,71,94,1051,5,2073,275.75
09/03/2018 00:00,35.77,51466,743,68,70,944,7,1832,275.75
09/03/2018 01:00,35.33,50422,834,70,71,930,7,1912,275.75
09/03/2018 02:00,34.99,50131,799,72,75,934,8,1888,275.75
09/03/2018 03:00,34.99,50321,715,76,82,929,9,1811,275.75
09/03/2018 04:00,35.55,51076,681,81,87,949,9,1807,275.75
09/03/2018 05:00,36.4,53109,724,85,93,978,8,1888,275.75
09/03/2018 06:00,38.14,56586,852,86,102,954,8,2002,275.75
09/03/2018 07:00,41.96,60336,906,84,105,918,8,2021,275.75
09/03/2018 08:00,43.89,61661,966,77,104,820,8,1975,275.75
09/03/2018 09:00,41.93,61566,986,73,104,742,7,1912,275.75
09/03/2018 10:00,40.69,61472,981,71,104,672,7,1835,275.75
09/03/2018 11:00,39.8,60954,912,68,103,638,7,1728,275.75
09/03/2018 12:00,38.51,60233,795,66,92,603,8,1564,275.75
09/03/2018 13:00,39.72,59559,696,66,83,578,7,1430,275.75
09/03/2018 14:00,40.38,58863,578,65,74,558,8,1283,275.75
09/03/2018 15:00,40.84,58420,425,67,65,566,8,1131,275.75
09/03/2018 16:00,41.52,58512,290,73,55,582,8,1008,275.75
09/03/2018 17:00,44.99,59756,205,79,52,586,8,930,275.75
09/03/2018 18:00,53.66,60540,154,85,54,605,8,906,275.75
09/03/2018 19:00,46.11,59536,137,91,51,600,8,887,275.75
09/03/2018 20:00,42.2,57521,140,91,44,537,5,817,275.75
09/03/2018 21:00,41.4,55931,154,91,39,462,4,750,275.75
09/03/2018 22:00,39.78,54157,156,88,29,431,4,708,275.75
09/03/2018 23:00,37.9,52107,178,83,24,393,4,682,275.75
10/03/2018 00:00,37.75,49906,203,27,22,396,3,651,275.75
10/03/2018 01:00,36.64,48950,234,22,19,364,3,642,275.75
10/03/2018 02:00,36.21,48490,271,20,16,337,3,647,275.75
10/03/2018 03:00,36.05,48375,323,18,15,316,3,675,275.75
10/03/2018 04:00,36.28,48696,429,18,12,299,3,761,275.75
10/03/2018 05:00,36.53,49412,644,19,12,281,3,959,275.75
10/03/2018 06:00,36.72,50308,893,21,11,269,3,1197,275.75
10/03/2018 07:00,37.25,51863,1104,20,12,236,2,1374,275.75
10/03/2018 08:00,37.56,53598,1267,16,14,191,3,1491,275.75
10/03/2018 09:00,37.89,54895,1421,11,14,155,3,1604,275.75
10/03/2018 10:00,37.66,55202,1595,7,17,145,3,1767,275.75
10/03/2018 11:00,37.38,54646,1764,5,19,140,2,1930,275.75
10/03/2018 12:00,37.02,53907,1916,5,24,129,3,2077,275.75
10/03/2018 13:00,36.5,53179,2067,7,25,142,3,2244,275.75
10/03/2018 14:00,36.23,52763,2261,11,22,152,2,2448,275.75
10/03/2018 15:00,36.2,52714,2476,19,15,171,2,2683,275.75
10/03/2018 16:00,36.76,53475,2598,26,13,214,2,2853,275.75
10/03/2018 17:00,38.52,55270,2794,33,10,285,4,3126,275.75
10/03/2018 18:00,41.32,56577,2957,40,9,400,4,3410,275.75
10/03/2018 19:00,41.3,55783,2972,41,8,504,4,3529,275.75
10/03/2018 20:00,38.6,54143,3111,38,9,579,2,3739,275.75
10/03/2018 21:00,36.66,53039,3069,34,9,658,2,3772,275.75
10/03/2018 22:00,36.26,51699,2829,30,10,721,3,3593,275.75
10/03/2018 23:00,36.03,50167,2610,25,13,767,2,3417,275.75
11/03/2018 00:00,36.28,48741,2593,12,59,830,3,3497,275.75
11/03/2018 01:00,35.83,47955,2426,10,76,863,4,3379,275.75
11/03/2018 02:00,35.72,47703,2251,11,87,909,4,3262,275.75
11/03/2018 03:00,35.73,47643,2124,12,98,973,5,3212,275.75
11/03/2018 04:00,35.64,47904,2078,15,120,1047,5,3265,275.75
11/03/2018 05:00,35.99,48369,2062,16,142,1124,5,3349,275.75
11/03/2018 06:00,36.28,48909,2001,16,164,1190,6,3377,275.75
11/03/2018 07:00,36.12,49901,1970,13,170,1230,7,3390,275.75
11/03/2018 08:00,36.3,51432,1883,9,176,1224,8,3300,275.75
11/03/2018 09:00,36.48,52764,1739,6,187,1233,9,3174,275.75
11/03/2018 10:00,36.83,53401,1636,5,193,1236,9,3079,275.75
11/03/2018 11:00,36.74,53356,1512,5,199,1232,9,2957,275.75
11/03/2018 12:00,36.39,53003,1413,6,200,1229,8,2856,275.75
11/03/2018 13:00,36.18,52555,1342,8,212,1265,5,2832,275.75
11/03/2018 14:00,35.49,52275,1267,11,233,1345,5,2861,275.75
11/03/2018 15:00,35.57,52298,1246,13,270,1439,4,2972,275.75
11/03/2018 16:00,35.98,52972,1279,14,281,1550,3,3127,275.75
11/03/2018 17:00,36.99,54658,1476,16,287,1653,3,3435,275.75
11/03/2018 18:00,37.46,56163,1703,17,293,1763,3,3779,275.75
11/03/2018 19:00,38,55766,1940,17,298,1825,3,4083,275.75
11/03/2018 20:00,36.89,54391,2204,15,292,1791,2,4304,275.75
11/03/2018 21:00,36.35,53279,2373,12,281,1774,2,4442,275.75
11/03/2018 22:00,35.88,51562,2394,10,270,1709,2,4385,275.75
11/03/2018 23:00,35.68,49670,2358,8,260,1632,2,4260,275.75
12/03/2018 00:00,35.06,48783,2130,71,179,1727,7,4114,2.510.357.143
12/03/2018 01:00,34.92,48055,1925,69,183,1682,7,3866,2.510.357.143
12/03/2018 02:00,35.1,47806,1621,67,195,1667,8,3558,2.510.357.143
12/03/2018 03:00,35.78,48033,1287,67,200,1632,9,3195,2.510.357.143
12/03/2018 04:00,36.18,48897,1050,68,212,1640,12,2982,2.510.357.143
12/03/2018 05:00,38.13,51265,855,70,230,1620,8,2783,2.510.357.143
12/03/2018 06:00,41.63,55144,761,70,253,1606,6,2696,2.510.357.143
12/03/2018 07:00,49.45,58999,632,71,265,1536,8,2512,2.510.357.143
12/03/2018 08:00,50.49,60244,468,66,272,1440,10,2256,2.510.357.143
12/03/2018 09:00,49.99,60047,327,63,283,1381,12,2066,2.510.357.143
12/03/2018 10:00,47.91,59760,267,60,296,1142,14,1779,2.510.357.143
12/03/2018 11:00,46.23,59244,196,57,307,908,16,1484,2.510.357.143
12/03/2018 12:00,44.86,58589,154,57,311,755,16,1293,2.510.357.143
12/03/2018 13:00,42.39,58074,135,54,311,662,14,1176,2.510.357.143
12/03/2018 14:00,41.63,57777,120,50,313,617,13,1113,2.510.357.143
12/03/2018 15:00,41.65,57547,131,48,319,533,12,1043,2.510.357.143
12/03/2018 16:00,42.49,57489,148,50,325,535,14,1072,2.510.357.143
12/03/2018 17:00,46.96,58533,163,52,337,575,14,1141,2.510.357.143
12/03/2018 18:00,50.24,59377,202,54,353,594,13,1216,2.510.357.143
12/03/2018 19:00,49.94,58723,220,54,354,596,14,1238,2.510.357.143
12/03/2018 20:00,42.25,56975,261,51,343,568,14,1237,2.510.357.143
12/03/2018 21:00,39.64,55355,315,48,342,543,15,1263,2.510.357.143
12/03/2018 22:00,37.6,53058,359,45,341,580,16,1341,2.510.357.143
12/03/2018 23:00,36.62,50560,494,42,340,681,16,1573,2.510.357.143
13/03/2018 00:00,37.39,48858,339,44,318,718,12,1431,2.510.357.143
13/03/2018 01:00,36.99,47859,405,44,322,818,13,1602,2.510.357.143
13/03/2018 02:00,36.29,47588,492,48,332,978,15,1865,2.510.357.143
13/03/2018 03:00,36.06,47785,548,52,329,1107,17,2053,2.510.357.143
13/03/2018 04:00,36.85,48712,603,61,326,1242,16,2248,2.510.357.143
13/03/2018 05:00,38.3,51028,704,64,326,1336,17,2447,2.510.357.143
13/03/2018 06:00,40.67,54846,829,66,325,1454,16,2690,2.510.357.143
13/03/2018 07:00,45.52,58763,878,68,317,1452,16,2731,2.510.357.143
13/03/2018 08:00,46.18,59886,925,67,311,1396,15,2714,2.510.357.143
13/03/2018 09:00,45.75,59639,942,69,312,1368,16,2707,2.510.357.143
13/03/2018 10:00,43.03,59561,1034,73,300,1369,21,2797,2.510.357.143
13/03/2018 11:00,42.63,59178,1092,77,294,1415,23,2901,2.510.357.143
13/03/2018 12:00,43.27,58737,1123,80,283,1341,21,2848,2.510.357.143
13/03/2018 13:00,41.88,58346,1130,82,283,1437,20,2952,2.510.357.143
13/03/2018 14:00,41.55,57945,1083,86,295,1517,21,3002,2.510.357.143
13/03/2018 15:00,41.98,57757,1069,91,295,1621,24,3100,2.510.357.143
13/03/2018 16:00,41.79,57760,1101,102,292,1747,28,3270,2.510.357.143
13/03/2018 17:00,45.63,58687,1102,113,283,1889,32,3419,2.510.357.143
13/03/2018 18:00,49.55,59465,1079,122,284,2041,33,3559,2.510.357.143
13/03/2018 19:00,49.1,58966,1100,127,273,2100,34,3634,2.510.357.143
13/03/2018 20:00,43.7,57406,1024,128,251,2063,29,3495,2.510.357.143
13/03/2018 21:00,41.91,55960,940,128,237,2081,27,3413,2.510.357.143
13/03/2018 22:00,39.73,53848,848,127,221,2114,23,3333,2.510.357.143
13/03/2018 23:00,37.64,51282,790,120,193,2156,18,3277,2.510.357.143
14/03/2018 00:00,37.05,49205,653,95,174,2143,9,3074,2.510.357.143
14/03/2018 01:00,36.22,48380,595,93,162,2160,9,3019,2.510.357.143
14/03/2018 02:00,36.09,48261,519,92,148,2154,12,2925,2.510.357.143
14/03/2018 03:00,36.09,48601,449,90,138,2164,16,2857,2.510.357.143
14/03/2018 04:00,37.12,49609,426,89,128,2196,18,2857,2.510.357.143
14/03/2018 05:00,39.11,52015,391,87,121,2174,18,2791,2.510.357.143
14/03/2018 06:00,45.27,56032,383,84,114,2089,17,2687,2.510.357.143
14/03/2018 07:00,60.6,59980,379,90,108,1907,17,2501,2.510.357.143
14/03/2018 08:00,64.98,61035,350,93,100,1525,19,2087,2.510.357.143
14/03/2018 09:00,61.99,60461,274,102,92,1289,20,1777,2.510.357.143
14/03/2018 10:00,58.08,59877,242,107,90,1032,21,1492,2.510.357.143
14/03/2018 11:00,53.52,59157,239,108,89,861,21,1318,2.510.357.143
14/03/2018 12:00,49.31,58299,240,105,87,722,24,1178,2.510.357.143
14/03/2018 13:00,47.48,57699,219,96,88,603,24,1030,2.510.357.143
14/03/2018 14:00,46.99,57253,208,88,90,561,23,970,2.510.357.143
14/03/2018 15:00,47.64,57145,229,82,94,560,23,988,2.510.357.143
14/03/2018 16:00,47.35,57325,280,72,97,534,24,1007,2.510.357.143
14/03/2018 17:00,52.23,58648,388,62,108,613,23,1194,2.510.357.143
14/03/2018 18:00,62.7,59862,503,63,122,714,21,1423,2.510.357.143
14/03/2018 19:00,58.5,59960,659,60,133,798,21,1671,2.510.357.143
14/03/2018 20:00,45.94,58672,833,59,140,895,18,1945,2.510.357.143
14/03/2018 21:00,40.66,57274,969,57,145,1021,15,2207,2.510.357.143
14/03/2018 22:00,38.56,55190,1083,57,143,1074,12,2369,2.510.357.143
14/03/2018 23:00,37.75,52798,1158,57,132,1073,10,2430,2.510.357.143
15/03/2018 00:00,37.71,51089,1229,60,84,1086,9,2468,2.510.357.143
15/03/2018 01:00,37.33,50262,1435,86,71,1098,8,2698,2.510.357.143
15/03/2018 02:00,37.32,50222,1697,104,62,1080,7,2950,2.510.357.143
15/03/2018 03:00,37.47,50600,2046,112,60,1138,7,3363,2.510.357.143
15/03/2018 04:00,37.83,51681,2302,121,55,1201,7,3686,2.510.357.143
15/03/2018 05:00,39.26,54128,2576,129,51,1311,7,4074,2.510.357.143
15/03/2018 06:00,40.77,57896,2840,140,47,1449,7,4483,2.510.357.143
15/03/2018 07:00,44.89,61774,3073,141,46,1478,8,4746,2.510.357.143
15/03/2018 08:00,47.89,62720,3326,136,43,1398,8,4911,2.510.357.143
15/03/2018 09:00,44.9,62051,3609,131,40,1384,11,5175,2.510.357.143
15/03/2018 10:00,42.43,61448,3799,129,38,1357,11,5334,2.510.357.143
15/03/2018 11:00,41.38,60779,3893,131,38,1423,11,5496,2.510.357.143
15/03/2018 12:00,40.82,60199,4007,135,40,1467,12,5661,2.510.357.143
15/03/2018 13:00,40.43,59886,4317,135,43,1537,12,6044,2.510.357.143
15/03/2018 14:00,40.21,59469,4572,130,51,1628,14,6395,2.510.357.143
15/03/2018 15:00,40.22,59170,4695,125,52,1734,15,6621,2.510.357.143
15/03/2018 16:00,40.47,59386,4756,121,63,1857,17,6814,2.510.357.143
15/03/2018 17:00,41.42,60621,4847,112,85,2046,16,7106,2.510.357.143
15/03/2018 18:00,43.01,61811,4966,108,113,2256,14,7457,2.510.357.143
15/03/2018 19:00,41.57,61880,5051,106,126,2408,9,7700,2.510.357.143
15/03/2018 20:00,40.46,60586,5022,99,124,2503,8,7756,2.510.357.143
15/03/2018 21:00,40.1,59291,4968,92,128,2594,6,7788,2.510.357.143
15/03/2018 22:00,38.66,57306,4964,89,128,2579,6,7766,2.510.357.143
15/03/2018 23:00,37.68,54992,5047,84,122,2522,6,7781,2.510.357.143
16/03/2018 00:00,37.44,53042,4912,85,95,2438,5,7535,2.510.357.143
16/03/2018 01:00,37.21,52310,4903,86,103,2423,6,7521,2.510.357.143
16/03/2018 02:00,37.08,52240,4838,89,119,2423,6,7475,2.510.357.143
16/03/2018 03:00,37.19,52587,4819,92,138,2448,8,7505,2.510.357.143
16/03/2018 04:00,37.7,53529,4785,93,153,2498,9,7538,2.510.357.143
16/03/2018 05:00,39.82,55800,4757,94,160,2546,9,7566,2.510.357.143
16/03/2018 06:00,41.2,59367,4731,94,174,2611,8,7618,2.510.357.143
16/03/2018 07:00,44.31,63023,4715,92,198,2545,9,7559,2.510.357.143
16/03/2018 08:00,45.6,64070,4668,88,226,2384,11,7377,2.510.357.143
16/03/2018 09:00,43.95,63502,4671,85,254,2283,14,7307,2.510.357.143
16/03/2018 10:00,42.95,62903,4677,85,257,2285,12,7316,2.510.357.143
16/03/2018 11:00,42.11,61925,4715,89,254,2337,15,7410,2.510.357.143
16/03/2018 12:00,41.18,61039,4740,96,244,2371,19,7470,2.510.357.143
16/03/2018 13:00,40.86,60238,4826,105,249,2410,21,7611,2.510.357.143
16/03/2018 14:00,40.27,59585,4855,112,270,2386,20,7643,2.510.357.143
16/03/2018 15:00,40.09,59113,4795,120,282,2377,25,7599,2.510.357.143
16/03/2018 16:00,40.19,59181,4768,123,292,2397,33,7613,2.510.357.143
16/03/2018 17:00,41.16,60524,4768,124,299,2430,34,7655,2.510.357.143
16/03/2018 18:00,43.16,61930,4788,118,308,2457,30,7701,2.510.357.143
16/03/2018 19:00,41.87,61878,4781,110,307,2476,27,7701,2.510.357.143
16/03/2018 20:00,40.48,60340,4761,103,301,2510,27,7702,2.510.357.143
16/03/2018 21:00,38.85,59057,4668,100,301,2574,24,7667,2.510.357.143
16/03/2018 22:00,37.74,57447,4644,97,299,2627,17,7684,2.510.357.143
16/03/2018 23:00,37.43,55500,4634,89,305,2606,13,7647,2.510.357.143
17/03/2018 00:00,38.2,53768,4564,44,0,2739,15,7362,2.510.357.143
17/03/2018 01:00,37.87,53089,4526,40,0,2644,13,7223,2.510.357.143
17/03/2018 02:00,37.62,52829,4419,37,0,2656,11,7123,2.510.357.143
17/03/2018 03:00,37.36,52901,4391,33,0,2725,8,7157,2.510.357.143
17/03/2018 04:00,37.14,53350,4416,31,0,2896,6,7349,2.510.357.143
17/03/2018 05:00,37.22,54079,4415,28,0,2919,6,7368,2.510.357.143
17/03/2018 06:00,37.44,54905,4426,27,0,3078,6,7537,2.510.357.143
17/03/2018 07:00,37.95,56280,4464,25,0,3024,7,7520,2.510.357.143
17/03/2018 08:00,38.19,57699,4487,21,0,2932,8,7448,2.510.357.143
17/03/2018 09:00,38.46,58593,4619,18,0,2826,9,7472,2.510.357.143
17/03/2018 10:00,38.64,58615,4657,14,0,2751,11,7433,2.510.357.143
17/03/2018 11:00,37.96,57929,4663,13,0,2665,17,7358,2.510.357.143
17/03/2018 12:00,37.59,57051,4653,13,0,2623,20,7309,2.510.357.143
17/03/2018 13:00,37.25,56147,4717,12,0,2556,18,7303,2.510.357.143
17/03/2018 14:00,36.68,55513,4762,11,0,2678,15,7466,2.510.357.143
17/03/2018 15:00,36.85,55321,4723,11,0,2784,12,7530,2.510.357.143
17/03/2018 16:00,36.93,55818,4696,13,0,2924,9,7642,2.510.357.143
17/03/2018 17:00,37.87,57403,4568,15,0,3075,8,7666,2.510.357.143
17/03/2018 18:00,39.55,58881,4468,17,0,3233,6,7724,2.510.357.143
17/03/2018 19:00,38.99,58750,4317,19,0,3312,6,7654,2.510.357.143
17/03/2018 20:00,37.64,57343,4162,19,0,3289,6,7476,2.510.357.143
17/03/2018 21:00,37.03,56340,4008,19,0,3271,4,7302,2.510.357.143
17/03/2018 22:00,37.39,55239,3815,18,0,3241,4,7078,2.510.357.143
17/03/2018 23:00,36.79,53959,3446,17,0,3192,3,6658,2.510.357.143
18/03/2018 00:00,37.04,52617,3572,18,114,3220,3,6927,2.510.357.143
18/03/2018 01:00,36.41,52038,3383,18,94,3267,3,6765,2.510.357.143
18/03/2018 02:00,36.51,51851,3161,17,70,3259,3,6510,2.510.357.143
18/03/2018 03:00,36.56,51793,3070,18,56,3327,4,6475,2.510.357.143
18/03/2018 04:00,36.57,52038,3091,18,41,3379,4,6533,2.510.357.143
18/03/2018 05:00,36.24,52448,2809,20,31,3368,5,6233,2.510.357.143
18/03/2018 06:00,36.18,52841,2643,21,23,3301,6,5994,2.510.357.143
18/03/2018 07:00,37.07,53616,2590,23,16,3295,6,5930,2.510.357.143
18/03/2018 08:00,37.24,54674,2456,23,13,3152,5,5649,2.510.357.143
18/03/2018 09:00,37.5,55332,2483,22,12,3033,7,5557,2.510.357.143
18/03/2018 10:00,37.14,55289,2489,21,14,3023,11,5558,2.510.357.143
18/03/2018 11:00,36.64,54727,2400,21,19,2961,14,5415,2.510.357.143
18/03/2018 12:00,36.05,53899,2313,20,22,2922,15,5292,2.510.357.143
18/03/2018 13:00,35.63,53070,2238,20,28,3016,16,5318,2.510.357.143
18/03/2018 14:00,35.5,52649,2179,18,34,3044,17,5292,2.510.357.143
18/03/2018 15:00,35.54,52556,2051,19,33,3039,16,5158,2.510.357.143
18/03/2018 16:00,36.28,53197,1892,22,38,3080,15,5047,2.510.357.143
18/03/2018 17:00,37.43,54730,1624,29,52,3106,14,4825,2.510.357.143
18/03/2018 18:00,40.23,56564,1464,37,68,3118,11,4698,2.510.357.143
18/03/2018 19:00,40.94,56798,1206,44,76,3212,9,4547,2.510.357.143
18/03/2018 20:00,39.73,55896,990,48,76,3255,7,4376,2.510.357.143
18/03/2018 21:00,37.98,54971,833,49,78,3120,7,4087,2.510.357.143
18/03/2018 22:00,38.06,53437,699,48,83,3145,8,3983,2.510.357.143
18/03/2018 23:00,37.14,51854,494,46,98,3220,7,3865,2.510.357.143
19/03/2018 00:00,36.42,50539,396,82,68,3277,11,3834,2.277.916.667
19/03/2018 01:00,35.87,49965,336,88,73,3353,10,3860,2.277.916.667
19/03/2018 02:00,35.92,50011,313,91,79,3370,10,3863,2.277.916.667
19/03/2018 03:00,35.93,50244,318,90,94,3379,9,3890,2.277.916.667
19/03/2018 04:00,36.73,51128,386,84,104,3388,9,3971,2.277.916.667
19/03/2018 05:00,39.44,53506,445,78,111,3384,10,4028,2.277.916.667
19/03/2018 06:00,43.97,57453,622,74,121,3484,12,4313,2.277.916.667
19/03/2018 07:00,52.21,61067,808,72,129,3311,11,4331,2.277.916.667
19/03/2018 08:00,60.09,61921,889,70,137,3132,15,4243,2.277.916.667
19/03/2018 09:00,52.13,61244,963,73,149,3227,24,4436,2.277.916.667
19/03/2018 10:00,47.91,60569,1134,81,163,3348,25,4751,2.277.916.667
19/03/2018 11:00,45.72,59714,1267,89,185,3495,27,5063,2.277.916.667
19/03/2018 12:00,43.21,58851,1441,97,202,3586,30,5356,2.277.916.667
19/03/2018 13:00,42.24,58299,1662,102,208,3626,31,5629,2.277.916.667
19/03/2018 14:00,41.49,57925,1855,110,201,3598,32,5796,2.277.916.667
19/03/2018 15:00,41.12,57497,2054,112,175,3536,33,5910,2.277.916.667
19/03/2018 16:00,41.17,57288,2212,110,173,3539,30,6064,2.277.916.667
19/03/2018 17:00,42.32,58211,2271,105,173,3582,24,6155,2.277.916.667
19/03/2018 18:00,45.14,59175,2308,98,177,3478,21,6082,2.277.916.667
19/03/2018 19:00,41.98,59197,2350,94,178,3345,18,5985,2.277.916.667
19/03/2018 20:00,40.75,57920,2240,90,180,3249,16,5775,2.277.916.667
19/03/2018 21:00,40,56443,2235,85,186,3136,13,5655,2.277.916.667
19/03/2018 22:00,39.47,54346,2301,80,185,3045,10,5621,2.277.916.667
19/03/2018 23:00,37.48,52014,2226,72,173,2888,7,5366,2.277.916.667
20/03/2018 00:00,38.02,49817,2469,0,150,2795,10,5424,2.277.916.667
20/03/2018 01:00,37.28,49076,2670,0,139,2753,7,5569,2.277.916.667
20/03/2018 02:00,37.31,49016,2774,0,127,2741,6,5648,2.277.916.667
20/03/2018 03:00,37.09,49274,2918,0,121,2767,5,5811,2.277.916.667
20/03/2018 04:00,37.19,50360,3146,0,105,2731,5,5987,2.277.916.667
20/03/2018 05:00,38.53,52692,2956,0,87,2624,4,5671,2.277.916.667
20/03/2018 06:00,41.64,56391,2908,0,71,2450,4,5433,2.277.916.667
20/03/2018 07:00,49.86,60033,2817,0,52,2179,3,5051,2.277.916.667
20/03/2018 08:00,49.82,60870,2655,0,41,1835,4,4535,2.277.916.667
20/03/2018 09:00,43.26,60021,2514,0,35,1513,7,4069,2.277.916.667
20/03/2018 10:00,41.72,59299,2286,0,33,1325,8,3652,2.277.916.667
20/03/2018 11:00,41.09,58655,1976,0,37,1180,12,3205,2.277.916.667
20/03/2018 12:00,40.78,57859,1824,0,43,1115,19,3001,2.277.916.667
20/03/2018 13:00,40.68,57354,1717,0,57,981,26,2781,2.277.916.667
20/03/2018 14:00,40.58,57027,1662,0,85,913,31,2691,2.277.916.667
20/03/2018 15:00,40.39,56702,1543,0,117,853,37,2550,2.277.916.667
20/03/2018 16:00,40.74,56764,1301,0,145,878,41,2365,2.277.916.667
20/03/2018 17:00,46.05,57674,1005,0,171,1058,41,2275,2.277.916.667
20/03/2018 18:00,56.93,58801,746,0,204,1340,38,2328,2.277.916.667
20/03/2018 19:00,63.58,59142,538,0,218,1595,32,2383,2.277.916.667
20/03/2018 20:00,50.05,58241,421,0,205,1838,30,2494,2.277.916.667
20/03/2018 21:00,46.06,57019,340,0,196,2189,29,2754,2.277.916.667
20/03/2018 22:00,41.86,55174,331,0,185,2445,28,2989,2.277.916.667
20/03/2018 23:00,39.6,52780,301,0,168,2626,23,3118,2.277.916.667
21/03/2018 00:00,39.46,49896,410,40,154,2860,15,3479,2.277.916.667
21/03/2018 01:00,39.34,49126,455,38,132,2973,14,3612,2.277.916.667
21/03/2018 02:00,39.25,48982,514,36,122,3067,12,3751,2.277.916.667
21/03/2018 03:00,38.99,49060,627,36,117,3108,11,3899,2.277.916.667
21/03/2018 04:00,39.35,49836,826,34,111,3180,10,4161,2.277.916.667
21/03/2018 05:00,40.39,51946,916,29,98,3204,9,4256,2.277.916.667
21/03/2018 06:00,42.67,55525,1061,26,87,3151,8,4333,2.277.916.667
21/03/2018 07:00,50.27,59055,1237,26,81,2976,7,4327,2.277.916.667
21/03/2018 08:00,52,59760,1434,29,80,2734,7,4284,2.277.916.667
21/03/2018 09:00,49.29,58889,1641,36,76,2471,7,4231,2.277.916.667
21/03/2018 10:00,45.32,58162,1803,43,76,2277,7,4206,2.277.916.667
21/03/2018 11:00,42.4,57493,1972,52,79,2279,8,4390,2.277.916.667
21/03/2018 12:00,41.98,56636,2104,57,79,2326,10,4576,2.277.916.667
21/03/2018 13:00,41.25,55932,2229,64,85,2361,13,4752,2.277.916.667
21/03/2018 14:00,41.1,55568,2309,70,93,2308,15,4795,2.277.916.667
21/03/2018 15:00,41.25,55326,2508,78,99,2256,16,4957,2.277.916.667
21/03/2018 16:00,41.34,55441,2577,89,107,2324,17,5114,2.277.916.667
21/03/2018 17:00,42.66,56430,2514,103,115,2396,16,5144,2.277.916.667
21/03/2018 18:00,45.9,57465,2408,119,125,2589,15,5256,2.277.916.667
21/03/2018 19:00,43.48,57598,2318,126,131,2703,15,5293,2.277.916.667
21/03/2018 20:00,41.86,56325,2406,126,130,2779,16,5457,2.277.916.667
21/03/2018 21:00,41.27,54844,2616,121,137,2763,16,5653,2.277.916.667
21/03/2018 22:00,38.98,52532,2603,113,150,2789,15,5670,2.277.916.667
21/03/2018 23:00,37.88,50032,2406,99,167,2597,15,5284,2.277.916.667
22/03/2018 00:00,37.4,48485,3232,90,200,2591,13,6126,2.277.916.667
22/03/2018 01:00,36.93,47509,3134,82,210,2473,11,5910,2.277.916.667
22/03/2018 02:00,36.58,47265,3029,72,212,2415,10,5738,2.277.916.667
22/03/2018 03:00,36.9,47390,2930,58,215,2327,9,5539,2.277.916.667
22/03/2018 04:00,37.65,48204,2831,40,213,2382,9,5475,2.277.916.667
22/03/2018 05:00,38.54,50217,2504,25,209,2409,9,5156,2.277.916.667
22/03/2018 06:00,39.77,53610,2292,15,207,2373,9,4896,2.277.916.667
22/03/2018 07:00,41.49,57092,1835,8,205,2273,9,4330,2.277.916.667
22/03/2018 08:00,42.11,58019,1481,5,212,2044,10,3752,2.277.916.667
22/03/2018 09:00,41.79,57509,1243,6,217,1988,10,3464,2.277.916.667
22/03/2018 10:00,41.37,57087,1085,14,222,1872,11,3204,2.277.916.667
22/03/2018 11:00,41.03,56355,928,30,219,1726,14,2917,2.277.916.667
22/03/2018 12:00,40.83,55693,865,49,215,1651,14,2794,2.277.916.667
22/03/2018 13:00,40.51,55148,779,62,204,1577,17,2639,2.277.916.667
22/03/2018 14:00,41.29,54699,735,73,170,1414,18,2410,2.277.916.667
22/03/2018 15:00,42.38,54337,642,83,147,1355,21,2248,2.277.916.667
22/03/2018 16:00,42.38,54479,563,88,128,1246,24,2049,2.277.916.667
22/03/2018 17:00,43.84,55304,452,90,122,1240,23,1927,2.277.916.667
22/03/2018 18:00,50.1,56224,321,96,117,1161,19,1714,2.277.916.667
22/03/2018 19:00,49.5,56384,248,100,107,975,16,1446,2.277.916.667
22/03/2018 20:00,45.18,55340,201,101,98,891,12,1303,2.277.916.667
22/03/2018 21:00,43.82,53949,170,99,93,729,15,1106,2.277.916.667
22/03/2018 22:00,42.04,52010,160,97,90,565,15,927,2.277.916.667
22/03/2018 23:00,41.43,49610,140,94,80,450,15,779,2.277.916.667
23/03/2018 00:00,41.39,48243,210,95,47,366,5,723,2.277.916.667
23/03/2018 01:00,41.12,47435,228,93,39,310,4,674,2.277.916.667
23/03/2018 02:00,40.95,47243,263,91,27,274,4,659,2.277.916.667
23/03/2018 03:00,40.49,47529,276,91,19,262,4,652,2.277.916.667
23/03/2018 04:00,40.47,48364,329,93,14,234,4,674,2.277.916.667
23/03/2018 05:00,42.78,50467,404,100,9,230,4,747,2.277.916.667
23/03/2018 06:00,50.68,53881,470,106,7,233,4,820,2.277.916.667
23/03/2018 07:00,64.95,57361,591,113,4,216,4,928,2.277.916.667
23/03/2018 08:00,70.42,58287,699,122,3,265,4,1093,2.277.916.667
23/03/2018 09:00,62.43,57743,789,127,2,329,4,1251,2.277.916.667
23/03/2018 10:00,56.91,57036,946,134,1,385,4,1470,2.277.916.667
23/03/2018 11:00,52.4,56192,1164,143,1,513,4,1825,2.277.916.667
23/03/2018 12:00,46.95,55331,1363,150,3,649,4,2169,2.277.916.667
23/03/2018 13:00,44.03,54492,1518,159,5,772,4,2458,2.277.916.667
23/03/2018 14:00,42.95,53873,1644,170,6,943,5,2768,2.277.916.667
23/03/2018 15:00,42.4,53390,1724,177,7,1088,6,3002,2.277.916.667
23/03/2018 16:00,42.52,53434,1730,176,9,1229,6,3150,2.277.916.667
23/03/2018 17:00,43.49,54477,1753,170,13,1412,6,3354,2.277.916.667
23/03/2018 18:00,45.87,55784,1889,160,17,1618,5,3689,2.277.916.667
23/03/2018 19:00,43.62,55764,1915,146,20,1860,4,3945,2.277.916.667
23/03/2018 20:00,41.88,54348,1822,131,20,2009,4,3986,2.277.916.667
23/03/2018 21:00,41.18,52982,1850,114,20,2182,4,4170,2.277.916.667
23/03/2018 22:00,40.54,51354,1931,106,21,2322,4,4384,2.277.916.667
23/03/2018 23:00,39.59,49414,1934,95,26,2351,4,4410,2.277.916.667
24/03/2018 00:00,40.23,47263,1531,55,37,2409,6,4038,2.277.916.667
24/03/2018 01:00,38.95,46576,1438,54,40,2464,6,4002,2.277.916.667
24/03/2018 02:00,38.04,46167,1313,52,38,2446,6,3855,2.277.916.667
24/03/2018 03:00,37.5,46159,1254,52,38,2399,6,3749,2.277.916.667
24/03/2018 04:00,38.14,46491,1206,53,36,2469,7,3771,2.277.916.667
24/03/2018 05:00,38.35,46971,1180,51,26,2436,7,3700,2.277.916.667
24/03/2018 06:00,38.86,47685,1142,48,20,2411,7,3628,2.277.916.667
24/03/2018 07:00,40.18,48989,1077,44,14,2356,7,3498,2.277.916.667
24/03/2018 08:00,41.58,50426,886,42,11,2262,7,3208,2.277.916.667
24/03/2018 09:00,41.5,51383,787,40,11,2082,7,2927,2.277.916.667
24/03/2018 10:00,40.67,51630,817,37,17,1999,7,2877,2.277.916.667
24/03/2018 11:00,40.15,51201,856,34,22,2035,8,2955,2.277.916.667
24/03/2018 12:00,39.72,50588,889,33,27,1961,9,2919,2.277.916.667
24/03/2018 13:00,39.23,49873,880,33,32,1957,11,2913,2.277.916.667
24/03/2018 14:00,39.15,49437,870,32,35,1932,15,2884,2.277.916.667
24/03/2018 15:00,39.42,49269,852,33,39,1985,17,2926,2.277.916.667
24/03/2018 16:00,40.54,49782,779,36,38,1952,18,2823,2.277.916.667
24/03/2018 17:00,42.57,51131,668,41,41,1983,19,2752,2.277.916.667
24/03/2018 18:00,44.14,52314,630,48,44,2034,13,2769,2.277.916.667
24/03/2018 19:00,43.81,52003,614,53,54,2203,13,2937,2.277.916.667
24/03/2018 20:00,42.32,50630,627,58,72,2251,12,3020,2.277.916.667
24/03/2018 21:00,42.01,49476,644,62,90,2288,14,3098,2.277.916.667
24/03/2018 22:00,40.27,48215,743,66,102,2282,14,3207,2.277.916.667
24/03/2018 23:00,38.68,46878,761,72,115,2268,16,3232,2.277.916.667
25/03/2018 00:00,38.52,45295,417,89,128,2340,15,2989,2.277.916.667
25/03/2018 01:00,38.38,44505,380,99,133,2293,15,2920,2.277.916.667
25/03/2018 02:00,38.365,44411.5,345.5,108,136,2356,11,2956.5,2.277.916.667
25/03/2018 03:00,38.35,44318,311,118,133,2351,11,2924,2.277.916.667
25/03/2018 04:00,37.66,44497,249,126,130,2329,9,2843,2.277.916.667
25/03/2018 05:00,38.01,44854,215,129,124,2261,8,2737,2.277.916.667
25/03/2018 06:00,38.29,45230,219,128,117,2254,9,2727,2.277.916.667
25/03/2018 07:00,38.67,46249,229,125,111,2077,10,2552,2.277.916.667
25/03/2018 08:00,39.64,47590,222,127,106,1814,13,2282,2.277.916.667
25/03/2018 09:00,40.92,48726,198,131,107,1608,15,2059,2.277.916.667
25/03/2018 10:00,41.02,49165,198,135,116,1372,16,1837,2.277.916.667
25/03/2018 11:00,40.82,48951,229,137,126,1397,17,1906,2.277.916.667
25/03/2018 12:00,40.28,48482,268,138,141,1365,17,1929,2.277.916.667
25/03/2018 13:00,39.66,47893,307,140,149,1424,16,2036,2.277.916.667
25/03/2018 14:00,39.11,47443,352,139,139,1383,14,2027,2.277.916.667
25/03/2018 15:00,38.62,47169,402,137,110,1390,12,2051,2.277.916.667
25/03/2018 16:00,38.25,47668,486,134,89,1408,11,2128,2.277.916.667
25/03/2018 17:00,38.89,48945,533,136,75,1516,9,2269,2.277.916.667
25/03/2018 18:00,40.96,50589,474,137,72,1660,7,2350,2.277.916.667
25/03/2018 19:00,43.77,51130,454,138,69,1761,6,2428,2.277.916.667
25/03/2018 20:00,43.07,50725,457,139,71,1782,6,2455,2.277.916.667
25/03/2018 21:00,42,50019,475,138,77,1841,5,2536,2.277.916.667
25/03/2018 22:00,41.11,48554,522,137,85,1840,5,2589,2.277.916.667
25/03/2018 23:00,39.54,46794,604,132,103,1792,14,2645,2.277.916.667
26/03/2018 00:00,40.36,46015,523,124,108,1766,12,2533,2.057.321.429
26/03/2018 01:00,39.53,45381,563,116,110,1733,10,2532,2.057.321.429
26/03/2018 02:00,38.92,45399,599,107,111,1680,9,2506,2.057.321.429
26/03/2018 03:00,38.01,45785,599,99,110,1653,8,2469,2.057.321.429
26/03/2018 04:00,39.32,46655,556,89,99,1642,7,2393,2.057.321.429
26/03/2018 05:00,41.29,48873,552,83,81,1635,6,2357,2.057.321.429
26/03/2018 06:00,45.91,52567,577,74,63,1607,4,2325,2.057.321.429
26/03/2018 07:00,51.6,56229,580,64,54,1569,4,2271,2.057.321.429
26/03/2018 08:00,63.81,57518,534,50,47,1466,3,2100,2.057.321.429
26/03/2018 09:00,67.59,57443,538,42,45,1408,4,2037,2.057.321.429
26/03/2018 10:00,57.93,57139,586,40,46,1248,5,1925,2.057.321.429
26/03/2018 11:00,54.88,56511,636,39,51,1200,8,1934,2.057.321.429
26/03/2018 12:00,51.97,55774,665,38,54,1090,9,1856,2.057.321.429
26/03/2018 13:00,50.54,55205,728,36,56,1021,9,1850,2.057.321.429
26/03/2018 14:00,47.92,54761,732,31,57,967,7,1794,2.057.321.429
26/03/2018 15:00,45.34,54387,697,26,59,1015,9,1806,2.057.321.429
26/03/2018 16:00,44.03,54131,775,20,70,1016,9,1890,2.057.321.429
26/03/2018 17:00,45.03,54716,748,15,79,1089,9,1940,2.057.321.429
26/03/2018 18:00,49.18,55429,583,12,88,1199,9,1891,2.057.321.429
26/03/2018 19:00,52.83,55783,503,10,95,1275,10,1893,2.057.321.429
26/03/2018 20:00,48.06,55278,433,8,101,1377,12,1931,2.057.321.429
26/03/2018 21:00,45.34,54051,402,6,106,1551,12,2077,2.057.321.429
26/03/2018 22:00,43.64,52193,360,6,104,1642,12,2124,2.057.321.429
26/03/2018 23:00,42.1,50001,317,56,197,1791,12,2373,2.057.321.429
27/03/2018 00:00,42.39,48506,276,44,125,1761,12,2218,2.057.321.429
27/03/2018 01:00,40.14,47781,293,42,124,1768,12,2239,2.057.321.429
27/03/2018 02:00,39.69,47717,297,50,126,1756,12,2241,2.057.321.429
27/03/2018 03:00,39.49,48051,335,72,132,1739,12,2290,2.057.321.429
27/03/2018 04:00,39.78,48975,359,92,133,1692,12,2288,2.057.321.429
27/03/2018 05:00,41.48,50970,391,101,123,1668,12,2295,2.057.321.429
27/03/2018 06:00,45.4,54383,402,107,115,1560,12,2196,2.057.321.429
27/03/2018 07:00,54.84,57644,506,108,104,1385,12,2115,2.057.321.429
27/03/2018 08:00,67.48,58636,582,113,95,1165,12,1967,2.057.321.429
27/03/2018 09:00,60.69,58208,665,110,90,1046,12,1923,2.057.321.429
27/03/2018 10:00,56.82,57669,774,104,79,978,12,1947,2.057.321.429
27/03/2018 11:00,52.93,57043,896,93,66,963,12,2030,2.057.321.429
27/03/2018 12:00,47.64,56337,1040,82,49,985,12,2168,2.057.321.429
27/03/2018 13:00,44.99,55634,1147,73,32,1024,12,2288,2.057.321.429
27/03/2018 14:00,43.98,55228,1239,65,31,1001,12,2348,2.057.321.429
27/03/2018 15:00,42.99,54837,1383,57,32,1031,12,2515,2.057.321.429
27/03/2018 16:00,42.86,54638,1489,47,44,1120,12,2712,2.057.321.429
27/03/2018 17:00,43.5,55121,1704,40,53,1282,12,3091,2.057.321.429
27/03/2018 18:00,44.2,55803,2033,38,63,1465,12,3611,2.057.321.429
27/03/2018 19:00,45.07,56101,2296,38,71,1568,12,3985,2.057.321.429
27/03/2018 20:00,43.9,55758,2661,39,74,1658,12,4444,2.057.321.429
27/03/2018 21:00,41.41,54684,2787,39,80,1721,12,4639,2.057.321.429
27/03/2018 22:00,40.41,52959,2895,37,78,1751,12,4773,2.057.321.429
27/03/2018 23:00,39.38,50879,3113,30,74,1754,3,4974,2.057.321.429
28/03/2018 00:00,40.57,49313,2585,25,51,1678,2,4341,2.057.321.429
28/03/2018 01:00,40.27,48643,2695,21,38,1617,1,4372,2.057.321.429
28/03/2018 02:00,40.09,48530,2845,18,31,1511,1,4406,2.057.321.429
28/03/2018 03:00,40.06,48868,2901,15,26,1500,1,4443,2.057.321.429
28/03/2018 04:00,40.42,49766,3156,12,21,1435,1,4625,2.057.321.429
28/03/2018 05:00,41.3,51825,3328,11,15,1341,1,4696,2.057.321.429
28/03/2018 06:00,43.72,55351,3388,10,10,1277,1,4686,2.057.321.429
28/03/2018 07:00,47.19,58647,3442,9,7,1157,1,4616,2.057.321.429
28/03/2018 08:00,50.11,59454,3618,9,5,1059,1,4692,2.057.321.429
28/03/2018 09:00,49.2,58912,3738,10,4,1011,2,4765,2.057.321.429
28/03/2018 10:00,46.92,58356,3837,12,3,1015,2,4869,2.057.321.429
28/03/2018 11:00,44.99,57611,4036,14,3,1030,2,5085,2.057.321.429
28/03/2018 12:00,43.6,56595,4210,16,3,1060,2,5291,2.057.321.429
28/03/2018 13:00,42.55,55688,4267,18,3,1058,2,5348,2.057.321.429
28/03/2018 14:00,42.34,55164,4270,20,5,1117,3,5415,2.057.321.429
28/03/2018 15:00,41.68,54689,4362,22,8,1156,4,5552,2.057.321.429
28/03/2018 16:00,41.44,54501,4404,21,21,1196,4,5646,2.057.321.429
28/03/2018 17:00,41.86,54974,4464,20,43,1291,5,5823,2.057.321.429
28/03/2018 18:00,42.86,55768,4563,21,75,1443,3,6105,2.057.321.429
28/03/2018 19:00,43.8,56062,4600,23,101,1582,4,6310,2.057.321.429
28/03/2018 20:00,43.48,55598,4613,23,120,1710,5,6471,2.057.321.429
28/03/2018 21:00,41.81,54497,4485,22,135,1902,4,6548,2.057.321.429
28/03/2018 22:00,39.95,52689,4328,21,147,2118,4,6618,2.057.321.429
28/03/2018 23:00,39.26,50754,4205,16,163,2192,5,6581,2.057.321.429
29/03/2018 00:00,39.04,48911,4355,13,171,2226,6,6771,2.057.321.429
29/03/2018 01:00,38.37,48182,4357,10,179,2343,6,6895,2.057.321.429
29/03/2018 02:00,38.13,48136,4295,8,188,2431,7,6929,2.057.321.429
29/03/2018 03:00,38.32,48409,4193,7,197,2567,8,6972,2.057.321.429
29/03/2018 04:00,38.64,49063,4054,7,202,2616,9,6888,2.057.321.429
29/03/2018 05:00,39.41,50424,3930,8,215,2638,10,6801,2.057.321.429
29/03/2018 06:00,39.85,52430,3782,8,224,2649,11,6674,2.057.321.429
29/03/2018 07:00,42.3,54346,3669,8,247,2595,9,6528,2.057.321.429
29/03/2018 08:00,43.1,55611,3533,10,294,2489,8,6334,2.057.321.429
29/03/2018 09:00,42.97,55991,3346,13,332,2422,13,6126,2.057.321.429
29/03/2018 10:00,41.22,56009,3147,17,365,2384,16,5929,2.057.321.429
29/03/2018 11:00,40.62,55477,3100,21,383,2394,16,5914,2.057.321.429
29/03/2018 12:00,40.1,54523,3043,25,397,2461,17,5943,2.057.321.429
29/03/2018 13:00,39.76,53743,2938,28,398,2448,17,5829,2.057.321.429
29/03/2018 14:00,39.46,53226,2724,32,386,2429,17,5588,2.057.321.429
29/03/2018 15:00,39.62,52919,2561,34,376,2344,19,5334,2.057.321.429
29/03/2018 16:00,39.84,52823,2356,32,372,2262,19,5041,2.057.321.429
29/03/2018 17:00,41.51,53493,2174,28,369,2197,15,4783,2.057.321.429
29/03/2018 18:00,42.09,54252,2015,27,370,2145,13,4570,2.057.321.429
29/03/2018 19:00,43.57,54553,1832,25,369,2068,15,4309,2.057.321.429
29/03/2018 20:00,42.61,54309,1707,23,361,1989,16,4096,2.057.321.429
29/03/2018 21:00,42.46,53398,1561,21,356,1947,16,3901,2.057.321.429
29/03/2018 22:00,42.06,51730,1416,18,340,1858,16,3648,2.057.321.429
29/03/2018 23:00,40.87,49674,1278,30,295,1833,28,3464,2.057.321.429
30/03/2018 00:00,39.86,47816,1035,26,232,1730,26,3049,2.057.321.429
30/03/2018 01:00,39.43,46999,910,21,189,1610,23,2753,2.057.321.429
30/03/2018 02:00,39.13,46807,812,18,154,1497,19,2500,2.057.321.429
30/03/2018 03:00,39.23,46810,771,15,131,1430,18,2365,2.057.321.429
30/03/2018 04:00,39.34,47128,746,10,114,1356,18,2244,2.057.321.429
30/03/2018 05:00,39.88,47501,740,7,104,1280,17,2148,2.057.321.429
30/03/2018 06:00,39.98,48063,743,5,99,1192,14,2053,2.057.321.429
30/03/2018 07:00,41.35,49185,761,3,95,1058,13,1930,2.057.321.429
30/03/2018 08:00,43.42,50717,824,2,101,882,12,1821,2.057.321.429
30/03/2018 09:00,43.07,51795,878,2,109,715,9,1713,2.057.321.429
30/03/2018 10:00,41.73,52187,919,2,119,570,9,1619,2.057.321.429
30/03/2018 11:00,41.29,51792,962,3,130,514,9,1618,2.057.321.429
30/03/2018 12:00,40.77,51034,971,4,136,488,7,1606,2.057.321.429
30/03/2018 13:00,40.29,50429,1020,5,137,455,5,1622,2.057.321.429
30/03/2018 14:00,40.06,50033,1003,5,127,424,6,1565,2.057.321.429
30/03/2018 15:00,40.01,49992,1071,7,127,404,5,1614,2.057.321.429
30/03/2018 16:00,40.28,50079,1110,10,122,400,3,1645,2.057.321.429
30/03/2018 17:00,40.85,50765,1172,15,110,447,2,1746,2.057.321.429
30/03/2018 18:00,41.31,51364,1368,23,102,510,3,2006,2.057.321.429
30/03/2018 19:00,41.8,51766,1396,31,99,540,4,2070,2.057.321.429
30/03/2018 20:00,41.52,52076,1504,37,98,572,4,2215,2.057.321.429
30/03/2018 21:00,41.51,51762,1664,41,103,592,3,2403,2.057.321.429
30/03/2018 22:00,40.62,50422,1736,42,92,649,2,2521,2.057.321.429
30/03/2018 23:00,39.52,48582,1710,0,21,605,3,2339,2.057.321.429
31/03/2018 00:00,39.99,47054,2102,6,15,567,3,2693,2.057.321.429
31/03/2018 01:00,40.02,46379,2126,11,8,622,3,2770,2.057.321.429
31/03/2018 02:00,39.93,46236,2183,18,4,590,4,2799,2.057.321.429
31/03/2018 03:00,39.95,46292,2246,24,2,597,4,2873,2.057.321.429
31/03/2018 04:00,39.95,46501,2357,30,2,602,3,2994,2.057.321.429
31/03/2018 05:00,39.75,46867,2554,36,2,605,4,3201,2.057.321.429
31/03/2018 06:00,39.57,47265,2625,40,2,593,4,3264,2.057.321.429
31/03/2018 07:00,39.74,48209,2640,45,3,594,3,3285,2.057.321.429
31/03/2018 08:00,40.56,49750,2697,54,8,569,3,3331,2.057.321.429
31/03/2018 09:00,40.76,50808,2763,67,12,554,4,3400,2.057.321.429
31/03/2018 10:00,40.55,51007,2777,82,20,547,4,3430,2.057.321.429
31/03/2018 11:00,39.99,50468,2912,93,40,553,4,3602,2.057.321.429
31/03/2018 12:00,39.82,49796,2949,104,58,610,4,3725,2.057.321.429
31/03/2018 13:00,39.55,49195,2847,116,76,660,4,3703,2.057.321.429
31/03/2018 14:00,39.13,48792,2649,127,110,732,5,3623,2.057.321.429
31/03/2018 15:00,38.93,48679,2513,140,145,799,6,3603,2.057.321.429
31/03/2018 16:00,38.8,48828,2468,155,190,874,8,3695,2.057.321.429
31/03/2018 17:00,39.3,49465,2419,162,247,922,10,3760,2.057.321.429
31/03/2018 18:00,40.06,50092,2335,165,299,974,11,3784,2.057.321.429
31/03/2018 19:00,40.73,50421,2158,169,327,1011,11,3676,2.057.321.429
31/03/2018 20:00,40.74,50815,2001,169,342,1029,11,3552,2.057.321.429
31/03/2018 21:00,40.22,50547,1855,163,355,1020,14,3407,2.057.321.429
31/03/2018 22:00,39.97,49355,1707,158,369,1015,16,3265,2.057.321.429
31/03/2018 23:00,39.56,47613,1626,151,354,938,13,3082,2.057.321.429
01/04/2018 00:00,39.8,45565,1236,162,378,929,15,2720,2.057.321.429
01/04/2018 01:00,39.57,44989,1210,158,393,940,16,2717,2.057.321.429
01/04/2018 02:00,39.43,44904,1180,148,396,963,18,2705,2.057.321.429
01/04/2018 03:00,39.39,44957,1208,140,401,1025,21,2795,2.057.321.429
01/04/2018 04:00,39.5,45271,1216,132,422,1098,21,2889,2.057.321.429
01/04/2018 05:00,39.33,45650,1271,124,434,1189,21,3039,2.057.321.429
01/04/2018 06:00,39.51,46081,1332,118,438,1257,24,3169,2.057.321.429
01/04/2018 07:00,39.39,46676,1397,118,437,1234,24,3210,2.057.321.429
01/04/2018 08:00,39.62,47832,1495,121,433,1196,26,3271,2.057.321.429
01/04/2018 09:00,39.61,48847,1594,125,429,1182,27,3357,2.057.321.429
01/04/2018 10:00,39.52,49126,1663,130,420,1158,31,3402,2.057.321.429
01/04/2018 11:00,39.17,48871,1774,136,389,1160,32,3491,2.057.321.429
01/04/2018 12:00,38.86,48347,1821,141,362,1168,30,3522,2.057.321.429
01/04/2018 13:00,38.48,47777,1830,144,331,1183,28,3516,2.057.321.429
01/04/2018 14:00,38.15,47241,1807,143,307,1179,27,3463,2.057.321.429
01/04/2018 15:00,38.03,47042,1803,137,278,1180,25,3423,2.057.321.429
01/04/2018 16:00,38.13,47154,1844,128,241,1187,25,3425,2.057.321.429
01/04/2018 17:00,38.59,47765,1853,116,196,1178,24,3367,2.057.321.429
01/04/2018 18:00,39.22,48440,1759,104,157,1188,22,3230,2.057.321.429
01/04/2018 19:00,39.64,49207,1539,97,128,1185,21,2970,2.057.321.429
01/04/2018 20:00,40,49732,1395,90,109,1192,19,2805,2.057.321.429
01/04/2018 21:00,39.89,49475,1276,81,96,1207,18,2678,2.057.321.429
01/04/2018 22:00,39.81,48380,1132,71,93,1228,16,2540,2.057.321.429
01/04/2018 23:00,39.22,46856,1017,56,101,1268,13,2455,2.057.321.429
02/04/2018 00:00,39.38,44993,1002,57,103,1303,11,2476,1.876.904.762
02/04/2018 01:00,38.67,44470,1000,58,117,1341,9,2525,1.876.904.762
02/04/2018 02:00,38.43,44520,958,61,154,1394,9,2576,1.876.904.762
02/04/2018 03:00,38.33,44767,961,63,202,1439,9,2674,1.876.904.762
02/04/2018 04:00,38.61,45165,938,65,261,1442,11,2717,1.876.904.762
02/04/2018 05:00,39.27,45659,919,65,319,1424,12,2739,1.876.904.762
02/04/2018 06:00,39.96,46259,849,66,366,1356,14,2651,1.876.904.762
02/04/2018 07:00,39.62,47214,749,63,405,1225,17,2459,1.876.904.762
02/04/2018 08:00,40.33,48692,655,58,438,1091,20,2262,1.876.904.762
02/04/2018 09:00,40.56,49613,546,55,464,969,25,2059,1.876.904.762
02/04/2018 10:00,40.63,49911,486,54,481,917,32,1970,1.876.904.762
02/04/2018 11:00,40.32,49526,485,53,485,949,36,2008,1.876.904.762
02/04/2018 12:00,39.91,48840,480,52,488,1017,37,2074,1.876.904.762
02/04/2018 13:00,39.52,48296,488,51,488,1108,36,2171,1.876.904.762
02/04/2018 14:00,38.97,47890,425,51,484,1141,36,2137,1.876.904.762
02/04/2018 15:00,38.81,47641,374,48,477,1129,37,2065,1.876.904.762
02/04/2018 16:00,39.08,47718,304,47,456,1176,36,2019,1.876.904.762
02/04/2018 17:00,39.53,48402,225,47,429,1227,35,1963,1.876.904.762
02/04/2018 18:00,40.11,48958,151,48,400,1343,32,1974,1.876.904.762
02/04/2018 19:00,40.88,49645,128,49,360,1287,27,1851,1.876.904.762
02/04/2018 20:00,41.09,50374,136,48,321,1303,24,1832,1.876.904.762
02/04/2018 21:00,40.92,49958,157,46,281,1367,21,1872,1.876.904.762
02/04/2018 22:00,39.96,48518,200,43,246,1411,16,1916,1.876.904.762
02/04/2018 23:00,39.22,46932,301,186,212,1308,12,2019,1.876.904.762
03/04/2018 00:00,40.08,46143,1295,190,190,1295,12,2982,1.876.904.762
03/04/2018 01:00,39.36,45398,1581,188,164,1272,12,3217,1.876.904.762
03/04/2018 02:00,39.05,45554,1870,181,140,1251,12,3454,1.876.904.762
03/04/2018 03:00,39,45969,2210,176,119,1287,10,3802,1.876.904.762
03/04/2018 04:00,38.93,46791,2527,171,97,1302,8,4105,1.876.904.762
03/04/2018 05:00,40.41,48699,2766,167,79,1358,5,4375,1.876.904.762
03/04/2018 06:00,41.89,52897,2940,165,63,1392,3,4563,1.876.904.762
03/04/2018 07:00,45.38,56231,2917,160,49,1327,2,4455,1.876.904.762
03/04/2018 08:00,49.91,57222,2715,155,42,1204,2,4118,1.876.904.762
03/04/2018 09:00,47.82,56862,2519,148,33,1119,2,3821,1.876.904.762
03/04/2018 10:00,44.61,56429,2270,141,28,1084,2,3525,1.876.904.762
03/04/2018 11:00,43.93,55805,2027,135,26,1084,3,3275,1.876.904.762
03/04/2018 12:00,43.22,55056,1935,138,23,1111,3,3210,1.876.904.762
03/04/2018 13:00,43.16,54407,1767,143,28,1114,2,3054,1.876.904.762
03/04/2018 14:00,42.66,53991,1662,155,40,1098,2,2957,1.876.904.762
03/04/2018 15:00,42.3,53594,1605,156,57,1099,2,2919,1.876.904.762
03/04/2018 16:00,42.94,53379,1626,154,86,1159,2,3027,1.876.904.762
03/04/2018 17:00,44.52,53782,1605,157,124,1265,2,3153,1.876.904.762
03/04/2018 18:00,47.51,54143,1641,165,167,1397,3,3373,1.876.904.762
03/04/2018 19:00,49.74,54426,1692,169,177,1515,4,3557,1.876.904.762
03/04/2018 20:00,46.92,54303,1825,172,154,1624,5,3780,1.876.904.762
03/04/2018 21:00,42.88,53258,1921,174,127,1783,6,4011,1.876.904.762
03/04/2018 22:00,40.47,51330,1913,172,105,1915,6,4111,1.876.904.762
03/04/2018 23:00,39.13,48897,2034,175,62,2010,7,4288,1.876.904.762
04/04/2018 00:00,39.01,47143,1560,177,44,2087,7,3875,1.876.904.762
04/04/2018 01:00,38.37,46301,1482,175,34,2158,6,3855,1.876.904.762
04/04/2018 02:00,38.42,46040,1489,172,32,2213,6,3912,1.876.904.762
04/04/2018 03:00,38.33,46132,1613,170,31,2309,7,4130,1.876.904.762
04/04/2018 04:00,38.63,46724,1668,164,39,2456,7,4334,1.876.904.762
04/04/2018 05:00,39.93,48445,1764,154,57,2526,7,4508,1.876.904.762
04/04/2018 06:00,42.54,51868,1782,143,75,2661,8,4669,1.876.904.762
04/04/2018 07:00,48.78,55210,1702,130,92,2697,8,4629,1.876.904.762
04/04/2018 08:00,58.02,56075,1579,123,101,2619,8,4430,1.876.904.762
04/04/2018 09:00,51.98,55657,1538,116,109,2700,9,4472,1.876.904.762
04/04/2018 10:00,46.66,55174,1392,111,119,2626,10,4258,1.876.904.762
04/04/2018 11:00,44.48,54351,1341,107,132,2538,14,4132,1.876.904.762
04/04/2018 12:00,42.4,53404,1266,98,137,2467,17,3985,1.876.904.762
04/04/2018 13:00,41.95,52802,1076,84,138,2287,16,3601,1.876.904.762
04/04/2018 14:00,41.31,52373,1000,67,121,2181,14,3383,1.876.904.762
04/04/2018 15:00,41.07,51888,895,50,110,1968,10,3033,1.876.904.762
04/04/2018 16:00,41.03,51670,869,40,108,1708,10,2735,1.876.904.762
04/04/2018 17:00,41.48,52052,912,34,131,1529,10,2616,1.876.904.762
04/04/2018 18:00,42.49,52358,1049,31,153,1380,9,2622,1.876.904.762
04/04/2018 19:00,42.77,52503,1338,30,165,1335,8,2876,1.876.904.762
04/04/2018 20:00,44,52301,1668,30,180,1334,9,3221,1.876.904.762
04/04/2018 21:00,42.37,51182,1967,29,185,1329,10,3520,1.876.904.762
04/04/2018 22:00,40.17,49332,2046,27,190,1307,10,3580,1.876.904.762
04/04/2018 23:00,38.39,47317,2168,19,129,1065,3,3384,1.876.904.762
05/04/2018 00:00,39.13,45935,1235,18,128,1017,3,2401,1.876.904.762
05/04/2018 01:00,38.5,44956,1305,21,123,1037,1,2487,1.876.904.762
05/04/2018 02:00,38.49,44677,1231,27,117,1041,1,2417,1.876.904.762
05/04/2018 03:00,38.95,44860,1154,34,109,1017,2,2316,1.876.904.762
05/04/2018 04:00,38.9,45584,910,43,96,997,3,2049,1.876.904.762
05/04/2018 05:00,40.25,47506,832,54,86,1004,5,1981,1.876.904.762
05/04/2018 06:00,42.25,50912,810,58,74,977,6,1925,1.876.904.762
05/04/2018 07:00,47.03,54285,817,53,59,875,6,1810,1.876.904.762
05/04/2018 08:00,50.21,55224,811,49,49,831,6,1746,1.876.904.762
05/04/2018 09:00,48.78,55065,948,54,48,766,4,1820,1.876.904.762
05/04/2018 10:00,46.4,54718,1033,63,56,841,6,1999,1.876.904.762
05/04/2018 11:00,44.26,54087,1162,76,73,936,7,2254,1.876.904.762
05/04/2018 12:00,42.76,53451,1402,92,83,1049,9,2635,1.876.904.762
05/04/2018 13:00,42.2,53021,1731,105,84,1155,9,3084,1.876.904.762
05/04/2018 14:00,41.2,52597,2302,117,74,1254,9,3756,1.876.904.762
05/04/2018 15:00,40.96,52206,3004,127,62,1359,10,4562,1.876.904.762
05/04/2018 16:00,40.98,52111,3781,133,58,1463,10,5445,1.876.904.762
05/04/2018 17:00,41.03,52444,4289,141,53,1660,9,6152,1.876.904.762
05/04/2018 18:00,41.39,52757,4504,150,50,1879,9,6592,1.876.904.762
05/04/2018 19:00,41.95,52987,4619,151,49,2107,9,6935,1.876.904.762
05/04/2018 20:00,41.92,52686,4537,132,47,2394,9,7119,1.876.904.762
05/04/2018 21:00,40.95,51657,4408,107,49,2677,9,7250,1.876.904.762
05/04/2018 22:00,39.93,49717,4195,87,63,2860,8,7213,1.876.904.762
05/04/2018 23:00,38.09,47554,4098,95,86,2936,11,7226,1.876.904.762
06/04/2018 00:00,37.52,45886,3998,72,112,3130,12,7324,1.876.904.762
06/04/2018 01:00,37.04,45102,3742,54,163,3269,16,7244,1.876.904.762
06/04/2018 02:00,36.91,45018,3561,42,243,3387,18,7251,1.876.904.762
06/04/2018 03:00,36.86,45252,3422,33,323,3518,22,7318,1.876.904.762
06/04/2018 04:00,36.91,46041,3075,29,383,3760,36,7283,1.876.904.762
06/04/2018 05:00,38.74,48030,2883,30,406,4061,38,7418,1.876.904.762
06/04/2018 06:00,41.46,51451,2613,35,422,4310,40,7420,1.876.904.762
06/04/2018 07:00,45.74,54766,2468,37,441,4466,42,7454,1.876.904.762
06/04/2018 08:00,49.46,55855,2279,40,457,4597,43,7416,1.876.904.762
06/04/2018 09:00,43.95,55569,2067,42,461,4755,45,7370,1.876.904.762
06/04/2018 10:00,41.99,55140,1905,46,463,4845,45,7304,1.876.904.762
06/04/2018 11:00,40.87,54313,1795,51,467,4813,45,7171,1.876.904.762
06/04/2018 12:00,40.44,53420,1562,58,468,4707,45,6840,1.876.904.762
06/04/2018 13:00,40.15,52486,1331,63,470,4617,43,6524,1.876.904.762
06/04/2018 14:00,39.61,51599,1122,64,464,4393,44,6087,1.876.904.762
06/04/2018 15:00,39.45,50853,894,68,456,4096,43,5557,1.876.904.762
06/04/2018 16:00,39.83,50488,675,73,440,3774,45,5007,1.876.904.762
06/04/2018 17:00,40.26,50889,459,84,408,3261,43,4255,1.876.904.762
06/04/2018 18:00,40.57,51337,325,91,375,2920,38,3749,1.876.904.762
06/04/2018 19:00,41.46,51390,331,97,337,2689,35,3489,1.876.904.762
06/04/2018 20:00,41.2,50984,508,102,295,2369,32,3306,1.876.904.762
06/04/2018 21:00,40.58,50055,853,101,234,2264,27,3479,1.876.904.762
06/04/2018 22:00,39.62,48589,1222,93,172,2120,23,3630,1.876.904.762
06/04/2018 23:00,37.42,46885,1619,28,159,1827,15,3648,1.876.904.762
07/04/2018 00:00,38.43,45027,2061,26,110,1799,13,4009,1.876.904.762
07/04/2018 01:00,37.71,44401,2337,24,72,1861,12,4306,1.876.904.762
07/04/2018 02:00,37.37,44131,2507,24,51,1974,9,4565,1.876.904.762
07/04/2018 03:00,37.31,44120,2643,24,39,2215,5,4926,1.876.904.762
07/04/2018 04:00,37.82,44436,2722,23,23,2262,3,5033,1.876.904.762
07/04/2018 05:00,38.17,44884,2875,20,17,2347,2,5261,1.876.904.762
07/04/2018 06:00,38.38,45752,2900,17,12,2407,2,5338,1.876.904.762
07/04/2018 07:00,38.83,47057,2968,12,11,2296,2,5289,1.876.904.762
07/04/2018 08:00,39.9,48569,3063,10,11,2213,2,5299,1.876.904.762
07/04/2018 09:00,40.48,49566,3058,10,11,2144,2,5225,1.876.904.762
07/04/2018 10:00,40.52,49560,2988,11,17,2116,2,5134,1.876.904.762
07/04/2018 11:00,39.72,48972,2866,13,27,2180,2,5088,1.876.904.762
07/04/2018 12:00,39.12,48248,2674,17,32,2247,3,4973,1.876.904.762
07/04/2018 13:00,38.68,47424,2505,22,43,2194,3,4767,1.876.904.762
07/04/2018 14:00,38.19,46777,2217,27,54,2167,4,4469,1.876.904.762
07/04/2018 15:00,38.06,46546,1950,28,65,2085,4,4132,1.876.904.762
07/04/2018 16:00,38.17,46879,1675,29,91,2074,3,3872,1.876.904.762
07/04/2018 17:00,38.95,47728,1480,31,135,1986,2,3634,1.876.904.762
07/04/2018 18:00,39.53,48398,1340,34,184,1993,3,3554,1.876.904.762
07/04/2018 19:00,40.49,48415,1225,38,233,1969,9,3474,1.876.904.762
07/04/2018 20:00,40.52,48296,1306,40,278,2016,19,3659,1.876.904.762
07/04/2018 21:00,39.09,47802,1077,41,307,2001,23,3449,1.876.904.762
07/04/2018 22:00,38.37,46643,901,41,319,1868,24,3153,1.876.904.762
07/04/2018 23:00,38.62,45319,896,26,266,1645,27,2860,1.876.904.762
08/04/2018 00:00,39.03,43541,948,31,261,1467,28,2735,1.876.904.762
08/04/2018 01:00,38.67,42895,846,38,251,1292,28,2455,1.876.904.762
08/04/2018 02:00,38.54,42675,777,44,245,1170,27,2263,1.876.904.762
08/04/2018 03:00,38.75,42606,735,47,240,1036,25,2083,1.876.904.762
08/04/2018 04:00,39.03,42803,704,50,229,956,22,1961,1.876.904.762
08/04/2018 05:00,39.26,43099,707,54,206,847,21,1835,1.876.904.762
08/04/2018 06:00,39.04,43509,679,55,183,748,21,1686,1.876.904.762
08/04/2018 07:00,38.92,44271,596,57,146,631,18,1448,1.876.904.762
08/04/2018 08:00,39.42,45446,525,60,113,494,14,1206,1.876.904.762
08/04/2018 09:00,39.82,46375,474,67,92,412,14,1059,1.876.904.762
08/04/2018 10:00,40.05,46706,413,76,86,391,15,981,1.876.904.762
08/04/2018 11:00,39.84,46511,394,87,86,410,15,992,1.876.904.762
08/04/2018 12:00,39.49,45869,395,102,86,494,15,1092,1.876.904.762
08/04/2018 13:00,39.12,45289,409,116,86,551,14,1176,1.876.904.762
08/04/2018 14:00,38.88,44757,465,131,69,580,13,1258,1.876.904.762
08/04/2018 15:00,38.8,44598,477,145,63,697,11,1393,1.876.904.762
08/04/2018 16:00,38.85,44815,494,159,68,841,7,1569,1.876.904.762
08/04/2018 17:00,39.07,45649,458,169,91,966,7,1691,1.876.904.762
08/04/2018 18:00,39.46,46527,427,173,114,1121,9,1844,1.876.904.762
08/04/2018 19:00,40.61,47101,411,176,140,1257,13,1997,1.876.904.762
08/04/2018 20:00,42.51,47578,408,175,162,1340,13,2098,1.876.904.762
08/04/2018 21:00,41.68,47194,432,173,173,1373,17,2168,1.876.904.762
08/04/2018 22:00,39.91,45740,402,172,173,1380,18,2145,1.876.904.762
08/04/2018 23:00,38.68,44194,393,106,209,1332,12,2052,1.876.904.762
09/04/2018 00:00,38.57,42250,253,112,198,1263,11,1837,1.729.821.429
09/04/2018 01:00,38.02,41405,210,118,193,1242,12,1775,1.729.821.429
09/04/2018 02:00,37.94,41238,201,124,188,1259,11,1783,1.729.821.429
09/04/2018 03:00,38.02,41476,200,133,188,1270,11,1802,1.729.821.429
09/04/2018 04:00,38.84,42356,210,145,183,1359,9,1906,1.729.821.429
09/04/2018 05:00,39.81,44683,219,158,172,1363,9,1921,1.729.821.429
09/04/2018 06:00,42.75,48466,228,166,151,1412,8,1965,1.729.821.429
09/04/2018 07:00,50.05,52108,219,170,125,1378,6,1898,1.729.821.429
09/04/2018 08:00,61,53303,179,169,109,1332,3,1792,1.729.821.429
09/04/2018 09:00,51.27,53239,161,170,94,1318,4,1747,1.729.821.429
09/04/2018 10:00,47.71,52855,163,167,96,1337,3,1766,1.729.821.429
09/04/2018 11:00,44.73,52161,171,167,107,1347,3,1795,1.729.821.429
09/04/2018 12:00,42.94,51309,212,157,130,1358,2,1859,1.729.821.429
09/04/2018 13:00,42.49,50716,272,149,131,1322,2,1876,1.729.821.429
09/04/2018 14:00,41.5,50285,301,150,109,1300,4,1864,1.729.821.429
09/04/2018 15:00,41.32,49793,317,168,75,1317,4,1881,1.729.821.429
09/04/2018 16:00,41.76,49555,358,177,63,1347,3,1948,1.729.821.429
09/04/2018 17:00,43.69,50140,454,184,57,1357,2,2054,1.729.821.429
09/04/2018 18:00,45.01,50517,614,191,46,1477,1,2329,1.729.821.429
09/04/2018 19:00,45.55,50946,787,198,43,1547,1,2576,1.729.821.429
09/04/2018 20:00,43.76,51077,929,206,37,1633,0,2805,1.729.821.429
09/04/2018 21:00,41.01,50223,1121,215,35,1828,0,3199,1.729.821.429
09/04/2018 22:00,39.63,48157,1212,219,34,1902,0,3367,1.729.821.429
09/04/2018 23:00,38.01,45750,1304,133,19,1850,1,3307,1.729.821.429
10/04/2018 00:00,38.24,43145,1303,139,19,1919,2,3382,1.729.821.429
10/04/2018 01:00,37.06,42310,1468,135,18,1971,3,3595,1.729.821.429
10/04/2018 02:00,37,42208,1658,134,17,1992,2,3803,1.729.821.429
10/04/2018 03:00,37.08,42501,1878,130,13,2027,3,4051,1.729.821.429
10/04/2018 04:00,37.39,43465,2128,123,12,2006,3,4272,1.729.821.429
10/04/2018 05:00,38.91,45712,2410,114,10,1998,4,4536,1.729.821.429
10/04/2018 06:00,40.77,49411,2656,102,7,1946,5,4716,1.729.821.429
10/04/2018 07:00,43.4,52965,2811,92,7,1928,4,4842,1.729.821.429
10/04/2018 08:00,44.86,53951,2918,77,7,1914,6,4922,1.729.821.429
10/04/2018 09:00,43.41,53549,3072,65,10,1916,8,5071,1.729.821.429
10/04/2018 10:00,41.85,52995,3138,59,16,1975,8,5196,1.729.821.429
10/04/2018 11:00,41.04,52253,3272,53,22,2031,9,5387,1.729.821.429
10/04/2018 12:00,41.85,51463,3431,47,25,2068,10,5581,1.729.821.429
10/04/2018 13:00,41.2,50644,3542,36,33,2114,10,5735,1.729.821.429
10/04/2018 14:00,39.83,50151,3623,24,51,2150,11,5859,1.729.821.429
10/04/2018 15:00,39.82,49664,3694,17,75,2198,13,5997,1.729.821.429
10/04/2018 16:00,39.76,49465,3791,15,109,2246,13,6174,1.729.821.429
10/04/2018 17:00,40.03,49843,3912,17,163,2317,12,6421,1.729.821.429
10/04/2018 18:00,40.73,50142,4070,27,230,2417,11,6755,1.729.821.429
10/04/2018 19:00,40.91,50356,3991,45,270,2473,13,6792,1.729.821.429
10/04/2018 20:00,40.31,50412,4050,72,272,2512,15,6921,1.729.821.429
10/04/2018 21:00,39.51,49849,4064,102,272,2657,16,7111,1.729.821.429
10/04/2018 22:00,39.04,48158,3964,119,276,2684,15,7058,1.729.821.429
10/04/2018 23:00,37.64,45869,3906,130,352,2658,18,7064,1.729.821.429
11/04/2018 00:00,38.15,43499,4038,143,359,2580,17,7137,1.729.821.429
11/04/2018 01:00,37.56,42744,3888,158,361,2625,18,7050,1.729.821.429
11/04/2018 02:00,37.28,42651,3820,167,361,2625,19,6992,1.729.821.429
11/04/2018 03:00,37.73,42896,3689,167,358,2650,18,6882,1.729.821.429
11/04/2018 04:00,37.94,43775,3620,160,357,2612,17,6766,1.729.821.429
11/04/2018 05:00,39.39,45779,3619,145,355,2565,18,6702,1.729.821.429
11/04/2018 06:00,40.36,49598,3573,122,353,2455,16,6519,1.729.821.429
11/04/2018 07:00,42.8,53130,3540,102,353,2313,14,6322,1.729.821.429
11/04/2018 08:00,44.69,54086,3522,95,353,2140,15,6125,1.729.821.429
11/04/2018 09:00,42.39,53616,3434,93,353,1928,19,5827,1.729.821.429
11/04/2018 10:00,41.58,52873,3336,90,353,1817,22,5618,1.729.821.429
11/04/2018 11:00,40.66,51984,3338,86,351,1844,23,5642,1.729.821.429
11/04/2018 12:00,40.33,50942,3320,80,347,1874,25,5646,1.729.821.429
11/04/2018 13:00,40.18,50229,3329,75,340,1861,26,5631,1.729.821.429
11/04/2018 14:00,39.9,49693,3376,72,335,1804,27,5614,1.729.821.429
11/04/2018 15:00,39.81,49160,3367,73,328,1777,26,5571,1.729.821.429
11/04/2018 16:00,39.87,48884,3414,72,318,1764,22,5590,1.729.821.429
11/04/2018 17:00,40.16,49093,3475,73,312,1805,18,5683,1.729.821.429
11/04/2018 18:00,40.4,49130,3535,80,311,1836,14,5776,1.729.821.429
11/04/2018 19:00,40.98,49371,3496,87,310,1851,16,5760,1.729.821.429
11/04/2018 20:00,41.28,49563,3522,92,304,1814,17,5749,1.729.821.429
11/04/2018 21:00,40.54,48975,3575,94,303,1819,18,5809,1.729.821.429
11/04/2018 22:00,39.73,47262,3423,90,300,1791,19,5623,1.729.821.429
11/04/2018 23:00,38.96,45052,3309,79,291,1784,18,5481,1.729.821.429
12/04/2018 00:00,39.39,43278,3795,73,283,1749,15,5915,1.729.821.429
12/04/2018 01:00,39.15,42321,3626,68,278,1737,14,5723,1.729.821.429
12/04/2018 02:00,39.08,42173,3529,64,276,1728,14,5611,1.729.821.429
12/04/2018 03:00,39.15,42492,3775,62,271,1763,15,5886,1.729.821.429
12/04/2018 04:00,39.25,43381,3721,55,257,1799,15,5847,1.729.821.429
12/04/2018 05:00,39.57,45407,3788,44,232,1811,16,5891,1.729.821.429
12/04/2018 06:00,40.8,48789,3787,33,211,1797,15,5843,1.729.821.429
12/04/2018 07:00,43.63,52096,3547,25,203,1795,9,5579,1.729.821.429
12/04/2018 08:00,44.38,52998,3377,23,200,1729,7,5336,1.729.821.429
12/04/2018 09:00,41.82,52343,3428,24,205,1767,8,5432,1.729.821.429
12/04/2018 10:00,40.91,51588,3572,27,218,1832,10,5659,1.729.821.429
12/04/2018 11:00,40.32,50585,3728,31,237,1988,14,5998,1.729.821.429
12/04/2018 12:00,40.01,49642,3727,35,251,2058,17,6088,1.729.821.429
12/04/2018 13:00,39.87,49031,3744,38,248,2123,17,6170,1.729.821.429
12/04/2018 14:00,39.44,48461,3778,43,247,2195,16,6279,1.729.821.429
12/04/2018 15:00,39.32,47941,3801,48,243,2234,15,6341,1.729.821.429
12/04/2018 16:00,39.37,47655,3908,50,246,2303,15,6522,1.729.821.429
12/04/2018 17:00,39.47,47792,4084,52,243,2379,12,6770,1.729.821.429
12/04/2018 18:00,39.65,47870,4207,57,247,2416,12,6939,1.729.821.429
12/04/2018 19:00,40.11,48163,4130,59,260,2464,14,6927,1.729.821.429
12/04/2018 20:00,39.83,48455,3963,58,282,2505,16,6824,1.729.821.429
12/04/2018 21:00,39.46,48160,3936,56,297,2596,18,6903,1.729.821.429
12/04/2018 22:00,39.12,46575,4006,52,304,2645,18,7025,1.729.821.429
12/04/2018 23:00,38.5,44445,4079,56,0,2639,19,6793,1.729.821.429
13/04/2018 00:00,38.32,42300,4123,52,0,2640,18,6833,1.729.821.429
13/04/2018 01:00,38.04,41525,4019,49,0,2619,17,6704,1.729.821.429
13/04/2018 02:00,38.01,41353,3850,46,0,2644,16,6556,1.729.821.429
13/04/2018 03:00,38.12,41583,3941,43,0,2624,18,6626,1.729.821.429
13/04/2018 04:00,38.16,42352,3948,39,0,2626,20,6633,1.729.821.429
13/04/2018 05:00,39.01,44336,3952,33,0,2658,21,6664,1.729.821.429
13/04/2018 06:00,40.63,47798,3994,26,0,2647,19,6686,1.729.821.429
13/04/2018 07:00,42.89,50979,4071,19,0,2584,15,6689,1.729.821.429
13/04/2018 08:00,42.93,51937,4106,17,0,2499,16,6638,1.729.821.429
13/04/2018 09:00,42.35,51351,4073,17,0,2492,19,6601,1.729.821.429
13/04/2018 10:00,41.3,50775,4010,18,0,2532,21,6581,1.729.821.429
13/04/2018 11:00,40.47,49740,3954,20,0,2640,20,6634,1.729.821.429
13/04/2018 12:00,39.67,48613,3866,22,0,2758,21,6667,1.729.821.429
13/04/2018 13:00,39.03,47606,3737,26,0,2816,22,6601,1.729.821.429
13/04/2018 14:00,38.95,46700,3679,31,0,2875,23,6608,1.729.821.429
13/04/2018 15:00,38.47,46032,3663,35,0,2938,22,6658,1.729.821.429
13/04/2018 16:00,38.96,45759,3702,39,0,3074,20,6835,1.729.821.429
13/04/2018 17:00,39.47,46005,3741,44,0,3335,20,7140,1.729.821.429
13/04/2018 18:00,39.6,46218,3759,50,0,3568,21,7398,1.729.821.429
13/04/2018 19:00,39.66,46103,3703,52,0,3680,23,7458,1.729.821.429
13/04/2018 20:00,39.48,46006,3704,51,0,3705,24,7484,1.729.821.429
13/04/2018 21:00,39.41,45521,3540,49,0,3815,24,7428,1.729.821.429
13/04/2018 22:00,39.01,44109,3206,44,0,3839,23,7112,1.729.821.429
13/04/2018 23:00,37.96,42511,2887,210,347,3792,23,7259,1.729.821.429
14/04/2018 00:00,36.58,40505,2004,210,346,3674,22,6256,1.729.821.429
14/04/2018 01:00,36.04,39745,1800,208,330,3492,21,5851,1.729.821.429
14/04/2018 02:00,35.9,39501,1616,197,324,3397,21,5555,1.729.821.429
14/04/2018 03:00,36,39550,1577,179,319,3291,21,5387,1.729.821.429
14/04/2018 04:00,36.3,39904,1431,153,313,3048,20,4965,1.729.821.429
14/04/2018 05:00,36.94,40288,1338,121,292,2824,20,4595,1.729.821.429
14/04/2018 06:00,37.71,41033,1226,89,260,2563,17,4155,1.729.821.429
14/04/2018 07:00,38.84,42244,1092,68,245,2170,13,3588,1.729.821.429
14/04/2018 08:00,39.72,43721,893,55,224,1680,12,2864,1.729.821.429
14/04/2018 09:00,39.92,44473,700,50,204,1180,12,2146,1.729.821.429
14/04/2018 10:00,39.87,44551,561,52,184,1042,12,1851,1.729.821.429
14/04/2018 11:00,39.77,43962,502,56,174,950,11,1693,1.729.821.429
14/04/2018 12:00,39.47,43116,458,63,163,892,11,1587,1.729.821.429
14/04/2018 13:00,39.14,42406,485,64,148,850,12,1559,1.729.821.429
14/04/2018 14:00,38.96,41798,525,59,137,772,10,1503,1.729.821.429
14/04/2018 15:00,38.87,41547,654,49,117,739,9,1568,1.729.821.429
14/04/2018 16:00,39.06,41827,779,44,106,680,7,1616,1.729.821.429
14/04/2018 17:00,39.2,42508,792,53,106,726,7,1684,1.729.821.429
14/04/2018 18:00,40.23,42958,743,73,118,828,9,1771,1.729.821.429
14/04/2018 19:00,41.37,42877,667,93,119,917,11,1807,1.729.821.429
14/04/2018 20:00,41.42,42919,632,115,109,1007,10,1873,1.729.821.429
14/04/2018 21:00,41.36,42658,606,136,98,1111,8,1959,1.729.821.429
14/04/2018 22:00,40.95,41623,578,148,87,1091,6,1910,1.729.821.429
14/04/2018 23:00,40.01,40433,591,148,76,1047,10,1872,1.729.821.429
15/04/2018 00:00,39.44,38695,476,151,56,1049,9,1741,1.729.821.429
15/04/2018 01:00,39.17,37981,446,147,44,1066,9,1712,1.729.821.429
15/04/2018 02:00,38.65,37793,404,137,40,1052,9,1642,1.729.821.429
15/04/2018 03:00,38.6,37854,387,128,41,1048,10,1614,1.729.821.429
15/04/2018 04:00,38.7,38015,349,117,42,981,10,1499,1.729.821.429
15/04/2018 05:00,38.77,38218,310,108,40,881,10,1349,1.729.821.429
15/04/2018 06:00,39.12,38599,268,100,36,824,10,1238,1.729.821.429
15/04/2018 07:00,39.56,39516,227,88,32,720,10,1077,1.729.821.429
15/04/2018 08:00,39.85,40893,185,76,31,569,9,870,1.729.821.429
15/04/2018 09:00,40.13,42033,162,64,35,453,9,723,1.729.821.429
15/04/2018 10:00,40.57,42544,176,54,36,396,9,671,1.729.821.429
15/04/2018 11:00,40.33,42425,215,46,40,382,9,692,1.729.821.429
15/04/2018 12:00,39.89,41930,211,41,46,366,9,673,1.729.821.429
15/04/2018 13:00,39.5,41462,191,35,41,352,9,628,1.729.821.429
15/04/2018 14:00,39.38,41132,158,29,34,351,9,581,1.729.821.429
15/04/2018 15:00,39.33,40981,162,25,27,308,9,531,1.729.821.429
15/04/2018 16:00,39.39,41077,179,24,23,311,9,546,1.729.821.429
15/04/2018 17:00,39.64,41715,215,26,26,328,9,604,1.729.821.429
15/04/2018 18:00,39.75,42262,257,33,30,368,9,697,1.729.821.429
15/04/2018 19:00,41.48,42528,287,43,32,391,9,762,1.729.821.429
15/04/2018 20:00,42.5,42890,291,53,35,403,9,791,1.729.821.429
15/04/2018 21:00,41.73,42846,295,62,39,420,9,825,1.729.821.429
15/04/2018 22:00,40.34,41563,304,74,40,447,9,874,1.729.821.429
15/04/2018 23:00,39.18,39938,304,48,186,418,2,958,1.729.821.429
16/04/2018 00:00,38.73,38224,227,47,183,376,2,835,1.781.964.286
16/04/2018 01:00,38.28,37433,233,47,167,349,2,798,1.781.964.286
16/04/2018 02:00,38.16,37307,232,49,143,335,2,761,1.781.964.286
16/04/2018 03:00,38.36,37633,246,52,121,336,2,757,1.781.964.286
16/04/2018 04:00,38.73,38477,250,54,101,325,2,732,1.781.964.286
16/04/2018 05:00,40.54,40603,268,51,84,293,2,698,1.781.964.286
16/04/2018 06:00,44.93,44139,288,45,60,262,2,657,1.781.964.286
16/04/2018 07:00,55.52,47607,314,34,39,234,3,624,1.781.964.286
16/04/2018 08:00,64.26,48948,280,27,27,173,2,509,1.781.964.286
16/04/2018 09:00,57.6,49055,239,25,20,155,3,442,1.781.964.286
16/04/2018 10:00,53.48,48806,237,26,15,99,3,380,1.781.964.286
16/04/2018 11:00,50.1,48193,249,29,13,93,3,387,1.781.964.286
16/04/2018 12:00,50.07,47484,247,35,13,87,3,385,1.781.964.286
16/04/2018 13:00,48.08,46888,238,42,17,87,3,387,1.781.964.286
16/04/2018 14:00,45.77,46415,237,50,19,92,5,403,1.781.964.286
16/04/2018 15:00,44.94,45837,261,54,25,102,5,447,1.781.964.286
16/04/2018 16:00,44.33,45489,291,57,33,108,6,495,1.781.964.286
16/04/2018 17:00,44.94,45647,299,66,41,111,6,523,1.781.964.286
16/04/2018 18:00,47.54,45651,291,78,53,122,5,549,1.781.964.286
16/04/2018 19:00,49.65,45677,272,86,62,150,5,575,1.781.964.286
16/04/2018 20:00,50.35,45743,279,86,65,165,5,600,1.781.964.286
16/04/2018 21:00,47.63,45255,304,85,73,202,6,670,1.781.964.286
16/04/2018 22:00,43.98,43463,340,81,73,249,5,748,1.781.964.286
16/04/2018 23:00,41.55,41108,355,28,33,222,6,644,1.781.964.286
17/04/2018 00:00,39.99,39203,360,30,39,274,8,711,1.781.964.286
17/04/2018 01:00,39.57,38204,414,30,47,335,8,834,1.781.964.286
17/04/2018 02:00,39.27,37964,459,31,54,396,6,946,1.781.964.286
17/04/2018 03:00,39,38225,486,31,73,486,6,1082,1.781.964.286
17/04/2018 04:00,39.04,39044,475,30,88,506,5,1104,1.781.964.286
17/04/2018 05:00,39.58,41196,449,29,99,483,6,1066,1.781.964.286
17/04/2018 06:00,43.77,45026,428,26,112,458,7,1031,1.781.964.286
17/04/2018 07:00,52.99,48734,468,23,117,400,6,1014,1.781.964.286
17/04/2018 08:00,52.59,49871,465,19,109,342,5,940,1.781.964.286
17/04/2018 09:00,50.08,49421,464,15,100,301,5,885,1.781.964.286
17/04/2018 10:00,46.72,48822,460,11,101,311,5,888,1.781.964.286
17/04/2018 11:00,43.65,48155,534,10,107,346,5,1002,1.781.964.286
17/04/2018 12:00,42.43,47384,673,12,114,445,5,1249,1.781.964.286
17/04/2018 13:00,41.97,46757,737,13,123,517,5,1395,1.781.964.286
17/04/2018 14:00,40.48,46274,755,12,137,585,6,1495,1.781.964.286
17/04/2018 15:00,40,45817,761,13,153,619,6,1552,1.781.964.286
17/04/2018 16:00,40.96,45636,762,14,150,675,6,1607,1.781.964.286
17/04/2018 17:00,42.96,45902,778,17,137,705,6,1643,1.781.964.286
17/04/2018 18:00,45.73,45957,829,19,117,779,3,1747,1.781.964.286
17/04/2018 19:00,45.88,46024,899,21,101,832,4,1857,1.781.964.286
17/04/2018 20:00,43.97,46132,973,21,93,886,4,1977,1.781.964.286
17/04/2018 21:00,42.68,45717,1070,22,89,985,6,2172,1.781.964.286
17/04/2018 22:00,41.59,43909,1132,24,82,1084,8,2330,1.781.964.286
17/04/2018 23:00,39.83,41424,1246,33,84,1184,5,2552,1.781.964.286
18/04/2018 00:00,38.44,39060,1555,34,82,1279,6,2956,1.781.964.286
18/04/2018 01:00,37.63,38197,1700,33,82,1421,7,3243,1.781.964.286
18/04/2018 02:00,36.85,37934,1688,33,82,1569,8,3380,1.781.964.286
18/04/2018 03:00,36.42,38079,1684,35,79,1680,11,3489,1.781.964.286
18/04/2018 04:00,36.4,38761,1645,36,78,1732,14,3505,1.781.964.286
18/04/2018 05:00,38.05,40679,1480,33,79,1701,16,3309,1.781.964.286
18/04/2018 06:00,42.58,44249,1277,31,80,1693,16,3097,1.781.964.286
18/04/2018 07:00,51.6,47735,1048,33,95,1617,13,2806,1.781.964.286
18/04/2018 08:00,56.95,48730,888,36,124,1455,13,2516,1.781.964.286
18/04/2018 09:00,48.99,48361,757,41,177,1502,11,2488,1.781.964.286
18/04/2018 10:00,44.88,47951,645,47,217,1472,10,2391,1.781.964.286
18/04/2018 11:00,42.71,47333,682,55,228,1553,6,2524,1.781.964.286
18/04/2018 12:00,41.82,46467,790,64,230,1686,6,2776,1.781.964.286
18/04/2018 13:00,40.9,45745,849,75,213,1801,5,2943,1.781.964.286
18/04/2018 14:00,39.73,45091,847,81,190,1889,5,3012,1.781.964.286
18/04/2018 15:00,39.54,44439,796,83,166,1933,4,2982,1.781.964.286
18/04/2018 16:00,39.89,43988,718,84,145,2040,4,2991,1.781.964.286
18/04/2018 17:00,40.99,43987,612,85,125,2167,3,2992,1.781.964.286
18/04/2018 18:00,43.68,43878,466,88,110,2400,4,3068,1.781.964.286
18/04/2018 19:00,44.9,43914,344,93,100,2472,4,3013,1.781.964.286
18/04/2018 20:00,43.41,44027,274,93,93,2593,5,3058,1.781.964.286
18/04/2018 21:00,42.69,43727,206,88,87,2662,6,3049,1.781.964.286
18/04/2018 22:00,40.99,42144,190,81,84,2591,7,2953,1.781.964.286
18/04/2018 23:00,38.04,39997,167,94,195,2640,11,3107,1.781.964.286
19/04/2018 00:00,35.8,38528,234,98,201,2621,11,3165,1.781.964.286
19/04/2018 01:00,34.15,37751,224,99,202,2595,12,3132,1.781.964.286
19/04/2018 02:00,33.89,37632,218,97,210,2550,12,3087,1.781.964.286
19/04/2018 03:00,34.02,37817,225,97,213,2449,12,2996,1.781.964.286
19/04/2018 04:00,34.05,38474,236,99,221,2240,13,2809,1.781.964.286
19/04/2018 05:00,36.4,40296,271,95,219,2023,13,2621,1.781.964.286
19/04/2018 06:00,40.96,43446,319,85,216,1788,11,2419,1.781.964.286
19/04/2018 07:00,49.37,46646,353,74,227,1342,11,2007,1.781.964.286
19/04/2018 08:00,49.96,47671,336,64,254,944,16,1614,1.781.964.286
19/04/2018 09:00,46.2,47272,336,57,278,610,16,1297,1.781.964.286
19/04/2018 10:00,43,46744,354,54,291,458,16,1173,1.781.964.286
19/04/2018 11:00,41.73,46025,357,56,285,386,17,1101,1.781.964.286
19/04/2018 12:00,39.92,45347,428,60,289,368,13,1158,1.781.964.286
19/04/2018 13:00,39.66,44774,480,62,282,370,10,1204,1.781.964.286
19/04/2018 14:00,38.73,44200,526,60,267,392,8,1253,1.781.964.286
19/04/2018 15:00,38.49,43642,579,57,245,414,7,1302,1.781.964.286
19/04/2018 16:00,39.4,43286,612,56,225,508,6,1407,1.781.964.286
19/04/2018 17:00,42.16,43321,663,55,203,670,5,1596,1.781.964.286
19/04/2018 18:00,42.56,43369,658,59,184,878,3,1782,1.781.964.286
19/04/2018 19:00,42.41,43534,658,57,164,1203,3,2085,1.781.964.286
19/04/2018 20:00,40.74,43647,696,57,140,1500,2,2395,1.781.964.286
19/04/2018 21:00,39.56,43430,801,58,110,1830,2,2801,1.781.964.286
19/04/2018 22:00,38.03,41895,913,61,87,2137,1,3199,1.781.964.286
19/04/2018 23:00,34.93,39769,1094,85,67,2156,2,3404,1.781.964.286
20/04/2018 00:00,35.01,37507,1308,99,50,2261,2,3720,1.781.964.286
20/04/2018 01:00,32.94,36595,1351,108,40,2202,2,3703,1.781.964.286
20/04/2018 02:00,31.8,36473,1354,114,37,2293,3,3801,1.781.964.286
20/04/2018 03:00,32.03,36717,1377,116,35,2305,3,3836,1.781.964.286
20/04/2018 04:00,33.3,37378,1395,112,32,2296,3,3838,1.781.964.286
20/04/2018 05:00,35.51,39236,1404,103,30,2299,3,3839,1.781.964.286
20/04/2018 06:00,38.86,42658,1429,91,26,2224,3,3773,1.781.964.286
20/04/2018 07:00,41.44,46259,1304,78,27,2015,3,3427,1.781.964.286
20/04/2018 08:00,43.1,47561,1168,68,37,1800,3,3076,1.781.964.286
20/04/2018 09:00,41.89,47072,1128,60,54,1587,5,2834,1.781.964.286
20/04/2018 10:00,41.27,46479,1048,57,75,1494,6,2680,1.781.964.286
20/04/2018 11:00,39.35,45653,1061,59,94,1557,7,2778,1.781.964.286
20/04/2018 12:00,37.86,44737,1120,62,109,1629,8,2928,1.781.964.286
20/04/2018 13:00,36.79,43862,1228,66,111,1688,8,3101,1.781.964.286
20/04/2018 14:00,35.87,42912,1343,71,112,1868,9,3403,1.781.964.286
20/04/2018 15:00,35.33,42129,1401,79,111,1993,9,3593,1.781.964.286
20/04/2018 16:00,35.76,41609,1517,84,117,2148,8,3874,1.781.964.286
20/04/2018 17:00,37.14,41727,1606,90,128,2281,8,4113,1.781.964.286
20/04/2018 18:00,38.38,41679,1766,93,146,2516,9,4530,1.781.964.286
20/04/2018 19:00,38.2,41548,1883,90,170,2698,9,4850,1.781.964.286
20/04/2018 20:00,37.86,41441,1874,80,209,2907,10,5080,1.781.964.286
20/04/2018 21:00,37.2,41216,1829,67,256,3138,11,5301,1.781.964.286
20/04/2018 22:00,36.16,39968,1684,55,292,3231,18,5280,1.781.964.286
20/04/2018 23:00,32.64,38196,1658,91,334,3308,16,5407,1.781.964.286
21/04/2018 00:00,33,36414,1740,91,357,3355,16,5559,1.781.964.286
21/04/2018 01:00,30.42,35692,1650,89,369,3318,13,5439,1.781.964.286
21/04/2018 02:00,29.37,35498,1596,88,365,3378,14,5441,1.781.964.286
21/04/2018 03:00,29.04,35547,1619,86,353,3438,16,5512,1.781.964.286
21/04/2018 04:00,29.3,35828,1621,82,348,3377,20,5448,1.781.964.286
21/04/2018 05:00,30.24,36195,1606,74,342,3310,20,5352,1.781.964.286
21/04/2018 06:00,33.21,36965,1551,58,336,3158,18,5121,1.781.964.286
21/04/2018 07:00,34.77,38332,1498,41,344,3167,18,5068,1.781.964.286
21/04/2018 08:00,35.26,39913,1453,30,355,3223,14,5075,1.781.964.286
21/04/2018 09:00,34.47,41057,1439,26,355,3220,11,5051,1.781.964.286
21/04/2018 10:00,34.5,41460,1488,26,345,3302,10,5171,1.781.964.286
21/04/2018 11:00,33.95,41022,1624,29,322,3476,9,5460,1.781.964.286
21/04/2018 12:00,31.47,40372,1760,29,299,3568,10,5666,1.781.964.286
21/04/2018 13:00,30.04,39810,1821,27,281,3548,13,5690,1.781.964.286
21/04/2018 14:00,27.11,39333,1832,24,270,3514,14,5654,1.781.964.286
21/04/2018 15:00,27.08,39188,1713,22,254,3475,13,5477,1.781.964.286
21/04/2018 16:00,29.55,39502,1662,21,230,3372,13,5298,1.781.964.286
21/04/2018 17:00,31.39,40233,1572,23,197,3239,11,5042,1.781.964.286
21/04/2018 18:00,35.13,40676,1373,29,170,3078,11,4661,1.781.964.286
21/04/2018 19:00,36.3,40552,1092,37,150,2926,11,4216,1.781.964.286
21/04/2018 20:00,36.47,40473,902,47,141,2933,8,4031,1.781.964.286
21/04/2018 21:00,36.34,40715,804,52,134,2893,6,3889,1.781.964.286
21/04/2018 22:00,36.07,39891,707,51,131,2793,5,3687,1.781.964.286
21/04/2018 23:00,35.34,38580,672,51,132,2663,11,3529,1.781.964.286
22/04/2018 00:00,34.78,37080,527,45,138,2485,10,3205,1.781.964.286
22/04/2018 01:00,32.73,36462,497,39,132,2313,8,2989,1.781.964.286
22/04/2018 02:00,30.96,36179,441,33,109,2173,7,2763,1.781.964.286
22/04/2018 03:00,31.96,36259,397,26,93,2002,6,2524,1.781.964.286
22/04/2018 04:00,33.1,36447,334,21,77,1770,4,2206,1.781.964.286
22/04/2018 05:00,33.92,36619,273,17,60,1525,5,1880,1.781.964.286
22/04/2018 06:00,34.85,36969,247,12,44,1229,5,1537,1.781.964.286
22/04/2018 07:00,35.78,37874,212,9,43,950,4,1218,1.781.964.286
22/04/2018 08:00,36.42,39152,200,8,53,695,4,960,1.781.964.286
22/04/2018 09:00,36.9,40187,259,8,77,481,4,829,1.781.964.286
22/04/2018 10:00,37,40743,344,8,102,334,5,793,1.781.964.286
22/04/2018 11:00,36.97,40672,441,8,125,225,6,805,1.781.964.286
22/04/2018 12:00,36.49,40295,531,7,139,133,7,817,1.781.964.286
22/04/2018 13:00,36,39957,584,7,143,111,7,852,1.781.964.286
22/04/2018 14:00,35.67,39562,591,7,136,119,7,860,1.781.964.286
22/04/2018 15:00,35.83,39506,702,7,126,148,6,989,1.781.964.286
22/04/2018 16:00,36.09,39636,875,6,110,196,6,1193,1.781.964.286
22/04/2018 17:00,36.62,40269,1104,6,93,281,4,1488,1.781.964.286
22/04/2018 18:00,36.82,40882,1319,6,78,420,4,1827,1.781.964.286
22/04/2018 19:00,36.91,41188,1499,7,57,619,4,2186,1.781.964.286
22/04/2018 20:00,36.96,41466,1655,9,43,892,4,2603,1.781.964.286
22/04/2018 21:00,36.14,41761,1913,10,31,1254,4,3212,1.781.964.286
22/04/2018 22:00,35,40588,2063,11,25,1541,3,3643,1.781.964.286
22/04/2018 23:00,33.97,38917,2318,52,27,1789,6,4192,1.781.964.286
23/04/2018 00:00,30.99,37770,2353,44,25,1995,6,4423,192.125
23/04/2018 01:00,27.6,36994,2316,41,27,2210,6,4600,192.125
23/04/2018 02:00,27.57,36807,2212,42,35,2419,6,4714,192.125
23/04/2018 03:00,27.53,37123,2128,42,46,2593,7,4816,192.125
23/04/2018 04:00,27.65,37724,2078,36,59,2658,7,4838,192.125
23/04/2018 05:00,35.19,39726,2097,38,58,2625,7,4825,192.125
23/04/2018 06:00,38.16,43045,2169,47,48,2552,7,4823,192.125
23/04/2018 07:00,41.65,46560,2253,54,47,2479,7,4840,192.125
23/04/2018 08:00,44.33,47781,2362,68,53,2478,8,4969,192.125
23/04/2018 09:00,41.86,47779,2555,84,66,2570,9,5284,192.125
23/04/2018 10:00,40.15,47526,2730,104,78,2773,11,5696,192.125
23/04/2018 11:00,38.63,47232,2946,120,91,2974,11,6142,192.125
23/04/2018 12:00,37.56,46782,3144,133,101,3101,12,6491,192.125
23/04/2018 13:00,37.27,46540,3224,137,110,3268,11,6750,192.125
23/04/2018 14:00,36.65,46123,3321,135,111,3370,13,6950,192.125
23/04/2018 15:00,36.63,45728,3344,131,109,3545,13,7142,192.125
23/04/2018 16:00,36.65,45597,3418,130,113,3578,13,7252,192.125
23/04/2018 17:00,36.89,45648,3515,128,131,3599,17,7390,192.125
23/04/2018 18:00,38.02,45496,3437,124,157,3550,15,7283,192.125
23/04/2018 19:00,38.24,45236,3298,124,175,3461,18,7076,192.125
23/04/2018 20:00,37.68,45130,3056,123,179,3449,19,6826,192.125
23/04/2018 21:00,37.29,44844,2825,124,182,3431,16,6578,192.125
23/04/2018 22:00,36.28,43273,2651,121,176,3370,12,6330,192.125
23/04/2018 23:00,34.21,41034,2395,20,128,3237,4,5784,192.125
24/04/2018 00:00,32.77,38747,1934,23,112,3091,4,5164,192.125
24/04/2018 01:00,30.17,37852,1896,27,112,2984,4,5023,192.125
24/04/2018 02:00,29.18,37701,1902,29,119,2860,5,4915,192.125
24/04/2018 03:00,27.08,37938,1982,31,132,2763,5,4913,192.125
24/04/2018 04:00,27.04,38506,2062,28,149,2634,5,4878,192.125
24/04/2018 05:00,31.7,40069,2153,23,171,2556,6,4909,192.125
24/04/2018 06:00,36.44,43237,2281,19,204,2472,6,4982,192.125
24/04/2018 07:00,38.33,46595,2469,18,238,2306,7,5038,192.125
24/04/2018 08:00,38.56,47823,2696,18,271,2276,10,5271,192.125
24/04/2018 09:00,37.85,47570,2970,20,305,2193,12,5500,192.125
24/04/2018 10:00,37.12,47345,3242,24,332,2195,13,5806,192.125
24/04/2018 11:00,36.89,46940,3462,27,337,2296,14,6136,192.125
24/04/2018 12:00,36.61,46472,3640,32,341,2363,13,6389,192.125
24/04/2018 13:00,36.27,45952,3705,36,324,2484,12,6561,192.125
24/04/2018 14:00,35.43,45608,3813,39,290,2579,13,6734,192.125
24/04/2018 15:00,35.45,45223,3734,43,246,2580,14,6617,192.125
24/04/2018 16:00,35.8,45140,3721,52,212,2677,12,6674,192.125
24/04/2018 17:00,36.38,45268,3710,63,184,2756,11,6724,192.125
24/04/2018 18:00,36.95,45123,3488,79,173,2837,10,6587,192.125
24/04/2018 19:00,37.15,45034,3250,100,184,2938,12,6484,192.125
24/04/2018 20:00,37.01,44913,2841,122,226,3073,14,6276,192.125
24/04/2018 21:00,36.77,44747,2465,141,281,3263,14,6164,192.125
24/04/2018 22:00,36.35,43253,2216,154,303,3321,15,6009,192.125
24/04/2018 23:00,34.77,41118,2084,160,386,3268,16,5914,192.125
25/04/2018 00:00,35.73,39345,1602,153,385,3150,18,5308,192.125
25/04/2018 01:00,34.3,38432,1346,128,364,2970,19,4827,192.125
25/04/2018 02:00,32.63,38156,1050,90,344,2837,19,4340,192.125
25/04/2018 03:00,32.62,38464,835,70,309,2756,17,3987,192.125
25/04/2018 04:00,33.08,39097,646,61,300,2504,16,3527,192.125
25/04/2018 05:00,35.24,40851,561,55,289,2237,15,3157,192.125
25/04/2018 06:00,37.93,44357,510,50,291,1929,12,2792,192.125
25/04/2018 07:00,40.91,48180,475,50,302,1798,11,2636,192.125
25/04/2018 08:00,42.13,49511,499,55,299,1711,11,2575,192.125
25/04/2018 09:00,41.5,49293,520,57,295,1580,12,2464,192.125
25/04/2018 10:00,40.56,48822,612,62,258,1591,13,2536,192.125
25/04/2018 11:00,39.64,48269,716,68,195,1539,14,2532,192.125
25/04/2018 12:00,38.9,47634,852,77,130,1563,12,2634,192.125
25/04/2018 13:00,38.1,47117,981,83,82,1555,10,2711,192.125
25/04/2018 14:00,37.4,46652,1129,88,61,1753,10,3041,192.125
25/04/2018 15:00,36.96,46176,1168,90,46,1933,9,3246,192.125
25/04/2018 16:00,37.03,45863,1221,90,40,1997,9,3357,192.125
25/04/2018 17:00,37.2,45832,1405,91,40,2034,7,3577,192.125
25/04/2018 18:00,37.33,45731,1392,93,53,1993,4,3535,192.125
25/04/2018 19:00,38.65,45579,1298,95,69,1965,4,3431,192.125
25/04/2018 20:00,38.83,45488,1291,95,79,2080,5,3550,192.125
25/04/2018 21:00,37.94,45329,1291,93,90,2189,5,3668,192.125
25/04/2018 22:00,36.48,43793,1394,84,102,2319,6,3905,192.125
25/04/2018 23:00,34.35,41586,1437,74,275,2516,5,4307,192.125
26/04/2018 00:00,34.59,39544,1603,67,267,2510,6,4453,192.125
26/04/2018 01:00,31.27,38684,1561,62,265,2398,9,4295,192.125
26/04/2018 02:00,31.21,38579,1514,62,267,2347,12,4202,192.125
26/04/2018 03:00,31.68,38820,1487,66,268,2271,10,4102,192.125
26/04/2018 04:00,32.64,39442,1415,72,272,2187,12,3958,192.125
26/04/2018 05:00,35.08,41180,1321,79,280,2006,13,3699,192.125
26/04/2018 06:00,37.33,44437,1227,87,292,1794,13,3413,192.125
26/04/2018 07:00,42.05,48055,1203,96,294,1567,14,3174,192.125
26/04/2018 08:00,45.11,49322,1220,101,278,1507,14,3120,192.125
26/04/2018 09:00,40.67,48895,1261,105,267,1431,13,3077,192.125
26/04/2018 10:00,38.91,48365,1349,109,271,1416,15,3160,192.125
26/04/2018 11:00,37.96,47611,1543,109,301,1446,17,3416,192.125
26/04/2018 12:00,37.61,47033,1781,107,327,1471,16,3702,192.125
26/04/2018 13:00,37.48,46652,1926,102,320,1521,15,3884,192.125
26/04/2018 14:00,37.05,46167,2134,97,303,1560,14,4108,192.125
26/04/2018 15:00,36.68,45704,2340,88,271,1632,12,4343,192.125
26/04/2018 16:00,36.73,45511,2525,78,235,1636,10,4484,192.125
26/04/2018 17:00,36.48,45485,2719,69,188,1527,10,4513,192.125
26/04/2018 18:00,37.18,45280,2610,60,146,1431,8,4255,192.125
26/04/2018 19:00,38.01,45288,2433,55,128,1460,9,4085,192.125
26/04/2018 20:00,38.38,45303,2279,52,132,1507,8,3978,192.125
26/04/2018 21:00,38.52,45279,2113,48,136,1584,8,3889,192.125
26/04/2018 22:00,37.62,43872,2072,44,141,1632,8,3897,192.125
26/04/2018 23:00,35.93,41565,2072,19,137,1555,7,3790,192.125
27/04/2018 00:00,35.2,39442,2116,18,147,1515,7,3803,192.125
27/04/2018 01:00,33.39,38434,2118,18,152,1452,8,3748,192.125
27/04/2018 02:00,32.23,38205,2142,17,147,1348,7,3661,192.125
27/04/2018 03:00,33.12,38333,2159,16,148,1305,7,3635,192.125
27/04/2018 04:00,33.92,38818,2096,16,148,1271,6,3537,192.125
27/04/2018 05:00,35.77,40343,2040,15,145,1243,6,3449,192.125
27/04/2018 06:00,38.62,43318,1878,14,146,1251,5,3294,192.125
27/04/2018 07:00,41.69,46711,1717,16,152,1234,4,3123,192.125
27/04/2018 08:00,45.02,48087,1599,20,175,1182,7,2983,192.125
27/04/2018 09:00,44.37,48052,1531,25,202,1158,6,2922,192.125
27/04/2018 10:00,42.14,47686,1468,32,231,1183,6,2920,192.125
27/04/2018 11:00,40.17,47073,1476,42,254,1217,8,2997,192.125
27/04/2018 12:00,38.31,46338,1515,50,271,1266,8,3110,192.125
27/04/2018 13:00,37.07,45556,1371,55,263,1283,11,2983,192.125
27/04/2018 14:00,36.63,44802,1263,56,222,1258,12,2811,192.125
27/04/2018 15:00,36.66,44186,1072,56,173,1275,15,2591,192.125
27/04/2018 16:00,37.32,43828,885,53,136,1196,14,2284,192.125
27/04/2018 17:00,38.09,43937,709,47,103,1030,12,1901,192.125
27/04/2018 18:00,38.71,43986,526,46,76,912,10,1570,192.125
27/04/2018 19:00,38.99,43720,335,47,66,864,11,1323,192.125
27/04/2018 20:00,38.58,43339,220,48,65,815,13,1161,192.125
27/04/2018 21:00,38.49,43213,170,48,70,876,12,1176,192.125
27/04/2018 22:00,37.83,42140,150,47,73,839,11,1120,192.125
27/04/2018 23:00,36.02,40517,144,154,0,786,9,1093,192.125
28/04/2018 00:00,35.91,38669,193,164,0,719,10,1086,192.125
28/04/2018 01:00,34.09,37877,208,173,0,659,10,1050,192.125
28/04/2018 02:00,33.32,37548,208,188,0,622,10,1028,192.125
28/04/2018 03:00,33.31,37474,206,206,0,597,11,1020,192.125
28/04/2018 04:00,32.96,37579,220,220,0,507,11,958,192.125
28/04/2018 05:00,32.91,37798,245,224,0,384,10,863,192.125
28/04/2018 06:00,35,38391,283,225,0,297,9,814,192.125
28/04/2018 07:00,36.04,39664,288,231,0,228,5,752,192.125
28/04/2018 08:00,36.85,41310,290,240,0,197,3,730,192.125
28/04/2018 09:00,37.63,42541,298,242,0,184,2,726,192.125
28/04/2018 10:00,37.37,43046,316,240,0,193,1,750,192.125
28/04/2018 11:00,36.98,42724,367,239,0,226,1,833,192.125
28/04/2018 12:00,36.21,42139,410,238,0,257,1,906,192.125
28/04/2018 13:00,35.81,41609,447,233,0,272,1,953,192.125
28/04/2018 14:00,34.99,41090,455,227,0,283,2,967,192.125
28/04/2018 15:00,34.81,40934,483,221,0,318,1,1023,192.125
28/04/2018 16:00,35.14,41208,553,212,0,334,1,1100,192.125
28/04/2018 17:00,36.29,41778,674,198,0,331,1,1204,192.125
28/04/2018 18:00,37.05,42108,706,186,0,302,1,1195,192.125
28/04/2018 19:00,38.25,41730,687,172,0,365,2,1226,192.125
28/04/2018 20:00,38.52,41445,680,158,0,360,2,1200,192.125
28/04/2018 21:00,38.1,41657,625,147,0,362,3,1137,192.125
28/04/2018 22:00,37.01,40914,535,138,0,371,3,1047,192.125
28/04/2018 23:00,35.91,39525,451,150,51,371,4,1027,192.125
29/04/2018 00:00,35.97,38105,417,146,40,356,3,962,192.125
29/04/2018 01:00,34.85,37261,349,144,38,351,3,885,192.125
29/04/2018 02:00,34.59,36892,314,142,38,341,3,838,192.125
29/04/2018 03:00,34.03,36836,255,136,36,341,3,771,192.125
29/04/2018 04:00,34,36819,211,128,34,339,3,715,192.125
29/04/2018 05:00,33.65,36806,185,117,32,285,3,622,192.125
29/04/2018 06:00,34.56,37187,155,106,30,235,2,528,192.125
29/04/2018 07:00,34.88,38193,121,97,29,196,1,444,192.125
29/04/2018 08:00,35.61,39529,115,87,32,173,0,407,192.125
29/04/2018 09:00,35.97,40782,114,75,44,153,0,386,192.125
29/04/2018 10:00,36.03,41400,118,64,53,149,0,384,192.125
29/04/2018 11:00,35.97,41402,127,58,48,151,0,384,192.125
29/04/2018 12:00,35.64,41056,145,48,42,168,0,403,192.125
29/04/2018 13:00,35.32,40714,186,43,33,167,1,430,192.125
29/04/2018 14:00,35.04,40341,211,38,29,177,1,456,192.125
29/04/2018 15:00,34.57,40106,250,32,23,211,1,517,192.125
29/04/2018 16:00,34.8,40221,350,25,20,260,1,656,192.125
29/04/2018 17:00,35.23,40709,501,21,20,265,1,808,192.125
29/04/2018 18:00,35.6,41244,596,17,24,311,3,951,192.125
29/04/2018 19:00,35.33,41328,615,16,27,352,3,1013,192.125
29/04/2018 20:00,35.31,41471,707,15,34,394,3,1153,192.125
29/04/2018 21:00,35.74,41868,848,15,47,481,2,1393,192.125
29/04/2018 22:00,35.3,41052,940,17,57,573,1,1588,192.125
29/04/2018 23:00,33.77,39532,1056,46,42,665,1,1810,192.125
30/04/2018 00:00,32.15,37572,1348,45,55,803,1,2252,2.122.083.333
30/04/2018 01:00,31.01,36820,1557,42,64,935,1,2599,2.122.083.333
30/04/2018 02:00,28.87,36715,1804,40,79,1101,2,3026,2.122.083.333
30/04/2018 03:00,24.86,36917,2116,36,97,1288,1,3538,2.122.083.333
30/04/2018 04:00,26.09,37360,2428,30,101,1353,1,3913,2.122.083.333
30/04/2018 05:00,31.04,38843,2757,25,90,1305,2,4179,2.122.083.333
30/04/2018 06:00,34.01,41814,3089,22,74,1319,3,4507,2.122.083.333
30/04/2018 07:00,35.12,45214,3330,24,66,1399,4,4823,2.122.083.333
30/04/2018 08:00,35.96,46742,3486,27,67,1512,4,5096,2.122.083.333
30/04/2018 09:00,35.65,46765,3654,33,68,1676,4,5435,2.122.083.333
30/04/2018 10:00,35.15,46581,3741,42,71,1900,6,5760,2.122.083.333
30/04/2018 11:00,34.75,46234,3568,50,87,2146,8,5859,2.122.083.333
30/04/2018 12:00,34.43,45759,3353,59,100,2346,11,5869,2.122.083.333
30/04/2018 13:00,34.03,45064,3075,65,114,2517,14,5785,2.122.083.333
30/04/2018 14:00,33.74,44650,2837,68,121,2632,16,5674,2.122.083.333
30/04/2018 15:00,32.1,44244,2462,64,125,2694,18,5363,2.122.083.333
30/04/2018 16:00,32.04,44058,2100,55,139,2733,19,5046,2.122.083.333
30/04/2018 17:00,32.79,44201,1870,45,173,2743,18,4849,2.122.083.333
30/04/2018 18:00,32.93,44163,1548,38,236,2690,18,4530,2.122.083.333
30/04/2018 19:00,34.44,43952,1345,36,275,2555,25,4236,2.122.083.333
30/04/2018 20:00,35.07,43717,1128,40,276,2390,29,3863,2.122.083.333
30/04/2018 21:00,34.16,43756,1027,47,265,2261,38,3638,2.122.083.333
30/04/2018 22:00,34.01,42585,1025,48,249,2182,26,3530,2.122.083.333
30/04/2018 23:00,32.13,40405,1059,19,188,2124,15,3405,2.122.083.333
01/05/2018 00:00,30.01,38233,1074,21,187,2053,8,3343,2.122.083.333
01/05/2018 01:00,26.67,37575,1170,23,185,1976,20,3374,2.122.083.333
01/05/2018 02:00,24.1,37222,1295,25,158,2022,17,3517,2.122.083.333
01/05/2018 03:00,20.69,37033,1429,26,136,2064,13,3668,2.122.083.333
01/05/2018 04:00,15.27,37012,1615,22,108,2112,12,3869,2.122.083.333
01/05/2018 05:00,10.8,37292,1649,17,70,2059,12,3807,2.122.083.333
01/05/2018 06:00,21.21,37953,1687,13,43,1996,11,3750,2.122.083.333
01/05/2018 07:00,28.26,39149,1864,10,32,1946,13,3865,2.122.083.333
01/05/2018 08:00,30.4,40189,2059,11,27,1953,10,4060,2.122.083.333
01/05/2018 09:00,32.3,41180,2144,13,22,2081,9,4269,2.122.083.333
01/05/2018 10:00,32.97,41747,2178,16,16,2228,10,4448,2.122.083.333
01/05/2018 11:00,31.89,41913,2194,19,16,2432,8,4669,2.122.083.333
01/05/2018 12:00,30.95,41542,2155,24,16,2547,6,4748,2.122.083.333
01/05/2018 13:00,30.08,41157,2089,30,16,2608,4,4747,2.122.083.333
01/05/2018 14:00,30.02,40853,2050,36,16,2672,2,4776,2.122.083.333
01/05/2018 15:00,30.12,40379,2054,39,16,2759,1,4869,2.122.083.333
01/05/2018 16:00,30.4,40372,2237,45,17,2679,1,4979,2.122.083.333
01/05/2018 17:00,31.42,40878,2345,53,29,2571,1,4999,2.122.083.333
01/05/2018 18:00,32.3,41157,2409,64,39,2508,1,5021,2.122.083.333
01/05/2018 19:00,31.72,41247,2459,76,38,2437,2,5012,2.122.083.333
01/05/2018 20:00,31.96,41060,2490,87,43,2369,5,4994,2.122.083.333
01/05/2018 21:00,32.28,41717,2641,96,49,2318,12,5116,2.122.083.333
01/05/2018 22:00,33.31,41044,2687,105,51,2288,8,5139,2.122.083.333
01/05/2018 23:00,31.09,39649,2586,136,80,2035,3,4840,2.122.083.333
02/05/2018 00:00,33.48,38499,2187,146,86,1939,4,4362,2.122.083.333
02/05/2018 01:00,31.61,37528,2038,151,98,1879,4,4170,2.122.083.333
02/05/2018 02:00,31.17,37289,1935,154,109,1826,11,4035,2.122.083.333
02/05/2018 03:00,31.28,37370,1858,149,113,1699,13,3832,2.122.083.333
02/05/2018 04:00,32.29,37833,1779,135,111,1617,10,3652,2.122.083.333
02/05/2018 05:00,35.9,39363,1659,124,104,1481,16,3384,2.122.083.333
02/05/2018 06:00,38.14,42704,1570,112,104,1348,20,3154,2.122.083.333
02/05/2018 07:00,40.28,46245,1467,94,115,1229,30,2935,2.122.083.333
02/05/2018 08:00,40.69,47630,1409,81,131,1099,33,2753,2.122.083.333
02/05/2018 09:00,40.26,47633,1533,68,141,1034,33,2809,2.122.083.333
02/05/2018 10:00,39.95,47468,1741,64,139,1051,30,3025,2.122.083.333
02/05/2018 11:00,39.02,47200,2054,61,118,1114,29,3376,2.122.083.333
02/05/2018 12:00,38.1,46727,2231,57,85,1109,24,3506,2.122.083.333
02/05/2018 13:00,37.62,46265,2226,51,59,1101,18,3455,2.122.083.333
02/05/2018 14:00,37.54,45915,2237,45,42,1109,15,3448,2.122.083.333
02/05/2018 15:00,37.54,45381,2114,39,27,1110,11,3301,2.122.083.333
02/05/2018 16:00,37.69,45121,1992,33,17,1046,7,3095,2.122.083.333
02/05/2018 17:00,37.99,45061,1772,24,17,947,4,2764,2.122.083.333
02/05/2018 18:00,38.18,44968,1598,18,19,964,2,2601,2.122.083.333
02/05/2018 19:00,38.36,44626,1419,18,30,1024,2,2493,2.122.083.333
02/05/2018 20:00,38.29,44356,1359,19,47,1065,2,2492,2.122.083.333
02/05/2018 21:00,38.11,44332,1566,21,80,1208,2,2877,2.122.083.333
02/05/2018 22:00,37.6,42945,1750,20,103,1303,3,3179,2.122.083.333
02/05/2018 23:00,36.03,40707,1996,13,74,1433,4,3520,2.122.083.333
03/05/2018 00:00,34.58,39476,2138,16,95,1490,4,3743,2.122.083.333
03/05/2018 01:00,32.7,38343,2001,25,117,1495,4,3642,2.122.083.333
03/05/2018 02:00,31.67,38086,1856,27,138,1549,4,3574,2.122.083.333
03/05/2018 03:00,31.78,38254,1737,22,165,1573,5,3502,2.122.083.333
03/05/2018 04:00,33.54,38770,1554,25,193,1601,7,3380,2.122.083.333
03/05/2018 05:00,35.32,40377,1414,32,220,1571,9,3246,2.122.083.333
03/05/2018 06:00,37.91,43852,1305,52,242,1553,10,3162,2.122.083.333
03/05/2018 07:00,41.46,47895,1243,72,258,1485,27,3085,2.122.083.333
03/05/2018 08:00,44.48,49344,1218,88,259,1516,27,3108,2.122.083.333
03/05/2018 09:00,42.58,49060,1249,108,275,1539,33,3204,2.122.083.333
03/05/2018 10:00,40.79,48416,1419,127,260,1586,17,3409,2.122.083.333
03/05/2018 11:00,39.4,47782,1740,133,242,1726,15,3856,2.122.083.333
03/05/2018 12:00,38.53,47358,1850,131,210,1880,14,4085,2.122.083.333
03/05/2018 13:00,37.88,47143,1974,123,189,1907,12,4205,2.122.083.333
03/05/2018 14:00,37.3,46968,2053,112,162,1956,10,4293,2.122.083.333
03/05/2018 15:00,36.78,46997,2047,97,135,2165,6,4450,2.122.083.333
03/05/2018 16:00,36.8,46751,2083,80,113,2176,7,4459,2.122.083.333
03/05/2018 17:00,37.72,46379,2070,64,107,2126,7,4374,2.122.083.333
03/05/2018 18:00,38.31,46189,1833,53,107,2064,6,4063,2.122.083.333
03/05/2018 19:00,38.35,45882,1574,48,117,1984,8,3731,2.122.083.333
03/05/2018 20:00,37.98,45673,1396,47,132,1842,10,3427,2.122.083.333
03/05/2018 21:00,37.79,45545,1310,44,132,1748,8,3242,2.122.083.333
03/05/2018 22:00,37.64,44233,1222,41,126,1699,6,3094,2.122.083.333
03/05/2018 23:00,35.26,41936,1207,40,81,1642,7,2977,2.122.083.333
04/05/2018 00:00,33.68,39351,606,38,88,1654,11,2397,2.122.083.333
04/05/2018 01:00,32.87,38334,536,33,93,1667,12,2341,2.122.083.333
04/05/2018 02:00,32.93,38123,488,26,94,1628,10,2246,2.122.083.333
04/05/2018 03:00,32.97,38267,454,20,95,1592,8,2169,2.122.083.333
04/05/2018 04:00,33.09,38846,446,15,91,1534,7,2093,2.122.083.333
04/05/2018 05:00,36.18,40376,457,9,70,1417,6,1959,2.122.083.333
04/05/2018 06:00,38.49,43574,389,6,50,1332,4,1781,2.122.083.333
04/05/2018 07:00,40.21,47095,299,4,43,1221,4,1571,2.122.083.333
04/05/2018 08:00,41.47,48664,256,5,37,1103,3,1404,2.122.083.333
04/05/2018 09:00,41.54,48639,232,8,36,1036,3,1315,2.122.083.333
04/05/2018 10:00,41.22,48405,233,10,39,941,4,1227,2.122.083.333
04/05/2018 11:00,40.23,47843,289,15,48,902,4,1258,2.122.083.333
04/05/2018 12:00,38.73,47120,353,23,62,827,5,1270,2.122.083.333
04/05/2018 13:00,38.13,46403,393,34,64,766,5,1262,2.122.083.333
04/05/2018 14:00,37.18,45555,429,48,66,712,4,1259,2.122.083.333
04/05/2018 15:00,36.33,44814,445,68,71,716,4,1304,2.122.083.333
04/05/2018 16:00,37.03,44396,461,91,78,700,3,1333,2.122.083.333
04/05/2018 17:00,37.92,44329,465,106,82,685,3,1341,2.122.083.333
04/05/2018 18:00,38.64,44208,436,125,89,686,3,1339,2.122.083.333
04/05/2018 19:00,38.57,43699,360,146,91,765,3,1365,2.122.083.333
04/05/2018 20:00,37.93,43070,296,153,88,834,3,1374,2.122.083.333
04/05/2018 21:00,37.54,42924,257,149,89,1010,3,1508,2.122.083.333
04/05/2018 22:00,37.11,41975,228,142,88,1176,3,1637,2.122.083.333
04/05/2018 23:00,34.15,40260,223,49,81,1390,4,1747,2.122.083.333
05/05/2018 00:00,33.72,38244,271,47,72,1496,3,1889,2.122.083.333
05/05/2018 01:00,30.97,37250,286,44,63,1562,4,1959,2.122.083.333
05/05/2018 02:00,28.37,36872,300,42,57,1567,4,1970,2.122.083.333
05/05/2018 03:00,27.46,36859,346,40,53,1553,4,1996,2.122.083.333
05/05/2018 04:00,26.55,36913,371,35,45,1439,3,1893,2.122.083.333
05/05/2018 05:00,28.41,37043,379,31,33,1185,4,1632,2.122.083.333
05/05/2018 06:00,31.15,37691,356,27,23,908,3,1317,2.122.083.333
05/05/2018 07:00,34.6,38964,315,26,17,790,2,1150,2.122.083.333
05/05/2018 08:00,35.46,40451,289,26,19,690,2,1026,2.122.083.333
05/05/2018 09:00,35.63,41531,287,28,26,629,3,973,2.122.083.333
05/05/2018 10:00,35.43,41936,295,29,37,647,3,1011,2.122.083.333
05/05/2018 11:00,34.99,41529,326,31,47,710,4,1118,2.122.083.333
05/05/2018 12:00,33.11,40758,371,29,55,776,3,1234,2.122.083.333
05/05/2018 13:00,32.03,40057,394,26,63,792,4,1279,2.122.083.333
05/05/2018 14:00,31.78,39334,410,23,70,876,4,1383,2.122.083.333
05/05/2018 15:00,31.53,39018,393,18,83,929,4,1427,2.122.083.333
05/05/2018 16:00,32.54,39084,376,15,95,928,4,1418,2.122.083.333
05/05/2018 17:00,33.72,39568,341,13,105,964,3,1426,2.122.083.333
05/05/2018 18:00,35.04,39950,275,14,127,1025,3,1444,2.122.083.333
05/05/2018 19:00,35.13,39670,232,16,133,1185,3,1569,2.122.083.333
05/05/2018 20:00,35.03,39229,199,19,128,1510,3,1859,2.122.083.333
05/05/2018 21:00,34.8,39508,169,21,118,1916,3,2227,2.122.083.333
05/05/2018 22:00,31.96,39039,155,20,95,2236,2,2508,2.122.083.333
05/05/2018 23:00,28.06,37729,180,22,76,2388,1,2667,2.122.083.333
06/05/2018 00:00,26.23,36175,183,21,46,2555,1,2806,2.122.083.333
06/05/2018 01:00,24.23,35199,196,19,33,2671,1,2920,2.122.083.333
06/05/2018 02:00,22.95,34872,213,17,26,2669,1,2926,2.122.083.333
06/05/2018 03:00,20.84,34798,236,16,22,2688,1,2963,2.122.083.333
06/05/2018 04:00,15.09,34852,272,13,17,2543,1,2846,2.122.083.333
06/05/2018 05:00,10.41,34820,292,12,13,2263,1,2581,2.122.083.333
06/05/2018 06:00,15.6,34991,292,11,9,1972,1,2285,2.122.083.333
06/05/2018 07:00,21.58,35819,265,11,8,1769,1,2054,2.122.083.333
06/05/2018 08:00,25.05,37017,236,10,10,1846,1,2103,2.122.083.333
06/05/2018 09:00,28.42,38169,223,9,15,1923,1,2171,2.122.083.333
06/05/2018 10:00,28.08,38838,219,8,18,2079,2,2326,2.122.083.333
06/05/2018 11:00,26.6,38781,247,8,22,2034,2,2313,2.122.083.333
06/05/2018 12:00,25.32,38505,301,8,26,2006,2,2343,2.122.083.333
06/05/2018 13:00,23.04,38196,338,7,27,1944,2,2318,2.122.083.333
06/05/2018 14:00,20.82,37913,372,6,30,1806,2,2216,2.122.083.333
06/05/2018 15:00,19.98,37731,384,7,39,1664,2,2096,2.122.083.333
06/05/2018 16:00,25.45,37786,399,8,46,1436,2,1891,2.122.083.333
06/05/2018 17:00,28.23,38268,398,9,48,1238,2,1695,2.122.083.333
06/05/2018 18:00,30.78,38742,368,11,56,1069,2,1506,2.122.083.333
06/05/2018 19:00,33.22,38760,325,12,59,979,2,1377,2.122.083.333
06/05/2018 20:00,33.7,38902,311,14,56,987,2,1370,2.122.083.333
06/05/2018 21:00,33.65,39437,350,14,50,1060,2,1476,2.122.083.333
06/05/2018 22:00,31.03,38896,403,15,41,1090,2,1551,2.122.083.333
06/05/2018 23:00,27.2,37244,502,116,32,1038,2,1690,2.122.083.333
07/05/2018 00:00,15.64,35137,867,120,27,1155,1,2170,2.986.607.143
07/05/2018 01:00,15.57,34480,957,134,21,1334,1,2447,2.986.607.143
07/05/2018 02:00,15.59,34338,1049,124,15,1579,2,2769,2.986.607.143
07/05/2018 03:00,15.55,34625,1127,94,13,1819,2,3055,2.986.607.143
07/05/2018 04:00,15.01,35202,1218,65,11,2086,3,3383,2.986.607.143
07/05/2018 05:00,28.74,36852,1239,50,9,2154,3,3455,2.986.607.143
07/05/2018 06:00,34.8,39940,1197,43,5,2144,2,3391,2.986.607.143
07/05/2018 07:00,37.57,43308,1030,39,3,2050,1,3123,2.986.607.143
07/05/2018 08:00,38.45,44723,830,36,5,2004,1,2876,2.986.607.143
07/05/2018 09:00,38.01,44496,714,37,9,1962,2,2724,2.986.607.143
07/05/2018 10:00,36.92,44179,671,37,10,2066,2,2786,2.986.607.143
07/05/2018 11:00,35.37,43560,678,37,15,2270,1,3001,2.986.607.143
07/05/2018 12:00,33.9,42977,704,35,17,2420,1,3177,2.986.607.143
07/05/2018 13:00,33.51,42578,700,38,19,2435,1,3193,2.986.607.143
07/05/2018 14:00,32.29,42185,702,41,21,2393,1,3158,2.986.607.143
07/05/2018 15:00,32.51,41846,673,42,21,2310,1,3047,2.986.607.143
07/05/2018 16:00,32.95,41625,628,38,23,2140,1,2830,2.986.607.143
07/05/2018 17:00,34.69,41658,579,30,29,1839,1,2478,2.986.607.143
07/05/2018 18:00,35.81,41581,503,25,42,1581,1,2152,2.986.607.143
07/05/2018 19:00,35.84,41269,403,24,56,1430,1,1914,2.986.607.143
07/05/2018 20:00,34.77,40935,340,26,66,1371,1,1804,2.986.607.143
07/05/2018 21:00,33.68,40935,350,29,68,1342,1,1790,2.986.607.143
07/05/2018 22:00,33.01,39970,380,28,59,1203,1,1671,2.986.607.143
07/05/2018 23:00,24.88,37784,515,31,36,1078,1,1661,2.986.607.143
08/05/2018 00:00,15.93,35734,738,27,30,1046,1,1842,2.986.607.143
08/05/2018 01:00,20.06,34757,781,25,25,973,1,1805,2.986.607.143
08/05/2018 02:00,18.69,34483,829,24,20,914,1,1788,2.986.607.143
08/05/2018 03:00,20,34594,864,22,15,792,1,1694,2.986.607.143
08/05/2018 04:00,15.1,35139,926,19,15,713,1,1674,2.986.607.143
08/05/2018 05:00,27.91,36520,1019,14,9,620,1,1663,2.986.607.143
08/05/2018 06:00,33.44,39327,1093,11,8,548,1,1661,2.986.607.143
08/05/2018 07:00,36.84,42611,1008,10,8,559,1,1586,2.986.607.143
08/05/2018 08:00,37.6,43949,956,12,9,564,1,1542,2.986.607.143
08/05/2018 09:00,36.54,43939,873,17,10,624,1,1525,2.986.607.143
08/05/2018 10:00,36.08,43668,839,22,16,656,1,1534,2.986.607.143
08/05/2018 11:00,35.31,43252,964,27,16,732,1,1740,2.986.607.143
08/05/2018 12:00,34.3,42635,1221,32,22,713,2,1990,2.986.607.143
08/05/2018 13:00,32.99,42133,1437,36,22,779,2,2276,2.986.607.143
08/05/2018 14:00,31.51,41710,1576,39,27,905,3,2550,2.986.607.143
08/05/2018 15:00,30.63,41357,1694,43,33,1009,3,2782,2.986.607.143
08/05/2018 16:00,31.31,41104,1862,45,44,1054,4,3009,2.986.607.143
08/05/2018 17:00,32.93,41015,2075,47,54,1138,4,3318,2.986.607.143
08/05/2018 18:00,34.51,40838,2028,47,70,1286,4,3435,2.986.607.143
08/05/2018 19:00,34.33,40474,1806,49,87,1532,6,3480,2.986.607.143
08/05/2018 20:00,33.23,39989,1737,49,107,1829,8,3730,2.986.607.143
08/05/2018 21:00,33.74,40017,1820,47,138,2159,8,4172,2.986.607.143
08/05/2018 22:00,29.21,39101,1871,42,143,2372,9,4437,2.986.607.143
08/05/2018 23:00,12.42,37213,1974,38,187,2574,16,4789,2.986.607.143
09/05/2018 00:00,4.04,35398,2084,30,190,2720,17,5041,2.986.607.143
09/05/2018 01:00,3.58,34314,2035,25,188,2754,17,5019,2.986.607.143
09/05/2018 02:00,3.56,33992,1938,24,179,2710,16,4867,2.986.607.143
09/05/2018 03:00,3.7,33985,1893,24,166,2721,14,4818,2.986.607.143
09/05/2018 04:00,3.89,34337,1852,24,148,2607,13,4644,2.986.607.143
09/05/2018 05:00,8.91,35735,1891,23,114,2320,11,4359,2.986.607.143
09/05/2018 06:00,24.72,38704,1906,20,79,2066,6,4077,2.986.607.143
09/05/2018 07:00,34.29,42376,1819,17,62,1766,6,3670,2.986.607.143
09/05/2018 08:00,36.21,43896,1715,15,66,1617,6,3419,2.986.607.143
09/05/2018 09:00,35.28,43650,1603,16,79,1671,7,3376,2.986.607.143
09/05/2018 10:00,34.08,43258,1540,18,97,1874,9,3538,2.986.607.143
09/05/2018 11:00,32.8,42760,1680,21,110,2260,10,4081,2.986.607.143
09/05/2018 12:00,32.32,42170,1926,25,117,2540,11,4619,2.986.607.143
09/05/2018 13:00,30.02,41852,2107,27,119,2769,14,5036,2.986.607.143
09/05/2018 14:00,27.45,41377,2270,29,125,2868,17,5309,2.986.607.143
09/05/2018 15:00,24.51,41024,2392,28,132,2961,17,5530,2.986.607.143
09/05/2018 16:00,22.84,40737,2413,28,150,3013,16,5620,2.986.607.143
09/05/2018 17:00,25.62,40656,2518,30,185,3118,18,5869,2.986.607.143
09/05/2018 18:00,24.5,40537,2494,39,223,3156,18,5930,2.986.607.143
09/05/2018 19:00,25.71,40378,2346,49,248,3236,19,5898,2.986.607.143
09/05/2018 20:00,21.55,40202,2225,58,272,3312,21,5888,2.986.607.143
09/05/2018 21:00,23.84,40346,2218,64,293,3451,22,6048,2.986.607.143
09/05/2018 22:00,13.15,39292,2266,63,300,3492,23,6144,2.986.607.143
09/05/2018 23:00,4.44,37155,2362,66,353,3420,17,6218,2.986.607.143
10/05/2018 00:00,3.28,34652,2375,64,340,3239,17,6035,2.986.607.143
10/05/2018 01:00,2.79,33394,2226,64,327,3153,16,5786,2.986.607.143
10/05/2018 02:00,2.89,32912,2152,63,320,2997,15,5547,2.986.607.143
10/05/2018 03:00,2.94,32735,2053,61,305,2854,15,5288,2.986.607.143
10/05/2018 04:00,2.81,32689,1897,54,288,2574,15,4828,2.986.607.143
10/05/2018 05:00,3.38,32794,1787,41,246,2273,13,4360,2.986.607.143
10/05/2018 06:00,4.61,33569,1699,28,216,1886,11,3840,2.986.607.143
10/05/2018 07:00,16.9,34797,1623,23,197,1611,10,3464,2.986.607.143
10/05/2018 08:00,28.45,36457,1550,24,189,1608,11,3382,2.986.607.143
10/05/2018 09:00,27.91,37852,1405,29,187,1641,10,3272,2.986.607.143
10/05/2018 10:00,27.06,38613,1360,37,181,1881,9,3468,2.986.607.143
10/05/2018 11:00,27.15,38633,1397,48,200,2175,10,3830,2.986.607.143
10/05/2018 12:00,24.24,38153,1388,56,216,2461,11,4132,2.986.607.143
10/05/2018 13:00,21.06,37653,1369,64,227,2669,11,4340,2.986.607.143
10/05/2018 14:00,17.79,37153,1310,66,222,2746,10,4354,2.986.607.143
10/05/2018 15:00,17.63,36913,1355,70,221,2814,9,4469,2.986.607.143
10/05/2018 16:00,19.76,36623,1650,72,219,2825,9,4775,2.986.607.143
10/05/2018 17:00,22.39,37103,1892,75,222,2868,8,5065,2.986.607.143
10/05/2018 18:00,28.4,37549,1950,80,249,2892,9,5180,2.986.607.143
10/05/2018 19:00,27.12,37660,1867,89,287,2900,11,5154,2.986.607.143
10/05/2018 20:00,21.95,37283,1697,91,322,2889,13,5012,2.986.607.143
10/05/2018 21:00,20.64,37560,1394,90,342,2926,16,4768,2.986.607.143
10/05/2018 22:00,15.51,37290,1347,88,350,2821,15,4621,2.986.607.143
10/05/2018 23:00,9.48,35653,1549,99,321,2751,23,4743,2.986.607.143
11/05/2018 00:00,4.35,33968,1507,97,310,2574,23,4511,2.986.607.143
11/05/2018 01:00,3.36,32870,1569,95,296,2371,21,4352,2.986.607.143
11/05/2018 02:00,3.42,32526,1551,93,282,2178,19,4123,2.986.607.143
11/05/2018 03:00,3.57,32474,1493,92,266,1993,18,3862,2.986.607.143
11/05/2018 04:00,4.01,32754,1364,85,244,1767,16,3476,2.986.607.143
11/05/2018 05:00,17.93,33995,1341,74,210,1445,15,3085,2.986.607.143
11/05/2018 06:00,31.29,35679,1268,63,187,1194,13,2725,2.986.607.143
11/05/2018 07:00,36.02,38523,1117,57,178,987,11,2350,2.986.607.143
11/05/2018 08:00,37.91,40244,1047,57,175,891,10,2180,2.986.607.143
11/05/2018 09:00,38.54,41002,916,62,180,854,11,2023,2.986.607.143
11/05/2018 10:00,38.51,41111,834,65,187,832,13,1931,2.986.607.143
11/05/2018 11:00,38.05,40710,787,63,184,909,13,1956,2.986.607.143
11/05/2018 12:00,37.34,40162,798,58,175,969,12,2012,2.986.607.143
11/05/2018 13:00,36.64,39625,761,55,166,980,9,1971,2.986.607.143
11/05/2018 14:00,35.65,39129,687,54,151,995,8,1895,2.986.607.143
11/05/2018 15:00,35.31,38775,596,54,135,1028,7,1820,2.986.607.143
11/05/2018 16:00,34.69,38492,502,53,132,1019,7,1713,2.986.607.143
11/05/2018 17:00,34.9,38528,423,56,135,905,8,1527,2.986.607.143
11/05/2018 18:00,35.12,38635,339,64,148,885,8,1444,2.986.607.143
11/05/2018 19:00,34.09,38199,235,76,168,880,8,1367,2.986.607.143
11/05/2018 20:00,32.65,37454,139,86,195,980,13,1413,2.986.607.143
11/05/2018 21:00,32.98,37388,112,93,223,987,18,1433,2.986.607.143
11/05/2018 22:00,32.3,37069,119,93,242,1060,16,1530,2.986.607.143
11/05/2018 23:00,30.11,35571,122,42,194,870,12,1240,2.986.607.143
12/05/2018 00:00,31.84,34744,102,34,183,804,12,1135,2.986.607.143
12/05/2018 01:00,30.02,33659,94,25,173,802,12,1106,2.986.607.143
12/05/2018 02:00,28.28,33144,97,19,165,792,9,1082,2.986.607.143
12/05/2018 03:00,28.25,33053,108,15,160,774,9,1066,2.986.607.143
12/05/2018 04:00,28.04,33016,127,12,143,736,8,1026,2.986.607.143
12/05/2018 05:00,27.99,33044,154,10,106,610,7,887,2.986.607.143
12/05/2018 06:00,29.19,33539,172,9,70,496,4,751,2.986.607.143
12/05/2018 07:00,32.14,34783,182,10,55,476,3,726,2.986.607.143
12/05/2018 08:00,33.16,36537,196,11,59,487,4,757,2.986.607.143
12/05/2018 09:00,37,37927,219,12,74,439,7,751,2.986.607.143
12/05/2018 10:00,33.63,38587,222,14,81,456,9,782,2.986.607.143
12/05/2018 11:00,32.47,38307,234,16,77,519,8,854,2.986.607.143
12/05/2018 12:00,30.41,37737,253,17,70,572,7,919,2.986.607.143
12/05/2018 13:00,30.06,37292,282,17,63,592,4,958,2.986.607.143
12/05/2018 14:00,28.64,36869,329,16,55,612,3,1015,2.986.607.143
12/05/2018 15:00,28.25,36579,384,14,48,628,3,1077,2.986.607.143
12/05/2018 16:00,28.08,36689,437,13,47,642,3,1142,2.986.607.143
12/05/2018 17:00,31.49,37121,518,13,48,615,4,1198,2.986.607.143
12/05/2018 18:00,34.62,37449,582,14,51,624,4,1275,2.986.607.143
12/05/2018 19:00,33.24,37151,665,14,60,659,5,1403,2.986.607.143
12/05/2018 20:00,32.98,36710,660,13,78,839,9,1599,2.986.607.143
12/05/2018 21:00,33.18,36940,706,12,97,927,10,1752,2.986.607.143
12/05/2018 22:00,32.33,36616,840,10,103,923,7,1883,2.986.607.143
12/05/2018 23:00,19.5,35343,899,7,0,903,7,1816,2.986.607.143
13/05/2018 00:00,26.68,33852,770,5,0,864,6,1645,2.986.607.143
13/05/2018 01:00,20.89,32841,743,4,0,786,6,1539,2.986.607.143
13/05/2018 02:00,17.06,32404,794,4,0,730,5,1533,2.986.607.143
13/05/2018 03:00,14.92,32191,843,5,0,694,5,1547,2.986.607.143
13/05/2018 04:00,14.88,32066,908,7,0,631,4,1550,2.986.607.143
13/05/2018 05:00,13.77,31986,919,8,0,522,5,1454,2.986.607.143
13/05/2018 06:00,14.03,32129,933,8,0,450,5,1396,2.986.607.143
13/05/2018 07:00,15.37,32971,908,9,0,415,2,1334,2.986.607.143
13/05/2018 08:00,17.74,34289,893,11,0,431,2,1337,2.986.607.143
13/05/2018 09:00,24.9,35514,910,15,0,477,2,1404,2.986.607.143
13/05/2018 10:00,28.14,36274,950,20,0,549,4,1523,2.986.607.143
13/05/2018 11:00,22.8,36420,1051,26,0,640,5,1722,2.986.607.143
13/05/2018 12:00,18.4,36299,1211,29,0,709,6,1955,2.986.607.143
13/05/2018 13:00,13.51,36069,1357,28,0,760,8,2153,2.986.607.143
13/05/2018 14:00,10.33,35742,1522,30,0,791,8,2351,2.986.607.143
13/05/2018 15:00,9.91,35532,1622,31,0,829,7,2489,2.986.607.143
13/05/2018 16:00,11.02,35493,1690,27,0,871,6,2594,2.986.607.143
13/05/2018 17:00,17.33,36160,1825,22,0,935,6,2788,2.986.607.143
13/05/2018 18:00,22.31,36684,1851,19,0,1038,6,2914,2.986.607.143
13/05/2018 19:00,26.97,36609,1877,17,0,1218,5,3117,2.986.607.143
13/05/2018 20:00,25.13,36553,1812,17,0,1392,7,3228,2.986.607.143
13/05/2018 21:00,24.07,36980,1865,15,0,1595,9,3484,2.986.607.143
13/05/2018 22:00,24.05,36507,1854,13,0,1693,7,3567,2.986.607.143
13/05/2018 23:00,20.07,34969,1726,100,115,1599,10,3550,2.986.607.143
14/05/2018 00:00,19.63,33399,1849,98,83,1532,10,3572,363.047.619
14/05/2018 01:00,17.91,32501,1792,92,62,1453,7,3406,363.047.619
14/05/2018 02:00,16,32180,1671,88,57,1378,4,3198,363.047.619
14/05/2018 03:00,16.01,32274,1670,85,57,1299,3,3114,363.047.619
14/05/2018 04:00,16.03,32580,1688,77,52,1172,2,2991,363.047.619
14/05/2018 05:00,27.69,33946,1673,62,46,962,0,2743,363.047.619
14/05/2018 06:00,37.56,37053,1642,44,36,709,0,2431,363.047.619
14/05/2018 07:00,40.41,40740,1502,35,32,576,16,2161,363.047.619
14/05/2018 08:00,41.13,42516,1314,30,46,479,0,1869,363.047.619
14/05/2018 09:00,41.06,42417,1086,31,60,420,0,1597,363.047.619
14/05/2018 10:00,40.59,42253,921,31,78,443,0,1473,363.047.619
14/05/2018 11:00,39.72,41992,901,30,89,494,1,1515,363.047.619
14/05/2018 12:00,39.12,41608,974,27,105,542,2,1650,363.047.619
14/05/2018 13:00,38.55,41133,1059,21,103,538,3,1724,363.047.619
14/05/2018 14:00,38.03,40840,1136,18,97,551,4,1806,363.047.619
14/05/2018 15:00,37.75,40459,1149,15,85,558,4,1811,363.047.619
14/05/2018 16:00,37.39,40201,1056,13,78,531,4,1682,363.047.619
14/05/2018 17:00,37.19,40050,1016,14,75,515,4,1624,363.047.619
14/05/2018 18:00,38.47,39797,954,19,73,562,3,1611,363.047.619
14/05/2018 19:00,38.63,39327,825,26,77,609,5,1542,363.047.619
14/05/2018 20:00,38.32,38878,727,33,86,612,7,1465,363.047.619
14/05/2018 21:00,38.26,38729,752,41,101,649,7,1550,363.047.619
14/05/2018 22:00,37.55,37949,785,45,111,676,6,1623,363.047.619
14/05/2018 23:00,32.98,35937,833,57,89,589,3,1571,363.047.619
15/05/2018 00:00,32.68,33997,455,51,84,554,3,1147,363.047.619
15/05/2018 01:00,31.07,32824,389,42,80,512,3,1026,363.047.619
15/05/2018 02:00,29.37,32381,383,33,80,465,2,963,363.047.619
15/05/2018 03:00,28.48,32308,360,23,77,472,2,934,363.047.619
15/05/2018 04:00,30.87,32677,326,15,70,426,5,842,363.047.619
15/05/2018 05:00,33.25,34097,303,8,56,369,2,738,363.047.619
15/05/2018 06:00,37.38,37112,251,3,44,293,1,592,363.047.619
15/05/2018 07:00,39.92,40811,196,2,39,228,0,465,363.047.619
15/05/2018 08:00,40.92,42503,158,2,35,202,1,398,363.047.619
15/05/2018 09:00,40.97,42438,149,3,34,200,1,387,363.047.619
15/05/2018 10:00,40.5,42323,154,5,35,225,1,420,363.047.619
15/05/2018 11:00,39.73,42101,187,7,38,268,0,500,363.047.619
15/05/2018 12:00,39.25,41606,263,8,39,316,1,627,363.047.619
15/05/2018 13:00,38.97,41208,379,10,40,355,2,786,363.047.619
15/05/2018 14:00,38.29,40834,463,13,40,351,3,870,363.047.619
15/05/2018 15:00,37.84,40409,545,16,39,374,8,982,363.047.619
15/05/2018 16:00,37.46,40234,591,20,40,389,6,1046,363.047.619
15/05/2018 17:00,37.58,40058,684,21,44,401,3,1153,363.047.619
15/05/2018 18:00,37.72,39901,707,23,49,461,2,1242,363.047.619
15/05/2018 19:00,37.7,39524,644,24,57,566,3,1294,363.047.619
15/05/2018 20:00,37.12,38993,508,24,67,680,3,1282,363.047.619
15/05/2018 21:00,37.21,38847,419,22,74,767,3,1285,363.047.619
15/05/2018 22:00,36.61,38043,371,21,80,860,2,1334,363.047.619
15/05/2018 23:00,32.97,35941,304,9,76,759,3,1151,363.047.619
16/05/2018 00:00,33.91,33461,429,11,77,701,3,1221,363.047.619
16/05/2018 01:00,32.95,32288,441,14,75,648,2,1180,363.047.619
16/05/2018 02:00,32.28,31888,456,16,70,580,1,1123,363.047.619
16/05/2018 03:00,31.89,31836,558,18,57,531,0,1164,363.047.619
16/05/2018 04:00,31.74,32143,637,19,47,464,0,1167,363.047.619
16/05/2018 05:00,34.49,33664,735,15,31,361,0,1142,363.047.619
16/05/2018 06:00,38.06,36743,762,13,17,293,16,1101,363.047.619
16/05/2018 07:00,40.94,40508,750,11,17,231,16,1025,363.047.619
16/05/2018 08:00,41.98,42133,764,10,19,200,16,1009,363.047.619
16/05/2018 09:00,41.82,42088,805,12,30,215,16,1078,363.047.619
16/05/2018 10:00,41.63,41965,817,16,41,289,16,1179,363.047.619
16/05/2018 11:00,40.98,41789,910,21,46,420,16,1413,363.047.619
16/05/2018 12:00,40.24,41340,1096,25,45,618,16,1800,363.047.619
16/05/2018 13:00,39.85,41042,1299,30,47,901,8,2285,363.047.619
16/05/2018 14:00,37.99,40694,1453,35,57,1276,3,2824,363.047.619
16/05/2018 15:00,37.17,40330,1509,40,70,1514,3,3136,363.047.619
16/05/2018 16:00,37.09,40252,1421,44,91,1758,3,3317,363.047.619
16/05/2018 17:00,37.44,40086,1406,48,111,1917,2,3484,363.047.619
16/05/2018 18:00,38.01,39876,1313,52,124,2173,2,3664,363.047.619
16/05/2018 19:00,37.7,39507,1246,52,138,2362,3,3801,363.047.619
16/05/2018 20:00,36.6,39010,1189,49,164,2496,7,3905,363.047.619
16/05/2018 21:00,35.58,38917,1209,45,191,2651,8,4104,363.047.619
16/05/2018 22:00,33.57,38064,1283,44,198,2819,7,4351,363.047.619
16/05/2018 23:00,24.98,35851,1390,53,0,2920,3,4366,363.047.619
17/05/2018 00:00,21.86,33146,1413,45,0,2922,3,4383,363.047.619
17/05/2018 01:00,11.13,31923,1290,40,0,2990,3,4323,363.047.619
17/05/2018 02:00,6.9,31542,1218,35,0,2998,3,4254,363.047.619
17/05/2018 03:00,6.74,31536,1232,31,0,2987,4,4254,363.047.619
17/05/2018 04:00,6.02,31806,1155,23,0,2865,5,4048,363.047.619
17/05/2018 05:00,25.56,33023,1127,15,0,2628,4,3774,363.047.619
17/05/2018 06:00,33.39,35375,1066,10,0,2320,18,3414,363.047.619
17/05/2018 07:00,36.28,38356,1033,6,0,2050,2,3091,363.047.619
17/05/2018 08:00,38.16,40304,1131,6,0,1744,3,2884,363.047.619
17/05/2018 09:00,38.53,40791,1306,7,0,1493,5,2811,363.047.619
17/05/2018 10:00,38.62,41117,1441,8,0,1309,6,2764,363.047.619
17/05/2018 11:00,38.36,41189,1644,7,0,1191,7,2849,363.047.619
17/05/2018 12:00,37.47,40886,1835,8,0,1107,9,2959,363.047.619
17/05/2018 13:00,36.28,40689,1953,8,0,1003,7,2971,363.047.619
17/05/2018 14:00,34.68,40344,2048,6,0,976,11,3041,363.047.619
17/05/2018 15:00,33.55,39940,2069,5,0,970,5,3049,363.047.619
17/05/2018 16:00,32.84,39686,2104,4,0,979,5,3092,363.047.619
17/05/2018 17:00,35.21,39806,2108,5,0,1054,4,3171,363.047.619
17/05/2018 18:00,36.55,39834,2027,6,0,1084,3,3120,363.047.619
17/05/2018 19:00,36.77,39562,1909,8,0,1210,3,3130,363.047.619
17/05/2018 20:00,35.7,38991,1629,9,0,1421,3,3062,363.047.619
17/05/2018 21:00,35.18,38798,1382,9,0,1657,2,3050,363.047.619
17/05/2018 22:00,34.33,38016,1283,32,0,1908,4,3227,363.047.619
17/05/2018 23:00,29.06,36078,1259,11,49,2139,3,3461,363.047.619
18/05/2018 00:00,29.31,34243,1265,11,34,2317,3,3630,363.047.619
18/05/2018 01:00,23.69,33006,1218,13,28,2490,4,3753,363.047.619
18/05/2018 02:00,22.48,32653,1173,15,28,2545,6,3767,363.047.619
18/05/2018 03:00,22.47,32675,1142,18,31,2647,9,3847,363.047.619
18/05/2018 04:00,16.48,33085,1032,17,30,2572,11,3662,363.047.619
18/05/2018 05:00,33.38,34648,996,12,26,2288,8,3330,363.047.619
18/05/2018 06:00,36.76,37631,965,8,10,2107,6,3096,363.047.619
18/05/2018 07:00,39.46,41171,938,4,10,1914,6,2872,363.047.619
18/05/2018 08:00,40.25,43251,959,5,17,1758,10,2749,363.047.619
18/05/2018 09:00,40.19,43638,909,7,32,1583,10,2541,363.047.619
18/05/2018 10:00,40.07,43648,888,12,49,1435,13,2397,363.047.619
18/05/2018 11:00,39.71,43289,892,19,73,1345,16,2345,363.047.619
18/05/2018 12:00,39.04,42514,929,27,104,1236,29,2325,363.047.619
18/05/2018 13:00,38.02,41927,898,32,124,1122,44,2220,363.047.619
18/05/2018 14:00,36.54,41167,865,34,146,1061,45,2151,363.047.619
18/05/2018 15:00,35.27,40453,783,35,169,1045,46,2078,363.047.619
18/05/2018 16:00,36.5,40052,818,39,181,938,41,2017,363.047.619
18/05/2018 17:00,38.19,39965,872,34,188,819,43,1956,363.047.619
18/05/2018 18:00,39.02,39876,807,40,202,651,43,1743,363.047.619
18/05/2018 19:00,38.99,39382,765,48,214,584,41,1652,363.047.619
18/05/2018 20:00,37.22,38637,647,52,220,588,33,1540,363.047.619
18/05/2018 21:00,36.88,38362,586,50,224,620,29,1509,363.047.619
18/05/2018 22:00,35.9,37898,581,46,218,609,23,1477,363.047.619
18/05/2018 23:00,33.81,36156,630,57,186,564,18,1455,363.047.619
19/05/2018 00:00,37.32,34398,426,59,175,542,14,1216,363.047.619
19/05/2018 01:00,35.18,33358,406,58,170,487,10,1131,363.047.619
19/05/2018 02:00,34.14,32876,385,56,165,447,8,1061,363.047.619
19/05/2018 03:00,33.97,32637,358,51,157,422,9,997,363.047.619
19/05/2018 04:00,33.79,32745,326,41,137,370,9,883,363.047.619
19/05/2018 05:00,33.85,32816,319,28,110,321,7,785,363.047.619
19/05/2018 06:00,35.09,33324,294,16,87,332,4,733,363.047.619
19/05/2018 07:00,35.86,34614,242,10,88,379,8,727,363.047.619
19/05/2018 08:00,37.39,36259,216,8,102,361,9,696,363.047.619
19/05/2018 09:00,38.19,37673,184,8,125,392,10,719,363.047.619
19/05/2018 10:00,37.55,38515,162,8,130,462,10,772,363.047.619
19/05/2018 11:00,35.65,38452,164,8,125,608,11,916,363.047.619
19/05/2018 12:00,34.48,38068,198,8,116,729,15,1066,363.047.619
19/05/2018 13:00,33.85,37591,266,9,127,852,16,1270,363.047.619
19/05/2018 14:00,32.57,37262,324,10,130,929,16,1409,363.047.619
19/05/2018 15:00,32.2,36983,382,13,140,1001,16,1552,363.047.619
19/05/2018 16:00,32.22,37006,412,16,140,1012,16,1596,363.047.619
19/05/2018 17:00,34.84,37531,388,21,135,941,15,1500,363.047.619
19/05/2018 18:00,37.78,37822,348,24,124,865,13,1374,363.047.619
19/05/2018 19:00,37.5,37482,292,27,119,815,9,1262,363.047.619
19/05/2018 20:00,35.97,36859,241,29,118,847,7,1242,363.047.619
19/05/2018 21:00,35.99,36832,232,31,112,935,6,1316,363.047.619
19/05/2018 22:00,35.68,36667,244,31,106,961,3,1345,363.047.619
19/05/2018 23:00,31.77,35519,280,34,117,1001,4,1436,363.047.619
20/05/2018 00:00,32.51,33514,209,33,106,1062,3,1413,363.047.619
20/05/2018 01:00,27.71,32455,211,30,95,1043,2,1381,363.047.619
20/05/2018 02:00,22.91,32011,225,28,87,972,2,1314,363.047.619
20/05/2018 03:00,22.61,31714,243,25,82,936,3,1289,363.047.619
20/05/2018 04:00,18.01,31520,241,19,72,832,2,1166,363.047.619
20/05/2018 05:00,17.06,31326,257,12,52,714,2,1037,363.047.619
20/05/2018 06:00,22.7,31487,273,6,32,588,1,900,363.047.619
20/05/2018 07:00,27.56,32468,268,4,26,542,1,841,363.047.619
20/05/2018 08:00,31.65,33892,253,4,28,650,1,936,363.047.619
20/05/2018 09:00,32.5,35264,252,6,29,818,2,1107,363.047.619
20/05/2018 10:00,32.94,36105,263,10,31,1050,2,1356,363.047.619
20/05/2018 11:00,32.31,36349,307,15,30,1305,2,1659,363.047.619
20/05/2018 12:00,30.71,36258,359,20,32,1488,3,1902,363.047.619
20/05/2018 13:00,26.69,36004,426,27,35,1580,3,2071,363.047.619
20/05/2018 14:00,22.89,35699,502,32,42,1602,3,2181,363.047.619
20/05/2018 15:00,19.26,35491,476,36,51,1649,3,2215,363.047.619
20/05/2018 16:00,20.77,35403,534,39,56,1639,3,2271,363.047.619
20/05/2018 17:00,25.9,35822,639,41,53,1637,3,2373,363.047.619
20/05/2018 18:00,29.66,36239,688,45,53,1577,3,2366,363.047.619
20/05/2018 19:00,27.93,36214,717,50,52,1543,1,2363,363.047.619
20/05/2018 20:00,25.23,36105,712,53,55,1621,1,2442,363.047.619
20/05/2018 21:00,25.8,36355,751,55,64,1697,1,2568,363.047.619
20/05/2018 22:00,21.59,36104,855,54,69,1791,1,2770,363.047.619
20/05/2018 23:00,15.27,34748,946,29,62,1864,1,2902,363.047.619
21/05/2018 00:00,9.47,32243,894,24,58,1774,1,2751,3.975.416.667
21/05/2018 01:00,4.69,31269,864,23,58,1686,1,2632,3.975.416.667
21/05/2018 02:00,4.38,30872,832,29,64,1715,1,2641,3.975.416.667
21/05/2018 03:00,4.35,30726,812,37,71,1617,1,2538,3.975.416.667
21/05/2018 04:00,4.03,30714,811,37,73,1441,1,2363,3.975.416.667
21/05/2018 05:00,19.98,31541,801,36,53,1132,1,2023,3.975.416.667
21/05/2018 06:00,33.78,33496,805,37,32,1005,1,1880,3.975.416.667
21/05/2018 07:00,37.93,36131,793,39,19,880,1,1732,3.975.416.667
21/05/2018 08:00,37.57,38319,784,49,22,865,1,1721,3.975.416.667
21/05/2018 09:00,38.53,39200,798,57,34,870,1,1760,3.975.416.667
21/05/2018 10:00,39.05,39661,844,62,51,908,1,1866,3.975.416.667
21/05/2018 11:00,38.98,39774,1042,71,79,955,1,2148,3.975.416.667
21/05/2018 12:00,38.5,39432,1358,83,101,968,2,2512,3.975.416.667
21/05/2018 13:00,37.65,39140,1512,86,112,990,2,2702,3.975.416.667
21/05/2018 14:00,36.87,38897,1705,93,119,939,3,2859,3.975.416.667
21/05/2018 15:00,36.23,38605,1809,97,125,874,4,2909,3.975.416.667
21/05/2018 16:00,34.79,38400,1837,100,129,774,5,2845,3.975.416.667
21/05/2018 17:00,35.11,38501,1962,104,126,729,6,2927,3.975.416.667
21/05/2018 18:00,35.8,38648,1934,110,125,691,6,2866,3.975.416.667
21/05/2018 19:00,36.04,38206,1838,116,118,712,7,2791,3.975.416.667
21/05/2018 20:00,34.02,37522,1567,120,118,781,9,2595,3.975.416.667
21/05/2018 21:00,33.79,37128,1411,127,122,902,9,2571,3.975.416.667
21/05/2018 22:00,33.73,36377,1391,130,120,967,11,2619,3.975.416.667
21/05/2018 23:00,28.05,34552,1299,7,135,987,11,2439,3.975.416.667
22/05/2018 00:00,32.75,32032,1142,7,119,1059,11,2338,3.975.416.667
22/05/2018 01:00,31.5,30787,1012,6,107,1016,12,2153,3.975.416.667
22/05/2018 02:00,31.17,30500,933,7,85,1087,11,2123,3.975.416.667
22/05/2018 03:00,30.02,30507,899,9,82,879,9,1878,3.975.416.667
22/05/2018 04:00,32.06,30901,894,11,83,723,10,1721,3.975.416.667
22/05/2018 05:00,36.04,32382,896,12,57,571,8,1544,3.975.416.667
22/05/2018 06:00,41.04,35479,816,11,47,426,5,1305,3.975.416.667
22/05/2018 07:00,42.21,39130,683,7,38,349,3,1080,3.975.416.667
22/05/2018 08:00,43.35,41081,558,6,36,326,12,938,3.975.416.667
22/05/2018 09:00,43.04,41436,461,5,34,327,4,831,3.975.416.667
22/05/2018 10:00,42.64,41504,409,5,35,340,4,793,3.975.416.667
22/05/2018 11:00,42.58,41501,410,6,37,372,3,828,3.975.416.667
22/05/2018 12:00,42.21,41156,414,6,37,410,11,878,3.975.416.667
22/05/2018 13:00,42.16,40853,412,6,34,482,3,937,3.975.416.667
22/05/2018 14:00,41.68,40569,454,5,28,570,2,1059,3.975.416.667
22/05/2018 15:00,41.3,40101,451,5,27,758,2,1243,3.975.416.667
22/05/2018 16:00,41.05,39772,433,4,28,917,2,1384,3.975.416.667
22/05/2018 17:00,41.66,39602,443,4,31,1033,2,1513,3.975.416.667
22/05/2018 18:00,42.17,39452,408,5,33,1218,3,1667,3.975.416.667
22/05/2018 19:00,42.1,39043,364,7,40,1441,2,1854,3.975.416.667
22/05/2018 20:00,40.58,38503,323,11,52,1568,2,1956,3.975.416.667
22/05/2018 21:00,40.51,38236,311,16,63,1689,2,2081,3.975.416.667
22/05/2018 22:00,39.92,37272,299,19,64,1774,2,2158,3.975.416.667
22/05/2018 23:00,36.81,35021,266,25,24,2008,3,2326,3.975.416.667
23/05/2018 00:00,37.48,33269,176,29,17,2062,2,2286,3.975.416.667
23/05/2018 01:00,36.38,31926,131,34,14,2032,2,2213,3.975.416.667
23/05/2018 02:00,35.53,31398,112,39,14,1922,2,2089,3.975.416.667
23/05/2018 03:00,34.57,31305,87,44,14,1832,2,1979,3.975.416.667
23/05/2018 04:00,35.26,31483,57,41,13,1655,2,1768,3.975.416.667
23/05/2018 05:00,38.02,32705,47,33,13,1339,2,1434,3.975.416.667
23/05/2018 06:00,41.22,35747,54,20,10,990,2,1076,3.975.416.667
23/05/2018 07:00,42.18,39743,55,10,7,727,10,809,3.975.416.667
23/05/2018 08:00,42.99,41664,47,9,9,503,2,570,3.975.416.667
23/05/2018 09:00,42.93,41837,45,13,11,390,2,461,3.975.416.667
23/05/2018 10:00,42.82,41806,55,16,11,327,2,411,3.975.416.667
23/05/2018 11:00,42.72,41639,78,17,14,292,3,404,3.975.416.667
23/05/2018 12:00,42.45,41276,118,16,21,297,3,455,3.975.416.667
23/05/2018 13:00,42.4,40991,181,15,30,311,3,540,3.975.416.667
23/05/2018 14:00,41.83,40724,237,15,45,333,4,634,3.975.416.667
23/05/2018 15:00,41.42,40292,288,16,62,371,5,742,3.975.416.667
23/05/2018 16:00,41.24,40013,405,14,75,373,6,873,3.975.416.667
23/05/2018 17:00,41.2,39808,485,15,76,393,5,974,3.975.416.667
23/05/2018 18:00,42.24,39639,524,19,76,407,4,1030,3.975.416.667
23/05/2018 19:00,42.21,39158,492,22,79,475,4,1072,3.975.416.667
23/05/2018 20:00,41.64,38448,443,21,84,560,4,1112,3.975.416.667
23/05/2018 21:00,41.17,38073,462,21,87,667,4,1241,3.975.416.667
23/05/2018 22:00,40.4,37322,436,19,87,765,4,1311,3.975.416.667
23/05/2018 23:00,36.07,35364,426,33,58,731,4,1252,3.975.416.667
24/05/2018 00:00,37.14,34128,574,32,60,768,4,1438,3.975.416.667
24/05/2018 01:00,34.34,32585,547,30,62,776,4,1419,3.975.416.667
24/05/2018 02:00,33.07,32184,501,25,63,788,4,1381,3.975.416.667
24/05/2018 03:00,32.07,32032,515,21,64,792,3,1395,3.975.416.667
24/05/2018 04:00,32.97,32247,574,17,60,748,3,1402,3.975.416.667
24/05/2018 05:00,37.44,33511,654,13,40,663,3,1373,3.975.416.667
24/05/2018 06:00,40.95,36147,655,9,22,576,2,1264,3.975.416.667
24/05/2018 07:00,43.1,39707,646,8,14,523,2,1193,3.975.416.667
24/05/2018 08:00,44.62,41825,634,8,16,475,2,1135,3.975.416.667
24/05/2018 09:00,44.94,42158,654,10,22,475,2,1163,3.975.416.667
24/05/2018 10:00,44.05,42071,701,13,27,535,3,1279,3.975.416.667
24/05/2018 11:00,43.9,41874,814,18,31,604,4,1471,3.975.416.667
24/05/2018 12:00,43.74,41495,1014,23,33,625,4,1699,3.975.416.667
24/05/2018 13:00,43.46,41270,1201,28,36,643,4,1912,3.975.416.667
24/05/2018 14:00,42.5,40996,1412,35,40,670,5,2162,3.975.416.667
24/05/2018 15:00,41.81,40753,1583,36,47,675,5,2346,3.975.416.667
24/05/2018 16:00,41.46,40462,1647,33,58,684,6,2428,3.975.416.667
24/05/2018 17:00,41.21,40355,1695,31,62,684,7,2479,3.975.416.667
24/05/2018 18:00,41.97,40144,1632,29,73,684,5,2423,3.975.416.667
24/05/2018 19:00,42.63,39679,1558,29,85,768,5,2445,3.975.416.667
24/05/2018 20:00,42.23,38959,1368,33,112,909,7,2429,3.975.416.667
24/05/2018 21:00,41.48,38631,1282,34,146,1084,8,2554,3.975.416.667
24/05/2018 22:00,40.4,37897,1266,36,155,1170,7,2634,3.975.416.667
24/05/2018 23:00,36.34,35951,1300,47,153,1324,9,2833,3.975.416.667
25/05/2018 00:00,36.56,34205,1395,59,138,1227,9,2828,3.975.416.667
25/05/2018 01:00,34.73,32769,1336,69,128,1112,9,2654,3.975.416.667
25/05/2018 02:00,33.36,32247,1294,72,125,961,10,2462,3.975.416.667
25/05/2018 03:00,32.07,32213,1303,68,128,854,8,2361,3.975.416.667
25/05/2018 04:00,33.98,32539,1337,58,124,716,7,2242,3.975.416.667
25/05/2018 05:00,39.14,33758,1375,50,102,536,6,2069,3.975.416.667
25/05/2018 06:00,41.4,36487,1311,45,71,427,3,1857,3.975.416.667
25/05/2018 07:00,43.38,39848,1208,42,64,355,3,1672,3.975.416.667
25/05/2018 08:00,44.01,41859,1047,42,83,382,4,1558,3.975.416.667
25/05/2018 09:00,44.82,42263,931,45,120,439,4,1539,3.975.416.667
25/05/2018 10:00,44.41,42356,863,48,157,544,5,1617,3.975.416.667
25/05/2018 11:00,43.73,42069,888,50,176,671,5,1790,3.975.416.667
25/05/2018 12:00,42.67,41455,1067,49,179,755,5,2055,3.975.416.667
25/05/2018 13:00,42.37,40805,1181,49,182,832,4,2248,3.975.416.667
25/05/2018 14:00,41.24,40082,1312,49,180,899,3,2443,3.975.416.667
25/05/2018 15:00,40.55,39401,1299,48,172,984,3,2506,3.975.416.667
25/05/2018 16:00,40.58,38940,1255,44,164,1045,5,2513,3.975.416.667
25/05/2018 17:00,41.52,38768,1312,42,154,1113,5,2626,3.975.416.667
25/05/2018 18:00,42.21,38542,1213,42,134,1199,5,2593,3.975.416.667
25/05/2018 19:00,41.91,38012,1078,42,133,1428,5,2686,3.975.416.667
25/05/2018 20:00,41.18,37172,807,42,153,1597,7,2606,3.975.416.667
25/05/2018 21:00,40.92,36647,677,41,184,1728,8,2638,3.975.416.667
25/05/2018 22:00,40.39,36143,637,38,203,1815,8,2701,3.975.416.667
25/05/2018 23:00,39.04,34852,595,114,185,1834,9,2737,3.975.416.667
26/05/2018 00:00,40.14,33001,525,121,195,1740,8,2589,3.975.416.667
26/05/2018 01:00,38.67,31802,470,120,191,1699,7,2487,3.975.416.667
26/05/2018 02:00,36,31120,440,115,183,1687,6,2431,3.975.416.667
26/05/2018 03:00,34.97,30750,451,107,167,1613,6,2344,3.975.416.667
26/05/2018 04:00,34.27,30597,437,94,150,1342,7,2030,3.975.416.667
26/05/2018 05:00,33.81,30656,421,84,115,1132,5,1757,3.975.416.667
26/05/2018 06:00,37.34,31229,378,75,80,1018,2,1553,3.975.416.667
26/05/2018 07:00,39.62,32631,352,69,61,885,1,1368,3.975.416.667
26/05/2018 08:00,41.64,34342,359,66,51,746,1,1223,3.975.416.667
26/05/2018 09:00,41.47,35708,393,66,50,745,1,1255,3.975.416.667
26/05/2018 10:00,40.61,36552,437,66,51,696,0,1250,3.975.416.667
26/05/2018 11:00,40.04,36595,485,68,56,671,0,1280,3.975.416.667
26/05/2018 12:00,39.08,36263,602,75,58,643,0,1378,3.975.416.667
26/05/2018 13:00,37.98,36000,676,81,59,654,1,1471,3.975.416.667
26/05/2018 14:00,37.11,35683,700,89,58,705,1,1553,3.975.416.667
26/05/2018 15:00,36.8,35406,678,98,59,765,1,1601,3.975.416.667
26/05/2018 16:00,36.94,35403,782,101,61,816,1,1761,3.975.416.667
26/05/2018 17:00,39.08,35855,918,101,69,828,2,1918,3.975.416.667
26/05/2018 18:00,41.73,36174,821,97,83,900,2,1903,3.975.416.667
26/05/2018 19:00,42.34,35805,715,89,114,953,4,1875,3.975.416.667
26/05/2018 20:00,42.26,35197,599,83,145,1006,5,1838,3.975.416.667
26/05/2018 21:00,42.03,35108,543,77,153,1187,5,1965,3.975.416.667
26/05/2018 22:00,41.82,34920,502,68,151,1240,6,1967,3.975.416.667
26/05/2018 23:00,39.12,33823,457,60,123,1258,8,1906,3.975.416.667
27/05/2018 00:00,38.82,32317,280,53,114,1242,7,1696,3.975.416.667
27/05/2018 01:00,36.28,31221,289,46,95,1316,7,1753,3.975.416.667
27/05/2018 02:00,34.02,30677,330,40,82,1363,5,1820,3.975.416.667
27/05/2018 03:00,33.06,30162,399,32,58,1397,5,1891,3.975.416.667
27/05/2018 04:00,32.6,29787,396,22,36,1329,3,1786,3.975.416.667
27/05/2018 05:00,32.01,29635,472,12,21,1107,2,1614,3.975.416.667
27/05/2018 06:00,34.42,29877,482,6,13,973,0,1474,3.975.416.667
27/05/2018 07:00,36.52,30988,437,4,9,947,0,1397,3.975.416.667
27/05/2018 08:00,37.67,32590,495,5,8,980,0,1488,3.975.416.667
27/05/2018 09:00,38.86,34099,637,5,12,1034,0,1688,3.975.416.667
27/05/2018 10:00,39.25,35077,819,7,21,1105,0,1952,3.975.416.667
27/05/2018 11:00,38.98,35441,1070,9,22,1199,0,2300,3.975.416.667
27/05/2018 12:00,38.56,35425,1206,10,23,1258,0,2497,3.975.416.667
27/05/2018 13:00,37.94,35341,1372,12,20,1315,0,2719,3.975.416.667
27/05/2018 14:00,37.24,35198,1447,12,20,1336,1,2816,3.975.416.667
27/05/2018 15:00,37.63,35193,1535,12,21,1376,2,2946,3.975.416.667
27/05/2018 16:00,37.85,35329,1603,11,23,1368,3,3008,3.975.416.667
27/05/2018 17:00,38.89,35885,1722,11,30,1362,3,3128,3.975.416.667
27/05/2018 18:00,41.33,36405,1709,12,42,1338,4,3105,3.975.416.667
27/05/2018 19:00,42.33,36282,1610,13,59,1392,6,3080,3.975.416.667
27/05/2018 20:00,42.11,36014,1523,14,83,1549,9,3178,3.975.416.667
27/05/2018 21:00,41.98,36062,1429,15,96,1683,13,3236,3.975.416.667
27/05/2018 22:00,41.27,35674,1378,16,95,1808,12,3309,3.975.416.667
27/05/2018 23:00,37.69,34297,1391,48,68,1836,13,3356,3.975.416.667
28/05/2018 00:00,37.15,32816,1819,48,67,1928,14,3876,4.300.297.619
28/05/2018 01:00,33.98,31743,1837,49,68,1970,14,3938,4.300.297.619
28/05/2018 02:00,29.36,31294,1812,49,72,1988,14,3935,4.300.297.619
28/05/2018 03:00,28.86,31216,1712,46,74,2021,14,3867,4.300.297.619
28/05/2018 04:00,31.81,31306,1688,36,64,1869,13,3670,4.300.297.619
28/05/2018 05:00,37.78,32665,1697,26,34,1575,11,3343,4.300.297.619
28/05/2018 06:00,42.8,35857,1601,19,17,1288,7,2932,4.300.297.619
28/05/2018 07:00,44.76,39418,1413,16,7,1084,4,2524,4.300.297.619
28/05/2018 08:00,45.63,41306,1230,15,7,980,3,2235,4.300.297.619
28/05/2018 09:00,45.34,41647,1177,16,13,983,2,2191,4.300.297.619
28/05/2018 10:00,45.28,41896,1157,16,19,1007,3,2202,4.300.297.619
28/05/2018 11:00,44.97,41869,1163,16,20,1087,2,2288,4.300.297.619
28/05/2018 12:00,44.42,41536,1127,16,25,1074,2,2244,4.300.297.619
28/05/2018 13:00,44.43,41212,1074,16,27,1054,1,2172,4.300.297.619
28/05/2018 14:00,43.91,40905,1020,18,27,1093,1,2159,4.300.297.619
28/05/2018 15:00,43.82,40519,967,20,27,1168,2,2184,4.300.297.619
28/05/2018 16:00,43.85,40267,947,22,28,1173,3,2173,4.300.297.619
28/05/2018 17:00,43.92,40184,906,24,30,1232,3,2195,4.300.297.619
28/05/2018 18:00,43.97,39868,807,27,33,1283,3,2153,4.300.297.619
28/05/2018 19:00,44.14,39357,780,28,37,1394,5,2244,4.300.297.619
28/05/2018 20:00,43.85,38627,777,31,49,1600,7,2464,4.300.297.619
28/05/2018 21:00,43.59,38260,826,36,68,1803,7,2740,4.300.297.619
28/05/2018 22:00,42.89,37515,793,39,79,1939,8,2858,4.300.297.619
28/05/2018 23:00,39.17,35640,813,57,113,1969,7,2959,4.300.297.619
29/05/2018 00:00,38.74,33596,803,56,101,1874,5,2839,4.300.297.619
29/05/2018 01:00,35.77,32167,767,53,86,1795,4,2705,4.300.297.619
29/05/2018 02:00,35.58,31601,739,49,68,1796,5,2657,4.300.297.619
29/05/2018 03:00,35.23,31411,730,44,56,1709,4,2543,4.300.297.619
29/05/2018 04:00,35.2,31499,678,36,41,1680,4,2439,4.300.297.619
29/05/2018 05:00,38.68,32759,682,24,30,1506,3,2245,4.300.297.619
29/05/2018 06:00,42.24,35781,718,15,15,1396,3,2147,4.300.297.619
29/05/2018 07:00,44.38,39378,705,12,10,1311,2,2040,4.300.297.619
29/05/2018 08:00,45.18,41185,621,12,10,1409,2,2054,4.300.297.619
29/05/2018 09:00,44.64,41534,633,15,15,1488,2,2153,4.300.297.619
29/05/2018 10:00,44.35,41757,708,16,19,1629,3,2375,4.300.297.619
29/05/2018 11:00,43.94,41680,813,18,21,1827,3,2682,4.300.297.619
29/05/2018 12:00,43.74,41289,981,22,21,1979,4,3007,4.300.297.619
29/05/2018 13:00,43.52,41042,1158,26,20,2050,3,3257,4.300.297.619
29/05/2018 14:00,42.97,40738,1383,27,18,2070,3,3501,4.300.297.619
29/05/2018 15:00,42.59,40250,1584,28,17,2177,3,3809,4.300.297.619
29/05/2018 16:00,42.3,39972,1529,27,17,2201,3,3777,4.300.297.619
29/05/2018 17:00,43.26,39849,1603,25,20,2189,3,3840,4.300.297.619
29/05/2018 18:00,43.83,39570,1575,24,27,2120,3,3749,4.300.297.619
29/05/2018 19:00,43.91,39117,1561,23,34,2067,3,3688,4.300.297.619
29/05/2018 20:00,43.22,38343,1449,22,49,2079,3,3602,4.300.297.619
29/05/2018 21:00,42.84,37856,1561,26,64,2071,4,3726,4.300.297.619
29/05/2018 22:00,42.3,37069,1600,29,64,2113,3,3809,4.300.297.619
29/05/2018 23:00,38.85,35267,1648,38,25,2065,3,3779,4.300.297.619
30/05/2018 00:00,39.48,33097,2012,41,23,2006,3,4085,4.300.297.619
30/05/2018 01:00,36.54,31656,1981,44,24,1981,2,4032,4.300.297.619
30/05/2018 02:00,35.04,31086,1982,44,21,1931,2,3980,4.300.297.619
30/05/2018 03:00,34,30909,1987,39,20,1832,2,3880,4.300.297.619
30/05/2018 04:00,35.54,31014,2030,31,17,1624,2,3704,4.300.297.619
30/05/2018 05:00,39.25,32280,2107,20,10,1334,2,3473,4.300.297.619
30/05/2018 06:00,42.91,35452,2089,9,8,1043,2,3151,4.300.297.619
30/05/2018 07:00,44.65,39199,1956,4,5,904,2,2871,4.300.297.619
30/05/2018 08:00,44.83,41131,1780,3,5,860,2,2650,4.300.297.619
30/05/2018 09:00,44.7,41366,1735,4,5,851,2,2597,4.300.297.619
30/05/2018 10:00,44.6,41501,1743,6,5,862,2,2618,4.300.297.619
30/05/2018 11:00,44.54,41461,1834,9,5,895,2,2745,4.300.297.619
30/05/2018 12:00,44.19,41192,2026,12,7,889,2,2936,4.300.297.619
30/05/2018 13:00,44.1,40975,2150,16,8,905,3,3082,4.300.297.619
30/05/2018 14:00,43.82,40713,2258,23,15,914,5,3215,4.300.297.619
30/05/2018 15:00,44,40303,2218,32,24,947,6,3227,4.300.297.619
30/05/2018 16:00,44.13,40025,2079,40,34,944,7,3104,4.300.297.619
30/05/2018 17:00,44.29,39802,2071,47,54,968,7,3147,4.300.297.619
30/05/2018 18:00,44.61,39483,1958,57,80,1028,6,3129,4.300.297.619
30/05/2018 19:00,44.85,39068,1962,67,100,1137,6,3272,4.300.297.619
30/05/2018 20:00,44.53,38366,1797,78,110,1310,7,3302,4.300.297.619
30/05/2018 21:00,44.35,37891,1792,89,125,1486,8,3500,4.300.297.619
30/05/2018 22:00,44.04,37146,1964,97,127,1599,9,3796,4.300.297.619
30/05/2018 23:00,42.26,35365,2062,124,125,1672,8,3991,4.300.297.619
31/05/2018 00:00,41.98,33192,1551,121,111,1790,8,3581,4.300.297.619
31/05/2018 01:00,39.27,31716,1499,111,101,1846,8,3565,4.300.297.619
31/05/2018 02:00,36.95,31246,1470,95,91,1916,7,3579,4.300.297.619
31/05/2018 03:00,37.48,31059,1468,81,87,2009,6,3651,4.300.297.619
31/05/2018 04:00,36.68,31221,1559,64,78,1925,7,3633,4.300.297.619
31/05/2018 05:00,39.64,32440,1654,49,58,1697,7,3465,4.300.297.619
31/05/2018 06:00,43.13,35267,1646,37,30,1593,5,3311,4.300.297.619
31/05/2018 07:00,45.57,38875,1569,29,28,1510,5,3141,4.300.297.619
31/05/2018 08:00,46.51,40972,1519,25,29,1438,6,3017,4.300.297.619
31/05/2018 09:00,45.35,41426,1629,27,38,1449,7,3150,4.300.297.619
31/05/2018 10:00,45.23,41582,1768,32,49,1508,7,3364,4.300.297.619
31/05/2018 11:00,44.92,41552,1889,38,55,1541,8,3531,4.300.297.619
31/05/2018 12:00,44.47,41259,1951,47,57,1569,10,3634,4.300.297.619
31/05/2018 13:00,44.48,41103,1935,54,60,1626,11,3686,4.300.297.619
31/05/2018 14:00,44.02,40867,1971,60,62,1664,10,3767,4.300.297.619
31/05/2018 15:00,43.72,40534,1976,61,64,1701,8,3810,4.300.297.619
31/05/2018 16:00,43.44,40285,1847,60,74,1610,7,3598,4.300.297.619
31/05/2018 17:00,44.05,40167,1764,56,91,1634,7,3552,4.300.297.619
31/05/2018 18:00,45.05,39904,1738,51,113,1675,8,3585,4.300.297.619
31/05/2018 19:00,44.95,39442,1792,50,142,1773,8,3765,4.300.297.619
31/05/2018 20:00,44.76,38763,1636,61,171,1964,9,3841,4.300.297.619
31/05/2018 21:00,44.58,38330,1601,81,199,2237,10,4128,4.300.297.619
31/05/2018 22:00,44.01,37548,1610,94,205,2356,11,4276,4.300.297.619
31/05/2018 23:00,41.36,35710,1605,124,0,2296,6,4031,4.300.297.619
01/06/2018 00:00,41.32,33802,1487,121,0,2298,5,3911,4.300.297.619
01/06/2018 01:00,38.54,32395,1378,111,0,2177,5,3671,4.300.297.619
01/06/2018 02:00,38.49,31816,1264,98,0,2082,5,3449,4.300.297.619
01/06/2018 03:00,38,31550,1178,85,0,1853,5,3121,4.300.297.619
01/06/2018 04:00,37.99,31636,1121,73,0,1441,6,2641,4.300.297.619
01/06/2018 05:00,41.08,32859,1103,68,0,1174,7,2352,4.300.297.619
01/06/2018 06:00,45.18,35765,939,63,0,940,9,1951,4.300.297.619
01/06/2018 07:00,46.22,39417,735,55,0,856,10,1656,4.300.297.619
01/06/2018 08:00,46.96,41539,678,49,0,742,9,1478,4.300.297.619
01/06/2018 09:00,47.29,41924,696,47,0,643,9,1395,4.300.297.619
01/06/2018 10:00,47.53,42128,673,45,0,623,9,1350,4.300.297.619
01/06/2018 11:00,47.4,41860,553,40,0,703,9,1305,4.300.297.619
01/06/2018 12:00,46.81,41218,553,35,0,813,9,1410,4.300.297.619
01/06/2018 13:00,46.31,40753,568,31,0,812,10,1421,4.300.297.619
01/06/2018 14:00,45.56,40025,583,25,0,860,9,1477,4.300.297.619
01/06/2018 15:00,44.79,39399,519,19,0,884,8,1430,4.300.297.619
01/06/2018 16:00,44.41,38873,506,15,0,903,8,1432,4.300.297.619
01/06/2018 17:00,44.63,38599,524,14,0,973,5,1516,4.300.297.619
01/06/2018 18:00,45.93,38386,510,15,0,972,3,1500,4.300.297.619
01/06/2018 19:00,46,37842,506,17,0,985,2,1510,4.300.297.619
01/06/2018 20:00,45.35,36858,437,19,0,998,2,1456,4.300.297.619
01/06/2018 21:00,45.05,36262,404,18,0,1041,1,1464,4.300.297.619
01/06/2018 22:00,44.95,35731,369,18,0,1109,1,1497,4.300.297.619
01/06/2018 23:00,44.16,34495,325,51,90,1162,3,1631,4.300.297.619
02/06/2018 00:00,42.15,32620,292,54,73,1254,4,1677,4.300.297.619
02/06/2018 01:00,40.41,31382,260,53,66,1259,3,1641,4.300.297.619
02/06/2018 02:00,39.13,30592,284,49,58,1195,2,1588,4.300.297.619
02/06/2018 03:00,38.49,30135,310,43,53,1235,2,1643,4.300.297.619
02/06/2018 04:00,38.5,29935,256,32,46,1131,2,1467,4.300.297.619
02/06/2018 05:00,38.77,29938,210,19,31,894,2,1156,4.300.297.619
02/06/2018 06:00,40.47,30558,164,9,19,708,2,902,4.300.297.619
02/06/2018 07:00,42.24,32026,124,5,14,642,2,787,4.300.297.619
02/06/2018 08:00,43.45,33776,108,3,12,624,2,749,4.300.297.619
02/06/2018 09:00,44.32,35268,95,3,12,635,2,747,4.300.297.619
02/06/2018 10:00,43.92,36104,82,4,14,673,2,775,4.300.297.619
02/06/2018 11:00,43.6,36195,87,5,18,767,2,879,4.300.297.619
02/06/2018 12:00,43.02,35986,90,7,22,796,3,918,4.300.297.619
02/06/2018 13:00,42.57,35625,105,8,29,831,3,976,4.300.297.619
02/06/2018 14:00,42.32,35338,137,8,37,917,4,1103,4.300.297.619
02/06/2018 15:00,42.22,35129,197,8,54,1079,5,1343,4.300.297.619
02/06/2018 16:00,42.25,35180,246,7,59,1126,4,1442,4.300.297.619
02/06/2018 17:00,43.02,35588,233,7,67,1167,3,1477,4.300.297.619
02/06/2018 18:00,43.92,35880,253,8,77,1121,3,1462,4.300.297.619
02/06/2018 19:00,44.46,35548,241,11,82,1177,2,1513,4.300.297.619
02/06/2018 20:00,43.96,34889,228,14,98,1227,2,1569,4.300.297.619
02/06/2018 21:00,43.96,34572,218,18,104,1202,2,1544,4.300.297.619
02/06/2018 22:00,43.68,34261,187,20,103,1184,2,1496,4.300.297.619
02/06/2018 23:00,42.2,33323,186,16,67,1132,2,1403,4.300.297.619
03/06/2018 00:00,43.39,31814,248,18,58,1001,2,1327,4.300.297.619
03/06/2018 01:00,41.59,30620,306,18,48,1030,2,1404,4.300.297.619
03/06/2018 02:00,40.04,29993,283,17,33,1069,2,1404,4.300.297.619
03/06/2018 03:00,39.33,29505,260,17,24,1094,2,1397,4.300.297.619
03/06/2018 04:00,38.43,29056,269,16,14,965,2,1266,4.300.297.619
03/06/2018 05:00,39.25,29027,305,15,11,841,2,1174,4.300.297.619
03/06/2018 06:00,40.18,29396,268,16,6,657,2,949,4.300.297.619
03/06/2018 07:00,41.39,30426,219,22,7,615,2,865,4.300.297.619
03/06/2018 08:00,43.08,32042,231,29,10,694,2,966,4.300.297.619
03/06/2018 09:00,43.57,33511,277,36,15,785,2,1115,4.300.297.619
03/06/2018 10:00,44.03,34515,342,42,27,961,4,1376,4.300.297.619
03/06/2018 11:00,43.89,34896,446,44,50,1223,3,1766,4.300.297.619
03/06/2018 12:00,43.89,34810,582,46,74,1509,3,2214,4.300.297.619
03/06/2018 13:00,43.46,34680,690,45,90,1668,5,2498,4.300.297.619
03/06/2018 14:00,41.62,34483,752,43,102,1973,5,2875,4.300.297.619
03/06/2018 15:00,40.97,34484,777,41,110,2211,5,3144,4.300.297.619
03/06/2018 16:00,41.32,34703,756,45,106,2429,3,3339,4.300.297.619
03/06/2018 17:00,42.58,35180,828,44,87,2469,2,3430,4.300.297.619
03/06/2018 18:00,43.57,35521,918,43,69,2528,2,3560,4.300.297.619
03/06/2018 19:00,44.5,35534,989,44,62,2734,2,3831,4.300.297.619
03/06/2018 20:00,45.11,35357,977,48,60,2938,2,4025,4.300.297.619
03/06/2018 21:00,45.29,35381,1065,53,62,3242,4,4426,4.300.297.619
03/06/2018 22:00,44.94,35005,1121,56,65,3438,5,4685,4.300.297.619
03/06/2018 23:00,40.66,33837,1216,15,70,3580,8,4889,4.300.297.619
04/06/2018 00:00,38.86,32218,1464,14,80,3729,11,5298,4.402.380.952
04/06/2018 01:00,36.21,31088,1508,18,90,3702,14,5332,4.402.380.952
04/06/2018 02:00,32.81,30532,1544,24,110,3729,21,5428,4.402.380.952
04/06/2018 03:00,31.92,30439,1542,31,132,3725,18,5448,4.402.380.952
04/06/2018 04:00,31.45,30525,1582,32,138,3678,12,5442,4.402.380.952
04/06/2018 05:00,37.48,31955,1596,25,122,3601,9,5353,4.402.380.952
04/06/2018 06:00,44.9,35138,1617,17,114,3556,13,5317,4.402.380.952
04/06/2018 07:00,45.62,38698,1496,15,126,3444,18,5099,4.402.380.952
04/06/2018 08:00,45.74,40729,1393,15,168,3455,14,5045,4.402.380.952
04/06/2018 09:00,45.81,41253,1391,18,215,3336,17,4977,4.402.380.952
04/06/2018 10:00,45.81,41543,1425,21,261,3333,16,5056,4.402.380.952
04/06/2018 11:00,45.66,41662,1584,24,294,3362,15,5279,4.402.380.952
04/06/2018 12:00,45.64,41502,1544,24,318,3380,17,5283,4.402.380.952
04/06/2018 13:00,45.44,41200,1549,23,320,3443,19,5354,4.402.380.952
04/06/2018 14:00,45.28,41037,1509,22,306,3505,23,5365,4.402.380.952
04/06/2018 15:00,45,40582,1407,21,287,3554,25,5294,4.402.380.952
04/06/2018 16:00,44.67,40350,1390,19,263,3576,23,5271,4.402.380.952
04/06/2018 17:00,45.44,40281,1405,18,225,3635,25,5308,4.402.380.952
04/06/2018 18:00,45.98,39949,1393,17,194,3608,22,5234,4.402.380.952
04/06/2018 19:00,45.98,39450,1320,19,180,3617,16,5152,4.402.380.952
04/06/2018 20:00,45.62,38699,1119,23,179,3651,10,4982,4.402.380.952
04/06/2018 21:00,45.37,38235,1079,29,171,3712,10,5001,4.402.380.952
04/06/2018 22:00,45.27,37495,986,33,148,3745,9,4921,4.402.380.952
04/06/2018 23:00,43.07,35830,1015,69,90,3808,6,4988,4.402.380.952
05/06/2018 00:00,42.66,33891,827,77,74,3802,7,4787,4.402.380.952
05/06/2018 01:00,41.01,32487,755,86,63,3810,8,4722,4.402.380.952
05/06/2018 02:00,39.44,31962,648,86,61,3809,8,4612,4.402.380.952
05/06/2018 03:00,39.35,31856,666,92,60,3784,11,4613,4.402.380.952
05/06/2018 04:00,39.05,31930,868,84,67,3778,13,4810,4.402.380.952
05/06/2018 05:00,41.63,33310,977,82,76,3742,15,4892,4.402.380.952
05/06/2018 06:00,45.9,36578,1073,89,91,3653,22,4928,4.402.380.952
05/06/2018 07:00,46.84,39743,1134,112,118,3429,25,4818,4.402.380.952
05/06/2018 08:00,46.92,41687,1093,125,165,3199,27,4609,4.402.380.952
05/06/2018 09:00,47.07,42261,1136,145,215,3080,30,4606,4.402.380.952
05/06/2018 10:00,47.24,42512,1206,180,253,2915,32,4586,4.402.380.952
05/06/2018 11:00,47.52,42489,1151,206,301,2785,32,4475,4.402.380.952
05/06/2018 12:00,47.5,42296,1179,221,333,2731,34,4498,4.402.380.952
05/06/2018 13:00,47.08,41949,1107,228,354,2654,37,4380,4.402.380.952
05/06/2018 14:00,46.88,41654,1028,234,367,2600,37,4266,4.402.380.952
05/06/2018 15:00,46.61,41264,1045,237,378,2531,37,4228,4.402.380.952
05/06/2018 16:00,46.45,41027,1081,237,378,2515,37,4248,4.402.380.952
05/06/2018 17:00,46.97,40865,1073,232,366,2465,37,4173,4.402.380.952
05/06/2018 18:00,47.82,40587,956,226,341,2300,36,3859,4.402.380.952
05/06/2018 19:00,48.2,40112,868,223,290,2186,31,3598,4.402.380.952
05/06/2018 20:00,47.54,39430,750,221,241,2110,23,3345,4.402.380.952
05/06/2018 21:00,47.16,38965,699,219,208,1998,16,3140,4.402.380.952
05/06/2018 22:00,47.32,38283,779,217,176,2034,12,3218,4.402.380.952
05/06/2018 23:00,44.91,36578,819,221,155,2025,11,3231,4.402.380.952
06/06/2018 00:00,44.99,33960,684,220,134,2054,9,3101,4.402.380.952
06/06/2018 01:00,42.28,32808,670,219,123,2037,8,3057,4.402.380.952
06/06/2018 02:00,41.24,32179,664,218,112,1944,7,2945,4.402.380.952
06/06/2018 03:00,41.68,31928,612,217,106,1813,9,2757,4.402.380.952
06/06/2018 04:00,41.75,31881,609,216,96,1623,7,2551,4.402.380.952
06/06/2018 05:00,44.64,32940,556,214,80,1389,7,2246,4.402.380.952
06/06/2018 06:00,47.39,35226,507,213,78,1164,9,1971,4.402.380.952
06/06/2018 07:00,48.42,37973,474,210,82,1021,9,1796,4.402.380.952
06/06/2018 08:00,49.02,39402,458,213,100,946,4,1721,4.402.380.952
06/06/2018 09:00,49.42,39962,426,213,110,940,4,1693,4.402.380.952
06/06/2018 10:00,49.93,40345,409,214,121,926,3,1673,4.402.380.952
06/06/2018 11:00,49.92,40430,382,211,134,952,4,1683,4.402.380.952
06/06/2018 12:00,48.57,40127,445,206,146,1010,3,1810,4.402.380.952
06/06/2018 13:00,47.86,39958,444,200,152,946,3,1745,4.402.380.952
06/06/2018 14:00,47.87,39709,448,196,145,999,3,1791,4.402.380.952
06/06/2018 15:00,47.82,39257,481,188,133,1058,4,1864,4.402.380.952
06/06/2018 16:00,48.32,39061,560,179,119,1040,4,1902,4.402.380.952
06/06/2018 17:00,48.43,39071,668,168,96,986,5,1923,4.402.380.952
06/06/2018 18:00,49.08,38914,686,155,74,916,4,1835,4.402.380.952
06/06/2018 19:00,49.36,38537,723,140,59,871,2,1795,4.402.380.952
06/06/2018 20:00,48.33,37745,699,124,55,853,2,1733,4.402.380.952
06/06/2018 21:00,48.26,37294,691,115,55,922,1,1784,4.402.380.952
06/06/2018 22:00,47.47,36754,892,104,46,1092,1,2135,4.402.380.952
06/06/2018 23:00,45.17,35294,988,109,38,1233,2,2370,4.402.380.952
07/06/2018 00:00,44.39,34690,856,98,44,1498,2,2498,4.402.380.952
07/06/2018 01:00,42.53,33290,816,86,52,1662,3,2619,4.402.380.952
07/06/2018 02:00,41.72,32734,755,76,56,1847,3,2737,4.402.380.952
07/06/2018 03:00,41.48,32470,716,65,60,1989,3,2833,4.402.380.952
07/06/2018 04:00,40.81,32520,697,57,59,2034,3,2850,4.402.380.952
07/06/2018 05:00,43.97,33783,634,52,34,1956,3,2679,4.402.380.952
07/06/2018 06:00,47.91,36508,570,49,30,1933,2,2584,4.402.380.952
07/06/2018 07:00,50.91,39930,495,47,32,1890,3,2467,4.402.380.952
07/06/2018 08:00,52.23,41846,481,46,47,1986,2,2562,4.402.380.952
07/06/2018 09:00,51.1,42364,481,50,70,2280,2,2883,4.402.380.952
07/06/2018 10:00,50.33,42518,470,55,89,2480,3,3097,4.402.380.952
07/06/2018 11:00,49.77,42375,502,63,114,2650,4,3333,4.402.380.952
07/06/2018 12:00,48.91,42008,538,76,141,2772,6,3533,4.402.380.952
07/06/2018 13:00,48.64,41787,527,87,149,2786,7,3556,4.402.380.952
07/06/2018 14:00,48.65,41532,568,87,143,2775,11,3584,4.402.380.952
07/06/2018 15:00,49.11,41128,564,86,126,2720,11,3507,4.402.380.952
07/06/2018 16:00,49.13,40734,548,85,108,2569,12,3322,4.402.380.952
07/06/2018 17:00,49.31,40579,492,85,83,2330,11,3001,4.402.380.952
07/06/2018 18:00,49.74,40292,457,80,61,2063,10,2671,4.402.380.952
07/06/2018 19:00,49.85,39785,419,74,57,1874,12,2436,4.402.380.952
07/06/2018 20:00,49.53,39032,437,73,60,1762,13,2345,4.402.380.952
07/06/2018 21:00,49.44,38544,493,73,79,1685,19,2349,4.402.380.952
07/06/2018 22:00,49.21,37794,534,75,93,1653,20,2375,4.402.380.952
07/06/2018 23:00,46.5,36109,539,50,92,1559,23,2263,4.402.380.952
08/06/2018 00:00,46.01,34397,324,43,123,1448,23,1961,4.402.380.952
08/06/2018 01:00,42.71,33073,284,37,137,1283,21,1762,4.402.380.952
08/06/2018 02:00,42.28,32450,247,32,140,1123,18,1560,4.402.380.952
08/06/2018 03:00,43.09,32152,196,28,136,968,16,1344,4.402.380.952
08/06/2018 04:00,43.35,32181,155,23,123,752,10,1063,4.402.380.952
08/06/2018 05:00,46.3,33435,116,19,91,514,6,746,4.402.380.952
08/06/2018 06:00,49.33,36353,95,20,63,384,2,564,4.402.380.952
08/06/2018 07:00,52.04,39906,69,24,47,306,2,448,4.402.380.952
08/06/2018 08:00,54.52,41845,55,30,46,301,2,434,4.402.380.952
08/06/2018 09:00,53.9,42195,53,41,45,293,1,433,4.402.380.952
08/06/2018 10:00,53.64,42415,63,59,43,315,3,483,4.402.380.952
08/06/2018 11:00,52.87,42226,82,77,44,338,4,545,4.402.380.952
08/06/2018 12:00,49.95,41677,115,92,44,365,3,619,4.402.380.952
08/06/2018 13:00,49.85,41243,167,108,44,423,4,746,4.402.380.952
08/06/2018 14:00,49.62,40613,270,123,43,454,4,894,4.402.380.952
08/06/2018 15:00,48.77,40056,380,134,43,512,4,1073,4.402.380.952
08/06/2018 16:00,48.68,39553,475,132,42,552,5,1206,4.402.380.952
08/06/2018 17:00,49.45,39390,465,125,39,580,4,1213,4.402.380.952
08/06/2018 18:00,49.75,39168,450,122,39,629,4,1244,4.402.380.952
08/06/2018 19:00,49.41,38588,435,116,43,682,2,1278,4.402.380.952
08/06/2018 20:00,48.88,37629,427,109,52,731,2,1321,4.402.380.952
08/06/2018 21:00,48.84,36959,438,98,64,841,3,1444,4.402.380.952
08/06/2018 22:00,49.24,36397,464,85,79,912,3,1543,4.402.380.952
08/06/2018 23:00,47.28,35219,481,31,78,877,3,1470,4.402.380.952
09/06/2018 00:00,46.26,33654,294,32,80,889,2,1297,4.402.380.952
09/06/2018 01:00,43.7,32386,266,30,78,881,2,1257,4.402.380.952
09/06/2018 02:00,42.07,31667,252,26,67,854,1,1200,4.402.380.952
09/06/2018 03:00,41.32,31247,239,22,64,761,1,1087,4.402.380.952
09/06/2018 04:00,40.25,30954,258,16,55,649,1,979,4.402.380.952
09/06/2018 05:00,41.92,31055,250,10,33,511,1,805,4.402.380.952
09/06/2018 06:00,45.24,31783,243,8,12,400,2,665,4.402.380.952
09/06/2018 07:00,46.93,33276,222,8,10,349,1,590,4.402.380.952
09/06/2018 08:00,47.43,35013,206,8,10,328,2,554,4.402.380.952
09/06/2018 09:00,48.17,36445,203,11,10,343,2,569,4.402.380.952
09/06/2018 10:00,48.21,37267,196,16,10,357,1,580,4.402.380.952
09/06/2018 11:00,48.06,37401,197,23,9,362,1,592,4.402.380.952
09/06/2018 12:00,47.73,37283,211,32,10,364,1,618,4.402.380.952
09/06/2018 13:00,47.38,36872,234,43,12,371,1,661,4.402.380.952
09/06/2018 14:00,46.87,36470,235,55,19,394,1,704,4.402.380.952
09/06/2018 15:00,46.47,36223,238,63,23,434,1,759,4.402.380.952
09/06/2018 16:00,46.65,36200,269,67,28,443,2,809,4.402.380.952
09/06/2018 17:00,47.25,36559,313,62,30,432,1,838,4.402.380.952
09/06/2018 18:00,48.41,36716,318,58,34,446,1,857,4.402.380.952
09/06/2018 19:00,48.46,36269,303,59,40,492,0,894,4.402.380.952
09/06/2018 20:00,47.96,35601,318,70,51,580,1,1020,4.402.380.952
09/06/2018 21:00,47.83,35332,346,85,68,677,1,1177,4.402.380.952
09/06/2018 22:00,47.51,34936,346,96,67,761,2,1272,4.402.380.952
09/06/2018 23:00,45.29,33999,349,105,93,686,2,1235,4.402.380.952
10/06/2018 00:00,45.46,32801,250,105,100,665,4,1124,4.402.380.952
10/06/2018 01:00,43.95,31544,243,101,99,676,4,1123,4.402.380.952
10/06/2018 02:00,43.31,30942,248,94,98,636,4,1080,4.402.380.952
10/06/2018 03:00,42.19,30459,234,86,96,517,5,938,4.402.380.952
10/06/2018 04:00,42.08,29948,240,72,80,453,5,850,4.402.380.952
10/06/2018 05:00,42.92,29879,221,61,49,353,4,688,4.402.380.952
10/06/2018 06:00,44.2,30354,217,49,13,226,3,508,4.402.380.952
10/06/2018 07:00,45.52,31429,208,39,11,156,3,417,4.402.380.952
10/06/2018 08:00,46.42,32991,164,35,11,150,4,364,4.402.380.952
10/06/2018 09:00,46.46,34477,135,36,10,177,5,363,4.402.380.952
10/06/2018 10:00,47.21,35464,176,45,10,224,4,459,4.402.380.952
10/06/2018 11:00,47.33,35868,263,60,11,305,4,643,4.402.380.952
10/06/2018 12:00,47.21,35891,334,80,10,375,3,802,4.402.380.952
10/06/2018 13:00,46.76,35720,399,99,10,458,3,969,4.402.380.952
10/06/2018 14:00,45.81,35608,473,112,11,543,2,1141,4.402.380.952
10/06/2018 15:00,45.21,35545,565,120,9,671,2,1367,4.402.380.952
10/06/2018 16:00,45.68,35689,563,118,9,767,1,1458,4.402.380.952
10/06/2018 17:00,46.67,36128,601,113,13,816,1,1544,4.402.380.952
10/06/2018 18:00,47.55,36405,631,105,19,767,1,1523,4.402.380.952
10/06/2018 19:00,48.46,36386,630,93,33,771,1,1528,4.402.380.952
10/06/2018 20:00,48.55,36194,640,82,67,850,2,1641,4.402.380.952
10/06/2018 21:00,48.48,36061,659,75,108,949,7,1798,4.402.380.952
10/06/2018 22:00,48.49,35647,654,69,130,1030,11,1894,4.402.380.952
10/06/2018 23:00,46.73,34515,681,45,201,1172,4,2103,4.402.380.952
11/06/2018 00:00,45.35,32803,1192,44,202,1331,7,2776,4.543.154.762
11/06/2018 01:00,42.3,31696,1411,48,198,1353,8,3018,4.543.154.762
11/06/2018 02:00,41.28,31196,1564,50,185,1329,9,3137,4.543.154.762
11/06/2018 03:00,40.04,31090,1639,46,160,1356,8,3209,4.543.154.762
11/06/2018 04:00,40.06,31118,1776,39,132,1266,6,3219,4.543.154.762
11/06/2018 05:00,43.63,32451,1893,32,87,1167,5,3184,4.543.154.762
11/06/2018 06:00,47.62,35614,2007,28,68,1112,2,3217,4.543.154.762
11/06/2018 07:00,48.59,39168,1973,26,60,1122,1,3182,4.543.154.762
11/06/2018 08:00,49.32,41175,1916,25,55,1194,1,3191,4.543.154.762
11/06/2018 09:00,49.44,41753,2060,25,55,1305,1,3446,4.543.154.762
11/06/2018 10:00,49.1,41883,2358,24,60,1402,2,3846,4.543.154.762
11/06/2018 11:00,49.2,41991,2690,24,92,1529,2,4337,4.543.154.762
11/06/2018 12:00,48.61,41802,3041,24,115,1605,3,4788,4.543.154.762
11/06/2018 13:00,48,41557,3311,25,126,1732,2,5196,4.543.154.762
11/06/2018 14:00,47.68,41319,3390,29,123,1912,4,5458,4.543.154.762
11/06/2018 15:00,47.67,40896,3414,36,123,2017,3,5593,4.543.154.762
11/06/2018 16:00,47.51,40648,3387,39,122,2059,3,5610,4.543.154.762
11/06/2018 17:00,47.94,40619,3355,37,120,2043,1,5556,4.543.154.762
11/06/2018 18:00,48.4,40255,3303,32,123,2089,2,5549,4.543.154.762
11/06/2018 19:00,48.21,39698,3184,25,126,2083,2,5420,4.543.154.762
11/06/2018 20:00,47.73,38909,2990,22,137,2127,2,5278,4.543.154.762
11/06/2018 21:00,47.58,38396,2853,20,150,2211,3,5237,4.543.154.762
11/06/2018 22:00,47.52,37586,2583,18,160,2324,3,5088,4.543.154.762
11/06/2018 23:00,45.1,35861,2391,45,187,2501,10,5134,4.543.154.762
12/06/2018 00:00,42.02,33930,2402,54,196,2466,7,5125,4.543.154.762
12/06/2018 01:00,40.49,32638,2180,61,194,2393,7,4835,4.543.154.762
12/06/2018 02:00,38.9,32135,1977,64,186,2290,5,4522,4.543.154.762
12/06/2018 03:00,39.58,31984,1724,61,175,2145,4,4109,4.543.154.762
12/06/2018 04:00,39.02,32126,1577,51,163,1938,4,3733,4.543.154.762
12/06/2018 05:00,41.73,33267,1400,35,166,1730,4,3335,4.543.154.762
12/06/2018 06:00,46.65,35903,1247,22,185,1497,5,2956,4.543.154.762
12/06/2018 07:00,47.79,39335,1127,17,207,1248,6,2605,4.543.154.762
12/06/2018 08:00,49.5,41055,978,18,220,1077,8,2301,4.543.154.762
12/06/2018 09:00,49.83,41422,853,20,235,893,7,2008,4.543.154.762
12/06/2018 10:00,49.88,41668,763,22,247,797,4,1833,4.543.154.762
12/06/2018 11:00,49.9,41740,725,24,253,785,5,1792,4.543.154.762
12/06/2018 12:00,50.09,41491,745,24,258,747,7,1781,4.543.154.762
12/06/2018 13:00,50,41375,791,22,262,720,9,1804,4.543.154.762
12/06/2018 14:00,49.93,41152,830,19,245,741,12,1847,4.543.154.762
12/06/2018 15:00,49.79,40793,855,20,222,796,17,1910,4.543.154.762
12/06/2018 16:00,49.01,40499,923,22,197,762,18,1922,4.543.154.762
12/06/2018 17:00,49.42,40433,959,19,171,748,18,1915,4.543.154.762
12/06/2018 18:00,49.33,40063,997,14,138,762,14,1925,4.543.154.762
12/06/2018 19:00,49.26,39454,931,12,110,755,9,1817,4.543.154.762
12/06/2018 20:00,48.7,38677,871,15,98,717,5,1706,4.543.154.762
12/06/2018 21:00,47.96,38126,878,20,94,777,6,1775,4.543.154.762
12/06/2018 22:00,48.4,37406,862,24,79,848,5,1818,4.543.154.762
12/06/2018 23:00,46.11,35710,862,21,57,837,4,1781,4.543.154.762
13/06/2018 00:00,46.04,33740,1110,20,40,896,2,2068,4.543.154.762
13/06/2018 01:00,44.01,32468,1151,17,32,872,2,2074,4.543.154.762
13/06/2018 02:00,41.62,31958,1177,12,25,827,2,2043,4.543.154.762
13/06/2018 03:00,41.16,31760,1174,9,19,792,3,1997,4.543.154.762
13/06/2018 04:00,41.18,31750,1276,7,13,663,3,1962,4.543.154.762
13/06/2018 05:00,44.97,32892,1359,5,9,523,2,1898,4.543.154.762
13/06/2018 06:00,47.57,35832,1368,6,3,408,1,1786,4.543.154.762
13/06/2018 07:00,50.51,39168,1401,12,3,328,1,1745,4.543.154.762
13/06/2018 08:00,51,40891,1361,25,2,287,1,1676,4.543.154.762
13/06/2018 09:00,51.92,41268,1419,43,3,256,1,1722,4.543.154.762
13/06/2018 10:00,52.04,41554,1558,58,3,271,2,1892,4.543.154.762
13/06/2018 11:00,52.02,41508,1690,66,4,302,2,2064,4.543.154.762
13/06/2018 12:00,51.22,41293,1777,63,6,345,3,2194,4.543.154.762
13/06/2018 13:00,50.86,41180,1868,52,6,324,5,2255,4.543.154.762
13/06/2018 14:00,50.29,40849,1857,47,9,313,7,2233,4.543.154.762
13/06/2018 15:00,48.12,40417,1840,47,15,313,4,2219,4.543.154.762
13/06/2018 16:00,47.49,39990,1847,54,22,318,5,2246,4.543.154.762
13/06/2018 17:00,47.93,39762,1868,62,32,341,4,2307,4.543.154.762
13/06/2018 18:00,49.5,39442,1893,69,45,346,4,2357,4.543.154.762
13/06/2018 19:00,50.37,38997,1828,73,63,400,3,2367,4.543.154.762
13/06/2018 20:00,49.8,38351,1659,74,79,497,3,2312,4.543.154.762
13/06/2018 21:00,49.42,37768,1495,72,101,643,4,2315,4.543.154.762
13/06/2018 22:00,49.54,36923,1316,65,108,791,6,2286,4.543.154.762
13/06/2018 23:00,46.91,35360,1199,53,23,976,4,2255,4.543.154.762
14/06/2018 00:00,47.3,33556,1220,47,23,1212,5,2507,4.543.154.762
14/06/2018 01:00,44.99,32403,1176,45,20,1350,3,2594,4.543.154.762
14/06/2018 02:00,42.13,31884,1141,44,17,1433,3,2638,4.543.154.762
14/06/2018 03:00,41.97,31649,1057,40,15,1547,3,2662,4.543.154.762
14/06/2018 04:00,42.03,31664,1071,35,14,1569,2,2691,4.543.154.762
14/06/2018 05:00,44.97,32971,1110,29,8,1567,2,2716,4.543.154.762
14/06/2018 06:00,46.69,35688,1208,26,4,1586,2,2826,4.543.154.762
14/06/2018 07:00,49.41,38943,1332,25,4,1652,2,3015,4.543.154.762
14/06/2018 08:00,51.63,40732,1452,26,4,1894,2,3378,4.543.154.762
14/06/2018 09:00,49.8,40995,1769,29,5,2215,2,4020,4.543.154.762
14/06/2018 10:00,48.9,41249,2089,33,10,2426,2,4560,4.543.154.762
14/06/2018 11:00,47.97,41276,2397,36,14,2646,2,5095,4.543.154.762
14/06/2018 12:00,47.85,41029,2739,39,21,2886,3,5688,4.543.154.762
14/06/2018 13:00,47.65,40844,3024,41,24,3090,3,6182,4.543.154.762
14/06/2018 14:00,47.22,40665,3050,44,28,3277,3,6402,4.543.154.762
14/06/2018 15:00,46.29,40582,3116,46,32,3415,3,6612,4.543.154.762
14/06/2018 16:00,45.91,40263,3016,46,32,3565,2,6661,4.543.154.762
14/06/2018 17:00,46.87,40027,3088,42,33,3669,2,6834,4.543.154.762
14/06/2018 18:00,47.51,39679,2962,36,33,3703,2,6736,4.543.154.762
14/06/2018 19:00,47.63,39109,2916,29,34,3843,2,6824,4.543.154.762
14/06/2018 20:00,47.19,38423,2715,25,33,3932,2,6707,4.543.154.762
14/06/2018 21:00,46.86,37782,2350,24,33,4117,3,6527,4.543.154.762
14/06/2018 22:00,46.2,36997,2225,22,28,4217,2,6494,4.543.154.762
14/06/2018 23:00,41.1,35383,2062,21,0,4306,5,6394,4.543.154.762
15/06/2018 00:00,40.32,33571,1736,19,0,4298,5,6058,4.543.154.762
15/06/2018 01:00,38.84,32212,1501,17,0,4241,5,5764,4.543.154.762
15/06/2018 02:00,37.95,31473,1336,15,0,4127,6,5484,4.543.154.762
15/06/2018 03:00,36.79,31173,1174,12,0,4025,7,5218,4.543.154.762
15/06/2018 04:00,37.74,31249,1091,8,0,3831,7,4937,4.543.154.762
15/06/2018 05:00,41.93,32572,989,5,0,3624,6,4624,4.543.154.762
15/06/2018 06:00,46.52,35268,921,3,0,3452,7,4383,4.543.154.762
15/06/2018 07:00,46.96,38759,825,2,0,3278,10,4115,4.543.154.762
15/06/2018 08:00,47.6,40662,786,2,0,3111,8,3907,4.543.154.762
15/06/2018 09:00,47.74,41101,845,2,0,3028,7,3882,4.543.154.762
15/06/2018 10:00,47.9,41248,914,3,0,2990,7,3914,4.543.154.762
15/06/2018 11:00,47.73,41096,951,5,0,2942,8,3906,4.543.154.762
15/06/2018 12:00,47.21,40500,998,7,0,2900,8,3913,4.543.154.762
15/06/2018 13:00,46.95,39978,951,8,0,2823,8,3790,4.543.154.762
15/06/2018 14:00,46.66,39362,865,9,0,2738,5,3617,4.543.154.762
15/06/2018 15:00,46.08,38872,762,11,0,2605,6,3384,4.543.154.762
15/06/2018 16:00,45.88,38455,721,11,0,2496,5,3233,4.543.154.762
15/06/2018 17:00,46.12,38280,692,12,0,2399,4,3107,4.543.154.762
15/06/2018 18:00,46.49,38038,658,13,0,2192,2,2865,4.543.154.762
15/06/2018 19:00,46.44,37327,573,16,0,2061,2,2652,4.543.154.762
15/06/2018 20:00,46.21,36394,430,22,0,1881,2,2335,4.543.154.762
15/06/2018 21:00,46.2,35723,305,33,0,1827,2,2167,4.543.154.762
15/06/2018 22:00,46.19,35087,308,42,0,1795,2,2147,4.543.154.762
15/06/2018 23:00,45.56,34055,357,18,34,1750,0,2159,4.543.154.762
16/06/2018 00:00,43.91,32633,276,20,35,1666,0,1997,4.543.154.762
16/06/2018 01:00,41.61,31370,288,23,30,1587,0,1928,4.543.154.762
16/06/2018 02:00,41.01,30695,266,24,29,1492,0,1811,4.543.154.762
16/06/2018 03:00,40.67,30262,257,23,29,1370,0,1679,4.543.154.762
16/06/2018 04:00,40.25,29920,258,18,29,1129,0,1434,4.543.154.762
16/06/2018 05:00,41.25,30073,225,13,18,890,0,1146,4.543.154.762
16/06/2018 06:00,42.49,30812,198,12,12,720,0,942,4.543.154.762
16/06/2018 07:00,43.91,32214,191,13,12,641,0,857,4.543.154.762
16/06/2018 08:00,44.99,33757,197,14,13,675,0,899,4.543.154.762
16/06/2018 09:00,45.44,35247,225,15,14,756,0,1010,4.543.154.762
16/06/2018 10:00,45.67,36106,280,15,19,827,0,1141,4.543.154.762
16/06/2018 11:00,45.5,36250,342,15,25,923,1,1306,4.543.154.762
16/06/2018 12:00,45.06,36080,439,15,31,1006,2,1493,4.543.154.762
16/06/2018 13:00,44.54,35714,548,18,41,980,1,1588,4.543.154.762
16/06/2018 14:00,44.51,35360,656,18,57,977,1,1709,4.543.154.762
16/06/2018 15:00,44.4,35144,715,18,63,905,2,1703,4.543.154.762
16/06/2018 16:00,44.53,35088,732,17,63,849,2,1663,4.543.154.762
16/06/2018 17:00,44.87,35546,728,14,57,752,2,1553,4.543.154.762
16/06/2018 18:00,45.42,35820,726,12,51,692,2,1483,4.543.154.762
16/06/2018 19:00,46.14,35287,704,12,51,671,1,1439,4.543.154.762
16/06/2018 20:00,45.44,34604,687,12,46,703,1,1449,4.543.154.762
16/06/2018 21:00,45.22,34251,756,12,45,781,1,1595,4.543.154.762
16/06/2018 22:00,45.62,33856,751,12,39,858,1,1661,4.543.154.762
16/06/2018 23:00,44.46,32976,730,12,16,937,1,1696,4.543.154.762
17/06/2018 00:00,43.84,31955,695,15,16,1066,1,1793,4.543.154.762
17/06/2018 01:00,42.09,30848,604,16,11,1129,1,1761,4.543.154.762
17/06/2018 02:00,40.42,30314,518,15,11,1146,1,1691,4.543.154.762
17/06/2018 03:00,40.02,29825,432,12,6,1104,1,1555,4.543.154.762
17/06/2018 04:00,39.6,29332,477,7,6,1050,1,1541,4.543.154.762
17/06/2018 05:00,39.64,29315,506,4,6,966,1,1483,4.543.154.762
17/06/2018 06:00,40.55,29741,604,2,6,905,1,1518,4.543.154.762
17/06/2018 07:00,41.48,30836,681,2,6,926,1,1616,4.543.154.762
17/06/2018 08:00,42.96,32401,789,2,6,990,1,1788,4.543.154.762
17/06/2018 09:00,44.05,33762,990,3,11,1104,1,2109,4.543.154.762
17/06/2018 10:00,44.4,34680,1232,4,12,1294,1,2543,4.543.154.762
17/06/2018 11:00,44.43,35076,1495,6,11,1371,1,2884,4.543.154.762
17/06/2018 12:00,44.22,35239,1822,7,16,1533,1,3379,4.543.154.762
17/06/2018 13:00,43.89,35143,2143,8,16,1644,1,3812,4.543.154.762
17/06/2018 14:00,43.21,35044,2213,8,17,1679,2,3919,4.543.154.762
17/06/2018 15:00,43.17,34899,2179,7,17,1722,1,3926,4.543.154.762
17/06/2018 16:00,43.25,34939,2105,7,11,1703,1,3827,4.543.154.762
17/06/2018 17:00,44.01,35367,2108,7,12,1648,1,3776,4.543.154.762
17/06/2018 18:00,44.12,35698,2004,9,11,1625,1,3650,4.543.154.762
17/06/2018 19:00,45.12,35874,1806,12,12,1595,1,3426,4.543.154.762
17/06/2018 20:00,45.7,35762,1587,19,13,1560,1,3180,4.543.154.762
17/06/2018 21:00,45.92,35604,1384,27,19,1613,2,3045,4.543.154.762
17/06/2018 22:00,45.9,35134,1310,36,24,1705,5,3080,4.543.154.762
17/06/2018 23:00,44.48,33946,1233,48,43,1649,9,2982,4.543.154.762
18/06/2018 00:00,43.46,32522,1261,55,53,1665,7,3041,4.694.880.952
18/06/2018 01:00,40.5,31422,1202,57,53,1550,2,2864,4.694.880.952
18/06/2018 02:00,38.94,30874,1114,55,48,1547,3,2767,4.694.880.952
18/06/2018 03:00,37.69,30687,1005,49,33,1586,3,2676,4.694.880.952
18/06/2018 04:00,36.82,30802,990,44,33,1554,3,2624,4.694.880.952
18/06/2018 05:00,40.85,32230,1008,40,27,1591,1,2667,4.694.880.952
18/06/2018 06:00,44.92,35253,1078,45,27,1693,2,2845,4.694.880.952
18/06/2018 07:00,47.11,38493,1284,50,27,1788,3,3152,4.694.880.952
18/06/2018 08:00,47.89,40549,1506,55,27,1897,3,3488,4.694.880.952
18/06/2018 09:00,47.51,40826,1798,59,38,2016,3,3914,4.694.880.952
18/06/2018 10:00,46.69,40798,2070,63,49,2064,5,4251,4.694.880.952
18/06/2018 11:00,45.92,40970,2288,67,60,2249,5,4669,4.694.880.952
18/06/2018 12:00,45.33,40802,2507,69,76,2460,6,5118,4.694.880.952
18/06/2018 13:00,45.32,40508,2699,67,88,2553,9,5416,4.694.880.952
18/06/2018 14:00,45.07,40188,2478,61,95,2606,11,5251,4.694.880.952
18/06/2018 15:00,44.92,39760,2217,53,97,2715,12,5094,4.694.880.952
18/06/2018 16:00,44.52,39437,2015,42,87,2735,15,4894,4.694.880.952
18/06/2018 17:00,45.45,39279,1915,29,65,2609,15,4633,4.694.880.952
18/06/2018 18:00,46.41,38826,1738,21,48,2512,14,4333,4.694.880.952
18/06/2018 19:00,46.1,38512,1583,16,48,2524,10,4181,4.694.880.952
18/06/2018 20:00,45.25,37961,1575,14,49,2654,8,4300,4.694.880.952
18/06/2018 21:00,44.85,37299,1599,12,55,2819,10,4495,4.694.880.952
18/06/2018 22:00,44.14,36644,1751,12,55,3010,10,4838,4.694.880.952
18/06/2018 23:00,41.49,34674,1827,24,57,3158,16,5082,4.694.880.952
19/06/2018 00:00,40.78,32981,1952,32,60,3327,16,5387,4.694.880.952
19/06/2018 01:00,39.11,31655,2015,40,64,3389,16,5524,4.694.880.952
19/06/2018 02:00,37.34,30973,2054,47,74,3378,16,5569,4.694.880.952
19/06/2018 03:00,36.86,30724,2022,50,84,3408,13,5577,4.694.880.952
19/06/2018 04:00,34.42,30771,2043,42,94,3507,11,5697,4.694.880.952
19/06/2018 05:00,38.04,32074,2100,33,107,3656,12,5908,4.694.880.952
19/06/2018 06:00,42.35,34773,2156,27,137,3757,26,6103,4.694.880.952
19/06/2018 07:00,45.07,37991,2346,28,186,3785,31,6376,4.694.880.952
19/06/2018 08:00,45.14,39750,2405,30,252,3970,44,6701,4.694.880.952
19/06/2018 09:00,44.85,40281,2548,36,309,4108,42,7043,4.694.880.952
19/06/2018 10:00,44.61,40572,2563,42,346,4255,44,7250,4.694.880.952
19/06/2018 11:00,44.23,40553,2638,46,367,4297,50,7398,4.694.880.952
19/06/2018 12:00,44.08,40385,2709,49,379,4453,50,7640,4.694.880.952
19/06/2018 13:00,43.97,40133,2834,53,379,4501,49,7816,4.694.880.952
19/06/2018 14:00,43.8,39831,2835,56,375,4620,48,7934,4.694.880.952
19/06/2018 15:00,43.4,39288,2828,59,370,4732,45,8034,4.694.880.952
19/06/2018 16:00,43.02,39098,2677,57,351,4713,40,7838,4.694.880.952
19/06/2018 17:00,43.53,38880,2610,55,322,4578,40,7605,4.694.880.952
19/06/2018 18:00,44.44,38588,2478,52,281,4434,35,7280,4.694.880.952
19/06/2018 19:00,44.77,38029,2135,48,264,4356,32,6835,4.694.880.952
19/06/2018 20:00,43.99,37223,1810,49,265,4267,25,6416,4.694.880.952
19/06/2018 21:00,43.64,36541,1505,54,268,4243,25,6095,4.694.880.952
19/06/2018 22:00,43.63,35784,1310,61,260,4147,13,5791,4.694.880.952
19/06/2018 23:00,42.22,34187,1138,72,269,4250,15,5744,4.694.880.952
20/06/2018 00:00,42.06,32887,1388,83,258,4220,16,5965,4.694.880.952
20/06/2018 01:00,40.89,31451,1272,91,247,4065,18,5693,4.694.880.952
20/06/2018 02:00,39.77,30764,1083,96,236,3935,18,5368,4.694.880.952
20/06/2018 03:00,39.27,30622,922,102,222,3837,16,5099,4.694.880.952
20/06/2018 04:00,39.67,30619,860,108,219,3627,15,4829,4.694.880.952
20/06/2018 05:00,41.22,31961,793,115,248,3488,17,4661,4.694.880.952
20/06/2018 06:00,44.49,35067,840,130,280,3369,18,4637,4.694.880.952
20/06/2018 07:00,45.33,38506,1023,152,292,3192,18,4677,4.694.880.952
20/06/2018 08:00,45.55,40274,1279,178,292,3130,14,4893,4.694.880.952
20/06/2018 09:00,45.59,40700,1843,197,286,3076,15,5417,4.694.880.952
20/06/2018 10:00,45.44,40926,2396,205,286,3048,18,5953,4.694.880.952
20/06/2018 11:00,44.81,40963,2822,212,282,3136,19,6471,4.694.880.952
20/06/2018 12:00,44.2,40825,3190,218,277,3196,18,6899,4.694.880.952
20/06/2018 13:00,43.63,40681,3404,219,270,3117,14,7024,4.694.880.952
20/06/2018 14:00,43.28,40470,3561,221,250,3074,15,7121,4.694.880.952
20/06/2018 15:00,42.22,40244,3729,222,223,3103,14,7291,4.694.880.952
20/06/2018 16:00,41.99,39966,3430,219,185,3097,14,6945,4.694.880.952
20/06/2018 17:00,43.03,39869,3246,211,146,3065,13,6681,4.694.880.952
20/06/2018 18:00,43.64,39508,3114,193,115,2951,13,6386,4.694.880.952
20/06/2018 19:00,43.6,38949,2868,179,123,2743,12,5925,4.694.880.952
20/06/2018 20:00,43.21,38117,2678,169,140,2526,12,5525,4.694.880.952
20/06/2018 21:00,42.97,37571,2751,163,158,2344,10,5426,4.694.880.952
20/06/2018 22:00,42.7,36785,2766,160,177,2352,20,5475,4.694.880.952
20/06/2018 23:00,41.97,35170,2665,190,214,2258,27,5354,4.694.880.952
21/06/2018 00:00,42.02,32968,2050,192,252,2273,32,4799,4.694.880.952
21/06/2018 01:00,40.81,31821,1983,192,263,2250,34,4722,4.694.880.952
21/06/2018 02:00,39.84,31225,2013,191,248,2124,34,4610,4.694.880.952
21/06/2018 03:00,39.36,30877,2019,190,234,2040,31,4514,4.694.880.952
21/06/2018 04:00,38.02,30830,2107,189,219,1917,24,4456,4.694.880.952
21/06/2018 05:00,40.14,32321,2148,189,198,1784,20,4339,4.694.880.952
21/06/2018 06:00,43.75,35337,2177,188,178,1640,19,4202,4.694.880.952
21/06/2018 07:00,46.92,39004,2156,185,174,1497,22,4034,4.694.880.952
21/06/2018 08:00,48.21,40810,2106,181,191,1424,25,3927,4.694.880.952
21/06/2018 09:00,46.23,41204,2174,181,208,1378,26,3967,4.694.880.952
21/06/2018 10:00,45.2,41457,2299,184,219,1411,24,4137,4.694.880.952
21/06/2018 11:00,45.11,41618,2439,187,220,1508,23,4377,4.694.880.952
21/06/2018 12:00,44.5,41125,2647,188,210,1570,22,4637,4.694.880.952
21/06/2018 13:00,43.88,40642,2934,188,194,1655,19,4990,4.694.880.952
21/06/2018 14:00,43.57,40155,3191,183,167,1825,15,5381,4.694.880.952
21/06/2018 15:00,42.94,39738,3486,174,135,1983,7,5785,4.694.880.952
21/06/2018 16:00,42.04,39285,3726,159,115,2114,5,6119,4.694.880.952
21/06/2018 17:00,42.46,39215,3837,141,122,2188,4,6292,4.694.880.952
21/06/2018 18:00,42.81,38990,3841,125,133,2277,6,6382,4.694.880.952
21/06/2018 19:00,43.05,38242,3651,109,144,2371,9,6284,4.694.880.952
21/06/2018 20:00,42.51,37251,3586,96,148,2569,6,6405,4.694.880.952
21/06/2018 21:00,40.98,36550,3601,86,160,2766,5,6618,4.694.880.952
21/06/2018 22:00,39.9,35631,3323,83,161,3028,12,6607,4.694.880.952
21/06/2018 23:00,38.05,34038,3140,87,233,3342,22,6824,4.694.880.952
22/06/2018 00:00,42.03,32783,3051,96,250,3527,22,6946,4.694.880.952
22/06/2018 01:00,40.23,31521,2923,89,262,3657,22,6953,4.694.880.952
22/06/2018 02:00,38.1,30835,2774,80,258,3698,22,6832,4.694.880.952
22/06/2018 03:00,38.13,30401,2474,73,260,3621,22,6450,4.694.880.952
22/06/2018 04:00,37.91,30268,2430,63,272,3619,26,6410,4.694.880.952
22/06/2018 05:00,35.19,30818,2344,50,315,3626,32,6367,4.694.880.952
22/06/2018 06:00,39.22,32842,2277,43,357,3582,36,6295,4.694.880.952
22/06/2018 07:00,42.41,35345,2241,42,378,3600,36,6297,4.694.880.952
22/06/2018 08:00,43.38,36894,2251,45,385,3717,36,6434,4.694.880.952
22/06/2018 09:00,43.47,37733,2336,51,386,3945,36,6754,4.694.880.952
22/06/2018 10:00,43.35,38270,2508,56,387,4136,36,7123,4.694.880.952
22/06/2018 11:00,42.94,38132,2661,61,387,4269,34,7412,4.694.880.952
22/06/2018 12:00,42.03,37660,2895,66,377,4336,36,7710,4.694.880.952
22/06/2018 13:00,41.89,37033,3079,67,346,4226,36,7754,4.694.880.952
22/06/2018 14:00,41.31,36308,3178,64,313,4107,33,7695,4.694.880.952
22/06/2018 15:00,40.39,35943,3365,66,265,3994,29,7719,4.694.880.952
22/06/2018 16:00,40.19,35837,3429,60,208,3839,29,7565,4.694.880.952
22/06/2018 17:00,40.97,35717,3494,55,151,3714,25,7439,4.694.880.952
22/06/2018 18:00,41.81,35343,3500,52,115,3543,17,7227,4.694.880.952
22/06/2018 19:00,41.07,34870,3361,61,105,3388,14,6929,4.694.880.952
22/06/2018 20:00,39.89,34023,3313,55,103,3295,14,6780,4.694.880.952
22/06/2018 21:00,37.39,33754,3378,60,108,3245,19,6810,4.694.880.952
22/06/2018 22:00,39.16,33561,3410,66,118,3203,22,6819,4.694.880.952
22/06/2018 23:00,37.47,32909,3438,5,122,3218,17,6800,4.694.880.952
23/06/2018 00:00,40.64,31341,3643,4,129,3166,15,6957,4.694.880.952
23/06/2018 01:00,39.64,30463,3616,4,128,3078,12,6838,4.694.880.952
23/06/2018 02:00,39.16,29891,3611,4,114,2944,11,6684,4.694.880.952
23/06/2018 03:00,37,29501,3462,3,92,2854,10,6421,4.694.880.952
23/06/2018 04:00,30.08,29213,3426,2,72,2781,9,6290,4.694.880.952
23/06/2018 05:00,35.04,29297,3381,1,53,2644,9,6088,4.694.880.952
23/06/2018 06:00,33.9,29769,3309,1,40,2558,9,5917,4.694.880.952
23/06/2018 07:00,37.1,30659,3199,1,32,2493,10,5735,4.694.880.952
23/06/2018 08:00,40.15,32108,3037,1,31,2472,10,5551,4.694.880.952
23/06/2018 09:00,41.86,33548,3010,2,30,2502,10,5554,4.694.880.952
23/06/2018 10:00,42.69,34420,2990,3,29,2524,10,5556,4.694.880.952
23/06/2018 11:00,42.51,34524,2907,5,30,2555,10,5507,4.694.880.952
23/06/2018 12:00,42.23,34468,2920,9,31,2502,10,5472,4.694.880.952
23/06/2018 13:00,42.02,34337,2956,10,34,2517,10,5527,4.694.880.952
23/06/2018 14:00,41.66,34060,2937,11,36,2501,10,5495,4.694.880.952
23/06/2018 15:00,41.06,33892,2990,11,41,2480,10,5532,4.694.880.952
23/06/2018 16:00,40.88,33877,3046,12,48,2343,10,5459,4.694.880.952
23/06/2018 17:00,41.92,34343,3123,15,54,2174,10,5376,4.694.880.952
23/06/2018 18:00,42.04,34566,3101,18,61,1877,10,5067,4.694.880.952
23/06/2018 19:00,42.56,34180,2943,21,72,1711,10,4757,4.694.880.952
23/06/2018 20:00,42.69,33720,2655,26,78,1737,9,4505,4.694.880.952
23/06/2018 21:00,42.63,33316,2469,31,87,1777,9,4373,4.694.880.952
23/06/2018 22:00,42.3,32952,2361,33,86,1766,9,4255,4.694.880.952
23/06/2018 23:00,41.01,32259,2309,28,73,1749,7,4166,4.694.880.952
24/06/2018 00:00,41.04,31777,2354,24,71,1777,7,4233,4.694.880.952
24/06/2018 01:00,39.68,30810,2234,20,66,1755,8,4083,4.694.880.952
24/06/2018 02:00,38.59,30196,2096,17,61,1664,8,3846,4.694.880.952
24/06/2018 03:00,37.54,29619,1865,15,59,1516,9,3464,4.694.880.952
24/06/2018 04:00,36.46,29240,1727,11,51,1325,9,3123,4.694.880.952
24/06/2018 05:00,36.38,29198,1567,7,36,1066,9,2685,4.694.880.952
24/06/2018 06:00,39.42,29553,1455,4,31,902,8,2400,4.694.880.952
24/06/2018 07:00,40.87,30206,1316,4,30,746,9,2105,4.694.880.952
24/06/2018 08:00,43.08,31664,1127,4,35,604,8,1778,4.694.880.952
24/06/2018 09:00,43.33,33075,993,5,47,533,8,1586,4.694.880.952
24/06/2018 10:00,43.96,34008,900,7,56,482,9,1454,4.694.880.952
24/06/2018 11:00,44.35,34488,862,10,67,505,11,1455,4.694.880.952
24/06/2018 12:00,44.28,34613,895,14,82,539,13,1543,4.694.880.952
24/06/2018 13:00,44.14,34546,931,16,89,570,13,1619,4.694.880.952
24/06/2018 14:00,44.24,34355,968,15,96,619,14,1712,4.694.880.952
24/06/2018 15:00,43.9,34317,999,14,101,630,17,1761,4.694.880.952
24/06/2018 16:00,43.91,34497,1040,13,106,640,14,1813,4.694.880.952
24/06/2018 17:00,44.06,34890,1098,11,88,565,14,1776,4.694.880.952
24/06/2018 18:00,44.32,35217,1125,11,71,528,12,1747,4.694.880.952
24/06/2018 19:00,44.95,35314,1086,12,70,524,9,1701,4.694.880.952
24/06/2018 20:00,44.9,35188,994,13,73,552,7,1639,4.694.880.952
24/06/2018 21:00,45.58,35153,955,17,72,656,8,1708,4.694.880.952
24/06/2018 22:00,45.53,34828,910,23,78,776,8,1795,4.694.880.952
24/06/2018 23:00,43.27,33724,902,93,38,786,5,1824,4.694.880.952
25/06/2018 00:00,42.39,32184,1093,113,35,889,5,2135,4.713.988.095
25/06/2018 01:00,41.37,31009,1159,129,32,949,6,2275,4.713.988.095
25/06/2018 02:00,40.03,30533,1142,138,31,971,8,2290,4.713.988.095
25/06/2018 03:00,40.03,30402,1085,146,36,992,8,2267,4.713.988.095
25/06/2018 04:00,40.61,30502,1093,154,36,926,11,2220,4.713.988.095
25/06/2018 05:00,42.96,31830,1055,168,36,802,7,2068,4.713.988.095
25/06/2018 06:00,46.21,34678,998,181,30,717,6,1932,4.713.988.095
25/06/2018 07:00,46.52,37879,944,196,26,660,7,1833,4.713.988.095
25/06/2018 08:00,47.73,39875,886,211,26,721,6,1850,4.713.988.095
25/06/2018 09:00,47.93,40434,857,223,27,779,5,1891,4.713.988.095
25/06/2018 10:00,47.99,40675,895,232,33,798,6,1964,4.713.988.095
25/06/2018 11:00,48.15,40843,895,235,37,801,5,1973,4.713.988.095
25/06/2018 12:00,47.87,40618,885,235,38,828,4,1990,4.713.988.095
25/06/2018 13:00,47.9,40447,883,235,39,877,4,2038,4.713.988.095
25/06/2018 14:00,47.42,40153,871,232,38,948,5,2094,4.713.988.095
25/06/2018 15:00,46.35,39735,877,230,37,1049,5,2198,4.713.988.095
25/06/2018 16:00,45.5,39566,865,222,33,1111,5,2236,4.713.988.095
25/06/2018 17:00,46.44,39538,892,205,29,1120,5,2251,4.713.988.095
25/06/2018 18:00,46.91,39193,869,178,25,1213,4,2289,4.713.988.095
25/06/2018 19:00,46.79,38651,777,155,25,1278,4,2239,4.713.988.095
25/06/2018 20:00,46.08,37886,666,136,26,1402,4,2234,4.713.988.095
25/06/2018 21:00,45.74,37307,602,125,28,1547,4,2306,4.713.988.095
25/06/2018 22:00,45.65,36674,565,122,30,1618,4,2339,4.713.988.095
25/06/2018 23:00,43.92,35201,562,99,7,1826,3,2497,4.713.988.095
26/06/2018 00:00,44.09,33032,681,100,8,1852,4,2645,4.713.988.095
26/06/2018 01:00,42.25,31753,623,99,10,1802,4,2538,4.713.988.095
26/06/2018 02:00,41.28,31186,531,95,13,1676,5,2320,4.713.988.095
26/06/2018 03:00,41.56,30980,402,89,14,1564,5,2074,4.713.988.095
26/06/2018 04:00,41.72,30985,325,80,13,1432,5,1855,4.713.988.095
26/06/2018 05:00,43.33,32337,284,69,8,1247,5,1613,4.713.988.095
26/06/2018 06:00,47.1,34984,265,59,7,1021,3,1355,4.713.988.095
26/06/2018 07:00,48.47,37960,245,49,7,822,3,1126,4.713.988.095
26/06/2018 08:00,49.09,39663,210,40,11,676,4,941,4.713.988.095
26/06/2018 09:00,48.98,40167,159,35,19,581,4,798,4.713.988.095
26/06/2018 10:00,49.19,40591,129,31,25,536,5,726,4.713.988.095
26/06/2018 11:00,48.96,40559,124,29,30,573,5,761,4.713.988.095
26/06/2018 12:00,48.91,40443,133,28,31,624,4,820,4.713.988.095
26/06/2018 13:00,48.9,40288,154,26,31,684,4,899,4.713.988.095
26/06/2018 14:00,48.43,40081,169,23,29,811,6,1038,4.713.988.095
26/06/2018 15:00,47.77,39837,196,18,27,957,5,1203,4.713.988.095
26/06/2018 16:00,46.95,39527,219,14,26,1038,5,1302,4.713.988.095
26/06/2018 17:00,47.75,39299,257,11,25,1118,4,1415,4.713.988.095
26/06/2018 18:00,48.05,39035,283,11,25,1229,4,1552,4.713.988.095
26/06/2018 19:00,47.64,38525,266,12,28,1297,4,1607,4.713.988.095
26/06/2018 20:00,47.08,37655,228,13,32,1427,4,1704,4.713.988.095
26/06/2018 21:00,46.79,36965,183,13,33,1626,4,1859,4.713.988.095
26/06/2018 22:00,46.54,36234,151,13,35,1717,5,1921,4.713.988.095
26/06/2018 23:00,44.45,34800,135,11,42,1873,4,2065,4.713.988.095
27/06/2018 00:00,43.96,33163,169,12,48,1852,4,2085,4.713.988.095
27/06/2018 01:00,42.88,31799,175,13,59,1801,4,2052,4.713.988.095
27/06/2018 02:00,41.91,31197,162,14,67,1674,4,1921,4.713.988.095
27/06/2018 03:00,41.48,30884,142,14,73,1563,4,1796,4.713.988.095
27/06/2018 04:00,41.22,30785,143,11,73,1367,3,1597,4.713.988.095
27/06/2018 05:00,43.82,32053,145,6,49,1168,3,1371,4.713.988.095
27/06/2018 06:00,47.37,35110,145,2,28,1060,2,1237,4.713.988.095
27/06/2018 07:00,47.91,38598,130,2,11,1045,2,1190,4.713.988.095
27/06/2018 08:00,48.79,40366,115,2,10,966,2,1095,4.713.988.095
27/06/2018 09:00,48.93,40934,97,2,11,876,2,988,4.713.988.095
27/06/2018 10:00,49.02,41244,102,3,13,773,2,893,4.713.988.095
27/06/2018 11:00,48.97,41277,130,4,13,740,3,890,4.713.988.095
27/06/2018 12:00,49.09,41080,161,7,13,646,3,830,4.713.988.095
27/06/2018 13:00,49.17,40934,185,9,16,603,3,816,4.713.988.095
27/06/2018 14:00,49.04,40618,225,8,22,577,4,836,4.713.988.095
27/06/2018 15:00,48.47,40276,272,7,27,600,4,910,4.713.988.095
27/06/2018 16:00,47.88,39972,301,6,38,569,3,917,4.713.988.095
27/06/2018 17:00,48.42,39774,320,5,54,524,3,906,4.713.988.095
27/06/2018 18:00,49.18,39375,332,4,74,529,3,942,4.713.988.095
27/06/2018 19:00,49.12,38781,293,5,88,516,3,905,4.713.988.095
27/06/2018 20:00,48.19,37944,251,5,106,611,3,976,4.713.988.095
27/06/2018 21:00,48.38,37277,213,6,136,810,4,1169,4.713.988.095
27/06/2018 22:00,47.68,36589,206,7,155,967,4,1339,4.713.988.095
27/06/2018 23:00,45.29,35264,200,3,210,1182,4,1599,4.713.988.095
28/06/2018 00:00,44.68,33684,162,3,212,1273,3,1653,4.713.988.095
28/06/2018 01:00,42.55,32252,154,4,210,1194,3,1565,4.713.988.095
28/06/2018 02:00,41.63,31615,154,4,202,1121,3,1484,4.713.988.095
28/06/2018 03:00,41.03,31226,153,4,196,1127,4,1484,4.713.988.095
28/06/2018 04:00,40.03,31168,164,4,169,949,4,1290,4.713.988.095
28/06/2018 05:00,44.01,32465,148,4,123,804,2,1081,4.713.988.095
28/06/2018 06:00,47.13,35075,128,3,77,639,2,849,4.713.988.095
28/06/2018 07:00,49.13,38436,105,4,55,537,2,703,4.713.988.095
28/06/2018 08:00,50.47,40391,111,6,59,521,2,699,4.713.988.095
28/06/2018 09:00,50.29,40877,127,8,65,670,2,872,4.713.988.095
28/06/2018 10:00,49.86,41271,161,10,66,838,2,1077,4.713.988.095
28/06/2018 11:00,49.7,41385,233,12,59,1115,2,1421,4.713.988.095
28/06/2018 12:00,49.32,41157,335,15,47,1367,2,1766,4.713.988.095
28/06/2018 13:00,49.15,40912,452,19,41,1598,3,2113,4.713.988.095
28/06/2018 14:00,48.55,40537,584,20,36,1846,4,2490,4.713.988.095
28/06/2018 15:00,47.59,40250,730,20,32,2193,4,2979,4.713.988.095
28/06/2018 16:00,46.68,39874,874,18,29,2569,3,3493,4.713.988.095
28/06/2018 17:00,47.38,39812,937,14,28,2770,3,3752,4.713.988.095
28/06/2018 18:00,47.97,39523,1053,14,27,2921,2,4017,4.713.988.095
28/06/2018 19:00,47.78,39127,1136,15,30,3174,2,4357,4.713.988.095
28/06/2018 20:00,46.74,38329,1143,19,32,3339,2,4535,4.713.988.095
28/06/2018 21:00,45.76,37770,1279,21,32,3528,2,4862,4.713.988.095
28/06/2018 22:00,45.68,36976,1393,23,28,3704,2,5150,4.713.988.095
28/06/2018 23:00,42.82,35453,1492,24,14,3894,4,5428,4.713.988.095
29/06/2018 00:00,43.03,33383,1591,22,11,3913,5,5542,4.713.988.095
29/06/2018 01:00,41.11,32101,1701,19,12,3997,7,5736,4.713.988.095
29/06/2018 02:00,38.69,31499,1719,17,29,3904,8,5677,4.713.988.095
29/06/2018 03:00,38,31122,1696,13,55,3784,5,5553,4.713.988.095
29/06/2018 04:00,37.83,31066,1735,8,61,3728,9,5541,4.713.988.095
29/06/2018 05:00,42.33,32352,1758,5,46,3699,9,5517,4.713.988.095
29/06/2018 06:00,45.21,35193,1800,4,35,3603,12,5454,4.713.988.095
29/06/2018 07:00,47.69,38638,1854,4,53,3438,17,5366,4.713.988.095
29/06/2018 08:00,48.97,40757,1916,6,84,3216,20,5242,4.713.988.095
29/06/2018 09:00,49.41,41403,1886,8,123,3054,25,5096,4.713.988.095
29/06/2018 10:00,49.27,41782,1884,9,165,2874,26,4958,4.713.988.095
29/06/2018 11:00,48.94,41735,1881,11,203,2786,26,4907,4.713.988.095
29/06/2018 12:00,48.04,41261,1910,13,245,2773,29,4970,4.713.988.095
29/06/2018 13:00,47.59,40863,1990,15,276,2687,29,4997,4.713.988.095
29/06/2018 14:00,46.91,40217,2030,17,305,2670,29,5051,4.713.988.095
29/06/2018 15:00,46.27,39643,2077,18,320,2739,30,5184,4.713.988.095
29/06/2018 16:00,46,39187,1966,17,328,2662,31,5004,4.713.988.095
29/06/2018 17:00,46.24,39045,1917,17,331,2570,30,4865,4.713.988.095
29/06/2018 18:00,47.41,38720,1826,20,332,2510,30,4718,4.713.988.095
29/06/2018 19:00,48.38,38044,1659,28,317,2316,28,4348,4.713.988.095
29/06/2018 20:00,48.25,36978,1428,42,287,2203,23,3983,4.713.988.095
29/06/2018 21:00,47.91,36254,1288,59,266,2146,19,3778,4.713.988.095
29/06/2018 22:00,47.13,35558,1139,76,241,2077,15,3548,4.713.988.095
29/06/2018 23:00,44.73,34446,1095,139,225,2116,18,3593,4.713.988.095
30/06/2018 00:00,45.79,32864,810,124,221,2162,15,3332,4.713.988.095
30/06/2018 01:00,44.94,31623,763,104,217,2109,12,3205,4.713.988.095
30/06/2018 02:00,44.01,30915,636,88,219,2050,12,3005,4.713.988.095
30/06/2018 03:00,42.88,30471,538,77,221,2056,13,2905,4.713.988.095
30/06/2018 04:00,42.4,30133,486,68,219,1749,10,2532,4.713.988.095
30/06/2018 05:00,43.07,30210,464,61,227,1553,10,2315,4.713.988.095
30/06/2018 06:00,44.68,30904,427,57,252,1238,19,1993,4.713.988.095
30/06/2018 07:00,45.94,32349,377,52,270,992,21,1712,4.713.988.095
30/06/2018 08:00,47.32,34124,361,48,280,900,25,1614,4.713.988.095
30/06/2018 09:00,47.25,35837,374,44,281,815,27,1541,4.713.988.095
30/06/2018 10:00,47.93,36833,404,40,284,772,28,1528,4.713.988.095
30/06/2018 11:00,47.62,36994,435,33,285,741,35,1529,4.713.988.095
30/06/2018 12:00,47.15,36775,513,28,302,712,39,1594,4.713.988.095
30/06/2018 13:00,46.12,36407,591,22,316,683,41,1653,4.713.988.095
30/06/2018 14:00,45.66,36087,610,17,323,683,41,1674,4.713.988.095
30/06/2018 15:00,45.33,35829,691,13,330,700,41,1775,4.713.988.095
30/06/2018 16:00,45.29,35847,766,11,332,696,41,1846,4.713.988.095
30/06/2018 17:00,46.13,36206,816,10,316,668,38,1848,4.713.988.095
30/06/2018 18:00,47.2,36402,882,10,287,631,32,1842,4.713.988.095
30/06/2018 19:00,48.16,35858,859,10,266,621,28,1784,4.713.988.095
30/06/2018 20:00,47.86,35095,813,10,255,647,20,1745,4.713.988.095
30/06/2018 21:00,47.12,34685,774,12,254,664,17,1721,4.713.988.095
30/06/2018 22:00,47.02,34174,729,14,244,657,14,1658,4.713.988.095
30/06/2018 23:00,45.48,33362,749,17,240,706,10,1722,4.713.988.095
01/07/2018 00:00,46.09,32200,734,20,244,758,9,1765,4.713.988.095
01/07/2018 01:00,44.54,31206,816,22,245,789,11,1883,4.713.988.095
01/07/2018 02:00,43.18,30585,765,24,240,810,11,1850,4.713.988.095
01/07/2018 03:00,42.37,30050,682,25,241,841,10,1799,4.713.988.095
01/07/2018 04:00,42.07,29646,643,24,248,830,10,1755,4.713.988.095
01/07/2018 05:00,42.33,29583,595,23,273,776,12,1679,4.713.988.095
01/07/2018 06:00,43.72,29929,567,23,308,714,21,1633,4.713.988.095
01/07/2018 07:00,44.93,30775,530,27,331,668,20,1576,4.713.988.095
01/07/2018 08:00,45.28,32317,583,32,334,721,19,1689,4.713.988.095
01/07/2018 09:00,45.47,33715,684,40,339,830,20,1913,4.713.988.095
01/07/2018 10:00,45.86,34721,811,47,344,863,22,2087,4.713.988.095
01/07/2018 11:00,46,35161,859,56,343,873,22,2153,4.713.988.095
01/07/2018 12:00,45.95,35216,837,65,337,867,23,2129,4.713.988.095
01/07/2018 13:00,45.7,35103,807,71,333,803,21,2035,4.713.988.095
01/07/2018 14:00,45.52,34937,765,75,333,788,22,1983,4.713.988.095
01/07/2018 15:00,45.89,34864,781,80,322,780,19,1982,4.713.988.095
01/07/2018 16:00,45.83,35055,728,78,306,769,18,1899,4.713.988.095
01/07/2018 17:00,46.19,35476,747,79,293,747,15,1881,4.713.988.095
01/07/2018 18:00,46.7,35765,784,82,279,719,13,1877,4.713.988.095
01/07/2018 19:00,48.09,35890,707,83,279,738,11,1818,4.713.988.095
01/07/2018 20:00,48.58,35624,584,83,283,805,8,1763,4.713.988.095
01/07/2018 21:00,46.91,35649,527,87,291,893,11,1809,4.713.988.095
01/07/2018 22:00,47.89,35210,510,91,300,973,14,1888,4.713.988.095
01/07/2018 23:00,46.78,34184,447,109,269,908,11,1744,4.713.988.095
02/07/2018 00:00,47.43,32271,333,115,277,924,9,1658,4.688.630.952
02/07/2018 01:00,46.21,31174,286,103,286,965,11,1651,4.688.630.952
02/07/2018 02:00,45.91,30629,250,91,291,940,12,1584,4.688.630.952
02/07/2018 03:00,45.39,30387,236,93,295,919,13,1556,4.688.630.952
02/07/2018 04:00,44.31,30414,245,116,296,832,14,1503,4.688.630.952
02/07/2018 05:00,45.99,31689,260,134,296,704,14,1408,4.688.630.952
02/07/2018 06:00,49.19,34576,275,144,301,600,15,1335,4.688.630.952
02/07/2018 07:00,50.8,37828,295,150,304,553,17,1319,4.688.630.952
02/07/2018 08:00,51.79,39893,333,150,304,614,16,1417,4.688.630.952
02/07/2018 09:00,50.98,40579,386,152,302,728,15,1583,4.688.630.952
02/07/2018 10:00,50.75,40989,445,155,283,821,13,1717,4.688.630.952
02/07/2018 11:00,50.71,41202,495,158,255,850,11,1769,4.688.630.952
02/07/2018 12:00,50.79,41098,572,169,225,882,9,1857,4.688.630.952
02/07/2018 13:00,50.75,40915,663,179,202,878,7,1929,4.688.630.952
02/07/2018 14:00,50.65,40618,831,184,184,905,8,2112,4.688.630.952
02/07/2018 15:00,50.55,40066,1011,180,169,908,8,2276,4.688.630.952
02/07/2018 16:00,50.4,39807,1110,169,159,863,6,2307,4.688.630.952
02/07/2018 17:00,50.85,39712,1196,155,149,818,6,2324,4.688.630.952
02/07/2018 18:00,51.41,39324,1217,148,142,804,6,2317,4.688.630.952
02/07/2018 19:00,51.65,38728,1107,145,134,802,6,2194,4.688.630.952
02/07/2018 20:00,51.05,37962,1015,139,128,817,5,2104,4.688.630.952
02/07/2018 21:00,51.41,37341,928,136,121,876,5,2066,4.688.630.952
02/07/2018 22:00,50.95,36542,878,138,110,910,4,2040,4.688.630.952
02/07/2018 23:00,48.94,35073,883,199,88,768,5,1943,4.688.630.952
03/07/2018 00:00,48.33,33094,940,199,82,789,5,2015,4.688.630.952
03/07/2018 01:00,46.75,31857,965,198,74,810,3,2050,4.688.630.952
03/07/2018 02:00,45.14,31255,974,194,68,827,1,2064,4.688.630.952
03/07/2018 03:00,44.73,30985,940,191,60,841,1,2033,4.688.630.952
03/07/2018 04:00,44.48,30961,893,190,50,840,1,1974,4.688.630.952
03/07/2018 05:00,46.74,32038,859,190,55,805,1,1910,4.688.630.952
03/07/2018 06:00,50.16,34385,814,188,57,704,2,1765,4.688.630.952
03/07/2018 07:00,52.92,37454,768,185,71,680,3,1707,4.688.630.952
03/07/2018 08:00,53.86,39408,738,183,89,660,6,1676,4.688.630.952
03/07/2018 09:00,53.39,40104,665,180,112,718,8,1683,4.688.630.952
03/07/2018 10:00,52.8,40543,621,175,131,810,11,1748,4.688.630.952
03/07/2018 11:00,51.98,40554,667,168,146,931,11,1923,4.688.630.952
03/07/2018 12:00,52.02,40444,734,162,163,1037,7,2103,4.688.630.952
03/07/2018 13:00,52.5,40352,758,154,176,1120,9,2217,4.688.630.952
03/07/2018 14:00,51.98,40192,742,143,184,1247,10,2326,4.688.630.952
03/07/2018 15:00,51.58,39769,700,133,188,1454,7,2482,4.688.630.952
03/07/2018 16:00,50.96,39501,629,120,191,1536,5,2481,4.688.630.952
03/07/2018 17:00,51.5,39261,640,103,175,1635,4,2557,4.688.630.952
03/07/2018 18:00,52.4,38931,669,89,166,1709,8,2641,4.688.630.952
03/07/2018 19:00,52.6,38344,609,77,158,1793,9,2646,4.688.630.952
03/07/2018 20:00,51.79,37591,586,68,158,1959,7,2778,4.688.630.952
03/07/2018 21:00,51.72,36918,581,64,154,2303,5,3107,4.688.630.952
03/07/2018 22:00,52.14,36193,577,60,144,2518,5,3304,4.688.630.952
03/07/2018 23:00,50.24,34706,616,56,143,2689,4,3508,4.688.630.952
04/07/2018 00:00,49.38,32816,683,54,143,2761,5,3646,4.688.630.952
04/07/2018 01:00,47.14,31446,677,51,130,2710,4,3572,4.688.630.952
04/07/2018 02:00,46.24,30826,619,43,112,2675,4,3453,4.688.630.952
04/07/2018 03:00,45.61,30445,543,37,93,2530,4,3207,4.688.630.952
04/07/2018 04:00,45.65,30231,452,32,70,2304,4,2862,4.688.630.952
04/07/2018 05:00,47.76,31334,376,27,55,1937,4,2399,4.688.630.952
04/07/2018 06:00,50.97,34013,332,22,50,1581,3,1988,4.688.630.952
04/07/2018 07:00,52.71,37253,320,18,47,1392,3,1780,4.688.630.952
04/07/2018 08:00,53.7,39104,313,16,45,1316,3,1693,4.688.630.952
04/07/2018 09:00,52.96,39791,311,13,48,1209,2,1583,4.688.630.952
04/07/2018 10:00,52.85,40214,321,12,55,1153,2,1543,4.688.630.952
04/07/2018 11:00,52.73,40318,366,11,62,1137,4,1580,4.688.630.952
04/07/2018 12:00,52.12,40165,402,11,79,1100,3,1595,4.688.630.952
04/07/2018 13:00,51.96,39902,457,12,94,1103,2,1668,4.688.630.952
04/07/2018 14:00,51.98,39712,523,12,105,1076,3,1719,4.688.630.952
04/07/2018 15:00,51.94,39310,587,12,108,1069,3,1779,4.688.630.952
04/07/2018 16:00,51.93,38951,620,13,103,1047,3,1786,4.688.630.952
04/07/2018 17:00,52.19,38798,681,12,86,942,2,1723,4.688.630.952
04/07/2018 18:00,52.58,38454,763,13,72,862,2,1712,4.688.630.952
04/07/2018 19:00,52.72,37966,802,13,61,778,3,1657,4.688.630.952
04/07/2018 20:00,52.55,37234,812,12,65,825,3,1717,4.688.630.952
04/07/2018 21:00,52.67,36597,835,13,60,898,3,1809,4.688.630.952
04/07/2018 22:00,52.29,35901,846,12,57,977,2,1894,4.688.630.952
04/07/2018 23:00,50.84,34508,876,11,87,930,5,1909,4.688.630.952
05/07/2018 00:00,50.17,32847,927,11,66,903,7,1914,4.688.630.952
05/07/2018 01:00,48.52,31441,969,10,54,828,7,1868,4.688.630.952
05/07/2018 02:00,47.52,30759,922,9,43,739,6,1719,4.688.630.952
05/07/2018 03:00,47.12,30357,852,6,37,679,6,1580,4.688.630.952
05/07/2018 04:00,47.32,30316,795,4,27,597,6,1429,4.688.630.952
05/07/2018 05:00,49.33,31578,749,2,17,460,6,1234,4.688.630.952
05/07/2018 06:00,51.51,34083,794,2,12,365,6,1179,4.688.630.952
05/07/2018 07:00,52.87,37219,880,2,9,277,4,1172,4.688.630.952
05/07/2018 08:00,53.76,39265,951,2,11,266,3,1233,4.688.630.952
05/07/2018 09:00,53.83,39952,989,2,14,277,2,1284,4.688.630.952
05/07/2018 10:00,53.87,40500,1087,4,22,292,2,1407,4.688.630.952
05/07/2018 11:00,53.94,40590,1233,7,29,311,3,1583,4.688.630.952
05/07/2018 12:00,54.19,40457,1282,11,38,326,4,1661,4.688.630.952
05/07/2018 13:00,53.73,40322,1411,12,48,370,4,1845,4.688.630.952
05/07/2018 14:00,52.93,39969,1607,14,54,409,5,2089,4.688.630.952
05/07/2018 15:00,52.55,39542,1732,15,59,482,4,2292,4.688.630.952
05/07/2018 16:00,52.12,39116,1796,16,63,529,3,2407,4.688.630.952
05/07/2018 17:00,52.05,38950,2025,18,59,518,3,2623,4.688.630.952
05/07/2018 18:00,52.35,38589,2209,20,58,540,2,2829,4.688.630.952
05/07/2018 19:00,52.43,38018,2242,21,59,555,1,2878,4.688.630.952
05/07/2018 20:00,52.5,37132,2153,22,62,583,2,2822,4.688.630.952
05/07/2018 21:00,52.17,36566,2068,23,60,649,3,2803,4.688.630.952
05/07/2018 22:00,51.93,35819,1984,24,54,715,3,2780,4.688.630.952
05/07/2018 23:00,50.19,34246,2100,35,25,873,3,3036,4.688.630.952
06/07/2018 00:00,49.42,32826,2089,36,22,991,3,3141,4.688.630.952
06/07/2018 01:00,47.63,31662,2201,38,22,1132,3,3396,4.688.630.952
06/07/2018 02:00,46.62,31079,2290,39,21,1180,3,3533,4.688.630.952
06/07/2018 03:00,44.04,30814,2324,37,20,1342,3,3726,4.688.630.952
06/07/2018 04:00,43.04,30783,2315,34,16,1279,4,3648,4.688.630.952
06/07/2018 05:00,47.09,31974,2343,32,10,1068,3,3456,4.688.630.952
06/07/2018 06:00,49.95,34521,2390,27,8,930,2,3357,4.688.630.952
06/07/2018 07:00,52,37557,2489,26,9,794,3,3321,4.688.630.952
06/07/2018 08:00,52.5,39675,2608,26,10,692,4,3340,4.688.630.952
06/07/2018 09:00,52.63,40501,2714,29,17,632,5,3397,4.688.630.952
06/07/2018 10:00,52.64,40949,2866,32,27,567,4,3496,4.688.630.952
06/07/2018 11:00,52.51,40894,2964,37,39,526,5,3571,4.688.630.952
06/07/2018 12:00,52.18,40438,3060,45,56,534,8,3703,4.688.630.952
06/07/2018 13:00,51.46,40038,3186,56,70,541,11,3864,4.688.630.952
06/07/2018 14:00,50.66,39413,3275,66,81,556,9,3987,4.688.630.952
06/07/2018 15:00,50.15,38790,3381,72,96,658,8,4215,4.688.630.952
06/07/2018 16:00,49.86,38351,3353,72,101,721,5,4252,4.688.630.952
06/07/2018 17:00,49.48,38280,3446,67,98,830,3,4444,4.688.630.952
06/07/2018 18:00,49.44,37891,3516,64,89,929,2,4600,4.688.630.952
06/07/2018 19:00,49.71,37260,3509,67,88,1007,1,4672,4.688.630.952
06/07/2018 20:00,49.8,36136,3368,75,90,1268,2,4803,4.688.630.952
06/07/2018 21:00,49.36,35420,3221,86,92,1525,3,4927,4.688.630.952
06/07/2018 22:00,48.72,34727,3037,97,88,1674,4,4900,4.688.630.952
06/07/2018 23:00,47.56,33665,3011,148,99,1706,5,4969,4.688.630.952
07/07/2018 00:00,48.12,32219,3098,153,91,1918,5,5265,4.688.630.952
07/07/2018 01:00,47.03,31013,3147,158,84,2018,4,5411,4.688.630.952
07/07/2018 02:00,46.61,30329,3173,160,69,2068,4,5474,4.688.630.952
07/07/2018 03:00,44.88,29982,3119,157,55,2053,5,5389,4.688.630.952
07/07/2018 04:00,44.04,29690,3050,154,37,2102,4,5347,4.688.630.952
07/07/2018 05:00,45.44,29833,2979,151,29,2070,3,5232,4.688.630.952
07/07/2018 06:00,47.37,30427,2945,150,21,2053,2,5171,4.688.630.952
07/07/2018 07:00,47.53,31766,2984,147,21,2059,2,5213,4.688.630.952
07/07/2018 08:00,47.97,33541,2948,146,26,2077,2,5199,4.688.630.952
07/07/2018 09:00,49.09,35288,2797,149,32,2107,2,5087,4.688.630.952
07/07/2018 10:00,49.4,36282,2751,149,47,2053,3,5003,4.688.630.952
07/07/2018 11:00,49.22,36499,2719,144,63,2128,5,5059,4.688.630.952
07/07/2018 12:00,48.99,36370,2595,137,80,2090,5,4907,4.688.630.952
07/07/2018 13:00,48.55,36050,2529,130,102,2055,7,4823,4.688.630.952
07/07/2018 14:00,48.23,35683,2565,124,124,2039,9,4861,4.688.630.952
07/07/2018 15:00,47.91,35449,2520,118,145,2088,9,4880,4.688.630.952
07/07/2018 16:00,47.79,35486,2410,111,148,2065,12,4746,4.688.630.952
07/07/2018 17:00,48.29,35784,2375,108,137,1963,11,4594,4.688.630.952
07/07/2018 18:00,48.82,35944,2338,109,121,1916,13,4497,4.688.630.952
07/07/2018 19:00,48.7,35536,2180,111,112,1845,11,4259,4.688.630.952
07/07/2018 20:00,48.43,34762,1941,117,110,1857,11,4036,4.688.630.952
07/07/2018 21:00,48.11,34404,1729,125,106,1920,11,3891,4.688.630.952
07/07/2018 22:00,48.08,33939,1539,136,96,1907,11,3689,4.688.630.952
07/07/2018 23:00,48.25,33243,1452,164,106,1832,11,3565,4.688.630.952
08/07/2018 00:00,48.06,31938,1482,172,103,1776,12,3545,4.688.630.952
08/07/2018 01:00,46.99,30939,1390,178,96,1720,14,3398,4.688.630.952
08/07/2018 02:00,46.84,30329,1233,183,98,1600,15,3129,4.688.630.952
08/07/2018 03:00,46.7,29876,1045,189,101,1505,16,2856,4.688.630.952
08/07/2018 04:00,46.64,29509,918,200,98,1246,16,2478,4.688.630.952
08/07/2018 05:00,47.08,29495,817,208,87,932,14,2058,4.688.630.952
08/07/2018 06:00,48.41,29814,736,215,84,625,13,1673,4.688.630.952
08/07/2018 07:00,48.55,30588,682,219,87,394,16,1398,4.688.630.952
08/07/2018 08:00,49.23,31984,641,221,101,262,18,1243,4.688.630.952
08/07/2018 09:00,49.32,33301,571,223,116,215,13,1138,4.688.630.952
08/07/2018 10:00,50,34264,510,223,137,189,13,1072,4.688.630.952
08/07/2018 11:00,50.2,34847,500,224,158,200,14,1096,4.688.630.952
08/07/2018 12:00,50.12,34932,553,224,173,212,15,1177,4.688.630.952
08/07/2018 13:00,49.92,34881,641,224,192,242,16,1315,4.688.630.952
08/07/2018 14:00,49.67,34709,748,223,201,296,14,1482,4.688.630.952
08/07/2018 15:00,49.46,34678,918,220,203,369,12,1722,4.688.630.952
08/07/2018 16:00,49.57,34876,1031,216,195,412,11,1865,4.688.630.952
08/07/2018 17:00,49.81,35237,1195,213,176,423,8,2015,4.688.630.952
08/07/2018 18:00,50.11,35529,1362,210,155,459,7,2193,4.688.630.952
08/07/2018 19:00,50.28,35677,1474,209,135,514,5,2337,4.688.630.952
08/07/2018 20:00,50.32,35499,1509,210,120,574,5,2418,4.688.630.952
08/07/2018 21:00,50.17,35441,1619,211,109,690,6,2635,4.688.630.952
08/07/2018 22:00,50.59,34948,1794,209,97,768,6,2874,4.688.630.952
08/07/2018 23:00,49.76,33918,1940,96,89,779,5,2909,4.688.630.952
09/07/2018 00:00,48.99,31962,2259,106,80,831,5,3281,4.640.238.095
09/07/2018 01:00,47.58,30917,2382,112,71,883,5,3453,4.640.238.095
09/07/2018 02:00,46.97,30392,2550,124,60,930,5,3669,4.640.238.095
09/07/2018 03:00,46.31,30136,2630,141,53,964,5,3793,4.640.238.095
09/07/2018 04:00,45.03,30175,2693,150,35,966,4,3848,4.640.238.095
09/07/2018 05:00,47.42,31441,2748,152,21,883,3,3807,4.640.238.095
09/07/2018 06:00,50.24,34142,2832,148,10,835,2,3827,4.640.238.095
09/07/2018 07:00,51.92,37426,2997,139,9,767,2,3914,4.640.238.095
09/07/2018 08:00,52.54,39656,3110,127,10,721,2,3970,4.640.238.095
09/07/2018 09:00,52.43,40472,3140,115,13,735,2,4005,4.640.238.095
09/07/2018 10:00,51.94,40970,3135,102,15,759,2,4013,4.640.238.095
09/07/2018 11:00,52.03,41133,3095,95,19,824,2,4035,4.640.238.095
09/07/2018 12:00,51.91,41012,2895,93,21,878,2,3889,4.640.238.095
09/07/2018 13:00,51.91,40807,2790,87,20,942,2,3841,4.640.238.095
09/07/2018 14:00,51.82,40500,2705,81,18,1034,2,3840,4.640.238.095
09/07/2018 15:00,51.41,40007,2606,80,14,1150,2,3852,4.640.238.095
09/07/2018 16:00,51.14,39777,2492,79,12,1233,2,3818,4.640.238.095
09/07/2018 17:00,51.17,39669,2465,75,10,1276,2,3828,4.640.238.095
09/07/2018 18:00,51.5,39307,2389,69,11,1298,2,3769,4.640.238.095
09/07/2018 19:00,52.11,38777,2214,65,12,1311,2,3604,4.640.238.095
09/07/2018 20:00,51.86,37883,1957,66,14,1345,2,3384,4.640.238.095
09/07/2018 21:00,51.69,37254,1572,66,19,1426,3,3086,4.640.238.095
09/07/2018 22:00,51.62,36384,1263,67,21,1500,3,2854,4.640.238.095
09/07/2018 23:00,49.68,34733,1117,24,16,1405,3,2565,4.640.238.095
10/07/2018 00:00,48.37,32338,1381,20,13,1476,3,2893,4.640.238.095
10/07/2018 01:00,47.68,31131,1237,17,11,1467,3,2735,4.640.238.095
10/07/2018 02:00,46.66,30573,1234,17,9,1371,3,2634,4.640.238.095
10/07/2018 03:00,45.72,30363,1233,14,7,1278,2,2534,4.640.238.095
10/07/2018 04:00,45.05,30324,1291,11,6,1104,3,2415,4.640.238.095
10/07/2018 05:00,48.2,31352,1353,8,4,878,3,2246,4.640.238.095
10/07/2018 06:00,50.77,33708,1360,6,4,695,3,2068,4.640.238.095
10/07/2018 07:00,52.97,36675,1392,5,3,600,3,2003,4.640.238.095
10/07/2018 08:00,53.4,38649,1426,5,4,577,3,2015,4.640.238.095
10/07/2018 09:00,53.92,39506,1514,7,5,624,3,2153,4.640.238.095
10/07/2018 10:00,53.84,39904,1618,9,6,652,3,2288,4.640.238.095
10/07/2018 11:00,53.9,39932,1679,11,5,672,3,2370,4.640.238.095
10/07/2018 12:00,53.77,39888,1590,14,6,709,3,2322,4.640.238.095
10/07/2018 13:00,53.54,39783,1498,15,10,667,3,2193,4.640.238.095
10/07/2018 14:00,53.34,39585,1334,16,11,627,4,1992,4.640.238.095
10/07/2018 15:00,53.04,39240,1155,19,16,599,4,1793,4.640.238.095
10/07/2018 16:00,52.73,38917,932,21,19,552,3,1527,4.640.238.095
10/07/2018 17:00,53.28,38764,790,22,18,490,4,1324,4.640.238.095
10/07/2018 18:00,53.53,38503,695,23,19,428,3,1168,4.640.238.095
10/07/2018 19:00,53.35,37978,582,25,26,406,4,1043,4.640.238.095
10/07/2018 20:00,53.02,37173,467,29,38,402,4,940,4.640.238.095
10/07/2018 21:00,52.69,36584,366,32,62,395,4,859,4.640.238.095
10/07/2018 22:00,52.68,35839,339,32,69,422,4,866,4.640.238.095
10/07/2018 23:00,50.8,34272,340,34,60,472,5,911,4.640.238.095
11/07/2018 00:00,49.48,32038,459,33,59,520,5,1076,4.640.238.095
11/07/2018 01:00,49.04,30859,462,31,56,521,4,1074,4.640.238.095
11/07/2018 02:00,48.15,30371,491,29,54,524,4,1102,4.640.238.095
11/07/2018 03:00,47.99,30113,519,26,51,538,3,1137,4.640.238.095
11/07/2018 04:00,47.27,30007,561,21,37,555,3,1177,4.640.238.095
11/07/2018 05:00,48.36,30966,600,15,23,460,2,1100,4.640.238.095
11/07/2018 06:00,51.36,33319,633,11,12,402,2,1060,4.640.238.095
11/07/2018 07:00,53.23,36190,678,10,9,371,1,1069,4.640.238.095
11/07/2018 08:00,53.87,37907,743,13,10,407,1,1174,4.640.238.095
11/07/2018 09:00,53.88,38596,798,17,10,507,1,1333,4.640.238.095
11/07/2018 10:00,53.92,39182,871,21,10,569,1,1472,4.640.238.095
11/07/2018 11:00,53.81,39352,886,23,9,595,1,1514,4.640.238.095
11/07/2018 12:00,53.62,39270,903,22,11,592,1,1529,4.640.238.095
11/07/2018 13:00,53.24,39171,904,22,14,585,2,1527,4.640.238.095
11/07/2018 14:00,52.85,39005,889,24,16,572,2,1503,4.640.238.095
11/07/2018 15:00,52.74,38631,912,26,18,581,3,1540,4.640.238.095
11/07/2018 16:00,52.52,38234,874,28,23,570,4,1499,4.640.238.095
11/07/2018 17:00,53.34,38012,825,29,28,531,4,1417,4.640.238.095
11/07/2018 18:00,53.8,37667,832,31,31,527,7,1428,4.640.238.095
11/07/2018 19:00,53.65,37190,774,31,38,559,5,1407,4.640.238.095
11/07/2018 20:00,53.24,36441,689,33,55,617,7,1401,4.640.238.095
11/07/2018 21:00,53.11,35882,605,34,62,655,5,1361,4.640.238.095
11/07/2018 22:00,52.93,35234,497,34,64,680,6,1281,4.640.238.095
11/07/2018 23:00,51.54,34025,450,33,93,665,5,1246,4.640.238.095
12/07/2018 00:00,50.3,32332,270,31,97,661,7,1066,4.640.238.095
12/07/2018 01:00,49.46,30977,229,28,95,638,6,996,4.640.238.095
12/07/2018 02:00,49.09,30373,209,27,96,577,5,914,4.640.238.095
12/07/2018 03:00,49.02,30091,182,25,96,504,6,813,4.640.238.095
12/07/2018 04:00,48.58,30090,170,22,86,432,8,718,4.640.238.095
12/07/2018 05:00,49.56,31144,181,16,65,334,6,602,4.640.238.095
12/07/2018 06:00,51.06,33336,189,12,45,297,3,546,4.640.238.095
12/07/2018 07:00,53.54,36103,185,10,45,284,2,526,4.640.238.095
12/07/2018 08:00,55.23,38029,178,10,56,289,2,535,4.640.238.095
12/07/2018 09:00,55.17,38862,166,12,81,330,4,593,4.640.238.095
12/07/2018 10:00,55.08,39527,181,14,82,355,5,637,4.640.238.095
12/07/2018 11:00,54.83,39607,220,17,75,385,8,705,4.640.238.095
12/07/2018 12:00,54.36,39448,233,19,59,383,10,704,4.640.238.095
12/07/2018 13:00,53.54,39296,279,20,53,381,9,742,4.640.238.095
12/07/2018 14:00,53.3,39025,348,20,48,381,8,805,4.640.238.095
12/07/2018 15:00,53.1,38732,433,21,47,392,7,900,4.640.238.095
12/07/2018 16:00,52.89,38356,514,23,52,397,11,997,4.640.238.095
12/07/2018 17:00,53.47,38175,621,26,62,403,9,1121,4.640.238.095
12/07/2018 18:00,53.71,37827,700,29,72,409,9,1219,4.640.238.095
12/07/2018 19:00,53.66,37316,755,31,81,424,11,1302,4.640.238.095
12/07/2018 20:00,53.34,36498,794,34,93,464,15,1400,4.640.238.095
12/07/2018 21:00,53.14,35974,779,38,108,500,18,1443,4.640.238.095
12/07/2018 22:00,53.16,35368,718,40,110,518,19,1405,4.640.238.095
12/07/2018 23:00,51.2,33983,693,38,35,461,6,1233,4.640.238.095
13/07/2018 00:00,51.31,32256,577,35,30,428,6,1076,4.640.238.095
13/07/2018 01:00,50.28,30955,654,33,25,407,8,1127,4.640.238.095
13/07/2018 02:00,49.84,30344,733,32,20,399,8,1192,4.640.238.095
13/07/2018 03:00,49.07,30089,766,30,17,333,7,1153,4.640.238.095
13/07/2018 04:00,48.43,30072,811,22,14,271,6,1124,4.640.238.095
13/07/2018 05:00,49.92,30977,857,13,13,205,5,1093,4.640.238.095
13/07/2018 06:00,52.35,33317,785,7,10,173,4,979,4.640.238.095
13/07/2018 07:00,54.55,36203,769,6,9,147,4,935,4.640.238.095
13/07/2018 08:00,55.21,38165,780,8,9,156,3,956,4.640.238.095
13/07/2018 09:00,55.07,39036,762,9,8,182,3,964,4.640.238.095
13/07/2018 10:00,54.57,39523,809,9,8,172,3,1001,4.640.238.095
13/07/2018 11:00,54.45,39556,933,13,9,193,4,1152,4.640.238.095
13/07/2018 12:00,54.31,39057,1003,17,10,252,4,1286,4.640.238.095
13/07/2018 13:00,54.21,38695,1102,20,13,261,3,1399,4.640.238.095
13/07/2018 14:00,53.94,38135,1191,20,19,282,3,1515,4.640.238.095
13/07/2018 15:00,53.52,37636,1274,22,22,312,4,1634,4.640.238.095
13/07/2018 16:00,52.97,37211,1346,22,25,345,4,1742,4.640.238.095
13/07/2018 17:00,53.92,37020,1519,21,26,301,4,1871,4.640.238.095
13/07/2018 18:00,54.42,36743,1642,23,32,278,4,1979,4.640.238.095
13/07/2018 19:00,54.65,36211,1693,28,38,285,4,2048,4.640.238.095
13/07/2018 20:00,54.38,35329,1677,34,53,347,4,2115,4.640.238.095
13/07/2018 21:00,54.2,34668,1560,38,64,396,4,2062,4.640.238.095
13/07/2018 22:00,54.35,34011,1475,40,69,451,3,2038,4.640.238.095
13/07/2018 23:00,51.94,33103,1456,76,61,443,4,2040,4.640.238.095
14/07/2018 00:00,52.17,31607,1438,74,59,496,4,2071,4.640.238.095
14/07/2018 01:00,50.74,30429,1436,69,55,523,4,2087,4.640.238.095
14/07/2018 02:00,49.78,29787,1436,63,55,536,5,2095,4.640.238.095
14/07/2018 03:00,48.85,29456,1426,58,54,548,4,2090,4.640.238.095
14/07/2018 04:00,47.2,29093,1424,48,51,473,3,1999,4.640.238.095
14/07/2018 05:00,48.23,29112,1424,38,49,386,3,1900,4.640.238.095
14/07/2018 06:00,49.66,29541,1394,32,47,311,3,1787,4.640.238.095
14/07/2018 07:00,50.37,30600,1401,32,47,260,3,1743,4.640.238.095
14/07/2018 08:00,52.51,32108,1403,34,42,242,3,1724,4.640.238.095
14/07/2018 09:00,52.71,33611,1380,40,41,255,3,1719,4.640.238.095
14/07/2018 10:00,52.66,34486,1345,52,43,287,3,1730,4.640.238.095
14/07/2018 11:00,52.63,34671,1348,67,55,330,3,1803,4.640.238.095
14/07/2018 12:00,52.04,34540,1361,83,62,376,3,1885,4.640.238.095
14/07/2018 13:00,51.67,34294,1430,95,72,425,3,2025,4.640.238.095
14/07/2018 14:00,51.38,34229,1495,105,80,471,5,2156,4.640.238.095
14/07/2018 15:00,51.08,34084,1542,106,88,508,6,2250,4.640.238.095
14/07/2018 16:00,51.2,34225,1599,104,96,535,5,2339,4.640.238.095
14/07/2018 17:00,51.69,34604,1727,101,103,515,4,2450,4.640.238.095
14/07/2018 18:00,53.38,34868,1745,100,109,519,3,2476,4.640.238.095
14/07/2018 19:00,54.27,34572,1663,101,115,535,4,2418,4.640.238.095
14/07/2018 20:00,54.48,33837,1483,106,117,582,4,2292,4.640.238.095
14/07/2018 21:00,54.16,33469,1313,105,124,662,5,2209,4.640.238.095
14/07/2018 22:00,54.46,33007,1187,97,125,720,5,2134,4.640.238.095
14/07/2018 23:00,52.4,32426,1132,106,106,742,3,2089,4.640.238.095
15/07/2018 00:00,50.93,31130,1208,98,101,777,2,2186,4.640.238.095
15/07/2018 01:00,49.04,29992,1194,89,101,752,2,2138,4.640.238.095
15/07/2018 02:00,48.07,29358,1181,81,96,686,3,2047,4.640.238.095
15/07/2018 03:00,47.92,29006,1098,75,96,652,3,1924,4.640.238.095
15/07/2018 04:00,47.01,28651,1011,64,86,552,4,1717,4.640.238.095
15/07/2018 05:00,48.02,28555,918,59,59,386,3,1425,4.640.238.095
15/07/2018 06:00,48.91,28766,852,54,38,304,2,1250,4.640.238.095
15/07/2018 07:00,49.78,29483,814,53,33,239,2,1141,4.640.238.095
15/07/2018 08:00,50.85,30858,807,56,39,189,2,1093,4.640.238.095
15/07/2018 09:00,51.62,32102,729,61,44,182,1,1017,4.640.238.095
15/07/2018 10:00,52.34,33077,661,65,49,207,2,984,4.640.238.095
15/07/2018 11:00,52.37,33635,624,70,59,264,2,1019,4.640.238.095
15/07/2018 12:00,52.37,33734,588,75,75,313,3,1054,4.640.238.095
15/07/2018 13:00,51.94,33611,564,76,85,378,3,1106,4.640.238.095
15/07/2018 14:00,51.81,33595,541,74,85,437,3,1140,4.640.238.095
15/07/2018 15:00,51.65,33475,529,71,90,471,4,1165,4.640.238.095
15/07/2018 16:00,52.03,33629,480,64,90,463,4,1101,4.640.238.095
15/07/2018 17:00,52.47,34067,453,57,85,443,4,1042,4.640.238.095
15/07/2018 18:00,53.03,34356,422,51,85,440,3,1001,4.640.238.095
15/07/2018 19:00,54.2,34570,369,46,96,445,4,960,4.640.238.095
15/07/2018 20:00,54.54,34307,294,41,115,507,5,962,4.640.238.095
15/07/2018 21:00,54.8,34176,213,37,125,569,6,950,4.640.238.095
15/07/2018 22:00,54.99,33667,176,32,120,601,6,935,4.640.238.095
15/07/2018 23:00,53.18,32895,175,32,114,636,6,963,4.640.238.095
16/07/2018 00:00,51.08,31329,145,30,108,615,6,904,461.452.381
16/07/2018 01:00,48.86,30044,144,28,108,576,6,862,461.452.381
16/07/2018 02:00,47.88,29443,139,25,102,522,6,794,461.452.381
16/07/2018 03:00,47.63,29259,144,24,102,494,6,770,461.452.381
16/07/2018 04:00,47.51,29230,156,19,91,434,6,706,461.452.381
16/07/2018 05:00,49.8,30059,156,12,70,338,6,582,461.452.381
16/07/2018 06:00,53.07,31924,153,6,45,220,6,430,461.452.381
16/07/2018 07:00,54.88,34683,141,4,36,182,6,369,461.452.381
16/07/2018 08:00,55.46,36787,132,5,52,173,6,368,461.452.381
16/07/2018 09:00,55.61,37626,132,7,68,195,6,408,461.452.381
16/07/2018 10:00,55.42,38098,138,10,83,248,6,485,461.452.381
16/07/2018 11:00,55.4,38250,136,14,85,284,6,525,461.452.381
16/07/2018 12:00,55.03,38137,154,17,91,329,6,597,461.452.381
16/07/2018 13:00,54.76,37987,170,19,82,355,6,632,461.452.381
16/07/2018 14:00,54.6,37768,198,22,82,395,6,703,461.452.381
16/07/2018 15:00,54.54,37449,268,23,83,448,6,828,461.452.381
16/07/2018 16:00,54.61,37261,327,22,76,469,6,900,461.452.381
16/07/2018 17:00,55.06,37170,381,22,75,484,6,968,461.452.381
16/07/2018 18:00,55.05,36924,407,22,84,523,6,1042,461.452.381
16/07/2018 19:00,54.98,36562,423,23,99,586,6,1137,461.452.381
16/07/2018 20:00,54.68,35907,410,24,114,693,6,1247,461.452.381
16/07/2018 21:00,54.57,35280,413,24,135,816,6,1394,461.452.381
16/07/2018 22:00,54.34,34438,402,22,145,899,6,1474,461.452.381
16/07/2018 23:00,51.73,33322,392,31,173,921,9,1526,461.452.381
17/07/2018 00:00,50.52,31579,430,28,173,948,10,1589,461.452.381
17/07/2018 01:00,49.1,30236,382,27,172,886,9,1476,461.452.381
17/07/2018 02:00,48.03,29718,323,25,164,827,10,1349,461.452.381
17/07/2018 03:00,47.77,29469,329,21,165,796,13,1324,461.452.381
17/07/2018 04:00,45.09,29345,292,16,158,671,14,1151,461.452.381
17/07/2018 05:00,48.73,30020,277,11,139,558,12,997,461.452.381
17/07/2018 06:00,52.42,31908,200,7,116,492,8,823,461.452.381
17/07/2018 07:00,54.44,34445,157,6,99,415,7,684,461.452.381
17/07/2018 08:00,54.92,36301,126,9,110,371,7,623,461.452.381
17/07/2018 09:00,54.94,37261,91,14,131,391,6,633,461.452.381
17/07/2018 10:00,54.62,37846,73,21,156,454,8,712,461.452.381
17/07/2018 11:00,54.59,37956,68,27,157,550,12,814,461.452.381
17/07/2018 12:00,54.07,37941,81,32,152,620,12,897,461.452.381
17/07/2018 13:00,53.89,37801,112,37,143,660,11,963,461.452.381
17/07/2018 14:00,53.71,37628,161,40,136,653,12,1002,461.452.381
17/07/2018 15:00,53.83,37366,212,42,119,699,11,1083,461.452.381
17/07/2018 16:00,53.63,37019,242,43,110,732,9,1136,461.452.381
17/07/2018 17:00,53.87,36883,222,46,103,729,6,1106,461.452.381
17/07/2018 18:00,54.53,36706,179,50,101,718,5,1053,461.452.381
17/07/2018 19:00,54.59,36384,168,54,108,757,6,1093,461.452.381
17/07/2018 20:00,54.37,35805,151,59,127,866,8,1211,461.452.381
17/07/2018 21:00,53.84,35146,144,64,163,963,9,1343,461.452.381
17/07/2018 22:00,53.36,34360,165,63,179,1013,9,1429,461.452.381
17/07/2018 23:00,51.33,33164,183,83,198,952,14,1430,461.452.381
18/07/2018 00:00,50.46,31401,271,83,204,931,11,1500,461.452.381
18/07/2018 01:00,48.99,29967,310,86,209,908,11,1524,461.452.381
18/07/2018 02:00,47.9,29473,343,87,209,855,13,1507,461.452.381
18/07/2018 03:00,46.28,29183,328,85,208,804,13,1438,461.452.381
18/07/2018 04:00,43,29060,346,75,185,713,14,1333,461.452.381
18/07/2018 05:00,47.88,29811,392,59,152,568,14,1185,461.452.381
18/07/2018 06:00,50.18,31787,446,44,113,448,8,1059,461.452.381
18/07/2018 07:00,53.51,34500,524,41,78,360,5,1008,461.452.381
18/07/2018 08:00,54.26,36428,630,49,73,360,3,1115,461.452.381
18/07/2018 09:00,54.09,37352,693,65,76,424,3,1261,461.452.381
18/07/2018 10:00,53.76,38047,758,83,89,518,4,1452,461.452.381
18/07/2018 11:00,53.77,38317,844,98,88,661,7,1698,461.452.381
18/07/2018 12:00,53.59,38231,893,106,78,796,7,1880,461.452.381
18/07/2018 13:00,53.54,37996,959,114,71,892,10,2046,461.452.381
18/07/2018 14:00,53.38,37898,1039,116,68,926,9,2158,461.452.381
18/07/2018 15:00,53.34,37546,1120,120,60,975,8,2283,461.452.381
18/07/2018 16:00,53.06,37160,1211,124,59,1027,7,2428,461.452.381
18/07/2018 17:00,53.61,36983,1298,122,62,972,6,2460,461.452.381
18/07/2018 18:00,54.07,36683,1331,117,66,944,5,2463,461.452.381
18/07/2018 19:00,54.1,36303,1335,114,80,844,6,2379,461.452.381
18/07/2018 20:00,54.05,35647,1334,110,104,873,7,2428,461.452.381
18/07/2018 21:00,53.65,35029,1323,104,133,956,10,2526,461.452.381
18/07/2018 22:00,52.72,34202,1291,99,147,966,10,2513,461.452.381
18/07/2018 23:00,50.51,33074,1270,102,98,962,12,2444,461.452.381
19/07/2018 00:00,50.25,31542,1336,96,93,974,11,2510,461.452.381
19/07/2018 01:00,49.05,30106,1321,93,87,907,8,2416,461.452.381
19/07/2018 02:00,47.47,29528,1294,90,76,830,7,2297,461.452.381
19/07/2018 03:00,42.63,29238,1240,85,66,808,6,2205,461.452.381
19/07/2018 04:00,42.04,29223,1204,75,60,709,6,2054,461.452.381
19/07/2018 05:00,47.76,30106,1184,64,40,621,6,1915,461.452.381
19/07/2018 06:00,51.05,31894,1176,53,24,502,4,1759,461.452.381
19/07/2018 07:00,53.99,34405,1237,51,14,390,3,1695,461.452.381
19/07/2018 08:00,54.47,36460,1285,60,22,345,3,1715,461.452.381
19/07/2018 09:00,54.48,37356,1243,72,33,344,3,1695,461.452.381
19/07/2018 10:00,54.12,38087,1215,81,40,376,4,1716,461.452.381
19/07/2018 11:00,53.83,38338,1224,87,46,414,5,1776,461.452.381
19/07/2018 12:00,53.64,38264,1180,91,57,439,6,1773,461.452.381
19/07/2018 13:00,53.19,38121,1182,92,64,475,7,1820,461.452.381
19/07/2018 14:00,53.23,37900,1213,91,75,499,9,1887,461.452.381
19/07/2018 15:00,53.55,37519,1226,89,87,546,6,1954,461.452.381
19/07/2018 16:00,53.67,37187,1230,92,92,501,6,1921,461.452.381
19/07/2018 17:00,54.26,37007,1298,92,90,492,6,1978,461.452.381
19/07/2018 18:00,54.8,36772,1333,89,78,495,6,2001,461.452.381
19/07/2018 19:00,55.56,36399,1313,86,77,545,6,2027,461.452.381
19/07/2018 20:00,55.05,35717,1166,83,81,629,6,1965,461.452.381
19/07/2018 21:00,54.84,35283,1028,81,80,700,5,1894,461.452.381
19/07/2018 22:00,54.28,34576,961,76,73,733,3,1846,461.452.381
19/07/2018 23:00,51.9,33199,965,75,57,719,4,1820,461.452.381
20/07/2018 00:00,51.48,31544,977,72,57,739,4,1849,461.452.381
20/07/2018 01:00,50.22,30290,951,70,62,716,4,1803,461.452.381
20/07/2018 02:00,49.64,29691,958,68,62,671,4,1763,461.452.381
20/07/2018 03:00,48.12,29457,928,66,61,623,4,1682,461.452.381
20/07/2018 04:00,46.42,29427,923,58,56,518,5,1560,461.452.381
20/07/2018 05:00,49.18,30277,925,45,46,362,4,1382,461.452.381
20/07/2018 06:00,52.47,32270,910,35,30,257,3,1235,461.452.381
20/07/2018 07:00,54.79,34928,930,33,31,205,3,1202,461.452.381
20/07/2018 08:00,55.62,36943,1002,37,31,197,3,1270,461.452.381
20/07/2018 09:00,55.94,37999,1088,47,31,216,4,1386,461.452.381
20/07/2018 10:00,55.57,38549,1125,55,42,255,4,1481,461.452.381
20/07/2018 11:00,55.42,38559,1130,60,63,290,4,1547,461.452.381
20/07/2018 12:00,55.05,38202,1142,62,87,323,5,1619,461.452.381
20/07/2018 13:00,54.77,37941,1189,62,112,344,5,1712,461.452.381
20/07/2018 14:00,54.68,37427,1229,63,134,376,5,1807,461.452.381
20/07/2018 15:00,54.89,36917,1140,61,150,410,5,1766,461.452.381
20/07/2018 16:00,54.95,36574,1058,61,151,447,4,1721,461.452.381
20/07/2018 17:00,55.62,36418,1001,65,135,471,4,1676,461.452.381
20/07/2018 18:00,55.75,36234,890,62,120,518,4,1594,461.452.381
20/07/2018 19:00,55.57,35774,775,61,110,580,4,1530,461.452.381
20/07/2018 20:00,55.36,34859,637,61,111,707,4,1520,461.452.381
20/07/2018 21:00,54.84,34277,537,60,111,764,5,1477,461.452.381
20/07/2018 22:00,54.53,33569,494,58,106,859,5,1522,461.452.381
20/07/2018 23:00,52.56,32572,476,16,81,896,4,1473,461.452.381
21/07/2018 00:00,51.99,30763,508,15,72,898,5,1498,461.452.381
21/07/2018 01:00,50.36,29694,487,17,62,832,6,1404,461.452.381
21/07/2018 02:00,49.18,29114,470,19,53,824,5,1371,461.452.381
21/07/2018 03:00,49.03,28787,448,18,39,783,5,1293,461.452.381
21/07/2018 04:00,48.07,28456,430,14,33,709,5,1191,461.452.381
21/07/2018 05:00,49.01,28447,408,9,26,581,3,1027,461.452.381
21/07/2018 06:00,50.53,28894,403,4,22,484,2,915,461.452.381
21/07/2018 07:00,52.02,29926,403,2,22,455,2,884,461.452.381
21/07/2018 08:00,53.73,31497,422,3,33,482,2,942,461.452.381
21/07/2018 09:00,54.89,33045,437,5,41,543,2,1028,461.452.381
21/07/2018 10:00,54.97,33947,480,7,59,623,4,1173,461.452.381
21/07/2018 11:00,55.05,34217,552,9,75,733,6,1375,461.452.381
21/07/2018 12:00,54.61,34117,670,12,91,817,6,1596,461.452.381
21/07/2018 13:00,53.71,33924,752,16,109,898,6,1781,461.452.381
21/07/2018 14:00,53.24,33771,801,21,110,1006,6,1944,461.452.381
21/07/2018 15:00,52.88,33563,845,23,109,1028,6,2011,461.452.381
21/07/2018 16:00,52.77,33689,859,24,99,1020,5,2007,461.452.381
21/07/2018 17:00,53.43,34012,858,22,74,994,3,1951,461.452.381
21/07/2018 18:00,54.71,34199,863,22,64,1026,3,1978,461.452.381
21/07/2018 19:00,55.03,33921,888,22,61,1026,3,2000,461.452.381
21/07/2018 20:00,54.86,33398,853,22,62,1081,2,2020,461.452.381
21/07/2018 21:00,54.61,33041,755,21,61,1191,3,2031,461.452.381
21/07/2018 22:00,54.45,32474,658,21,58,1189,3,1929,461.452.381
21/07/2018 23:00,52.44,31794,621,21,25,1170,3,1840,461.452.381
22/07/2018 00:00,52.72,30631,502,22,26,1180,3,1733,461.452.381
22/07/2018 01:00,51.14,29563,512,20,22,1149,3,1706,461.452.381
22/07/2018 02:00,50.29,28938,528,17,17,1119,2,1683,461.452.381
22/07/2018 03:00,49.89,28536,558,14,15,1079,3,1669,461.452.381
22/07/2018 04:00,48.28,28162,578,12,12,1003,3,1608,461.452.381
22/07/2018 05:00,48.96,28064,573,9,9,892,3,1486,461.452.381
22/07/2018 06:00,50.11,28348,602,5,7,831,3,1448,461.452.381
22/07/2018 07:00,51.44,29114,622,4,7,805,2,1440,461.452.381
22/07/2018 08:00,52.46,30513,683,6,10,759,3,1461,461.452.381
22/07/2018 09:00,52.88,31732,724,8,11,791,4,1538,461.452.381
22/07/2018 10:00,53.46,32649,782,13,14,808,4,1621,461.452.381
22/07/2018 11:00,53.67,33159,852,18,22,815,4,1711,461.452.381
22/07/2018 12:00,53.16,33237,941,22,30,897,4,1894,461.452.381
22/07/2018 13:00,52.96,33212,1021,25,44,958,4,2052,461.452.381
22/07/2018 14:00,52.67,33223,1065,30,52,941,3,2091,461.452.381
22/07/2018 15:00,52.5,33112,1100,34,63,996,3,2196,461.452.381
22/07/2018 16:00,52.6,33280,1141,37,68,974,4,2224,461.452.381
22/07/2018 17:00,52.75,33659,1179,39,70,917,3,2208,461.452.381
22/07/2018 18:00,52.93,33888,1200,37,70,877,3,2187,461.452.381
22/07/2018 19:00,55,34038,1180,37,72,877,2,2168,461.452.381
22/07/2018 20:00,56.08,33841,1088,36,74,948,2,2148,461.452.381
22/07/2018 21:00,56.59,33854,960,36,74,1055,2,2127,461.452.381
22/07/2018 22:00,56.11,33393,899,31,72,1131,2,2135,461.452.381
22/07/2018 23:00,53.29,32334,938,54,71,1252,2,2317,461.452.381
23/07/2018 00:00,51.77,30773,925,51,65,1223,2,2266,460.452.381
23/07/2018 01:00,50.18,29728,957,47,61,1163,2,2230,460.452.381
23/07/2018 02:00,47.92,29180,994,44,57,1094,2,2191,460.452.381
23/07/2018 03:00,47.09,28996,985,39,46,1009,2,2081,460.452.381
23/07/2018 04:00,46.02,29003,970,30,39,879,2,1920,460.452.381
23/07/2018 05:00,50.22,29962,955,22,29,707,2,1715,460.452.381
23/07/2018 06:00,53.63,32266,956,18,17,608,2,1601,460.452.381
23/07/2018 07:00,56.2,35101,971,19,14,553,2,1559,460.452.381
23/07/2018 08:00,57.15,37141,1011,20,15,538,2,1586,460.452.381
23/07/2018 09:00,57.56,38089,966,23,19,588,2,1598,460.452.381
23/07/2018 10:00,57.51,38549,921,28,25,630,2,1606,460.452.381
23/07/2018 11:00,57.44,38682,962,34,36,652,2,1686,460.452.381
23/07/2018 12:00,56.72,38596,986,37,56,729,2,1810,460.452.381
23/07/2018 13:00,56.2,38433,1007,38,68,769,4,1886,460.452.381
23/07/2018 14:00,55.96,38244,1023,37,79,789,6,1934,460.452.381
23/07/2018 15:00,56.02,37994,1057,35,92,840,7,2031,460.452.381
23/07/2018 16:00,55.98,37795,1113,34,97,791,6,2041,460.452.381
23/07/2018 17:00,56.67,37732,1157,34,98,722,4,2015,460.452.381
23/07/2018 18:00,56.91,37463,1105,29,102,692,2,1930,460.452.381
23/07/2018 19:00,56.82,36934,983,30,105,708,2,1828,460.452.381
23/07/2018 20:00,56.41,35963,818,31,104,777,2,1732,460.452.381
23/07/2018 21:00,56.31,35467,665,29,99,855,2,1650,460.452.381
23/07/2018 22:00,56.1,34726,612,27,88,926,2,1655,460.452.381
23/07/2018 23:00,53.92,33215,602,8,109,823,1,1543,460.452.381
24/07/2018 00:00,52.56,31394,547,6,100,781,1,1435,460.452.381
24/07/2018 01:00,50.84,30224,496,4,94,714,1,1309,460.452.381
24/07/2018 02:00,49.57,29708,451,4,89,653,1,1198,460.452.381
24/07/2018 03:00,49.08,29457,385,4,83,581,1,1054,460.452.381
24/07/2018 04:00,48.17,29390,346,3,70,488,1,908,460.452.381
24/07/2018 05:00,50.87,30171,307,2,41,378,1,729,460.452.381
24/07/2018 06:00,54.05,32201,271,2,19,312,1,605,460.452.381
24/07/2018 07:00,55.79,34701,231,1,13,291,1,537,460.452.381
24/07/2018 08:00,56.38,36560,222,1,14,302,1,540,460.452.381
24/07/2018 09:00,56.51,37655,211,2,14,333,1,561,460.452.381
24/07/2018 10:00,56.41,38284,222,3,15,425,1,666,460.452.381
24/07/2018 11:00,56.67,38437,231,4,21,497,1,754,460.452.381
24/07/2018 12:00,56.04,38366,250,5,37,560,2,854,460.452.381
24/07/2018 13:00,55.79,38225,267,6,53,653,4,983,460.452.381
24/07/2018 14:00,55.79,38037,290,6,58,736,5,1095,460.452.381
24/07/2018 15:00,55.93,37753,325,7,69,820,5,1226,460.452.381
24/07/2018 16:00,56.26,37391,348,7,71,870,5,1301,460.452.381
24/07/2018 17:00,56.2,37217,312,8,67,906,4,1297,460.452.381
24/07/2018 18:00,56.68,36904,281,7,64,955,3,1310,460.452.381
24/07/2018 19:00,56.69,36440,250,8,60,1074,3,1395,460.452.381
24/07/2018 20:00,56,35711,199,9,52,1242,3,1505,460.452.381
24/07/2018 21:00,55.83,35163,155,11,47,1425,2,1640,460.452.381
24/07/2018 22:00,55.76,34500,124,12,44,1501,3,1684,460.452.381
24/07/2018 23:00,54.39,32954,113,18,34,1498,1,1664,460.452.381
25/07/2018 00:00,53.56,31426,138,16,28,1373,1,1556,460.452.381
25/07/2018 01:00,51.54,30225,145,14,23,1290,1,1473,460.452.381
25/07/2018 02:00,50.5,29727,151,13,23,1073,1,1261,460.452.381
25/07/2018 03:00,50.28,29437,172,12,24,852,0,1060,460.452.381
25/07/2018 04:00,50.02,29373,183,10,24,649,0,866,460.452.381
25/07/2018 05:00,51.42,30201,181,7,18,458,1,665,460.452.381
25/07/2018 06:00,54.47,32300,145,5,13,349,0,512,460.452.381
25/07/2018 07:00,55.43,34838,108,4,8,350,0,470,460.452.381
25/07/2018 08:00,55.56,36604,98,4,14,436,0,552,460.452.381
25/07/2018 09:00,55.91,37481,96,4,19,575,0,694,460.452.381
25/07/2018 10:00,56.21,38059,112,6,20,761,1,900,460.452.381
25/07/2018 11:00,56.64,38295,152,9,26,955,1,1143,460.452.381
25/07/2018 12:00,56.69,38161,216,12,25,1106,1,1360,460.452.381
25/07/2018 13:00,56.02,37892,280,13,31,1172,3,1499,460.452.381
25/07/2018 14:00,55.89,37767,335,15,37,1178,3,1568,460.452.381
25/07/2018 15:00,56.16,37411,385,18,52,1176,4,1635,460.452.381
25/07/2018 16:00,55.67,37069,399,20,52,1213,4,1688,460.452.381
25/07/2018 17:00,55.65,36884,449,20,51,1105,4,1629,460.452.381
25/07/2018 18:00,55.53,36596,544,20,51,1009,3,1627,460.452.381
25/07/2018 19:00,55.53,36185,575,21,51,959,4,1610,460.452.381
25/07/2018 20:00,55.24,35468,574,22,56,973,3,1628,460.452.381
25/07/2018 21:00,55.25,35061,575,25,66,1049,6,1721,460.452.381
25/07/2018 22:00,55.09,34408,561,28,65,1110,7,1771,460.452.381
25/07/2018 23:00,54.33,32973,573,23,36,1227,6,1865,460.452.381
26/07/2018 00:00,51.66,31476,435,23,35,1241,7,1741,460.452.381
26/07/2018 01:00,50.24,30243,404,20,33,1315,7,1779,460.452.381
26/07/2018 02:00,49.07,29691,393,19,30,1320,4,1766,460.452.381
26/07/2018 03:00,48.24,29445,398,18,28,1387,4,1835,460.452.381
26/07/2018 04:00,47.65,29451,402,14,23,1314,3,1756,460.452.381
26/07/2018 05:00,50.11,30230,412,10,16,1036,3,1477,460.452.381
26/07/2018 06:00,53.4,32055,385,5,9,804,2,1205,460.452.381
26/07/2018 07:00,54.98,34457,330,4,8,652,1,995,460.452.381
26/07/2018 08:00,55.13,36452,299,6,10,521,1,837,460.452.381
26/07/2018 09:00,56.13,37375,276,7,15,436,2,736,460.452.381
26/07/2018 10:00,56.59,38055,256,10,16,363,2,647,460.452.381
26/07/2018 11:00,56.44,38196,217,14,16,309,4,560,460.452.381
26/07/2018 12:00,55.93,38033,211,17,17,259,5,509,460.452.381
26/07/2018 13:00,55.39,37994,206,23,18,254,5,506,460.452.381
26/07/2018 14:00,55.39,37798,211,30,20,277,7,545,460.452.381
26/07/2018 15:00,55.47,37467,235,33,22,329,10,629,460.452.381
26/07/2018 16:00,55.17,37142,268,35,24,357,8,692,460.452.381
26/07/2018 17:00,55.34,37016,298,35,27,394,7,761,460.452.381
26/07/2018 18:00,55.35,36816,373,34,31,450,6,894,460.452.381
26/07/2018 19:00,55.13,36320,428,34,45,498,6,1011,460.452.381
26/07/2018 20:00,54.93,35543,464,35,51,564,7,1121,460.452.381
26/07/2018 21:00,54.75,35221,584,33,61,640,8,1326,460.452.381
26/07/2018 22:00,54.21,34606,688,30,62,701,7,1488,460.452.381
26/07/2018 23:00,51.99,32975,814,23,63,697,5,1602,460.452.381
27/07/2018 00:00,52.06,31248,884,18,65,771,5,1743,460.452.381
27/07/2018 01:00,50.26,30192,897,14,68,816,6,1801,460.452.381
27/07/2018 02:00,48.11,29628,918,10,71,805,6,1810,460.452.381
27/07/2018 03:00,47.76,29413,910,9,77,840,6,1842,460.452.381
27/07/2018 04:00,46.43,29392,849,6,72,801,6,1734,460.452.381
27/07/2018 05:00,50.86,30170,826,4,55,728,6,1619,460.452.381
27/07/2018 06:00,53.24,32222,733,3,33,614,3,1386,460.452.381
27/07/2018 07:00,54.86,34727,616,2,32,577,2,1229,460.452.381
27/07/2018 08:00,55.54,36616,586,3,57,585,3,1234,460.452.381
27/07/2018 09:00,55.95,37584,588,5,85,682,4,1364,460.452.381
27/07/2018 10:00,56.26,38074,632,7,103,779,6,1527,460.452.381
27/07/2018 11:00,55.87,38167,712,11,112,883,5,1723,460.452.381
27/07/2018 12:00,55.04,37881,841,17,113,927,5,1903,460.452.381
27/07/2018 13:00,54.55,37717,1033,22,116,990,4,2165,460.452.381
27/07/2018 14:00,54.33,37303,1201,25,122,1059,6,2413,460.452.381
27/07/2018 15:00,54.31,36885,1303,25,124,1108,7,2567,460.452.381
27/07/2018 16:00,54.47,36562,1473,23,118,1114,7,2735,460.452.381
27/07/2018 17:00,54.71,36380,1601,23,107,1153,8,2892,460.452.381
27/07/2018 18:00,55.09,36188,1828,24,93,1208,8,3161,460.452.381
27/07/2018 19:00,55.13,35601,1910,25,90,1317,5,3347,460.452.381
27/07/2018 20:00,54.64,34756,1752,26,99,1477,5,3359,460.452.381
27/07/2018 21:00,54.47,34300,1619,26,108,1637,6,3396,460.452.381
27/07/2018 22:00,52.91,33736,1630,27,105,1735,5,3502,460.452.381
27/07/2018 23:00,50.87,32529,1706,15,0,1772,11,3504,460.452.381
28/07/2018 00:00,51.43,30935,1698,13,0,1832,11,3554,460.452.381
28/07/2018 01:00,49.16,29938,1676,12,0,1819,11,3518,460.452.381
28/07/2018 02:00,45.8,29326,1708,10,0,1826,8,3552,460.452.381
28/07/2018 03:00,45.03,29024,1740,9,0,1768,8,3525,460.452.381
28/07/2018 04:00,44.66,28710,1796,7,0,1655,8,3466,460.452.381
28/07/2018 05:00,44.46,28621,1828,6,0,1488,8,3330,460.452.381
28/07/2018 06:00,47.05,29003,1841,5,0,1372,6,3224,460.452.381
28/07/2018 07:00,49.9,30065,1781,7,0,1351,6,3145,460.452.381
28/07/2018 08:00,52.06,31576,1892,8,0,1416,6,3322,460.452.381
28/07/2018 09:00,53.05,33162,2056,10,0,1511,9,3586,460.452.381
28/07/2018 10:00,53.5,34121,2140,13,0,1676,11,3840,460.452.381
28/07/2018 11:00,53.26,34445,2222,17,0,1923,11,4173,460.452.381
28/07/2018 12:00,52.43,34391,2345,22,0,2130,7,4504,460.452.381
28/07/2018 13:00,51.52,34203,2441,22,0,2237,9,4709,460.452.381
28/07/2018 14:00,51.08,33990,2503,24,0,2327,9,4863,460.452.381
28/07/2018 15:00,50.69,33872,2527,25,0,2385,12,4949,460.452.381
28/07/2018 16:00,50.93,33890,2500,25,0,2326,12,4863,460.452.381
28/07/2018 17:00,50.89,34179,2464,23,0,2276,10,4773,460.452.381
28/07/2018 18:00,51.42,34237,2143,20,0,2225,10,4398,460.452.381
28/07/2018 19:00,52.81,33874,1822,19,0,2169,6,4016,460.452.381
28/07/2018 20:00,52.78,33362,1619,18,0,2181,6,3824,460.452.381
28/07/2018 21:00,53.07,33141,1339,18,0,2152,9,3518,460.452.381
28/07/2018 22:00,53.41,32693,1334,19,0,2173,9,3535,460.452.381
28/07/2018 23:00,50.53,31750,1432,25,115,2137,11,3720,460.452.381
29/07/2018 00:00,50.02,30989,896,21,97,2048,20,3082,460.452.381
29/07/2018 01:00,46.74,30083,921,17,86,1924,11,2959,460.452.381
29/07/2018 02:00,45.04,29486,950,14,83,1835,5,2887,460.452.381
29/07/2018 03:00,44.05,29066,1013,12,81,1767,6,2879,460.452.381
29/07/2018 04:00,43.9,28719,1063,10,77,1718,13,2881,460.452.381
29/07/2018 05:00,44.02,28510,1029,8,62,1626,8,2733,460.452.381
29/07/2018 06:00,46.83,28662,950,8,37,1534,9,2538,460.452.381
29/07/2018 07:00,48.08,29442,818,9,37,1492,7,2363,460.452.381
29/07/2018 08:00,50.2,30927,760,10,42,1607,5,2424,460.452.381
29/07/2018 09:00,51.15,32054,712,12,47,1676,4,2451,460.452.381
29/07/2018 10:00,51.38,33067,667,15,48,1746,4,2480,460.452.381
29/07/2018 11:00,51.25,33579,670,17,46,1697,4,2434,460.452.381
29/07/2018 12:00,51.14,33658,652,18,43,1686,3,2402,460.452.381
29/07/2018 13:00,51.12,33650,614,17,38,1522,3,2194,460.452.381
29/07/2018 14:00,51.21,33517,582,15,31,1379,3,2010,460.452.381
29/07/2018 15:00,51.39,33374,543,13,25,1296,3,1880,460.452.381
29/07/2018 16:00,51.39,33418,515,12,23,1234,3,1787,460.452.381
29/07/2018 17:00,52.18,33754,503,10,22,1153,9,1697,460.452.381
29/07/2018 18:00,52.61,33911,514,8,26,1068,3,1619,460.452.381
29/07/2018 19:00,54.11,33951,572,7,39,1006,2,1626,460.452.381
29/07/2018 20:00,54.51,33836,741,7,40,951,3,1742,460.452.381
29/07/2018 21:00,54.49,33974,980,7,48,846,5,1886,460.452.381
29/07/2018 22:00,54.3,33617,1236,7,48,847,17,2155,460.452.381
29/07/2018 23:00,53,32436,1466,17,109,807,5,2404,460.452.381
30/07/2018 00:00,51.29,30746,1155,16,104,828,6,2109,4.646.964.286
30/07/2018 01:00,48.2,29635,1179,15,89,780,4,2067,4.646.964.286
30/07/2018 02:00,45.72,29126,1221,14,89,737,5,2066,4.646.964.286
30/07/2018 03:00,45.39,29042,1202,15,95,696,7,2015,4.646.964.286
30/07/2018 04:00,45.07,29056,1231,14,94,717,6,2062,4.646.964.286
30/07/2018 05:00,50.05,29910,1188,11,71,645,6,1921,4.646.964.286
30/07/2018 06:00,52.98,32022,1117,9,38,575,5,1744,4.646.964.286
30/07/2018 07:00,54.43,35037,1018,11,17,525,5,1576,4.646.964.286
30/07/2018 08:00,55.38,37167,937,15,17,483,5,1457,4.646.964.286
30/07/2018 09:00,55.8,38342,745,21,18,467,5,1256,4.646.964.286
30/07/2018 10:00,55.69,38990,577,31,22,510,5,1145,4.646.964.286
30/07/2018 11:00,55.68,39188,496,42,27,527,5,1097,4.646.964.286
30/07/2018 12:00,55.38,39021,485,51,28,550,6,1120,4.646.964.286
30/07/2018 13:00,54.88,38856,502,56,26,583,6,1173,4.646.964.286
30/07/2018 14:00,54.69,38568,535,61,26,599,4,1225,4.646.964.286
30/07/2018 15:00,54.83,38224,571,67,25,639,6,1308,4.646.964.286
30/07/2018 16:00,54.97,37882,645,72,32,617,6,1372,4.646.964.286
30/07/2018 17:00,55.27,37752,624,77,34,559,5,1299,4.646.964.286
30/07/2018 18:00,55,37475,633,80,35,556,8,1312,4.646.964.286
30/07/2018 19:00,54.88,36966,639,79,38,577,11,1344,4.646.964.286
30/07/2018 20:00,54.9,36198,592,82,64,596,9,1343,4.646.964.286
30/07/2018 21:00,54.74,35808,718,85,86,643,10,1542,4.646.964.286
30/07/2018 22:00,54.74,34895,852,84,95,670,10,1711,4.646.964.286
30/07/2018 23:00,52.67,33163,899,65,35,612,4,1615,4.646.964.286
31/07/2018 00:00,51.35,31568,1018,62,40,559,5,1684,4.646.964.286
31/07/2018 01:00,49.71,30401,1071,58,39,526,4,1698,4.646.964.286
31/07/2018 02:00,48.64,29833,1135,55,36,493,4,1723,4.646.964.286
31/07/2018 03:00,47.57,29612,1217,52,33,438,4,1744,4.646.964.286
31/07/2018 04:00,46.98,29546,1203,46,27,412,4,1692,4.646.964.286
31/07/2018 05:00,50.67,30337,1125,38,23,374,4,1564,4.646.964.286
31/07/2018 06:00,53.28,32395,1088,28,16,340,4,1476,4.646.964.286
31/07/2018 07:00,54.9,34997,1057,22,11,317,4,1411,4.646.964.286
31/07/2018 08:00,55.42,36843,1103,21,9,340,4,1477,4.646.964.286
31/07/2018 09:00,55.58,37917,1079,22,8,397,4,1510,4.646.964.286
31/07/2018 10:00,55.68,38529,1090,21,11,469,4,1595,4.646.964.286
31/07/2018 11:00,55.47,38694,1164,20,12,587,4,1787,4.646.964.286
31/07/2018 12:00,55.2,38559,1371,18,14,657,4,2064,4.646.964.286
31/07/2018 13:00,54.56,38360,1590,17,16,724,4,2351,4.646.964.286
31/07/2018 14:00,54.1,38155,1691,17,14,843,4,2569,4.646.964.286
31/07/2018 15:00,54.28,37810,1734,19,13,931,4,2701,4.646.964.286
31/07/2018 16:00,54.33,37458,1518,21,13,994,4,2550,4.646.964.286
31/07/2018 17:00,55.07,37336,1157,22,18,1036,4,2237,4.646.964.286
31/07/2018 18:00,55.09,37032,828,24,27,1099,5,1983,4.646.964.286
31/07/2018 19:00,55.09,36536,663,27,34,1168,7,1899,4.646.964.286
31/07/2018 20:00,54.8,35879,604,35,52,1223,5,1919,4.646.964.286
31/07/2018 21:00,54.54,35481,559,43,68,1365,4,2039,4.646.964.286
31/07/2018 22:00,54.62,34719,539,44,74,1392,5,2054,4.646.964.286
31/07/2018 23:00,52.72,33050,485,42,79,1376,6,1988,4.646.964.286
01/08/2018 00:00,50.42,31355,542,41,82,1250,6,1921,4.646.964.286
01/08/2018 01:00,49.46,30178,546,38,78,1102,6,1770,4.646.964.286
01/08/2018 02:00,49.03,29641,494,37,72,1007,7,1617,4.646.964.286
01/08/2018 03:00,48.28,29363,421,35,65,906,7,1434,4.646.964.286
01/08/2018 04:00,47.51,29317,358,29,56,791,7,1241,4.646.964.286
01/08/2018 05:00,50.13,30116,295,21,39,641,7,1003,4.646.964.286
01/08/2018 06:00,53.22,32179,259,14,29,528,5,835,4.646.964.286
01/08/2018 07:00,54.96,34795,237,11,20,509,4,781,4.646.964.286
01/08/2018 08:00,55.88,36557,250,11,17,519,4,801,4.646.964.286
01/08/2018 09:00,55.86,37455,203,12,15,582,4,816,4.646.964.286
01/08/2018 10:00,55.94,38108,143,13,14,692,5,867,4.646.964.286
01/08/2018 11:00,55.83,38390,131,13,11,799,4,958,4.646.964.286
01/08/2018 12:00,55.9,38204,140,13,10,860,4,1027,4.646.964.286
01/08/2018 13:00,55.83,37960,176,12,7,894,5,1094,4.646.964.286
01/08/2018 14:00,55.91,37813,198,11,7,865,4,1085,4.646.964.286
01/08/2018 15:00,55.95,37429,244,10,7,897,4,1162,4.646.964.286
01/08/2018 16:00,55.88,37163,279,11,8,908,4,1210,4.646.964.286
01/08/2018 17:00,55.9,37021,288,12,11,816,4,1131,4.646.964.286
01/08/2018 18:00,55.96,36815,261,14,16,759,4,1054,4.646.964.286
01/08/2018 19:00,55.96,36378,221,16,21,717,5,980,4.646.964.286
01/08/2018 20:00,55.57,35601,179,19,32,814,4,1048,4.646.964.286
01/08/2018 21:00,55.33,35205,150,22,41,778,4,995,4.646.964.286
01/08/2018 22:00,54.71,34481,133,25,49,785,4,996,4.646.964.286
01/08/2018 23:00,53.6,32929,116,33,65,627,3,844,4.646.964.286
02/08/2018 00:00,50.96,31576,98,34,61,578,5,776,4.646.964.286
02/08/2018 01:00,49.95,30358,89,34,58,526,4,711,4.646.964.286
02/08/2018 02:00,49.49,29767,83,33,52,474,4,646,4.646.964.286
02/08/2018 03:00,49.17,29503,86,31,47,460,4,628,4.646.964.286
02/08/2018 04:00,47.73,29553,83,26,40,389,4,542,4.646.964.286
02/08/2018 05:00,49.96,30395,72,18,31,315,4,440,4.646.964.286
02/08/2018 06:00,52.96,32222,58,11,16,280,3,368,4.646.964.286
02/08/2018 07:00,54.72,34834,50,9,11,251,3,324,4.646.964.286
02/08/2018 08:00,54.61,36807,49,9,9,269,2,338,4.646.964.286
02/08/2018 09:00,54.79,37856,64,9,8,324,2,407,4.646.964.286
02/08/2018 10:00,54.84,38575,92,9,7,406,2,516,4.646.964.286
02/08/2018 11:00,54.83,38701,123,10,7,491,2,633,4.646.964.286
02/08/2018 12:00,54.84,38521,177,11,8,590,2,788,4.646.964.286
02/08/2018 13:00,54.81,38383,236,10,10,675,2,933,4.646.964.286
02/08/2018 14:00,54.73,38152,274,8,10,758,2,1052,4.646.964.286
02/08/2018 15:00,54.75,37900,330,7,11,821,2,1171,4.646.964.286
02/08/2018 16:00,54.67,37636,397,6,13,868,2,1286,4.646.964.286
02/08/2018 17:00,54.86,37490,396,4,15,894,2,1311,4.646.964.286
02/08/2018 18:00,54.78,37160,355,4,21,940,2,1322,4.646.964.286
02/08/2018 19:00,54.72,36604,288,6,25,1023,2,1344,4.646.964.286
02/08/2018 20:00,54.42,35903,213,6,25,1132,2,1378,4.646.964.286
02/08/2018 21:00,54.66,35616,153,6,25,1300,2,1486,4.646.964.286
02/08/2018 22:00,54.39,34782,142,8,25,1470,3,1648,4.646.964.286
02/08/2018 23:00,53.33,33078,152,8,17,1432,3,1612,4.646.964.286
03/08/2018 00:00,52.05,31425,114,9,19,1506,3,1651,4.646.964.286
03/08/2018 01:00,50.95,30247,133,9,23,1537,3,1705,4.646.964.286
03/08/2018 02:00,50.18,29629,135,8,25,1491,3,1662,4.646.964.286
03/08/2018 03:00,49.02,29435,133,7,23,1522,3,1688,4.646.964.286
03/08/2018 04:00,49.16,29485,148,6,23,1455,2,1634,4.646.964.286
03/08/2018 05:00,50.28,30318,159,4,20,1273,2,1458,4.646.964.286
03/08/2018 06:00,54.01,32412,161,3,19,1166,3,1352,4.646.964.286
03/08/2018 07:00,54.7,35128,156,2,21,1041,4,1224,4.646.964.286
03/08/2018 08:00,54.69,37059,169,2,25,1038,4,1238,4.646.964.286
03/08/2018 09:00,54.97,38167,187,3,36,1039,5,1270,4.646.964.286
03/08/2018 10:00,55.05,38734,201,5,56,1168,5,1435,4.646.964.286
03/08/2018 11:00,55.03,38821,236,8,74,1324,5,1647,4.646.964.286
03/08/2018 12:00,54.95,38394,292,11,90,1438,5,1836,4.646.964.286
03/08/2018 13:00,54.93,38067,347,13,101,1440,5,1906,4.646.964.286
03/08/2018 14:00,54.79,37653,400,13,107,1439,5,1964,4.646.964.286
03/08/2018 15:00,54.85,37245,473,12,111,1457,4,2057,4.646.964.286
03/08/2018 16:00,54.74,36972,565,10,103,1514,5,2197,4.646.964.286
03/08/2018 17:00,54.78,36802,605,9,88,1427,4,2133,4.646.964.286
03/08/2018 18:00,54.78,36509,576,8,76,1325,3,1988,4.646.964.286
03/08/2018 19:00,54.71,35920,503,7,73,1252,2,1837,4.646.964.286
03/08/2018 20:00,54.13,35133,432,6,67,1285,2,1792,4.646.964.286
03/08/2018 21:00,54.29,34662,418,7,65,1323,2,1815,4.646.964.286
03/08/2018 22:00,54.11,33865,488,8,59,1361,3,1919,4.646.964.286
03/08/2018 23:00,53.44,32518,541,85,0,1293,2,1921,4.646.964.286
04/08/2018 00:00,53.56,30999,428,82,0,1241,3,1754,4.646.964.286
04/08/2018 01:00,51.51,30007,465,81,0,1232,4,1782,4.646.964.286
04/08/2018 02:00,49.94,29319,497,81,0,1226,6,1810,4.646.964.286
04/08/2018 03:00,49.5,28963,548,84,0,1194,4,1830,4.646.964.286
04/08/2018 04:00,48.75,28673,558,85,0,1133,4,1780,4.646.964.286
04/08/2018 05:00,48.73,28617,506,85,0,1032,3,1626,4.646.964.286
04/08/2018 06:00,49.96,29101,470,91,0,977,3,1541,4.646.964.286
04/08/2018 07:00,51.63,30202,467,103,0,898,3,1471,4.646.964.286
04/08/2018 08:00,53.07,31861,515,122,0,858,6,1501,4.646.964.286
04/08/2018 09:00,53.61,33312,576,138,0,874,8,1596,4.646.964.286
04/08/2018 10:00,53.45,34265,648,147,0,913,5,1713,4.646.964.286
04/08/2018 11:00,52.81,34615,760,155,0,969,7,1891,4.646.964.286
04/08/2018 12:00,52.37,34638,929,160,0,1034,4,2127,4.646.964.286
04/08/2018 13:00,51.47,34449,1088,153,0,1097,6,2344,4.646.964.286
04/08/2018 14:00,51.24,34259,1268,147,0,1144,6,2565,4.646.964.286
04/08/2018 15:00,51.08,34072,1468,142,0,1215,8,2833,4.646.964.286
04/08/2018 16:00,50.94,34044,1672,137,0,1208,7,3024,4.646.964.286
04/08/2018 17:00,51.29,34193,1854,131,0,1136,5,3126,4.646.964.286
04/08/2018 18:00,52.66,34341,2106,124,0,1113,4,3347,4.646.964.286
04/08/2018 19:00,53.23,34068,2278,120,0,1147,3,3548,4.646.964.286
04/08/2018 20:00,52.8,33590,2343,120,0,1277,3,3743,4.646.964.286
04/08/2018 21:00,52.73,33492,2388,117,0,1368,3,3876,4.646.964.286
04/08/2018 22:00,52.09,32882,2489,111,0,1479,5,4084,4.646.964.286
04/08/2018 23:00,49.6,31841,2659,106,90,1480,5,4340,4.646.964.286
05/08/2018 00:00,50.61,30544,2725,101,96,1507,3,4432,4.646.964.286
05/08/2018 01:00,49.88,29617,2859,97,104,1505,2,4567,4.646.964.286
05/08/2018 02:00,49.41,28994,2998,92,102,1499,3,4694,4.646.964.286
05/08/2018 03:00,47.86,28670,3138,88,104,1497,2,4829,4.646.964.286
05/08/2018 04:00,46.07,28372,3180,82,103,1444,1,4810,4.646.964.286
05/08/2018 05:00,45.07,28142,3130,76,95,1363,1,4665,4.646.964.286
05/08/2018 06:00,45.68,28315,3088,65,93,1358,0,4604,4.646.964.286
05/08/2018 07:00,47.44,29058,3007,56,104,1404,1,4572,4.646.964.286
05/08/2018 08:00,49.44,30902,3061,51,118,1480,1,4711,4.646.964.286
05/08/2018 09:00,49.78,32214,3074,49,134,1630,1,4888,4.646.964.286
05/08/2018 10:00,49.69,33284,2946,50,153,1881,1,5031,4.646.964.286
05/08/2018 11:00,49.72,33866,2916,52,181,2151,2,5302,4.646.964.286
05/08/2018 12:00,49.46,33968,2971,51,213,2457,4,5696,4.646.964.286
05/08/2018 13:00,49.36,33864,3045,46,231,2712,5,6039,4.646.964.286
05/08/2018 14:00,49.19,33810,3111,42,234,2710,8,6105,4.646.964.286
05/08/2018 15:00,48.05,33765,3149,37,236,2866,10,6298,4.646.964.286
05/08/2018 16:00,48.19,33749,3194,35,228,2813,11,6281,4.646.964.286
05/08/2018 17:00,49.82,34032,3154,37,207,2726,10,6134,4.646.964.286
05/08/2018 18:00,51.33,34307,2992,41,178,2736,6,5953,4.646.964.286
05/08/2018 19:00,52.34,34438,2706,48,153,2772,4,5683,4.646.964.286
05/08/2018 20:00,52.74,34309,2352,59,143,2786,4,5344,4.646.964.286
05/08/2018 21:00,53.31,34506,2020,63,136,2878,3,5100,4.646.964.286
05/08/2018 22:00,52.82,33978,1787,62,132,2903,4,4888,4.646.964.286
05/08/2018 23:00,51.51,32475,1631,13,130,2976,5,4755,4.646.964.286
06/08/2018 00:00,50.05,31085,1637,14,143,3049,4,4847,4.748.809.524
06/08/2018 01:00,47.99,30059,1506,14,152,3099,3,4774,4.748.809.524
06/08/2018 02:00,47.02,29485,1394,15,154,3122,1,4686,4.748.809.524
06/08/2018 03:00,46.02,29346,1286,19,158,3070,0,4533,4.748.809.524
06/08/2018 04:00,45.08,29407,1156,24,156,3077,0,4413,4.748.809.524
06/08/2018 05:00,48.09,30362,1033,26,151,2995,0,4205,4.748.809.524
06/08/2018 06:00,52.73,32744,899,25,148,2988,0,4060,4.748.809.524
06/08/2018 07:00,53.5,35938,812,28,160,2927,0,3927,4.748.809.524
06/08/2018 08:00,53.68,38087,801,36,178,2796,3,3814,4.748.809.524
06/08/2018 09:00,53.94,39152,770,42,201,2719,4,3736,4.748.809.524
06/08/2018 10:00,54.15,39818,759,49,225,2647,13,3693,4.748.809.524
06/08/2018 11:00,54.3,40035,777,55,245,2389,22,3488,4.748.809.524
06/08/2018 12:00,53.97,39894,843,64,258,2168,28,3361,4.748.809.524
06/08/2018 13:00,53.89,39804,912,72,274,1983,27,3268,4.748.809.524
06/08/2018 14:00,54.03,39578,913,76,285,1816,23,3113,4.748.809.524
06/08/2018 15:00,53.95,39252,945,79,285,1630,23,2962,4.748.809.524
06/08/2018 16:00,53.95,38903,1017,78,268,1432,26,2821,4.748.809.524
06/08/2018 17:00,53.97,38785,950,72,227,1297,25,2571,4.748.809.524
06/08/2018 18:00,54.07,38426,796,64,177,1056,16,2109,4.748.809.524
06/08/2018 19:00,54.55,37782,617,60,129,988,6,1800,4.748.809.524
06/08/2018 20:00,53.79,36945,438,59,102,951,2,1552,4.748.809.524
06/08/2018 21:00,53.87,36595,317,59,85,998,1,1460,4.748.809.524
06/08/2018 22:00,53.84,35560,238,59,75,1012,0,1384,4.748.809.524
06/08/2018 23:00,53.6,33572,188,68,57,936,0,1249,4.748.809.524
07/08/2018 00:00,52.83,31947,196,73,57,912,1,1239,4.748.809.524
07/08/2018 01:00,51.65,30848,162,83,63,801,0,1109,4.748.809.524
07/08/2018 02:00,50.75,30387,144,87,70,630,2,933,4.748.809.524
07/08/2018 03:00,49.64,30185,147,88,78,496,5,814,4.748.809.524
07/08/2018 04:00,49.49,30210,145,79,83,385,3,695,4.748.809.524
07/08/2018 05:00,51.26,31057,156,66,75,271,2,570,4.748.809.524
07/08/2018 06:00,53.25,33442,169,67,62,181,2,481,4.748.809.524
07/08/2018 07:00,53.95,36273,177,75,63,145,2,462,4.748.809.524
07/08/2018 08:00,54.72,38119,192,81,79,137,1,490,4.748.809.524
07/08/2018 09:00,54.91,39201,191,87,97,170,1,546,4.748.809.524
07/08/2018 10:00,54.98,39875,187,100,104,221,2,614,4.748.809.524
07/08/2018 11:00,54.94,40066,220,117,107,280,3,727,4.748.809.524
07/08/2018 12:00,55.09,39931,315,133,106,327,8,889,4.748.809.524
07/08/2018 13:00,55.08,39809,373,143,102,356,9,983,4.748.809.524
07/08/2018 14:00,55,39526,436,150,95,401,9,1091,4.748.809.524
07/08/2018 15:00,54.94,39142,481,149,83,448,9,1170,4.748.809.524
07/08/2018 16:00,54.58,38674,543,147,65,458,11,1224,4.748.809.524
07/08/2018 17:00,54.59,38391,585,139,39,480,7,1250,4.748.809.524
07/08/2018 18:00,54.92,38057,621,128,22,546,5,1322,4.748.809.524
07/08/2018 19:00,54.78,37610,673,118,15,686,2,1494,4.748.809.524
07/08/2018 20:00,53.98,36896,726,111,14,905,3,1759,4.748.809.524
07/08/2018 21:00,54.02,36469,904,103,15,1210,2,2234,4.748.809.524
07/08/2018 22:00,53.36,35537,1080,94,19,1459,2,2654,4.748.809.524
07/08/2018 23:00,51.78,33538,1228,93,13,1632,0,2966,4.748.809.524
08/08/2018 00:00,49.33,31882,1237,83,20,1762,1,3103,4.748.809.524
08/08/2018 01:00,47.49,30707,1263,73,28,1822,1,3187,4.748.809.524
08/08/2018 02:00,46.53,30159,1301,65,30,1839,2,3237,4.748.809.524
08/08/2018 03:00,43.81,29830,1294,55,36,1824,3,3212,4.748.809.524
08/08/2018 04:00,43.81,29809,1202,45,38,1774,4,3063,4.748.809.524
08/08/2018 05:00,47.74,30604,1098,41,34,1613,5,2791,4.748.809.524
08/08/2018 06:00,51.17,32900,1095,36,28,1393,4,2556,4.748.809.524
08/08/2018 07:00,53.62,35879,1035,32,28,1306,2,2403,4.748.809.524
08/08/2018 08:00,54.64,37660,913,28,32,1335,2,2310,4.748.809.524
08/08/2018 09:00,54.46,38473,912,24,36,1463,3,2438,4.748.809.524
08/08/2018 10:00,54.04,39010,1079,23,38,1754,3,2897,4.748.809.524
08/08/2018 11:00,53.45,39238,1304,22,42,2205,4,3577,4.748.809.524
08/08/2018 12:00,52.6,39062,1640,23,45,2602,3,4313,4.748.809.524
08/08/2018 13:00,52.32,38826,2023,23,50,2793,4,4893,4.748.809.524
08/08/2018 14:00,51.73,38492,2299,23,51,2879,5,5257,4.748.809.524
08/08/2018 15:00,52.17,37992,2453,22,56,2940,5,5476,4.748.809.524
08/08/2018 16:00,52.62,37581,2492,22,65,2932,4,5515,4.748.809.524
08/08/2018 17:00,52.86,37423,2343,18,82,2888,3,5334,4.748.809.524
08/08/2018 18:00,52.8,37034,1985,14,104,2840,2,4945,4.748.809.524
08/08/2018 19:00,52.62,36529,1752,13,138,2848,4,4755,4.748.809.524
08/08/2018 20:00,52.4,35850,1455,14,184,2907,11,4571,4.748.809.524
08/08/2018 21:00,52.37,35365,1105,15,232,2912,17,4281,4.748.809.524
08/08/2018 22:00,52.08,34435,916,15,250,2963,20,4164,4.748.809.524
08/08/2018 23:00,50.74,32885,941,22,249,2956,22,4190,4.748.809.524
09/08/2018 00:00,49.43,31489,1057,21,244,2847,25,4194,4.748.809.524
09/08/2018 01:00,47.24,30536,884,22,233,2712,23,3874,4.748.809.524
09/08/2018 02:00,45.45,30009,741,23,220,2566,25,3575,4.748.809.524
09/08/2018 03:00,43.55,29863,578,23,209,2521,25,3356,4.748.809.524
09/08/2018 04:00,44,29991,406,20,185,2360,25,2996,4.748.809.524
09/08/2018 05:00,47.63,30799,273,16,154,2217,21,2681,4.748.809.524
09/08/2018 06:00,51.49,32364,191,11,108,2028,15,2353,4.748.809.524
09/08/2018 07:00,52.09,35064,130,7,101,1849,9,2096,4.748.809.524
09/08/2018 08:00,52.41,36907,96,6,103,1705,8,1918,4.748.809.524
09/08/2018 09:00,52.62,37650,77,7,115,1632,10,1841,4.748.809.524
09/08/2018 10:00,52.6,38047,77,7,155,1534,12,1785,4.748.809.524
09/08/2018 11:00,52.61,38023,95,8,182,1336,17,1638,4.748.809.524
09/08/2018 12:00,52.65,37865,116,9,182,1233,18,1558,4.748.809.524
09/08/2018 13:00,52.63,37661,140,10,181,1122,18,1471,4.748.809.524
09/08/2018 14:00,52.66,37388,163,11,176,973,15,1338,4.748.809.524
09/08/2018 15:00,52.59,37003,196,12,171,899,14,1292,4.748.809.524
09/08/2018 16:00,52.56,36639,282,14,170,797,14,1277,4.748.809.524
09/08/2018 17:00,52.57,36477,384,18,177,703,11,1293,4.748.809.524
09/08/2018 18:00,52.64,36208,537,23,201,631,6,1398,4.748.809.524
09/08/2018 19:00,52.77,35805,751,31,241,607,7,1637,4.748.809.524
09/08/2018 20:00,52.07,35282,878,43,285,661,16,1883,4.748.809.524
09/08/2018 21:00,51.26,35046,1088,59,321,809,21,2298,4.748.809.524
09/08/2018 22:00,49.61,34120,1481,74,334,959,24,2872,4.748.809.524
09/08/2018 23:00,47.48,32661,1811,97,0,1235,14,3157,4.748.809.524
10/08/2018 00:00,46.86,31636,2867,107,0,1460,16,4450,4.748.809.524
10/08/2018 01:00,43.73,30808,2916,112,0,1682,18,4728,4.748.809.524
10/08/2018 02:00,41.77,30324,3112,113,0,1881,19,5125,4.748.809.524
10/08/2018 03:00,41.59,30201,3506,112,0,2043,19,5680,4.748.809.524
10/08/2018 04:00,41.07,30290,3721,111,0,2240,16,6088,4.748.809.524
10/08/2018 05:00,41.72,31077,3831,105,0,2382,17,6335,4.748.809.524
10/08/2018 06:00,48.07,33007,3877,97,0,2547,17,6538,4.748.809.524
10/08/2018 07:00,50.54,35651,3549,97,0,2739,16,6401,4.748.809.524
10/08/2018 08:00,51.81,37381,3667,107,0,2955,18,6747,4.748.809.524
10/08/2018 09:00,51.89,38313,4072,118,0,3323,19,7532,4.748.809.524
10/08/2018 10:00,51.38,38623,4291,126,0,3685,20,8122,4.748.809.524
10/08/2018 11:00,51.15,38570,4383,130,0,4004,20,8537,4.748.809.524
10/08/2018 12:00,49.93,38176,4475,131,0,4196,19,8821,4.748.809.524
10/08/2018 13:00,48.59,37802,4434,124,0,4382,21,8961,4.748.809.524
10/08/2018 14:00,47.9,37375,4236,115,0,4497,22,8870,4.748.809.524
10/08/2018 15:00,47.8,36847,4085,105,0,4637,20,8847,4.748.809.524
10/08/2018 16:00,48.84,36364,3937,93,0,4596,19,8645,4.748.809.524
10/08/2018 17:00,50.85,36235,3630,82,0,4535,10,8257,4.748.809.524
10/08/2018 18:00,51,36021,3181,78,0,4487,18,7764,4.748.809.524
10/08/2018 19:00,50.98,35478,2537,80,0,4389,12,7018,4.748.809.524
10/08/2018 20:00,50.2,34756,1994,85,0,4338,6,6423,4.748.809.524
10/08/2018 21:00,50.51,34532,1597,93,0,4355,11,6056,4.748.809.524
10/08/2018 22:00,50.09,33769,1294,98,0,4259,16,5667,4.748.809.524
10/08/2018 23:00,49.08,32557,1212,62,86,4106,19,5485,4.748.809.524
11/08/2018 00:00,48.57,32424,775,58,83,4001,15,4932,4.748.809.524
11/08/2018 01:00,46.02,31323,741,53,73,3874,10,4751,4.748.809.524
11/08/2018 02:00,44.08,30565,810,48,57,3768,10,4693,4.748.809.524
11/08/2018 03:00,41.99,30142,1001,42,41,3638,10,4732,4.748.809.524
11/08/2018 04:00,41,29875,1187,35,32,3502,8,4764,4.748.809.524
11/08/2018 05:00,41.44,29755,1196,29,21,3391,4,4641,4.748.809.524
11/08/2018 06:00,42.2,29996,1273,25,11,3222,2,4533,4.748.809.524
11/08/2018 07:00,44.21,31223,1272,25,8,3080,2,4387,4.748.809.524
11/08/2018 08:00,47.97,32643,1291,27,9,3078,1,4406,4.748.809.524
11/08/2018 09:00,48.48,33988,1321,30,9,3036,1,4397,4.748.809.524
11/08/2018 10:00,48.46,34983,1372,35,9,2970,2,4388,4.748.809.524
11/08/2018 11:00,48.56,35250,1408,42,10,2911,2,4373,4.748.809.524
11/08/2018 12:00,48.76,35216,1680,48,11,2832,3,4574,4.748.809.524
11/08/2018 13:00,48.43,35009,2046,51,13,2659,3,4772,4.748.809.524
11/08/2018 14:00,47.78,34751,2244,54,14,2511,2,4825,4.748.809.524
11/08/2018 15:00,46.49,34738,2458,52,16,2357,2,4885,4.748.809.524
11/08/2018 16:00,47.94,34731,2691,49,17,2229,1,4987,4.748.809.524
11/08/2018 17:00,48.74,34842,2840,44,17,2036,1,4938,4.748.809.524
11/08/2018 18:00,49.49,35015,2954,43,18,1826,1,4842,4.748.809.524
11/08/2018 19:00,50.59,34602,2991,38,25,1769,1,4824,4.748.809.524
11/08/2018 20:00,50.76,34306,2714,32,37,1802,1,4586,4.748.809.524
11/08/2018 21:00,50.93,34508,2526,30,56,1831,2,4445,4.748.809.524
11/08/2018 22:00,50.13,34074,2389,30,77,1921,10,4427,4.748.809.524
11/08/2018 23:00,49.32,32748,2309,33,135,2243,8,4728,4.748.809.524
12/08/2018 00:00,47.06,31611,2597,31,161,2405,7,5201,4.748.809.524
12/08/2018 01:00,44.5,30591,2406,33,194,2544,11,5188,4.748.809.524
12/08/2018 02:00,43.08,29949,2207,32,231,2644,13,5127,4.748.809.524
12/08/2018 03:00,42.12,29540,2012,30,277,2763,16,5098,4.748.809.524
12/08/2018 04:00,41.03,29234,1833,30,319,2848,21,5051,4.748.809.524
12/08/2018 05:00,41.01,29060,1672,27,347,2861,18,4925,4.748.809.524
12/08/2018 06:00,42.02,29332,1501,22,354,2869,21,4767,4.748.809.524
12/08/2018 07:00,40.98,30392,1310,22,376,2913,25,4646,4.748.809.524
12/08/2018 08:00,42.29,32243,1240,24,387,2945,27,4623,4.748.809.524
12/08/2018 09:00,43.89,33911,1249,26,401,2966,29,4671,4.748.809.524
12/08/2018 10:00,44.54,35179,1281,29,415,2973,29,4727,4.748.809.524
12/08/2018 11:00,45.02,35884,1210,34,425,2963,29,4661,4.748.809.524
12/08/2018 12:00,45.02,35976,1109,40,433,3011,31,4624,4.748.809.524
12/08/2018 13:00,44.43,36180,1009,46,433,2957,31,4476,4.748.809.524
12/08/2018 14:00,44.41,36123,920,51,428,2890,31,4320,4.748.809.524
12/08/2018 15:00,45.09,36035,898,53,420,2780,31,4182,4.748.809.524
12/08/2018 16:00,45.88,36192,896,51,408,2667,31,4053,4.748.809.524
12/08/2018 17:00,47.45,36782,819,47,387,2404,30,3687,4.748.809.524
12/08/2018 18:00,49.59,37250,837,43,356,2177,30,3443,4.748.809.524
12/08/2018 19:00,50.62,37221,852,41,324,2088,28,3333,4.748.809.524
12/08/2018 20:00,50.83,37080,825,43,303,2050,27,3248,4.748.809.524
12/08/2018 21:00,51.23,37347,905,48,283,2076,25,3337,4.748.809.524
12/08/2018 22:00,50.45,36612,981,57,240,2105,25,3408,4.748.809.524
12/08/2018 23:00,49.43,34747,1081,81,231,2099,28,3520,4.748.809.524
13/08/2018 00:00,48.98,32832,820,97,211,2108,25,3261,4.874.166.667
13/08/2018 01:00,46.92,31793,844,115,186,2113,24,3282,4.874.166.667
13/08/2018 02:00,44.49,31332,921,126,159,2077,21,3304,4.874.166.667
13/08/2018 03:00,43.78,31386,938,127,134,2087,15,3301,4.874.166.667
13/08/2018 04:00,43.76,31636,931,126,108,2088,11,3264,4.874.166.667
13/08/2018 05:00,47.16,32942,950,121,79,1951,8,3109,4.874.166.667
13/08/2018 06:00,50.65,35892,965,117,51,1881,6,3020,4.874.166.667
13/08/2018 07:00,51.66,39351,916,119,42,1773,4,2854,4.874.166.667
13/08/2018 08:00,52.53,41293,811,124,39,1657,4,2635,4.874.166.667
13/08/2018 09:00,52.79,42303,675,133,32,1521,4,2365,4.874.166.667
13/08/2018 10:00,53.04,42969,634,149,26,1388,4,2201,4.874.166.667
13/08/2018 11:00,53.23,43183,661,161,22,1260,4,2108,4.874.166.667
13/08/2018 12:00,53.07,43032,638,171,19,1182,5,2015,4.874.166.667
13/08/2018 13:00,53.27,42889,553,175,19,1102,5,1854,4.874.166.667
13/08/2018 14:00,53.09,42592,471,176,17,1024,5,1693,4.874.166.667
13/08/2018 15:00,52.78,42220,462,175,16,1021,4,1678,4.874.166.667
13/08/2018 16:00,52.61,41763,484,163,13,1011,4,1675,4.874.166.667
13/08/2018 17:00,52.78,41625,450,143,11,923,3,1530,4.874.166.667
13/08/2018 18:00,52.59,41296,440,126,12,857,3,1438,4.874.166.667
13/08/2018 19:00,52.82,40678,440,116,14,929,3,1502,4.874.166.667
13/08/2018 20:00,52.9,39901,408,114,21,936,3,1482,4.874.166.667
13/08/2018 21:00,52.81,39451,418,108,32,1016,3,1577,4.874.166.667
13/08/2018 22:00,51.87,38198,405,103,42,1055,3,1608,4.874.166.667
13/08/2018 23:00,49.87,35949,464,91,28,1107,2,1692,4.874.166.667
14/08/2018 00:00,49.38,32837,673,90,45,1071,2,1881,4.874.166.667
14/08/2018 01:00,47.81,31915,637,86,56,1048,3,1830,4.874.166.667
14/08/2018 02:00,46.84,31496,598,74,67,1001,3,1743,4.874.166.667
14/08/2018 03:00,45.63,31364,641,63,77,987,4,1772,4.874.166.667
14/08/2018 04:00,46.04,31608,672,53,84,973,5,1787,4.874.166.667
14/08/2018 05:00,48.33,32792,714,41,82,879,5,1721,4.874.166.667
14/08/2018 06:00,51.86,35427,761,35,71,774,5,1646,4.874.166.667
14/08/2018 07:00,54.17,37965,761,40,57,713,4,1575,4.874.166.667
14/08/2018 08:00,55.18,39444,798,53,50,660,4,1565,4.874.166.667
14/08/2018 09:00,55.15,40226,772,70,42,622,5,1511,4.874.166.667
14/08/2018 10:00,55.22,40735,799,82,36,603,5,1525,4.874.166.667
14/08/2018 11:00,55.56,40900,940,88,36,551,4,1619,4.874.166.667
14/08/2018 12:00,55.18,40769,1052,93,38,552,5,1740,4.874.166.667
14/08/2018 13:00,54.53,40504,1033,97,40,537,4,1711,4.874.166.667
14/08/2018 14:00,53.5,40272,998,97,43,543,5,1686,4.874.166.667
14/08/2018 15:00,52.58,39902,1132,93,60,555,6,1846,4.874.166.667
14/08/2018 16:00,52.26,39491,1296,86,62,551,4,1999,4.874.166.667
14/08/2018 17:00,52.41,39266,1523,76,61,570,6,2236,4.874.166.667
14/08/2018 18:00,53.27,38928,1589,68,51,620,6,2334,4.874.166.667
14/08/2018 19:00,54.55,38360,1594,62,52,668,9,2385,4.874.166.667
14/08/2018 20:00,53.96,37574,1479,55,63,718,6,2321,4.874.166.667
14/08/2018 21:00,54.28,37085,1373,50,75,751,3,2252,4.874.166.667
14/08/2018 22:00,52.53,35897,1258,44,83,781,3,2169,4.874.166.667
14/08/2018 23:00,50.53,34231,1242,40,75,701,3,2061,4.874.166.667
15/08/2018 00:00,49.37,32673,1011,34,78,709,3,1835,4.874.166.667
15/08/2018 01:00,48.38,31606,990,29,76,703,3,1801,4.874.166.667
15/08/2018 02:00,47.84,31274,956,26,73,708,2,1765,4.874.166.667
15/08/2018 03:00,46.54,31212,901,23,76,699,2,1701,4.874.166.667
15/08/2018 04:00,45.49,31458,879,19,76,636,2,1612,4.874.166.667
15/08/2018 05:00,47.18,32623,842,14,76,588,2,1522,4.874.166.667
15/08/2018 06:00,50.28,35192,743,10,70,530,2,1355,4.874.166.667
15/08/2018 07:00,51.94,37646,654,8,70,498,2,1232,4.874.166.667
15/08/2018 08:00,52.95,39350,629,8,81,488,2,1208,4.874.166.667
15/08/2018 09:00,52.84,40044,601,8,90,501,2,1202,4.874.166.667
15/08/2018 10:00,52.93,40472,583,8,107,545,2,1245,4.874.166.667
15/08/2018 11:00,53.04,40584,632,7,126,590,1,1356,4.874.166.667
15/08/2018 12:00,52.65,40356,696,7,143,636,2,1484,4.874.166.667
15/08/2018 13:00,52.23,40120,757,7,154,659,2,1579,4.874.166.667
15/08/2018 14:00,51.77,39875,777,8,156,705,2,1648,4.874.166.667
15/08/2018 15:00,51.71,39334,828,8,157,767,3,1763,4.874.166.667
15/08/2018 16:00,51.27,38876,835,10,144,870,4,1863,4.874.166.667
15/08/2018 17:00,52.14,38658,768,15,121,954,3,1861,4.874.166.667
15/08/2018 18:00,54.4,38344,647,23,100,990,3,1763,4.874.166.667
15/08/2018 19:00,53.8,37817,588,35,93,1154,2,1872,4.874.166.667
15/08/2018 20:00,52.96,37090,524,42,88,1399,3,2056,4.874.166.667
15/08/2018 21:00,52.76,36748,496,46,81,1686,2,2311,4.874.166.667
15/08/2018 22:00,52.03,35706,565,49,69,1824,2,2509,4.874.166.667
15/08/2018 23:00,50.59,33943,679,37,0,1950,2,2668,4.874.166.667
16/08/2018 00:00,49.39,32735,917,35,0,1981,2,2935,4.874.166.667
16/08/2018 01:00,47.88,31599,970,34,0,1972,2,2978,4.874.166.667
16/08/2018 02:00,47.3,31214,1028,34,0,2011,2,3075,4.874.166.667
16/08/2018 03:00,46.75,31165,1087,33,0,2037,2,3159,4.874.166.667
16/08/2018 04:00,46.47,31362,1218,31,0,2121,2,3372,4.874.166.667
16/08/2018 05:00,48.48,32460,1385,29,0,2109,1,3524,4.874.166.667
16/08/2018 06:00,51.87,34964,1497,27,0,1992,1,3517,4.874.166.667
16/08/2018 07:00,52.9,37630,1640,24,0,2047,1,3712,4.874.166.667
16/08/2018 08:00,53.74,39534,1871,19,0,2175,1,4066,4.874.166.667
16/08/2018 09:00,53.52,40339,2186,17,0,2373,1,4577,4.874.166.667
16/08/2018 10:00,53.03,40638,2397,14,0,2617,1,5029,4.874.166.667
16/08/2018 11:00,52.06,40501,2520,13,0,2677,1,5211,4.874.166.667
16/08/2018 12:00,51.18,40336,2708,12,0,2830,1,5551,4.874.166.667
16/08/2018 13:00,50.96,40194,2807,12,0,2961,1,5781,4.874.166.667
16/08/2018 14:00,50.58,39912,2822,11,0,2961,2,5796,4.874.166.667
16/08/2018 15:00,50.85,39477,2804,12,0,3072,1,5889,4.874.166.667
16/08/2018 16:00,51.17,39000,2734,12,0,3113,1,5860,4.874.166.667
16/08/2018 17:00,51.83,38870,2624,12,0,3180,1,5817,4.874.166.667
16/08/2018 18:00,51.77,38546,2348,12,0,3244,1,5605,4.874.166.667
16/08/2018 19:00,51.72,37982,1834,11,0,3299,1,5145,4.874.166.667
16/08/2018 20:00,51.05,37279,1259,9,0,3366,1,4635,4.874.166.667
16/08/2018 21:00,50.91,36875,890,8,0,3474,1,4373,4.874.166.667
16/08/2018 22:00,50.49,35645,703,7,0,3584,2,4296,4.874.166.667
16/08/2018 23:00,48.72,33870,650,3,8,3683,1,4345,4.874.166.667
17/08/2018 00:00,47.94,32401,682,3,12,3645,1,4343,4.874.166.667
17/08/2018 01:00,46.67,31345,599,2,18,3551,2,4172,4.874.166.667
17/08/2018 02:00,45.16,30834,555,1,25,3502,3,4086,4.874.166.667
17/08/2018 03:00,45.14,30665,613,1,31,3413,5,4063,4.874.166.667
17/08/2018 04:00,45.03,30808,636,1,31,3303,5,3976,4.874.166.667
17/08/2018 05:00,47.03,31885,545,1,28,3118,5,3697,4.874.166.667
17/08/2018 06:00,50.11,34434,442,1,22,2952,5,3422,4.874.166.667
17/08/2018 07:00,50.71,37101,340,1,13,2755,2,3111,4.874.166.667
17/08/2018 08:00,51.81,38746,340,1,7,2683,2,3033,4.874.166.667
17/08/2018 09:00,51.99,39360,378,1,6,2657,2,3044,4.874.166.667
17/08/2018 10:00,52.1,39685,430,1,6,2675,2,3114,4.874.166.667
17/08/2018 11:00,52.04,39681,471,2,6,2759,3,3241,4.874.166.667
17/08/2018 12:00,52.13,39240,579,2,6,2767,3,3357,4.874.166.667
17/08/2018 13:00,52.16,38880,755,3,6,2727,3,3494,4.874.166.667
17/08/2018 14:00,51.65,38447,867,4,4,2790,2,3667,4.874.166.667
17/08/2018 15:00,50.99,37955,854,4,3,2794,2,3657,4.874.166.667
17/08/2018 16:00,50.95,37560,867,4,4,2610,2,3487,4.874.166.667
17/08/2018 17:00,50.97,37331,850,5,6,2427,1,3289,4.874.166.667
17/08/2018 18:00,50.88,37055,817,7,11,2194,2,3031,4.874.166.667
17/08/2018 19:00,50.97,36344,685,9,20,2035,2,2751,4.874.166.667
17/08/2018 20:00,50.35,35626,593,12,32,1991,3,2631,4.874.166.667
17/08/2018 21:00,50.46,35339,551,18,53,1973,4,2599,4.874.166.667
17/08/2018 22:00,50.03,34341,534,24,59,1961,5,2583,4.874.166.667
17/08/2018 23:00,48.83,32994,588,86,69,1867,7,2617,4.874.166.667
18/08/2018 00:00,49.15,31853,785,77,69,1760,7,2698,4.874.166.667
18/08/2018 01:00,48.36,30907,863,65,66,1723,8,2725,4.874.166.667
18/08/2018 02:00,47.35,30358,944,57,56,1648,8,2713,4.874.166.667
18/08/2018 03:00,46.08,30132,1009,56,45,1507,7,2624,4.874.166.667
18/08/2018 04:00,45.9,29896,1063,60,37,1448,8,2616,4.874.166.667
18/08/2018 05:00,45.73,29929,1138,60,34,1395,5,2632,4.874.166.667
18/08/2018 06:00,47.64,30396,1231,59,29,1411,4,2734,4.874.166.667
18/08/2018 07:00,48.66,31439,1340,59,22,1505,3,2929,4.874.166.667
18/08/2018 08:00,49.96,32944,1592,59,17,1822,2,3492,4.874.166.667
18/08/2018 09:00,50.29,34233,1960,58,15,2212,3,4248,4.874.166.667
18/08/2018 10:00,50.13,35075,2357,56,16,2740,3,5172,4.874.166.667
18/08/2018 11:00,49.45,35211,2671,54,17,3208,2,5952,4.874.166.667
18/08/2018 12:00,47.33,35161,2986,51,19,3643,1,6700,4.874.166.667
18/08/2018 13:00,46.02,34946,3146,46,23,3906,2,7123,4.874.166.667
18/08/2018 14:00,45.53,34696,3134,41,28,3972,3,7178,4.874.166.667
18/08/2018 15:00,46,34565,3148,34,34,4059,5,7280,4.874.166.667
18/08/2018 16:00,46.85,34709,3123,26,41,4128,5,7323,4.874.166.667
18/08/2018 17:00,48,35085,3049,18,42,4084,3,7196,4.874.166.667
18/08/2018 18:00,48.16,35208,2908,12,47,4166,3,7136,4.874.166.667
18/08/2018 19:00,48.11,34750,2668,9,51,4237,3,6968,4.874.166.667
18/08/2018 20:00,47.67,34379,2378,7,51,4243,3,6682,4.874.166.667
18/08/2018 21:00,48.04,34354,2120,7,53,4236,5,6421,4.874.166.667
18/08/2018 22:00,46.41,33765,2038,9,53,4193,7,6300,4.874.166.667
18/08/2018 23:00,43.64,32470,1946,14,60,4143,13,6176,4.874.166.667
19/08/2018 00:00,44.18,31255,1998,16,64,4052,13,6143,4.874.166.667
19/08/2018 01:00,42.8,30419,1850,18,70,3739,16,5693,4.874.166.667
19/08/2018 02:00,42.56,29914,1680,19,79,3676,14,5468,4.874.166.667
19/08/2018 03:00,43.1,29664,1418,18,88,3770,13,5307,4.874.166.667
19/08/2018 04:00,44.01,29425,1228,20,91,3677,11,5027,4.874.166.667
19/08/2018 05:00,44.14,29362,1098,22,93,3575,10,4798,4.874.166.667
19/08/2018 06:00,44.21,29407,943,26,93,3410,12,4484,4.874.166.667
19/08/2018 07:00,45,30287,827,33,102,3280,19,4261,4.874.166.667
19/08/2018 08:00,46.06,31813,775,39,124,3233,22,4193,4.874.166.667
19/08/2018 09:00,47.02,33137,724,47,155,3186,20,4132,4.874.166.667
19/08/2018 10:00,46.02,34096,651,51,175,3197,19,4093,4.874.166.667
19/08/2018 11:00,45.89,34536,624,53,189,3117,19,4002,4.874.166.667
19/08/2018 12:00,44.7,34608,640,58,197,3134,15,4044,4.874.166.667
19/08/2018 13:00,44.24,34587,613,68,191,3090,12,3974,4.874.166.667
19/08/2018 14:00,42.57,34485,589,74,176,2954,14,3807,4.874.166.667
19/08/2018 15:00,42.45,34384,588,75,155,2956,14,3788,4.874.166.667
19/08/2018 16:00,44.24,34627,573,82,136,2813,11,3615,4.874.166.667
19/08/2018 17:00,47.07,35185,507,88,111,2598,8,3312,4.874.166.667
19/08/2018 18:00,49.78,35543,467,89,89,2479,7,3131,4.874.166.667
19/08/2018 19:00,50.03,35530,429,88,77,2364,6,2964,4.874.166.667
19/08/2018 20:00,50.14,35434,408,86,73,2372,6,2945,4.874.166.667
19/08/2018 21:00,50.26,35652,393,86,68,2335,6,2888,4.874.166.667
19/08/2018 22:00,49.82,34864,444,83,63,2288,3,2881,4.874.166.667
19/08/2018 23:00,48.23,33383,507,30,62,2323,3,2925,4.874.166.667
20/08/2018 00:00,46.59,31715,1499,33,77,2362,3,3974,4.931.309.524
20/08/2018 01:00,46.06,30862,1468,37,85,2371,4,3965,4.931.309.524
20/08/2018 02:00,44.15,30480,1422,42,85,2310,4,3863,4.931.309.524
20/08/2018 03:00,43.8,30455,1432,48,83,2426,4,3993,4.931.309.524
20/08/2018 04:00,43.6,30747,1524,48,85,2391,5,4053,4.931.309.524
20/08/2018 05:00,46.76,32170,1615,43,88,2193,4,3943,4.931.309.524
20/08/2018 06:00,50.79,35101,1639,32,86,1937,4,3698,4.931.309.524
20/08/2018 07:00,52.47,38139,1695,23,85,1784,3,3590,4.931.309.524
20/08/2018 08:00,53,39888,1851,25,99,1617,4,3596,4.931.309.524
20/08/2018 09:00,52.95,40724,1984,29,121,1542,5,3681,4.931.309.524
20/08/2018 10:00,52.94,41335,2089,34,155,1515,3,3796,4.931.309.524
20/08/2018 11:00,52.8,41300,2178,36,196,1571,4,3985,4.931.309.524
20/08/2018 12:00,52.36,41040,2286,37,234,1679,3,4239,4.931.309.524
20/08/2018 13:00,51.61,40938,2345,37,257,1690,4,4333,4.931.309.524
20/08/2018 14:00,50.84,40629,2530,36,276,1782,6,4630,4.931.309.524
20/08/2018 15:00,50.73,40232,2721,36,282,1930,13,4982,4.931.309.524
20/08/2018 16:00,50.74,39842,2826,35,279,1998,17,5155,4.931.309.524
20/08/2018 17:00,50.95,39734,2814,34,283,1940,17,5088,4.931.309.524
20/08/2018 18:00,50.97,39479,2651,34,290,1947,17,4939,4.931.309.524
20/08/2018 19:00,50.93,38983,2320,40,279,1958,14,4611,4.931.309.524
20/08/2018 20:00,50.81,38397,1977,49,252,2022,12,4312,4.931.309.524
20/08/2018 21:00,50.8,37943,1745,55,223,2217,7,4247,4.931.309.524
20/08/2018 22:00,50.23,36640,1600,58,193,2314,9,4174,4.931.309.524
20/08/2018 23:00,48.17,34738,1463,50,211,2492,10,4226,4.931.309.524
21/08/2018 00:00,48.79,32917,1469,58,193,2475,7,4202,4.931.309.524
21/08/2018 01:00,48.22,31927,1334,64,174,2414,7,3993,4.931.309.524
21/08/2018 02:00,48.07,31648,1196,68,157,2343,8,3772,4.931.309.524
21/08/2018 03:00,48.02,31668,1089,68,137,2338,8,3640,4.931.309.524
21/08/2018 04:00,47.94,32109,1005,71,119,2238,8,3441,4.931.309.524
21/08/2018 05:00,48.88,33521,918,74,89,2039,8,3128,4.931.309.524
21/08/2018 06:00,51.08,36321,768,83,72,1798,9,2730,4.931.309.524
21/08/2018 07:00,52.89,39890,652,84,70,1736,9,2551,4.931.309.524
21/08/2018 08:00,54.09,41398,575,86,73,1738,14,2486,4.931.309.524
21/08/2018 09:00,54.14,41962,517,100,78,1721,13,2429,4.931.309.524
21/08/2018 10:00,53.96,42165,466,99,88,1716,13,2382,4.931.309.524
21/08/2018 11:00,53.77,42032,418,92,102,1678,16,2306,4.931.309.524
21/08/2018 12:00,53.73,41784,380,92,128,1726,16,2342,4.931.309.524
21/08/2018 13:00,53.64,41540,314,92,144,1637,14,2201,4.931.309.524
21/08/2018 14:00,53.42,41485,278,102,149,1590,14,2133,4.931.309.524
21/08/2018 15:00,53.53,41181,262,107,151,1476,14,2010,4.931.309.524
21/08/2018 16:00,53.38,40829,247,100,144,1347,11,1849,4.931.309.524
21/08/2018 17:00,53.39,40715,213,89,124,1210,9,1645,4.931.309.524
21/08/2018 18:00,53.5,40551,152,82,109,1021,6,1370,4.931.309.524
21/08/2018 19:00,53.55,40134,98,76,96,905,4,1179,4.931.309.524
21/08/2018 20:00,52.9,39702,74,72,84,879,3,1112,4.931.309.524
21/08/2018 21:00,53.03,39292,83,73,73,912,2,1143,4.931.309.524
21/08/2018 22:00,51.77,37887,112,78,58,889,1,1138,4.931.309.524
21/08/2018 23:00,49.92,35723,169,123,39,865,4,1200,4.931.309.524
22/08/2018 00:00,49.88,33708,349,129,27,796,4,1305,4.931.309.524
22/08/2018 01:00,49.48,32784,552,133,23,803,4,1515,4.931.309.524
22/08/2018 02:00,49.2,32352,806,135,20,830,4,1795,4.931.309.524
22/08/2018 03:00,48.42,32284,1049,136,18,928,5,2136,4.931.309.524
22/08/2018 04:00,48.61,32493,1245,137,15,1090,4,2491,4.931.309.524
22/08/2018 05:00,49.1,33758,1404,137,15,1283,4,2843,4.931.309.524
22/08/2018 06:00,51.56,36340,1454,142,7,1482,4,3089,4.931.309.524
22/08/2018 07:00,54.01,39063,1552,134,5,1680,4,3375,4.931.309.524
22/08/2018 08:00,54.57,40643,1638,134,5,1949,4,3730,4.931.309.524
22/08/2018 09:00,55.04,41047,1629,133,4,2266,4,4036,4.931.309.524
22/08/2018 10:00,53.66,41474,1601,133,5,2571,5,4315,4.931.309.524
22/08/2018 11:00,53.31,41507,1663,131,6,2941,8,4749,4.931.309.524
22/08/2018 12:00,51.68,41237,1834,140,7,3245,11,5237,4.931.309.524
22/08/2018 13:00,51.1,41080,1947,153,8,3382,13,5503,4.931.309.524
22/08/2018 14:00,50.95,40965,1997,165,7,3498,13,5680,4.931.309.524
22/08/2018 15:00,51.43,40529,2030,173,7,3602,13,5825,4.931.309.524
22/08/2018 16:00,51.04,40167,1999,175,7,3626,13,5820,4.931.309.524
22/08/2018 17:00,51.04,39968,1952,170,10,3531,12,5675,4.931.309.524
22/08/2018 18:00,51.14,39632,1847,161,18,3376,8,5410,4.931.309.524
22/08/2018 19:00,51.21,39018,1631,152,34,3304,7,5128,4.931.309.524
22/08/2018 20:00,50.7,38412,1454,142,62,3241,7,4906,4.931.309.524
22/08/2018 21:00,50.77,38090,1287,130,116,3145,10,4688,4.931.309.524
22/08/2018 22:00,49.74,36773,1147,113,153,3109,12,4534,4.931.309.524
22/08/2018 23:00,48.26,35060,1087,125,149,2913,16,4290,4.931.309.524
23/08/2018 00:00,48.71,33722,1163,108,163,2820,17,4271,4.931.309.524
23/08/2018 01:00,48.05,32564,1005,91,168,2829,19,4112,4.931.309.524
23/08/2018 02:00,47.71,32077,878,78,165,2726,19,3866,4.931.309.524
23/08/2018 03:00,48.12,31973,693,69,165,2529,18,3474,4.931.309.524
23/08/2018 04:00,47.98,32161,522,63,148,2290,17,3040,4.931.309.524
23/08/2018 05:00,49.68,33368,419,57,118,2078,18,2690,4.931.309.524
23/08/2018 06:00,51.72,35988,351,54,92,1802,16,2315,4.931.309.524
23/08/2018 07:00,53.72,38838,319,51,65,1486,11,1932,4.931.309.524
23/08/2018 08:00,54.13,40682,354,54,61,1325,9,1803,4.931.309.524
23/08/2018 09:00,54.83,41359,449,54,62,1199,9,1773,4.931.309.524
23/08/2018 10:00,55.81,41639,574,56,81,1212,9,1932,4.931.309.524
23/08/2018 11:00,54.94,41585,681,54,92,1216,9,2052,4.931.309.524
23/08/2018 12:00,53.42,41236,814,53,100,1168,11,2146,4.931.309.524
23/08/2018 13:00,52.87,41128,899,56,103,1120,11,2189,4.931.309.524
23/08/2018 14:00,52.95,40913,909,59,97,1070,12,2147,4.931.309.524
23/08/2018 15:00,53.68,40476,863,60,90,992,12,2017,4.931.309.524
23/08/2018 16:00,54.44,40139,771,67,89,930,9,1866,4.931.309.524
23/08/2018 17:00,55.24,40057,741,71,96,857,7,1772,4.931.309.524
23/08/2018 18:00,54.99,39834,716,80,119,896,6,1817,4.931.309.524
23/08/2018 19:00,55.63,39353,678,97,156,964,9,1904,4.931.309.524
23/08/2018 20:00,55.09,38848,674,115,194,1107,16,2106,4.931.309.524
23/08/2018 21:00,55.05,38303,676,129,222,1267,19,2313,4.931.309.524
23/08/2018 22:00,52.86,36944,622,138,234,1380,19,2393,4.931.309.524
23/08/2018 23:00,50.62,35138,609,161,264,1477,19,2530,4.931.309.524
24/08/2018 00:00,50.46,33658,990,164,283,1536,20,2993,4.931.309.524
24/08/2018 01:00,50.29,32508,1051,164,290,1542,19,3066,4.931.309.524
24/08/2018 02:00,49.77,31983,1159,163,273,1662,19,3276,4.931.309.524
24/08/2018 03:00,49.06,31900,1198,160,268,1711,20,3357,4.931.309.524
24/08/2018 04:00,48.97,32125,1191,158,261,1790,20,3420,4.931.309.524
24/08/2018 05:00,49.73,33376,1189,158,237,1721,20,3325,4.931.309.524
24/08/2018 06:00,51.08,36114,1234,156,196,1738,20,3344,4.931.309.524
24/08/2018 07:00,53.58,39104,1369,158,155,1748,14,3444,4.931.309.524
24/08/2018 08:00,54.56,40743,1583,160,140,1676,12,3571,4.931.309.524
24/08/2018 09:00,54.47,41293,1854,159,130,1689,12,3844,4.931.309.524
24/08/2018 10:00,53.85,41704,2122,159,126,1768,11,4186,4.931.309.524
24/08/2018 11:00,53.42,41700,2353,155,126,1897,15,4546,4.931.309.524
24/08/2018 12:00,50.98,41308,2609,147,129,2039,9,4933,4.931.309.524
24/08/2018 13:00,50.54,41113,2661,132,126,2086,5,5010,4.931.309.524
24/08/2018 14:00,50.03,40719,2782,113,111,2139,4,5149,4.931.309.524
24/08/2018 15:00,49.32,39994,2835,97,89,2204,4,5229,4.931.309.524
24/08/2018 16:00,49.36,39441,2748,84,83,2161,5,5081,4.931.309.524
24/08/2018 17:00,50.16,39259,2578,76,76,2138,4,4872,4.931.309.524
24/08/2018 18:00,50.96,38901,2345,73,73,2142,2,4635,4.931.309.524
24/08/2018 19:00,51.11,38295,2040,73,76,2117,1,4307,4.931.309.524
24/08/2018 20:00,51.01,37731,1784,71,76,2109,3,4043,4.931.309.524
24/08/2018 21:00,51.07,37425,1597,73,67,2110,5,3852,4.931.309.524
24/08/2018 22:00,50.36,36426,1452,79,63,2098,6,3698,4.931.309.524
24/08/2018 23:00,49.63,34803,1421,60,57,2090,8,3636,4.931.309.524
25/08/2018 00:00,50.21,33375,1283,60,55,2067,10,3475,4.931.309.524
25/08/2018 01:00,49.55,32419,1190,60,55,2020,8,3333,4.931.309.524
25/08/2018 02:00,49.1,31904,1144,59,53,1996,8,3260,4.931.309.524
25/08/2018 03:00,49.28,31655,1077,59,51,1868,6,3061,4.931.309.524
25/08/2018 04:00,49.23,31439,958,58,39,1858,4,2917,4.931.309.524
25/08/2018 05:00,49.38,31516,882,52,29,1826,4,2793,4.931.309.524
25/08/2018 06:00,49.56,31974,799,41,25,1707,4,2576,4.931.309.524
25/08/2018 07:00,50.71,33320,766,33,21,1602,4,2426,4.931.309.524
25/08/2018 08:00,51.93,35051,767,33,20,1546,4,2370,4.931.309.524
25/08/2018 09:00,52.76,36372,783,35,20,1509,4,2351,4.931.309.524
25/08/2018 10:00,52.6,37187,766,38,20,1452,4,2280,4.931.309.524
25/08/2018 11:00,51.35,37311,721,41,23,1475,3,2263,4.931.309.524
25/08/2018 12:00,50.14,36954,705,43,28,1515,3,2294,4.931.309.524
25/08/2018 13:00,49.61,36669,717,41,35,1529,3,2325,4.931.309.524
25/08/2018 14:00,49.43,36391,749,41,35,1434,3,2262,4.931.309.524
25/08/2018 15:00,49.43,36273,868,39,33,1399,5,2344,4.931.309.524
25/08/2018 16:00,50.1,36284,1000,36,28,1307,5,2376,4.931.309.524
25/08/2018 17:00,51.44,36659,963,34,27,1203,4,2231,4.931.309.524
25/08/2018 18:00,52.87,36987,931,33,26,1004,3,1997,4.931.309.524
25/08/2018 19:00,53.56,36583,938,36,24,969,3,1970,4.931.309.524
25/08/2018 20:00,53.33,36362,898,43,24,1003,4,1972,4.931.309.524
25/08/2018 21:00,52.94,36334,945,52,25,1010,5,2037,4.931.309.524
25/08/2018 22:00,51.87,35495,977,61,25,1017,5,2085,4.931.309.524
25/08/2018 23:00,49.77,34103,1008,69,17,794,6,1894,4.931.309.524
26/08/2018 00:00,50,32748,1122,84,23,750,8,1987,4.931.309.524
26/08/2018 01:00,49.45,31924,1237,95,33,694,8,2067,4.931.309.524
26/08/2018 02:00,48.83,31456,1305,103,44,670,8,2130,4.931.309.524
26/08/2018 03:00,48.56,31214,1391,109,54,668,11,2233,4.931.309.524
26/08/2018 04:00,48.45,31103,1420,115,52,646,12,2245,4.931.309.524
26/08/2018 05:00,48.24,31088,1518,118,47,598,10,2291,4.931.309.524
26/08/2018 06:00,48.46,31111,1497,122,41,556,11,2227,4.931.309.524
26/08/2018 07:00,49.27,31972,1515,126,40,543,14,2238,4.931.309.524
26/08/2018 08:00,50.21,33553,1571,127,41,545,9,2293,4.931.309.524
26/08/2018 09:00,50.61,34998,1752,130,43,542,5,2472,4.931.309.524
26/08/2018 10:00,51.35,35997,1934,132,54,610,6,2736,4.931.309.524
26/08/2018 11:00,51.69,36467,1992,127,59,737,5,2920,4.931.309.524
26/08/2018 12:00,51.27,36488,1991,128,68,873,5,3065,4.931.309.524
26/08/2018 13:00,50.51,36432,1909,127,70,935,7,3048,4.931.309.524
26/08/2018 14:00,49.9,36158,1927,126,69,1025,9,3156,4.931.309.524
26/08/2018 15:00,49.47,36111,1877,121,64,1090,10,3162,4.931.309.524
26/08/2018 16:00,50.1,36273,1696,109,63,1086,10,2964,4.931.309.524
26/08/2018 17:00,51.34,36793,1407,91,60,972,9,2539,4.931.309.524
26/08/2018 18:00,53.74,37161,1150,69,56,916,10,2201,4.931.309.524
26/08/2018 19:00,54.68,37284,891,58,59,915,9,1932,4.931.309.524
26/08/2018 20:00,55.17,37352,722,52,61,1012,7,1854,4.931.309.524
26/08/2018 21:00,55.13,37413,709,47,68,1100,7,1931,4.931.309.524
26/08/2018 22:00,53.35,36406,850,43,69,1157,6,2125,4.931.309.524
26/08/2018 23:00,50.14,34948,1087,87,36,1037,6,2253,4.931.309.524
27/08/2018 00:00,50.02,33346,1347,92,35,1017,6,2497,4.895.833.333
27/08/2018 01:00,48.68,32425,1770,96,31,960,5,2862,4.895.833.333
27/08/2018 02:00,47.2,32008,2203,102,28,940,5,3278,4.895.833.333
27/08/2018 03:00,44.73,32063,2720,104,20,889,4,3737,4.895.833.333
27/08/2018 04:00,44.07,32465,3104,103,16,860,3,4086,4.895.833.333
27/08/2018 05:00,47.24,34037,3357,97,16,867,3,4340,4.895.833.333
27/08/2018 06:00,50.63,37078,3554,89,15,896,3,4557,4.895.833.333
27/08/2018 07:00,52.36,40414,3645,84,16,942,3,4690,4.895.833.333
27/08/2018 08:00,54.05,42248,3789,83,17,1075,2,4966,4.895.833.333
27/08/2018 09:00,54.33,42971,3782,87,20,1245,2,5136,4.895.833.333
27/08/2018 10:00,53.39,43418,3727,94,24,1435,3,5283,4.895.833.333
27/08/2018 11:00,52.86,43353,3645,99,26,1599,4,5373,4.895.833.333
27/08/2018 12:00,52.63,43181,3397,105,28,1777,3,5310,4.895.833.333
27/08/2018 13:00,52.75,42940,3115,103,26,1918,3,5165,4.895.833.333
27/08/2018 14:00,52.65,42714,3029,94,23,1995,3,5144,4.895.833.333
27/08/2018 15:00,52.19,42221,3043,86,17,2038,3,5187,4.895.833.333
27/08/2018 16:00,52.14,41836,3039,75,15,2020,3,5152,4.895.833.333
27/08/2018 17:00,52.86,41557,3005,65,15,1958,3,5046,4.895.833.333
27/08/2018 18:00,54.28,41306,2968,66,18,1874,3,4929,4.895.833.333
27/08/2018 19:00,55.84,41049,2817,69,26,1867,3,4782,4.895.833.333
27/08/2018 20:00,55.73,40582,2619,79,40,1862,6,4606,4.895.833.333
27/08/2018 21:00,55.56,39990,2485,84,63,1830,7,4469,4.895.833.333
27/08/2018 22:00,53.21,38334,2390,85,81,1702,9,4267,4.895.833.333
27/08/2018 23:00,50.15,36275,2303,48,129,1519,11,4010,4.895.833.333
28/08/2018 00:00,52.75,34359,2022,43,133,1384,10,3592,4.895.833.333
28/08/2018 01:00,52.04,33344,1966,39,140,1257,10,3412,4.895.833.333
28/08/2018 02:00,52.51,32844,1852,37,145,1204,10,3248,4.895.833.333
28/08/2018 03:00,52.47,32671,1745,38,150,1142,10,3085,4.895.833.333
28/08/2018 04:00,52.33,32917,1616,37,145,1074,12,2884,4.895.833.333
28/08/2018 05:00,53.55,34155,1509,33,135,965,12,2654,4.895.833.333
28/08/2018 06:00,56.87,36871,1382,24,125,880,12,2423,4.895.833.333
28/08/2018 07:00,62.07,40023,1229,17,106,755,11,2118,4.895.833.333
28/08/2018 08:00,64.37,41579,1152,17,86,686,8,1949,4.895.833.333
28/08/2018 09:00,63.89,41936,1108,18,70,618,8,1822,4.895.833.333
28/08/2018 10:00,63.21,42097,1049,19,59,566,6,1699,4.895.833.333
28/08/2018 11:00,62.96,42023,998,19,54,544,6,1621,4.895.833.333
28/08/2018 12:00,60.99,41841,892,18,42,564,6,1522,4.895.833.333
28/08/2018 13:00,61.84,41634,721,18,37,509,4,1289,4.895.833.333
28/08/2018 14:00,60.96,41380,659,16,32,485,3,1195,4.895.833.333
28/08/2018 15:00,60.83,40974,597,14,29,458,3,1101,4.895.833.333
28/08/2018 16:00,61.71,40616,525,11,24,411,2,973,4.895.833.333
28/08/2018 17:00,63.22,40485,421,8,20,404,2,855,4.895.833.333
28/08/2018 18:00,64.7,40197,293,9,15,438,2,757,4.895.833.333
28/08/2018 19:00,64.97,40047,191,10,13,512,2,728,4.895.833.333
28/08/2018 20:00,64.07,39633,122,12,12,542,2,690,4.895.833.333
28/08/2018 21:00,62.73,39075,96,15,11,640,2,764,4.895.833.333
28/08/2018 22:00,58.19,37520,90,18,9,678,2,797,4.895.833.333
28/08/2018 23:00,55.8,35491,88,19,10,651,1,769,4.895.833.333
29/08/2018 00:00,56.45,33642,197,22,9,613,1,842,4.895.833.333
29/08/2018 01:00,54.35,32617,178,25,8,560,1,772,4.895.833.333
29/08/2018 02:00,53.21,32125,194,29,7,549,1,780,4.895.833.333
29/08/2018 03:00,52.52,32014,235,31,6,515,1,788,4.895.833.333
29/08/2018 04:00,52.61,32271,274,31,5,502,1,813,4.895.833.333
29/08/2018 05:00,54.44,33595,322,30,4,490,1,847,4.895.833.333
29/08/2018 06:00,58.87,36341,364,28,3,480,1,876,4.895.833.333
29/08/2018 07:00,65.8,39402,423,25,3,576,1,1028,4.895.833.333
29/08/2018 08:00,64.97,40997,517,26,2,662,1,1208,4.895.833.333
29/08/2018 09:00,63.75,41297,608,26,1,793,1,1429,4.895.833.333
29/08/2018 10:00,62.7,41672,664,26,1,941,1,1633,4.895.833.333
29/08/2018 11:00,61.72,41759,741,27,2,1097,1,1868,4.895.833.333
29/08/2018 12:00,60.05,41433,846,26,3,1305,1,2181,4.895.833.333
29/08/2018 13:00,59.71,41264,860,23,4,1421,1,2309,4.895.833.333
29/08/2018 14:00,59.72,41111,869,20,6,1484,1,2380,4.895.833.333
29/08/2018 15:00,59.77,40681,845,18,6,1568,1,2438,4.895.833.333
29/08/2018 16:00,60.61,40401,825,16,8,1594,1,2444,4.895.833.333
29/08/2018 17:00,61.61,40282,778,15,9,1669,1,2472,4.895.833.333
29/08/2018 18:00,63.52,40022,704,18,12,1705,1,2440,4.895.833.333
29/08/2018 19:00,64.94,39558,648,23,14,1815,1,2501,4.895.833.333
29/08/2018 20:00,64.68,39221,671,28,14,1951,3,2667,4.895.833.333
29/08/2018 21:00,59.39,38645,793,30,12,2073,3,2911,4.895.833.333
29/08/2018 22:00,54.27,37005,794,30,11,2135,2,2972,4.895.833.333
29/08/2018 23:00,52.37,34993,763,34,4,2167,2,2970,4.895.833.333
30/08/2018 00:00,51.78,33433,910,32,3,2010,2,2957,4.895.833.333
30/08/2018 01:00,50.31,32270,886,29,5,1897,2,2819,4.895.833.333
30/08/2018 02:00,49.84,31748,804,26,6,1716,2,2554,4.895.833.333
30/08/2018 03:00,49.62,31768,669,25,7,1623,2,2326,4.895.833.333
30/08/2018 04:00,50,32145,624,26,7,1544,2,2203,4.895.833.333
30/08/2018 05:00,52.56,33554,734,24,7,1480,2,2247,4.895.833.333
30/08/2018 06:00,55.92,36466,904,17,7,1389,2,2319,4.895.833.333
30/08/2018 07:00,59.29,39459,1047,10,6,1250,1,2314,4.895.833.333
30/08/2018 08:00,62.91,41218,1189,7,6,1104,1,2307,4.895.833.333
30/08/2018 09:00,63.24,41746,1357,7,8,954,1,2327,4.895.833.333
30/08/2018 10:00,62.43,42082,1529,9,9,937,1,2485,4.895.833.333
30/08/2018 11:00,61.93,42033,1666,13,10,937,1,2627,4.895.833.333
30/08/2018 12:00,58.96,41861,1804,18,11,878,1,2712,4.895.833.333
30/08/2018 13:00,58.44,41810,1832,20,12,830,1,2695,4.895.833.333
30/08/2018 14:00,57.75,41744,1941,23,13,778,1,2756,4.895.833.333
30/08/2018 15:00,57.58,41244,2120,24,14,722,1,2881,4.895.833.333
30/08/2018 16:00,57.31,40914,2229,32,15,719,1,2996,4.895.833.333
30/08/2018 17:00,59.2,40977,2365,40,19,782,1,3207,4.895.833.333
30/08/2018 18:00,61.1,40775,2390,43,28,885,1,3347,4.895.833.333
30/08/2018 19:00,62.84,40431,2334,44,44,1055,2,3479,4.895.833.333
30/08/2018 20:00,63.17,39928,2228,43,72,1245,4,3592,4.895.833.333
30/08/2018 21:00,61.32,39263,2085,39,97,1522,6,3749,4.895.833.333
30/08/2018 22:00,56.42,37649,2024,34,119,1765,7,3949,4.895.833.333
30/08/2018 23:00,54.05,35552,2105,21,103,1874,4,4107,4.895.833.333
31/08/2018 00:00,53.84,33873,1594,18,112,2032,5,3761,4.895.833.333
31/08/2018 01:00,52.78,32820,1483,17,120,2048,5,3673,4.895.833.333
31/08/2018 02:00,52.59,32354,1431,15,122,2078,5,3651,4.895.833.333
31/08/2018 03:00,53.01,32301,1433,13,122,2241,4,3813,4.895.833.333
31/08/2018 04:00,53.4,32636,1390,9,115,2289,5,3808,4.895.833.333
31/08/2018 05:00,55.13,34088,1375,5,107,2251,6,3744,4.895.833.333
31/08/2018 06:00,58.61,37006,1349,2,102,2218,7,3678,4.895.833.333
31/08/2018 07:00,65.15,40203,1282,2,95,2116,6,3501,4.895.833.333
31/08/2018 08:00,66.9,41946,1280,2,86,1924,5,3297,4.895.833.333
31/08/2018 09:00,67.54,42466,1297,2,77,1722,4,3102,4.895.833.333
31/08/2018 10:00,65.26,42585,1298,3,74,1559,4,2938,4.895.833.333
31/08/2018 11:00,65.08,42507,1298,3,68,1474,3,2846,4.895.833.333
31/08/2018 12:00,64.57,42005,1213,3,63,1409,4,2692,4.895.833.333
31/08/2018 13:00,63.13,41495,1129,2,59,1345,4,2539,4.895.833.333
31/08/2018 14:00,62.76,40991,1165,3,47,1299,6,2520,4.895.833.333
31/08/2018 15:00,58.45,40473,1174,3,40,1264,7,2488,4.895.833.333
31/08/2018 16:00,58.91,40112,1130,3,36,1186,6,2361,4.895.833.333
31/08/2018 17:00,59.39,39967,1072,3,32,1180,5,2292,4.895.833.333
31/08/2018 18:00,60.3,39708,1002,3,31,1201,4,2241,4.895.833.333
31/08/2018 19:00,60.86,39220,826,3,34,1168,4,2035,4.895.833.333
31/08/2018 20:00,61.53,38823,727,4,38,1173,4,1946,4.895.833.333
31/08/2018 21:00,59.93,38342,697,4,42,1137,3,1883,4.895.833.333
31/08/2018 22:00,57.6,36961,632,4,42,1109,3,1790,4.895.833.333
31/08/2018 23:00,56.58,35158,563,89,93,1044,2,1791,4.895.833.333
01/09/2018 00:00,57.36,33298,420,92,87,1035,4,1638,4.895.833.333
01/09/2018 01:00,55.91,32348,417,91,84,986,3,1581,4.895.833.333
01/09/2018 02:00,55.32,31810,418,76,86,950,3,1533,4.895.833.333
01/09/2018 03:00,54.27,31581,413,62,91,934,2,1502,4.895.833.333
01/09/2018 04:00,53.99,31506,418,48,88,898,3,1455,4.895.833.333
01/09/2018 05:00,54.08,31650,432,39,78,806,4,1359,4.895.833.333
01/09/2018 06:00,55.35,32097,418,33,64,719,3,1237,4.895.833.333
01/09/2018 07:00,57.03,33401,366,27,56,615,3,1067,4.895.833.333
01/09/2018 08:00,58.31,35178,345,23,58,512,3,941,4.895.833.333
01/09/2018 09:00,60.83,36597,354,22,64,439,4,883,4.895.833.333
01/09/2018 10:00,60.92,37403,325,21,66,372,5,789,4.895.833.333
01/09/2018 11:00,60.84,37462,312,21,62,347,5,747,4.895.833.333
01/09/2018 12:00,59.49,37213,266,19,58,320,7,670,4.895.833.333
01/09/2018 13:00,57.42,36741,224,17,55,302,7,605,4.895.833.333
01/09/2018 14:00,56.9,36390,226,15,49,276,5,571,4.895.833.333
01/09/2018 15:00,56.61,36222,273,13,40,269,3,598,4.895.833.333
01/09/2018 16:00,57.14,36367,312,11,33,272,4,632,4.895.833.333
01/09/2018 17:00,58.88,36806,308,12,29,289,3,641,4.895.833.333
01/09/2018 18:00,60.79,37006,275,11,28,339,2,655,4.895.833.333
01/09/2018 19:00,60.63,36708,237,13,27,386,1,664,4.895.833.333
01/09/2018 20:00,61.16,36588,198,16,22,464,2,702,4.895.833.333
01/09/2018 21:00,60.18,36393,181,21,20,547,2,771,4.895.833.333
01/09/2018 22:00,57.03,35329,155,23,18,586,1,783,4.895.833.333
01/09/2018 23:00,55.2,33855,133,19,10,633,3,798,4.895.833.333
02/09/2018 00:00,55.6,32969,85,19,9,658,2,773,4.895.833.333
02/09/2018 01:00,54.89,32001,85,19,9,662,2,777,4.895.833.333
02/09/2018 02:00,54.07,31523,85,20,9,615,1,730,4.895.833.333
02/09/2018 03:00,53.73,31256,85,20,8,576,1,690,4.895.833.333
02/09/2018 04:00,53.78,31162,88,20,7,582,1,698,4.895.833.333
02/09/2018 05:00,53.77,31198,98,20,6,549,1,674,4.895.833.333
02/09/2018 06:00,54.08,31202,111,21,5,494,1,632,4.895.833.333
02/09/2018 07:00,54.76,32033,116,22,4,457,1,600,4.895.833.333
02/09/2018 08:00,56.02,33594,120,28,2,389,1,540,4.895.833.333
02/09/2018 09:00,57.08,35017,127,36,3,321,1,488,4.895.833.333
02/09/2018 10:00,57.23,35883,132,46,3,309,2,492,4.895.833.333
02/09/2018 11:00,57.4,36160,132,53,3,347,2,537,4.895.833.333
02/09/2018 12:00,57.38,36094,149,58,4,413,2,626,4.895.833.333
02/09/2018 13:00,56.04,35877,175,61,7,465,2,710,4.895.833.333
02/09/2018 14:00,55.7,35618,209,60,8,546,2,825,4.895.833.333
02/09/2018 15:00,55.7,35459,265,56,11,544,3,879,4.895.833.333
02/09/2018 16:00,56.44,35700,329,56,16,601,3,1005,4.895.833.333
02/09/2018 17:00,56.73,36227,375,57,23,702,3,1160,4.895.833.333
02/09/2018 18:00,58.96,36772,387,53,33,876,2,1351,4.895.833.333
02/09/2018 19:00,60.64,36999,395,53,51,1007,3,1509,4.895.833.333
02/09/2018 20:00,61.18,37184,389,52,60,1218,2,1721,4.895.833.333
02/09/2018 21:00,59.38,37035,423,50,64,1353,2,1892,4.895.833.333
02/09/2018 22:00,55.73,35824,471,50,65,1444,2,2032,4.895.833.333
02/09/2018 23:00,53.87,34194,503,3,56,1509,5,2076,4.895.833.333
03/09/2018 00:00,53.2,32985,532,3,61,1441,4,2041,4.878.511.905
03/09/2018 01:00,52.84,32062,556,3,63,1388,3,2013,4.878.511.905
03/09/2018 02:00,52.33,31730,540,4,63,1439,3,2049,4.878.511.905
03/09/2018 03:00,52,31870,529,6,63,1371,3,1972,4.878.511.905
03/09/2018 04:00,52.13,32368,535,7,60,1369,3,1974,4.878.511.905
03/09/2018 05:00,55.12,33972,587,9,46,1326,3,1971,4.878.511.905
03/09/2018 06:00,59.79,37018,650,10,37,1219,2,1918,4.878.511.905
03/09/2018 07:00,62.01,40265,721,8,31,1033,2,1795,4.878.511.905
03/09/2018 08:00,64.18,41831,771,8,27,873,1,1680,4.878.511.905
03/09/2018 09:00,64.09,42153,821,6,24,768,1,1620,4.878.511.905
03/09/2018 10:00,63.85,42260,847,7,21,730,1,1606,4.878.511.905
03/09/2018 11:00,63.23,42022,851,8,18,735,2,1614,4.878.511.905
03/09/2018 12:00,62.98,41670,845,7,14,762,2,1630,4.878.511.905
03/09/2018 13:00,61.95,41373,798,8,15,776,2,1599,4.878.511.905
03/09/2018 14:00,61.75,41050,781,9,15,740,3,1548,4.878.511.905
03/09/2018 15:00,61.3,40753,740,9,19,719,4,1491,4.878.511.905
03/09/2018 16:00,61.7,40477,696,10,26,690,4,1426,4.878.511.905
03/09/2018 17:00,61.75,40455,679,14,41,697,4,1435,4.878.511.905
03/09/2018 18:00,61.98,40309,673,18,65,762,4,1522,4.878.511.905
03/09/2018 19:00,61.99,40280,674,25,82,850,6,1637,4.878.511.905
03/09/2018 20:00,61.82,40000,619,30,93,907,6,1655,4.878.511.905
03/09/2018 21:00,60.48,39314,605,30,99,961,6,1701,4.878.511.905
03/09/2018 22:00,56.39,37584,602,27,98,909,8,1644,4.878.511.905
03/09/2018 23:00,53.8,35469,555,6,123,860,8,1552,4.878.511.905
04/09/2018 00:00,54.79,33803,460,6,109,835,8,1418,4.878.511.905
04/09/2018 01:00,54.21,32740,406,5,96,822,8,1337,4.878.511.905
04/09/2018 02:00,53.48,32315,373,5,90,834,8,1310,4.878.511.905
04/09/2018 03:00,53.18,32331,351,4,85,881,9,1330,4.878.511.905
04/09/2018 04:00,53.48,32755,339,4,74,875,9,1301,4.878.511.905
04/09/2018 05:00,56.08,34224,323,3,63,891,7,1287,4.878.511.905
04/09/2018 06:00,60.86,37246,314,3,44,805,8,1174,4.878.511.905
04/09/2018 07:00,64.69,40473,307,2,33,696,4,1042,4.878.511.905
04/09/2018 08:00,66.42,42005,295,2,29,613,3,942,4.878.511.905
04/09/2018 09:00,65.44,42250,282,2,27,553,4,868,4.878.511.905
04/09/2018 10:00,65.04,42394,249,2,24,475,3,753,4.878.511.905
04/09/2018 11:00,64.51,42379,225,3,22,412,4,666,4.878.511.905
04/09/2018 12:00,63.83,42177,195,6,20,377,4,602,4.878.511.905
04/09/2018 13:00,62.95,42073,168,9,20,369,4,570,4.878.511.905
04/09/2018 14:00,62.74,41821,167,12,21,353,3,556,4.878.511.905
04/09/2018 15:00,62.5,41380,189,15,25,350,2,581,4.878.511.905
04/09/2018 16:00,63,41135,208,18,29,367,2,624,4.878.511.905
04/09/2018 17:00,63.72,41046,202,22,33,397,2,656,4.878.511.905
04/09/2018 18:00,63.94,40836,210,28,37,438,2,715,4.878.511.905
04/09/2018 19:00,64.08,40739,216,32,42,488,4,782,4.878.511.905
04/09/2018 20:00,64.44,40433,207,34,42,492,5,780,4.878.511.905
04/09/2018 21:00,61.64,39709,186,33,44,551,5,819,4.878.511.905
04/09/2018 22:00,58.97,37910,179,32,42,551,5,809,4.878.511.905
04/09/2018 23:00,56.61,35649,182,39,48,554,5,828,4.878.511.905
05/09/2018 00:00,55.55,33553,102,37,47,569,5,760,4.878.511.905
05/09/2018 01:00,54.4,32567,85,36,45,563,4,733,4.878.511.905
05/09/2018 02:00,53.53,32177,78,36,41,572,4,731,4.878.511.905
05/09/2018 03:00,53.36,32126,71,35,37,586,4,733,4.878.511.905
05/09/2018 04:00,53.94,32483,67,33,31,579,5,715,4.878.511.905
05/09/2018 05:00,56.67,34002,63,28,25,545,5,666,4.878.511.905
05/09/2018 06:00,62.1,37028,57,24,18,484,3,586,4.878.511.905
05/09/2018 07:00,65.61,40268,50,22,15,416,3,506,4.878.511.905
05/09/2018 08:00,67.85,41878,42,24,12,367,3,448,4.878.511.905
05/09/2018 09:00,67.93,42276,37,30,11,312,3,393,4.878.511.905
05/09/2018 10:00,66.94,42590,27,34,9,263,2,335,4.878.511.905
05/09/2018 11:00,64.56,42467,28,34,10,234,2,308,4.878.511.905
05/09/2018 12:00,62.89,42168,37,36,10,215,2,300,4.878.511.905
05/09/2018 13:00,61.89,41933,52,37,13,194,2,298,4.878.511.905
05/09/2018 14:00,61.93,41756,64,40,14,190,3,311,4.878.511.905
05/09/2018 15:00,63.7,41340,78,35,19,212,3,347,4.878.511.905
05/09/2018 16:00,63.93,41117,97,32,20,203,3,355,4.878.511.905
05/09/2018 17:00,64.78,41061,110,34,22,220,4,390,4.878.511.905
05/09/2018 18:00,63.99,40882,128,42,24,284,3,481,4.878.511.905
05/09/2018 19:00,64.9,40621,141,40,26,332,3,542,4.878.511.905
05/09/2018 20:00,63.81,40258,148,38,26,361,3,576,4.878.511.905
05/09/2018 21:00,61.5,39450,163,35,28,385,2,613,4.878.511.905
05/09/2018 22:00,59.64,37653,168,33,27,391,2,621,4.878.511.905
05/09/2018 23:00,56.84,35398,170,22,42,380,6,620,4.878.511.905
06/09/2018 00:00,55.06,33759,331,21,40,354,5,751,4.878.511.905
06/09/2018 01:00,53.86,32611,340,21,40,338,5,744,4.878.511.905
06/09/2018 02:00,53.1,32148,325,20,42,350,5,742,4.878.511.905
06/09/2018 03:00,52.98,32133,316,20,47,369,6,758,4.878.511.905
06/09/2018 04:00,53.61,32614,320,19,48,383,5,775,4.878.511.905
06/09/2018 05:00,55.77,34197,364,18,46,399,8,835,4.878.511.905
06/09/2018 06:00,62.33,37267,417,15,41,404,5,882,4.878.511.905
06/09/2018 07:00,66.9,40546,459,12,35,382,3,891,4.878.511.905
06/09/2018 08:00,66.96,42377,519,11,29,372,3,934,4.878.511.905
06/09/2018 09:00,66.83,42837,646,11,27,330,2,1016,4.878.511.905
06/09/2018 10:00,65.16,42905,790,11,25,337,2,1165,4.878.511.905
06/09/2018 11:00,64.81,42759,957,13,23,345,3,1341,4.878.511.905
06/09/2018 12:00,63.28,42459,1129,15,21,359,4,1528,4.878.511.905
06/09/2018 13:00,62.5,42181,1244,16,21,385,5,1671,4.878.511.905
06/09/2018 14:00,64.01,41935,1400,18,22,423,4,1867,4.878.511.905
06/09/2018 15:00,63.45,41619,1472,19,23,470,3,1987,4.878.511.905
06/09/2018 16:00,64,41426,1555,19,30,525,4,2133,4.878.511.905
06/09/2018 17:00,64.15,41415,1611,19,47,621,4,2302,4.878.511.905
06/09/2018 18:00,63.94,41315,1676,20,72,756,4,2528,4.878.511.905
06/09/2018 19:00,62.99,41177,1765,21,92,905,9,2792,4.878.511.905
06/09/2018 20:00,61.41,40863,1767,21,106,1015,11,2920,4.878.511.905
06/09/2018 21:00,60.12,40035,1850,21,118,1107,13,3109,4.878.511.905
06/09/2018 22:00,57.14,38193,2051,22,119,1132,13,3337,4.878.511.905
06/09/2018 23:00,54.61,35817,2100,14,0,1069,6,3189,4.878.511.905
07/09/2018 00:00,54.7,34036,2392,14,0,1042,4,3452,4.878.511.905
07/09/2018 01:00,53.84,32993,2335,14,0,1021,4,3374,4.878.511.905
07/09/2018 02:00,53.53,32621,2246,15,0,1034,4,3299,4.878.511.905
07/09/2018 03:00,53.51,32573,2136,15,0,1049,5,3205,4.878.511.905
07/09/2018 04:00,53.83,32961,1951,13,0,1090,4,3058,4.878.511.905
07/09/2018 05:00,55.63,34617,1766,11,0,1153,5,2935,4.878.511.905
07/09/2018 06:00,59.58,37782,1582,8,0,1186,5,2781,4.878.511.905
07/09/2018 07:00,62.32,41105,1359,6,0,1178,4,2547,4.878.511.905
07/09/2018 08:00,63.49,42589,1276,5,0,1187,3,2471,4.878.511.905
07/09/2018 09:00,63.8,42962,1246,4,0,1230,3,2483,4.878.511.905
07/09/2018 10:00,63.47,43057,1216,5,0,1205,3,2429,4.878.511.905
07/09/2018 11:00,62.38,42870,1222,5,0,1239,3,2469,4.878.511.905
07/09/2018 12:00,61.35,42330,1238,7,0,1249,4,2498,4.878.511.905
07/09/2018 13:00,59.19,41730,1235,10,0,1202,4,2451,4.878.511.905
07/09/2018 14:00,57.56,41197,1224,12,0,1164,4,2404,4.878.511.905
07/09/2018 15:00,56.88,40687,1137,13,0,1167,3,2320,4.878.511.905
07/09/2018 16:00,57.67,40414,1135,16,0,1180,2,2333,4.878.511.905
07/09/2018 17:00,59.29,40479,1168,19,0,1232,2,2421,4.878.511.905
07/09/2018 18:00,59.75,40338,1299,23,0,1405,2,2729,4.878.511.905
07/09/2018 19:00,59.61,40009,1355,28,0,1505,4,2892,4.878.511.905
07/09/2018 20:00,59.17,39655,1337,32,0,1530,6,2905,4.878.511.905
07/09/2018 21:00,58.21,38821,1380,33,0,1624,7,3044,4.878.511.905
07/09/2018 22:00,55.64,37218,1433,33,0,1642,9,3117,4.878.511.905
07/09/2018 23:00,53.44,35088,1492,45,53,1671,7,3268,4.878.511.905
08/09/2018 00:00,53.89,32676,1889,41,48,1670,5,3653,4.878.511.905
08/09/2018 01:00,53.53,31710,1913,40,47,1561,5,3566,4.878.511.905
08/09/2018 02:00,52.6,31251,1937,36,45,1493,3,3514,4.878.511.905
08/09/2018 03:00,50.84,31056,2029,31,44,1470,4,3578,4.878.511.905
08/09/2018 04:00,50.21,31084,2071,25,42,1463,2,3603,4.878.511.905
08/09/2018 05:00,50.96,31353,2141,21,40,1452,3,3657,4.878.511.905
08/09/2018 06:00,52.08,31891,2290,16,36,1442,5,3789,4.878.511.905
08/09/2018 07:00,53.47,33276,2481,12,31,1417,4,3945,4.878.511.905
08/09/2018 08:00,55.68,35116,2619,11,24,1481,2,4137,4.878.511.905
08/09/2018 09:00,55.46,36651,2758,11,21,1552,2,4344,4.878.511.905
08/09/2018 10:00,55.91,37547,2885,12,21,1578,3,4499,4.878.511.905
08/09/2018 11:00,55.51,37613,2972,14,24,1690,3,4703,4.878.511.905
08/09/2018 12:00,54.77,37429,2979,16,25,1803,4,4827,4.878.511.905
08/09/2018 13:00,54.43,37172,2952,16,26,1909,3,4906,4.878.511.905
08/09/2018 14:00,54.22,36951,3117,14,27,1921,4,5083,4.878.511.905
08/09/2018 15:00,54.24,36868,3214,12,32,1917,4,5179,4.878.511.905
08/09/2018 16:00,54.46,37065,3216,12,37,1874,3,5142,4.878.511.905
08/09/2018 17:00,55.63,37546,3022,11,40,1891,3,4967,4.878.511.905
08/09/2018 18:00,57.24,37795,2676,11,43,1924,3,4657,4.878.511.905
08/09/2018 19:00,57.47,37725,2281,11,45,1930,2,4269,4.878.511.905
08/09/2018 20:00,57.33,37472,2020,11,41,1864,2,3938,4.878.511.905
08/09/2018 21:00,56.79,36931,2018,12,42,1846,2,3920,4.878.511.905
08/09/2018 22:00,55.39,35693,2100,13,44,1796,2,3955,4.878.511.905
08/09/2018 23:00,53.65,34055,2129,22,42,1750,2,3945,4.878.511.905
09/09/2018 00:00,53.57,32555,1943,20,42,1661,1,3667,4.878.511.905
09/09/2018 01:00,51.22,31595,2122,17,39,1610,1,3789,4.878.511.905
09/09/2018 02:00,50.63,31080,2152,14,34,1575,1,3776,4.878.511.905
09/09/2018 03:00,50.6,30900,2184,12,30,1524,1,3751,4.878.511.905
09/09/2018 04:00,50.62,30889,2129,11,24,1489,2,3655,4.878.511.905
09/09/2018 05:00,50.48,31003,2063,9,21,1500,3,3596,4.878.511.905
09/09/2018 06:00,50.55,31107,1900,7,19,1540,2,3468,4.878.511.905
09/09/2018 07:00,51.82,31878,1699,4,15,1531,2,3251,4.878.511.905
09/09/2018 08:00,52.98,33429,1572,3,14,1562,2,3153,4.878.511.905
09/09/2018 09:00,54.2,34985,1488,3,12,1587,2,3092,4.878.511.905
09/09/2018 10:00,54.76,35891,1421,3,10,1612,2,3048,4.878.511.905
09/09/2018 11:00,54.71,36220,1442,4,12,1733,2,3193,4.878.511.905
09/09/2018 12:00,54.49,36174,1479,5,12,1788,2,3286,4.878.511.905
09/09/2018 13:00,54.21,36087,1439,7,14,1807,1,3268,4.878.511.905
09/09/2018 14:00,53.79,35970,1435,8,14,1778,1,3236,4.878.511.905
09/09/2018 15:00,52.98,35994,1391,8,15,1752,1,3167,4.878.511.905
09/09/2018 16:00,54.06,36248,1320,9,17,1765,1,3112,4.878.511.905
09/09/2018 17:00,55.65,36823,1246,10,17,1783,1,3057,4.878.511.905
09/09/2018 18:00,57.37,37476,1229,12,17,1848,1,3107,4.878.511.905
09/09/2018 19:00,57.77,37883,1184,12,18,1966,1,3181,4.878.511.905
09/09/2018 20:00,58.51,38046,1184,13,17,2031,1,3246,4.878.511.905
09/09/2018 21:00,57.73,37587,1317,14,20,2075,1,3427,4.878.511.905
09/09/2018 22:00,55.72,36098,1480,13,20,2102,1,3616,4.878.511.905
09/09/2018 23:00,53.05,34264,1573,40,11,2168,1,3793,4.878.511.905
10/09/2018 00:00,53.47,32365,1688,39,8,2156,1,3892,5.082.619.048
10/09/2018 01:00,50.9,31392,1826,36,10,2177,1,4050,5.082.619.048
10/09/2018 02:00,49.52,31098,1813,35,9,2185,1,4043,5.082.619.048
10/09/2018 03:00,48.06,31273,1810,34,9,2261,1,4115,5.082.619.048
10/09/2018 04:00,49.1,31884,1765,29,8,2366,1,4169,5.082.619.048
10/09/2018 05:00,54.01,33560,1747,24,7,2453,1,4232,5.082.619.048
10/09/2018 06:00,56.83,36833,1639,19,5,2546,1,4210,5.082.619.048
10/09/2018 07:00,58.64,40198,1500,15,4,2510,1,4030,5.082.619.048
10/09/2018 08:00,59.03,41841,1436,14,3,2577,1,4031,5.082.619.048
10/09/2018 09:00,58.87,42343,1473,12,2,2713,1,4201,5.082.619.048
10/09/2018 10:00,58.27,42617,1520,11,3,2824,1,4359,5.082.619.048
10/09/2018 11:00,57.86,42710,1667,10,3,2856,1,4537,5.082.619.048
10/09/2018 12:00,57.4,42646,1867,10,3,2915,1,4796,5.082.619.048
10/09/2018 13:00,56.74,42364,1996,12,5,2970,1,4984,5.082.619.048
10/09/2018 14:00,56.98,42224,2071,14,6,2870,1,4962,5.082.619.048
10/09/2018 15:00,56.76,41882,2063,15,7,2938,2,5025,5.082.619.048
10/09/2018 16:00,57.06,41578,1998,19,9,2906,1,4933,5.082.619.048
10/09/2018 17:00,57.32,41503,1765,26,12,2854,1,4658,5.082.619.048
10/09/2018 18:00,57.83,41432,1436,35,13,2774,2,4260,5.082.619.048
10/09/2018 19:00,57.96,41520,1142,43,15,2752,4,3956,5.082.619.048
10/09/2018 20:00,57.47,41260,1031,46,18,2649,6,3750,5.082.619.048
10/09/2018 21:00,56.73,40268,1012,49,27,2573,8,3669,5.082.619.048
10/09/2018 22:00,55.77,38165,1078,48,33,2582,8,3749,5.082.619.048
10/09/2018 23:00,54.19,35763,1147,8,30,2379,9,3573,5.082.619.048
11/09/2018 00:00,53.3,33509,1280,7,36,2280,10,3613,5.082.619.048
11/09/2018 01:00,51.62,32503,1244,7,44,2291,10,3596,5.082.619.048
11/09/2018 02:00,49.08,32188,1234,7,47,2271,10,3569,5.082.619.048
11/09/2018 03:00,47.52,32164,1289,6,48,2152,9,3504,5.082.619.048
11/09/2018 04:00,48.31,32650,1301,6,46,2092,10,3455,5.082.619.048
11/09/2018 05:00,52.56,34321,1316,6,37,2164,10,3533,5.082.619.048
11/09/2018 06:00,56.06,37588,1433,6,33,2143,10,3625,5.082.619.048
11/09/2018 07:00,57.55,40952,1677,6,30,2125,6,3844,5.082.619.048
11/09/2018 08:00,57.73,42427,1996,7,28,2106,8,4145,5.082.619.048
11/09/2018 09:00,57.53,42816,2488,8,28,2154,7,4685,5.082.619.048
11/09/2018 10:00,56.42,43106,2976,10,35,2348,5,5374,5.082.619.048
11/09/2018 11:00,55.59,42971,3336,11,55,2568,7,5977,5.082.619.048
11/09/2018 12:00,55.28,42910,3611,12,68,2781,11,6483,5.082.619.048
11/09/2018 13:00,54.45,42875,3776,11,83,2923,12,6805,5.082.619.048
11/09/2018 14:00,54.02,42750,3837,11,102,3266,11,7227,5.082.619.048
11/09/2018 15:00,54.02,42443,3810,11,117,3480,9,7427,5.082.619.048
11/09/2018 16:00,54.48,42213,3840,13,135,3593,14,7595,5.082.619.048
11/09/2018 17:00,54.76,42091,3755,17,156,3578,24,7530,5.082.619.048
11/09/2018 18:00,55.02,41910,3488,26,181,3602,25,7322,5.082.619.048
11/09/2018 19:00,55.38,42001,2853,36,206,3526,22,6643,5.082.619.048
11/09/2018 20:00,55.4,41614,2344,45,227,3423,27,6066,5.082.619.048
11/09/2018 21:00,55.06,40553,2117,52,244,3355,31,5799,5.082.619.048
11/09/2018 22:00,53.94,38497,1960,57,255,3326,35,5633,5.082.619.048
11/09/2018 23:00,50.99,36096,1829,60,0,3232,35,5156,5.082.619.048
12/09/2018 00:00,48.97,34069,2219,61,0,3203,34,5517,5.082.619.048
12/09/2018 01:00,48.19,32942,2069,58,0,3190,32,5349,5.082.619.048
12/09/2018 02:00,47.23,32583,2029,57,0,3185,32,5303,5.082.619.048
12/09/2018 03:00,48.16,32552,2136,60,0,3173,30,5399,5.082.619.048
12/09/2018 04:00,48.52,32973,2237,64,0,3179,29,5509,5.082.619.048
12/09/2018 05:00,51.85,34581,2302,63,0,3247,28,5640,5.082.619.048
12/09/2018 06:00,54.33,37757,2380,62,0,3344,29,5815,5.082.619.048
12/09/2018 07:00,55.73,41080,2434,62,0,3349,29,5874,5.082.619.048
12/09/2018 08:00,55.74,42481,2467,65,0,3503,30,6065,5.082.619.048
12/09/2018 09:00,55.58,42718,2524,68,0,3594,29,6215,5.082.619.048
12/09/2018 10:00,55.41,42971,2603,77,0,3649,28,6357,5.082.619.048
12/09/2018 11:00,55.06,42935,2742,90,0,3716,27,6575,5.082.619.048
12/09/2018 12:00,54.85,42670,2969,97,0,3852,27,6945,5.082.619.048
12/09/2018 13:00,54.37,42362,3120,96,0,3886,28,7130,5.082.619.048
12/09/2018 14:00,54.28,42170,3202,98,0,3908,29,7237,5.082.619.048
12/09/2018 15:00,54.32,41957,3171,101,0,4048,32,7352,5.082.619.048
12/09/2018 16:00,54.29,41745,3156,100,0,4202,32,7490,5.082.619.048
12/09/2018 17:00,54.8,41805,3075,109,0,4245,32,7461,5.082.619.048
12/09/2018 18:00,55.08,41791,2859,125,0,4221,31,7236,5.082.619.048
12/09/2018 19:00,55.38,41680,2453,146,0,4292,30,6921,5.082.619.048
12/09/2018 20:00,54.99,41434,2187,170,0,4336,28,6721,5.082.619.048
12/09/2018 21:00,54.4,40459,2043,189,0,4394,30,6656,5.082.619.048
12/09/2018 22:00,52.25,38497,1916,203,0,4389,30,6538,5.082.619.048
12/09/2018 23:00,49.92,36170,1738,232,263,4402,35,6670,5.082.619.048
13/09/2018 00:00,50.58,34115,1532,235,243,4261,32,6303,5.082.619.048
13/09/2018 01:00,50.56,33049,1335,239,219,4179,29,6001,5.082.619.048
13/09/2018 02:00,50.53,32663,1164,241,198,4030,27,5660,5.082.619.048
13/09/2018 03:00,51.02,32671,1069,239,178,3866,23,5375,5.082.619.048
13/09/2018 04:00,51.96,33250,969,235,161,3592,23,4980,5.082.619.048
13/09/2018 05:00,53.39,34941,913,231,141,3355,19,4659,5.082.619.048
13/09/2018 06:00,54.98,38030,888,228,121,3100,14,4351,5.082.619.048
13/09/2018 07:00,56.44,41187,859,229,121,2797,15,4021,5.082.619.048
13/09/2018 08:00,57.82,42837,846,234,125,2596,17,3818,5.082.619.048
13/09/2018 09:00,58.01,43080,945,238,160,2449,14,3806,5.082.619.048
13/09/2018 10:00,57.86,43026,1096,238,164,2386,14,3898,5.082.619.048
13/09/2018 11:00,57.59,42883,1261,237,157,2334,14,4003,5.082.619.048
13/09/2018 12:00,57.99,42513,1409,234,150,2221,14,4028,5.082.619.048
13/09/2018 13:00,57.04,42167,1468,229,136,2096,14,3943,5.082.619.048
13/09/2018 14:00,56.48,42036,1510,227,117,2057,12,3923,5.082.619.048
13/09/2018 15:00,56.29,41974,1478,225,99,2022,11,3835,5.082.619.048
13/09/2018 16:00,56.18,41765,1403,224,82,1977,11,3697,5.082.619.048
13/09/2018 17:00,56.44,41757,1332,225,67,1909,11,3544,5.082.619.048
13/09/2018 18:00,56.79,41753,1274,226,60,1911,8,3479,5.082.619.048
13/09/2018 19:00,57.35,41832,1180,226,57,2004,5,3472,5.082.619.048
13/09/2018 20:00,56.48,41478,1159,226,57,2193,6,3641,5.082.619.048
13/09/2018 21:00,55.92,40518,1180,224,57,2349,7,3817,5.082.619.048
13/09/2018 22:00,54.7,38572,1294,222,55,2469,7,4047,5.082.619.048
13/09/2018 23:00,53.13,36168,1342,230,36,2528,6,4142,5.082.619.048
14/09/2018 00:00,53.17,34134,1612,227,36,2606,6,4487,5.082.619.048
14/09/2018 01:00,52.25,33154,1646,224,35,2610,7,4522,5.082.619.048
14/09/2018 02:00,51.84,32837,1591,220,34,2509,6,4360,5.082.619.048
14/09/2018 03:00,51.05,32824,1595,215,34,2449,5,4298,5.082.619.048
14/09/2018 04:00,51.46,33269,1528,209,32,2391,6,4166,5.082.619.048
14/09/2018 05:00,53.58,35039,1456,205,28,2308,5,4002,5.082.619.048
14/09/2018 06:00,56.15,38262,1358,198,22,2222,6,3806,5.082.619.048
14/09/2018 07:00,57.44,41645,1302,193,23,1999,6,3523,5.082.619.048
14/09/2018 08:00,58.09,43117,1260,194,24,1844,8,3330,5.082.619.048
14/09/2018 09:00,58.42,43322,1327,197,32,1748,12,3316,5.082.619.048
14/09/2018 10:00,58.04,43446,1438,197,40,1769,20,3464,5.082.619.048
14/09/2018 11:00,57.62,43195,1599,191,53,1855,28,3726,5.082.619.048
14/09/2018 12:00,57.49,42599,1759,181,59,1999,14,4012,5.082.619.048
14/09/2018 13:00,55.3,41992,1837,169,60,2073,12,4151,5.082.619.048
14/09/2018 14:00,55.02,41499,1962,154,57,2010,13,4196,5.082.619.048
14/09/2018 15:00,54.43,40925,1998,135,54,2042,13,4242,5.082.619.048
14/09/2018 16:00,54.69,40666,1968,115,48,2022,10,4163,5.082.619.048
14/09/2018 17:00,55.29,40709,1971,100,36,2045,8,4160,5.082.619.048
14/09/2018 18:00,56.15,40682,1980,89,36,2041,6,4152,5.082.619.048
14/09/2018 19:00,56.04,40647,1909,84,37,2233,7,4270,5.082.619.048
14/09/2018 20:00,55.14,40137,1924,82,39,2482,8,4535,5.082.619.048
14/09/2018 21:00,53.9,39093,2139,81,39,2673,9,4941,5.082.619.048
14/09/2018 22:00,52.53,37435,2402,77,39,2807,8,5333,5.082.619.048
14/09/2018 23:00,50.19,35274,2462,42,28,3100,10,5642,5.082.619.048
15/09/2018 00:00,50.07,33203,1850,39,35,3139,10,5073,5.082.619.048
15/09/2018 01:00,48.88,32252,1683,39,45,3119,9,4895,5.082.619.048
15/09/2018 02:00,46.31,31825,1566,39,64,3029,8,4706,5.082.619.048
15/09/2018 03:00,44.89,31651,1443,36,77,2918,9,4483,5.082.619.048
15/09/2018 04:00,44.72,31669,1382,33,83,2856,10,4364,5.082.619.048
15/09/2018 05:00,45.12,32012,1387,31,76,2738,11,4243,5.082.619.048
15/09/2018 06:00,47.31,32598,1337,27,69,2518,13,3964,5.082.619.048
15/09/2018 07:00,48.85,33923,1264,20,67,2408,10,3769,5.082.619.048
15/09/2018 08:00,50.75,35854,1245,16,60,2244,9,3574,5.082.619.048
15/09/2018 09:00,51.54,37432,1306,14,55,2205,9,3589,5.082.619.048
15/09/2018 10:00,50.71,38241,1422,15,61,2389,15,3902,5.082.619.048
15/09/2018 11:00,49.78,38132,1538,16,84,2511,14,4163,5.082.619.048
15/09/2018 12:00,48.78,37716,1651,17,113,2738,16,4535,5.082.619.048
15/09/2018 13:00,48.01,37289,1741,16,137,2946,25,4865,5.082.619.048
15/09/2018 14:00,47.7,37019,1723,16,150,3016,15,4920,5.082.619.048
15/09/2018 15:00,47.83,36991,1589,15,160,3085,22,4871,5.082.619.048
15/09/2018 16:00,48.04,37322,1464,14,159,3133,20,4790,5.082.619.048
15/09/2018 17:00,49.96,37973,1378,15,159,3123,10,4685,5.082.619.048
15/09/2018 18:00,52.27,38513,1314,17,163,3075,12,4581,5.082.619.048
15/09/2018 19:00,52.47,38632,1136,18,168,3050,13,4385,5.082.619.048
15/09/2018 20:00,52.34,38298,1064,18,170,3191,15,4458,5.082.619.048
15/09/2018 21:00,51.84,37470,978,17,170,3110,15,4290,5.082.619.048
15/09/2018 22:00,50.77,36190,858,18,163,3090,16,4145,5.082.619.048
15/09/2018 23:00,49.35,34573,738,10,148,2924,13,3833,5.082.619.048
16/09/2018 00:00,51.38,33249,640,10,128,2872,13,3663,5.082.619.048
16/09/2018 01:00,50,32252,590,11,120,2861,12,3594,5.082.619.048
16/09/2018 02:00,46.71,31779,551,10,123,2764,11,3459,5.082.619.048
16/09/2018 03:00,44.4,31585,523,10,127,2836,11,3507,5.082.619.048
16/09/2018 04:00,44.64,31655,486,10,132,2808,13,3449,5.082.619.048
16/09/2018 05:00,44.6,31858,463,9,134,2719,13,3338,5.082.619.048
16/09/2018 06:00,44.86,31919,533,9,134,2570,13,3259,5.082.619.048
16/09/2018 07:00,45.59,32731,656,9,129,2421,13,3228,5.082.619.048
16/09/2018 08:00,47.97,34393,802,8,132,2289,16,3247,5.082.619.048
16/09/2018 09:00,50.47,36018,1075,8,144,2155,17,3399,5.082.619.048
16/09/2018 10:00,50.57,36871,1404,8,158,2075,14,3659,5.082.619.048
16/09/2018 11:00,49.97,37141,1751,9,164,2081,13,4018,5.082.619.048
16/09/2018 12:00,49.82,37055,2185,9,170,2054,12,4430,5.082.619.048
16/09/2018 13:00,48.43,36859,2548,10,166,2043,13,4780,5.082.619.048
16/09/2018 14:00,46.19,36723,2804,10,149,1988,12,4963,5.082.619.048
16/09/2018 15:00,46.42,36576,2878,9,132,1984,11,5014,5.082.619.048
16/09/2018 16:00,49.09,36858,2931,10,112,2040,11,5104,5.082.619.048
16/09/2018 17:00,50.89,37552,2919,13,86,2129,11,5158,5.082.619.048
16/09/2018 18:00,52.41,38417,2895,16,69,2301,11,5292,5.082.619.048
16/09/2018 19:00,52.81,39011,2739,16,66,2544,11,5376,5.082.619.048
16/09/2018 20:00,52.7,38980,2627,15,76,2727,11,5456,5.082.619.048
16/09/2018 21:00,51.43,38222,2684,14,89,2905,10,5702,5.082.619.048
16/09/2018 22:00,49.9,36720,2764,14,98,3080,10,5966,5.082.619.048
16/09/2018 23:00,48.58,34917,2669,67,98,3225,12,6071,5.082.619.048
17/09/2018 00:00,45.02,33741,2356,67,115,3197,11,5746,532.672.619
17/09/2018 01:00,43.71,32860,2186,63,130,3223,11,5613,532.672.619
17/09/2018 02:00,43.72,32410,2007,60,144,3121,11,5343,532.672.619
17/09/2018 03:00,42.92,32470,1764,57,154,3044,11,5030,532.672.619
17/09/2018 04:00,43.74,33008,1545,55,170,2937,12,4719,532.672.619
17/09/2018 05:00,49.93,34822,1306,54,190,2829,15,4394,532.672.619
17/09/2018 06:00,53.96,38104,1126,54,211,2682,19,4092,532.672.619
17/09/2018 07:00,56.95,41390,965,57,227,2588,26,3863,532.672.619
17/09/2018 08:00,57.18,42682,886,67,233,2658,29,3873,532.672.619
17/09/2018 09:00,56.96,43102,822,80,241,2639,33,3815,532.672.619
17/09/2018 10:00,56.15,43313,756,85,253,2591,32,3717,532.672.619
17/09/2018 11:00,54.7,43154,739,90,265,2605,36,3735,532.672.619
17/09/2018 12:00,54.38,42898,759,98,275,2536,34,3702,532.672.619
17/09/2018 13:00,53.15,42595,734,100,276,2330,35,3475,532.672.619
17/09/2018 14:00,52.99,42370,648,103,275,2239,34,3299,532.672.619
17/09/2018 15:00,54.26,42181,504,108,269,2218,33,3132,532.672.619
17/09/2018 16:00,55.2,41941,379,100,260,2051,26,2816,532.672.619
17/09/2018 17:00,55.08,42093,314,94,243,1980,21,2652,532.672.619
17/09/2018 18:00,55.75,42146,285,91,229,1941,17,2563,532.672.619
17/09/2018 19:00,56.97,42370,289,87,213,2010,15,2614,532.672.619
17/09/2018 20:00,55.01,42021,345,84,196,2079,14,2718,532.672.619
17/09/2018 21:00,54.23,40921,457,82,178,2068,12,2797,532.672.619
17/09/2018 22:00,51.69,38830,582,80,157,2036,11,2866,532.672.619
17/09/2018 23:00,48.91,36566,698,86,125,2031,12,2952,532.672.619
18/09/2018 00:00,47.82,34546,0,84,107,1980,11,2182,532.672.619
18/09/2018 01:00,47.28,33505,0,82,90,2045,10,2227,532.672.619
18/09/2018 02:00,45.08,33147,0,85,77,2093,10,2265,532.672.619
18/09/2018 03:00,44.29,33076,0,95,65,2165,10,2335,532.672.619
18/09/2018 04:00,44.74,33487,0,117,58,2180,10,2365,532.672.619
18/09/2018 05:00,47.27,35128,0,139,55,2121,11,2326,532.672.619
18/09/2018 06:00,51.14,38316,0,160,54,2071,11,2296,532.672.619
18/09/2018 07:00,55.6,41549,0,180,47,1894,11,2132,532.672.619
18/09/2018 08:00,55.49,42819,0,195,46,1730,11,1982,532.672.619
18/09/2018 09:00,55.87,43003,0,204,45,1698,11,1958,532.672.619
18/09/2018 10:00,55.19,43104,0,213,53,1754,11,2031,532.672.619
18/09/2018 11:00,53.52,42859,0,220,59,1860,12,2151,532.672.619
18/09/2018 12:00,52.4,42430,0,221,67,2021,13,2322,532.672.619
18/09/2018 13:00,51,42173,653,218,69,2120,13,3073,532.672.619
18/09/2018 14:00,50.48,41919,3032,212,64,2169,12,5489,532.672.619
18/09/2018 15:00,49.59,41540,3331,203,55,2220,12,5821,532.672.619
18/09/2018 16:00,49.96,41348,3564,195,47,2337,12,6155,532.672.619
18/09/2018 17:00,50.87,41581,3645,180,57,2516,12,6410,532.672.619
18/09/2018 18:00,50.96,41602,3531,162,69,2672,13,6447,532.672.619
18/09/2018 19:00,51.13,41792,3286,149,89,2842,14,6380,532.672.619
18/09/2018 20:00,50.13,41478,3106,132,116,2963,14,6331,532.672.619
18/09/2018 21:00,48.94,40408,3023,118,144,2982,14,6281,532.672.619
18/09/2018 22:00,46.15,38382,2931,102,161,2991,15,6200,532.672.619
18/09/2018 23:00,44.41,36018,2760,96,193,3045,18,6112,532.672.619
19/09/2018 00:00,43.94,33545,2510,82,197,3095,18,5902,532.672.619
19/09/2018 01:00,43.04,32567,2316,70,194,3037,18,5635,532.672.619
19/09/2018 02:00,43.06,32310,2169,60,186,3162,20,5597,532.672.619
19/09/2018 03:00,43.4,32344,2047,50,177,3173,19,5466,532.672.619
19/09/2018 04:00,43.9,32926,1966,44,166,3135,20,5331,532.672.619
19/09/2018 05:00,45.2,34682,1832,47,156,3029,22,5086,532.672.619
19/09/2018 06:00,50.08,37798,1761,48,144,2915,21,4889,532.672.619
19/09/2018 07:00,52.12,41125,1781,48,118,2749,18,4714,532.672.619
19/09/2018 08:00,52.57,42613,1844,50,106,2632,15,4647,532.672.619
19/09/2018 09:00,52.1,42648,2179,55,104,2523,19,4880,532.672.619
19/09/2018 10:00,51.08,42757,2563,59,112,2543,19,5296,532.672.619
19/09/2018 11:00,49.87,42639,2852,60,127,2622,15,5676,532.672.619
19/09/2018 12:00,49.3,42188,3001,63,143,2672,11,5890,532.672.619
19/09/2018 13:00,47.97,41891,3009,68,151,2713,14,5955,532.672.619
19/09/2018 14:00,47.48,41724,3066,73,139,2648,17,5943,532.672.619
19/09/2018 15:00,47.51,41458,3087,77,127,2671,13,5975,532.672.619
19/09/2018 16:00,48.71,41322,3074,83,119,2618,11,5905,532.672.619
19/09/2018 17:00,49.81,41490,3064,83,107,2728,11,5993,532.672.619
19/09/2018 18:00,49.77,41649,3102,84,93,2896,12,6187,532.672.619
19/09/2018 19:00,49.88,41762,3078,83,85,3172,14,6432,532.672.619
19/09/2018 20:00,48.06,41352,3105,84,86,3448,14,6737,532.672.619
19/09/2018 21:00,45.82,40202,3369,87,89,3693,15,7253,532.672.619
19/09/2018 22:00,43.1,38143,3601,86,89,3975,11,7762,532.672.619
19/09/2018 23:00,39.04,35744,3621,128,73,4364,12,8198,532.672.619
20/09/2018 00:00,39.92,33447,3533,134,76,4626,12,8381,532.672.619
20/09/2018 01:00,35.99,32224,3131,141,75,4783,11,8141,532.672.619
20/09/2018 02:00,33.37,31907,2772,145,74,4872,9,7872,532.672.619
20/09/2018 03:00,35.38,31885,2472,147,79,4928,9,7635,532.672.619
20/09/2018 04:00,36.25,32448,2243,151,94,4943,11,7442,532.672.619
20/09/2018 05:00,42.95,34310,2115,151,111,4873,11,7261,532.672.619
20/09/2018 06:00,45.81,37604,2058,148,130,4841,15,7192,532.672.619
20/09/2018 07:00,47.8,40904,2046,135,131,4816,16,7144,532.672.619
20/09/2018 08:00,48.32,42510,2041,134,113,4840,18,7146,532.672.619
20/09/2018 09:00,46.99,42752,2377,130,109,4908,18,7542,532.672.619
20/09/2018 10:00,46.07,42646,2808,130,106,4939,15,7998,532.672.619
20/09/2018 11:00,45.74,42538,2965,134,104,4868,12,8083,532.672.619
20/09/2018 12:00,45.28,42328,2734,139,99,4775,13,7760,532.672.619
20/09/2018 13:00,44.94,42116,2341,141,88,4642,13,7225,532.672.619
20/09/2018 14:00,44.76,42078,2102,139,70,4439,14,6764,532.672.619
20/09/2018 15:00,45.05,41856,1862,143,57,4473,13,6548,532.672.619
20/09/2018 16:00,45.53,41820,1559,142,51,4391,12,6155,532.672.619
20/09/2018 17:00,46.43,41937,1260,142,50,4219,11,5682,532.672.619
20/09/2018 18:00,46.58,42018,892,147,52,4031,10,5132,532.672.619
20/09/2018 19:00,48.07,42179,644,144,55,3838,11,4692,532.672.619
20/09/2018 20:00,46.95,41524,584,141,61,3834,12,4632,532.672.619
20/09/2018 21:00,46.98,40379,772,138,70,3652,12,4644,532.672.619
20/09/2018 22:00,44.45,38435,1210,127,77,3590,20,5024,532.672.619
20/09/2018 23:00,43.01,35827,1571,113,0,3600,16,5300,532.672.619
21/09/2018 00:00,40.02,33861,2360,109,0,3562,16,6047,532.672.619
21/09/2018 01:00,34.05,32928,2946,110,0,3536,14,6606,532.672.619
21/09/2018 02:00,25.53,32516,3122,112,0,3570,12,6816,532.672.619
21/09/2018 03:00,25.73,32497,3195,111,0,3655,12,6973,532.672.619
21/09/2018 04:00,26.31,32893,3249,113,0,3695,12,7069,532.672.619
21/09/2018 05:00,33.62,34719,3323,124,0,3645,12,7104,532.672.619
21/09/2018 06:00,42.62,37981,3532,141,0,3577,13,7263,532.672.619
21/09/2018 07:00,46.93,41264,3658,152,0,3452,14,7276,532.672.619
21/09/2018 08:00,47.75,42658,3652,165,0,3393,11,7221,532.672.619
21/09/2018 09:00,46.61,42886,3808,173,0,3515,12,7508,532.672.619
21/09/2018 10:00,44.9,43159,4027,177,0,3613,14,7831,532.672.619
21/09/2018 11:00,44.53,42900,4183,176,0,3774,21,8154,532.672.619
21/09/2018 12:00,43.6,42307,4147,173,0,4017,25,8362,532.672.619
21/09/2018 13:00,41.18,41757,3938,169,0,4171,28,8306,532.672.619
21/09/2018 14:00,39.76,41231,3861,165,0,4420,28,8474,532.672.619
21/09/2018 15:00,37.65,40722,3777,157,0,4653,28,8615,532.672.619
21/09/2018 16:00,38.7,40496,3585,149,0,4862,27,8623,532.672.619
21/09/2018 17:00,40.1,40623,3543,148,0,4944,25,8660,532.672.619
21/09/2018 18:00,43.51,40798,3690,148,0,5010,28,8876,532.672.619
21/09/2018 19:00,43.67,40817,3796,149,0,5095,30,9070,532.672.619
21/09/2018 20:00,38.13,40064,3813,146,0,5197,31,9187,532.672.619
21/09/2018 21:00,34.87,38817,3969,142,0,5239,32,9382,532.672.619
21/09/2018 22:00,23.48,37095,4146,131,0,5305,25,9607,532.672.619
21/09/2018 23:00,3.27,34849,4214,97,343,5235,25,9914,532.672.619
22/09/2018 00:00,3.98,32726,4207,92,292,5297,27,9915,532.672.619
22/09/2018 01:00,3.06,31945,4175,91,249,5340,21,9876,532.672.619
22/09/2018 02:00,2.42,31707,4069,97,238,5320,14,9738,532.672.619
22/09/2018 03:00,2.33,31761,4058,105,250,5336,21,9770,532.672.619
22/09/2018 04:00,2.82,31891,3968,113,279,5341,33,9734,532.672.619
22/09/2018 05:00,3.52,32418,3839,123,312,5323,35,9632,532.672.619
22/09/2018 06:00,16.43,33052,3786,133,329,5219,35,9502,532.672.619
22/09/2018 07:00,23.53,34378,3708,143,349,5110,37,9347,532.672.619
22/09/2018 08:00,32.03,36290,3531,154,367,5149,38,9239,532.672.619
22/09/2018 09:00,31.64,37917,3644,160,381,5305,38,9528,532.672.619
22/09/2018 10:00,31.51,38673,3904,172,383,5388,36,9883,532.672.619
22/09/2018 11:00,29.84,38626,4077,178,380,5458,32,10125,532.672.619
22/09/2018 12:00,25.6,38355,4200,184,377,5422,37,10220,532.672.619
22/09/2018 13:00,18.51,37856,4258,179,360,5443,36,10276,532.672.619
22/09/2018 14:00,16.54,37390,4354,161,330,5403,35,10283,532.672.619
22/09/2018 15:00,17.24,37300,4406,138,296,5357,34,10231,532.672.619
22/09/2018 16:00,23.89,37481,4362,121,271,5297,33,10084,532.672.619
22/09/2018 17:00,31.54,38149,4330,98,267,5243,35,9973,532.672.619
22/09/2018 18:00,35.5,38900,4343,86,270,5176,35,9910,532.672.619
22/09/2018 19:00,35.91,39240,4153,80,273,5037,32,9575,532.672.619
22/09/2018 20:00,35.48,38673,3967,80,270,5035,28,9380,532.672.619
22/09/2018 21:00,31.96,37555,3937,79,271,4973,30,9290,532.672.619
22/09/2018 22:00,25.94,36262,3933,76,277,4866,26,9178,532.672.619
22/09/2018 23:00,21.04,34703,3897,55,333,4932,29,9246,532.672.619
23/09/2018 00:00,22.09,33364,3483,48,340,4847,25,8743,532.672.619
23/09/2018 01:00,12.97,32582,3395,45,331,4750,29,8550,532.672.619
23/09/2018 02:00,10.03,32205,3260,47,339,4648,27,8321,532.672.619
23/09/2018 03:00,17,32089,3171,52,346,4616,29,8214,532.672.619
23/09/2018 04:00,22.8,32179,3000,56,351,4533,27,7967,532.672.619
23/09/2018 05:00,30.84,32471,2830,59,349,4423,29,7690,532.672.619
23/09/2018 06:00,34.94,32651,2716,57,341,4296,28,7438,532.672.619
23/09/2018 07:00,36.1,33418,2589,56,344,4192,29,7210,532.672.619
23/09/2018 08:00,40.06,35025,2467,62,362,4079,25,6995,532.672.619
23/09/2018 09:00,40.74,36669,2528,71,375,4014,27,7015,532.672.619
23/09/2018 10:00,41.54,37491,2681,77,379,3984,28,7149,532.672.619
23/09/2018 11:00,41.56,37738,2767,87,382,3937,28,7201,532.672.619
23/09/2018 12:00,40.88,37600,2829,92,387,3868,27,7203,532.672.619
23/09/2018 13:00,40.78,37271,2844,92,379,3850,29,7194,532.672.619
23/09/2018 14:00,40.73,37152,2887,90,353,3768,29,7127,532.672.619
23/09/2018 15:00,40.26,37095,2831,87,323,3714,27,6982,532.672.619
23/09/2018 16:00,40.01,37392,2811,87,279,3543,22,6742,532.672.619
23/09/2018 17:00,40.57,38292,2913,88,232,3407,22,6662,532.672.619
23/09/2018 18:00,42.82,39462,2950,90,183,3302,16,6541,532.672.619
23/09/2018 19:00,43.58,40208,2992,89,144,3278,16,6519,532.672.619
23/09/2018 20:00,43.03,39980,3047,86,111,3391,11,6646,532.672.619
23/09/2018 21:00,40.34,39297,3235,85,90,3471,11,6892,532.672.619
23/09/2018 22:00,37.38,37758,3420,83,72,3543,12,7130,532.672.619
23/09/2018 23:00,30.61,35901,3593,146,37,3545,4,7325,532.672.619
24/09/2018 00:00,25.53,34447,3688,124,29,3637,4,7482,553.172.619
24/09/2018 01:00,18.13,33746,3738,98,26,3722,5,7589,553.172.619
24/09/2018 02:00,3.97,33492,3770,79,23,3774,4,7650,553.172.619
24/09/2018 03:00,4.4,33719,3772,66,22,3840,4,7704,553.172.619
24/09/2018 04:00,19.67,34445,3697,63,27,3869,4,7660,553.172.619
24/09/2018 05:00,37.03,36385,3652,70,38,3921,4,7685,553.172.619
24/09/2018 06:00,41.96,39914,3661,84,59,3878,5,7687,553.172.619
24/09/2018 07:00,46.23,43369,3635,96,73,3832,6,7642,553.172.619
24/09/2018 08:00,48.03,44693,3474,107,89,3867,4,7541,553.172.619
24/09/2018 09:00,45.5,44790,3509,116,100,3887,6,7618,553.172.619
24/09/2018 10:00,44.05,44923,3686,125,138,3912,18,7879,553.172.619
24/09/2018 11:00,42.97,44759,3796,131,204,3991,23,8145,553.172.619
24/09/2018 12:00,42.56,44361,3739,141,264,4142,23,8309,553.172.619
24/09/2018 13:00,41.58,44007,3721,149,297,4149,23,8339,553.172.619
24/09/2018 14:00,40.68,43661,3800,164,313,4192,23,8492,553.172.619
24/09/2018 15:00,40.41,43379,3957,181,320,4229,23,8710,553.172.619
24/09/2018 16:00,41.63,43233,4031,197,318,4193,19,8758,553.172.619
24/09/2018 17:00,44.67,43485,3960,209,309,4032,23,8533,553.172.619
24/09/2018 18:00,46.16,43777,3791,221,304,3901,33,8250,553.172.619
24/09/2018 19:00,47.25,44151,3371,230,290,3745,27,7663,553.172.619
24/09/2018 20:00,46.74,43578,3155,238,271,3700,33,7397,553.172.619
24/09/2018 21:00,43.65,42336,3098,241,252,3608,31,7230,553.172.619
24/09/2018 22:00,40.52,40176,2908,239,238,3478,31,6894,553.172.619
24/09/2018 23:00,39.25,37841,2571,29,217,3336,28,6181,553.172.619
25/09/2018 00:00,37.79,35975,2394,21,215,3220,30,5880,553.172.619
25/09/2018 01:00,38.01,35012,2045,17,216,3066,27,5371,553.172.619
25/09/2018 02:00,38.26,34750,1791,19,223,2999,28,5060,553.172.619
25/09/2018 03:00,38.78,34788,1637,23,233,2964,31,4888,553.172.619
25/09/2018 04:00,39.27,35322,1511,20,239,2853,31,4654,553.172.619
25/09/2018 05:00,40.57,37130,1344,18,235,2763,33,4393,553.172.619
25/09/2018 06:00,46.96,40538,1239,19,232,2716,31,4237,553.172.619
25/09/2018 07:00,49.21,43608,1108,20,238,2531,31,3928,553.172.619
25/09/2018 08:00,49.83,44733,944,25,260,2397,31,3657,553.172.619
25/09/2018 09:00,49.88,44858,870,32,283,2423,34,3642,553.172.619
25/09/2018 10:00,49.47,44884,905,42,296,2542,29,3814,553.172.619
25/09/2018 11:00,48.93,44494,977,51,307,2922,31,4288,553.172.619
25/09/2018 12:00,48.04,43876,1114,61,318,3268,35,4796,553.172.619
25/09/2018 13:00,46.19,43379,1250,73,318,3494,35,5170,553.172.619
25/09/2018 14:00,45.03,43030,1360,94,293,3681,34,5462,553.172.619
25/09/2018 15:00,45.21,42679,1588,107,264,3803,29,5791,553.172.619
25/09/2018 16:00,45.72,42551,1744,132,227,3917,23,6043,553.172.619
25/09/2018 17:00,44.97,42833,1784,142,195,3990,19,6130,553.172.619
25/09/2018 18:00,45.13,43110,1850,154,181,4028,17,6230,553.172.619
25/09/2018 19:00,45.24,43549,1953,157,168,4142,19,6439,553.172.619
25/09/2018 20:00,42.41,42920,2186,155,157,4370,20,6888,553.172.619
25/09/2018 21:00,39.81,41670,2508,151,154,4433,20,7266,553.172.619
25/09/2018 22:00,37.56,39544,2857,148,157,4628,19,7809,553.172.619
25/09/2018 23:00,34.23,37421,3154,140,177,4684,22,8177,553.172.619
26/09/2018 00:00,25.32,35590,3373,138,204,4821,22,8558,553.172.619
26/09/2018 01:00,16.26,34556,3692,144,228,4931,24,9019,553.172.619
26/09/2018 02:00,10.09,34234,3957,148,254,5102,28,9489,553.172.619
26/09/2018 03:00,6.28,34221,4184,154,277,5249,28,9892,553.172.619
26/09/2018 04:00,3.88,34802,4251,162,305,5428,34,10180,553.172.619
26/09/2018 05:00,19.04,36573,4230,174,334,5596,38,10372,553.172.619
26/09/2018 06:00,35.62,39822,4259,178,360,5686,40,10523,553.172.619
26/09/2018 07:00,38.78,43111,4206,190,391,5637,42,10466,553.172.619
26/09/2018 08:00,38.97,44439,3979,200,420,5624,42,10265,553.172.619
26/09/2018 09:00,38.55,44517,3978,193,447,5655,43,10316,553.172.619
26/09/2018 10:00,38.12,44600,4135,186,467,5668,43,10499,553.172.619
26/09/2018 11:00,37.17,44604,4269,180,476,5694,43,10662,553.172.619
26/09/2018 12:00,34.05,44261,4350,180,482,5683,43,10738,553.172.619
26/09/2018 13:00,31.85,43891,4408,184,486,5690,43,10811,553.172.619
26/09/2018 14:00,30.56,43548,4484,188,489,5627,43,10831,553.172.619
26/09/2018 15:00,33.69,43403,4650,183,491,5551,43,10918,553.172.619
26/09/2018 16:00,36.2,43284,4680,166,493,5451,43,10833,553.172.619
26/09/2018 17:00,37.47,43440,4606,152,493,5459,43,10753,553.172.619
26/09/2018 18:00,38.42,43756,4549,142,493,5433,43,10660,553.172.619
26/09/2018 19:00,38.96,43783,4277,135,494,5504,43,10453,553.172.619
26/09/2018 20:00,37.76,42835,4136,132,492,5519,43,10322,553.172.619
26/09/2018 21:00,34.99,41422,4115,130,488,5502,42,10277,553.172.619
26/09/2018 22:00,29.79,39395,4039,124,487,5477,42,10169,553.172.619
26/09/2018 23:00,20.99,37050,3777,138,485,5510,35,9945,553.172.619
27/09/2018 00:00,18.67,35264,2722,139,479,5454,33,8827,553.172.619
27/09/2018 01:00,14.49,34215,2522,146,470,5378,34,8550,553.172.619
27/09/2018 02:00,17.98,33872,2344,153,455,5286,32,8270,553.172.619
27/09/2018 03:00,22.54,33975,2190,161,439,5177,34,8001,553.172.619
27/09/2018 04:00,17.46,34577,2052,172,422,5011,34,7691,553.172.619
27/09/2018 05:00,29.43,36482,2026,184,401,4756,33,7400,553.172.619
27/09/2018 06:00,39.7,39853,2226,196,380,4431,34,7267,553.172.619
27/09/2018 07:00,44.17,43254,2473,209,370,4029,32,7113,553.172.619
27/09/2018 08:00,44.42,45039,2698,223,388,3633,32,6974,553.172.619
27/09/2018 09:00,42.97,45432,3154,232,405,3293,30,7114,553.172.619
27/09/2018 10:00,42.74,45316,3603,239,409,3175,28,7454,553.172.619
27/09/2018 11:00,41.39,44937,3937,242,410,3039,28,7656,553.172.619
27/09/2018 12:00,40.47,44341,4180,242,397,2939,26,7784,553.172.619
27/09/2018 13:00,39.29,44250,4305,242,381,2893,26,7847,553.172.619
27/09/2018 14:00,38.7,44043,4411,242,344,2982,26,8005,553.172.619
27/09/2018 15:00,38.46,43842,4547,239,312,3100,28,8226,553.172.619
27/09/2018 16:00,39.04,43692,4574,231,330,3141,28,8304,553.172.619
27/09/2018 17:00,39.63,43819,4491,215,389,3161,30,8286,553.172.619
27/09/2018 18:00,41.84,44103,4438,195,436,3119,36,8224,553.172.619
27/09/2018 19:00,44.13,44393,4136,183,459,3141,36,7955,553.172.619
27/09/2018 20:00,41.32,43591,3973,180,465,3153,36,7807,553.172.619
27/09/2018 21:00,39.58,42331,3999,182,467,3170,36,7854,553.172.619
27/09/2018 22:00,36.02,40338,3978,187,469,3182,37,7853,553.172.619
27/09/2018 23:00,30.48,37832,3786,223,473,3131,36,7649,553.172.619
28/09/2018 00:00,32.78,35961,3824,226,472,3130,36,7688,553.172.619
28/09/2018 01:00,29.92,35028,3788,229,473,3167,36,7693,553.172.619
28/09/2018 02:00,26.28,34733,3721,232,474,3172,36,7635,553.172.619
28/09/2018 03:00,29.07,34754,3740,234,475,3215,36,7700,553.172.619
28/09/2018 04:00,29.19,35253,3644,235,471,3163,36,7549,553.172.619
28/09/2018 05:00,36.58,37192,3473,233,456,3041,36,7239,553.172.619
28/09/2018 06:00,42.48,40592,3357,231,433,2929,34,6984,553.172.619
28/09/2018 07:00,47.03,43981,3262,230,398,2722,33,6645,553.172.619
28/09/2018 08:00,48.15,45250,3051,231,358,2604,29,6273,553.172.619
28/09/2018 09:00,47.99,45351,3024,230,309,2469,24,6056,553.172.619
28/09/2018 10:00,47.41,45491,3222,228,264,2410,24,6148,553.172.619
28/09/2018 11:00,45.97,45089,3397,224,230,2450,25,6326,553.172.619
28/09/2018 12:00,44.43,44340,3582,218,198,2562,21,6581,553.172.619
28/09/2018 13:00,42.38,43702,3666,209,176,2613,21,6685,553.172.619
28/09/2018 14:00,40.48,43183,3737,190,157,2690,20,6794,553.172.619
28/09/2018 15:00,40.07,42764,3845,166,139,2749,20,6919,553.172.619
28/09/2018 16:00,40.74,42595,3896,139,127,2723,21,6906,553.172.619
28/09/2018 17:00,42.96,42721,3720,109,122,2596,20,6567,553.172.619
28/09/2018 18:00,46.35,43102,3485,76,117,2454,20,6152,553.172.619
28/09/2018 19:00,47.26,43402,3006,58,112,2292,19,5487,553.172.619
28/09/2018 20:00,44.92,42514,2676,49,107,2149,18,4999,553.172.619
28/09/2018 21:00,43.42,41020,2517,57,99,2038,18,4729,553.172.619
28/09/2018 22:00,43.01,39310,2240,66,94,1938,18,4356,553.172.619
28/09/2018 23:00,41.79,37194,1949,237,130,1724,19,4059,553.172.619
29/09/2018 00:00,42.91,35828,1510,230,133,1544,28,3445,553.172.619
29/09/2018 01:00,42.46,35025,1276,214,136,1504,15,3145,553.172.619
29/09/2018 02:00,42.48,34737,1131,201,128,1499,13,2972,553.172.619
29/09/2018 03:00,42.39,34698,1001,191,124,1554,16,2886,553.172.619
29/09/2018 04:00,42.33,34773,891,185,115,1713,14,2918,553.172.619
29/09/2018 05:00,42.07,35435,817,187,104,1968,14,3090,553.172.619
29/09/2018 06:00,41.9,36084,863,200,94,2310,14,3481,553.172.619
29/09/2018 07:00,41.89,37338,921,206,84,2538,13,3762,553.172.619
29/09/2018 08:00,43.14,39051,937,208,76,2706,13,3940,553.172.619
29/09/2018 09:00,44.22,40316,1061,211,76,2837,13,4198,553.172.619
29/09/2018 10:00,43.86,40919,1329,213,75,3077,14,4708,553.172.619
29/09/2018 11:00,41.31,40728,1649,216,74,3463,13,5415,553.172.619
29/09/2018 12:00,38.88,40166,2166,220,74,3728,14,6202,553.172.619
29/09/2018 13:00,35.8,39664,2587,220,77,4034,15,6933,553.172.619
29/09/2018 14:00,30.45,39306,2907,213,82,4267,15,7484,553.172.619
29/09/2018 15:00,35.08,39368,3192,205,85,4356,16,7854,553.172.619
29/09/2018 16:00,37.31,39845,3346,196,85,4512,14,8153,553.172.619
29/09/2018 17:00,40.09,40677,3308,186,87,4606,15,8202,553.172.619
29/09/2018 18:00,41.32,41608,3378,179,101,4707,17,8382,553.172.619
29/09/2018 19:00,41.32,41937,3209,175,127,4784,19,8314,553.172.619
29/09/2018 20:00,40.07,41037,3144,172,162,4908,21,8407,553.172.619
29/09/2018 21:00,37.41,39859,3256,166,199,4989,23,8633,553.172.619
29/09/2018 22:00,29.1,38605,3320,152,231,5018,28,8749,553.172.619
29/09/2018 23:00,19.92,37127,3258,147,292,5100,31,8828,553.172.619
30/09/2018 00:00,25.89,35990,3170,138,306,5041,33,8688,553.172.619
30/09/2018 01:00,20.63,35121,3049,131,332,5002,33,8547,553.172.619
30/09/2018 02:00,19.17,34679,2953,134,351,4902,34,8374,553.172.619
30/09/2018 03:00,21.71,34449,2896,139,358,4787,34,8214,553.172.619
30/09/2018 04:00,28.03,34464,2766,140,366,4752,33,8057,553.172.619
30/09/2018 05:00,29.13,34818,2612,141,371,4688,34,7846,553.172.619
30/09/2018 06:00,31.2,35011,2534,135,375,4564,34,7642,553.172.619
30/09/2018 07:00,33.24,35675,2499,133,375,4432,34,7473,553.172.619
30/09/2018 08:00,35.55,37057,2360,126,380,4241,34,7141,553.172.619
30/09/2018 09:00,37.75,38575,2346,131,390,4082,35,6984,553.172.619
30/09/2018 10:00,32.52,39436,2401,128,405,3852,35,6821,553.172.619
30/09/2018 11:00,31.18,39735,2388,126,408,3753,34,6709,553.172.619
30/09/2018 12:00,30.9,39622,2343,136,408,3665,35,6587,553.172.619
30/09/2018 13:00,29.94,39254,2160,128,388,3556,35,6267,553.172.619
30/09/2018 14:00,30.74,39048,1951,110,346,3262,35,5704,553.172.619
30/09/2018 15:00,34.57,39093,1711,99,299,3025,34,5168,553.172.619
30/09/2018 16:00,39.05,39461,1431,78,262,2841,34,4646,553.172.619
30/09/2018 17:00,43.52,40211,1158,66,245,2752,32,4253,553.172.619
30/09/2018 18:00,46.64,41231,941,56,234,2642,32,3905,553.172.619
30/09/2018 19:00,47.94,41801,783,52,232,2568,31,3666,553.172.619
30/09/2018 20:00,46.88,41338,734,48,232,2559,29,3602,553.172.619
30/09/2018 21:00,44.73,40577,692,42,230,2453,26,3443,553.172.619
30/09/2018 22:00,42.96,39078,662,35,216,2300,22,3235,553.172.619
30/09/2018 23:00,42.05,37220,696,123,0,2137,19,2975,553.172.619
01/10/2018 00:00,42.45,35984,729,130,0,1990,16,2865,5.553.690.476
01/10/2018 01:00,42.5,35194,702,134,0,1890,15,2741,5.553.690.476
01/10/2018 02:00,42.5,34991,700,129,0,1838,14,2681,5.553.690.476
01/10/2018 03:00,42.76,35162,699,123,0,1775,14,2611,5.553.690.476
01/10/2018 04:00,43.41,35810,701,122,0,1753,13,2589,5.553.690.476
01/10/2018 05:00,45.05,37941,700,133,0,1735,14,2582,5.553.690.476
01/10/2018 06:00,47.37,41661,732,146,0,1694,13,2585,5.553.690.476
01/10/2018 07:00,49.27,45217,804,136,0,1536,13,2489,5.553.690.476
01/10/2018 08:00,50.04,46452,838,122,0,1285,12,2257,5.553.690.476
01/10/2018 09:00,50.05,46396,912,110,0,1210,11,2243,5.553.690.476
01/10/2018 10:00,50.16,46186,1057,100,0,1133,11,2301,5.553.690.476
01/10/2018 11:00,49.84,45737,1200,89,0,1142,11,2442,5.553.690.476
01/10/2018 12:00,49.51,45253,1387,80,0,1159,11,2637,5.553.690.476
01/10/2018 13:00,49.38,45018,1534,70,0,1153,11,2768,5.553.690.476
01/10/2018 14:00,48.96,44694,1644,66,0,1149,11,2870,5.553.690.476
01/10/2018 15:00,48.4,44450,1784,58,0,1090,11,2943,5.553.690.476
01/10/2018 16:00,48.31,44379,1924,53,0,1154,11,3142,5.553.690.476
01/10/2018 17:00,48.81,44738,1920,50,0,1216,11,3197,5.553.690.476
01/10/2018 18:00,49.44,45153,1940,49,0,1354,11,3354,5.553.690.476
01/10/2018 19:00,49.84,45542,1850,50,0,1464,11,3375,5.553.690.476
01/10/2018 20:00,48.48,44814,1858,46,0,1428,11,3343,5.553.690.476
01/10/2018 21:00,47.48,43518,1857,46,0,1440,11,3354,5.553.690.476
01/10/2018 22:00,45.15,41391,1790,43,0,1468,11,3312,5.553.690.476
01/10/2018 23:00,42.76,39064,1763,134,0,1203,9,3109,5.553.690.476
02/10/2018 00:00,45.07,37547,1825,115,0,1110,9,3059,5.553.690.476
02/10/2018 01:00,44.02,36673,1868,104,0,1021,9,3002,5.553.690.476
02/10/2018 02:00,43.99,36500,1882,100,0,956,9,2947,5.553.690.476
02/10/2018 03:00,43.72,36633,1925,96,0,934,10,2965,5.553.690.476
02/10/2018 04:00,44.07,37193,1945,91,0,951,10,2997,5.553.690.476
02/10/2018 05:00,46.9,39113,1960,87,0,1013,10,3070,5.553.690.476
02/10/2018 06:00,49.32,42677,1930,79,0,1146,10,3165,5.553.690.476
02/10/2018 07:00,54.08,45743,1925,69,0,1183,11,3188,5.553.690.476
02/10/2018 08:00,54.07,46908,1909,63,0,1123,12,3107,5.553.690.476
02/10/2018 09:00,50.96,46970,2144,57,0,1181,17,3399,5.553.690.476
02/10/2018 10:00,49.23,46977,2601,50,0,1337,20,4008,5.553.690.476
02/10/2018 11:00,48.04,46726,3105,47,0,1562,19,4733,5.553.690.476
02/10/2018 12:00,47.18,46240,3644,42,0,1706,21,5413,5.553.690.476
02/10/2018 13:00,47.16,46050,3957,37,0,1911,23,5928,5.553.690.476
02/10/2018 14:00,46.88,45695,4208,32,0,2072,22,6334,5.553.690.476
02/10/2018 15:00,46.37,45390,4407,30,0,2294,22,6753,5.553.690.476
02/10/2018 16:00,46.38,45347,4491,27,0,2443,22,6983,5.553.690.476
02/10/2018 17:00,46.01,45740,4336,28,0,2491,22,6877,5.553.690.476
02/10/2018 18:00,48.19,46226,4399,30,0,2506,22,6957,5.553.690.476
02/10/2018 19:00,48.33,46516,4184,29,0,2527,25,6765,5.553.690.476
02/10/2018 20:00,45.86,45615,4174,27,0,2548,22,6771,5.553.690.476
02/10/2018 21:00,44.93,44195,4271,24,0,2562,24,6881,5.553.690.476
02/10/2018 22:00,42.72,42033,4287,21,0,2566,27,6901,5.553.690.476
02/10/2018 23:00,42.51,39804,4246,17,439,2667,39,7408,5.553.690.476
03/10/2018 00:00,40.93,38478,4244,16,428,2749,26,7463,5.553.690.476
03/10/2018 01:00,39.03,37534,4134,15,408,2780,31,7368,5.553.690.476
03/10/2018 02:00,36.76,37282,4093,16,405,2828,26,7368,5.553.690.476
03/10/2018 03:00,39.01,37305,4108,18,392,2857,24,7399,5.553.690.476
03/10/2018 04:00,38.43,37854,3960,20,391,2826,13,7210,5.553.690.476
03/10/2018 05:00,40.66,39542,3830,19,390,2740,10,6989,5.553.690.476
03/10/2018 06:00,45.5,42865,3712,20,383,2681,11,6807,5.553.690.476
03/10/2018 07:00,48.15,46330,3579,21,379,2500,13,6492,5.553.690.476
03/10/2018 08:00,49.37,47494,3302,18,369,2257,12,5958,5.553.690.476
03/10/2018 09:00,49.52,47459,3260,17,369,2075,14,5735,5.553.690.476
03/10/2018 10:00,48.67,47352,3370,18,379,1977,15,5759,5.553.690.476
03/10/2018 11:00,47.8,47192,3454,16,394,1969,16,5849,5.553.690.476
03/10/2018 12:00,47.22,46675,3538,16,408,1972,24,5958,5.553.690.476
03/10/2018 13:00,46.75,46213,3498,16,418,2005,20,5957,5.553.690.476
03/10/2018 14:00,46.7,45676,3542,24,431,2020,29,6046,5.553.690.476
03/10/2018 15:00,46.74,45470,3642,26,445,2020,34,6167,5.553.690.476
03/10/2018 16:00,46.62,45295,3699,30,455,1991,43,6218,5.553.690.476
03/10/2018 17:00,47.36,45698,3488,30,460,2000,43,6021,5.553.690.476
03/10/2018 18:00,50.32,46279,3312,37,464,1978,43,5834,5.553.690.476
03/10/2018 19:00,50.62,46265,2944,43,466,1983,43,5479,5.553.690.476
03/10/2018 20:00,49.49,45260,2744,51,458,2038,42,5333,5.553.690.476
03/10/2018 21:00,47.51,44136,2567,63,441,2070,42,5183,5.553.690.476
03/10/2018 22:00,46.29,42316,2264,69,426,2027,40,4826,5.553.690.476
03/10/2018 23:00,44.67,39972,1935,95,363,1881,27,4301,5.553.690.476
04/10/2018 00:00,46.69,39091,1405,100,321,1798,25,3649,5.553.690.476
04/10/2018 01:00,44.99,38410,1111,106,296,1657,22,3192,5.553.690.476
04/10/2018 02:00,44.51,38080,896,107,274,1511,24,2812,5.553.690.476
04/10/2018 03:00,45.74,38193,744,100,266,1342,24,2476,5.553.690.476
04/10/2018 04:00,46.02,38722,663,89,259,1201,25,2237,5.553.690.476
04/10/2018 05:00,48.18,40456,618,76,250,1025,27,1996,5.553.690.476
04/10/2018 06:00,49.96,43664,602,62,241,863,27,1795,5.553.690.476
04/10/2018 07:00,54.86,46706,616,52,239,638,25,1570,5.553.690.476
04/10/2018 08:00,54.02,47947,645,45,254,402,23,1369,5.553.690.476
04/10/2018 09:00,54.14,47878,790,34,271,332,27,1454,5.553.690.476
04/10/2018 10:00,54.09,47654,965,20,279,406,26,1696,5.553.690.476
04/10/2018 11:00,53.83,47284,1184,16,273,526,19,2018,5.553.690.476
04/10/2018 12:00,50.8,46718,1535,15,261,667,16,2494,5.553.690.476
04/10/2018 13:00,49.88,46363,1899,18,236,857,11,3021,5.553.690.476
04/10/2018 14:00,49.71,45951,2021,25,206,1072,11,3335,5.553.690.476
04/10/2018 15:00,49.91,45851,2034,44,178,1346,8,3610,5.553.690.476
04/10/2018 16:00,50.21,45756,2053,75,149,1618,9,3904,5.553.690.476
04/10/2018 17:00,49.86,46108,1916,106,122,1995,8,4147,5.553.690.476
04/10/2018 18:00,50,46570,1905,126,101,2354,8,4494,5.553.690.476
04/10/2018 19:00,49.97,46862,1906,138,83,2763,6,4896,5.553.690.476
04/10/2018 20:00,48.95,46000,2031,147,67,2925,5,5175,5.553.690.476
04/10/2018 21:00,48.16,44561,2245,153,55,3180,5,5638,5.553.690.476
04/10/2018 22:00,46.4,42503,2375,159,53,3415,4,6006,5.553.690.476
04/10/2018 23:00,43.34,39976,2408,151,0,3745,10,6314,5.553.690.476
05/10/2018 00:00,45.3,38469,2646,149,0,3915,12,6722,5.553.690.476
05/10/2018 01:00,42.57,37380,2721,147,0,4122,12,7002,5.553.690.476
05/10/2018 02:00,40.67,36993,2789,141,0,4292,14,7236,5.553.690.476
05/10/2018 03:00,41.14,36947,2783,139,0,4405,22,7349,5.553.690.476
05/10/2018 04:00,42.56,37289,2559,141,0,4452,27,7179,5.553.690.476
05/10/2018 05:00,46.17,38985,2260,145,0,4480,31,6916,5.553.690.476
05/10/2018 06:00,48.4,42303,1940,142,0,4475,29,6586,5.553.690.476
05/10/2018 07:00,49.95,45669,1671,137,0,4297,31,6136,5.553.690.476
05/10/2018 08:00,50.4,46823,1464,132,0,4163,31,5790,5.553.690.476
05/10/2018 09:00,50.34,46800,1422,124,0,4060,31,5637,5.553.690.476
05/10/2018 10:00,49.88,46915,1522,121,0,4038,30,5711,5.553.690.476
05/10/2018 11:00,48.92,46490,1610,125,0,4001,29,5765,5.553.690.476
05/10/2018 12:00,48.01,45779,1701,132,0,3876,29,5738,5.553.690.476
05/10/2018 13:00,48.71,45143,1705,127,0,3766,31,5629,5.553.690.476
05/10/2018 14:00,48.08,44543,1697,112,0,3721,30,5560,5.553.690.476
05/10/2018 15:00,48.09,44104,1617,97,0,3646,27,5387,5.553.690.476
05/10/2018 16:00,48.32,44000,1546,82,0,3610,24,5262,5.553.690.476
05/10/2018 17:00,48.55,44214,1329,71,0,3656,20,5076,5.553.690.476
05/10/2018 18:00,48.95,44827,1141,61,0,3725,18,4945,5.553.690.476
05/10/2018 19:00,49.11,45008,1013,48,0,3818,18,4897,5.553.690.476
05/10/2018 20:00,48.71,43916,887,36,0,3839,21,4783,5.553.690.476
05/10/2018 21:00,48.29,42324,801,30,0,3810,22,4663,5.553.690.476
05/10/2018 22:00,47.27,40545,662,30,0,3727,28,4447,5.553.690.476
05/10/2018 23:00,45.61,38547,525,34,283,3727,24,4593,5.553.690.476
06/10/2018 00:00,44.94,37313,404,27,274,3616,24,4345,5.553.690.476
06/10/2018 01:00,43.3,36294,304,22,263,3487,27,4103,5.553.690.476
06/10/2018 02:00,43.21,35893,261,19,238,3320,28,3866,5.553.690.476
06/10/2018 03:00,43.21,35753,238,20,222,3179,25,3684,5.553.690.476
06/10/2018 04:00,43.79,35776,235,17,211,3057,22,3542,5.553.690.476
06/10/2018 05:00,43.98,36417,274,16,205,2951,19,3465,5.553.690.476
06/10/2018 06:00,44.79,37052,323,14,202,2842,15,3396,5.553.690.476
06/10/2018 07:00,46.28,38298,365,10,189,2643,13,3220,5.553.690.476
06/10/2018 08:00,47.47,40029,376,11,161,2411,13,2972,5.553.690.476
06/10/2018 09:00,48.05,41630,408,15,146,2149,15,2733,5.553.690.476
06/10/2018 10:00,48.15,42224,470,23,140,1957,17,2607,5.553.690.476
06/10/2018 11:00,48.1,42139,496,33,136,1884,16,2565,5.553.690.476
06/10/2018 12:00,48.14,41767,503,47,128,1700,16,2394,5.553.690.476
06/10/2018 13:00,48.14,41250,565,57,119,1551,12,2304,5.553.690.476
06/10/2018 14:00,48.13,40745,618,59,109,1408,10,2204,5.553.690.476
06/10/2018 15:00,47.91,40648,711,64,101,1295,8,2179,5.553.690.476
06/10/2018 16:00,48.15,41066,770,69,105,1274,6,2224,5.553.690.476
06/10/2018 17:00,48.47,42030,783,78,123,1272,5,2261,5.553.690.476
06/10/2018 18:00,49.34,43083,799,95,145,1244,5,2288,5.553.690.476
06/10/2018 19:00,49.25,43243,820,117,160,1364,6,2467,5.553.690.476
06/10/2018 20:00,48.21,42142,931,137,168,1312,5,2553,5.553.690.476
06/10/2018 21:00,47.94,41034,1158,157,168,1454,4,2941,5.553.690.476
06/10/2018 22:00,47.09,39848,1325,175,160,1531,4,3195,5.553.690.476
06/10/2018 23:00,45.34,38381,1299,201,137,1587,3,3227,5.553.690.476
07/10/2018 00:00,47,37048,1110,202,123,1597,3,3035,5.553.690.476
07/10/2018 01:00,45.54,36185,1192,205,110,1664,3,3174,5.553.690.476
07/10/2018 02:00,44.67,35805,1391,206,101,1790,3,3491,5.553.690.476
07/10/2018 03:00,43.03,35776,1534,202,93,1914,3,3746,5.553.690.476
07/10/2018 04:00,42.52,35986,1557,198,92,2002,3,3852,5.553.690.476
07/10/2018 05:00,43.81,36447,1462,196,95,2046,3,3802,5.553.690.476
07/10/2018 06:00,44.64,36970,1353,195,98,2114,3,3763,5.553.690.476
07/10/2018 07:00,46.37,37657,1194,195,98,1855,3,3345,5.553.690.476
07/10/2018 08:00,47.99,39170,925,198,95,1409,3,2630,5.553.690.476
07/10/2018 09:00,49.33,40635,728,200,99,1120,3,2150,5.553.690.476
07/10/2018 10:00,49.82,41519,624,201,118,922,8,1873,5.553.690.476
07/10/2018 11:00,49.83,41587,553,208,153,777,9,1700,5.553.690.476
07/10/2018 12:00,49.64,41294,521,206,199,634,11,1571,5.553.690.476
07/10/2018 13:00,49.04,40854,424,204,229,515,13,1385,5.553.690.476
07/10/2018 14:00,48.31,40617,332,201,255,455,11,1254,5.553.690.476
07/10/2018 15:00,47.93,40631,253,196,268,427,9,1153,5.553.690.476
07/10/2018 16:00,48.44,41122,180,191,270,450,9,1100,5.553.690.476
07/10/2018 17:00,49.09,42338,138,184,261,551,8,1142,5.553.690.476
07/10/2018 18:00,50.41,43544,141,177,243,721,7,1289,5.553.690.476
07/10/2018 19:00,50.66,44102,159,170,212,985,7,1533,5.553.690.476
07/10/2018 20:00,49.81,43327,209,163,171,1265,5,1813,5.553.690.476
07/10/2018 21:00,49.09,42450,318,156,133,1641,3,2251,5.553.690.476
07/10/2018 22:00,47.89,40951,490,141,101,2113,3,2848,5.553.690.476
07/10/2018 23:00,47.03,39001,731,38,48,2576,3,3396,5.553.690.476
08/10/2018 00:00,46.15,37441,1379,57,39,2882,2,4359,5.760.059.524
08/10/2018 01:00,44.16,36836,1706,81,30,3239,2,5058,5.760.059.524
08/10/2018 02:00,42.94,36573,2038,105,23,3642,2,5810,5.760.059.524
08/10/2018 03:00,41.82,36705,2368,132,16,3917,2,6435,5.760.059.524
08/10/2018 04:00,41.79,37360,2594,155,12,4245,2,7008,5.760.059.524
08/10/2018 05:00,44.23,39750,2741,170,10,4462,2,7385,5.760.059.524
08/10/2018 06:00,47.52,43983,2896,175,14,4747,3,7835,5.760.059.524
08/10/2018 07:00,48.6,47303,2987,176,19,4907,5,8094,5.760.059.524
08/10/2018 08:00,48.72,48059,2932,181,25,4936,7,8081,5.760.059.524
08/10/2018 09:00,48.56,47905,3004,192,30,5061,6,8293,5.760.059.524
08/10/2018 10:00,48.38,47810,3185,202,36,5069,6,8498,5.760.059.524
08/10/2018 11:00,48.08,47260,3316,210,52,5008,10,8596,5.760.059.524
08/10/2018 12:00,47.77,46684,3445,213,59,4780,14,8511,5.760.059.524
08/10/2018 13:00,47.73,46326,3414,209,59,4509,22,8213,5.760.059.524
08/10/2018 14:00,47.71,45953,3386,197,55,4346,26,8010,5.760.059.524
08/10/2018 15:00,47.36,45730,3193,182,53,4166,24,7618,5.760.059.524
08/10/2018 16:00,47.48,45652,2938,163,57,4037,24,7219,5.760.059.524
08/10/2018 17:00,47.73,46224,2655,146,72,3942,24,6839,5.760.059.524
08/10/2018 18:00,48.46,46814,2555,129,90,4004,21,6799,5.760.059.524
08/10/2018 19:00,48.84,46887,2421,119,107,3839,19,6505,5.760.059.524
08/10/2018 20:00,47.81,45494,2344,116,125,3816,19,6420,5.760.059.524
08/10/2018 21:00,47.4,43898,2305,108,144,3850,20,6427,5.760.059.524
08/10/2018 22:00,46.27,41689,2209,102,154,3870,21,6356,5.760.059.524
08/10/2018 23:00,44.08,39206,2143,22,0,3912,27,6104,5.760.059.524
09/10/2018 00:00,40.97,37366,2094,17,0,3876,26,6013,5.760.059.524
09/10/2018 01:00,38.15,36610,1992,13,0,3702,27,5734,5.760.059.524
09/10/2018 02:00,36.94,36363,1972,8,0,3540,27,5547,5.760.059.524
09/10/2018 03:00,38.04,36397,2015,5,0,3486,19,5525,5.760.059.524
09/10/2018 04:00,38.11,36927,2032,7,0,3411,21,5471,5.760.059.524
09/10/2018 05:00,43.82,38981,2079,15,0,3491,23,5608,5.760.059.524
09/10/2018 06:00,46.95,42977,2179,31,0,3640,19,5869,5.760.059.524
09/10/2018 07:00,48.17,46304,2307,45,0,3791,18,6161,5.760.059.524
09/10/2018 08:00,49.1,46906,2322,59,0,3827,18,6226,5.760.059.524
09/10/2018 09:00,48.7,46792,2554,74,0,3942,24,6594,5.760.059.524
09/10/2018 10:00,48.09,46796,2889,99,0,4033,31,7052,5.760.059.524
09/10/2018 11:00,47.64,46410,3126,124,0,3968,31,7249,5.760.059.524
09/10/2018 12:00,47.28,45884,3267,145,0,4085,30,7527,5.760.059.524
09/10/2018 13:00,47.07,45577,3192,159,0,4012,30,7393,5.760.059.524
09/10/2018 14:00,46.66,45355,3129,167,0,4008,31,7335,5.760.059.524
09/10/2018 15:00,45.99,45107,3008,186,0,3923,29,7146,5.760.059.524
09/10/2018 16:00,45.88,44985,2808,195,0,3997,29,7029,5.760.059.524
09/10/2018 17:00,46.07,45645,2498,200,0,4069,29,6796,5.760.059.524
09/10/2018 18:00,47.15,46067,2337,205,0,4068,28,6638,5.760.059.524
09/10/2018 19:00,47.55,45863,2167,212,0,4078,30,6487,5.760.059.524
09/10/2018 20:00,46.07,44417,2033,215,0,4075,30,6353,5.760.059.524
09/10/2018 21:00,45.31,42898,1918,214,0,4036,30,6198,5.760.059.524
09/10/2018 22:00,43.93,40724,1726,211,0,3982,24,5943,5.760.059.524
09/10/2018 23:00,41.38,38269,1548,218,0,4032,34,5832,5.760.059.524
10/10/2018 00:00,42.1,36329,1557,214,0,4026,30,5827,5.760.059.524
10/10/2018 01:00,41.32,35366,1351,208,0,3983,24,5566,5.760.059.524
10/10/2018 02:00,41.17,35177,1170,201,0,3843,24,5238,5.760.059.524
10/10/2018 03:00,42.17,35263,980,193,0,3796,23,4992,5.760.059.524
10/10/2018 04:00,42.19,35950,775,183,0,3709,23,4690,5.760.059.524
10/10/2018 05:00,44.23,38160,658,175,0,3451,21,4305,5.760.059.524
10/10/2018 06:00,47.51,42215,576,170,0,3114,18,3878,5.760.059.524
10/10/2018 07:00,49.11,45440,510,165,0,2735,14,3424,5.760.059.524
10/10/2018 08:00,49.49,46173,428,166,0,2350,10,2954,5.760.059.524
10/10/2018 09:00,49.52,45875,359,169,0,1883,9,2420,5.760.059.524
10/10/2018 10:00,49.83,45595,312,174,0,1508,7,2001,5.760.059.524
10/10/2018 11:00,49.54,45304,285,178,0,1214,5,1682,5.760.059.524
10/10/2018 12:00,49.07,44773,287,180,0,1047,4,1518,5.760.059.524
10/10/2018 13:00,48.55,44284,276,182,0,957,3,1418,5.760.059.524
10/10/2018 14:00,48.29,43910,270,186,0,868,3,1327,5.760.059.524
10/10/2018 15:00,48.36,44030,280,196,0,765,2,1243,5.760.059.524
10/10/2018 16:00,48.75,44072,314,200,0,742,1,1257,5.760.059.524
10/10/2018 17:00,49.5,44998,396,200,0,973,1,1570,5.760.059.524
10/10/2018 18:00,50,45869,675,198,0,1257,1,2131,5.760.059.524
10/10/2018 19:00,50.3,45862,1097,198,0,1455,1,2751,5.760.059.524
10/10/2018 20:00,48.19,44496,1389,195,0,1538,1,3123,5.760.059.524
10/10/2018 21:00,46.94,43069,1540,191,0,1649,1,3381,5.760.059.524
10/10/2018 22:00,44.24,40944,1718,184,0,1653,2,3557,5.760.059.524
10/10/2018 23:00,41.88,38240,1865,193,7,1733,8,3806,5.760.059.524
11/10/2018 00:00,36.69,36171,2062,193,10,1778,8,4051,5.760.059.524
11/10/2018 01:00,32.52,35522,2226,193,13,1697,8,4137,5.760.059.524
11/10/2018 02:00,30.35,35311,2318,190,21,1530,8,4067,5.760.059.524
11/10/2018 03:00,31.34,35446,2409,186,28,1430,8,4061,5.760.059.524
11/10/2018 04:00,36.22,36094,2503,182,34,1433,8,4160,5.760.059.524
11/10/2018 05:00,42.36,38276,2607,178,37,1486,8,4316,5.760.059.524
11/10/2018 06:00,46.07,42224,2665,167,39,1501,8,4380,5.760.059.524
11/10/2018 07:00,48.27,45450,2703,147,40,1471,8,4369,5.760.059.524
11/10/2018 08:00,48.7,46220,2563,139,31,1340,8,4081,5.760.059.524
11/10/2018 09:00,48.2,46066,2572,131,27,1273,8,4011,5.760.059.524
11/10/2018 10:00,47.55,45817,2633,120,29,1220,8,4010,5.760.059.524
11/10/2018 11:00,46.87,45250,2650,109,32,1195,9,3995,5.760.059.524
11/10/2018 12:00,45.37,44690,2650,97,40,1215,9,4011,5.760.059.524
11/10/2018 13:00,45.62,44173,2555,83,52,1291,10,3991,5.760.059.524
11/10/2018 14:00,46.09,43883,2588,66,70,1403,10,4137,5.760.059.524
11/10/2018 15:00,46.42,43714,2654,56,93,1645,9,4457,5.760.059.524
11/10/2018 16:00,46.75,43777,2666,46,126,1932,9,4779,5.760.059.524
11/10/2018 17:00,47.89,44561,2516,41,164,2287,13,5021,5.760.059.524
11/10/2018 18:00,48.65,45200,2486,35,199,2621,16,5357,5.760.059.524
11/10/2018 19:00,48.37,45188,2348,28,216,3114,19,5725,5.760.059.524
11/10/2018 20:00,47.12,43900,2132,23,219,3068,19,5461,5.760.059.524
11/10/2018 21:00,45.22,42441,1878,18,215,2987,17,5115,5.760.059.524
11/10/2018 22:00,43.63,40268,1657,14,212,2867,17,4767,5.760.059.524
11/10/2018 23:00,42.4,37653,1479,5,0,3004,22,4510,5.760.059.524
12/10/2018 00:00,40.94,35769,1496,4,0,2913,20,4433,5.760.059.524
12/10/2018 01:00,40.35,34882,1460,4,0,2779,16,4259,5.760.059.524
12/10/2018 02:00,39.82,34621,1497,4,0,2595,17,4113,5.760.059.524
12/10/2018 03:00,40.36,34722,1498,4,0,2429,14,3945,5.760.059.524
12/10/2018 04:00,40.92,35390,1501,5,0,2299,14,3819,5.760.059.524
12/10/2018 05:00,43.32,37690,1523,6,0,2225,16,3770,5.760.059.524
12/10/2018 06:00,46.3,41816,1478,7,0,2080,14,3579,5.760.059.524
12/10/2018 07:00,48.57,45337,1523,8,0,1902,14,3447,5.760.059.524
12/10/2018 08:00,49.28,46235,1512,8,0,1521,14,3055,5.760.059.524
12/10/2018 09:00,48.27,46177,1509,9,0,1272,11,2801,5.760.059.524
12/10/2018 10:00,48.41,46002,1466,10,0,1150,11,2637,5.760.059.524
12/10/2018 11:00,47,45183,1459,13,0,1098,10,2580,5.760.059.524
12/10/2018 12:00,46.57,44327,1430,14,0,1085,12,2541,5.760.059.524
12/10/2018 13:00,45.89,43462,1384,14,0,1131,7,2536,5.760.059.524
12/10/2018 14:00,45.01,42638,1364,15,0,1278,7,2664,5.760.059.524
12/10/2018 15:00,44.82,42187,1329,17,0,1473,5,2824,5.760.059.524
12/10/2018 16:00,44.53,42297,1352,19,0,1745,4,3120,5.760.059.524
12/10/2018 17:00,45.39,43040,1308,24,0,1994,6,3332,5.760.059.524
12/10/2018 18:00,46.06,43847,1373,29,0,2276,10,3688,5.760.059.524
12/10/2018 19:00,46.26,43695,1546,32,0,2460,14,4052,5.760.059.524
12/10/2018 20:00,43.68,42058,1687,36,0,2526,18,4267,5.760.059.524
12/10/2018 21:00,42.4,40465,1832,42,0,2598,18,4490,5.760.059.524
12/10/2018 22:00,40.92,38658,1884,47,0,2578,15,4524,5.760.059.524
12/10/2018 23:00,39.36,36579,1886,110,161,2834,18,5009,5.760.059.524
13/10/2018 00:00,35.7,35124,2532,115,145,2997,18,5807,5.760.059.524
13/10/2018 01:00,31.33,34296,2516,114,134,3171,18,5953,5.760.059.524
13/10/2018 02:00,27.08,33865,2484,108,128,3350,18,6088,5.760.059.524
13/10/2018 03:00,26.87,33728,2500,103,121,3458,20,6202,5.760.059.524
13/10/2018 04:00,27.43,33834,2407,105,113,3594,18,6237,5.760.059.524
13/10/2018 05:00,31.54,34479,2337,110,100,3758,18,6323,5.760.059.524
13/10/2018 06:00,34.95,35271,2203,115,87,3831,18,6254,5.760.059.524
13/10/2018 07:00,37.35,36488,2101,118,75,3869,17,6180,5.760.059.524
13/10/2018 08:00,39.45,38075,1993,115,59,3783,12,5962,5.760.059.524
13/10/2018 09:00,40.15,39486,1955,115,40,3611,7,5728,5.760.059.524
13/10/2018 10:00,40.36,39858,1898,111,29,3551,8,5597,5.760.059.524
13/10/2018 11:00,40.32,39462,1927,106,24,3468,8,5533,5.760.059.524
13/10/2018 12:00,37.84,38854,1997,95,24,3463,8,5587,5.760.059.524
13/10/2018 13:00,34.77,38283,1994,84,27,3417,7,5529,5.760.059.524
13/10/2018 14:00,32.35,37790,2039,73,33,3450,6,5601,5.760.059.524
13/10/2018 15:00,36.97,37736,2222,61,43,3488,6,5820,5.760.059.524
13/10/2018 16:00,38.59,38341,2278,53,70,3570,6,5977,5.760.059.524
13/10/2018 17:00,39.79,39797,2275,47,111,3651,8,6092,5.760.059.524
13/10/2018 18:00,40.78,41051,2475,41,156,3804,12,6488,5.760.059.524
13/10/2018 19:00,40.3,40746,2606,34,177,3962,16,6795,5.760.059.524
13/10/2018 20:00,38.9,39242,2655,27,179,4063,15,6939,5.760.059.524
13/10/2018 21:00,31.59,38076,2627,21,172,4169,16,7005,5.760.059.524
13/10/2018 22:00,25.39,36838,2584,16,167,4194,14,6975,5.760.059.524
13/10/2018 23:00,19.55,35328,2548,11,144,4266,17,6986,5.760.059.524
14/10/2018 00:00,5.1,33842,2725,10,133,4247,17,7132,5.760.059.524
14/10/2018 01:00,4.71,32944,2658,11,122,4238,17,7046,5.760.059.524
14/10/2018 02:00,4.04,32440,2631,12,121,4282,17,7063,5.760.059.524
14/10/2018 03:00,3.99,32539,2617,14,120,4263,16,7030,5.760.059.524
14/10/2018 04:00,4.24,32705,2516,15,123,4195,16,6865,5.760.059.524
14/10/2018 05:00,4.7,33151,2425,16,128,4176,16,6761,5.760.059.524
14/10/2018 06:00,4.59,33762,2308,23,132,4244,16,6723,5.760.059.524
14/10/2018 07:00,10.42,34527,2269,31,117,4167,16,6600,5.760.059.524
14/10/2018 08:00,26.35,36044,2217,43,104,4010,13,6387,5.760.059.524
14/10/2018 09:00,29.03,37347,2182,56,94,3805,8,6145,5.760.059.524
14/10/2018 10:00,29.07,38067,2062,67,89,3720,7,5945,5.760.059.524
14/10/2018 11:00,28.81,37919,1992,78,89,3733,7,5899,5.760.059.524
14/10/2018 12:00,23.73,37540,1997,84,92,3716,6,5895,5.760.059.524
14/10/2018 13:00,25.02,37085,1950,86,100,3806,6,5948,5.760.059.524
14/10/2018 14:00,20.98,36904,1980,87,112,3898,6,6083,5.760.059.524
14/10/2018 15:00,23.83,36986,2226,85,130,4050,8,6499,5.760.059.524
14/10/2018 16:00,23.17,37757,2402,82,159,4263,10,6916,5.760.059.524
14/10/2018 17:00,37.03,39214,2494,77,187,4386,16,7160,5.760.059.524
14/10/2018 18:00,38.81,40555,2761,72,209,4573,24,7639,5.760.059.524
14/10/2018 19:00,38.46,40715,2933,66,221,4682,28,7930,5.760.059.524
14/10/2018 20:00,33.76,39601,2972,57,221,4692,25,7967,5.760.059.524
14/10/2018 21:00,30.27,38648,2900,48,219,4615,28,7810,5.760.059.524
14/10/2018 22:00,26.62,37046,2700,39,216,4554,30,7539,5.760.059.524
14/10/2018 23:00,4.91,35071,2492,53,224,4274,31,7074,5.760.059.524
15/10/2018 00:00,2.17,34078,1791,57,211,4076,29,6164,5.827.678.571
15/10/2018 01:00,4.03,33469,1489,59,198,3767,24,5537,5.827.678.571
15/10/2018 02:00,4.88,33313,1233,58,189,3610,21,5111,5.827.678.571
15/10/2018 03:00,10.47,33535,1035,59,180,3421,23,4718,5.827.678.571
15/10/2018 04:00,17.51,34267,854,61,178,3279,25,4397,5.827.678.571
15/10/2018 05:00,39.8,36570,764,63,182,3076,24,4109,5.827.678.571
15/10/2018 06:00,43.1,40741,684,64,192,2851,23,3814,5.827.678.571
15/10/2018 07:00,45.64,44093,668,59,179,2438,21,3365,5.827.678.571
15/10/2018 08:00,46.41,44980,674,56,139,1978,17,2864,5.827.678.571
15/10/2018 09:00,46.26,44885,644,53,112,1652,12,2473,5.827.678.571
15/10/2018 10:00,46.01,44838,541,51,93,1410,9,2104,5.827.678.571
15/10/2018 11:00,45.81,44211,500,53,94,1158,10,1815,5.827.678.571
15/10/2018 12:00,45.37,43608,483,54,96,1027,10,1670,5.827.678.571
15/10/2018 13:00,45.03,43265,426,57,105,985,9,1582,5.827.678.571
15/10/2018 14:00,45.39,43024,420,60,125,987,9,1601,5.827.678.571
15/10/2018 15:00,45.46,43039,462,71,156,988,10,1687,5.827.678.571
15/10/2018 16:00,46.07,43227,526,79,192,968,13,1778,5.827.678.571
15/10/2018 17:00,46.44,44236,563,88,226,1067,19,1963,5.827.678.571
15/10/2018 18:00,48.14,45075,622,94,244,1160,23,2143,5.827.678.571
15/10/2018 19:00,48.29,45132,687,97,255,1178,23,2240,5.827.678.571
15/10/2018 20:00,45.85,43739,681,101,247,1130,21,2180,5.827.678.571
15/10/2018 21:00,43.17,42170,600,105,235,1066,26,2032,5.827.678.571
15/10/2018 22:00,42.58,40145,497,103,230,986,30,1846,5.827.678.571
15/10/2018 23:00,40.59,37585,435,145,198,949,28,1755,5.827.678.571
16/10/2018 00:00,40.51,36187,405,137,182,908,25,1657,5.827.678.571
16/10/2018 01:00,39.96,35345,346,132,173,882,22,1555,5.827.678.571
16/10/2018 02:00,39.66,35142,307,127,171,871,21,1497,5.827.678.571
16/10/2018 03:00,39.95,35182,261,128,168,966,21,1544,5.827.678.571
16/10/2018 04:00,40.48,35782,182,128,162,983,18,1473,5.827.678.571
16/10/2018 05:00,42.56,37915,153,125,153,1004,17,1452,5.827.678.571
16/10/2018 06:00,44.28,41897,140,121,139,1069,19,1488,5.827.678.571
16/10/2018 07:00,46.7,45122,136,106,116,948,19,1325,5.827.678.571
16/10/2018 08:00,47.51,45802,128,96,79,823,14,1140,5.827.678.571
16/10/2018 09:00,47.23,45865,103,86,52,698,9,948,5.827.678.571
16/10/2018 10:00,47.2,45989,94,80,29,628,8,839,5.827.678.571
16/10/2018 11:00,46.7,45643,102,78,22,578,9,789,5.827.678.571
16/10/2018 12:00,45.83,45124,115,79,19,467,7,687,5.827.678.571
16/10/2018 13:00,45.09,44821,132,86,18,415,7,658,5.827.678.571
16/10/2018 14:00,44.4,44574,158,98,20,389,5,670,5.827.678.571
16/10/2018 15:00,44.42,44437,194,116,28,420,4,762,5.827.678.571
16/10/2018 16:00,45.75,44544,207,126,49,496,4,882,5.827.678.571
16/10/2018 17:00,46.41,45504,200,131,73,621,5,1030,5.827.678.571
16/10/2018 18:00,47.11,46138,233,133,99,864,6,1335,5.827.678.571
16/10/2018 19:00,47.32,45820,307,133,101,1012,6,1559,5.827.678.571
16/10/2018 20:00,44.96,44316,377,131,93,1112,6,1719,5.827.678.571
16/10/2018 21:00,44.1,42949,460,132,80,1202,7,1881,5.827.678.571
16/10/2018 22:00,42.62,40844,502,128,69,1295,6,2000,5.827.678.571
16/10/2018 23:00,41.44,38495,544,140,67,1500,8,2259,5.827.678.571
17/10/2018 00:00,42.3,36471,707,142,56,1580,8,2493,5.827.678.571
17/10/2018 01:00,40.01,35701,776,141,50,1612,7,2586,5.827.678.571
17/10/2018 02:00,39.61,35411,782,138,46,1732,6,2704,5.827.678.571
17/10/2018 03:00,39.82,35513,810,133,41,1823,6,2813,5.827.678.571
17/10/2018 04:00,41.01,36230,815,131,41,1911,7,2905,5.827.678.571
17/10/2018 05:00,42.8,38314,773,131,39,1988,7,2938,5.827.678.571
17/10/2018 06:00,44.7,42111,715,126,40,2030,6,2917,5.827.678.571
17/10/2018 07:00,45.43,45286,661,106,39,2032,7,2845,5.827.678.571
17/10/2018 08:00,45.81,45916,656,87,28,2008,7,2786,5.827.678.571
17/10/2018 09:00,45.83,45669,623,68,19,1892,5,2607,5.827.678.571
17/10/2018 10:00,45.62,45507,559,54,12,1809,4,2438,5.827.678.571
17/10/2018 11:00,45.16,45152,554,41,10,1666,4,2275,5.827.678.571
17/10/2018 12:00,44.06,44611,562,31,10,1659,4,2266,5.827.678.571
17/10/2018 13:00,43.93,44315,533,23,10,1621,5,2192,5.827.678.571
17/10/2018 14:00,43.72,43963,456,18,13,1558,5,2050,5.827.678.571
17/10/2018 15:00,44.06,44079,343,17,13,1524,5,1902,5.827.678.571
17/10/2018 16:00,44.54,44192,268,15,22,1581,5,1891,5.827.678.571
17/10/2018 17:00,45.07,44945,232,13,40,1650,6,1941,5.827.678.571
17/10/2018 18:00,45.39,45627,204,10,57,1706,7,1984,5.827.678.571
17/10/2018 19:00,45.49,45238,172,9,73,1712,9,1975,5.827.678.571
17/10/2018 20:00,44.12,43659,159,9,80,1719,9,1976,5.827.678.571
17/10/2018 21:00,42.93,42288,162,9,87,1785,9,2052,5.827.678.571
17/10/2018 22:00,42.08,40254,172,9,91,1819,9,2100,5.827.678.571
17/10/2018 23:00,41.01,37941,214,11,70,1898,9,2202,5.827.678.571
18/10/2018 00:00,40.43,35945,352,14,65,1810,9,2250,5.827.678.571
18/10/2018 01:00,39.95,35273,494,17,57,1855,9,2432,5.827.678.571
18/10/2018 02:00,39.37,35046,625,19,51,1747,11,2453,5.827.678.571
18/10/2018 03:00,40.04,35197,796,20,48,1719,11,2594,5.827.678.571
18/10/2018 04:00,40.67,35921,1057,22,45,1696,10,2830,5.827.678.571
18/10/2018 05:00,42.33,38072,1163,24,44,1814,12,3057,5.827.678.571
18/10/2018 06:00,42.89,42062,1193,25,46,1920,13,3197,5.827.678.571
18/10/2018 07:00,46.73,45435,1283,25,44,1983,13,3348,5.827.678.571
18/10/2018 08:00,47.29,46332,1314,24,33,1907,12,3290,5.827.678.571
18/10/2018 09:00,47.26,46420,1348,23,24,1953,8,3356,5.827.678.571
18/10/2018 10:00,46.89,46400,1477,23,17,2037,8,3562,5.827.678.571
18/10/2018 11:00,44.98,46022,1687,24,14,2136,9,3870,5.827.678.571
18/10/2018 12:00,44.59,45505,1769,27,14,2172,8,3990,5.827.678.571
18/10/2018 13:00,43.95,45170,1649,30,15,2346,6,4046,5.827.678.571
18/10/2018 14:00,43.34,44954,1520,36,16,2424,3,3999,5.827.678.571
18/10/2018 15:00,42.97,44849,1423,43,17,2579,3,4065,5.827.678.571
18/10/2018 16:00,42.9,45115,1339,51,20,2756,3,4169,5.827.678.571
18/10/2018 17:00,44.16,45975,1175,58,23,2819,4,4079,5.827.678.571
18/10/2018 18:00,44.89,46685,1111,64,26,2931,4,4136,5.827.678.571
18/10/2018 19:00,45.66,46589,1077,70,27,2987,5,4166,5.827.678.571
18/10/2018 20:00,43,45284,1000,73,29,2971,6,4079,5.827.678.571
18/10/2018 21:00,42.32,43814,826,74,32,2885,6,3823,5.827.678.571
18/10/2018 22:00,41.45,41764,636,72,32,2776,5,3521,5.827.678.571
18/10/2018 23:00,39.89,39261,510,68,54,2673,6,3311,5.827.678.571
19/10/2018 00:00,39.84,37627,541,68,52,2595,6,3262,5.827.678.571
19/10/2018 01:00,39.57,36819,467,67,53,2521,6,3114,5.827.678.571
19/10/2018 02:00,38.82,36635,364,67,48,2452,5,2936,5.827.678.571
19/10/2018 03:00,39.11,36766,296,69,47,2313,4,2729,5.827.678.571
19/10/2018 04:00,40.01,37402,267,71,44,2315,3,2700,5.827.678.571
19/10/2018 05:00,41.58,39669,271,74,39,2230,3,2617,5.827.678.571
19/10/2018 06:00,44.25,43732,272,76,38,2120,2,2508,5.827.678.571
19/10/2018 07:00,44.72,47132,270,73,33,1956,2,2334,5.827.678.571
19/10/2018 08:00,46.03,48048,261,71,24,1792,2,2150,5.827.678.571
19/10/2018 09:00,46.5,48073,250,66,11,1488,2,1817,5.827.678.571
19/10/2018 10:00,46.58,47901,247,64,7,1312,2,1632,5.827.678.571
19/10/2018 11:00,45.66,47060,297,65,6,1129,2,1499,5.827.678.571
19/10/2018 12:00,44.59,46164,399,64,5,988,2,1458,5.827.678.571
19/10/2018 13:00,44.05,45406,464,63,5,848,2,1382,5.827.678.571
19/10/2018 14:00,43.76,44754,457,60,5,764,2,1288,5.827.678.571
19/10/2018 15:00,43.37,44388,447,61,6,736,2,1252,5.827.678.571
19/10/2018 16:00,43.96,44699,419,57,9,761,2,1248,5.827.678.571
19/10/2018 17:00,45.37,45566,383,58,13,860,2,1316,5.827.678.571
19/10/2018 18:00,46.54,46195,428,60,16,959,2,1465,5.827.678.571
19/10/2018 19:00,46.11,45785,505,63,19,1071,2,1660,5.827.678.571
19/10/2018 20:00,43.87,44144,556,69,18,1118,2,1763,5.827.678.571
19/10/2018 21:00,42.51,42727,579,77,15,1173,2,1846,5.827.678.571
19/10/2018 22:00,41.78,41031,643,74,13,1207,2,1939,5.827.678.571
19/10/2018 23:00,41.37,39100,751,103,6,1138,1,1999,5.827.678.571
20/10/2018 00:00,41.56,37711,858,99,6,1090,2,2055,5.827.678.571
20/10/2018 01:00,41.23,36986,998,96,8,1081,2,2185,5.827.678.571
20/10/2018 02:00,40.98,36500,1142,97,11,1021,2,2273,5.827.678.571
20/10/2018 03:00,40.47,36383,1253,93,13,969,2,2330,5.827.678.571
20/10/2018 04:00,40.6,36592,1319,92,15,991,2,2419,5.827.678.571
20/10/2018 05:00,41.16,37275,1393,90,17,1018,2,2520,5.827.678.571
20/10/2018 06:00,41.26,38196,1524,87,21,1085,2,2719,5.827.678.571
20/10/2018 07:00,41.39,39466,1569,82,25,1065,3,2744,5.827.678.571
20/10/2018 08:00,41.75,41056,1514,77,27,984,3,2605,5.827.678.571
20/10/2018 09:00,42.43,42521,1431,70,30,841,2,2374,5.827.678.571
20/10/2018 10:00,42.94,43066,1370,66,36,832,2,2306,5.827.678.571
20/10/2018 11:00,42.57,42859,1406,64,56,888,4,2418,5.827.678.571
20/10/2018 12:00,41.85,42357,1440,62,70,869,7,2448,5.827.678.571
20/10/2018 13:00,41.53,41875,1473,62,79,880,7,2501,5.827.678.571
20/10/2018 14:00,41.43,41473,1531,65,76,843,5,2520,5.827.678.571
20/10/2018 15:00,41.5,41492,1526,71,73,801,4,2475,5.827.678.571
20/10/2018 16:00,41.71,42114,1496,78,67,825,4,2470,5.827.678.571
20/10/2018 17:00,44.37,43654,1214,85,60,944,3,2306,5.827.678.571
20/10/2018 18:00,45.86,44795,1022,92,51,1065,3,2233,5.827.678.571
20/10/2018 19:00,45.15,44175,868,99,45,1248,4,2264,5.827.678.571
20/10/2018 20:00,43.41,42665,750,105,36,1248,3,2142,5.827.678.571
20/10/2018 21:00,42.99,41636,667,111,31,1332,3,2144,5.827.678.571
20/10/2018 22:00,41.97,40504,596,110,24,1586,3,2319,5.827.678.571
20/10/2018 23:00,40.77,39201,563,109,3,2144,1,2820,5.827.678.571
21/10/2018 00:00,42.57,37971,488,110,3,2486,1,3088,5.827.678.571
21/10/2018 01:00,42.11,37099,540,109,3,2807,1,3460,5.827.678.571
21/10/2018 02:00,40.53,36371,579,106,3,3068,1,3757,5.827.678.571
21/10/2018 03:00,39.43,36447,632,102,3,3314,1,4052,5.827.678.571
21/10/2018 04:00,39.38,36549,714,99,3,3495,1,4312,5.827.678.571
21/10/2018 05:00,40,36917,809,97,1,3500,1,4408,5.827.678.571
21/10/2018 06:00,39.78,37537,910,94,1,3485,2,4492,5.827.678.571
21/10/2018 07:00,39.29,38334,986,90,1,3497,2,4576,5.827.678.571
21/10/2018 08:00,40.71,39721,1032,78,2,3430,2,4544,5.827.678.571
21/10/2018 09:00,41.95,41043,1124,68,2,3407,1,4602,5.827.678.571
21/10/2018 10:00,42.13,41888,1239,63,3,3405,2,4712,5.827.678.571
21/10/2018 11:00,42.13,41840,1422,61,5,3382,2,4872,5.827.678.571
21/10/2018 12:00,41.81,41449,1674,63,7,3407,2,5153,5.827.678.571
21/10/2018 13:00,40.71,41098,1844,67,11,3524,2,5448,5.827.678.571
21/10/2018 14:00,39.82,40979,1974,73,14,3632,3,5696,5.827.678.571
21/10/2018 15:00,39.48,41157,2163,82,16,3659,4,5924,5.827.678.571
21/10/2018 16:00,40.05,41910,2386,95,22,3738,5,6246,5.827.678.571
21/10/2018 17:00,42.07,43223,2429,109,36,3862,9,6445,5.827.678.571
21/10/2018 18:00,42.47,44091,2643,121,58,4012,13,6847,5.827.678.571
21/10/2018 19:00,42.28,43623,2821,129,73,4046,15,7084,5.827.678.571
21/10/2018 20:00,41.57,42270,2867,134,94,4154,16,7265,5.827.678.571
21/10/2018 21:00,40.4,41309,2804,138,120,4238,21,7321,5.827.678.571
21/10/2018 22:00,38.32,39611,2697,136,144,4343,27,7347,5.827.678.571
21/10/2018 23:00,35.08,37672,2614,71,201,4244,32,7162,5.827.678.571
22/10/2018 00:00,24.82,35702,2667,60,221,4166,35,7149,5.822.738.095
22/10/2018 01:00,20.99,35162,2666,52,238,4143,36,7135,5.822.738.095
22/10/2018 02:00,19.95,35117,2736,46,247,4201,37,7267,5.822.738.095
22/10/2018 03:00,21.11,35359,2845,43,256,4245,38,7427,5.822.738.095
22/10/2018 04:00,25.26,36200,2836,44,257,4229,38,7404,5.822.738.095
22/10/2018 05:00,39.17,38733,2834,45,247,4483,38,7647,5.822.738.095
22/10/2018 06:00,42,43379,2884,47,249,4740,37,7957,5.822.738.095
22/10/2018 07:00,43.81,47144,2850,48,244,4847,36,8025,5.822.738.095
22/10/2018 08:00,44.49,48060,2796,47,240,4861,31,7975,5.822.738.095
22/10/2018 09:00,44.32,48045,2833,52,236,4918,27,8066,5.822.738.095
22/10/2018 10:00,43.85,48095,2979,61,227,4994,27,8288,5.822.738.095
22/10/2018 11:00,43.19,47618,3369,70,223,5005,23,8690,5.822.738.095
22/10/2018 12:00,42.75,47030,3707,76,213,5073,25,9094,5.822.738.095
22/10/2018 13:00,42.23,46702,3742,78,207,5024,23,9074,5.822.738.095
22/10/2018 14:00,41.69,46537,3656,76,207,4920,26,8885,5.822.738.095
22/10/2018 15:00,41.8,46614,3549,72,206,4883,26,8736,5.822.738.095
22/10/2018 16:00,42.25,46948,3472,65,201,4784,21,8543,5.822.738.095
22/10/2018 17:00,43.45,48085,3213,56,190,4716,24,8199,5.822.738.095
22/10/2018 18:00,44.09,48744,3174,47,178,4729,27,8155,5.822.738.095
22/10/2018 19:00,43.79,48367,3220,40,161,4595,27,8043,5.822.738.095
22/10/2018 20:00,42.64,46811,3431,35,139,4475,27,8107,5.822.738.095
22/10/2018 21:00,41.54,45221,3617,30,123,4441,24,8235,5.822.738.095
22/10/2018 22:00,39.35,43059,3784,28,115,4368,21,8316,5.822.738.095
22/10/2018 23:00,34.58,40552,3899,240,175,4348,26,8688,5.822.738.095
23/10/2018 00:00,30.36,38691,4441,244,171,4267,18,9141,5.822.738.095
23/10/2018 01:00,17.38,37975,4479,248,178,4073,13,8991,5.822.738.095
23/10/2018 02:00,12.1,37773,4452,251,198,3922,14,8837,5.822.738.095
23/10/2018 03:00,12.97,37882,4507,253,218,3727,19,8724,5.822.738.095
23/10/2018 04:00,22,38430,4454,252,249,3576,27,8558,5.822.738.095
23/10/2018 05:00,34.8,40571,4376,245,284,3442,35,8382,5.822.738.095
23/10/2018 06:00,41.66,44599,4344,237,317,3244,37,8179,5.822.738.095
23/10/2018 07:00,44,48038,4255,223,356,3103,35,7972,5.822.738.095
23/10/2018 08:00,44.21,48735,4173,204,399,3008,32,7816,5.822.738.095
23/10/2018 09:00,43.57,48613,4125,185,436,3026,44,7816,5.822.738.095
23/10/2018 10:00,43.28,48447,4152,170,451,3050,31,7854,5.822.738.095
23/10/2018 11:00,42.79,48071,4395,158,450,3170,22,8195,5.822.738.095
23/10/2018 12:00,41.76,47550,4552,150,444,3299,30,8475,5.822.738.095
23/10/2018 13:00,41.32,47266,4481,147,426,3450,33,8537,5.822.738.095
23/10/2018 14:00,41.43,46982,4414,146,390,3648,41,8639,5.822.738.095
23/10/2018 15:00,40.93,47045,4474,144,356,3914,40,8928,5.822.738.095
23/10/2018 16:00,40.57,47462,4684,141,337,4101,50,9313,5.822.738.095
23/10/2018 17:00,41.55,48491,4505,138,334,4260,54,9291,5.822.738.095
23/10/2018 18:00,42.1,49052,4540,136,322,4440,57,9495,5.822.738.095
23/10/2018 19:00,41.78,48635,4498,129,314,4557,54,9552,5.822.738.095
23/10/2018 20:00,40.25,47180,4543,122,322,4537,52,9576,5.822.738.095
23/10/2018 21:00,38.29,45972,4435,113,328,4547,58,9481,5.822.738.095
23/10/2018 22:00,35.88,44024,4346,101,337,4474,61,9319,5.822.738.095
23/10/2018 23:00,30.02,41679,4215,97,385,4339,52,9088,5.822.738.095
24/10/2018 00:00,29.79,40022,4533,95,405,4279,52,9364,5.822.738.095
24/10/2018 01:00,29.78,39367,4388,93,413,4280,53,9227,5.822.738.095
24/10/2018 02:00,27.4,39183,4211,89,426,4210,52,8988,5.822.738.095
24/10/2018 03:00,29.04,39310,4175,88,436,4181,52,8932,5.822.738.095
24/10/2018 04:00,29.77,39960,4031,92,449,4134,53,8759,5.822.738.095
24/10/2018 05:00,38.34,42092,3880,99,460,4116,53,8608,5.822.738.095
24/10/2018 06:00,42.75,45999,3688,106,468,4058,53,8373,5.822.738.095
24/10/2018 07:00,45.45,49210,3432,111,477,3910,53,7983,5.822.738.095
24/10/2018 08:00,46.22,49791,3139,117,479,3716,53,7504,5.822.738.095
24/10/2018 09:00,46.75,49485,2848,121,479,3482,53,6983,5.822.738.095
24/10/2018 10:00,46.75,49254,2662,131,481,3345,53,6672,5.822.738.095
24/10/2018 11:00,46.35,48884,2765,141,478,3312,53,6749,5.822.738.095
24/10/2018 12:00,45.93,48277,2861,145,478,3288,53,6825,5.822.738.095
24/10/2018 13:00,45.67,47797,2793,144,479,3255,53,6724,5.822.738.095
24/10/2018 14:00,45.46,47457,2739,140,479,3145,52,6555,5.822.738.095
24/10/2018 15:00,45.14,47604,2808,142,474,3093,52,6569,5.822.738.095
24/10/2018 16:00,45.52,47889,2918,123,466,3040,52,6599,5.822.738.095
24/10/2018 17:00,46.1,48743,2649,114,455,2989,50,6257,5.822.738.095
24/10/2018 18:00,46.63,49492,2549,111,439,2994,47,6140,5.822.738.095
24/10/2018 19:00,46.74,49071,2441,108,419,2960,46,5974,5.822.738.095
24/10/2018 20:00,45.53,47657,2470,102,379,2856,39,5846,5.822.738.095
24/10/2018 21:00,44.4,46402,2738,100,337,2703,39,5917,5.822.738.095
24/10/2018 22:00,42.87,44419,2997,95,295,2558,34,5979,5.822.738.095
24/10/2018 23:00,41.19,41948,3125,115,208,2485,19,5952,5.822.738.095
25/10/2018 00:00,40.95,40345,4197,127,162,2401,17,6904,5.822.738.095
25/10/2018 01:00,38.54,39706,4422,134,137,2440,17,7150,5.822.738.095
25/10/2018 02:00,37.63,39407,4444,146,127,2553,19,7289,5.822.738.095
25/10/2018 03:00,37.76,39503,4512,158,119,2673,19,7481,5.822.738.095
25/10/2018 04:00,38.23,40106,4462,163,109,2736,17,7487,5.822.738.095
25/10/2018 05:00,40.97,42198,4402,165,96,2746,13,7422,5.822.738.095
25/10/2018 06:00,45.18,46066,4384,174,86,2752,12,7408,5.822.738.095
25/10/2018 07:00,47.47,49208,4285,176,84,2694,10,7249,5.822.738.095
25/10/2018 08:00,47.66,49917,4174,178,91,2594,9,7046,5.822.738.095
25/10/2018 09:00,47.53,49756,4097,177,99,2512,7,6892,5.822.738.095
25/10/2018 10:00,46.82,49555,4085,177,97,2527,7,6893,5.822.738.095
25/10/2018 11:00,46.38,48987,4290,173,86,2513,7,7069,5.822.738.095
25/10/2018 12:00,45.1,48359,4446,174,72,2511,7,7210,5.822.738.095
25/10/2018 13:00,44.6,47956,4366,167,66,2387,7,6993,5.822.738.095
25/10/2018 14:00,44.81,47691,4270,158,69,2268,7,6772,5.822.738.095
25/10/2018 15:00,45.37,47617,4283,152,78,2163,7,6683,5.822.738.095
25/10/2018 16:00,46.22,48096,4386,144,88,2081,7,6706,5.822.738.095
25/10/2018 17:00,47.06,49256,4089,130,87,1936,7,6249,5.822.738.095
25/10/2018 18:00,47.95,49782,3923,114,92,1764,7,5900,5.822.738.095
25/10/2018 19:00,47.98,49404,3700,100,90,1583,7,5480,5.822.738.095
25/10/2018 20:00,46.93,48079,3513,87,87,1416,7,5110,5.822.738.095
25/10/2018 21:00,46.25,46720,3196,72,85,1253,9,4615,5.822.738.095
25/10/2018 22:00,45.23,44712,2884,55,82,1132,9,4162,5.822.738.095
25/10/2018 23:00,44.3,42441,2556,19,68,1064,18,3725,5.822.738.095
26/10/2018 00:00,45,41133,2272,13,66,1005,17,3373,5.822.738.095
26/10/2018 01:00,44.76,40301,1996,9,69,1010,18,3102,5.822.738.095
26/10/2018 02:00,44.82,39992,1706,11,71,986,18,2792,5.822.738.095
26/10/2018 03:00,45.18,40067,1460,15,74,917,19,2485,5.822.738.095
26/10/2018 04:00,45.77,40679,1195,17,72,882,21,2187,5.822.738.095
26/10/2018 05:00,47.33,42904,1020,19,67,809,23,1938,5.822.738.095
26/10/2018 06:00,48.66,47096,1035,17,58,767,24,1901,5.822.738.095
26/10/2018 07:00,58.31,50713,1097,11,52,662,21,1843,5.822.738.095
26/10/2018 08:00,61.51,51405,1172,8,40,529,18,1767,5.822.738.095
26/10/2018 09:00,56.46,51298,1353,5,37,483,16,1894,5.822.738.095
26/10/2018 10:00,55.07,51282,1560,4,37,484,15,2100,5.822.738.095
26/10/2018 11:00,51.25,50733,1749,3,39,550,14,2355,5.822.738.095
26/10/2018 12:00,49.28,49880,1890,3,45,639,14,2591,5.822.738.095
26/10/2018 13:00,48.19,49225,1892,3,47,746,13,2701,5.822.738.095
26/10/2018 14:00,47.79,48617,1788,3,43,907,12,2753,5.822.738.095
26/10/2018 15:00,47.69,48370,1603,4,42,1114,12,2775,5.822.738.095
26/10/2018 16:00,47.9,48722,1465,6,53,1320,12,2856,5.822.738.095
26/10/2018 17:00,49.72,49668,1316,7,68,1526,12,2929,5.822.738.095
26/10/2018 18:00,51.37,50233,1352,9,92,1728,12,3193,5.822.738.095
26/10/2018 19:00,50.03,49339,1308,9,123,1921,12,3373,5.822.738.095
26/10/2018 20:00,47.19,47568,1328,10,157,2076,13,3584,5.822.738.095
26/10/2018 21:00,46.96,46265,1550,10,188,2205,13,3966,5.822.738.095
26/10/2018 22:00,44.25,44602,1769,14,215,2341,15,4354,5.822.738.095
26/10/2018 23:00,42.5,42696,2049,23,226,2643,13,4954,5.822.738.095
27/10/2018 00:00,42.96,41266,2759,25,258,2794,15,5851,5.822.738.095
27/10/2018 01:00,40.98,40521,2887,27,280,2914,19,6127,5.822.738.095
27/10/2018 02:00,39.65,40095,3108,28,293,3035,26,6490,5.822.738.095
27/10/2018 03:00,38.88,40055,3525,27,305,3133,28,7018,5.822.738.095
27/10/2018 04:00,39.27,40337,3627,25,314,3227,23,7216,5.822.738.095
27/10/2018 05:00,40.2,41171,3647,24,321,3283,31,7306,5.822.738.095
27/10/2018 06:00,40.6,42314,3592,23,323,3365,25,7328,5.822.738.095
27/10/2018 07:00,43.38,43709,3485,22,335,3432,20,7294,5.822.738.095
27/10/2018 08:00,44.71,45374,3399,17,354,3527,25,7322,5.822.738.095
27/10/2018 09:00,45.59,46805,3355,13,380,3633,24,7405,5.822.738.095
27/10/2018 10:00,46,47452,3302,10,391,3712,22,7437,5.822.738.095
27/10/2018 11:00,46.09,47412,3312,8,405,3677,20,7422,5.822.738.095
27/10/2018 12:00,45.6,47044,3191,7,420,3601,12,7231,5.822.738.095
27/10/2018 13:00,45.47,46598,2834,5,423,3532,16,6810,5.822.738.095
27/10/2018 14:00,45.48,46276,2533,4,420,3480,27,6464,5.822.738.095
27/10/2018 15:00,45.25,46342,2311,4,418,3442,30,6205,5.822.738.095
27/10/2018 16:00,46.09,47221,2226,4,417,3421,20,6088,5.822.738.095
27/10/2018 17:00,46.77,48716,2031,4,414,3383,24,5856,5.822.738.095
27/10/2018 18:00,47.62,49594,1921,4,407,3325,23,5680,5.822.738.095
27/10/2018 19:00,46.95,48576,1837,5,394,3240,28,5504,5.822.738.095
27/10/2018 20:00,46.14,46918,1688,5,375,3077,21,5166,5.822.738.095
27/10/2018 21:00,45.82,45806,1590,5,356,2939,20,4910,5.822.738.095
27/10/2018 22:00,45.82,44632,1436,5,333,2822,13,4609,5.822.738.095
27/10/2018 23:00,44.23,43391,1321,7,337,2681,37,4383,5.822.738.095
28/10/2018 00:00,44.53,42676,1112,7,304,2586,34,4043,5.822.738.095
28/10/2018 01:00,43.58,41747,1052,8,262,2483,26,3831,5.822.738.095
28/10/2018 02:00,41.605,41012.5,1053,11,222,2427,26,3739,5.822.738.095
28/10/2018 03:00,40.12,41106,1059,13,168,2313,26,3579,5.822.738.095
28/10/2018 04:00,40.01,41373,1146,17,138,2271,22,3594,5.822.738.095
28/10/2018 05:00,40.93,41926,1304,21,116,2202,18,3661,5.822.738.095
28/10/2018 06:00,41.94,42791,1529,27,97,2165,18,3836,5.822.738.095
28/10/2018 07:00,43.59,43663,1630,32,83,2013,15,3773,5.822.738.095
28/10/2018 08:00,45.02,44962,1688,37,75,1831,14,3645,5.822.738.095
28/10/2018 09:00,45.92,46141,1722,43,70,1641,10,3486,5.822.738.095
28/10/2018 10:00,46.21,46976,1888,55,71,1527,8,3549,5.822.738.095
28/10/2018 11:00,45.9,47049,2053,72,77,1428,9,3639,5.822.738.095
28/10/2018 12:00,45.61,46772,2111,89,80,1353,9,3642,5.822.738.095
28/10/2018 13:00,44.96,46587,2134,103,86,1249,9,3581,5.822.738.095
28/10/2018 14:00,44.38,46655,2190,120,99,1222,11,3642,5.822.738.095
28/10/2018 15:00,45.19,47132,2339,141,109,1193,9,3791,5.822.738.095
28/10/2018 16:00,45.84,48378,2307,165,125,1271,9,3877,5.822.738.095
28/10/2018 17:00,47.74,50199,2458,187,144,1406,8,4203,5.822.738.095
28/10/2018 18:00,47.74,50677,2635,202,163,1563,11,4574,5.822.738.095
28/10/2018 19:00,46.28,49986,2743,213,175,1673,13,4817,5.822.738.095
28/10/2018 20:00,44.98,48816,2806,221,188,1765,12,4992,5.822.738.095
28/10/2018 21:00,44.24,48044,2824,230,203,1813,12,5082,5.822.738.095
28/10/2018 22:00,42.58,46541,2838,180,215,1877,12,5122,5.822.738.095
28/10/2018 23:00,40.99,44724,2968,120,242,1960,10,5300,5.822.738.095
29/10/2018 00:00,40.42,44069,2833,19,223,1986,15,5076,5.733.690.476
29/10/2018 01:00,39.92,43577,2927,25,237,2058,14,5261,5.733.690.476
29/10/2018 02:00,39.52,43336,3010,28,255,2168,14,5475,5.733.690.476
29/10/2018 03:00,39.92,43501,3005,30,276,2220,15,5546,5.733.690.476
29/10/2018 04:00,40.58,44231,3030,31,295,2302,16,5674,5.733.690.476
29/10/2018 05:00,43.76,46587,3105,29,316,2370,19,5839,5.733.690.476
29/10/2018 06:00,46.21,50973,3149,29,335,2439,19,5971,5.733.690.476
29/10/2018 07:00,49.32,54496,3130,26,345,2460,21,5982,5.733.690.476
29/10/2018 08:00,50.41,55212,3115,26,361,2453,26,5981,5.733.690.476
29/10/2018 09:00,49.63,55003,3222,25,376,2514,28,6165,5.733.690.476
29/10/2018 10:00,48.65,54760,3537,24,382,2666,27,6636,5.733.690.476
29/10/2018 11:00,47.64,54247,3890,22,395,2771,33,7111,5.733.690.476
29/10/2018 12:00,47.01,53560,4003,19,403,2904,31,7360,5.733.690.476
29/10/2018 13:00,46.62,53380,4004,19,411,3035,31,7500,5.733.690.476
29/10/2018 14:00,46.26,53261,4080,18,410,3167,30,7705,5.733.690.476
29/10/2018 15:00,46.34,53520,4190,17,411,3330,29,7977,5.733.690.476
29/10/2018 16:00,47.02,54264,3976,16,410,3509,32,7943,5.733.690.476
29/10/2018 17:00,47.58,55404,4039,13,413,3649,39,8153,5.733.690.476
29/10/2018 18:00,47.36,55080,4087,14,414,3776,40,8331,5.733.690.476
29/10/2018 19:00,45.7,54300,4161,12,411,3914,40,8538,5.733.690.476
29/10/2018 20:00,45.02,52747,4123,11,410,4005,37,8586,5.733.690.476
29/10/2018 21:00,43.26,51185,4139,11,413,4124,37,8724,5.733.690.476
29/10/2018 22:00,41.18,49117,4074,12,413,4152,40,8691,5.733.690.476
29/10/2018 23:00,39.09,46651,4263,20,420,4266,41,9010,5.733.690.476
30/10/2018 00:00,40.01,44931,4158,56,424,4282,40,8960,5.733.690.476
30/10/2018 01:00,39.19,44057,4111,58,429,4374,39,9011,5.733.690.476
30/10/2018 02:00,38.57,43712,4141,61,428,4451,39,9120,5.733.690.476
30/10/2018 03:00,38.91,43766,4078,64,430,4525,40,9137,5.733.690.476
30/10/2018 04:00,39.62,44319,4051,68,434,4558,43,9154,5.733.690.476
30/10/2018 05:00,41.04,46512,4094,72,443,4539,42,9190,5.733.690.476
30/10/2018 06:00,42.91,50553,4086,79,452,4628,42,9287,5.733.690.476
30/10/2018 07:00,44.85,53748,4015,87,454,4619,43,9218,5.733.690.476
30/10/2018 08:00,44.78,54192,3917,92,453,4631,44,9137,5.733.690.476
30/10/2018 09:00,44.2,54129,3893,100,450,4610,46,9099,5.733.690.476
30/10/2018 10:00,43.95,54080,3988,112,450,4628,46,9224,5.733.690.476
30/10/2018 11:00,44.06,53744,3887,127,450,4630,47,9141,5.733.690.476
30/10/2018 12:00,43.8,53185,3533,139,449,4589,47,8757,5.733.690.476
30/10/2018 13:00,43.73,53037,3260,149,452,4494,46,8401,5.733.690.476
30/10/2018 14:00,43.88,52811,3190,162,453,4412,46,8263,5.733.690.476
30/10/2018 15:00,44.63,52857,3249,178,457,4336,46,8266,5.733.690.476
30/10/2018 16:00,45.35,53386,3103,191,459,4285,46,8084,5.733.690.476
30/10/2018 17:00,46.3,54148,3110,196,458,4205,46,8015,5.733.690.476
30/10/2018 18:00,46.07,53916,3138,198,451,4022,46,7855,5.733.690.476
30/10/2018 19:00,44.89,52882,3147,196,441,3830,45,7659,5.733.690.476
30/10/2018 20:00,44,51169,2919,194,424,3622,42,7201,5.733.690.476
30/10/2018 21:00,42.75,49573,2649,189,403,3493,40,6774,5.733.690.476
30/10/2018 22:00,40.26,47205,2590,186,384,3454,37,6651,5.733.690.476
30/10/2018 23:00,39.04,44747,2632,188,371,3441,33,6665,5.733.690.476
31/10/2018 00:00,37.24,42366,2568,201,370,3416,36,6591,5.733.690.476
31/10/2018 01:00,37.03,41450,2549,201,366,3566,36,6718,5.733.690.476
31/10/2018 02:00,36.84,41049,2565,199,366,3676,35,6841,5.733.690.476
31/10/2018 03:00,37.03,41110,2551,197,364,3819,37,6968,5.733.690.476
31/10/2018 04:00,38.42,41712,2683,196,361,3960,31,7231,5.733.690.476
31/10/2018 05:00,40.84,43842,3069,194,347,3958,33,7601,5.733.690.476
31/10/2018 06:00,43.67,47959,3435,195,328,3981,31,7970,5.733.690.476
31/10/2018 07:00,45.57,51192,3651,199,308,3906,31,8095,5.733.690.476
31/10/2018 08:00,45.45,51691,3798,202,274,3946,29,8249,5.733.690.476
31/10/2018 09:00,44.66,51471,3895,201,247,3984,29,8356,5.733.690.476
31/10/2018 10:00,44.09,51403,3976,199,219,4055,30,8479,5.733.690.476
31/10/2018 11:00,44.41,51215,3778,199,190,4125,37,8329,5.733.690.476
31/10/2018 12:00,44.42,50702,3257,200,157,4144,37,7795,5.733.690.476
31/10/2018 13:00,44.73,50566,2678,201,124,4180,33,7216,5.733.690.476
31/10/2018 14:00,45.44,50362,2105,202,100,4147,27,6581,5.733.690.476
31/10/2018 15:00,46.69,50653,1628,207,90,4059,24,6008,5.733.690.476
31/10/2018 16:00,47.35,51311,1293,215,84,4106,18,5716,5.733.690.476
31/10/2018 17:00,47.93,52222,1127,217,80,4069,17,5510,5.733.690.476
31/10/2018 18:00,47.65,52077,1014,218,80,3964,16,5292,5.733.690.476
31/10/2018 19:00,45.51,51152,1027,219,74,3833,14,5167,5.733.690.476
31/10/2018 20:00,44.66,49473,1162,221,62,3620,12,5077,5.733.690.476
31/10/2018 21:00,43.66,47994,1227,221,50,3428,10,4936,5.733.690.476
31/10/2018 22:00,42.21,45784,1227,220,39,3256,11,4753,5.733.690.476
31/10/2018 23:00,40.23,43438,1275,217,33,3056,8,4589,5.733.690.476
01/11/2018 00:00,41.05,41453,1368,217,0,2809,8,4402,5.733.690.476
01/11/2018 01:00,41.1,40671,1509,216,0,2719,7,4451,5.733.690.476
01/11/2018 02:00,40.59,40339,1754,216,0,2605,6,4581,5.733.690.476
01/11/2018 03:00,40.09,40527,1981,216,0,2486,4,4687,5.733.690.476
01/11/2018 04:00,40.07,41238,2153,218,0,2411,6,4788,5.733.690.476
01/11/2018 05:00,42.78,43508,2279,218,0,2319,6,4822,5.733.690.476
01/11/2018 06:00,44.05,47794,2400,216,0,2294,7,4917,5.733.690.476
01/11/2018 07:00,44.56,51258,2442,212,0,2151,8,4813,5.733.690.476
01/11/2018 08:00,45.36,51863,2462,206,0,1957,8,4633,5.733.690.476
01/11/2018 09:00,45.08,51581,2490,201,0,1797,8,4496,5.733.690.476
01/11/2018 10:00,45.4,51331,2501,193,0,1645,5,4344,5.733.690.476
01/11/2018 11:00,45.93,50705,2359,184,0,1521,3,4067,5.733.690.476
01/11/2018 12:00,46.27,50067,2117,183,0,1384,3,3687,5.733.690.476
01/11/2018 13:00,47.07,49909,2024,177,0,1410,4,3615,5.733.690.476
01/11/2018 14:00,46.74,49975,2025,172,0,1511,6,3714,5.733.690.476
01/11/2018 15:00,46.71,50091,2019,169,0,1759,10,3957,5.733.690.476
01/11/2018 16:00,47.45,50972,1930,171,0,2004,18,4123,5.733.690.476
01/11/2018 17:00,48.36,52176,1952,170,0,2214,19,4355,5.733.690.476
01/11/2018 18:00,49.06,51899,1909,168,0,2340,19,4436,5.733.690.476
01/11/2018 19:00,47.54,51031,1806,164,0,2262,18,4250,5.733.690.476
01/11/2018 20:00,46.19,49471,1525,161,0,2195,16,3897,5.733.690.476
01/11/2018 21:00,44.79,47937,1209,158,0,2094,19,3480,5.733.690.476
01/11/2018 22:00,43.9,45665,1048,148,0,1939,18,3153,5.733.690.476
01/11/2018 23:00,41.93,43259,1029,135,0,1882,19,3065,5.733.690.476
02/11/2018 00:00,42.22,40422,732,149,330,2018,27,3256,5.733.690.476
02/11/2018 01:00,40.98,39552,809,133,329,1988,26,3285,5.733.690.476
02/11/2018 02:00,40.8,39246,902,115,320,2030,29,3396,5.733.690.476
02/11/2018 03:00,40.55,39278,1086,101,306,2049,29,3571,5.733.690.476
02/11/2018 04:00,41.16,39863,1391,87,288,2075,26,3867,5.733.690.476
02/11/2018 05:00,44.04,42183,1763,78,262,2142,27,4272,5.733.690.476
02/11/2018 06:00,45.56,46087,2060,72,240,2201,26,4599,5.733.690.476
02/11/2018 07:00,47.25,49468,2290,63,219,2267,25,4864,5.733.690.476
02/11/2018 08:00,47.62,50186,2383,51,194,2216,26,4870,5.733.690.476
02/11/2018 09:00,46.61,49982,2501,37,160,2224,25,4947,5.733.690.476
02/11/2018 10:00,45.83,50080,2773,26,128,2226,24,5177,5.733.690.476
02/11/2018 11:00,45.07,49559,3015,19,97,2241,24,5396,5.733.690.476
02/11/2018 12:00,45.27,48778,3132,15,72,2262,26,5507,5.733.690.476
02/11/2018 13:00,45.86,48247,3141,16,57,2286,24,5524,5.733.690.476
02/11/2018 14:00,45.4,47904,3099,20,60,2294,23,5496,5.733.690.476
02/11/2018 15:00,45.05,48165,2980,29,59,2374,22,5464,5.733.690.476
02/11/2018 16:00,46.04,49246,2751,37,58,2352,23,5221,5.733.690.476
02/11/2018 17:00,46.92,49760,2701,41,63,2385,22,5212,5.733.690.476
02/11/2018 18:00,46.64,49070,2641,44,66,2444,22,5217,5.733.690.476
02/11/2018 19:00,44.89,47837,2535,45,69,2434,22,5105,5.733.690.476
02/11/2018 20:00,44.2,45874,2360,47,67,2487,23,4984,5.733.690.476
02/11/2018 21:00,43.94,44440,2152,50,65,2561,24,4852,5.733.690.476
02/11/2018 22:00,43.45,42702,1988,56,65,2583,24,4716,5.733.690.476
02/11/2018 23:00,42.54,40831,1937,61,74,2612,23,4707,5.733.690.476
03/11/2018 00:00,42.87,38955,1487,14,57,2749,14,4321,5.733.690.476
03/11/2018 01:00,42.15,38072,1358,23,53,2877,12,4323,5.733.690.476
03/11/2018 02:00,41.7,37657,1221,36,52,2952,15,4276,5.733.690.476
03/11/2018 03:00,41.64,37634,1083,53,53,3046,18,4253,5.733.690.476
03/11/2018 04:00,41.92,37890,946,68,57,3093,17,4181,5.733.690.476
03/11/2018 05:00,42.85,38725,814,81,64,3061,16,4036,5.733.690.476
03/11/2018 06:00,43.19,39874,758,94,67,3010,17,3946,5.733.690.476
03/11/2018 07:00,43.54,41143,756,107,67,2951,15,3896,5.733.690.476
03/11/2018 08:00,44.17,42894,785,121,69,2770,12,3757,5.733.690.476
03/11/2018 09:00,44.95,44401,818,139,76,2476,16,3525,5.733.690.476
03/11/2018 10:00,45.28,45085,871,156,85,2257,20,3389,5.733.690.476
03/11/2018 11:00,45.01,44992,967,170,98,1993,21,3249,5.733.690.476
03/11/2018 12:00,44.5,44636,1066,182,109,1891,17,3265,5.733.690.476
03/11/2018 13:00,44.29,44344,1172,191,115,1778,19,3275,5.733.690.476
03/11/2018 14:00,44.6,44267,1234,197,116,1741,17,3305,5.733.690.476
03/11/2018 15:00,44.7,44894,1305,202,113,1792,11,3423,5.733.690.476
03/11/2018 16:00,45.61,46543,1285,204,109,1991,8,3597,5.733.690.476
03/11/2018 17:00,46.28,48015,1443,204,104,2165,8,3924,5.733.690.476
03/11/2018 18:00,45.82,47930,1595,204,98,2417,7,4321,5.733.690.476
03/11/2018 19:00,44.89,46835,1642,207,87,2565,6,4507,5.733.690.476
03/11/2018 20:00,44.21,45205,1661,207,75,2563,5,4511,5.733.690.476
03/11/2018 21:00,43.75,44367,1692,206,58,2565,4,4525,5.733.690.476
03/11/2018 22:00,42.33,43008,1778,204,48,2525,4,4559,5.733.690.476
03/11/2018 23:00,41.44,41399,1842,221,40,2477,3,4583,5.733.690.476
04/11/2018 00:00,42.44,39696,1844,218,19,2516,8,4605,5.733.690.476
04/11/2018 01:00,42.06,38850,1857,206,12,2533,8,4616,5.733.690.476
04/11/2018 02:00,41.9,38128,1870,204,9,2478,8,4569,5.733.690.476
04/11/2018 03:00,41.19,38368,1847,194,8,2463,8,4520,5.733.690.476
04/11/2018 04:00,41.03,38683,1838,182,7,2435,8,4470,5.733.690.476
04/11/2018 05:00,41.31,39292,1842,169,8,2440,8,4467,5.733.690.476
04/11/2018 06:00,41.93,40156,1839,159,11,2471,8,4488,5.733.690.476
04/11/2018 07:00,43.13,41150,1843,150,12,2521,8,4534,5.733.690.476
04/11/2018 08:00,44.02,42565,1827,142,17,2531,8,4525,5.733.690.476
04/11/2018 09:00,44.51,43767,1834,132,20,2580,8,4574,5.733.690.476
04/11/2018 10:00,44.72,44537,1879,118,22,2588,8,4615,5.733.690.476
04/11/2018 11:00,44.68,44495,1811,105,26,2614,8,4564,5.733.690.476
04/11/2018 12:00,44.54,44208,1673,93,33,2644,8,4451,5.733.690.476
04/11/2018 13:00,44.43,44046,1543,83,47,2742,8,4423,5.733.690.476
04/11/2018 14:00,44.42,44202,1342,77,68,2758,8,4253,5.733.690.476
04/11/2018 15:00,44.48,44995,1190,72,100,2859,8,4229,5.733.690.476
04/11/2018 16:00,44.98,46523,1076,71,133,2987,8,4275,5.733.690.476
04/11/2018 17:00,45.57,48095,1123,72,164,2970,10,4339,5.733.690.476
04/11/2018 18:00,45.46,47947,1160,73,191,3011,11,4446,5.733.690.476
04/11/2018 19:00,44.95,47041,1147,72,194,2991,11,4415,5.733.690.476
04/11/2018 20:00,44.64,45801,1021,70,192,2966,12,4261,5.733.690.476
04/11/2018 21:00,44.07,44765,843,65,188,2890,11,3997,5.733.690.476
04/11/2018 22:00,43.73,43112,718,59,183,2762,12,3734,5.733.690.476
04/11/2018 23:00,42.1,41247,592,53,179,2614,12,3450,5.733.690.476
05/11/2018 00:00,40.52,39220,593,65,146,2502,13,3319,5.681.309.524
05/11/2018 01:00,41.61,38624,528,71,139,2448,14,3200,5.681.309.524
05/11/2018 02:00,41.72,38468,542,75,130,2347,12,3106,5.681.309.524
05/11/2018 03:00,40.93,38680,609,82,129,2220,12,3052,5.681.309.524
05/11/2018 04:00,40.56,39512,637,85,135,2107,12,2976,5.681.309.524
05/11/2018 05:00,42.51,41967,735,90,136,1985,13,2959,5.681.309.524
05/11/2018 06:00,45.49,46415,801,95,133,1878,13,2920,5.681.309.524
05/11/2018 07:00,47.81,49932,807,101,134,1746,13,2801,5.681.309.524
05/11/2018 08:00,48.26,50673,833,109,128,1525,14,2609,5.681.309.524
05/11/2018 09:00,47.98,50501,856,114,123,1347,13,2453,5.681.309.524
05/11/2018 10:00,48.52,50510,895,114,121,1170,13,2313,5.681.309.524
05/11/2018 11:00,48.03,50211,952,111,127,1045,12,2247,5.681.309.524
05/11/2018 12:00,47.61,49740,956,111,127,928,11,2133,5.681.309.524
05/11/2018 13:00,47.44,49595,971,108,126,898,11,2114,5.681.309.524
05/11/2018 14:00,47.53,49505,1024,107,133,997,12,2273,5.681.309.524
05/11/2018 15:00,48.35,49880,1133,109,146,1096,13,2497,5.681.309.524
05/11/2018 16:00,49.23,50805,1183,110,153,1246,13,2705,5.681.309.524
05/11/2018 17:00,49.28,51772,1368,113,165,1338,14,2998,5.681.309.524
05/11/2018 18:00,48.12,51118,1535,114,174,1466,13,3302,5.681.309.524
05/11/2018 19:00,47.37,50151,1593,115,178,1513,17,3416,5.681.309.524
05/11/2018 20:00,47.08,48467,1563,114,179,1477,19,3352,5.681.309.524
05/11/2018 21:00,46.3,46851,1522,115,179,1436,20,3272,5.681.309.524
05/11/2018 22:00,44.75,44576,1495,113,178,1446,22,3254,5.681.309.524
05/11/2018 23:00,42.99,41985,1402,113,178,1537,21,3251,5.681.309.524
06/11/2018 00:00,42.92,39797,1179,41,167,1484,8,2879,5.681.309.524
06/11/2018 01:00,42.39,38929,1116,40,164,1410,10,2740,5.681.309.524
06/11/2018 02:00,42.23,38630,1093,37,166,1440,11,2747,5.681.309.524
06/11/2018 03:00,42.14,38790,1099,36,166,1512,13,2826,5.681.309.524
06/11/2018 04:00,42.52,39551,1018,38,171,1603,15,2845,5.681.309.524
06/11/2018 05:00,45.21,41811,976,39,177,1635,15,2842,5.681.309.524
06/11/2018 06:00,47.32,45950,911,40,185,1576,11,2723,5.681.309.524
06/11/2018 07:00,52.1,49221,885,43,186,1501,10,2625,5.681.309.524
06/11/2018 08:00,52.38,49740,826,44,170,1360,10,2410,5.681.309.524
06/11/2018 09:00,50.66,49577,724,46,148,1166,10,2094,5.681.309.524
06/11/2018 10:00,50.03,49574,668,45,133,1046,10,1902,5.681.309.524
06/11/2018 11:00,49.99,49243,589,42,119,841,11,1602,5.681.309.524
06/11/2018 12:00,49.79,48800,519,41,110,764,11,1445,5.681.309.524
06/11/2018 13:00,50.21,48693,480,41,115,689,11,1336,5.681.309.524
06/11/2018 14:00,50.2,48604,464,43,139,647,9,1302,5.681.309.524
06/11/2018 15:00,51.43,49010,435,48,175,696,11,1365,5.681.309.524
06/11/2018 16:00,52.46,49865,442,51,202,744,16,1455,5.681.309.524
06/11/2018 17:00,54.94,50716,511,54,219,759,17,1560,5.681.309.524
06/11/2018 18:00,53.36,50353,624,55,225,794,17,1715,5.681.309.524
06/11/2018 19:00,50.33,49221,726,54,227,787,17,1811,5.681.309.524
06/11/2018 20:00,47.96,47570,790,51,216,733,19,1809,5.681.309.524
06/11/2018 21:00,46.62,46138,825,47,208,665,19,1764,5.681.309.524
06/11/2018 22:00,45.57,43926,867,44,203,622,19,1755,5.681.309.524
06/11/2018 23:00,43.91,41487,886,40,192,588,19,1725,5.681.309.524
07/11/2018 00:00,43.45,39395,804,45,155,483,9,1496,5.681.309.524
07/11/2018 01:00,42.51,38481,926,44,144,488,9,1611,5.681.309.524
07/11/2018 02:00,41.59,38168,1155,44,149,485,10,1843,5.681.309.524
07/11/2018 03:00,40.64,38277,1293,43,154,497,11,1998,5.681.309.524
07/11/2018 04:00,41.77,38979,1314,41,160,523,11,2049,5.681.309.524
07/11/2018 05:00,43.77,41214,1374,40,161,529,11,2115,5.681.309.524
07/11/2018 06:00,46.94,45397,1377,39,172,558,12,2158,5.681.309.524
07/11/2018 07:00,51.84,48748,1374,40,168,547,13,2142,5.681.309.524
07/11/2018 08:00,53.71,49227,1262,42,152,515,11,1982,5.681.309.524
07/11/2018 09:00,52.48,48989,1073,45,130,489,9,1746,5.681.309.524
07/11/2018 10:00,50.76,49026,981,48,114,452,5,1600,5.681.309.524
07/11/2018 11:00,49.62,48780,841,52,103,430,4,1430,5.681.309.524
07/11/2018 12:00,49.84,48356,735,55,97,398,3,1288,5.681.309.524
07/11/2018 13:00,50.94,48250,676,56,102,391,3,1228,5.681.309.524
07/11/2018 14:00,51.18,48224,597,58,118,439,3,1215,5.681.309.524
07/11/2018 15:00,51.97,48688,554,61,144,516,4,1279,5.681.309.524
07/11/2018 16:00,52.72,49545,559,65,161,576,6,1367,5.681.309.524
07/11/2018 17:00,52.96,50437,636,73,167,640,7,1523,5.681.309.524
07/11/2018 18:00,52.07,50012,765,77,173,649,8,1672,5.681.309.524
07/11/2018 19:00,50.74,48906,838,79,168,638,7,1730,5.681.309.524
07/11/2018 20:00,47.57,47257,901,77,151,592,4,1725,5.681.309.524
07/11/2018 21:00,46.38,45756,902,71,135,526,3,1637,5.681.309.524
07/11/2018 22:00,44.75,43568,912,65,123,479,2,1581,5.681.309.524
07/11/2018 23:00,43.49,41131,891,58,112,447,3,1511,5.681.309.524
08/11/2018 00:00,43.73,39385,779,57,95,441,3,1375,5.681.309.524
08/11/2018 01:00,43.33,38619,671,56,90,434,6,1257,5.681.309.524
08/11/2018 02:00,42.89,38273,617,56,86,439,4,1202,5.681.309.524
08/11/2018 03:00,42.92,38359,587,54,81,438,3,1163,5.681.309.524
08/11/2018 04:00,43.5,39069,560,52,77,436,3,1128,5.681.309.524
08/11/2018 05:00,45.34,41399,594,50,71,434,2,1151,5.681.309.524
08/11/2018 06:00,48.57,45673,629,47,66,415,1,1158,5.681.309.524
08/11/2018 07:00,51.76,49286,665,44,58,395,1,1163,5.681.309.524
08/11/2018 08:00,52.29,49804,675,40,48,353,1,1117,5.681.309.524
08/11/2018 09:00,50.49,49728,667,35,31,328,0,1061,5.681.309.524
08/11/2018 10:00,48.87,49760,639,28,23,298,0,988,5.681.309.524
08/11/2018 11:00,49.3,49434,598,22,19,266,0,905,5.681.309.524
08/11/2018 12:00,50.14,49151,585,17,17,254,0,873,5.681.309.524
08/11/2018 13:00,51.16,49176,540,15,16,233,0,804,5.681.309.524
08/11/2018 14:00,51.32,49269,446,16,21,251,0,734,5.681.309.524
08/11/2018 15:00,50.91,49556,361,17,30,269,0,677,5.681.309.524
08/11/2018 16:00,51.71,50446,277,20,34,308,0,639,5.681.309.524
08/11/2018 17:00,58.85,51205,248,23,39,339,0,649,5.681.309.524
08/11/2018 18:00,55.59,50535,226,24,44,358,0,652,5.681.309.524
08/11/2018 19:00,49.86,49497,183,24,45,347,0,599,5.681.309.524
08/11/2018 20:00,49.25,47865,128,23,44,343,0,538,5.681.309.524
08/11/2018 21:00,47.49,46260,94,22,42,356,0,514,5.681.309.524
08/11/2018 22:00,45.29,43951,74,18,41,361,0,494,5.681.309.524
08/11/2018 23:00,43.8,41310,55,15,37,389,0,496,5.681.309.524
09/11/2018 00:00,44.95,39221,50,9,15,368,0,442,5.681.309.524
09/11/2018 01:00,44.33,38336,49,8,15,361,0,433,5.681.309.524
09/11/2018 02:00,43.88,37939,61,8,15,337,0,421,5.681.309.524
09/11/2018 03:00,43.91,37980,74,8,15,332,0,429,5.681.309.524
09/11/2018 04:00,44.28,38678,100,9,14,312,0,435,5.681.309.524
09/11/2018 05:00,46.15,41026,139,10,14,282,0,445,5.681.309.524
09/11/2018 06:00,47.65,45122,189,11,16,272,0,488,5.681.309.524
09/11/2018 07:00,51.94,48844,257,12,17,230,0,516,5.681.309.524
09/11/2018 08:00,53.1,49498,326,12,17,189,0,544,5.681.309.524
09/11/2018 09:00,51.53,49452,416,11,13,172,0,612,5.681.309.524
09/11/2018 10:00,51.2,49511,538,9,10,164,0,721,5.681.309.524
09/11/2018 11:00,51.11,49056,663,8,9,164,0,844,5.681.309.524
09/11/2018 12:00,49.93,48667,756,7,9,179,0,951,5.681.309.524
09/11/2018 13:00,50.02,48292,826,5,9,203,0,1043,5.681.309.524
09/11/2018 14:00,49.17,47844,914,5,10,235,0,1164,5.681.309.524
09/11/2018 15:00,50.06,48118,1040,6,13,287,0,1346,5.681.309.524
09/11/2018 16:00,51.14,48877,1180,8,19,343,0,1550,5.681.309.524
09/11/2018 17:00,51.6,49464,1448,9,22,393,0,1872,5.681.309.524
09/11/2018 18:00,48.95,48833,1684,9,28,464,0,2185,5.681.309.524
09/11/2018 19:00,47.17,47458,1862,9,33,514,0,2418,5.681.309.524
09/11/2018 20:00,45.75,45554,1861,9,33,571,0,2474,5.681.309.524
09/11/2018 21:00,45.36,44140,1902,9,35,600,0,2546,5.681.309.524
09/11/2018 22:00,44.23,42324,1885,9,38,666,0,2598,5.681.309.524
09/11/2018 23:00,42.69,40331,1806,9,41,719,0,2575,5.681.309.524
10/11/2018 00:00,42.66,39164,1902,115,15,764,0,2796,5.681.309.524
10/11/2018 01:00,41.43,38251,1959,121,17,822,0,2919,5.681.309.524
10/11/2018 02:00,40.79,37810,2140,122,18,913,0,3193,5.681.309.524
10/11/2018 03:00,40.12,37708,2237,120,18,971,0,3346,5.681.309.524
10/11/2018 04:00,40.03,37920,2271,119,20,1063,0,3473,5.681.309.524
10/11/2018 05:00,40.41,38673,2515,119,25,1225,0,3884,5.681.309.524
10/11/2018 06:00,41.45,39826,2646,116,35,1319,0,4116,5.681.309.524
10/11/2018 07:00,42.06,41342,2857,115,38,1457,0,4467,5.681.309.524
10/11/2018 08:00,42.92,42955,2975,117,40,1666,0,4798,5.681.309.524
10/11/2018 09:00,43.28,44526,3024,119,42,1818,0,5003,5.681.309.524
10/11/2018 10:00,43.74,45319,3246,123,45,1925,0,5339,5.681.309.524
10/11/2018 11:00,43.8,45355,3323,123,52,2090,0,5588,5.681.309.524
10/11/2018 12:00,43.7,45099,3282,122,56,2223,0,5683,5.681.309.524
10/11/2018 13:00,42.83,44856,3088,123,61,2362,0,5634,5.681.309.524
10/11/2018 14:00,43.96,44843,2815,121,71,2498,0,5505,5.681.309.524
10/11/2018 15:00,44.46,45418,2700,111,89,2614,2,5516,5.681.309.524
10/11/2018 16:00,45.12,46679,2432,98,104,2781,2,5417,5.681.309.524
10/11/2018 17:00,45.86,47846,2414,87,116,2982,3,5602,5.681.309.524
10/11/2018 18:00,45.28,47518,2422,80,121,3100,4,5727,5.681.309.524
10/11/2018 19:00,44.32,45855,2394,73,121,3137,5,5730,5.681.309.524
10/11/2018 20:00,42.93,44254,2226,65,119,3189,5,5604,5.681.309.524
10/11/2018 21:00,41.21,43065,2095,56,119,3238,5,5513,5.681.309.524
10/11/2018 22:00,41.19,41827,1977,49,123,3241,4,5394,5.681.309.524
10/11/2018 23:00,39.58,40329,1901,42,127,3268,6,5344,5.681.309.524
11/11/2018 00:00,40.09,38167,2200,30,137,3257,4,5628,5.681.309.524
11/11/2018 01:00,38.33,37201,2196,28,147,3324,5,5700,5.681.309.524
11/11/2018 02:00,37.93,36387,2256,26,164,3415,7,5868,5.681.309.524
11/11/2018 03:00,35.84,36526,2182,24,180,3531,8,5925,5.681.309.524
11/11/2018 04:00,34.88,36690,2042,23,196,3647,9,5917,5.681.309.524
11/11/2018 05:00,34.98,37088,2040,23,216,3754,10,6043,5.681.309.524
11/11/2018 06:00,35.59,37942,2026,24,236,3831,10,6127,5.681.309.524
11/11/2018 07:00,37.68,38858,2100,26,255,3856,12,6249,5.681.309.524
11/11/2018 08:00,39.99,40241,2077,28,268,3874,11,6258,5.681.309.524
11/11/2018 09:00,41.11,41712,2055,27,284,3842,12,6220,5.681.309.524
11/11/2018 10:00,41.97,42922,2137,27,299,3703,16,6182,5.681.309.524
11/11/2018 11:00,42.12,43451,2181,28,301,3640,18,6168,5.681.309.524
11/11/2018 12:00,41.06,43402,2248,28,303,3493,21,6093,5.681.309.524
11/11/2018 13:00,40.25,43292,2219,28,305,3404,22,5978,5.681.309.524
11/11/2018 14:00,40.75,43434,2074,28,315,3417,21,5855,5.681.309.524
11/11/2018 15:00,42.3,44349,2025,31,324,3409,20,5809,5.681.309.524
11/11/2018 16:00,44.67,45892,1960,35,327,3401,20,5743,5.681.309.524
11/11/2018 17:00,45.54,47022,2078,37,327,3407,20,5869,5.681.309.524
11/11/2018 18:00,45.07,46576,2206,38,324,3425,20,6013,5.681.309.524
11/11/2018 19:00,43.75,45669,2306,38,319,3433,20,6116,5.681.309.524
11/11/2018 20:00,42.99,44382,2335,41,311,3332,20,6039,5.681.309.524
11/11/2018 21:00,41.58,43258,2385,43,302,3248,17,5995,5.681.309.524
11/11/2018 22:00,41.6,41566,2317,44,290,3161,18,5830,5.681.309.524
11/11/2018 23:00,38.47,39599,2149,44,273,3127,18,5611,5.681.309.524
12/11/2018 00:00,36.1,37791,2318,9,264,3198,13,5802,5.715.654.762
12/11/2018 01:00,37.8,37175,2067,9,246,3143,13,5478,5.715.654.762
12/11/2018 02:00,38.3,36969,1856,9,237,3093,14,5209,5.715.654.762
12/11/2018 03:00,39.28,37118,1599,9,227,3042,15,4892,5.715.654.762
12/11/2018 04:00,39.07,37935,1376,8,224,2980,16,4604,5.715.654.762
12/11/2018 05:00,43.11,40411,1265,8,229,2938,14,4454,5.715.654.762
12/11/2018 06:00,46.43,44954,1187,8,236,2871,15,4317,5.715.654.762
12/11/2018 07:00,48.8,48670,1152,8,236,2796,14,4206,5.715.654.762
12/11/2018 08:00,49.17,49452,1075,7,228,2666,14,3990,5.715.654.762
12/11/2018 09:00,47.92,49314,1002,7,219,2567,14,3809,5.715.654.762
12/11/2018 10:00,47.54,49412,946,7,208,2497,12,3670,5.715.654.762
12/11/2018 11:00,47.6,49163,955,8,191,2489,12,3655,5.715.654.762
12/11/2018 12:00,47.9,48775,964,9,167,2386,10,3536,5.715.654.762
12/11/2018 13:00,48.33,48599,957,10,162,2390,9,3528,5.715.654.762
12/11/2018 14:00,47.82,48699,840,12,175,2368,8,3403,5.715.654.762
12/11/2018 15:00,49.01,49312,715,14,189,2404,7,3329,5.715.654.762
12/11/2018 16:00,49.76,50379,629,17,198,2400,7,3251,5.715.654.762
12/11/2018 17:00,49.71,51057,692,20,209,2430,9,3360,5.715.654.762
12/11/2018 18:00,49.05,50296,735,22,220,2442,9,3428,5.715.654.762
12/11/2018 19:00,47.52,49264,764,24,233,2424,9,3454,5.715.654.762
12/11/2018 20:00,46.68,47490,712,25,249,2315,10,3311,5.715.654.762
12/11/2018 21:00,45.94,45893,766,27,259,2225,11,3288,5.715.654.762
12/11/2018 22:00,44.42,43570,808,28,275,2099,10,3220,5.715.654.762
12/11/2018 23:00,41.95,41059,814,29,292,2003,10,3148,5.715.654.762
13/11/2018 00:00,42.87,38962,1027,193,336,1745,21,3322,5.715.654.762
13/11/2018 01:00,42.62,38109,1057,197,344,1650,27,3275,5.715.654.762
13/11/2018 02:00,42.5,37755,1108,195,347,1589,31,3270,5.715.654.762
13/11/2018 03:00,42.48,37883,1179,197,349,1473,35,3233,5.715.654.762
13/11/2018 04:00,42.93,38644,1159,196,352,1461,38,3206,5.715.654.762
13/11/2018 05:00,44.98,40982,1202,196,354,1510,43,3305,5.715.654.762
13/11/2018 06:00,49.68,45314,1276,196,352,1513,43,3380,5.715.654.762
13/11/2018 07:00,51.34,48981,1440,195,340,1516,42,3533,5.715.654.762
13/11/2018 08:00,51.85,49582,1564,195,317,1485,45,3606,5.715.654.762
13/11/2018 09:00,51.07,49482,1694,193,298,1394,45,3624,5.715.654.762
13/11/2018 10:00,50.51,49544,1897,190,271,1395,47,3800,5.715.654.762
13/11/2018 11:00,49.79,49349,2123,188,233,1382,48,3974,5.715.654.762
13/11/2018 12:00,48.53,48886,2294,183,196,1331,48,4052,5.715.654.762
13/11/2018 13:00,48.23,48876,2302,181,163,1349,31,4026,5.715.654.762
13/11/2018 14:00,48.67,48914,2148,181,142,1338,27,3836,5.715.654.762
13/11/2018 15:00,50.06,49655,2030,180,127,1377,14,3728,5.715.654.762
13/11/2018 16:00,51.65,50619,1956,178,112,1415,6,3667,5.715.654.762
13/11/2018 17:00,52.37,51189,2031,174,104,1428,3,3740,5.715.654.762
13/11/2018 18:00,51.88,50561,1978,169,102,1443,2,3694,5.715.654.762
13/11/2018 19:00,50.38,49401,1954,164,100,1422,2,3642,5.715.654.762
13/11/2018 20:00,48.05,47692,1934,156,101,1400,2,3593,5.715.654.762
13/11/2018 21:00,46.69,46216,1912,150,106,1339,4,3511,5.715.654.762
13/11/2018 22:00,45.52,43889,1908,145,112,1289,7,3461,5.715.654.762
13/11/2018 23:00,43.68,41269,1894,138,110,1248,6,3396,5.715.654.762
14/11/2018 00:00,43.14,39704,1949,169,0,1148,3,3269,5.715.654.762
14/11/2018 01:00,43.13,38769,1807,166,0,1109,1,3083,5.715.654.762
14/11/2018 02:00,43.15,38465,1667,165,0,1046,2,2880,5.715.654.762
14/11/2018 03:00,44.2,38629,1519,167,0,978,1,2665,5.715.654.762
14/11/2018 04:00,44.94,39429,1348,173,0,912,1,2434,5.715.654.762
14/11/2018 05:00,46.97,41823,1203,181,0,858,1,2243,5.715.654.762
14/11/2018 06:00,51.87,46250,1045,193,0,803,0,2041,5.715.654.762
14/11/2018 07:00,54.31,49981,922,205,0,764,0,1891,5.715.654.762
14/11/2018 08:00,54.58,50394,831,215,0,719,0,1765,5.715.654.762
14/11/2018 09:00,53.8,50154,813,219,0,694,0,1726,5.715.654.762
14/11/2018 10:00,53.53,50175,863,214,0,681,2,1760,5.715.654.762
14/11/2018 11:00,53.54,50011,919,197,0,651,0,1767,5.715.654.762
14/11/2018 12:00,53.25,49678,942,180,0,590,0,1712,5.715.654.762
14/11/2018 13:00,53.66,49707,971,161,0,590,1,1723,5.715.654.762
14/11/2018 14:00,53.73,49859,970,136,0,623,2,1731,5.715.654.762
14/11/2018 15:00,54.23,50657,994,112,0,659,1,1766,5.715.654.762
14/11/2018 16:00,55.31,51672,988,91,0,810,0,1889,5.715.654.762
14/11/2018 17:00,55.78,52334,1054,75,0,1053,0,2182,5.715.654.762
14/11/2018 18:00,54.3,51654,1159,60,0,1334,0,2553,5.715.654.762
14/11/2018 19:00,52.2,50494,1273,49,0,1570,1,2893,5.715.654.762
14/11/2018 20:00,49.66,48721,1361,38,0,1909,1,3309,5.715.654.762
14/11/2018 21:00,48.19,47181,1404,31,0,2150,0,3585,5.715.654.762
14/11/2018 22:00,46.68,44894,1460,26,0,2363,0,3849,5.715.654.762
14/11/2018 23:00,45.17,42388,1485,22,0,2434,0,3941,5.715.654.762
15/11/2018 00:00,44.76,40439,1602,13,16,2665,0,4296,5.715.654.762
15/11/2018 01:00,44.07,39561,1440,13,13,2796,0,4262,5.715.654.762
15/11/2018 02:00,43.77,39113,1347,12,10,2839,0,4208,5.715.654.762
15/11/2018 03:00,43.52,39154,1284,10,9,2905,0,4208,5.715.654.762
15/11/2018 04:00,44.67,39870,1194,10,8,2948,0,4160,5.715.654.762
15/11/2018 05:00,46.18,42283,1117,10,7,2958,0,4092,5.715.654.762
15/11/2018 06:00,47.73,46654,1055,10,5,2926,0,3996,5.715.654.762
15/11/2018 07:00,49.52,50328,1041,11,4,2808,0,3864,5.715.654.762
15/11/2018 08:00,49.65,50731,988,9,4,2640,0,3641,5.715.654.762
15/11/2018 09:00,48.44,50528,905,9,3,2589,0,3506,5.715.654.762
15/11/2018 10:00,48.31,50380,859,8,3,2480,0,3350,5.715.654.762
15/11/2018 11:00,48.29,50100,843,7,3,2376,0,3229,5.715.654.762
15/11/2018 12:00,48.47,49627,822,7,3,2289,0,3121,5.715.654.762
15/11/2018 13:00,49.44,49514,853,7,4,2236,0,3100,5.715.654.762
15/11/2018 14:00,49.75,49645,854,8,5,2237,0,3104,5.715.654.762
15/11/2018 15:00,49.98,50227,837,10,8,2295,2,3152,5.715.654.762
15/11/2018 16:00,51.13,51228,902,10,10,2315,2,3239,5.715.654.762
15/11/2018 17:00,52.09,51786,1101,9,12,2337,3,3462,5.715.654.762
15/11/2018 18:00,51.12,50873,1314,7,15,2351,5,3692,5.715.654.762
15/11/2018 19:00,49.22,49750,1486,5,20,2250,5,3766,5.715.654.762
15/11/2018 20:00,48.05,47967,1572,5,23,2299,7,3906,5.715.654.762
15/11/2018 21:00,47.2,46317,1667,6,28,2353,8,4062,5.715.654.762
15/11/2018 22:00,46.01,43993,1665,6,39,2373,8,4091,5.715.654.762
15/11/2018 23:00,44.97,41441,1625,5,42,2384,11,4067,5.715.654.762
16/11/2018 00:00,44.88,38828,1703,4,28,2517,7,4259,5.715.654.762
16/11/2018 01:00,44.41,37993,1674,4,29,2685,8,4400,5.715.654.762
16/11/2018 02:00,44.05,37677,1651,6,30,2797,9,4493,5.715.654.762
16/11/2018 03:00,44.19,37786,1496,8,30,2911,10,4455,5.715.654.762
16/11/2018 04:00,44.66,38597,1327,11,29,2931,6,4304,5.715.654.762
16/11/2018 05:00,46.43,41042,1349,15,31,3009,6,4410,5.715.654.762
16/11/2018 06:00,47.82,45290,1439,20,29,3022,6,4516,5.715.654.762
16/11/2018 07:00,50.05,49296,1555,25,28,3055,8,4671,5.715.654.762
16/11/2018 08:00,50.33,49950,1566,28,26,3027,8,4655,5.715.654.762
16/11/2018 09:00,49.44,49764,1431,32,20,2984,5,4472,5.715.654.762
16/11/2018 10:00,48.9,49687,1250,36,14,2985,3,4288,5.715.654.762
16/11/2018 11:00,48.66,49104,1086,41,13,2939,2,4081,5.715.654.762
16/11/2018 12:00,48.37,48499,904,47,11,2873,2,3837,5.715.654.762
16/11/2018 13:00,48.36,48076,838,51,10,2850,3,3752,5.715.654.762
16/11/2018 14:00,48.47,47850,808,57,10,2928,2,3805,5.715.654.762
16/11/2018 15:00,48.73,48439,854,64,14,2887,3,3822,5.715.654.762
16/11/2018 16:00,49.09,49510,966,70,16,2924,3,3979,5.715.654.762
16/11/2018 17:00,48.98,50195,1078,75,17,2968,5,4143,5.715.654.762
16/11/2018 18:00,48.57,49589,1211,82,18,3019,5,4335,5.715.654.762
16/11/2018 19:00,47.16,48090,1313,90,21,3011,6,4441,5.715.654.762
16/11/2018 20:00,46.08,46229,1294,96,23,2993,8,4414,5.715.654.762
16/11/2018 21:00,45.76,44872,1270,103,24,2956,6,4359,5.715.654.762
16/11/2018 22:00,45.21,43136,1172,111,25,2888,6,4202,5.715.654.762
16/11/2018 23:00,43.78,41157,1045,114,25,2834,8,4026,5.715.654.762
17/11/2018 00:00,43.71,39309,1301,18,28,2952,11,4310,5.715.654.762
17/11/2018 01:00,39.38,38328,1134,18,26,2892,8,4078,5.715.654.762
17/11/2018 02:00,43.07,37914,963,21,21,2854,8,3867,5.715.654.762
17/11/2018 03:00,42.03,37863,797,24,17,2784,9,3631,5.715.654.762
17/11/2018 04:00,42.87,38087,727,26,14,2750,6,3523,5.715.654.762
17/11/2018 05:00,42.18,38952,745,27,14,2694,7,3487,5.715.654.762
17/11/2018 06:00,44.22,40083,766,29,14,2525,7,3341,5.715.654.762
17/11/2018 07:00,45.23,41724,833,33,15,2535,5,3421,5.715.654.762
17/11/2018 08:00,46.15,43436,849,36,16,2462,4,3367,5.715.654.762
17/11/2018 09:00,46.77,44994,807,41,12,2312,4,3176,5.715.654.762
17/11/2018 10:00,46.74,45681,721,45,11,2317,5,3099,5.715.654.762
17/11/2018 11:00,46.79,45717,601,49,14,2270,8,2942,5.715.654.762
17/11/2018 12:00,46.39,45389,484,51,17,2290,13,2855,5.715.654.762
17/11/2018 13:00,46.39,45130,412,53,22,2304,15,2806,5.715.654.762
17/11/2018 14:00,46.84,45294,343,57,27,2402,8,2837,5.715.654.762
17/11/2018 15:00,48.7,46265,295,62,31,2526,9,2923,5.715.654.762
17/11/2018 16:00,50.03,47743,281,68,36,2581,9,2975,5.715.654.762
17/11/2018 17:00,51.09,48791,266,74,43,2593,7,2983,5.715.654.762
17/11/2018 18:00,50.46,48497,262,81,50,2577,6,2976,5.715.654.762
17/11/2018 19:00,48.75,47000,263,85,57,2567,6,2978,5.715.654.762
17/11/2018 20:00,47.4,45414,240,90,65,2529,6,2930,5.715.654.762
17/11/2018 21:00,47.02,44443,237,91,70,2443,7,2848,5.715.654.762
17/11/2018 22:00,46.9,43164,221,95,77,2387,10,2790,5.715.654.762
17/11/2018 23:00,45.38,41566,191,97,80,2276,11,2655,5.715.654.762
18/11/2018 00:00,46.16,40043,253,94,84,2186,14,2631,5.715.654.762
18/11/2018 01:00,43.83,39134,245,101,93,2069,17,2525,5.715.654.762
18/11/2018 02:00,42.92,38519,236,109,105,2050,22,2522,5.715.654.762
18/11/2018 03:00,43.84,38495,220,119,110,2022,24,2495,5.715.654.762
18/11/2018 04:00,44.24,38750,227,127,119,1981,23,2477,5.715.654.762
18/11/2018 05:00,43.66,39312,324,132,124,2035,24,2639,5.715.654.762
18/11/2018 06:00,44.88,40232,484,139,134,2075,27,2859,5.715.654.762
18/11/2018 07:00,45.4,41442,632,145,147,2004,25,2953,5.715.654.762
18/11/2018 08:00,46.27,42785,722,149,153,1949,20,2993,5.715.654.762
18/11/2018 09:00,47.84,44356,858,151,153,1875,20,3057,5.715.654.762
18/11/2018 10:00,47.84,45534,993,152,160,1779,20,3104,5.715.654.762
18/11/2018 11:00,48.3,46039,1096,155,171,1716,26,3164,5.715.654.762
18/11/2018 12:00,48.75,46048,1238,157,175,1663,26,3259,5.715.654.762
18/11/2018 13:00,48.17,45974,1409,159,181,1615,26,3390,5.715.654.762
18/11/2018 14:00,48.37,46255,1530,162,183,1638,31,3544,5.715.654.762
18/11/2018 15:00,49.74,47372,1638,165,188,1664,28,3683,5.715.654.762
18/11/2018 16:00,50.75,48963,1708,170,192,1698,19,3787,5.715.654.762
18/11/2018 17:00,52.12,49962,1787,174,199,1700,21,3881,5.715.654.762
18/11/2018 18:00,51.54,49563,1828,178,209,1724,20,3959,5.715.654.762
18/11/2018 19:00,49.34,48771,1777,181,216,1705,22,3901,5.715.654.762
18/11/2018 20:00,46.96,47536,1718,182,219,1711,22,3852,5.715.654.762
18/11/2018 21:00,46.15,46606,1705,183,219,1663,21,3791,5.715.654.762
18/11/2018 22:00,46.47,44931,1681,183,215,1623,20,3722,5.715.654.762
18/11/2018 23:00,44.16,42961,1741,182,204,1582,13,3722,5.715.654.762
19/11/2018 00:00,41.96,41739,2004,119,282,1637,15,4057,5.525.357.143
19/11/2018 01:00,41.71,41195,2083,121,273,1633,12,4122,5.525.357.143
19/11/2018 02:00,40.13,41072,2270,120,268,1657,12,4327,5.525.357.143
19/11/2018 03:00,39.91,41286,2433,120,258,1701,12,4524,5.525.357.143
19/11/2018 04:00,41.55,42157,2459,118,246,1736,12,4571,5.525.357.143
19/11/2018 05:00,45.62,44808,2558,118,239,1819,13,4747,5.525.357.143
19/11/2018 06:00,48.33,49607,2614,118,233,1908,11,4884,5.525.357.143
19/11/2018 07:00,52.75,53726,2731,119,229,1943,12,5034,5.525.357.143
19/11/2018 08:00,53.72,54580,2712,126,230,1939,10,5017,5.525.357.143
19/11/2018 09:00,53.04,54557,2713,131,235,1925,9,5013,5.525.357.143
19/11/2018 10:00,52.06,54561,2785,135,237,1916,10,5083,5.525.357.143
19/11/2018 11:00,51.59,54250,2957,137,233,1909,12,5248,5.525.357.143
19/11/2018 12:00,51.12,53915,3082,136,228,1826,12,5284,5.525.357.143
19/11/2018 13:00,51.57,53877,3096,131,215,1809,11,5262,5.525.357.143
19/11/2018 14:00,52,54066,2987,127,200,1836,8,5158,5.525.357.143
19/11/2018 15:00,53.01,54914,2914,125,197,1875,8,5119,5.525.357.143
19/11/2018 16:00,53.59,56035,2810,124,194,1906,8,5042,5.525.357.143
19/11/2018 17:00,54.37,56603,2815,126,198,2021,10,5170,5.525.357.143
19/11/2018 18:00,53.01,55830,2848,128,198,2118,9,5301,5.525.357.143
19/11/2018 19:00,51.04,54777,2843,132,191,2198,9,5373,5.525.357.143
19/11/2018 20:00,47.64,53038,2779,137,181,2313,9,5419,5.525.357.143
19/11/2018 21:00,46.41,51512,2779,142,167,2304,8,5400,5.525.357.143
19/11/2018 22:00,44.85,49220,2766,146,158,2377,8,5455,5.525.357.143
19/11/2018 23:00,43.48,46659,2770,142,145,2477,7,5541,5.525.357.143
20/11/2018 00:00,42.61,44445,2900,99,120,2613,3,5735,5.525.357.143
20/11/2018 01:00,41.58,43572,2853,90,108,2567,3,5621,5.525.357.143
20/11/2018 02:00,41.16,43272,2924,83,111,2591,2,5711,5.525.357.143
20/11/2018 03:00,41.35,43455,2957,79,115,2506,2,5659,5.525.357.143
20/11/2018 04:00,41.5,44254,2904,75,111,2496,1,5587,5.525.357.143
20/11/2018 05:00,44.3,46715,2992,74,102,2611,1,5780,5.525.357.143
20/11/2018 06:00,46.71,51185,3036,71,92,2670,3,5872,5.525.357.143
20/11/2018 07:00,50.64,55204,3133,65,82,2654,2,5936,5.525.357.143
20/11/2018 08:00,51.38,55741,3075,59,75,2607,2,5818,5.525.357.143
20/11/2018 09:00,49.78,55419,3049,55,70,2543,1,5718,5.525.357.143
20/11/2018 10:00,48.94,55395,3095,49,64,2405,0,5613,5.525.357.143
20/11/2018 11:00,48.78,55138,3267,43,59,2207,0,5576,5.525.357.143
20/11/2018 12:00,48.44,54693,3435,39,52,2031,0,5557,5.525.357.143
20/11/2018 13:00,49.25,54698,3549,35,49,1915,0,5548,5.525.357.143
20/11/2018 14:00,50.28,54844,3524,32,53,2005,0,5614,5.525.357.143
20/11/2018 15:00,51.53,55690,3549,31,61,2019,0,5660,5.525.357.143
20/11/2018 16:00,52.21,56729,3495,29,69,2082,0,5675,5.525.357.143
20/11/2018 17:00,52.57,57207,3571,26,77,2119,1,5794,5.525.357.143
20/11/2018 18:00,51.62,56461,3628,23,82,2178,1,5912,5.525.357.143
20/11/2018 19:00,50.62,55483,3642,20,82,2117,0,5861,5.525.357.143
20/11/2018 20:00,49.46,53848,3593,17,80,2052,0,5742,5.525.357.143
20/11/2018 21:00,48.86,52296,3622,15,76,1960,0,5673,5.525.357.143
20/11/2018 22:00,47.12,49982,3584,13,73,1861,0,5531,5.525.357.143
20/11/2018 23:00,44.65,47405,3637,10,68,1753,0,5468,5.525.357.143
21/11/2018 00:00,44.64,45275,3641,3,76,1603,2,5325,5.525.357.143
21/11/2018 01:00,43.56,44290,3646,3,71,1572,1,5293,5.525.357.143
21/11/2018 02:00,43.07,43996,3742,4,70,1571,1,5388,5.525.357.143
21/11/2018 03:00,42.96,44188,3734,5,70,1601,1,5411,5.525.357.143
21/11/2018 04:00,43.91,45004,3555,6,70,1652,1,5284,5.525.357.143
21/11/2018 05:00,45.77,47548,3571,7,74,1733,2,5387,5.525.357.143
21/11/2018 06:00,49.86,51957,3531,9,74,1828,2,5444,5.525.357.143
21/11/2018 07:00,52.44,55850,3569,12,67,1871,3,5522,5.525.357.143
21/11/2018 08:00,53.52,56195,3428,15,55,1836,2,5336,5.525.357.143
21/11/2018 09:00,52.04,55814,3307,16,39,1929,3,5294,5.525.357.143
21/11/2018 10:00,51.57,55841,3278,16,32,1902,2,5230,5.525.357.143
21/11/2018 11:00,51.4,55722,3354,16,30,1901,2,5303,5.525.357.143
21/11/2018 12:00,51.38,55396,3394,17,28,1887,2,5328,5.525.357.143
21/11/2018 13:00,51.71,55297,3349,21,28,1924,1,5323,5.525.357.143
21/11/2018 14:00,51.97,55461,3109,26,29,1953,1,5118,5.525.357.143
21/11/2018 15:00,53.79,56308,2937,31,29,1936,2,4935,5.525.357.143
21/11/2018 16:00,57.29,57274,2762,36,32,1964,3,4797,5.525.357.143
21/11/2018 17:00,57.97,57589,2675,38,34,2012,3,4762,5.525.357.143
21/11/2018 18:00,55.73,56758,2595,37,35,2031,3,4701,5.525.357.143
21/11/2018 19:00,52.13,55591,2500,33,35,2063,3,4634,5.525.357.143
21/11/2018 20:00,50.89,53920,2314,31,33,2004,2,4384,5.525.357.143
21/11/2018 21:00,50.24,52404,2142,32,31,1987,1,4193,5.525.357.143
21/11/2018 22:00,49,50063,2000,35,27,2002,1,4065,5.525.357.143
21/11/2018 23:00,47.6,47439,1864,37,19,2019,1,3940,5.525.357.143
22/11/2018 00:00,47.07,45422,1698,27,10,2024,1,3760,5.525.357.143
22/11/2018 01:00,46.61,44649,1575,26,7,2003,1,3612,5.525.357.143
22/11/2018 02:00,46.32,44246,1529,23,5,1927,1,3485,5.525.357.143
22/11/2018 03:00,46.48,44388,1463,20,3,1855,1,3342,5.525.357.143
22/11/2018 04:00,47.2,45186,1396,19,2,1822,1,3240,5.525.357.143
22/11/2018 05:00,49.31,47581,1399,18,3,1918,1,3339,5.525.357.143
22/11/2018 06:00,51.68,51856,1367,18,3,1860,2,3250,5.525.357.143
22/11/2018 07:00,63.09,55751,1385,16,3,1741,2,3147,5.525.357.143
22/11/2018 08:00,66.96,56239,1369,14,4,1614,3,3004,5.525.357.143
22/11/2018 09:00,61.58,55896,1304,11,5,1475,3,2798,5.525.357.143
22/11/2018 10:00,59.09,55873,1303,9,6,1383,2,2703,5.525.357.143
22/11/2018 11:00,60.28,55542,1322,8,6,1194,2,2532,5.525.357.143
22/11/2018 12:00,59.35,55094,1299,9,6,969,4,2287,5.525.357.143
22/11/2018 13:00,64.96,55047,1262,11,8,873,5,2159,5.525.357.143
22/11/2018 14:00,68.59,55322,1148,12,9,808,5,1982,5.525.357.143
22/11/2018 15:00,73.69,56001,1062,13,15,721,5,1816,5.525.357.143
22/11/2018 16:00,78.13,57070,1023,12,16,669,13,1733,5.525.357.143
22/11/2018 17:00,82.38,57533,1048,12,17,659,21,1757,5.525.357.143
22/11/2018 18:00,78.98,56740,1062,13,17,651,13,1756,5.525.357.143
22/11/2018 19:00,64.88,55755,1039,13,18,678,5,1753,5.525.357.143
22/11/2018 20:00,55.28,54288,1000,14,18,751,5,1788,5.525.357.143
22/11/2018 21:00,52.2,52735,972,15,19,795,5,1806,5.525.357.143
22/11/2018 22:00,51.08,50515,906,20,22,865,5,1818,5.525.357.143
22/11/2018 23:00,49.43,47988,833,27,23,954,5,1842,5.525.357.143
23/11/2018 00:00,49.49,46801,659,47,10,1104,3,1823,5.525.357.143
23/11/2018 01:00,48.81,45783,664,57,10,1229,3,1963,5.525.357.143
23/11/2018 02:00,48.14,45425,620,67,10,1356,4,2057,5.525.357.143
23/11/2018 03:00,48.31,45493,542,76,11,1503,4,2136,5.525.357.143
23/11/2018 04:00,49.07,46227,498,85,12,1591,5,2191,5.525.357.143
23/11/2018 05:00,50.23,48734,518,91,14,1715,4,2342,5.525.357.143
23/11/2018 06:00,52.74,53008,548,93,16,1923,3,2583,5.525.357.143
23/11/2018 07:00,59.8,57034,641,90,17,2017,2,2767,5.525.357.143
23/11/2018 08:00,70.9,57728,659,84,17,2092,11,2863,5.525.357.143
23/11/2018 09:00,57.56,57451,620,79,17,2116,13,2845,5.525.357.143
23/11/2018 10:00,54.96,57360,576,74,17,2133,8,2808,5.525.357.143
23/11/2018 11:00,53.98,56928,529,67,17,2173,15,2801,5.525.357.143
23/11/2018 12:00,53.38,56319,449,62,20,2211,17,2759,5.525.357.143
23/11/2018 13:00,53.69,55857,384,57,23,2243,9,2716,5.525.357.143
23/11/2018 14:00,53.18,55482,296,50,27,2298,10,2681,5.525.357.143
23/11/2018 15:00,53.57,56302,256,44,31,2337,11,2679,5.525.357.143
23/11/2018 16:00,53.41,57276,255,37,36,2389,20,2737,5.525.357.143
23/11/2018 17:00,54.01,57447,241,31,43,2398,20,2733,5.525.357.143
23/11/2018 18:00,53.05,56534,241,26,50,2368,15,2700,5.525.357.143
23/11/2018 19:00,50.65,55055,232,19,54,2429,12,2746,5.525.357.143
23/11/2018 20:00,49.44,53140,199,13,55,2411,11,2689,5.525.357.143
23/11/2018 21:00,49,51721,167,8,55,2384,8,2622,5.525.357.143
23/11/2018 22:00,48.06,49867,117,5,55,2357,9,2543,5.525.357.143
23/11/2018 23:00,47.59,47719,82,3,53,2405,11,2554,5.525.357.143
24/11/2018 00:00,48.39,46800,63,156,65,2447,8,2739,5.525.357.143
24/11/2018 01:00,47.91,45766,63,155,64,2493,8,2783,5.525.357.143
24/11/2018 02:00,47.4,45218,72,155,61,2598,7,2893,5.525.357.143
24/11/2018 03:00,47.4,45066,87,156,58,2644,6,2951,5.525.357.143
24/11/2018 04:00,47.52,45256,100,151,56,2712,6,3025,5.525.357.143
24/11/2018 05:00,47.9,45977,128,140,56,2747,6,3077,5.525.357.143
24/11/2018 06:00,48.3,47130,158,127,53,2760,5,3103,5.525.357.143
24/11/2018 07:00,48.79,48841,187,119,51,2752,5,3114,5.525.357.143
24/11/2018 08:00,48.96,50474,201,112,47,2726,4,3090,5.525.357.143
24/11/2018 09:00,49.39,52091,240,105,39,2699,3,3086,5.525.357.143
24/11/2018 10:00,49.57,52914,287,104,30,2615,3,3039,5.525.357.143
24/11/2018 11:00,49.65,52968,349,107,25,2510,2,2993,5.525.357.143
24/11/2018 12:00,49.59,52574,406,107,19,2410,1,2943,5.525.357.143
24/11/2018 13:00,49.51,52229,466,109,15,2306,1,2897,5.525.357.143
24/11/2018 14:00,49.57,52416,537,114,14,2289,0,2954,5.525.357.143
24/11/2018 15:00,49.9,53517,635,117,13,2369,0,3134,5.525.357.143
24/11/2018 16:00,50.59,54957,741,118,12,2405,0,3276,5.525.357.143
24/11/2018 17:00,51.22,55620,861,121,11,2489,1,3483,5.525.357.143
24/11/2018 18:00,50.95,55036,954,123,11,2469,1,3558,5.525.357.143
24/11/2018 19:00,50.58,53519,998,125,10,2424,1,3558,5.525.357.143
24/11/2018 20:00,49.58,51738,1062,127,9,2492,1,3691,5.525.357.143
24/11/2018 21:00,49.39,50729,1169,133,9,2620,1,3932,5.525.357.143
24/11/2018 22:00,49.11,49490,1152,140,9,2631,1,3933,5.525.357.143
24/11/2018 23:00,48.16,47865,1155,143,8,2671,0,3977,5.525.357.143
25/11/2018 00:00,48.3,46571,1023,171,0,2692,0,3886,5.525.357.143
25/11/2018 01:00,47.86,45587,1074,176,0,2704,0,3954,5.525.357.143
25/11/2018 02:00,47.16,45012,1058,182,0,2602,0,3842,5.525.357.143
25/11/2018 03:00,46.88,44877,1025,187,0,2662,0,3874,5.525.357.143
25/11/2018 04:00,46.57,44999,1018,190,0,2651,0,3859,5.525.357.143
25/11/2018 05:00,46.89,45571,1102,187,0,2613,0,3902,5.525.357.143
25/11/2018 06:00,47.87,46460,1177,184,0,2567,0,3928,5.525.357.143
25/11/2018 07:00,47.97,47550,1255,181,0,2478,1,3915,5.525.357.143
25/11/2018 08:00,49.15,48882,1266,180,0,2417,1,3864,5.525.357.143
25/11/2018 09:00,50.06,50568,1298,180,0,2332,0,3810,5.525.357.143
25/11/2018 10:00,50.44,51751,1331,180,0,2221,0,3732,5.525.357.143
25/11/2018 11:00,50.58,52041,1357,181,0,2011,0,3549,5.525.357.143
25/11/2018 12:00,50.44,51777,1334,180,0,1799,0,3313,5.525.357.143
25/11/2018 13:00,49.91,51629,1316,176,0,1777,0,3269,5.525.357.143
25/11/2018 14:00,50.45,51969,1276,169,0,1817,0,3262,5.525.357.143
25/11/2018 15:00,50.38,53127,1363,163,0,1928,0,3454,5.525.357.143
25/11/2018 16:00,51.57,54717,1424,157,0,1981,0,3562,5.525.357.143
25/11/2018 17:00,52.09,55570,1444,154,0,2024,0,3622,5.525.357.143
25/11/2018 18:00,51.93,55071,1502,149,0,1984,2,3637,5.525.357.143
25/11/2018 19:00,51.47,54312,1478,141,0,2030,2,3651,5.525.357.143
25/11/2018 20:00,50.39,53051,1384,135,0,2074,0,3593,5.525.357.143
25/11/2018 21:00,49.71,52087,1272,126,0,2037,0,3435,5.525.357.143
25/11/2018 22:00,49.41,50429,1176,118,0,2073,0,3367,5.525.357.143
25/11/2018 23:00,47.88,48433,1109,110,0,2063,0,3282,5.525.357.143
26/11/2018 00:00,48.16,47865,957,2,5,2104,0,3068,5.353.095.238
26/11/2018 01:00,47.83,47194,860,2,4,2143,0,3009,5.353.095.238
26/11/2018 02:00,46.41,46992,794,2,4,2197,0,2997,5.353.095.238
26/11/2018 03:00,45.06,47180,738,4,5,2245,1,2993,5.353.095.238
26/11/2018 04:00,45.07,48036,690,6,4,2311,3,3014,5.353.095.238
26/11/2018 05:00,48.78,50740,686,8,5,2330,2,3031,5.353.095.238
26/11/2018 06:00,51.34,55429,666,11,5,2266,4,2952,5.353.095.238
26/11/2018 07:00,58.04,59590,632,17,5,2281,4,2939,5.353.095.238
26/11/2018 08:00,59.81,60337,573,23,6,2195,3,2800,5.353.095.238
26/11/2018 09:00,60.42,60025,503,30,6,2191,2,2732,5.353.095.238
26/11/2018 10:00,60.77,59776,449,40,6,2128,4,2627,5.353.095.238
26/11/2018 11:00,61.59,59304,389,52,6,1991,4,2442,5.353.095.238
26/11/2018 12:00,59.16,58691,329,68,6,1887,6,2296,5.353.095.238
26/11/2018 13:00,62.09,58512,301,85,8,1898,8,2300,5.353.095.238
26/11/2018 14:00,62.07,58805,301,101,10,1994,8,2414,5.353.095.238
26/11/2018 15:00,69.9,59783,302,113,13,2094,10,2532,5.353.095.238
26/11/2018 16:00,73.14,60910,340,122,14,2150,20,2646,5.353.095.238
26/11/2018 17:00,76.28,61363,371,128,16,2206,23,2744,5.353.095.238
26/11/2018 18:00,69.97,60472,392,134,18,2211,13,2768,5.353.095.238
26/11/2018 19:00,58.35,59346,380,137,19,2182,14,2732,5.353.095.238
26/11/2018 20:00,54.8,57497,312,135,21,2198,11,2677,5.353.095.238
26/11/2018 21:00,52.87,55876,267,131,23,2275,10,2706,5.353.095.238
26/11/2018 22:00,50.96,53597,281,123,26,2337,10,2777,5.353.095.238
26/11/2018 23:00,49.28,51025,296,109,30,2370,12,2817,5.353.095.238
27/11/2018 00:00,49.01,49700,242,21,48,2404,11,2726,5.353.095.238
27/11/2018 01:00,48.26,48760,247,20,49,2405,8,2729,5.353.095.238
27/11/2018 02:00,48.05,48479,241,23,51,2394,15,2724,5.353.095.238
27/11/2018 03:00,48.45,48666,205,24,55,2393,17,2694,5.353.095.238
27/11/2018 04:00,49.33,49544,182,26,58,2321,9,2596,5.353.095.238
27/11/2018 05:00,51.36,52186,172,25,63,2198,11,2469,5.353.095.238
27/11/2018 06:00,54.48,56681,162,25,66,2112,13,2378,5.353.095.238
27/11/2018 07:00,64.44,60770,167,22,58,1941,12,2200,5.353.095.238
27/11/2018 08:00,78.5,61360,150,20,48,1802,16,2036,5.353.095.238
27/11/2018 09:00,74.32,61007,136,20,39,1627,14,1836,5.353.095.238
27/11/2018 10:00,73.54,60779,137,23,29,1425,2,1616,5.353.095.238
27/11/2018 11:00,78.79,60254,136,28,20,1119,0,1303,5.353.095.238
27/11/2018 12:00,74.24,59455,130,38,10,900,0,1078,5.353.095.238
27/11/2018 13:00,75.34,59295,157,47,8,717,0,929,5.353.095.238
27/11/2018 14:00,74.12,59665,208,60,7,667,0,942,5.353.095.238
27/11/2018 15:00,78.05,60766,291,77,10,676,0,1054,5.353.095.238
27/11/2018 16:00,80.1,62012,350,80,9,679,0,1118,5.353.095.238
27/11/2018 17:00,78.76,62532,416,73,8,679,8,1184,5.353.095.238
27/11/2018 18:00,74.37,61971,512,67,9,743,0,1331,5.353.095.238
27/11/2018 19:00,69.73,60937,577,67,8,795,3,1450,5.353.095.238
27/11/2018 20:00,62.28,59311,606,66,9,913,2,1596,5.353.095.238
27/11/2018 21:00,55.92,57906,667,67,13,1061,3,1811,5.353.095.238
27/11/2018 22:00,51.91,55627,795,69,17,1154,4,2039,5.353.095.238
27/11/2018 23:00,49.5,52885,931,68,19,1242,4,2264,5.353.095.238
28/11/2018 00:00,49.05,51099,1372,84,21,1406,1,2884,5.353.095.238
28/11/2018 01:00,47.74,50194,1449,87,23,1562,2,3123,5.353.095.238
28/11/2018 02:00,47.19,49925,1574,89,24,1700,2,3389,5.353.095.238
28/11/2018 03:00,46.44,50209,1671,90,26,1792,2,3581,5.353.095.238
28/11/2018 04:00,46.9,51103,1723,88,28,1843,2,3684,5.353.095.238
28/11/2018 05:00,49.04,53690,1895,80,35,1908,2,3920,5.353.095.238
28/11/2018 06:00,52.44,58095,2146,73,43,2004,2,4268,5.353.095.238
28/11/2018 07:00,58.01,62138,2393,64,47,2127,1,4632,5.353.095.238
28/11/2018 08:00,61.28,62614,2639,59,40,2233,1,4972,5.353.095.238
28/11/2018 09:00,56.34,62117,2911,58,28,2349,0,5346,5.353.095.238
28/11/2018 10:00,52.66,61909,3199,58,20,2353,0,5630,5.353.095.238
28/11/2018 11:00,51.95,61424,3567,60,10,2394,0,6031,5.353.095.238
28/11/2018 12:00,51.44,60654,3854,64,9,2389,0,6316,5.353.095.238
28/11/2018 13:00,51.53,60487,4033,70,8,2513,0,6624,5.353.095.238
28/11/2018 14:00,51.69,60905,4034,77,12,2756,0,6879,5.353.095.238
28/11/2018 15:00,51.91,62018,4086,81,17,3058,2,7244,5.353.095.238
28/11/2018 16:00,52.54,63039,4065,78,25,3366,3,7537,5.353.095.238
28/11/2018 17:00,51.99,63290,4162,71,35,3624,5,7897,5.353.095.238
28/11/2018 18:00,50.56,62314,4280,68,53,3840,4,8245,5.353.095.238
28/11/2018 19:00,49.28,61079,4358,64,68,4074,2,8566,5.353.095.238
28/11/2018 20:00,47.79,59191,4344,57,82,4347,4,8834,5.353.095.238
28/11/2018 21:00,46.21,57541,4361,49,100,4598,5,9113,5.353.095.238
28/11/2018 22:00,44.9,55079,4332,41,114,4822,7,9316,5.353.095.238
28/11/2018 23:00,42.4,52328,4395,33,126,5023,9,9586,5.353.095.238
29/11/2018 00:00,42.89,49845,4497,14,143,5201,21,9876,5.353.095.238
29/11/2018 01:00,41.92,48862,4455,10,150,5415,23,10053,5.353.095.238
29/11/2018 02:00,41.78,48416,4496,7,159,5564,25,10251,5.353.095.238
29/11/2018 03:00,41.78,48402,4417,6,169,5658,26,10276,5.353.095.238
29/11/2018 04:00,42.1,49104,4230,4,185,5757,26,10202,5.353.095.238
29/11/2018 05:00,43.62,51401,4184,2,201,5790,34,10211,5.353.095.238
29/11/2018 06:00,47.89,55559,4102,2,217,5840,35,10196,5.353.095.238
29/11/2018 07:00,49.79,59558,3994,3,235,5835,35,10102,5.353.095.238
29/11/2018 08:00,49.48,60068,3756,5,243,5769,35,9808,5.353.095.238
29/11/2018 09:00,48.88,59750,3526,8,254,5751,39,9578,5.353.095.238
29/11/2018 10:00,48.61,59664,3496,10,264,5732,45,9547,5.353.095.238
29/11/2018 11:00,48.65,59410,3572,13,282,5675,46,9588,5.353.095.238
29/11/2018 12:00,48.65,58979,3627,15,291,5599,47,9579,5.353.095.238
29/11/2018 13:00,48.8,58972,3720,21,308,5506,48,9603,5.353.095.238
29/11/2018 14:00,48.71,59251,3781,30,331,5440,50,9632,5.353.095.238
29/11/2018 15:00,48.91,59820,3908,42,351,5409,51,9761,5.353.095.238
29/11/2018 16:00,48.79,60481,3932,52,371,5347,50,9752,5.353.095.238
29/11/2018 17:00,48.87,60560,3996,60,386,5345,54,9841,5.353.095.238
29/11/2018 18:00,48.74,59492,4102,67,397,5340,54,9960,5.353.095.238
29/11/2018 19:00,47.96,58340,4124,77,402,5321,55,9979,5.353.095.238
29/11/2018 20:00,46.66,56607,4098,87,404,5336,57,9982,5.353.095.238
29/11/2018 21:00,45.46,54899,4095,99,404,5315,57,9970,5.353.095.238
29/11/2018 22:00,43.84,52464,4059,114,404,5277,57,9911,5.353.095.238
29/11/2018 23:00,42.66,49709,3988,128,405,5289,57,9867,5.353.095.238
30/11/2018 00:00,42.23,46361,3817,135,443,5332,50,9777,5.353.095.238
30/11/2018 01:00,41.18,45235,3638,142,443,5348,51,9622,5.353.095.238
30/11/2018 02:00,41.1,44785,3493,143,442,5352,49,9479,5.353.095.238
30/11/2018 03:00,40.27,44883,3361,144,434,5318,49,9306,5.353.095.238
30/11/2018 04:00,40.79,45576,3278,144,434,5296,50,9202,5.353.095.238
30/11/2018 05:00,43.08,47912,3305,148,437,5237,49,9176,5.353.095.238
30/11/2018 06:00,46.64,52158,3323,158,440,5201,47,9169,5.353.095.238
30/11/2018 07:00,48.57,56382,3287,169,443,5140,49,9088,5.353.095.238
30/11/2018 08:00,48.99,56959,3155,179,442,5125,50,8951,5.353.095.238
30/11/2018 09:00,48.67,56588,2965,188,435,5048,52,8688,5.353.095.238
30/11/2018 10:00,48.13,56564,2919,198,432,4953,51,8553,5.353.095.238
30/11/2018 11:00,47.96,56268,2986,207,428,4885,51,8557,5.353.095.238
30/11/2018 12:00,47.93,55785,3025,213,421,4785,51,8495,5.353.095.238
30/11/2018 13:00,47.98,55471,2971,216,420,4761,51,8419,5.353.095.238
30/11/2018 14:00,48.03,55175,2827,217,418,4769,50,8281,5.353.095.238
30/11/2018 15:00,48.48,55665,2711,220,417,4806,47,8201,5.353.095.238
30/11/2018 16:00,48.95,56334,2628,223,412,4846,47,8156,5.353.095.238
30/11/2018 17:00,49.02,56323,2567,226,407,4871,47,8118,5.353.095.238
30/11/2018 18:00,48.57,55370,2520,230,404,4907,47,8108,5.353.095.238
30/11/2018 19:00,47.51,53829,2474,232,398,4965,46,8115,5.353.095.238
30/11/2018 20:00,46.06,51775,2395,234,389,4937,45,8000,5.353.095.238
30/11/2018 21:00,45.66,50341,2342,236,380,4916,44,7918,5.353.095.238
30/11/2018 22:00,44.78,48491,2318,237,373,4870,41,7839,5.353.095.238
30/11/2018 23:00,43.21,46436,2299,238,368,4812,40,7757,5.353.095.238
01/12/2018 00:00,44.4,44024,2201,93,341,4821,38,7494,5.353.095.238
01/12/2018 01:00,43.45,43097,2147,81,336,4727,38,7329,5.353.095.238
01/12/2018 02:00,43.01,42557,2132,70,326,4664,32,7224,5.353.095.238
01/12/2018 03:00,43.09,42378,2010,60,304,4568,27,6969,5.353.095.238
01/12/2018 04:00,43.44,42653,1891,52,292,4513,27,6775,5.353.095.238
01/12/2018 05:00,43.65,43440,1808,46,279,4465,24,6622,5.353.095.238
01/12/2018 06:00,44.42,44553,1692,41,266,4395,30,6424,5.353.095.238
01/12/2018 07:00,45.6,45993,1621,37,253,4325,23,6259,5.353.095.238
01/12/2018 08:00,46.37,47537,1583,36,228,4237,23,6107,5.353.095.238
01/12/2018 09:00,47.06,49196,1494,36,200,4140,26,5896,5.353.095.238
01/12/2018 10:00,47.46,50175,1461,37,171,4039,16,5724,5.353.095.238
01/12/2018 11:00,47.8,50312,1472,39,146,3902,14,5573,5.353.095.238
01/12/2018 12:00,47.7,50220,1448,42,125,3770,11,5396,5.353.095.238
01/12/2018 13:00,47.61,50046,1370,43,119,3623,12,5167,5.353.095.238
01/12/2018 14:00,47.93,50275,1307,44,133,3582,9,5075,5.353.095.238
01/12/2018 15:00,48.45,51225,1235,43,148,3503,10,4939,5.353.095.238
01/12/2018 16:00,48.92,52464,1221,41,162,3394,13,4831,5.353.095.238
01/12/2018 17:00,48.95,52984,1331,38,166,3322,15,4872,5.353.095.238
01/12/2018 18:00,48.38,52276,1432,35,168,3266,15,4916,5.353.095.238
01/12/2018 19:00,46.52,50790,1524,31,160,3183,15,4913,5.353.095.238
01/12/2018 20:00,45.43,49126,1623,25,146,3056,16,4866,5.353.095.238
01/12/2018 21:00,45.27,48051,1638,21,138,2934,15,4746,5.353.095.238
01/12/2018 22:00,44.05,46686,1684,17,121,2806,13,4641,5.353.095.238
01/12/2018 23:00,43.23,45078,1779,15,107,2647,10,4558,5.353.095.238
02/12/2018 00:00,43.72,43268,2152,9,74,2532,8,4775,5.353.095.238
02/12/2018 01:00,43.28,42285,2271,7,72,2380,7,4737,5.353.095.238
02/12/2018 02:00,43.25,41728,2483,8,71,2330,6,4898,5.353.095.238
02/12/2018 03:00,43.12,41477,2631,10,68,2291,6,5006,5.353.095.238
02/12/2018 04:00,42.42,41552,2672,10,71,2321,6,5080,5.353.095.238
02/12/2018 05:00,41.81,42107,2759,8,75,2336,6,5184,5.353.095.238
02/12/2018 06:00,42.9,43110,2774,8,83,2394,6,5265,5.353.095.238
02/12/2018 07:00,43.82,44288,2749,7,88,2491,6,5341,5.353.095.238
02/12/2018 08:00,44.34,45673,2595,10,90,2558,6,5259,5.353.095.238
02/12/2018 09:00,45.18,47366,2402,13,91,2645,6,5157,5.353.095.238
02/12/2018 10:00,46.06,48740,2330,15,92,2663,6,5106,5.353.095.238
02/12/2018 11:00,46.41,49210,2253,16,94,2665,6,5034,5.353.095.238
02/12/2018 12:00,46.42,49227,2172,20,98,2646,5,4941,5.353.095.238
02/12/2018 13:00,46.44,49284,2065,26,107,2772,6,4976,5.353.095.238
02/12/2018 14:00,46.13,49508,1876,32,125,2837,6,4876,5.353.095.238
02/12/2018 15:00,46.66,50543,1711,41,145,2970,8,4875,5.353.095.238
02/12/2018 16:00,47.31,51730,1545,47,165,3099,10,4866,5.353.095.238
02/12/2018 17:00,47.59,52278,1405,49,182,3199,10,4845,5.353.095.238
02/12/2018 18:00,47.29,51677,1350,50,203,3231,11,4845,5.353.095.238
02/12/2018 19:00,46.62,50809,1395,50,221,3262,14,4942,5.353.095.238
02/12/2018 20:00,45.81,49536,1417,50,239,3141,15,4862,5.353.095.238
02/12/2018 21:00,45.07,48378,1406,48,252,3056,18,4780,5.353.095.238
02/12/2018 22:00,44.41,46646,1558,43,262,2975,18,4856,5.353.095.238
02/12/2018 23:00,42.89,44539,1782,39,271,2982,19,5093,5.353.095.238
03/12/2018 00:00,43.52,42890,1296,247,253,2951,20,4767,5.210.297.619
03/12/2018 01:00,41.92,42139,1398,248,253,2881,23,4803,5.210.297.619
03/12/2018 02:00,40.97,41954,1593,249,246,2865,23,4976,5.210.297.619
03/12/2018 03:00,40.85,42140,1713,249,240,2774,23,4999,5.210.297.619
03/12/2018 04:00,42.02,42964,1827,249,235,2629,22,4962,5.210.297.619
03/12/2018 05:00,45.01,45535,2088,249,230,2580,21,5168,5.210.297.619
03/12/2018 06:00,47.71,50176,2264,249,217,2544,16,5290,5.210.297.619
03/12/2018 07:00,50.46,54511,2462,249,210,2509,15,5445,5.210.297.619
03/12/2018 08:00,51.21,55354,2614,250,196,2515,15,5590,5.210.297.619
03/12/2018 09:00,50.08,55079,2697,252,187,2479,15,5630,5.210.297.619
03/12/2018 10:00,49.57,55066,2884,253,178,2456,13,5784,5.210.297.619
03/12/2018 11:00,49.28,54894,3115,253,177,2473,12,6030,5.210.297.619
03/12/2018 12:00,49.28,54699,3291,253,174,2502,12,6232,5.210.297.619
03/12/2018 13:00,49.42,54699,3382,252,177,2570,13,6394,5.210.297.619
03/12/2018 14:00,49.74,54963,3412,251,185,2605,12,6465,5.210.297.619
03/12/2018 15:00,50.18,55652,3437,251,193,2691,12,6584,5.210.297.619
03/12/2018 16:00,50.75,56375,3467,250,202,2747,16,6682,5.210.297.619
03/12/2018 17:00,50.7,56415,3465,250,209,2872,19,6815,5.210.297.619
03/12/2018 18:00,50.1,55437,3453,250,215,3019,21,6958,5.210.297.619
03/12/2018 19:00,49.67,54275,3369,250,217,3052,26,6914,5.210.297.619
03/12/2018 20:00,48.93,52552,3310,248,216,3068,27,6869,5.210.297.619
03/12/2018 21:00,47.56,50775,3284,246,209,3116,23,6878,5.210.297.619
03/12/2018 22:00,46.03,48373,3333,243,200,3135,19,6930,5.210.297.619
03/12/2018 23:00,44.65,45715,3423,240,190,3112,16,6981,5.210.297.619
04/12/2018 00:00,41.44,43183,3308,91,165,3311,12,6887,5.210.297.619
04/12/2018 01:00,40.8,42278,3499,95,158,3218,12,6982,5.210.297.619
04/12/2018 02:00,41.06,41993,3790,101,157,3232,12,7292,5.210.297.619
04/12/2018 03:00,41.29,42251,3983,109,157,3219,15,7483,5.210.297.619
04/12/2018 04:00,41.48,43126,3980,118,157,3215,16,7486,5.210.297.619
04/12/2018 05:00,43.88,45647,4015,123,159,3239,17,7553,5.210.297.619
04/12/2018 06:00,47.09,50188,4098,128,162,3283,16,7687,5.210.297.619
04/12/2018 07:00,48.52,54428,4181,134,164,3224,16,7719,5.210.297.619
04/12/2018 08:00,49.08,55214,4194,137,168,3236,19,7754,5.210.297.619
04/12/2018 09:00,48.91,54922,4145,139,168,3317,18,7787,5.210.297.619
04/12/2018 10:00,47.93,54920,4193,140,168,3387,18,7906,5.210.297.619
04/12/2018 11:00,47.07,54845,4234,138,158,3547,21,8098,5.210.297.619
04/12/2018 12:00,46.99,54547,4279,138,158,3731,20,8326,5.210.297.619
04/12/2018 13:00,47.5,54630,4299,134,175,3915,21,8544,5.210.297.619
04/12/2018 14:00,48.14,55024,4205,133,196,4092,18,8644,5.210.297.619
04/12/2018 15:00,48.52,55915,4066,131,223,4303,17,8740,5.210.297.619
04/12/2018 16:00,49.23,56822,3860,131,246,4454,15,8706,5.210.297.619
04/12/2018 17:00,49.52,57167,3647,129,262,4534,15,8587,5.210.297.619
04/12/2018 18:00,49.29,56564,3402,127,276,4618,17,8440,5.210.297.619
04/12/2018 19:00,49.04,55473,3143,129,284,4664,20,8240,5.210.297.619
04/12/2018 20:00,48.24,53905,2923,131,283,4750,18,8105,5.210.297.619
04/12/2018 21:00,47.48,52456,2663,135,284,4825,23,7930,5.210.297.619
04/12/2018 22:00,46.23,50249,2399,140,286,4838,29,7692,5.210.297.619
04/12/2018 23:00,45.06,47693,2127,146,292,4809,29,7403,5.210.297.619
05/12/2018 00:00,46,46616,1818,142,287,4686,32,6965,5.210.297.619
05/12/2018 01:00,45.83,46623,1601,147,283,4609,35,6675,5.210.297.619
05/12/2018 02:00,45.95,46278,1475,149,279,4517,34,6454,5.210.297.619
05/12/2018 03:00,45.83,46151,1269,148,273,4363,33,6086,5.210.297.619
05/12/2018 04:00,46.08,47643,1117,145,267,4237,33,5799,5.210.297.619
05/12/2018 05:00,47.43,51104,980,143,262,4104,29,5518,5.210.297.619
05/12/2018 06:00,51.23,56482,823,141,254,3978,25,5221,5.210.297.619
05/12/2018 07:00,53.65,61480,725,139,251,3807,27,4949,5.210.297.619
05/12/2018 08:00,55.88,62127,683,138,250,3595,21,4687,5.210.297.619
05/12/2018 09:00,56.29,62103,642,140,246,3429,21,4478,5.210.297.619
05/12/2018 10:00,55.02,59190,689,140,247,3241,24,4341,5.210.297.619
05/12/2018 11:00,53.78,58087,728,138,243,2969,27,4105,5.210.297.619
05/12/2018 12:00,54.19,57566,742,135,242,2789,25,3933,5.210.297.619
05/12/2018 13:00,53.49,57377,758,134,227,2741,24,3884,5.210.297.619
05/12/2018 14:00,53.82,58042,765,135,215,2974,24,4113,5.210.297.619
05/12/2018 15:00,54.99,59067,820,134,204,3125,21,4304,5.210.297.619
05/12/2018 16:00,55.91,60591,926,131,191,3339,21,4608,5.210.297.619
05/12/2018 17:00,55.87,61492,1026,127,174,3452,24,4803,5.210.297.619
05/12/2018 18:00,54.6,60916,1189,125,158,3521,25,5018,5.210.297.619
05/12/2018 19:00,51.54,59710,1325,123,138,3524,21,5131,5.210.297.619
05/12/2018 20:00,50.97,58115,1381,125,114,3541,14,5175,5.210.297.619
05/12/2018 21:00,49.34,55821,1411,130,98,3489,11,5139,5.210.297.619
05/12/2018 22:00,48.75,52743,1427,136,91,3433,10,5097,5.210.297.619
05/12/2018 23:00,46.69,49814,1405,140,90,3386,10,5031,5.210.297.619
06/12/2018 00:00,47.02,47524,1651,144,90,3331,10,5226,5.210.297.619
06/12/2018 01:00,46.17,45999,1638,135,96,3155,15,5039,5.210.297.619
06/12/2018 02:00,45.89,45890,1557,129,107,3069,14,4876,5.210.297.619
06/12/2018 03:00,45.49,45925,1443,135,116,3001,11,4706,5.210.297.619
06/12/2018 04:00,45.21,46549,1363,149,123,2854,7,4496,5.210.297.619
06/12/2018 05:00,48,49224,1267,167,132,2678,7,4251,5.210.297.619
06/12/2018 06:00,51.39,53645,1201,180,141,2605,3,4130,5.210.297.619
06/12/2018 07:00,55.56,57582,1149,189,135,2476,5,3954,5.210.297.619
06/12/2018 08:00,58.35,58613,1090,193,122,2384,7,3796,5.210.297.619
06/12/2018 09:00,58.07,58450,1017,198,111,2327,9,3662,5.210.297.619
06/12/2018 10:00,54.72,58055,1043,202,104,2168,7,3524,5.210.297.619
06/12/2018 11:00,54.74,57283,1057,204,97,2025,10,3393,5.210.297.619
06/12/2018 12:00,56.6,56852,1052,205,92,1823,12,3184,5.210.297.619
06/12/2018 13:00,55.21,56862,1058,203,92,1579,17,2949,5.210.297.619
06/12/2018 14:00,56.39,57355,1073,199,109,1551,12,2944,5.210.297.619
06/12/2018 15:00,59.15,58177,1195,194,128,1484,13,3014,5.210.297.619
06/12/2018 16:00,63.82,59320,1374,189,145,1472,12,3192,5.210.297.619
06/12/2018 17:00,58.56,59631,1661,184,163,1403,12,3423,5.210.297.619
06/12/2018 18:00,54.61,58392,1934,176,180,1367,9,3666,5.210.297.619
06/12/2018 19:00,52.03,57355,2052,166,194,1317,11,3740,5.210.297.619
06/12/2018 20:00,50.73,55957,2096,152,211,1215,11,3685,5.210.297.619
06/12/2018 21:00,49.37,54552,2152,139,225,1206,11,3733,5.210.297.619
06/12/2018 22:00,47.74,52153,2216,131,242,1248,14,3851,5.210.297.619
06/12/2018 23:00,46.56,49522,2223,127,252,1295,13,3910,5.210.297.619
07/12/2018 00:00,45.08,47171,2858,118,280,1492,22,4770,5.210.297.619
07/12/2018 01:00,43.91,45990,2687,127,286,1535,22,4657,5.210.297.619
07/12/2018 02:00,43.5,45508,2471,137,291,1605,22,4526,5.210.297.619
07/12/2018 03:00,43.79,45546,2136,146,294,1612,22,4210,5.210.297.619
07/12/2018 04:00,43.95,46259,1797,148,293,1562,22,3822,5.210.297.619
07/12/2018 05:00,46,48640,1460,140,278,1492,20,3390,5.210.297.619
07/12/2018 06:00,48.97,52787,1100,132,265,1376,22,2895,5.210.297.619
07/12/2018 07:00,52.94,56751,855,123,253,1231,22,2484,5.210.297.619
07/12/2018 08:00,60.56,57515,673,114,240,1103,22,2152,5.210.297.619
07/12/2018 09:00,56.07,57197,645,103,226,930,20,1924,5.210.297.619
07/12/2018 10:00,53.6,57188,803,92,217,766,22,1900,5.210.297.619
07/12/2018 11:00,52.82,56869,1077,84,203,679,20,2063,5.210.297.619
07/12/2018 12:00,51.66,56344,1474,76,189,560,18,2317,5.210.297.619
07/12/2018 13:00,49.94,55981,2004,67,177,527,17,2792,5.210.297.619
07/12/2018 14:00,49.48,55837,2509,61,167,553,15,3305,5.210.297.619
07/12/2018 15:00,49.05,56407,3118,55,160,648,15,3996,5.210.297.619
07/12/2018 16:00,49.42,56914,3377,50,156,806,18,4407,5.210.297.619
07/12/2018 17:00,49.53,56906,3442,50,156,1006,14,4668,5.210.297.619
07/12/2018 18:00,49.1,55996,3445,51,162,1278,16,4952,5.210.297.619
07/12/2018 19:00,47.71,54439,3465,53,167,1507,15,5207,5.210.297.619
07/12/2018 20:00,46.31,52405,3592,57,175,1710,15,5549,5.210.297.619
07/12/2018 21:00,46.04,50955,3557,63,184,1888,13,5705,5.210.297.619
07/12/2018 22:00,44.35,49071,3542,69,191,2010,16,5828,5.210.297.619
07/12/2018 23:00,43.81,46920,3638,76,194,2104,18,6030,5.210.297.619
08/12/2018 00:00,44.45,45461,3259,239,229,2126,13,5866,5.210.297.619
08/12/2018 01:00,44.27,44610,3217,234,244,2200,13,5908,5.210.297.619
08/12/2018 02:00,42.97,44043,3224,227,252,2310,17,6030,5.210.297.619
08/12/2018 03:00,41.14,43713,3093,220,252,2402,18,5985,5.210.297.619
08/12/2018 04:00,41.35,43770,2984,214,244,2525,18,5985,5.210.297.619
08/12/2018 05:00,41.9,44472,2960,208,227,2552,18,5965,5.210.297.619
08/12/2018 06:00,43.55,45710,3027,200,227,2610,25,6089,5.210.297.619
08/12/2018 07:00,44.31,47095,3171,196,238,2680,21,6306,5.210.297.619
08/12/2018 08:00,45.37,48806,3270,191,264,2665,19,6409,5.210.297.619
08/12/2018 09:00,46.1,50428,3227,185,294,2698,27,6431,5.210.297.619
08/12/2018 10:00,46.19,51484,3281,177,326,2675,37,6496,5.210.297.619
08/12/2018 11:00,46.29,51630,3416,167,338,2585,36,6542,5.210.297.619
08/12/2018 12:00,46.22,51367,3545,155,337,2526,41,6604,5.210.297.619
08/12/2018 13:00,46.12,51188,3627,146,325,2560,36,6694,5.210.297.619
08/12/2018 14:00,46.17,51473,3702,137,308,2663,39,6849,5.210.297.619
08/12/2018 15:00,46.43,52355,3834,131,295,2777,39,7076,5.210.297.619
08/12/2018 16:00,46.87,53169,4030,128,292,2904,40,7394,5.210.297.619
08/12/2018 17:00,47.01,53533,4107,125,294,3127,43,7696,5.210.297.619
08/12/2018 18:00,46.46,52910,4193,123,310,3280,44,7950,5.210.297.619
08/12/2018 19:00,45.98,51616,4293,119,327,3327,44,8110,5.210.297.619
08/12/2018 20:00,45.31,50071,4314,112,339,3340,47,8152,5.210.297.619
08/12/2018 21:00,44.78,48996,4222,105,352,3339,41,8059,5.210.297.619
08/12/2018 22:00,44.54,47533,4066,98,363,3279,37,7843,5.210.297.619
08/12/2018 23:00,44.25,45816,3910,92,376,3197,40,7615,5.210.297.619
09/12/2018 00:00,43.96,44240,3423,60,384,3203,40,7110,5.210.297.619
09/12/2018 01:00,42.82,43238,3057,61,392,3072,44,6626,5.210.297.619
09/12/2018 02:00,40.66,42665,2751,61,381,2918,42,6153,5.210.297.619
09/12/2018 03:00,40.64,42479,2410,60,377,2778,43,5668,5.210.297.619
09/12/2018 04:00,41.31,42536,2207,61,366,2623,39,5296,5.210.297.619
09/12/2018 05:00,41.61,43015,2273,65,352,2351,40,5081,5.210.297.619
09/12/2018 06:00,43.03,43802,2361,69,338,2153,38,4959,5.210.297.619
09/12/2018 07:00,43.79,45303,2380,72,328,1948,32,4760,5.210.297.619
09/12/2018 08:00,44.33,46757,2430,75,319,1715,27,4566,5.210.297.619
09/12/2018 09:00,45,48351,2483,75,310,1529,25,4422,5.210.297.619
09/12/2018 10:00,45.48,49798,2612,73,310,1407,24,4426,5.210.297.619
09/12/2018 11:00,45.76,50350,2820,73,305,1280,23,4501,5.210.297.619
09/12/2018 12:00,45.74,50484,2974,73,305,1252,20,4624,5.210.297.619
09/12/2018 13:00,45.55,50525,3130,75,292,1246,17,4760,5.210.297.619
09/12/2018 14:00,45.4,50873,3291,79,273,1246,15,4904,5.210.297.619
09/12/2018 15:00,45.9,52017,3348,85,253,1304,16,5006,5.210.297.619
09/12/2018 16:00,46.73,53050,3473,92,229,1404,16,5214,5.210.297.619
09/12/2018 17:00,46.8,53600,3644,94,195,1514,15,5462,5.210.297.619
09/12/2018 18:00,46.4,53131,3777,96,164,1604,12,5653,5.210.297.619
09/12/2018 19:00,45.92,52320,3852,100,142,1763,10,5867,5.210.297.619
09/12/2018 20:00,45.49,51195,3883,102,133,1830,8,5956,5.210.297.619
09/12/2018 21:00,45.02,50208,3889,103,134,1962,8,6096,5.210.297.619
09/12/2018 22:00,44.43,48492,3958,105,133,2111,7,6314,5.210.297.619
09/12/2018 23:00,43.8,46589,4125,105,130,2173,7,6540,5.210.297.619
10/12/2018 00:00,43.85,45589,3918,97,95,2219,6,6335,4.960.654.762
10/12/2018 01:00,43.23,44929,3985,104,96,2239,6,6430,4.960.654.762
10/12/2018 02:00,42.2,44778,4051,107,98,2357,5,6618,4.960.654.762
10/12/2018 03:00,42.62,44989,4114,109,101,2471,3,6798,4.960.654.762
10/12/2018 04:00,42.75,45764,4169,112,98,2518,2,6899,4.960.654.762
10/12/2018 05:00,45.17,48216,4189,116,97,2511,3,6916,4.960.654.762
10/12/2018 06:00,47.66,52659,4278,118,97,2516,3,7012,4.960.654.762
10/12/2018 07:00,50.98,56861,4253,123,99,2495,5,6975,4.960.654.762
10/12/2018 08:00,51.62,57730,4162,125,111,2437,7,6842,4.960.654.762
10/12/2018 09:00,51.53,57366,4033,127,129,2413,9,6711,4.960.654.762
10/12/2018 10:00,49.31,57388,4076,130,138,2404,6,6754,4.960.654.762
10/12/2018 11:00,48.46,56845,4113,130,128,2428,6,6805,4.960.654.762
10/12/2018 12:00,48.49,56349,4123,128,107,2472,5,6835,4.960.654.762
10/12/2018 13:00,48.48,56379,4071,127,90,2518,4,6810,4.960.654.762
10/12/2018 14:00,49.12,56618,4018,126,74,2590,3,6811,4.960.654.762
10/12/2018 15:00,50.95,57351,3922,124,64,2682,2,6794,4.960.654.762
10/12/2018 16:00,51.27,58167,3872,122,65,2721,2,6782,4.960.654.762
10/12/2018 17:00,51.27,58413,3711,124,66,2762,1,6664,4.960.654.762
10/12/2018 18:00,49.95,57555,3570,125,66,2776,1,6538,4.960.654.762
10/12/2018 19:00,49.24,56516,3616,125,64,2792,1,6598,4.960.654.762
10/12/2018 20:00,48.1,54914,3656,123,59,2765,1,6604,4.960.654.762
10/12/2018 21:00,46.8,53501,3578,122,56,2789,1,6546,4.960.654.762
10/12/2018 22:00,45.43,51346,3511,124,54,2824,1,6514,4.960.654.762
10/12/2018 23:00,44.43,48893,3414,125,39,2877,1,6456,4.960.654.762
11/12/2018 00:00,44.62,46634,3457,96,36,2925,0,6514,4.960.654.762
11/12/2018 01:00,43.71,45654,3419,90,31,2936,0,6476,4.960.654.762
11/12/2018 02:00,43.34,45262,3283,85,28,2887,0,6283,4.960.654.762
11/12/2018 03:00,43.4,45321,3105,81,23,2887,1,6097,4.960.654.762
11/12/2018 04:00,44.07,46076,2919,75,20,2868,1,5883,4.960.654.762
11/12/2018 05:00,46.47,48376,2783,71,16,2823,0,5693,4.960.654.762
11/12/2018 06:00,48.84,52614,2710,61,13,2732,0,5516,4.960.654.762
11/12/2018 07:00,51.65,56640,2573,56,11,2711,1,5352,4.960.654.762
11/12/2018 08:00,53.01,57450,2455,49,9,2551,1,5065,4.960.654.762
11/12/2018 09:00,53.32,56985,2320,45,7,2484,0,4856,4.960.654.762
11/12/2018 10:00,53.23,56927,2247,40,6,2428,0,4721,4.960.654.762
11/12/2018 11:00,53.65,56724,2164,36,5,2290,0,4495,4.960.654.762
11/12/2018 12:00,53.99,56347,2092,33,3,2278,0,4406,4.960.654.762
11/12/2018 13:00,54.35,56381,1966,31,4,2249,1,4251,4.960.654.762
11/12/2018 14:00,56.09,56732,1770,30,4,2156,1,3961,4.960.654.762
11/12/2018 15:00,59.04,57582,1648,28,5,2128,1,3810,4.960.654.762
11/12/2018 16:00,61.75,58442,1627,28,5,2073,1,3734,4.960.654.762
11/12/2018 17:00,62.31,58678,1551,25,6,1979,1,3562,4.960.654.762
11/12/2018 18:00,58.07,57870,1471,24,6,1918,2,3421,4.960.654.762
11/12/2018 19:00,53.76,56869,1401,22,7,1881,2,3313,4.960.654.762
11/12/2018 20:00,53.19,55381,1345,21,9,1806,3,3184,4.960.654.762
11/12/2018 21:00,51.55,53975,1268,19,11,1749,4,3051,4.960.654.762
11/12/2018 22:00,49.8,51910,1189,18,14,1679,5,2905,4.960.654.762
11/12/2018 23:00,48.58,49474,1118,16,16,1619,5,2774,4.960.654.762
12/12/2018 00:00,48.79,47444,897,15,20,1421,3,2356,4.960.654.762
12/12/2018 01:00,48.08,46477,813,15,23,1312,3,2166,4.960.654.762
12/12/2018 02:00,47.81,46151,784,16,27,1252,5,2084,4.960.654.762
12/12/2018 03:00,47.8,46264,803,18,31,1216,6,2074,4.960.654.762
12/12/2018 04:00,48.34,46922,839,21,36,1156,7,2059,4.960.654.762
12/12/2018 05:00,51,49362,863,23,42,1095,8,2031,4.960.654.762
12/12/2018 06:00,55.2,53770,891,25,48,1034,8,2006,4.960.654.762
12/12/2018 07:00,69.53,57932,942,27,54,970,8,2001,4.960.654.762
12/12/2018 08:00,75.93,58707,954,28,58,898,8,1946,4.960.654.762
12/12/2018 09:00,73.66,58194,941,32,61,821,8,1863,4.960.654.762
12/12/2018 10:00,69.44,58308,892,38,63,734,8,1735,4.960.654.762
12/12/2018 11:00,67.42,58153,807,45,63,673,7,1595,4.960.654.762
12/12/2018 12:00,66.89,57771,721,52,63,638,7,1481,4.960.654.762
12/12/2018 13:00,65.02,57832,694,58,66,608,6,1432,4.960.654.762
12/12/2018 14:00,67.18,58328,711,62,74,609,5,1461,4.960.654.762
12/12/2018 15:00,74.15,59227,730,62,83,634,7,1516,4.960.654.762
12/12/2018 16:00,78.2,60015,841,63,87,652,7,1650,4.960.654.762
12/12/2018 17:00,78.19,60139,923,65,88,685,8,1769,4.960.654.762
12/12/2018 18:00,74.15,59245,962,66,88,715,8,1839,4.960.654.762
12/12/2018 19:00,64.04,58245,999,67,90,766,8,1930,4.960.654.762
12/12/2018 20:00,53.57,56680,1014,70,93,782,8,1967,4.960.654.762
12/12/2018 21:00,53.57,55261,1007,71,95,808,7,1988,4.960.654.762
12/12/2018 22:00,50.91,52826,1026,71,96,824,8,2025,4.960.654.762
12/12/2018 23:00,49.21,50213,1004,70,97,869,8,2048,4.960.654.762
13/12/2018 00:00,49.57,48601,774,52,96,873,7,1802,4.960.654.762
13/12/2018 01:00,48.77,47602,756,49,95,946,8,1854,4.960.654.762
13/12/2018 02:00,48.16,47144,800,47,93,996,7,1943,4.960.654.762
13/12/2018 03:00,47.86,47268,863,45,91,1037,7,2043,4.960.654.762
13/12/2018 04:00,48.24,48084,931,46,85,1059,6,2127,4.960.654.762
13/12/2018 05:00,50.09,50599,973,50,85,1094,6,2208,4.960.654.762
13/12/2018 06:00,54.84,55197,1034,50,84,1144,9,2321,4.960.654.762
13/12/2018 07:00,67.43,59397,1118,46,79,1117,9,2369,4.960.654.762
13/12/2018 08:00,72.23,60272,1161,50,71,1118,6,2406,4.960.654.762
13/12/2018 09:00,69.97,59928,1182,45,71,1154,5,2457,4.960.654.762
13/12/2018 10:00,61.79,59882,1205,41,71,1189,6,2512,4.960.654.762
13/12/2018 11:00,58.27,59550,1236,40,72,1185,6,2539,4.960.654.762
13/12/2018 12:00,63.83,59187,1270,42,76,1174,6,2568,4.960.654.762
13/12/2018 13:00,62.6,59205,1252,47,79,1123,6,2507,4.960.654.762
13/12/2018 14:00,63.84,59575,1252,51,83,1135,7,2528,4.960.654.762
13/12/2018 15:00,72.35,60359,1321,55,91,1179,7,2653,4.960.654.762
13/12/2018 16:00,68.05,61093,1461,58,97,1188,7,2811,4.960.654.762
13/12/2018 17:00,61.68,61200,1434,63,100,1234,7,2838,4.960.654.762
13/12/2018 18:00,59,60268,1471,68,101,1285,6,2931,4.960.654.762
13/12/2018 19:00,54.79,59228,1549,73,101,1300,6,3029,4.960.654.762
13/12/2018 20:00,52.97,57524,1547,73,104,1268,6,2998,4.960.654.762
13/12/2018 21:00,52.67,56033,1505,72,107,1259,5,2948,4.960.654.762
13/12/2018 22:00,50.74,53722,1507,69,108,1269,4,2957,4.960.654.762
13/12/2018 23:00,49.65,51159,1447,69,106,1220,4,2846,4.960.654.762
14/12/2018 00:00,49.48,50121,1390,65,100,1224,4,2783,4.960.654.762
14/12/2018 01:00,48.64,49188,1321,70,97,1193,4,2685,4.960.654.762
14/12/2018 02:00,48.11,48925,1248,72,96,1150,3,2569,4.960.654.762
14/12/2018 03:00,48.45,49122,1221,73,95,1119,3,2511,4.960.654.762
14/12/2018 04:00,49.32,49994,1217,74,92,1038,3,2424,4.960.654.762
14/12/2018 05:00,52.41,52625,1220,76,92,1025,2,2415,4.960.654.762
14/12/2018 06:00,57.65,57038,1258,78,92,953,4,2385,4.960.654.762
14/12/2018 07:00,69.61,60874,1311,78,88,907,4,2388,4.960.654.762
14/12/2018 08:00,73.23,61551,1320,76,82,873,4,2355,4.960.654.762
14/12/2018 09:00,70.83,61158,1273,75,76,858,3,2285,4.960.654.762
14/12/2018 10:00,63.09,61220,1255,75,74,802,3,2209,4.960.654.762
14/12/2018 11:00,61.81,60885,1236,73,64,718,3,2094,4.960.654.762
14/12/2018 12:00,64.07,60316,1258,72,56,694,2,2082,4.960.654.762
14/12/2018 13:00,60.76,59832,1215,73,53,672,2,2015,4.960.654.762
14/12/2018 14:00,61.8,59709,1084,78,51,673,3,1889,4.960.654.762
14/12/2018 15:00,63.9,60339,1007,79,51,683,2,1822,4.960.654.762
14/12/2018 16:00,74.91,60871,1027,80,51,693,2,1853,4.960.654.762
14/12/2018 17:00,71.79,60813,1026,79,51,689,2,1847,4.960.654.762
14/12/2018 18:00,62.88,60021,1014,78,51,670,2,1815,4.960.654.762
14/12/2018 19:00,56.33,58682,1023,73,51,677,2,1826,4.960.654.762
14/12/2018 20:00,55.04,56813,1065,66,50,698,2,1881,4.960.654.762
14/12/2018 21:00,54.43,55390,1066,59,48,731,2,1906,4.960.654.762
14/12/2018 22:00,53.12,53498,1019,52,48,735,2,1856,4.960.654.762
14/12/2018 23:00,51.36,51267,999,45,48,775,3,1870,4.960.654.762
15/12/2018 00:00,53.1,49989,855,177,55,781,2,1870,4.960.654.762
15/12/2018 01:00,51.56,48950,901,177,56,777,2,1913,4.960.654.762
15/12/2018 02:00,50.92,48393,882,175,57,793,2,1909,4.960.654.762
15/12/2018 03:00,51.06,48131,814,173,58,839,2,1886,4.960.654.762
15/12/2018 04:00,50.5,48305,764,170,58,883,3,1878,4.960.654.762
15/12/2018 05:00,50.78,49029,755,167,58,896,3,1879,4.960.654.762
15/12/2018 06:00,51.07,50202,776,168,58,954,2,1958,4.960.654.762
15/12/2018 07:00,52.22,52139,872,174,53,1015,2,2116,4.960.654.762
15/12/2018 08:00,53.07,54135,1052,182,50,1069,3,2356,4.960.654.762
15/12/2018 09:00,53.96,55774,1167,190,51,1155,3,2566,4.960.654.762
15/12/2018 10:00,54.72,56760,1198,198,49,1222,3,2670,4.960.654.762
15/12/2018 11:00,54.97,56815,1268,203,49,1228,3,2751,4.960.654.762
15/12/2018 12:00,53.97,56701,1311,208,49,1232,3,2803,4.960.654.762
15/12/2018 13:00,53.92,56447,1300,207,51,1252,2,2812,4.960.654.762
15/12/2018 14:00,53.97,56804,1241,204,59,1338,3,2845,4.960.654.762
15/12/2018 15:00,53.88,57854,1346,197,72,1402,3,3020,4.960.654.762
15/12/2018 16:00,53.63,58841,1548,190,79,1525,3,3345,4.960.654.762
15/12/2018 17:00,55.41,59306,1733,180,81,1663,3,3660,4.960.654.762
15/12/2018 18:00,52.88,58625,1967,170,84,1721,4,3946,4.960.654.762
15/12/2018 19:00,51.42,57065,2294,167,87,1836,3,4387,4.960.654.762
15/12/2018 20:00,50.3,55236,2637,165,88,1996,3,4889,4.960.654.762
15/12/2018 21:00,49.4,54191,2836,162,89,2029,2,5118,4.960.654.762
15/12/2018 22:00,48.08,52730,3013,161,92,2120,2,5388,4.960.654.762
15/12/2018 23:00,46.47,50932,3129,164,94,2245,2,5634,4.960.654.762
16/12/2018 00:00,46.95,49267,2832,200,108,2353,4,5497,4.960.654.762
16/12/2018 01:00,46.87,48268,2837,200,120,2466,4,5627,4.960.654.762
16/12/2018 02:00,46.52,47683,2892,201,134,2487,4,5718,4.960.654.762
16/12/2018 03:00,46.35,47557,2994,201,150,2452,5,5802,4.960.654.762
16/12/2018 04:00,46.31,47636,3107,201,165,2461,5,5939,4.960.654.762
16/12/2018 05:00,46.38,48074,3199,202,182,2402,7,5992,4.960.654.762
16/12/2018 06:00,46.78,48897,3290,202,198,2401,9,6100,4.960.654.762
16/12/2018 07:00,47.27,50327,3327,204,215,2516,7,6269,4.960.654.762
16/12/2018 08:00,48.19,51793,3322,205,233,2566,11,6337,4.960.654.762
16/12/2018 09:00,48.67,53283,3258,203,247,2621,8,6337,4.960.654.762
16/12/2018 10:00,49.09,54722,3262,199,266,2502,11,6240,4.960.654.762
16/12/2018 11:00,50.55,55270,3182,193,272,2355,12,6014,4.960.654.762
16/12/2018 12:00,51.52,55354,3108,185,271,2258,11,5833,4.960.654.762
16/12/2018 13:00,51.45,55352,2898,177,280,2139,12,5506,4.960.654.762
16/12/2018 14:00,51.71,55743,2614,166,290,2080,11,5161,4.960.654.762
16/12/2018 15:00,52.49,56976,2404,157,306,2033,12,4912,4.960.654.762
16/12/2018 16:00,54.38,58031,2240,147,314,1939,14,4654,4.960.654.762
16/12/2018 17:00,54.76,58400,1940,138,308,1884,16,4286,4.960.654.762
16/12/2018 18:00,54.5,57761,1644,131,305,1707,17,3804,4.960.654.762
16/12/2018 19:00,52.94,56830,1440,125,292,1625,15,3497,4.960.654.762
16/12/2018 20:00,52.13,55495,1143,117,267,1517,17,3061,4.960.654.762
16/12/2018 21:00,51.65,54394,930,108,238,1364,14,2654,4.960.654.762
16/12/2018 22:00,50.67,52539,735,102,214,1197,13,2261,4.960.654.762
16/12/2018 23:00,49.86,50473,592,95,191,1079,13,1970,4.960.654.762
17/12/2018 00:00,50.41,48630,459,52,163,994,12,1680,4.724.047.619
17/12/2018 01:00,49.94,47801,410,49,143,925,11,1538,4.724.047.619
17/12/2018 02:00,49.77,47639,383,46,124,873,12,1438,4.724.047.619
17/12/2018 03:00,49.05,47861,371,40,106,747,10,1274,4.724.047.619
17/12/2018 04:00,49.47,48682,380,36,93,675,10,1194,4.724.047.619
17/12/2018 05:00,52.03,51311,388,32,84,596,12,1112,4.724.047.619
17/12/2018 06:00,57.19,56165,433,29,70,562,8,1102,4.724.047.619
17/12/2018 07:00,70.21,60535,483,26,60,538,8,1115,4.724.047.619
17/12/2018 08:00,77.37,61463,481,23,48,523,7,1082,4.724.047.619
17/12/2018 09:00,77.82,60983,468,21,40,477,7,1013,4.724.047.619
17/12/2018 10:00,76.64,61037,479,19,33,419,6,956,4.724.047.619
17/12/2018 11:00,77.36,60887,483,17,26,358,5,889,4.724.047.619
17/12/2018 12:00,76.62,60445,488,16,21,312,3,840,4.724.047.619
17/12/2018 13:00,76.62,60439,455,15,18,268,3,759,4.724.047.619
17/12/2018 14:00,77.14,60800,455,14,19,255,2,745,4.724.047.619
17/12/2018 15:00,77.33,61583,500,14,21,262,5,802,4.724.047.619
17/12/2018 16:00,77.37,62388,563,14,24,266,5,872,4.724.047.619
17/12/2018 17:00,77.34,62470,634,13,25,275,4,951,4.724.047.619
17/12/2018 18:00,76.67,61526,729,12,25,277,4,1047,4.724.047.619
17/12/2018 19:00,69.5,60273,818,12,24,305,5,1164,4.724.047.619
17/12/2018 20:00,56.52,58490,826,13,21,312,6,1178,4.724.047.619
17/12/2018 21:00,55.14,56963,788,13,21,339,6,1167,4.724.047.619
17/12/2018 22:00,53.56,54685,811,13,21,367,5,1217,4.724.047.619
17/12/2018 23:00,52.49,52049,776,11,19,404,4,1214,4.724.047.619
18/12/2018 00:00,52.33,50035,731,142,8,396,3,1280,4.724.047.619
18/12/2018 01:00,51.02,48886,731,142,8,408,3,1292,4.724.047.619
18/12/2018 02:00,50.24,48419,706,141,8,430,3,1288,4.724.047.619
18/12/2018 03:00,49.42,48465,669,134,8,449,3,1263,4.724.047.619
18/12/2018 04:00,50.18,49274,626,127,8,469,3,1233,4.724.047.619
18/12/2018 05:00,52.89,51726,604,120,8,491,3,1226,4.724.047.619
18/12/2018 06:00,56.46,56191,618,112,8,502,4,1244,4.724.047.619
18/12/2018 07:00,71.25,60639,766,104,10,522,5,1407,4.724.047.619
18/12/2018 08:00,74.69,61744,937,92,12,532,4,1577,4.724.047.619
18/12/2018 09:00,72.06,61349,1042,84,14,534,4,1678,4.724.047.619
18/12/2018 10:00,69.72,61344,1141,74,14,529,3,1761,4.724.047.619
18/12/2018 11:00,67.63,61260,1229,62,11,496,3,1801,4.724.047.619
18/12/2018 12:00,65.92,60721,1291,55,11,476,3,1836,4.724.047.619
18/12/2018 13:00,66.08,60732,1291,51,12,480,2,1836,4.724.047.619
18/12/2018 14:00,68.05,61102,1340,49,17,530,3,1939,4.724.047.619
18/12/2018 15:00,69.94,61982,1423,48,22,609,5,2107,4.724.047.619
18/12/2018 16:00,67.68,62784,1541,48,27,667,8,2291,4.724.047.619
18/12/2018 17:00,65.96,62870,1639,48,30,702,7,2426,4.724.047.619
18/12/2018 18:00,57.86,61866,1766,46,30,749,7,2598,4.724.047.619
18/12/2018 19:00,55.12,60674,1960,43,35,787,7,2832,4.724.047.619
18/12/2018 20:00,53.54,59051,2118,41,42,810,6,3017,4.724.047.619
18/12/2018 21:00,52.55,57382,2223,37,49,871,7,3187,4.724.047.619
18/12/2018 22:00,50.67,55033,2484,35,49,934,8,3510,4.724.047.619
18/12/2018 23:00,48.69,52334,2686,34,49,968,10,3747,4.724.047.619
19/12/2018 00:00,49.55,49982,2590,28,0,1034,4,3656,4.724.047.619
19/12/2018 01:00,48.84,48919,2817,27,0,1105,4,3953,4.724.047.619
19/12/2018 02:00,48.18,48333,3024,26,0,1192,4,4246,4.724.047.619
19/12/2018 03:00,47.82,48448,3174,25,0,1268,5,4472,4.724.047.619
19/12/2018 04:00,48.65,49048,3333,24,0,1353,5,4715,4.724.047.619
19/12/2018 05:00,50.6,51490,3521,24,0,1456,5,5006,4.724.047.619
19/12/2018 06:00,52.14,55702,3687,24,0,1550,4,5265,4.724.047.619
19/12/2018 07:00,54.25,59881,3681,24,0,1652,4,5361,4.724.047.619
19/12/2018 08:00,55.69,60639,3535,22,0,1719,5,5281,4.724.047.619
19/12/2018 09:00,55.27,60030,3310,22,0,1795,6,5133,4.724.047.619
19/12/2018 10:00,55.03,60139,3198,21,0,1851,6,5076,4.724.047.619
19/12/2018 11:00,55.32,59982,2994,19,0,1892,6,4911,4.724.047.619
19/12/2018 12:00,55.71,59605,2795,17,0,1924,4,4740,4.724.047.619
19/12/2018 13:00,55.68,59523,2504,17,0,2015,5,4541,4.724.047.619
19/12/2018 14:00,55.74,60037,2254,19,0,2086,5,4364,4.724.047.619
19/12/2018 15:00,56.31,60886,2044,22,0,2184,7,4257,4.724.047.619
19/12/2018 16:00,57.19,61556,1916,26,0,2269,9,4220,4.724.047.619
19/12/2018 17:00,56.71,61531,1823,27,0,2247,11,4108,4.724.047.619
19/12/2018 18:00,56.27,60390,1720,29,0,2298,10,4057,4.724.047.619
19/12/2018 19:00,55.2,59186,1648,29,0,2289,9,3975,4.724.047.619
19/12/2018 20:00,54.34,57424,1593,30,0,2241,8,3872,4.724.047.619
19/12/2018 21:00,53.22,55810,1493,31,0,2199,8,3731,4.724.047.619
19/12/2018 22:00,51.67,53565,1390,32,0,2237,9,3668,4.724.047.619
19/12/2018 23:00,50.12,50983,1270,33,0,2181,9,3493,4.724.047.619
20/12/2018 00:00,48.35,48174,1268,36,201,2140,10,3655,4.724.047.619
20/12/2018 01:00,48.08,47090,1238,35,206,2070,11,3560,4.724.047.619
20/12/2018 02:00,48.31,46720,1208,36,214,2080,12,3550,4.724.047.619
20/12/2018 03:00,47.36,46933,1184,35,221,2131,12,3583,4.724.047.619
20/12/2018 04:00,47.94,47784,1199,35,223,2153,12,3622,4.724.047.619
20/12/2018 05:00,50.62,50337,1252,34,222,2183,14,3705,4.724.047.619
20/12/2018 06:00,54.38,54762,1319,34,223,2205,14,3795,4.724.047.619
20/12/2018 07:00,57.84,59053,1363,33,223,2182,14,3815,4.724.047.619
20/12/2018 08:00,58.63,59914,1369,33,224,2097,16,3739,4.724.047.619
20/12/2018 09:00,57.53,59664,1361,32,224,2028,15,3660,4.724.047.619
20/12/2018 10:00,56.45,59680,1386,29,214,1961,13,3603,4.724.047.619
20/12/2018 11:00,56.31,59447,1391,25,192,1861,11,3480,4.724.047.619
20/12/2018 12:00,57.39,59298,1423,23,179,1811,11,3447,4.724.047.619
20/12/2018 13:00,57.21,59337,1410,23,170,1812,11,3426,4.724.047.619
20/12/2018 14:00,57.52,59757,1439,25,164,1822,11,3461,4.724.047.619
20/12/2018 15:00,57.81,60428,1510,29,163,1938,11,3651,4.724.047.619
20/12/2018 16:00,57.88,60960,1642,32,159,2030,10,3873,4.724.047.619
20/12/2018 17:00,57.2,61083,1719,33,158,2028,11,3949,4.724.047.619
20/12/2018 18:00,55.7,60104,1735,34,156,2077,8,4010,4.724.047.619
20/12/2018 19:00,54.31,58890,1809,35,144,2112,7,4107,4.724.047.619
20/12/2018 20:00,52.25,57082,1845,37,133,1988,7,4010,4.724.047.619
20/12/2018 21:00,51.29,55563,1819,37,125,2029,6,4016,4.724.047.619
20/12/2018 22:00,50,53305,1834,38,118,2005,5,4000,4.724.047.619
20/12/2018 23:00,48.12,50716,1773,37,109,1917,5,3841,4.724.047.619
21/12/2018 00:00,47.21,48214,1775,36,83,1857,4,3755,4.724.047.619
21/12/2018 01:00,46.42,47404,1719,35,78,1826,4,3662,4.724.047.619
21/12/2018 02:00,46,47168,1670,37,69,1788,4,3568,4.724.047.619
21/12/2018 03:00,46.12,47360,1657,40,63,1760,4,3524,4.724.047.619
21/12/2018 04:00,46.49,48151,1638,42,60,1757,3,3500,4.724.047.619
21/12/2018 05:00,49.97,50613,1601,43,55,1715,3,3417,4.724.047.619
21/12/2018 06:00,52.73,54733,1612,42,46,1704,3,3407,4.724.047.619
21/12/2018 07:00,55.65,58644,1628,43,42,1697,3,3413,4.724.047.619
21/12/2018 08:00,57.04,59640,1574,46,38,1680,2,3340,4.724.047.619
21/12/2018 09:00,57.13,59616,1528,48,31,1679,2,3288,4.724.047.619
21/12/2018 10:00,56.98,59731,1454,48,28,1621,2,3153,4.724.047.619
21/12/2018 11:00,56.04,59605,1374,48,25,1599,2,3048,4.724.047.619
21/12/2018 12:00,56.22,59209,1376,48,22,1588,2,3036,4.724.047.619
21/12/2018 13:00,55.78,58919,1369,51,23,1587,2,3032,4.724.047.619
21/12/2018 14:00,54.6,58995,1317,56,27,1642,2,3044,4.724.047.619
21/12/2018 15:00,54.11,59685,1281,62,33,1705,2,3083,4.724.047.619
21/12/2018 16:00,54.25,60204,1289,67,37,1751,2,3146,4.724.047.619
21/12/2018 17:00,54.69,60163,1283,70,43,1783,2,3181,4.724.047.619
21/12/2018 18:00,54.21,59280,1228,73,48,1805,3,3157,4.724.047.619
21/12/2018 19:00,52.79,57865,1217,74,58,1788,3,3140,4.724.047.619
21/12/2018 20:00,52.05,55791,1148,74,61,1751,3,3037,4.724.047.619
21/12/2018 21:00,51.43,54474,1069,72,65,1669,3,2878,4.724.047.619
21/12/2018 22:00,50.07,52663,1036,72,70,1615,3,2796,4.724.047.619
21/12/2018 23:00,49.01,50391,986,72,73,1615,3,2749,4.724.047.619
22/12/2018 00:00,48.39,47884,1821,8,127,2060,5,4021,4.724.047.619
22/12/2018 01:00,47.72,47021,1759,8,142,1993,6,3908,4.724.047.619
22/12/2018 02:00,47.23,46621,1641,8,152,1878,7,3686,4.724.047.619
22/12/2018 03:00,46.6,46706,1515,9,156,1794,8,3482,4.724.047.619
22/12/2018 04:00,46.94,47128,1453,9,156,1728,8,3354,4.724.047.619
22/12/2018 05:00,47.76,48361,1358,10,156,1618,8,3150,4.724.047.619
22/12/2018 06:00,48.41,49773,1245,10,160,1482,8,2905,4.724.047.619
22/12/2018 07:00,49.44,51712,1104,10,153,1348,8,2623,4.724.047.619
22/12/2018 08:00,50.29,54002,977,9,143,1219,8,2356,4.724.047.619
22/12/2018 09:00,51.52,55466,784,8,127,1067,8,1994,4.724.047.619
22/12/2018 10:00,52.56,56550,653,7,117,874,7,1658,4.724.047.619
22/12/2018 11:00,53.08,56768,543,6,108,737,5,1399,4.724.047.619
22/12/2018 12:00,52.99,56605,420,5,102,630,5,1162,4.724.047.619
22/12/2018 13:00,53.13,56384,301,5,101,565,6,978,4.724.047.619
22/12/2018 14:00,52.93,56582,234,7,109,539,7,896,4.724.047.619
22/12/2018 15:00,53.78,57313,187,9,118,543,9,866,4.724.047.619
22/12/2018 16:00,55.04,57986,158,11,125,516,9,819,4.724.047.619
22/12/2018 17:00,56.52,58366,159,12,128,476,11,786,4.724.047.619
22/12/2018 18:00,57.07,57872,165,14,134,457,10,780,4.724.047.619
22/12/2018 19:00,55.52,56607,192,15,141,441,8,797,4.724.047.619
22/12/2018 20:00,53.05,54928,228,16,150,410,7,811,4.724.047.619
22/12/2018 21:00,52.05,53861,283,17,163,386,5,854,4.724.047.619
22/12/2018 22:00,51.09,52347,350,18,164,377,5,914,4.724.047.619
22/12/2018 23:00,50.47,50706,408,18,163,364,6,959,4.724.047.619
23/12/2018 00:00,51.49,49549,156,15,166,348,7,692,4.724.047.619
23/12/2018 01:00,50.83,48691,163,16,164,344,8,695,4.724.047.619
23/12/2018 02:00,50.74,48385,169,18,154,327,10,678,4.724.047.619
23/12/2018 03:00,50.14,48348,192,19,149,311,11,682,4.724.047.619
23/12/2018 04:00,49.94,48576,214,19,139,325,19,716,4.724.047.619
23/12/2018 05:00,50.46,49131,268,20,127,340,16,771,4.724.047.619
23/12/2018 06:00,50.88,50103,320,23,116,355,12,826,4.724.047.619
23/12/2018 07:00,51.37,51571,335,27,106,377,14,859,4.724.047.619
23/12/2018 08:00,51.61,53005,339,31,94,417,10,891,4.724.047.619
23/12/2018 09:00,52.22,54453,326,34,86,457,11,914,4.724.047.619
23/12/2018 10:00,52.8,56010,356,34,79,469,11,949,4.724.047.619
23/12/2018 11:00,53,56643,419,35,75,466,8,1003,4.724.047.619
23/12/2018 12:00,53.11,56587,479,39,71,468,8,1065,4.724.047.619
23/12/2018 13:00,52.93,56559,424,47,65,497,7,1040,4.724.047.619
23/12/2018 14:00,52.93,56891,452,57,57,560,5,1131,4.724.047.619
23/12/2018 15:00,53.75,58135,462,70,46,630,4,1212,4.724.047.619
23/12/2018 16:00,55.99,59352,485,77,40,682,3,1287,4.724.047.619
23/12/2018 17:00,61.2,59673,552,86,35,743,2,1418,4.724.047.619
23/12/2018 18:00,61.2,59144,572,95,31,887,1,1586,4.724.047.619
23/12/2018 19:00,57.42,58247,529,103,31,947,1,1611,4.724.047.619
23/12/2018 20:00,55.61,57002,525,110,30,1008,1,1674,4.724.047.619
23/12/2018 21:00,53.99,55990,478,118,31,1116,1,1744,4.724.047.619
23/12/2018 22:00,53.86,54336,410,126,41,1175,1,1753,4.724.047.619
23/12/2018 23:00,52.32,51679,371,131,44,1290,1,1837,4.724.047.619
24/12/2018 00:00,51.09,49119,461,77,9,1257,2,1806,4.580.833.333
24/12/2018 01:00,50.19,48115,484,76,9,1306,4,1879,4.580.833.333
24/12/2018 02:00,48.98,47727,497,74,12,1399,3,1985,4.580.833.333
24/12/2018 03:00,48.8,47673,509,72,22,1520,4,2127,4.580.833.333
24/12/2018 04:00,48.52,47848,510,69,24,1650,5,2258,4.580.833.333
24/12/2018 05:00,49.8,48673,511,67,26,1827,8,2439,4.580.833.333
24/12/2018 06:00,50.05,50071,526,65,28,1872,11,2502,4.580.833.333
24/12/2018 07:00,50.55,52259,528,64,32,1937,12,2573,4.580.833.333
24/12/2018 08:00,52.33,54395,659,60,34,2082,9,2844,4.580.833.333
24/12/2018 09:00,53.26,56071,897,56,41,2106,9,3109,4.580.833.333
24/12/2018 10:00,53.14,56989,1140,53,50,2200,11,3454,4.580.833.333
24/12/2018 11:00,52.88,56985,1342,48,65,2179,10,3644,4.580.833.333
24/12/2018 12:00,53.03,56391,1547,44,77,2176,18,3862,4.580.833.333
24/12/2018 13:00,52.46,55922,1618,42,85,2212,20,3977,4.580.833.333
24/12/2018 14:00,52.44,55826,1664,42,86,2301,18,4111,4.580.833.333
24/12/2018 15:00,52.89,56216,1768,43,86,2374,14,4285,4.580.833.333
24/12/2018 16:00,53.26,56661,1964,44,83,2395,13,4499,4.580.833.333
24/12/2018 17:00,52.61,55479,2092,43,72,2397,11,4615,4.580.833.333
24/12/2018 18:00,51.28,53741,2243,41,64,2461,8,4817,4.580.833.333
24/12/2018 19:00,50.72,52591,2544,39,56,2476,6,5121,4.580.833.333
24/12/2018 20:00,49.86,51787,2785,39,47,2558,3,5432,4.580.833.333
24/12/2018 21:00,49.09,51488,2919,38,46,2738,1,5742,4.580.833.333
24/12/2018 22:00,49.02,50928,3119,36,44,2843,0,6042,4.580.833.333
24/12/2018 23:00,48.1,49889,3306,41,39,3051,0,6437,4.580.833.333
25/12/2018 00:00,48.02,45387,3313,62,63,3587,1,7026,4.580.833.333
25/12/2018 01:00,47.22,44658,3435,64,45,3774,2,7320,4.580.833.333
25/12/2018 02:00,46.04,44086,3535,66,37,3985,2,7625,4.580.833.333
25/12/2018 03:00,45.61,43813,3551,68,30,4198,5,7852,4.580.833.333
25/12/2018 04:00,45.07,43787,3549,69,27,4339,7,7991,4.580.833.333
25/12/2018 05:00,46.91,44185,3643,71,28,4486,9,8237,4.580.833.333
25/12/2018 06:00,46.98,44855,3738,71,34,4568,8,8419,4.580.833.333
25/12/2018 07:00,47.36,46007,3720,68,44,4712,9,8553,4.580.833.333
25/12/2018 08:00,47.5,47138,3670,62,56,4669,9,8466,4.580.833.333
25/12/2018 09:00,47.83,48234,3597,56,72,4622,8,8355,4.580.833.333
25/12/2018 10:00,47.23,49337,3670,48,80,4532,8,8338,4.580.833.333
25/12/2018 11:00,47.51,49714,3686,41,87,4427,10,8251,4.580.833.333
25/12/2018 12:00,47.83,49670,3691,35,90,4288,10,8114,4.580.833.333
25/12/2018 13:00,47.86,49724,3598,31,96,4271,6,8002,4.580.833.333
25/12/2018 14:00,47.54,50180,3593,26,104,4289,6,8018,4.580.833.333
25/12/2018 15:00,47.75,50983,3577,23,115,4324,7,8046,4.580.833.333
25/12/2018 16:00,48.05,51673,3564,20,115,4367,9,8075,4.580.833.333
25/12/2018 17:00,48.14,51616,3565,17,110,4399,12,8103,4.580.833.333
25/12/2018 18:00,48.09,51030,3513,14,111,4382,6,8026,4.580.833.333
25/12/2018 19:00,47.73,50204,3567,11,117,4458,9,8162,4.580.833.333
25/12/2018 20:00,47.81,49265,3515,8,128,4432,7,8090,4.580.833.333
25/12/2018 21:00,46.92,48558,3362,7,142,4410,13,7934,4.580.833.333
25/12/2018 22:00,47.02,47164,3317,7,161,4392,21,7898,4.580.833.333
25/12/2018 23:00,46.38,45470,3184,8,178,4328,28,7726,4.580.833.333
26/12/2018 00:00,45.89,43446,3136,21,233,4516,29,7935,4.580.833.333
26/12/2018 01:00,45,42434,3115,36,255,4443,35,7884,4.580.833.333
26/12/2018 02:00,44.58,41926,3044,53,267,4365,41,7770,4.580.833.333
26/12/2018 03:00,44.57,41911,2843,71,269,4228,44,7455,4.580.833.333
26/12/2018 04:00,44.61,42274,2673,86,266,4109,46,7180,4.580.833.333
26/12/2018 05:00,45.66,43093,2577,95,255,3971,43,6941,4.580.833.333
26/12/2018 06:00,46.98,45134,2523,109,239,3765,36,6672,4.580.833.333
26/12/2018 07:00,48.2,47608,2290,123,231,3543,38,6225,4.580.833.333
26/12/2018 08:00,49.75,49119,1997,133,229,3379,32,5770,4.580.833.333
26/12/2018 09:00,50.89,49776,1777,135,229,3120,36,5297,4.580.833.333
26/12/2018 10:00,51.01,50425,1738,128,238,2807,36,4947,4.580.833.333
26/12/2018 11:00,51.35,50566,1699,115,254,2440,43,4551,4.580.833.333
26/12/2018 12:00,51.7,50428,1756,104,264,2147,47,4318,4.580.833.333
26/12/2018 13:00,51.75,50183,1760,104,263,1946,47,4120,4.580.833.333
26/12/2018 14:00,51.24,50506,1884,112,254,1889,41,4180,4.580.833.333
26/12/2018 15:00,51.81,51440,1967,122,239,1791,33,4152,4.580.833.333
26/12/2018 16:00,52.5,52387,2048,126,229,1824,30,4257,4.580.833.333
26/12/2018 17:00,52.5,52451,2129,131,213,1852,28,4353,4.580.833.333
26/12/2018 18:00,52.28,51944,2154,136,195,2000,27,4512,4.580.833.333
26/12/2018 19:00,51.36,51175,2316,143,180,2191,25,4855,4.580.833.333
26/12/2018 20:00,50.89,50099,2332,151,165,2394,20,5062,4.580.833.333
26/12/2018 21:00,50.42,49029,2277,162,150,2606,14,5209,4.580.833.333
26/12/2018 22:00,49.82,47580,2435,168,137,2730,10,5480,4.580.833.333
26/12/2018 23:00,49.1,46061,2543,167,126,2752,8,5596,4.580.833.333
27/12/2018 00:00,49.08,44393,2509,196,122,2808,6,5641,4.580.833.333
27/12/2018 01:00,48.73,43404,2448,202,106,2718,6,5480,4.580.833.333
27/12/2018 02:00,48.15,43076,2372,205,93,2693,8,5371,4.580.833.333
27/12/2018 03:00,46.74,43184,2312,211,90,2604,9,5226,4.580.833.333
27/12/2018 04:00,46.99,43788,2272,219,86,2534,8,5119,4.580.833.333
27/12/2018 05:00,49.55,45754,2255,223,79,2547,11,5115,4.580.833.333
27/12/2018 06:00,50.92,49758,2240,223,71,2503,10,5047,4.580.833.333
27/12/2018 07:00,52.59,53531,2156,226,64,2432,8,4886,4.580.833.333
27/12/2018 08:00,52.77,54803,2099,223,63,2368,10,4763,4.580.833.333
27/12/2018 09:00,53.39,54824,2044,218,64,2372,7,4705,4.580.833.333
27/12/2018 10:00,53.4,54868,2131,211,64,2361,7,4774,4.580.833.333
27/12/2018 11:00,53.27,54703,2266,198,63,2370,6,4903,4.580.833.333
27/12/2018 12:00,53.46,54580,2432,180,63,2364,6,5045,4.580.833.333
27/12/2018 13:00,53.27,54517,2393,163,63,2431,6,5056,4.580.833.333
27/12/2018 14:00,53.39,54797,2323,149,65,2559,6,5102,4.580.833.333
27/12/2018 15:00,53.88,55612,2265,137,70,2685,4,5161,4.580.833.333
27/12/2018 16:00,54.68,56212,2203,126,71,2764,5,5169,4.580.833.333
27/12/2018 17:00,54.59,56194,2210,114,75,2794,4,5197,4.580.833.333
27/12/2018 18:00,53.96,55198,2190,103,83,2815,5,5196,4.580.833.333
27/12/2018 19:00,52.91,53989,2289,89,93,2879,3,5353,4.580.833.333
27/12/2018 20:00,52.1,52294,2339,74,104,2824,3,5344,4.580.833.333
27/12/2018 21:00,51.35,50952,2308,60,118,2774,4,5264,4.580.833.333
27/12/2018 22:00,50.51,48858,2345,46,130,2740,3,5264,4.580.833.333
27/12/2018 23:00,49.78,46393,2430,34,149,2774,4,5391,4.580.833.333
28/12/2018 00:00,50.04,43872,2582,23,163,2746,4,5518,4.580.833.333
28/12/2018 01:00,49.42,43019,2470,21,161,2757,4,5413,4.580.833.333
28/12/2018 02:00,49.19,42972,2288,17,151,2725,5,5186,4.580.833.333
28/12/2018 03:00,48.51,43174,2083,13,142,2772,5,5015,4.580.833.333
28/12/2018 04:00,48.07,43915,1918,8,130,2742,6,4804,4.580.833.333
28/12/2018 05:00,50.12,46107,1829,6,120,2654,6,4615,4.580.833.333
28/12/2018 06:00,51.73,49926,1731,6,108,2566,6,4417,4.580.833.333
28/12/2018 07:00,52.95,53352,1539,6,101,2493,6,4145,4.580.833.333
28/12/2018 08:00,53.87,54776,1414,7,97,2374,6,3898,4.580.833.333
28/12/2018 09:00,54.44,55011,1324,10,93,2188,6,3621,4.580.833.333
28/12/2018 10:00,54.69,55351,1254,11,86,2020,5,3376,4.580.833.333
28/12/2018 11:00,54.64,55233,1230,13,82,1873,4,3202,4.580.833.333
28/12/2018 12:00,55.15,54807,1316,13,76,1789,4,3198,4.580.833.333
28/12/2018 13:00,55.08,54438,1320,13,69,1642,4,3048,4.580.833.333
28/12/2018 14:00,55.2,54706,1288,14,65,1493,3,2863,4.580.833.333
28/12/2018 15:00,55.89,55478,1170,16,63,1366,3,2618,4.580.833.333
28/12/2018 16:00,57.65,56192,1122,18,59,1240,3,2442,4.580.833.333
28/12/2018 17:00,58.07,56409,1178,17,55,1186,3,2439,4.580.833.333
28/12/2018 18:00,56.18,55813,1202,15,52,1322,4,2595,4.580.833.333
28/12/2018 19:00,54.3,54577,1266,14,50,1408,3,2741,4.580.833.333
28/12/2018 20:00,52.94,52700,1312,14,48,1646,4,3024,4.580.833.333
28/12/2018 21:00,52.38,51269,1324,14,51,1896,4,3289,4.580.833.333
28/12/2018 22:00,51.46,49214,1424,13,51,2167,4,3659,4.580.833.333
28/12/2018 23:00,50.14,46956,1514,14,50,2476,4,4058,4.580.833.333
29/12/2018 00:00,50.93,45555,1540,36,55,2686,3,4320,4.580.833.333
29/12/2018 01:00,49.75,44523,1650,36,52,3009,3,4750,4.580.833.333
29/12/2018 02:00,48.76,43923,1778,36,51,3231,3,5099,4.580.833.333
29/12/2018 03:00,47.71,43924,1886,37,49,3353,3,5328,4.580.833.333
29/12/2018 04:00,47.62,44186,1953,37,48,3510,3,5551,4.580.833.333
29/12/2018 05:00,47.6,44866,1929,39,44,3577,4,5593,4.580.833.333
29/12/2018 06:00,48.77,45729,1843,40,41,3602,4,5530,4.580.833.333
29/12/2018 07:00,49.9,47313,1699,39,41,3551,4,5334,4.580.833.333
29/12/2018 08:00,51.1,49232,1596,37,49,3473,6,5161,4.580.833.333
29/12/2018 09:00,51.99,50857,1554,35,57,3344,4,4994,4.580.833.333
29/12/2018 10:00,51.72,52005,1663,33,73,3279,6,5054,4.580.833.333
29/12/2018 11:00,51.75,52218,1745,33,80,3237,8,5103,4.580.833.333
29/12/2018 12:00,52.1,52196,1779,32,83,3210,10,5114,4.580.833.333
29/12/2018 13:00,51.99,51979,1679,33,85,3130,10,4937,4.580.833.333
29/12/2018 14:00,51.13,52186,1594,32,93,3086,9,4814,4.580.833.333
29/12/2018 15:00,50.76,53135,1532,31,101,3026,5,4695,4.580.833.333
29/12/2018 16:00,51.45,54223,1478,29,110,2946,4,4567,4.580.833.333
29/12/2018 17:00,52.62,54720,1490,26,115,2916,4,4551,4.580.833.333
29/12/2018 18:00,51.93,54186,1495,24,118,2840,3,4480,4.580.833.333
29/12/2018 19:00,50.78,52784,1599,22,112,2768,3,4504,4.580.833.333
29/12/2018 20:00,49.87,51084,1778,21,103,2765,3,4670,4.580.833.333
29/12/2018 21:00,48.95,49923,1974,22,100,2691,3,4790,4.580.833.333
29/12/2018 22:00,48.06,48668,2227,23,95,2600,2,4947,4.580.833.333
29/12/2018 23:00,47.24,46988,2498,25,82,2485,3,5093,4.580.833.333
30/12/2018 00:00,49.22,45476,2975,9,63,1866,1,4914,4.580.833.333
30/12/2018 01:00,48.61,44445,3148,9,56,1802,1,5016,4.580.833.333
30/12/2018 02:00,48.77,44086,3367,10,49,1787,1,5214,4.580.833.333
30/12/2018 03:00,48.29,44118,3399,10,46,1724,1,5180,4.580.833.333
30/12/2018 04:00,48.72,44463,3402,12,41,1681,1,5137,4.580.833.333
30/12/2018 05:00,48.27,44962,3456,14,38,1775,1,5284,4.580.833.333
30/12/2018 06:00,49.18,45710,3466,19,33,1915,2,5435,4.580.833.333
30/12/2018 07:00,49.62,47217,3449,25,30,1983,2,5489,4.580.833.333
30/12/2018 08:00,49.62,48676,3467,27,27,2024,1,5546,4.580.833.333
30/12/2018 09:00,49.7,50123,3419,26,27,2146,2,5620,4.580.833.333
30/12/2018 10:00,50.41,51524,3463,23,25,2211,2,5724,4.580.833.333
30/12/2018 11:00,51.09,52104,3336,24,25,2215,2,5602,4.580.833.333
30/12/2018 12:00,51.1,52105,3119,27,23,2190,2,5361,4.580.833.333
30/12/2018 13:00,50.09,52028,2799,28,23,2163,2,5015,4.580.833.333
30/12/2018 14:00,50,52286,2398,28,29,2077,2,4534,4.580.833.333
30/12/2018 15:00,51.06,53571,1954,29,35,1974,2,3994,4.580.833.333
30/12/2018 16:00,52.29,54774,1601,30,46,1982,4,3663,4.580.833.333
30/12/2018 17:00,54.46,55236,1224,33,60,1890,3,3210,4.580.833.333
30/12/2018 18:00,55.11,54825,940,34,79,1783,4,2840,4.580.833.333
30/12/2018 19:00,54.99,53962,804,35,96,1770,5,2710,4.580.833.333
30/12/2018 20:00,53.97,52639,629,36,107,1715,5,2492,4.580.833.333
30/12/2018 21:00,52.93,51659,453,38,113,1638,6,2248,4.580.833.333
30/12/2018 22:00,52.94,50235,406,39,119,1542,7,2113,4.580.833.333
30/12/2018 23:00,52.28,48204,326,31,123,1514,4,1998,4.580.833.333
31/12/2018 00:00,50.71,45111,271,9,0,1481,5,1766,4.468.511.905
31/12/2018 01:00,49.81,44055,305,8,0,1498,7,1818,4.468.511.905
31/12/2018 02:00,49.04,43559,318,9,0,1653,6,1986,4.468.511.905
31/12/2018 03:00,46.41,43453,347,9,0,1844,5,2205,4.468.511.905
31/12/2018 04:00,45.98,43981,434,9,0,2077,7,2527,4.468.511.905
31/12/2018 05:00,47.3,45109,640,8,0,2368,5,3021,4.468.511.905
31/12/2018 06:00,48.99,46194,860,7,0,2629,4,3500,4.468.511.905
31/12/2018 07:00,50.01,48012,971,7,0,2957,4,3939,4.468.511.905
31/12/2018 08:00,50.06,49408,1040,9,0,3299,4,4352,4.468.511.905
31/12/2018 09:00,50.41,50762,1136,11,0,3637,3,4787,4.468.511.905
31/12/2018 10:00,50.76,52242,1354,12,0,3940,2,5308,4.468.511.905
31/12/2018 11:00,50.8,52822,1519,13,0,4284,1,5817,4.468.511.905
31/12/2018 12:00,50.39,52748,1750,14,0,4506,0,6270,4.468.511.905
31/12/2018 13:00,50.29,52544,1945,15,0,4680,0,6640,4.468.511.905
31/12/2018 14:00,50.18,52997,2246,17,0,4866,1,7130,4.468.511.905
31/12/2018 15:00,50.58,54009,2538,18,0,5052,2,7610,4.468.511.905
31/12/2018 16:00,50.91,54850,2805,19,0,5141,10,7975,4.468.511.905
31/12/2018 17:00,50.42,54588,3076,21,0,5266,16,8379,4.468.511.905
31/12/2018 18:00,49.78,53008,3353,22,0,5364,18,8757,4.468.511.905
31/12/2018 19:00,48.83,50921,3740,20,0,5483,23,9266,4.468.511.905
31/12/2018 20:00,47.23,48994,3955,18,0,5536,28,9537,4.468.511.905
31/12/2018 21:00,46.02,47930,3969,16,0,5570,42,9597,4.468.511.905
31/12/2018 22:00,45.55,46887,4083,15,0,5557,52,9707,4.468.511.905
31/12/2018 23:00,42.69,45563,4228,13,0,5455,58,9754,4.468.511.905
01/01/2019 00:00,44.55,43498,4488,34,360,5354,58,10294,4.468.511.905
01/01/2019 01:00,44.07,42773,4552,37,392,5236,59,10276,4.468.511.905
01/01/2019 02:00,41.12,42351,4436,36,406,5011,60,9949,4.468.511.905
01/01/2019 03:00,38.88,42104,4204,33,417,4934,59,9647,4.468.511.905
01/01/2019 04:00,35.7,42005,4206,30,425,4895,59,9615,4.468.511.905
01/01/2019 05:00,35.09,42515,4338,25,431,4895,59,9748,4.468.511.905
01/01/2019 06:00,36.07,43233,4347,17,435,4837,60,9696,4.468.511.905
01/01/2019 07:00,41.16,44196,4206,11,438,4901,60,9616,4.468.511.905
01/01/2019 08:00,42.07,45149,3965,7,445,5032,60,9509,4.468.511.905
01/01/2019 09:00,41.14,46179,3838,4,449,5074,60,9425,4.468.511.905
01/01/2019 10:00,43.38,47508,3962,3,451,5231,60,9707,4.468.511.905
01/01/2019 11:00,43.66,48191,3955,4,452,5465,57,9933,4.468.511.905
01/01/2019 12:00,43.08,48399,3933,7,452,5637,54,10083,4.468.511.905
01/01/2019 13:00,41.17,48700,3878,15,446,5753,51,10143,4.468.511.905
01/01/2019 14:00,41.03,49431,3873,30,434,5951,51,10339,4.468.511.905
01/01/2019 15:00,43.01,50424,3948,53,419,6057,46,10523,4.468.511.905
01/01/2019 16:00,44.66,51497,4049,78,395,6108,41,10671,4.468.511.905
01/01/2019 17:00,45.51,52088,4204,103,366,6171,37,10881,4.468.511.905
01/01/2019 18:00,44.45,51554,4358,131,333,6199,31,11052,4.468.511.905
01/01/2019 19:00,42.99,50716,4579,166,301,6229,26,11301,4.468.511.905
01/01/2019 20:00,44.05,49592,4563,195,259,6249,26,11292,4.468.511.905
01/01/2019 21:00,41.12,48875,4402,213,221,6243,21,11100,4.468.511.905
01/01/2019 22:00,43.19,47500,4394,222,202,6228,21,11067,4.468.511.905
01/01/2019 23:00,33.55,46006,4469,252,194,6200,37,11152,4.468.511.905
02/01/2019 00:00,39.62,45116,3838,255,207,6198,54,10552,4.468.511.905
02/01/2019 01:00,31.24,44300,3890,255,229,6145,58,10577,4.468.511.905
02/01/2019 02:00,29.97,44068,3776,252,256,6069,63,10416,4.468.511.905
02/01/2019 03:00,29.9,44225,3597,246,300,5984,64,10191,4.468.511.905
02/01/2019 04:00,35.71,45116,4134,240,317,5926,64,10681,4.468.511.905
02/01/2019 05:00,43.11,47233,4317,239,329,5863,64,10812,4.468.511.905
02/01/2019 06:00,47.13,50826,4333,240,346,5747,64,10730,4.468.511.905
02/01/2019 07:00,49.68,54231,4198,238,355,5624,64,10479,4.468.511.905
02/01/2019 08:00,50.21,55394,3850,232,361,5556,63,10062,4.468.511.905
02/01/2019 09:00,50.72,55702,3475,219,374,5354,64,9486,4.468.511.905
02/01/2019 10:00,50.17,56293,3378,199,385,5265,64,9291,4.468.511.905
02/01/2019 11:00,50.18,56290,3249,180,394,5070,64,8957,4.468.511.905
02/01/2019 12:00,49.92,56208,3106,157,404,4937,64,8668,4.468.511.905
02/01/2019 13:00,49.98,56138,2834,132,409,4817,64,8256,4.468.511.905
02/01/2019 14:00,50.9,56728,2517,121,412,4704,64,7818,4.468.511.905
02/01/2019 15:00,52.42,57668,2246,118,417,4586,64,7431,4.468.511.905
02/01/2019 16:00,54.84,58594,2034,121,420,4415,64,7054,4.468.511.905
02/01/2019 17:00,55.46,58856,1830,120,424,4171,64,6609,4.468.511.905
02/01/2019 18:00,55.43,58086,1631,122,427,3911,64,6155,4.468.511.905
02/01/2019 19:00,54.9,57014,1492,128,428,3580,63,5691,4.468.511.905
02/01/2019 20:00,53.8,55366,1358,131,426,3359,62,5336,4.468.511.905
02/01/2019 21:00,52.67,54146,1207,138,422,3094,62,4923,4.468.511.905
02/01/2019 22:00,52.03,52430,1267,145,421,2892,62,4787,4.468.511.905
02/01/2019 23:00,50.74,50068,1274,153,417,2612,62,4518,4.468.511.905
03/01/2019 00:00,49.78,48987,1148,172,431,2268,47,4066,4.468.511.905
03/01/2019 01:00,48.63,47959,1136,178,426,2042,47,3829,4.468.511.905
03/01/2019 02:00,48.29,47657,1155,184,421,1857,46,3663,4.468.511.905
03/01/2019 03:00,48.4,47763,1171,192,414,1735,45,3557,4.468.511.905
03/01/2019 04:00,48.79,48592,1191,198,410,1628,43,3470,4.468.511.905
03/01/2019 05:00,49.49,50777,1208,201,408,1599,41,3457,4.468.511.905
03/01/2019 06:00,51.23,54417,1300,202,403,1638,38,3581,4.468.511.905
03/01/2019 07:00,53.97,58494,1362,202,398,1706,34,3702,4.468.511.905
03/01/2019 08:00,57.11,60105,1322,205,387,1769,31,3714,4.468.511.905
03/01/2019 09:00,57.08,60301,1274,212,380,1922,29,3817,4.468.511.905
03/01/2019 10:00,56.44,60541,1104,217,378,2109,30,3838,4.468.511.905
03/01/2019 11:00,57.09,60366,917,223,377,2287,30,3834,4.468.511.905
03/01/2019 12:00,56.84,59921,806,229,373,2461,28,3897,4.468.511.905
03/01/2019 13:00,56.95,59732,683,234,359,2570,26,3872,4.468.511.905
03/01/2019 14:00,56.93,60100,559,236,340,2717,25,3877,4.468.511.905
03/01/2019 15:00,57.24,60917,491,235,323,2884,18,3951,4.468.511.905
03/01/2019 16:00,57.68,61555,557,235,307,3032,17,4148,4.468.511.905
03/01/2019 17:00,57.63,61825,720,235,294,3118,20,4387,4.468.511.905
03/01/2019 18:00,57,60889,928,236,280,3215,15,4674,4.468.511.905
03/01/2019 19:00,56.23,59612,1191,236,257,3257,14,4955,4.468.511.905
03/01/2019 20:00,55.2,57529,1475,236,231,3259,13,5214,4.468.511.905
03/01/2019 21:00,54.02,56104,1694,236,202,3340,9,5481,4.468.511.905
03/01/2019 22:00,51.96,53986,1948,236,175,3383,8,5750,4.468.511.905
03/01/2019 23:00,49.9,51224,2228,234,140,3346,5,5953,4.468.511.905
04/01/2019 00:00,49.96,47990,2422,244,72,3513,2,6253,4.468.511.905
04/01/2019 01:00,48.27,46990,2742,242,51,3534,1,6570,4.468.511.905
04/01/2019 02:00,47.25,46470,2946,239,37,3565,2,6789,4.468.511.905
04/01/2019 03:00,47.19,46542,3015,237,29,3493,4,6778,4.468.511.905
04/01/2019 04:00,47.5,47239,3019,233,24,3455,6,6737,4.468.511.905
04/01/2019 05:00,48.51,49324,3043,229,29,3287,8,6596,4.468.511.905
04/01/2019 06:00,50.98,52541,3054,225,42,3228,10,6559,4.468.511.905
04/01/2019 07:00,52.59,55862,2987,220,66,3088,14,6375,4.468.511.905
04/01/2019 08:00,53.82,57230,2928,216,92,2951,14,6201,4.468.511.905
04/01/2019 09:00,53.82,57394,2894,211,118,2851,12,6086,4.468.511.905
04/01/2019 10:00,53.84,57894,2972,206,138,2744,11,6071,4.468.511.905
04/01/2019 11:00,53.26,57785,2961,199,151,2719,10,6040,4.468.511.905
04/01/2019 12:00,51.92,57373,3080,189,161,2666,10,6106,4.468.511.905
04/01/2019 13:00,51.9,57014,3125,178,163,2706,10,6182,4.468.511.905
04/01/2019 14:00,51.76,57112,3252,167,166,2713,10,6308,4.468.511.905
04/01/2019 15:00,51.99,57461,3388,150,163,2691,8,6400,4.468.511.905
04/01/2019 16:00,53.07,57768,3536,131,163,2657,8,6495,4.468.511.905
04/01/2019 17:00,53.67,57855,3603,108,160,2657,7,6535,4.468.511.905
04/01/2019 18:00,53.16,57012,3632,83,155,2558,7,6435,4.468.511.905
04/01/2019 19:00,51.99,55545,3723,60,147,2467,6,6403,4.468.511.905
04/01/2019 20:00,51.13,53491,3618,41,141,2410,6,6216,4.468.511.905
04/01/2019 21:00,50.3,52033,3450,26,140,2230,6,5852,4.468.511.905
04/01/2019 22:00,49.67,50167,3468,16,132,2160,6,5782,4.468.511.905
04/01/2019 23:00,48.93,47970,3486,9,119,2075,8,5697,4.468.511.905
05/01/2019 00:00,47.95,45414,3337,8,115,1979,8,5447,4.468.511.905
05/01/2019 01:00,47.24,44393,3259,7,118,1924,11,5319,4.468.511.905
05/01/2019 02:00,46.91,43894,3040,6,128,1844,13,5031,4.468.511.905
05/01/2019 03:00,46.52,43947,2745,5,143,1819,15,4727,4.468.511.905
05/01/2019 04:00,46.43,44311,2615,4,156,1744,12,4531,4.468.511.905
05/01/2019 05:00,47.09,45018,2559,6,174,1633,13,4385,4.468.511.905
05/01/2019 06:00,47.3,46218,2461,10,193,1518,14,4196,4.468.511.905
05/01/2019 07:00,48.08,48063,2230,17,207,1384,16,3854,4.468.511.905
05/01/2019 08:00,49.91,49879,1914,26,212,1260,16,3428,4.468.511.905
05/01/2019 09:00,50.7,51353,1631,35,215,1149,14,3044,4.468.511.905
05/01/2019 10:00,50.95,52429,1295,47,226,1082,16,2666,4.468.511.905
05/01/2019 11:00,51.06,52566,1005,58,247,929,18,2257,4.468.511.905
05/01/2019 12:00,51.43,52484,906,63,265,822,19,2075,4.468.511.905
05/01/2019 13:00,51.7,52204,853,64,267,832,15,2031,4.468.511.905
05/01/2019 14:00,51.82,52312,679,64,261,903,14,1921,4.468.511.905
05/01/2019 15:00,53.24,53320,546,61,254,914,14,1789,4.468.511.905
05/01/2019 16:00,55.98,54523,429,55,250,946,16,1696,4.468.511.905
05/01/2019 17:00,56.28,55036,350,51,239,943,20,1603,4.468.511.905
05/01/2019 18:00,55.81,54364,311,47,226,932,18,1534,4.468.511.905
05/01/2019 19:00,53.99,52810,313,41,213,908,17,1492,4.468.511.905
05/01/2019 20:00,52.68,51144,331,35,197,890,16,1469,4.468.511.905
05/01/2019 21:00,51.86,50049,344,31,185,859,11,1430,4.468.511.905
05/01/2019 22:00,51.09,48695,340,28,170,853,8,1399,4.468.511.905
05/01/2019 23:00,50.21,47252,302,26,161,880,6,1375,4.468.511.905
06/01/2019 00:00,50.26,46537,100,30,168,1033,6,1337,4.468.511.905
06/01/2019 01:00,49.01,45529,107,31,162,1068,5,1373,4.468.511.905
06/01/2019 02:00,48.74,44987,123,30,150,1094,4,1401,4.468.511.905
06/01/2019 03:00,48.6,44848,129,27,137,1127,3,1423,4.468.511.905
06/01/2019 04:00,47.78,45112,141,23,121,1153,2,1440,4.468.511.905
06/01/2019 05:00,48.64,45659,166,20,105,1218,2,1511,4.468.511.905
06/01/2019 06:00,49.35,46636,187,17,86,1284,2,1576,4.468.511.905
06/01/2019 07:00,49.63,48160,215,16,67,1402,3,1703,4.468.511.905
06/01/2019 08:00,50.43,49437,280,14,52,1530,2,1878,4.468.511.905
06/01/2019 09:00,51.76,50443,386,13,41,1680,2,2122,4.468.511.905
06/01/2019 10:00,52.34,51678,506,12,36,1825,2,2381,4.468.511.905
06/01/2019 11:00,52.75,52114,616,11,27,1979,2,2635,4.468.511.905
06/01/2019 12:00,52.77,51888,726,11,21,2035,2,2795,4.468.511.905
06/01/2019 13:00,52.37,51742,791,13,15,2139,2,2960,4.468.511.905
06/01/2019 14:00,51.47,51942,836,14,11,2167,2,3030,4.468.511.905
06/01/2019 15:00,51.54,53082,861,18,9,2236,2,3126,4.468.511.905
06/01/2019 16:00,53.23,54153,894,22,9,2334,2,3261,4.468.511.905
06/01/2019 17:00,54.53,54596,936,25,7,2450,2,3420,4.468.511.905
06/01/2019 18:00,53.72,53934,971,30,6,2540,3,3550,4.468.511.905
06/01/2019 19:00,52.76,52785,1000,35,6,2657,5,3703,4.468.511.905
06/01/2019 20:00,51.93,51187,963,40,9,2774,8,3794,4.468.511.905
06/01/2019 21:00,51.58,49998,899,44,10,2939,8,3900,4.468.511.905
06/01/2019 22:00,50.71,48539,893,47,17,2988,9,3954,4.468.511.905
06/01/2019 23:00,50.1,46462,926,49,25,2969,9,3978,4.468.511.905
07/01/2019 00:00,48.6,44963,851,11,62,2939,8,3871,4.320.059.524
07/01/2019 01:00,48.06,44219,830,25,73,2854,9,3791,4.320.059.524
07/01/2019 02:00,48.05,44052,820,42,83,2686,9,3640,4.320.059.524
07/01/2019 03:00,47.31,44159,816,60,93,2536,10,3515,4.320.059.524
07/01/2019 04:00,48.07,45014,780,82,104,2351,13,3330,4.320.059.524
07/01/2019 05:00,49.91,47261,798,109,116,2264,15,3302,4.320.059.524
07/01/2019 06:00,52.81,51192,826,130,132,2089,15,3192,4.320.059.524
07/01/2019 07:00,55.64,54982,836,135,147,1962,13,3093,4.320.059.524
07/01/2019 08:00,56.98,56014,874,134,160,1988,11,3167,4.320.059.524
07/01/2019 09:00,56.42,56048,1007,124,166,1999,8,3304,4.320.059.524
07/01/2019 10:00,55.87,56194,1110,104,170,1901,9,3294,4.320.059.524
07/01/2019 11:00,55.62,56173,1186,88,168,1849,9,3300,4.320.059.524
07/01/2019 12:00,55.01,55783,1333,79,164,1823,8,3407,4.320.059.524
07/01/2019 13:00,54.28,55822,1602,76,166,1873,6,3723,4.320.059.524
07/01/2019 14:00,53.73,56069,2065,73,175,1987,5,4305,4.320.059.524
07/01/2019 15:00,53.26,56757,2644,64,184,2058,4,4954,4.320.059.524
07/01/2019 16:00,53.28,57456,3242,57,192,2279,5,5775,4.320.059.524
07/01/2019 17:00,53.02,57511,3858,53,195,2373,4,6483,4.320.059.524
07/01/2019 18:00,51.32,56525,4201,53,196,2490,5,6945,4.320.059.524
07/01/2019 19:00,50.76,55233,4367,55,197,2635,5,7259,4.320.059.524
07/01/2019 20:00,50.47,53377,4210,61,200,2794,8,7273,4.320.059.524
07/01/2019 21:00,49.82,51955,3906,65,206,2876,12,7065,4.320.059.524
07/01/2019 22:00,48.8,49939,3761,68,219,2883,18,6949,4.320.059.524
07/01/2019 23:00,46.73,47835,3731,73,230,2720,15,6769,4.320.059.524
08/01/2019 00:00,46.89,46776,4061,156,260,2483,20,6980,4.320.059.524
08/01/2019 01:00,46.21,45966,3888,160,273,2216,23,6560,4.320.059.524
08/01/2019 02:00,46.01,45463,3617,159,305,2061,27,6169,4.320.059.524
08/01/2019 03:00,46.01,45573,3424,155,328,2028,28,5963,4.320.059.524
08/01/2019 04:00,46.33,46261,3342,148,336,2033,30,5889,4.320.059.524
08/01/2019 05:00,47.68,48349,3526,140,345,2087,31,6129,4.320.059.524
08/01/2019 06:00,49.96,51981,3667,132,356,2223,31,6409,4.320.059.524
08/01/2019 07:00,51.36,55431,3779,123,356,2406,30,6694,4.320.059.524
08/01/2019 08:00,51.69,56316,3828,110,354,2574,30,6896,4.320.059.524
08/01/2019 09:00,51.47,56219,3767,98,348,2809,31,7053,4.320.059.524
08/01/2019 10:00,51.46,56538,3902,86,333,2982,28,7331,4.320.059.524
08/01/2019 11:00,51.29,56652,4167,75,314,3201,24,7781,4.320.059.524
08/01/2019 12:00,50.89,56573,4368,64,287,3527,24,8270,4.320.059.524
08/01/2019 13:00,50.71,56661,4446,53,261,3789,22,8571,4.320.059.524
08/01/2019 14:00,50.84,56953,4515,41,246,4122,21,8945,4.320.059.524
08/01/2019 15:00,50.85,57680,4595,33,239,4371,17,9255,4.320.059.524
08/01/2019 16:00,51.16,58310,4664,28,228,4612,16,9548,4.320.059.524
08/01/2019 17:00,51.11,58533,4706,25,217,4763,14,9725,4.320.059.524
08/01/2019 18:00,50.77,57660,4669,24,204,4966,14,9877,4.320.059.524
08/01/2019 19:00,50.01,56640,4813,25,192,5124,10,10164,4.320.059.524
08/01/2019 20:00,49.64,55155,4727,29,188,5296,9,10249,4.320.059.524
08/01/2019 21:00,49.33,53742,4526,38,181,5383,6,10134,4.320.059.524
08/01/2019 22:00,48.8,51805,4484,52,175,5443,6,10160,4.320.059.524
08/01/2019 23:00,47.43,49675,4599,68,164,5485,5,10321,4.320.059.524
09/01/2019 00:00,46.03,47983,4565,71,116,5446,3,10201,4.320.059.524
09/01/2019 01:00,45.09,47116,4416,78,106,5497,4,10101,4.320.059.524
09/01/2019 02:00,44.64,46809,4279,86,102,5502,3,9972,4.320.059.524
09/01/2019 03:00,44.75,46938,4241,99,96,5468,3,9907,4.320.059.524
09/01/2019 04:00,45.25,47647,4209,113,92,5436,3,9853,4.320.059.524
09/01/2019 05:00,47.73,49866,4262,126,88,5384,3,9863,4.320.059.524
09/01/2019 06:00,49.53,53896,4281,129,84,5291,3,9788,4.320.059.524
09/01/2019 07:00,50.96,57942,4172,131,76,5174,3,9556,4.320.059.524
09/01/2019 08:00,51.35,59146,4064,131,70,5036,3,9304,4.320.059.524
09/01/2019 09:00,51.14,59071,3936,125,62,4873,2,8998,4.320.059.524
09/01/2019 10:00,51.28,59219,3960,121,56,4613,2,8752,4.320.059.524
09/01/2019 11:00,51.24,58985,4000,120,51,4421,2,8594,4.320.059.524
09/01/2019 12:00,50.88,58702,4005,120,41,4176,2,8344,4.320.059.524
09/01/2019 13:00,50.79,58572,3905,118,38,3920,3,7984,4.320.059.524
09/01/2019 14:00,51.09,58791,3710,115,39,3759,3,7626,4.320.059.524
09/01/2019 15:00,51.89,59584,3428,109,48,3645,3,7233,4.320.059.524
09/01/2019 16:00,54.17,60507,3182,105,50,3469,4,6810,4.320.059.524
09/01/2019 17:00,55.19,60897,2973,100,49,3300,4,6426,4.320.059.524
09/01/2019 18:00,54.55,59973,2741,93,47,3096,4,5981,4.320.059.524
09/01/2019 19:00,54.32,59054,2619,84,45,2860,4,5612,4.320.059.524
09/01/2019 20:00,53,57620,2357,76,37,2609,4,5083,4.320.059.524
09/01/2019 21:00,51.69,56116,2058,69,32,2337,4,4500,4.320.059.524
09/01/2019 22:00,50.96,54014,1856,64,29,2103,4,4056,4.320.059.524
09/01/2019 23:00,49.96,51642,1656,59,27,1880,3,3625,4.320.059.524
10/01/2019 00:00,50.41,49759,840,35,21,1477,4,2377,4.320.059.524
10/01/2019 01:00,49.95,48727,659,29,18,1388,5,2099,4.320.059.524
10/01/2019 02:00,49.52,48368,507,22,16,1397,6,1948,4.320.059.524
10/01/2019 03:00,49.89,48606,407,17,14,1510,6,1954,4.320.059.524
10/01/2019 04:00,49.8,49426,339,14,13,1700,4,2070,4.320.059.524
10/01/2019 05:00,51.56,51677,281,12,11,1910,5,2219,4.320.059.524
10/01/2019 06:00,55.21,55829,246,11,9,2120,4,2390,4.320.059.524
10/01/2019 07:00,57.75,59973,212,10,8,2365,3,2598,4.320.059.524
10/01/2019 08:00,59.02,60992,189,8,6,2603,4,2810,4.320.059.524
10/01/2019 09:00,58.74,60905,206,7,5,2808,4,3030,4.320.059.524
10/01/2019 10:00,57.73,60873,230,6,4,2901,3,3144,4.320.059.524
10/01/2019 11:00,57.27,60561,275,5,3,3004,3,3290,4.320.059.524
10/01/2019 12:00,56.95,59915,344,5,3,3101,2,3455,4.320.059.524
10/01/2019 13:00,56.48,59577,452,4,3,3217,1,3677,4.320.059.524
10/01/2019 14:00,55.88,59521,586,7,3,3345,1,3942,4.320.059.524
10/01/2019 15:00,55.44,60053,741,15,3,3566,1,4326,4.320.059.524
10/01/2019 16:00,55.48,60758,921,24,3,3762,1,4711,4.320.059.524
10/01/2019 17:00,55.22,61219,1147,32,3,3937,1,5120,4.320.059.524
10/01/2019 18:00,54.2,60206,1345,39,4,4152,1,5541,4.320.059.524
10/01/2019 19:00,52.67,58910,1546,42,5,4299,2,5894,4.320.059.524
10/01/2019 20:00,51.9,56997,1678,43,8,4444,4,6177,4.320.059.524
10/01/2019 21:00,51.26,55407,1833,41,16,4540,8,6438,4.320.059.524
10/01/2019 22:00,50.15,53090,2059,39,26,4649,12,6785,4.320.059.524
10/01/2019 23:00,48.77,50295,2351,38,34,4738,16,7177,4.320.059.524
11/01/2019 00:00,47.84,47617,2638,37,68,4754,16,7513,4.320.059.524
11/01/2019 01:00,46.58,46688,2775,34,82,4805,15,7711,4.320.059.524
11/01/2019 02:00,46.36,46277,2826,30,98,4881,19,7854,4.320.059.524
11/01/2019 03:00,46.14,46298,2941,27,110,4906,25,8009,4.320.059.524
11/01/2019 04:00,46.38,47157,3072,25,126,4864,35,8122,4.320.059.524
11/01/2019 05:00,47.71,49310,3259,21,145,4750,40,8215,4.320.059.524
11/01/2019 06:00,50.16,53421,3424,16,184,4664,43,8331,4.320.059.524
11/01/2019 07:00,51.76,57269,3437,11,231,4559,45,8283,4.320.059.524
11/01/2019 08:00,52.95,58384,3394,7,260,4445,45,8151,4.320.059.524
11/01/2019 09:00,52.5,58245,3435,4,291,4342,45,8117,4.320.059.524
11/01/2019 10:00,51.98,58218,3556,3,305,4306,45,8215,4.320.059.524
11/01/2019 11:00,51.7,57868,3662,2,315,4365,44,8388,4.320.059.524
11/01/2019 12:00,50.98,57229,3712,2,318,4330,38,8400,4.320.059.524
11/01/2019 13:00,50.14,56490,3693,2,320,4385,33,8433,4.320.059.524
11/01/2019 14:00,49.53,56283,3607,4,308,4481,21,8421,4.320.059.524
11/01/2019 15:00,49.29,56741,3441,7,288,4604,17,8357,4.320.059.524
11/01/2019 16:00,49.8,57651,3135,12,262,4647,12,8068,4.320.059.524
11/01/2019 17:00,50.63,58149,2819,19,234,4730,15,7817,4.320.059.524
11/01/2019 18:00,50.07,57473,2533,31,208,4732,20,7524,4.320.059.524
11/01/2019 19:00,49.47,55978,2437,46,193,4732,20,7428,4.320.059.524
11/01/2019 20:00,49.08,53901,2211,66,188,4686,22,7173,4.320.059.524
11/01/2019 21:00,48.55,52541,2009,93,184,4611,26,6923,4.320.059.524
11/01/2019 22:00,47.78,50915,1918,125,185,4531,27,6786,4.320.059.524
11/01/2019 23:00,46.16,49023,1872,153,192,4401,27,6645,4.320.059.524
12/01/2019 00:00,47.77,47424,1839,97,205,4182,20,6343,4.320.059.524
12/01/2019 01:00,47.17,46457,1759,104,212,3963,20,6058,4.320.059.524
12/01/2019 02:00,47.06,45962,1708,106,221,3717,26,5778,4.320.059.524
12/01/2019 03:00,46.24,45985,1740,110,226,3509,26,5611,4.320.059.524
12/01/2019 04:00,46.25,46351,1778,116,225,3321,26,5466,4.320.059.524
12/01/2019 05:00,45.83,47094,1852,123,212,3174,21,5382,4.320.059.524
12/01/2019 06:00,46.28,48455,1938,124,203,3020,18,5303,4.320.059.524
12/01/2019 07:00,47.59,50519,1918,121,199,2920,14,5172,4.320.059.524
12/01/2019 08:00,48.21,52389,1904,120,199,2801,15,5039,4.320.059.524
12/01/2019 09:00,49.91,53674,1921,115,197,2693,13,4939,4.320.059.524
12/01/2019 10:00,50.3,54630,2128,106,194,2534,14,4976,4.320.059.524
12/01/2019 11:00,50.32,54830,2359,93,184,2347,12,4995,4.320.059.524
12/01/2019 12:00,50.32,54489,2575,82,175,2229,13,5074,4.320.059.524
12/01/2019 13:00,49.95,53962,2751,78,159,2058,10,5056,4.320.059.524
12/01/2019 14:00,50.09,54021,2897,77,145,1987,7,5113,4.320.059.524
12/01/2019 15:00,50.82,55117,2995,72,133,1819,6,5025,4.320.059.524
12/01/2019 16:00,51.7,56675,3020,66,120,1708,6,4920,4.320.059.524
12/01/2019 17:00,52.96,57537,2981,58,107,1615,5,4766,4.320.059.524
12/01/2019 18:00,52.32,56826,2904,52,97,1519,4,4576,4.320.059.524
12/01/2019 19:00,51.22,55247,2771,47,95,1474,3,4390,4.320.059.524
12/01/2019 20:00,50.01,53493,2626,40,94,1370,2,4132,4.320.059.524
12/01/2019 21:00,49.63,52355,2445,32,96,1296,1,3870,4.320.059.524
12/01/2019 22:00,48.67,51064,2410,25,97,1173,1,3706,4.320.059.524
12/01/2019 23:00,47.99,49291,2546,18,89,1074,1,3728,4.320.059.524
13/01/2019 00:00,49.45,47880,2501,15,62,933,3,3514,4.320.059.524
13/01/2019 01:00,48.75,46988,2371,11,54,960,2,3398,4.320.059.524
13/01/2019 02:00,48.06,46551,2417,8,50,987,2,3464,4.320.059.524
13/01/2019 03:00,47.88,46518,2513,7,50,1022,1,3593,4.320.059.524
13/01/2019 04:00,47.62,46804,2649,5,51,1133,2,3840,4.320.059.524
13/01/2019 05:00,47.45,47514,2786,3,53,1245,2,4089,4.320.059.524
13/01/2019 06:00,47.5,48170,2862,2,55,1485,2,4406,4.320.059.524
13/01/2019 07:00,47.79,49345,2958,2,63,1688,3,4714,4.320.059.524
13/01/2019 08:00,47.96,50727,3294,3,70,1858,3,5228,4.320.059.524
13/01/2019 09:00,48.44,52234,3652,5,78,1974,3,5712,4.320.059.524
13/01/2019 10:00,49.13,53436,4000,7,87,2034,2,6130,4.320.059.524
13/01/2019 11:00,49.53,54075,4254,11,102,1978,2,6347,4.320.059.524
13/01/2019 12:00,49.62,53970,4443,16,126,1993,2,6580,4.320.059.524
13/01/2019 13:00,49.13,53792,4541,19,151,2067,2,6780,4.320.059.524
13/01/2019 14:00,48.74,53898,4580,26,166,2171,2,6945,4.320.059.524
13/01/2019 15:00,49.12,54877,4669,35,174,2372,3,7253,4.320.059.524
13/01/2019 16:00,50.1,56294,4694,46,189,2672,4,7605,4.320.059.524
13/01/2019 17:00,50.3,57025,4723,57,197,3160,5,8142,4.320.059.524
13/01/2019 18:00,49.62,56547,4753,69,215,3533,6,8576,4.320.059.524
13/01/2019 19:00,49.17,55604,4715,84,223,3858,8,8888,4.320.059.524
13/01/2019 20:00,48.27,54162,4542,100,224,4121,6,8993,4.320.059.524
13/01/2019 21:00,47.6,53058,4400,114,226,4394,6,9140,4.320.059.524
13/01/2019 22:00,46.74,51335,4449,126,219,4582,4,9380,4.320.059.524
13/01/2019 23:00,45.65,49644,4628,133,206,4740,4,9711,4.320.059.524
14/01/2019 00:00,44.79,48489,4698,189,250,5022,10,10169,4.097.321.429
14/01/2019 01:00,42.75,47798,4539,208,233,5102,5,10087,4.097.321.429
14/01/2019 02:00,41.51,47642,4254,222,225,5129,4,9834,4.097.321.429
14/01/2019 03:00,42.44,47979,4358,233,224,5141,3,9959,4.097.321.429
14/01/2019 04:00,43.76,49032,4445,240,237,5133,2,10057,4.097.321.429
14/01/2019 05:00,46.38,51566,4458,240,255,5113,7,10073,4.097.321.429
14/01/2019 06:00,48.63,55800,4476,233,271,5127,18,10125,4.097.321.429
14/01/2019 07:00,51.62,59715,4339,224,296,5053,26,9938,4.097.321.429
14/01/2019 08:00,51.87,60700,4151,218,338,5012,38,9757,4.097.321.429
14/01/2019 09:00,50.88,60615,4038,207,374,5169,45,9833,4.097.321.429
14/01/2019 10:00,50.81,60713,4107,190,410,5249,48,10004,4.097.321.429
14/01/2019 11:00,50.42,60465,4286,169,437,5373,48,10313,4.097.321.429
14/01/2019 12:00,49.97,59794,4432,150,448,5413,47,10490,4.097.321.429
14/01/2019 13:00,50.05,59532,4505,143,446,5526,47,10667,4.097.321.429
14/01/2019 14:00,50.17,59614,4536,145,439,5652,47,10819,4.097.321.429
14/01/2019 15:00,50.45,60097,4560,155,415,5739,46,10915,4.097.321.429
14/01/2019 16:00,51.37,61129,4547,170,405,5815,46,10983,4.097.321.429
14/01/2019 17:00,51.68,61670,4570,184,391,5805,44,10994,4.097.321.429
14/01/2019 18:00,50.95,60604,4586,198,379,5766,39,10968,4.097.321.429
14/01/2019 19:00,50.4,59358,4475,207,362,5705,36,10785,4.097.321.429
14/01/2019 20:00,49.89,57507,4330,212,346,5633,33,10554,4.097.321.429
14/01/2019 21:00,48.58,56110,4249,212,329,5504,28,10322,4.097.321.429
14/01/2019 22:00,47.76,54086,4110,208,324,5373,29,10044,4.097.321.429
14/01/2019 23:00,46.41,51896,4010,200,327,5258,32,9827,4.097.321.429
15/01/2019 00:00,46.44,50745,3290,49,263,5159,29,8790,4.097.321.429
15/01/2019 01:00,45.81,49851,3055,46,271,5020,40,8432,4.097.321.429
15/01/2019 02:00,45.72,49462,2864,41,274,4878,43,8100,4.097.321.429
15/01/2019 03:00,46.06,49639,2667,37,278,4651,40,7673,4.097.321.429
15/01/2019 04:00,46.25,50468,2534,34,292,4446,43,7349,4.097.321.429
15/01/2019 05:00,48.25,52551,2311,32,318,4216,43,6920,4.097.321.429
15/01/2019 06:00,51.08,56501,1965,33,335,3962,44,6339,4.097.321.429
15/01/2019 07:00,54.12,60219,1609,36,337,3626,45,5653,4.097.321.429
15/01/2019 08:00,57.11,61024,1352,43,349,3213,45,5002,4.097.321.429
15/01/2019 09:00,58.28,60769,1237,57,363,2774,47,4478,4.097.321.429
15/01/2019 10:00,57.02,60990,1441,75,374,2279,47,4216,4.097.321.429
15/01/2019 11:00,55.43,60738,2035,94,378,1904,47,4458,4.097.321.429
15/01/2019 12:00,54.29,60318,2636,114,378,1562,47,4737,4.097.321.429
15/01/2019 13:00,53.82,60272,3174,132,372,1418,47,5143,4.097.321.429
15/01/2019 14:00,52.93,60313,3753,140,366,1399,46,5704,4.097.321.429
15/01/2019 15:00,52.79,60790,4037,138,355,1566,45,6141,4.097.321.429
15/01/2019 16:00,53.67,61715,4029,135,344,1634,45,6187,4.097.321.429
15/01/2019 17:00,54.65,62184,3795,133,310,1670,44,5952,4.097.321.429
15/01/2019 18:00,53.99,61215,3456,131,281,1734,42,5644,4.097.321.429
15/01/2019 19:00,53.39,60057,3093,125,254,1804,40,5316,4.097.321.429
15/01/2019 20:00,52.51,58477,2816,117,233,1815,36,5017,4.097.321.429
15/01/2019 21:00,51.65,56995,2631,105,215,1815,33,4799,4.097.321.429
15/01/2019 22:00,50.4,54942,2514,96,197,1772,31,4610,4.097.321.429
15/01/2019 23:00,48.66,52450,2601,89,184,1682,26,4582,4.097.321.429
16/01/2019 00:00,49.44,51122,2196,68,103,1568,8,3943,4.097.321.429
16/01/2019 01:00,48.97,50155,2178,57,94,1406,7,3742,4.097.321.429
16/01/2019 02:00,48.87,49812,2312,49,86,1203,7,3657,4.097.321.429
16/01/2019 03:00,49.02,49966,2451,41,77,1010,8,3587,4.097.321.429
16/01/2019 04:00,49.08,50927,2622,37,70,847,8,3584,4.097.321.429
16/01/2019 05:00,51.03,53398,2892,40,61,732,7,3732,4.097.321.429
16/01/2019 06:00,52.88,57756,3125,47,49,635,5,3861,4.097.321.429
16/01/2019 07:00,55.56,61888,3149,53,39,653,4,3898,4.097.321.429
16/01/2019 08:00,57.51,62717,3071,55,32,819,3,3980,4.097.321.429
16/01/2019 09:00,55.9,62390,3069,54,31,1095,2,4251,4.097.321.429
16/01/2019 10:00,55.89,62324,3264,56,36,1397,2,4755,4.097.321.429
16/01/2019 11:00,55.5,61867,3563,63,43,1731,2,5402,4.097.321.429
16/01/2019 12:00,54.22,61462,3808,71,52,1989,2,5922,4.097.321.429
16/01/2019 13:00,53.27,61151,3876,80,68,2296,2,6322,4.097.321.429
16/01/2019 14:00,53.81,61235,3966,89,94,2552,3,6704,4.097.321.429
16/01/2019 15:00,53.84,61818,4076,94,130,2764,4,7068,4.097.321.429
16/01/2019 16:00,55.17,62486,4127,100,162,3032,8,7429,4.097.321.429
16/01/2019 17:00,54.56,62677,4266,103,190,3159,11,7729,4.097.321.429
16/01/2019 18:00,52.91,61498,4374,104,219,3277,16,7990,4.097.321.429
16/01/2019 19:00,52.32,60229,4333,102,251,3267,16,7969,4.097.321.429
16/01/2019 20:00,51.24,58423,4169,101,297,3189,23,7779,4.097.321.429
16/01/2019 21:00,50.17,56812,4116,104,327,3099,30,7676,4.097.321.429
16/01/2019 22:00,48.66,54469,3963,106,354,3028,34,7485,4.097.321.429
16/01/2019 23:00,47.61,51883,3907,108,377,3020,48,7460,4.097.321.429
17/01/2019 00:00,48.12,50255,3609,95,407,2978,45,7134,4.097.321.429
17/01/2019 01:00,47.24,49291,3349,93,419,2957,45,6863,4.097.321.429
17/01/2019 02:00,47.24,48970,3054,94,422,2981,45,6596,4.097.321.429
17/01/2019 03:00,47.39,49176,2748,98,423,2974,45,6288,4.097.321.429
17/01/2019 04:00,48.22,50102,2596,100,423,2951,45,6115,4.097.321.429
17/01/2019 05:00,50.13,52475,2524,98,431,2881,45,5979,4.097.321.429
17/01/2019 06:00,52.75,57022,2419,93,440,2832,45,5829,4.097.321.429
17/01/2019 07:00,53.95,61347,2290,83,452,2805,46,5676,4.097.321.429
17/01/2019 08:00,54.42,62212,2192,70,462,2698,46,5468,4.097.321.429
17/01/2019 09:00,54.86,62147,2086,59,466,2625,46,5282,4.097.321.429
17/01/2019 10:00,54.81,62297,1943,50,467,2467,46,4973,4.097.321.429
17/01/2019 11:00,54.71,62141,1903,44,473,2421,46,4887,4.097.321.429
17/01/2019 12:00,54.59,61733,1912,39,474,2369,46,4840,4.097.321.429
17/01/2019 13:00,54.55,61518,1876,35,471,2329,45,4756,4.097.321.429
17/01/2019 14:00,55.26,61691,1830,32,463,2339,45,4709,4.097.321.429
17/01/2019 15:00,56.05,62304,1891,31,446,2391,42,4801,4.097.321.429
17/01/2019 16:00,57.07,63234,2012,35,414,2424,33,4918,4.097.321.429
17/01/2019 17:00,57.73,63972,2269,41,368,2476,23,5177,4.097.321.429
17/01/2019 18:00,55.22,63071,2466,51,314,2584,17,5432,4.097.321.429
17/01/2019 19:00,53.87,61906,2463,66,263,2653,9,5454,4.097.321.429
17/01/2019 20:00,53.05,60129,2345,83,228,2784,8,5448,4.097.321.429
17/01/2019 21:00,52.75,58681,2290,103,201,2966,8,5568,4.097.321.429
17/01/2019 22:00,51.19,56559,2151,129,171,3110,6,5567,4.097.321.429
17/01/2019 23:00,50.03,54100,1890,150,141,3193,4,5378,4.097.321.429
18/01/2019 00:00,51.06,52600,1772,185,0,3249,6,5212,4.097.321.429
18/01/2019 01:00,50.45,51700,1594,191,0,3258,7,5050,4.097.321.429
18/01/2019 02:00,50.09,51325,1358,194,0,3252,6,4810,4.097.321.429
18/01/2019 03:00,50.1,51569,1202,198,0,3302,4,4706,4.097.321.429
18/01/2019 04:00,50.61,52459,1129,201,0,3282,4,4616,4.097.321.429
18/01/2019 05:00,52.92,54798,1077,199,0,3277,4,4557,4.097.321.429
18/01/2019 06:00,55.43,59111,1095,191,0,3192,4,4482,4.097.321.429
18/01/2019 07:00,61.4,63081,1000,186,0,3108,4,4298,4.097.321.429
18/01/2019 08:00,62.84,64135,937,186,0,3011,6,4140,4.097.321.429
18/01/2019 09:00,63.7,63899,958,189,0,2857,8,4012,4.097.321.429
18/01/2019 10:00,61.45,63823,975,187,0,2784,11,3957,4.097.321.429
18/01/2019 11:00,61.62,63339,995,174,0,2720,13,3902,4.097.321.429
18/01/2019 12:00,61.21,62367,1044,161,0,2694,17,3916,4.097.321.429
18/01/2019 13:00,60.54,61407,1105,161,0,2682,17,3965,4.097.321.429
18/01/2019 14:00,59.65,61036,1193,171,0,2827,16,4207,4.097.321.429
18/01/2019 15:00,58.98,61360,1325,191,0,3006,14,4536,4.097.321.429
18/01/2019 16:00,60.93,62358,1356,208,0,3191,15,4770,4.097.321.429
18/01/2019 17:00,60.92,63175,1323,214,0,3210,19,4766,4.097.321.429
18/01/2019 18:00,61.56,62471,1124,220,0,3200,22,4566,4.097.321.429
18/01/2019 19:00,59.02,60996,955,219,0,3276,27,4477,4.097.321.429
18/01/2019 20:00,57.89,58875,890,210,0,3223,29,4352,4.097.321.429
18/01/2019 21:00,56.19,57477,799,201,0,3149,30,4179,4.097.321.429
18/01/2019 22:00,54.93,55687,739,194,0,3082,24,4039,4.097.321.429
18/01/2019 23:00,52.99,53799,697,185,0,2956,22,3860,4.097.321.429
19/01/2019 00:00,53.43,53030,684,192,266,2742,16,3900,4.097.321.429
19/01/2019 01:00,52.9,52087,683,191,255,2607,15,3751,4.097.321.429
19/01/2019 02:00,53.11,51609,690,194,247,2516,15,3662,4.097.321.429
19/01/2019 03:00,52.04,51562,700,199,225,2439,15,3578,4.097.321.429
19/01/2019 04:00,51.84,51965,665,196,199,2501,15,3576,4.097.321.429
19/01/2019 05:00,51.58,52784,606,188,169,2557,13,3533,4.097.321.429
19/01/2019 06:00,51.42,54016,593,174,148,2707,14,3636,4.097.321.429
19/01/2019 07:00,52.53,56112,613,157,133,2795,10,3708,4.097.321.429
19/01/2019 08:00,54.49,57864,608,139,121,2872,11,3751,4.097.321.429
19/01/2019 09:00,55.96,59155,638,120,108,3015,10,3891,4.097.321.429
19/01/2019 10:00,57.96,59879,680,106,99,3035,10,3930,4.097.321.429
19/01/2019 11:00,56.75,59739,718,94,98,3158,13,4081,4.097.321.429
19/01/2019 12:00,54.94,59025,749,85,98,3234,13,4179,4.097.321.429
19/01/2019 13:00,54.2,58169,727,79,109,3413,11,4339,4.097.321.429
19/01/2019 14:00,53.55,58002,690,76,129,3515,10,4420,4.097.321.429
19/01/2019 15:00,55.02,58861,648,73,153,3612,16,4502,4.097.321.429
19/01/2019 16:00,58.37,60318,667,72,176,3719,21,4655,4.097.321.429
19/01/2019 17:00,61.03,61261,689,69,204,3687,29,4678,4.097.321.429
19/01/2019 18:00,59.3,60487,671,66,234,3589,39,4599,4.097.321.429
19/01/2019 19:00,56.71,58825,644,62,261,3484,40,4491,4.097.321.429
19/01/2019 20:00,54.4,57002,644,57,284,3308,43,4336,4.097.321.429
19/01/2019 21:00,53.29,55842,681,53,301,3149,43,4227,4.097.321.429
19/01/2019 22:00,52.56,54442,710,49,309,3083,38,4189,4.097.321.429
19/01/2019 23:00,51.45,52797,721,44,312,3004,32,4113,4.097.321.429
20/01/2019 00:00,51.85,51070,721,28,346,3130,39,4264,4.097.321.429
20/01/2019 01:00,50.98,50187,685,25,346,3013,42,4111,4.097.321.429
20/01/2019 02:00,50.98,49709,614,23,339,2860,42,3878,4.097.321.429
20/01/2019 03:00,50.64,49601,559,22,323,2724,35,3663,4.097.321.429
20/01/2019 04:00,50.88,49910,504,24,295,2689,33,3545,4.097.321.429
20/01/2019 05:00,50.99,50549,447,26,266,2600,29,3368,4.097.321.429
20/01/2019 06:00,50.98,51394,377,31,231,2540,29,3208,4.097.321.429
20/01/2019 07:00,51.57,52700,328,36,196,2456,24,3040,4.097.321.429
20/01/2019 08:00,51.93,54055,269,41,160,2336,23,2829,4.097.321.429
20/01/2019 09:00,53.17,55739,233,44,127,2267,20,2691,4.097.321.429
20/01/2019 10:00,54.12,56963,230,43,99,2074,18,2464,4.097.321.429
20/01/2019 11:00,54.33,57358,252,42,84,1837,18,2233,4.097.321.429
20/01/2019 12:00,53.86,56811,246,40,73,1723,20,2102,4.097.321.429
20/01/2019 13:00,53.3,56462,243,41,63,1579,19,1945,4.097.321.429
20/01/2019 14:00,53.72,56634,252,46,56,1514,15,1883,4.097.321.429
20/01/2019 15:00,55.17,57770,269,51,57,1525,15,1917,4.097.321.429
20/01/2019 16:00,57.69,59615,313,55,59,1544,13,1984,4.097.321.429
20/01/2019 17:00,60.86,60987,354,60,59,1482,14,1969,4.097.321.429
20/01/2019 18:00,61.3,60788,393,63,58,1421,18,1953,4.097.321.429
20/01/2019 19:00,60.49,59943,427,62,56,1302,22,1869,4.097.321.429
20/01/2019 20:00,58.64,58525,493,60,55,1140,17,1765,4.097.321.429
20/01/2019 21:00,56.72,57495,594,60,55,1038,15,1762,4.097.321.429
20/01/2019 22:00,56.74,55884,721,56,55,946,11,1789,4.097.321.429
20/01/2019 23:00,54.26,53980,877,52,55,884,8,1876,4.097.321.429
21/01/2019 00:00,54.71,52744,1345,78,90,832,8,2353,3.828.154.762
21/01/2019 01:00,52.84,52049,1565,64,86,782,9,2506,3.828.154.762
21/01/2019 02:00,51.98,51783,1825,55,80,751,8,2719,3.828.154.762
21/01/2019 03:00,51.77,51951,2029,55,73,776,6,2939,3.828.154.762
21/01/2019 04:00,52.46,52841,2142,58,65,823,5,3093,3.828.154.762
21/01/2019 05:00,54.8,55247,2139,60,56,877,4,3136,3.828.154.762
21/01/2019 06:00,60.74,59726,2232,61,42,917,4,3256,3.828.154.762
21/01/2019 07:00,68,64004,2304,59,36,939,3,3341,3.828.154.762
21/01/2019 08:00,73.1,64931,2349,57,34,953,4,3397,3.828.154.762
21/01/2019 09:00,72.07,64812,2398,58,34,982,4,3476,3.828.154.762
21/01/2019 10:00,69.99,64794,2399,58,34,990,4,3485,3.828.154.762
21/01/2019 11:00,67.78,64340,2376,61,34,959,4,3434,3.828.154.762
21/01/2019 12:00,64.12,63650,2322,63,38,930,4,3357,3.828.154.762
21/01/2019 13:00,64.87,63410,2236,68,43,895,4,3246,3.828.154.762
21/01/2019 14:00,64.4,63417,2068,68,49,904,3,3092,3.828.154.762
21/01/2019 15:00,68.22,63911,1877,67,57,894,3,2898,3.828.154.762
21/01/2019 16:00,70.06,64843,1686,64,61,875,2,2688,3.828.154.762
21/01/2019 17:00,73.67,65469,1413,64,66,814,2,2359,3.828.154.762
21/01/2019 18:00,73.6,64458,1114,63,72,786,2,2037,3.828.154.762
21/01/2019 19:00,68.25,63139,824,66,78,739,3,1710,3.828.154.762
21/01/2019 20:00,64.25,61298,625,66,82,671,4,1448,3.828.154.762
21/01/2019 21:00,60.05,59748,493,63,86,659,4,1305,3.828.154.762
21/01/2019 22:00,57.61,57629,397,60,90,631,4,1182,3.828.154.762
21/01/2019 23:00,54.74,55307,378,56,90,589,4,1117,3.828.154.762
22/01/2019 00:00,54.46,54215,279,60,52,646,4,1041,3.828.154.762
22/01/2019 01:00,53.73,53199,339,59,53,600,4,1055,3.828.154.762
22/01/2019 02:00,53.11,52795,401,55,51,562,4,1073,3.828.154.762
22/01/2019 03:00,52.3,52937,512,52,50,589,5,1208,3.828.154.762
22/01/2019 04:00,53,53722,589,51,48,605,4,1297,3.828.154.762
22/01/2019 05:00,54.87,55944,690,50,47,641,5,1433,3.828.154.762
22/01/2019 06:00,58.77,60127,838,47,48,708,5,1646,3.828.154.762
22/01/2019 07:00,67.14,63873,960,39,48,758,5,1810,3.828.154.762
22/01/2019 08:00,69.96,64518,1087,29,48,798,5,1967,3.828.154.762
22/01/2019 09:00,69.23,64055,1238,20,46,830,5,2139,3.828.154.762
22/01/2019 10:00,67.77,64078,1392,14,39,757,5,2207,3.828.154.762
22/01/2019 11:00,65.46,63844,1556,10,34,674,5,2279,3.828.154.762
22/01/2019 12:00,60.87,63248,1757,8,31,653,7,2456,3.828.154.762
22/01/2019 13:00,58.43,62967,1894,7,38,638,8,2585,3.828.154.762
22/01/2019 14:00,59,62907,2052,6,55,609,10,2732,3.828.154.762
22/01/2019 15:00,62.79,63351,2201,5,78,598,11,2893,3.828.154.762
22/01/2019 16:00,66.03,64198,2343,5,93,642,12,3095,3.828.154.762
22/01/2019 17:00,68.76,64788,2586,4,103,691,12,3396,3.828.154.762
22/01/2019 18:00,66.88,63771,2795,4,112,736,11,3658,3.828.154.762
22/01/2019 19:00,59.06,62558,2863,5,117,750,12,3747,3.828.154.762
22/01/2019 20:00,56.69,60902,2846,5,118,809,14,3792,3.828.154.762
22/01/2019 21:00,55.18,59345,2841,6,120,859,14,3840,3.828.154.762
22/01/2019 22:00,54.78,57114,2729,8,120,874,13,3744,3.828.154.762
22/01/2019 23:00,53.03,54596,2667,10,118,898,13,3706,3.828.154.762
23/01/2019 00:00,52.73,52832,2377,11,0,878,13,3279,3.828.154.762
23/01/2019 01:00,52.11,51778,2224,14,0,895,10,3143,3.828.154.762
23/01/2019 02:00,51.71,51398,2101,17,0,930,9,3057,3.828.154.762
23/01/2019 03:00,50.99,51353,1993,20,0,980,9,3002,3.828.154.762
23/01/2019 04:00,51.7,52154,1901,23,0,1020,10,2954,3.828.154.762
23/01/2019 05:00,54.78,54513,1782,25,0,1069,12,2888,3.828.154.762
23/01/2019 06:00,58.37,59037,1759,28,0,1093,13,2893,3.828.154.762
23/01/2019 07:00,69.15,63482,1702,31,0,1130,12,2875,3.828.154.762
23/01/2019 08:00,76.94,64329,1613,34,0,1177,15,2839,3.828.154.762
23/01/2019 09:00,72.5,63897,1548,36,0,1189,12,2785,3.828.154.762
23/01/2019 10:00,72.21,63798,1487,37,0,1146,10,2680,3.828.154.762
23/01/2019 11:00,71.18,63397,1368,38,0,1071,9,2486,3.828.154.762
23/01/2019 12:00,67.58,62809,1295,36,0,953,8,2292,3.828.154.762
23/01/2019 13:00,65.81,62413,1250,36,0,882,9,2177,3.828.154.762
23/01/2019 14:00,65.36,62449,1159,41,0,900,8,2108,3.828.154.762
23/01/2019 15:00,66.61,63197,1094,51,0,948,7,2100,3.828.154.762
23/01/2019 16:00,70.57,64356,1095,60,0,985,8,2148,3.828.154.762
23/01/2019 17:00,72.74,65144,1193,71,0,1046,8,2318,3.828.154.762
23/01/2019 18:00,70.87,64226,1306,77,0,1088,10,2481,3.828.154.762
23/01/2019 19:00,60.06,63138,1306,84,0,1065,10,2465,3.828.154.762
23/01/2019 20:00,57.69,61573,1285,90,0,1137,11,2523,3.828.154.762
23/01/2019 21:00,57.03,60074,1252,94,0,1116,11,2473,3.828.154.762
23/01/2019 22:00,56.49,57702,1193,101,0,1069,11,2374,3.828.154.762
23/01/2019 23:00,54.72,55112,1097,106,0,1045,11,2259,3.828.154.762
24/01/2019 00:00,55.76,52795,956,79,26,1022,7,2090,3.828.154.762
24/01/2019 01:00,55.54,51796,832,80,22,1008,8,1950,3.828.154.762
24/01/2019 02:00,55.3,51474,732,83,21,969,8,1813,3.828.154.762
24/01/2019 03:00,55.07,51750,658,87,19,963,7,1734,3.828.154.762
24/01/2019 04:00,55.54,52655,636,87,19,970,6,1718,3.828.154.762
24/01/2019 05:00,58.03,55072,638,89,21,1009,7,1764,3.828.154.762
24/01/2019 06:00,61.79,59603,682,91,22,1023,7,1825,3.828.154.762
24/01/2019 07:00,77.24,63817,723,97,22,1069,14,1925,3.828.154.762
24/01/2019 08:00,84.21,64486,780,99,19,1109,14,2021,3.828.154.762
24/01/2019 09:00,84.97,64139,841,103,16,1172,13,2145,3.828.154.762
24/01/2019 10:00,82.73,64067,874,101,13,1214,13,2215,3.828.154.762
24/01/2019 11:00,82.9,63785,837,92,9,1176,12,2126,3.828.154.762
24/01/2019 12:00,81.59,63125,789,87,7,1142,12,2037,3.828.154.762
24/01/2019 13:00,78.96,62919,706,81,7,1098,4,1896,3.828.154.762
24/01/2019 14:00,72.78,62899,615,79,19,1098,4,1815,3.828.154.762
24/01/2019 15:00,72.85,63355,528,80,29,1128,4,1769,3.828.154.762
24/01/2019 16:00,76.95,64385,458,77,42,1228,4,1809,3.828.154.762
24/01/2019 17:00,81.92,65287,434,71,61,1261,12,1839,3.828.154.762
24/01/2019 18:00,77.87,64449,439,64,79,1307,12,1901,3.828.154.762
24/01/2019 19:00,62.85,63264,459,58,96,1289,5,1907,3.828.154.762
24/01/2019 20:00,59.54,61524,443,51,106,1290,5,1895,3.828.154.762
24/01/2019 21:00,58.86,60045,395,46,112,1305,5,1863,3.828.154.762
24/01/2019 22:00,57.75,57833,343,40,122,1250,5,1760,3.828.154.762
24/01/2019 23:00,56.7,55308,294,37,126,1203,6,1666,3.828.154.762
25/01/2019 00:00,57.1,53183,167,26,108,1267,6,1574,3.828.154.762
25/01/2019 01:00,56.31,52188,155,21,111,1195,6,1488,3.828.154.762
25/01/2019 02:00,55.53,51803,161,15,120,1136,6,1438,3.828.154.762
25/01/2019 03:00,54.98,52011,165,12,129,1097,6,1409,3.828.154.762
25/01/2019 04:00,54.85,52942,180,10,138,1041,7,1376,3.828.154.762
25/01/2019 05:00,57.23,55297,202,8,147,977,9,1343,3.828.154.762
25/01/2019 06:00,61.21,59519,263,7,160,913,9,1352,3.828.154.762
25/01/2019 07:00,69.54,63681,333,8,164,870,11,1386,3.828.154.762
25/01/2019 08:00,76.88,64610,423,8,159,825,11,1426,3.828.154.762
25/01/2019 09:00,74.73,64284,509,8,154,795,11,1477,3.828.154.762
25/01/2019 10:00,69.89,64417,628,7,148,728,9,1520,3.828.154.762
25/01/2019 11:00,67.02,63969,757,6,142,647,9,1561,3.828.154.762
25/01/2019 12:00,62.76,63327,926,5,135,587,9,1662,3.828.154.762
25/01/2019 13:00,61.64,62579,1100,4,134,520,9,1767,3.828.154.762
25/01/2019 14:00,60.81,62202,1324,5,133,533,9,2004,3.828.154.762
25/01/2019 15:00,60.77,62430,1575,7,131,593,7,2313,3.828.154.762
25/01/2019 16:00,61.41,63379,1852,9,125,609,8,2603,3.828.154.762
25/01/2019 17:00,61.98,64192,2272,11,117,628,8,3036,3.828.154.762
25/01/2019 18:00,60.22,63326,2683,13,105,647,8,3456,3.828.154.762
25/01/2019 19:00,56.72,61731,2854,14,89,657,7,3621,3.828.154.762
25/01/2019 20:00,54.86,59596,2864,18,73,665,7,3627,3.828.154.762
25/01/2019 21:00,54.04,58069,2810,22,62,666,8,3568,3.828.154.762
25/01/2019 22:00,53.3,56240,2545,25,51,686,7,3314,3.828.154.762
25/01/2019 23:00,52.11,54283,2254,26,42,723,5,3050,3.828.154.762
26/01/2019 00:00,51.91,52418,1746,46,0,690,4,2486,3.828.154.762
26/01/2019 01:00,51.52,51388,1480,45,0,714,4,2243,3.828.154.762
26/01/2019 02:00,50.98,50901,1220,44,0,746,4,2014,3.828.154.762
26/01/2019 03:00,50.85,50806,1005,39,0,798,4,1846,3.828.154.762
26/01/2019 04:00,51.52,51067,876,34,0,816,4,1730,3.828.154.762
26/01/2019 05:00,51.74,51835,795,31,0,831,4,1661,3.828.154.762
26/01/2019 06:00,52.16,53041,813,39,0,865,4,1721,3.828.154.762
26/01/2019 07:00,53.1,54959,793,53,0,886,4,1736,3.828.154.762
26/01/2019 08:00,53.82,56726,765,64,0,901,4,1734,3.828.154.762
26/01/2019 09:00,56.03,58201,779,68,0,903,3,1753,3.828.154.762
26/01/2019 10:00,57.91,59117,786,69,0,866,3,1724,3.828.154.762
26/01/2019 11:00,58.31,59171,763,73,0,820,3,1659,3.828.154.762
26/01/2019 12:00,56.48,58728,791,78,0,782,3,1654,3.828.154.762
26/01/2019 13:00,56.14,58291,851,81,0,798,3,1733,3.828.154.762
26/01/2019 14:00,54.24,58132,958,89,0,812,3,1862,3.828.154.762
26/01/2019 15:00,53.95,58879,1137,107,0,881,3,2128,3.828.154.762
26/01/2019 16:00,55.21,60521,1311,131,0,963,3,2408,3.828.154.762
26/01/2019 17:00,56.63,61899,1578,160,0,1039,3,2780,3.828.154.762
26/01/2019 18:00,57.02,61270,1813,182,0,1141,4,3140,3.828.154.762
26/01/2019 19:00,54.98,59707,2021,183,0,1207,3,3414,3.828.154.762
26/01/2019 20:00,53.01,58002,2319,173,0,1267,3,3762,3.828.154.762
26/01/2019 21:00,52.39,56898,2551,163,0,1326,3,4043,3.828.154.762
26/01/2019 22:00,51.88,55465,2738,159,0,1423,3,4323,3.828.154.762
26/01/2019 23:00,50.81,53979,2950,155,0,1501,3,4609,3.828.154.762
27/01/2019 00:00,51.36,52264,2544,212,28,1780,5,4569,3.828.154.762
27/01/2019 01:00,50.73,51408,2518,218,31,1883,5,4655,3.828.154.762
27/01/2019 02:00,50.21,50926,2541,220,35,2019,5,4820,3.828.154.762
27/01/2019 03:00,50.12,50907,2616,219,39,2186,5,5065,3.828.154.762
27/01/2019 04:00,50.1,51180,2715,212,50,2345,6,5328,3.828.154.762
27/01/2019 05:00,50.23,51805,2759,202,62,2444,6,5473,3.828.154.762
27/01/2019 06:00,50.94,52755,2789,192,78,2541,7,5607,3.828.154.762
27/01/2019 07:00,51.24,53969,2722,179,93,2645,7,5646,3.828.154.762
27/01/2019 08:00,51.32,55313,2656,159,103,2704,7,5629,3.828.154.762
27/01/2019 09:00,51.57,57036,2513,138,114,2760,9,5534,3.828.154.762
27/01/2019 10:00,52.51,58241,2401,119,122,2768,7,5417,3.828.154.762
27/01/2019 11:00,52.58,58887,2211,103,135,2769,7,5225,3.828.154.762
27/01/2019 12:00,52.22,58715,2062,92,154,2782,8,5098,3.828.154.762
27/01/2019 13:00,52.02,58556,1943,84,183,2801,10,5021,3.828.154.762
27/01/2019 14:00,52.03,58634,1781,78,228,2843,10,4940,3.828.154.762
27/01/2019 15:00,52.17,59447,1619,73,269,2881,13,4855,3.828.154.762
27/01/2019 16:00,53.68,60999,1509,70,300,2899,15,4793,3.828.154.762
27/01/2019 17:00,54.42,62090,1428,67,332,2891,19,4737,3.828.154.762
27/01/2019 18:00,54.48,61537,1312,64,355,2929,23,4683,3.828.154.762
27/01/2019 19:00,54.27,60542,1154,63,368,2933,29,4547,3.828.154.762
27/01/2019 20:00,53.56,59201,994,66,371,2916,31,4378,3.828.154.762
27/01/2019 21:00,52.78,58090,914,70,372,2937,35,4328,3.828.154.762
27/01/2019 22:00,52.48,56326,829,67,375,2970,34,4275,3.828.154.762
27/01/2019 23:00,51.52,54468,785,62,378,2900,34,4159,3.828.154.762
28/01/2019 00:00,51.06,53394,775,40,404,2843,41,4103,3.570.654.762
28/01/2019 01:00,50.65,52661,731,43,404,2775,39,3992,3.570.654.762
28/01/2019 02:00,50.46,52427,685,44,393,2649,39,3810,3.570.654.762
28/01/2019 03:00,50.55,52621,707,46,382,2621,39,3795,3.570.654.762
28/01/2019 04:00,51.04,53462,725,47,378,2564,39,3753,3.570.654.762
28/01/2019 05:00,53.71,55853,781,47,377,2431,39,3675,3.570.654.762
28/01/2019 06:00,55.22,60186,884,48,374,2346,39,3691,3.570.654.762
28/01/2019 07:00,61.7,64219,972,50,365,2229,38,3654,3.570.654.762
28/01/2019 08:00,62.85,65124,1114,54,359,2153,37,3717,3.570.654.762
28/01/2019 09:00,61.94,65033,1217,54,351,2014,31,3667,3.570.654.762
28/01/2019 10:00,58.85,64985,1375,53,336,1907,28,3699,3.570.654.762
28/01/2019 11:00,57.73,64615,1520,53,309,1752,28,3662,3.570.654.762
28/01/2019 12:00,56.91,64041,1696,51,285,1652,28,3712,3.570.654.762
28/01/2019 13:00,56.62,63806,1857,47,264,1522,28,3718,3.570.654.762
28/01/2019 14:00,56.77,63766,1998,43,250,1428,20,3739,3.570.654.762
28/01/2019 15:00,56.95,63996,2099,46,235,1443,19,3842,3.570.654.762
28/01/2019 16:00,57.74,64711,2219,48,223,1349,18,3857,3.570.654.762
28/01/2019 17:00,61.15,65343,2314,51,213,1249,18,3845,3.570.654.762
28/01/2019 18:00,59.51,64441,2288,52,199,1163,19,3721,3.570.654.762
28/01/2019 19:00,55.96,63085,2174,53,184,1089,20,3520,3.570.654.762
28/01/2019 20:00,55.1,61242,2111,50,165,1030,19,3375,3.570.654.762
28/01/2019 21:00,54.73,59801,2045,48,152,992,15,3252,3.570.654.762
28/01/2019 22:00,53.59,57576,1923,45,137,938,13,3056,3.570.654.762
28/01/2019 23:00,52.37,55244,1866,42,127,936,12,2983,3.570.654.762
29/01/2019 00:00,51.28,54096,1669,82,141,946,10,2848,3.570.654.762
29/01/2019 01:00,50.65,53119,1581,94,126,972,11,2784,3.570.654.762
29/01/2019 02:00,50.57,52754,1428,108,115,1009,9,2669,3.570.654.762
29/01/2019 03:00,50.97,52839,1242,122,102,1021,7,2494,3.570.654.762
29/01/2019 04:00,51.52,53600,1026,136,87,1013,7,2269,3.570.654.762
29/01/2019 05:00,53.84,55847,888,150,78,1020,6,2142,3.570.654.762
29/01/2019 06:00,56.17,59934,817,162,70,993,6,2048,3.570.654.762
29/01/2019 07:00,61.57,63801,702,173,63,956,6,1900,3.570.654.762
29/01/2019 08:00,65.43,64446,657,180,62,919,6,1824,3.570.654.762
29/01/2019 09:00,66.19,64029,701,185,69,866,6,1827,3.570.654.762
29/01/2019 10:00,66.02,64038,779,188,77,780,5,1829,3.570.654.762
29/01/2019 11:00,63.67,63854,885,188,83,725,3,1884,3.570.654.762
29/01/2019 12:00,61.75,63329,950,188,88,682,3,1911,3.570.654.762
29/01/2019 13:00,61.31,63104,1006,185,92,652,4,1939,3.570.654.762
29/01/2019 14:00,61.91,62867,1047,179,97,664,5,1992,3.570.654.762
29/01/2019 15:00,61.93,63291,1047,176,105,671,7,2006,3.570.654.762
29/01/2019 16:00,62.76,64179,1072,176,113,719,10,2090,3.570.654.762
29/01/2019 17:00,63.65,65223,1148,176,119,758,10,2211,3.570.654.762
29/01/2019 18:00,62.82,64626,1235,174,126,806,7,2348,3.570.654.762
29/01/2019 19:00,61.15,63602,1256,171,131,817,8,2383,3.570.654.762
29/01/2019 20:00,57.57,62185,1248,167,134,797,12,2358,3.570.654.762
29/01/2019 21:00,55.53,60742,1302,162,142,798,14,2418,3.570.654.762
29/01/2019 22:00,53.7,58614,1382,155,149,807,15,2508,3.570.654.762
29/01/2019 23:00,52.59,56240,1370,147,155,816,13,2501,3.570.654.762
30/01/2019 00:00,51.56,54387,1126,136,174,807,10,2253,3.570.654.762
30/01/2019 01:00,51.2,53481,1050,127,173,786,8,2144,3.570.654.762
30/01/2019 02:00,50.85,53283,985,118,156,771,10,2040,3.570.654.762
30/01/2019 03:00,50.96,53491,927,106,142,773,5,1953,3.570.654.762
30/01/2019 04:00,51.56,54382,936,96,127,767,5,1931,3.570.654.762
30/01/2019 05:00,53.85,56762,1075,85,116,747,4,2027,3.570.654.762
30/01/2019 06:00,55.68,61059,1318,77,105,734,5,2239,3.570.654.762
30/01/2019 07:00,61.57,65319,1460,69,92,725,5,2351,3.570.654.762
30/01/2019 08:00,63.58,66071,1560,66,78,704,4,2412,3.570.654.762
30/01/2019 09:00,63.18,65673,1672,66,60,668,4,2470,3.570.654.762
30/01/2019 10:00,60.4,65509,1773,66,50,590,3,2482,3.570.654.762
30/01/2019 11:00,57.31,65041,1885,62,36,525,3,2511,3.570.654.762
30/01/2019 12:00,56.87,64431,2034,59,27,470,3,2593,3.570.654.762
30/01/2019 13:00,56.28,63906,2203,56,22,480,3,2764,3.570.654.762
30/01/2019 14:00,55.94,63789,2434,53,21,520,2,3030,3.570.654.762
30/01/2019 15:00,55.95,64239,2641,53,21,598,2,3315,3.570.654.762
30/01/2019 16:00,56.95,65201,2874,54,23,739,2,3692,3.570.654.762
30/01/2019 17:00,59.93,66115,3113,55,29,833,1,4031,3.570.654.762
30/01/2019 18:00,58.29,65298,3327,55,32,937,2,4353,3.570.654.762
30/01/2019 19:00,56.56,64148,3397,54,35,1054,2,4542,3.570.654.762
30/01/2019 20:00,53.87,62567,3450,52,41,1151,2,4696,3.570.654.762
30/01/2019 21:00,53.41,61005,3596,53,45,1232,2,4928,3.570.654.762
30/01/2019 22:00,51.94,58681,3636,54,51,1267,2,5010,3.570.654.762
30/01/2019 23:00,50.75,56098,3741,56,53,1325,3,5178,3.570.654.762
31/01/2019 00:00,51.02,54451,3325,56,0,1308,2,4691,3.570.654.762
31/01/2019 01:00,50.53,53548,3346,64,0,1400,2,4812,3.570.654.762
31/01/2019 02:00,50.45,53221,3351,74,0,1457,2,4884,3.570.654.762
31/01/2019 03:00,50.6,53413,3441,83,0,1502,2,5028,3.570.654.762
31/01/2019 04:00,50.9,54264,3552,85,0,1550,2,5189,3.570.654.762
31/01/2019 05:00,53.92,56503,3540,84,0,1604,2,5230,3.570.654.762
31/01/2019 06:00,56.33,60640,3522,81,0,1620,2,5225,3.570.654.762
31/01/2019 07:00,61.22,64630,3408,82,0,1672,2,5164,3.570.654.762
31/01/2019 08:00,61.26,65203,3237,81,0,1698,3,5019,3.570.654.762
31/01/2019 09:00,60.91,64868,3040,81,0,1740,3,4864,3.570.654.762
31/01/2019 10:00,60.47,64866,2917,79,0,1738,3,4737,3.570.654.762
31/01/2019 11:00,59.74,64625,2828,74,0,1745,3,4650,3.570.654.762
31/01/2019 12:00,58.67,64070,2743,67,0,1759,3,4572,3.570.654.762
31/01/2019 13:00,58.05,63708,2703,62,0,1771,3,4539,3.570.654.762
31/01/2019 14:00,57.38,63513,2553,58,0,1768,3,4382,3.570.654.762
31/01/2019 15:00,57.38,63726,2370,52,0,1867,4,4293,3.570.654.762
31/01/2019 16:00,59.33,64483,2266,44,0,1882,6,4198,3.570.654.762
31/01/2019 17:00,61.33,65392,2209,40,0,1896,10,4155,3.570.654.762
31/01/2019 18:00,59.49,64624,2137,36,0,1864,12,4049,3.570.654.762
31/01/2019 19:00,56.79,63424,2063,33,0,1834,13,3943,3.570.654.762
31/01/2019 20:00,55.8,61646,2022,30,0,1790,14,3856,3.570.654.762
31/01/2019 21:00,54.28,60046,1957,27,0,1766,12,3762,3.570.654.762
31/01/2019 22:00,52.73,57708,1828,25,0,1723,11,3587,3.570.654.762
31/01/2019 23:00,51.56,55209,1704,22,0,1690,13,3429,3.570.654.762
01/02/2019 00:00,51.48,52885,1346,18,105,1665,9,3143,3.570.654.762
01/02/2019 01:00,50.62,51995,1352,16,99,1626,9,3102,3.570.654.762
01/02/2019 02:00,50.15,51639,1405,13,89,1646,8,3161,3.570.654.762
01/02/2019 03:00,50.24,51781,1472,11,80,1648,8,3219,3.570.654.762
01/02/2019 04:00,50.87,52673,1603,9,71,1659,6,3348,3.570.654.762
01/02/2019 05:00,52.67,55112,1775,7,65,1730,6,3583,3.570.654.762
01/02/2019 06:00,54.22,59436,1955,6,60,1751,6,3778,3.570.654.762
01/02/2019 07:00,55.63,63440,2072,6,53,1805,5,3941,3.570.654.762
01/02/2019 08:00,57.73,64342,2198,5,47,1851,5,4106,3.570.654.762
01/02/2019 09:00,56.75,64071,2248,5,43,1882,5,4183,3.570.654.762
01/02/2019 10:00,56.25,64178,2340,4,40,1892,4,4280,3.570.654.762
01/02/2019 11:00,56.71,63689,2524,4,37,1914,4,4483,3.570.654.762
01/02/2019 12:00,56.19,63023,2709,3,36,1914,3,4665,3.570.654.762
01/02/2019 13:00,55.75,62318,2728,4,40,2013,3,4788,3.570.654.762
01/02/2019 14:00,56.07,61921,2677,5,55,2042,3,4782,3.570.654.762
01/02/2019 15:00,55.97,62046,2605,9,67,2092,3,4776,3.570.654.762
01/02/2019 16:00,56.82,62861,2581,14,84,2134,3,4816,3.570.654.762
01/02/2019 17:00,58.05,63725,2544,22,101,2172,4,4843,3.570.654.762
01/02/2019 18:00,56.9,63060,2436,31,116,2187,4,4774,3.570.654.762
01/02/2019 19:00,55.19,61548,2225,36,128,2128,6,4523,3.570.654.762
01/02/2019 20:00,54.23,59302,2048,40,139,1900,7,4134,3.570.654.762
01/02/2019 21:00,54.07,57721,1948,44,154,1907,7,4060,3.570.654.762
01/02/2019 22:00,52.82,55829,1786,50,169,1904,9,3918,3.570.654.762
01/02/2019 23:00,51.01,53840,1705,52,186,2002,8,3953,3.570.654.762
02/02/2019 00:00,50.04,51652,1079,47,207,2275,10,3618,3.570.654.762
02/02/2019 01:00,48.7,50553,1060,46,220,2218,12,3556,3.570.654.762
02/02/2019 02:00,48.41,49984,1048,45,239,2198,13,3543,3.570.654.762
02/02/2019 03:00,48.37,49796,1032,43,256,2219,12,3562,3.570.654.762
02/02/2019 04:00,48.53,49966,1069,40,272,2236,11,3628,3.570.654.762
02/02/2019 05:00,49.07,50697,1107,36,290,2237,12,3682,3.570.654.762
02/02/2019 06:00,49.21,52007,1162,33,306,2213,15,3729,3.570.654.762
02/02/2019 07:00,49.66,53926,1143,28,317,2172,18,3678,3.570.654.762
02/02/2019 08:00,51.48,55755,1189,23,323,2180,21,3736,3.570.654.762
02/02/2019 09:00,53.5,57399,1209,17,327,2219,22,3794,3.570.654.762
02/02/2019 10:00,54.11,58357,1172,12,326,2188,25,3723,3.570.654.762
02/02/2019 11:00,53.88,58390,1195,7,317,2208,25,3752,3.570.654.762
02/02/2019 12:00,53.73,58026,1229,5,309,2228,24,3795,3.570.654.762
02/02/2019 13:00,52.12,57487,1211,4,302,2280,26,3823,3.570.654.762
02/02/2019 14:00,50.97,57186,1187,3,294,2308,26,3818,3.570.654.762
02/02/2019 15:00,51.03,57726,1125,3,289,2366,25,3808,3.570.654.762
02/02/2019 16:00,52.15,59193,1023,3,289,2431,22,3768,3.570.654.762
02/02/2019 17:00,54.41,60529,1042,2,290,2480,22,3836,3.570.654.762
02/02/2019 18:00,55.24,59848,1019,3,290,2469,22,3803,3.570.654.762
02/02/2019 19:00,53.4,58136,989,3,290,2409,20,3711,3.570.654.762
02/02/2019 20:00,51.55,56230,1001,3,288,2404,23,3719,3.570.654.762
02/02/2019 21:00,49.86,54980,1011,4,287,2397,23,3722,3.570.654.762
02/02/2019 22:00,49.44,53409,956,6,280,2421,19,3682,3.570.654.762
02/02/2019 23:00,48.62,51847,937,8,270,2460,19,3694,3.570.654.762
03/02/2019 00:00,48.52,50721,1194,8,249,2485,19,3955,3.570.654.762
03/02/2019 01:00,48.03,49742,1280,9,237,2572,19,4117,3.570.654.762
03/02/2019 02:00,47.72,49262,1328,12,223,2629,22,4214,3.570.654.762
03/02/2019 03:00,47.41,49135,1403,15,207,2732,21,4378,3.570.654.762
03/02/2019 04:00,47.65,49325,1376,17,190,2773,19,4375,3.570.654.762
03/02/2019 05:00,47.9,49965,1337,19,167,2762,14,4299,3.570.654.762
03/02/2019 06:00,48.31,50856,1329,20,146,2803,17,4315,3.570.654.762
03/02/2019 07:00,48.44,52185,1236,20,129,2849,18,4252,3.570.654.762
03/02/2019 08:00,48.87,53670,1169,21,111,2844,18,4163,3.570.654.762
03/02/2019 09:00,49.84,55555,1142,21,97,2764,16,4040,3.570.654.762
03/02/2019 10:00,50.52,56792,1135,20,85,2728,17,3985,3.570.654.762
03/02/2019 11:00,51.09,57227,1141,20,69,2623,17,3870,3.570.654.762
03/02/2019 12:00,50.73,56925,1190,19,53,2474,15,3751,3.570.654.762
03/02/2019 13:00,50.43,56566,1166,19,38,2366,11,3600,3.570.654.762
03/02/2019 14:00,50.28,56510,1025,23,32,2320,8,3408,3.570.654.762
03/02/2019 15:00,50.58,57143,826,29,26,2247,6,3134,3.570.654.762
03/02/2019 16:00,51.58,58752,696,35,23,2206,5,2965,3.570.654.762
03/02/2019 17:00,53.23,60378,612,42,24,2201,4,2883,3.570.654.762
03/02/2019 18:00,55.33,60346,601,48,28,2112,3,2792,3.570.654.762
03/02/2019 19:00,55.15,59519,598,53,31,2027,4,2713,3.570.654.762
03/02/2019 20:00,53.58,58115,577,58,38,1947,3,2623,3.570.654.762
03/02/2019 21:00,51.94,57113,573,64,46,1822,2,2507,3.570.654.762
03/02/2019 22:00,51.04,55450,602,71,61,1753,3,2490,3.570.654.762
03/02/2019 23:00,49.46,53678,619,76,73,1715,3,2486,3.570.654.762
04/02/2019 00:00,50.18,53121,818,24,77,1501,3,2423,3.362.678.571
04/02/2019 01:00,50.05,52554,926,26,93,1439,3,2487,3.362.678.571
04/02/2019 02:00,49.82,52431,1099,29,113,1455,4,2700,3.362.678.571
04/02/2019 03:00,50,52784,1294,31,137,1414,4,2880,3.362.678.571
04/02/2019 04:00,50.56,53736,1511,31,161,1456,5,3164,3.362.678.571
04/02/2019 05:00,52.13,56278,1803,32,173,1456,7,3471,3.362.678.571
04/02/2019 06:00,53.46,60723,2125,32,186,1467,8,3818,3.362.678.571
04/02/2019 07:00,57.36,64850,2404,34,191,1526,9,4164,3.362.678.571
04/02/2019 08:00,58.46,65712,2745,34,191,1515,10,4495,3.362.678.571
04/02/2019 09:00,56.74,65456,2998,35,193,1545,12,4783,3.362.678.571
04/02/2019 10:00,55.21,65146,3226,34,202,1573,18,5053,3.362.678.571
04/02/2019 11:00,53.78,64503,3506,33,210,1588,20,5357,3.362.678.571
04/02/2019 12:00,53.31,63699,3858,33,211,1685,19,5806,3.362.678.571
04/02/2019 13:00,52.98,63278,4168,33,195,1818,17,6231,3.362.678.571
04/02/2019 14:00,53.13,63056,4397,33,161,1942,14,6547,3.362.678.571
04/02/2019 15:00,53.33,63173,4532,31,133,2138,10,6844,3.362.678.571
04/02/2019 16:00,53.65,64082,4635,30,113,2355,9,7142,3.362.678.571
04/02/2019 17:00,54.01,65189,4752,29,100,2471,6,7358,3.362.678.571
04/02/2019 18:00,53.61,64513,4806,26,91,2578,7,7508,3.362.678.571
04/02/2019 19:00,52.66,63096,4652,25,90,2672,9,7448,3.362.678.571
04/02/2019 20:00,52.02,61218,4555,23,110,2751,10,7449,3.362.678.571
04/02/2019 21:00,51.43,59562,4538,21,133,2822,16,7530,3.362.678.571
04/02/2019 22:00,50.27,57400,4452,19,159,2782,16,7428,3.362.678.571
04/02/2019 23:00,48.8,54895,4445,17,181,2772,17,7432,3.362.678.571
05/02/2019 00:00,47.68,53346,4538,61,229,2778,26,7632,3.362.678.571
05/02/2019 01:00,47.42,52228,4516,55,244,2729,31,7575,3.362.678.571
05/02/2019 02:00,47.31,51840,4465,54,249,2652,32,7452,3.362.678.571
05/02/2019 03:00,47.39,51919,4451,50,247,2528,32,7308,3.362.678.571
05/02/2019 04:00,47.69,52741,4408,47,254,2445,29,7183,3.362.678.571
05/02/2019 05:00,49.82,54969,4277,45,268,2410,23,7023,3.362.678.571
05/02/2019 06:00,51.6,59184,4176,43,285,2402,26,6932,3.362.678.571
05/02/2019 07:00,54.48,62957,3960,41,295,2394,34,6724,3.362.678.571
05/02/2019 08:00,55.78,63446,3811,42,307,2338,36,6534,3.362.678.571
05/02/2019 09:00,55.64,63032,3611,47,314,2298,38,6308,3.362.678.571
05/02/2019 10:00,55.35,62955,3530,56,318,2307,41,6252,3.362.678.571
05/02/2019 11:00,54.11,62639,3515,66,321,2236,41,6179,3.362.678.571
05/02/2019 12:00,53.5,62105,3577,78,314,2153,44,6166,3.362.678.571
05/02/2019 13:00,53.41,61814,3575,86,311,2093,43,6108,3.362.678.571
05/02/2019 14:00,53.92,61564,3413,93,312,2090,40,5948,3.362.678.571
05/02/2019 15:00,53.9,61687,3171,98,312,2092,40,5713,3.362.678.571
05/02/2019 16:00,55.36,62452,2885,100,310,2108,34,5437,3.362.678.571
05/02/2019 17:00,58.03,63539,2571,98,309,2155,35,5168,3.362.678.571
05/02/2019 18:00,57.58,62899,2283,92,309,2152,32,4868,3.362.678.571
05/02/2019 19:00,55.19,61697,1900,89,306,2134,36,4465,3.362.678.571
05/02/2019 20:00,53.69,60151,1567,87,305,2107,40,4106,3.362.678.571
05/02/2019 21:00,52.69,58520,1279,90,303,2091,38,3801,3.362.678.571
05/02/2019 22:00,50.9,56238,1096,99,302,1956,39,3492,3.362.678.571
05/02/2019 23:00,49.58,53819,931,105,299,1876,29,3240,3.362.678.571
06/02/2019 00:00,49.33,52361,970,109,331,1863,22,3295,3.362.678.571
06/02/2019 01:00,49.03,51544,942,133,315,1723,20,3133,3.362.678.571
06/02/2019 02:00,48.92,51336,957,155,300,1636,21,3069,3.362.678.571
06/02/2019 03:00,49.03,51625,984,171,285,1501,24,2965,3.362.678.571
06/02/2019 04:00,49.65,52661,1075,183,270,1375,27,2930,3.362.678.571
06/02/2019 05:00,51.19,55158,1324,196,245,1397,24,3186,3.362.678.571
06/02/2019 06:00,52.49,59619,1750,209,222,1433,25,3639,3.362.678.571
06/02/2019 07:00,56.05,63770,2150,214,204,1460,25,4053,3.362.678.571
06/02/2019 08:00,58.91,64481,2635,217,182,1479,19,4532,3.362.678.571
06/02/2019 09:00,55.5,64202,2892,218,165,1413,19,4707,3.362.678.571
06/02/2019 10:00,54.29,63960,3030,220,150,1419,17,4836,3.362.678.571
06/02/2019 11:00,53.43,63491,3012,225,129,1445,11,4822,3.362.678.571
06/02/2019 12:00,53.31,63006,2918,226,116,1548,6,4814,3.362.678.571
06/02/2019 13:00,52.98,62738,2784,226,94,1690,4,4798,3.362.678.571
06/02/2019 14:00,53.31,62580,2578,225,74,1950,2,4829,3.362.678.571
06/02/2019 15:00,54.36,62736,2365,223,55,2198,2,4843,3.362.678.571
06/02/2019 16:00,55.74,63531,2157,222,39,2347,1,4766,3.362.678.571
06/02/2019 17:00,57.01,64495,1965,218,34,2553,2,4772,3.362.678.571
06/02/2019 18:00,56.92,63683,1796,213,30,2739,3,4781,3.362.678.571
06/02/2019 19:00,54.83,62299,1656,208,35,2780,5,4684,3.362.678.571
06/02/2019 20:00,52.86,60534,1554,202,61,2753,9,4579,3.362.678.571
06/02/2019 21:00,51.57,58842,1479,196,93,2721,11,4500,3.362.678.571
06/02/2019 22:00,50.2,56388,1350,183,131,2661,15,4340,3.362.678.571
06/02/2019 23:00,48.17,53719,1182,170,163,2621,17,4153,3.362.678.571
07/02/2019 00:00,47.64,51598,743,126,215,2469,17,3570,3.362.678.571
07/02/2019 01:00,46.84,50581,604,92,244,2363,21,3324,3.362.678.571
07/02/2019 02:00,46.53,50214,527,64,265,2235,29,3120,3.362.678.571
07/02/2019 03:00,46.47,50274,572,47,282,2112,29,3042,3.362.678.571
07/02/2019 04:00,47.18,51052,697,47,284,1947,26,3001,3.362.678.571
07/02/2019 05:00,48.93,53307,919,63,268,1823,29,3102,3.362.678.571
07/02/2019 06:00,50.4,57493,1276,89,251,1780,25,3421,3.362.678.571
07/02/2019 07:00,52.66,61448,1678,108,235,1752,30,3803,3.362.678.571
07/02/2019 08:00,53.32,62008,2105,112,217,1766,29,4229,3.362.678.571
07/02/2019 09:00,52.26,61675,2360,101,196,1666,25,4348,3.362.678.571
07/02/2019 10:00,51.64,61649,2593,84,177,1579,17,4450,3.362.678.571
07/02/2019 11:00,51.34,61299,2821,73,155,1612,13,4674,3.362.678.571
07/02/2019 12:00,51.01,60738,3047,66,136,1532,11,4792,3.362.678.571
07/02/2019 13:00,50.55,60436,3339,59,131,1452,11,4992,3.362.678.571
07/02/2019 14:00,50.75,60334,3634,51,147,1475,11,5318,3.362.678.571
07/02/2019 15:00,50.71,60442,3804,40,171,1567,11,5593,3.362.678.571
07/02/2019 16:00,50.82,61204,3951,31,201,1696,11,5890,3.362.678.571
07/02/2019 17:00,51.6,62308,4072,25,233,1776,13,6119,3.362.678.571
07/02/2019 18:00,51.56,61712,4182,23,258,1934,14,6411,3.362.678.571
07/02/2019 19:00,50.41,60314,4079,24,279,2098,20,6500,3.362.678.571
07/02/2019 20:00,49.72,58433,4055,34,291,2317,20,6717,3.362.678.571
07/02/2019 21:00,48.64,56697,4138,50,297,2601,21,7107,3.362.678.571
07/02/2019 22:00,48.21,54440,4196,70,296,2827,29,7418,3.362.678.571
07/02/2019 23:00,46.86,51903,4427,89,284,3001,26,7827,3.362.678.571
08/02/2019 00:00,46.77,49641,4850,94,247,3301,25,8517,3.362.678.571
08/02/2019 01:00,46.37,48662,4793,113,233,3400,25,8564,3.362.678.571
08/02/2019 02:00,46.06,48239,4723,134,219,3381,25,8482,3.362.678.571
08/02/2019 03:00,46.03,48277,4643,150,203,3380,23,8399,3.362.678.571
08/02/2019 04:00,46.24,49063,4502,170,196,3400,21,8289,3.362.678.571
08/02/2019 05:00,47.75,51370,4296,186,198,3362,26,8068,3.362.678.571
08/02/2019 06:00,50.06,55723,4094,202,210,3312,26,7844,3.362.678.571
08/02/2019 07:00,52.32,59611,3715,208,229,3215,29,7396,3.362.678.571
08/02/2019 08:00,53.02,60468,3417,207,248,3096,36,7004,3.362.678.571
08/02/2019 09:00,52.87,60273,3197,195,266,2996,46,6700,3.362.678.571
08/02/2019 10:00,51.52,60417,3176,175,277,2921,50,6599,3.362.678.571
08/02/2019 11:00,50.65,59884,3193,150,287,2920,51,6601,3.362.678.571
08/02/2019 12:00,50.18,59061,3288,129,293,2906,52,6668,3.362.678.571
08/02/2019 13:00,49.59,58332,3502,112,295,2837,52,6798,3.362.678.571
08/02/2019 14:00,49.85,57871,3803,94,286,2772,52,7007,3.362.678.571
08/02/2019 15:00,49.48,57726,4065,79,282,2763,51,7240,3.362.678.571
08/02/2019 16:00,49.84,58462,4252,71,281,2766,51,7421,3.362.678.571
08/02/2019 17:00,50.52,59633,4443,71,280,2824,51,7669,3.362.678.571
08/02/2019 18:00,50.78,59251,4570,76,281,2897,48,7872,3.362.678.571
08/02/2019 19:00,49.11,57583,4549,84,280,2951,48,7912,3.362.678.571
08/02/2019 20:00,48.76,55338,4548,95,277,3005,49,7974,3.362.678.571
08/02/2019 21:00,47.81,53702,4640,104,273,3073,42,8132,3.362.678.571
08/02/2019 22:00,47.47,51842,4639,115,275,3099,41,8169,3.362.678.571
08/02/2019 23:00,46.42,49879,4730,125,275,3122,40,8292,3.362.678.571
09/02/2019 00:00,46.44,47434,4829,89,238,3204,28,8388,3.362.678.571
09/02/2019 01:00,46.02,46506,4740,82,250,3242,30,8344,3.362.678.571
09/02/2019 02:00,45.05,45942,4519,77,267,3255,31,8149,3.362.678.571
09/02/2019 03:00,44.97,45706,4330,72,287,3319,32,8040,3.362.678.571
09/02/2019 04:00,45.39,45942,4193,69,304,3366,35,7967,3.362.678.571
09/02/2019 05:00,45.98,46698,4102,67,328,3362,35,7894,3.362.678.571
09/02/2019 06:00,46,47985,4076,69,350,3377,36,7908,3.362.678.571
09/02/2019 07:00,46.41,49668,3944,71,356,3406,40,7817,3.362.678.571
09/02/2019 08:00,46.52,51460,4003,74,364,3347,41,7829,3.362.678.571
09/02/2019 09:00,47.77,53167,4064,80,370,3229,40,7783,3.362.678.571
09/02/2019 10:00,48.2,53831,4204,84,376,3128,39,7831,3.362.678.571
09/02/2019 11:00,48.02,53733,4340,90,381,3037,39,7887,3.362.678.571
09/02/2019 12:00,47.71,53266,4528,94,394,2925,40,7981,3.362.678.571
09/02/2019 13:00,47.13,52673,4702,101,400,2924,40,8167,3.362.678.571
09/02/2019 14:00,46.51,52409,4828,117,398,2950,40,8333,3.362.678.571
09/02/2019 15:00,46.6,52864,4775,135,398,3024,35,8367,3.362.678.571
09/02/2019 16:00,47.67,54233,4775,149,391,3169,37,8521,3.362.678.571
09/02/2019 17:00,49.1,55864,4852,155,376,3348,35,8766,3.362.678.571
09/02/2019 18:00,49.07,55445,4895,159,361,3484,30,8929,3.362.678.571
09/02/2019 19:00,47.75,53775,4770,163,352,3610,25,8920,3.362.678.571
09/02/2019 20:00,46.95,51914,4707,166,353,3647,30,8903,3.362.678.571
09/02/2019 21:00,46.36,50708,4789,165,358,3697,37,9046,3.362.678.571
09/02/2019 22:00,46.95,49207,4747,163,368,3753,40,9071,3.362.678.571
09/02/2019 23:00,46.37,47650,4828,155,384,3754,50,9171,3.362.678.571
10/02/2019 00:00,45.65,46093,4841,171,405,3785,48,9250,3.362.678.571
10/02/2019 01:00,44.78,45133,4632,161,421,3767,53,9034,3.362.678.571
10/02/2019 02:00,44.44,44649,4399,151,416,3709,54,8729,3.362.678.571
10/02/2019 03:00,44.3,44512,4146,139,413,3643,54,8395,3.362.678.571
10/02/2019 04:00,44.28,44623,3922,131,408,3550,54,8065,3.362.678.571
10/02/2019 05:00,44.65,45211,3633,127,405,3464,54,7683,3.362.678.571
10/02/2019 06:00,45.23,45999,3343,128,403,3378,54,7306,3.362.678.571
10/02/2019 07:00,45.37,47124,2937,128,390,3281,53,6789,3.362.678.571
10/02/2019 08:00,45.77,48432,2565,124,362,3181,52,6284,3.362.678.571
10/02/2019 09:00,46.22,50145,2191,122,329,3065,51,5758,3.362.678.571
10/02/2019 10:00,46.75,51144,1879,119,302,2943,51,5294,3.362.678.571
10/02/2019 11:00,47.03,51418,1523,120,281,2808,50,4782,3.362.678.571
10/02/2019 12:00,47.17,51107,1169,123,263,2651,47,4253,3.362.678.571
10/02/2019 13:00,46.96,50757,858,122,257,2424,44,3705,3.362.678.571
10/02/2019 14:00,46.89,50642,522,117,273,2218,42,3172,3.362.678.571
10/02/2019 15:00,47.04,51111,359,109,292,1967,32,2759,3.362.678.571
10/02/2019 16:00,48.21,52577,302,102,319,1758,24,2505,3.362.678.571
10/02/2019 17:00,49.41,54256,298,92,344,1520,26,2280,3.362.678.571
10/02/2019 18:00,49.75,54460,423,83,366,1338,24,2234,3.362.678.571
10/02/2019 19:00,49.49,53552,604,72,380,1242,29,2327,3.362.678.571
10/02/2019 20:00,48.17,52213,951,62,385,1148,25,2571,3.362.678.571
10/02/2019 21:00,47.28,51118,1423,53,385,1139,26,3026,3.362.678.571
10/02/2019 22:00,46.58,49623,1764,45,383,1195,25,3412,3.362.678.571
10/02/2019 23:00,46.15,47959,2024,37,376,1345,23,3805,3.362.678.571
11/02/2019 00:00,46.14,46521,2622,115,409,1294,26,4466,3.210.059.524
11/02/2019 01:00,45.21,45854,2752,128,407,1512,27,4826,3.210.059.524
11/02/2019 02:00,44.47,45688,2869,140,393,1781,27,5210,3.210.059.524
11/02/2019 03:00,44.05,45974,3093,154,370,2077,27,5721,3.210.059.524
11/02/2019 04:00,44.24,47025,3353,166,346,2290,26,6181,3.210.059.524
11/02/2019 05:00,46.42,49536,3462,172,317,2601,25,6577,3.210.059.524
11/02/2019 06:00,47.63,53761,3602,177,289,2963,25,7056,3.210.059.524
11/02/2019 07:00,49.36,57421,3567,181,261,3314,19,7342,3.210.059.524
11/02/2019 08:00,49.78,58376,3631,185,228,3512,19,7575,3.210.059.524
11/02/2019 09:00,48.89,58296,3678,191,200,3749,14,7832,3.210.059.524
11/02/2019 10:00,48.6,58035,3761,201,179,3850,11,8002,3.210.059.524
11/02/2019 11:00,48.12,57511,3868,210,173,3891,9,8151,3.210.059.524
11/02/2019 12:00,47.92,57026,4033,216,166,3857,6,8278,3.210.059.524
11/02/2019 13:00,47.9,56743,4131,223,160,3944,5,8463,3.210.059.524
11/02/2019 14:00,47.82,56598,4147,227,160,4028,5,8567,3.210.059.524
11/02/2019 15:00,47.76,56593,4109,231,159,4220,4,8723,3.210.059.524
11/02/2019 16:00,47.92,57341,4170,232,175,4340,3,8920,3.210.059.524
11/02/2019 17:00,48.68,58630,4236,233,191,4505,4,9169,3.210.059.524
11/02/2019 18:00,48.84,58564,4238,233,212,4634,5,9322,3.210.059.524
11/02/2019 19:00,48.82,57496,4102,233,233,4862,17,9447,3.210.059.524
11/02/2019 20:00,47.92,55877,3977,230,283,4941,44,9475,3.210.059.524
11/02/2019 21:00,47.08,54591,3973,229,324,4976,52,9554,3.210.059.524
11/02/2019 22:00,46.53,52647,3901,227,371,4971,53,9523,3.210.059.524
11/02/2019 23:00,45.11,50405,3788,223,400,4950,52,9413,3.210.059.524
12/02/2019 00:00,44.49,48817,3598,139,453,4805,50,9045,3.210.059.524
12/02/2019 01:00,44.09,47987,3332,129,456,4677,49,8643,3.210.059.524
12/02/2019 02:00,43.99,47776,3052,119,449,4648,50,8318,3.210.059.524
12/02/2019 03:00,44.06,48017,2764,115,441,4573,51,7944,3.210.059.524
12/02/2019 04:00,44.19,49041,2435,117,434,4545,49,7580,3.210.059.524
12/02/2019 05:00,45.99,51426,2054,120,425,4453,48,7100,3.210.059.524
12/02/2019 06:00,47.85,55509,1784,121,416,4266,49,6636,3.210.059.524
12/02/2019 07:00,49.95,59056,1449,119,410,4157,49,6184,3.210.059.524
12/02/2019 08:00,50.77,59695,1208,114,413,3935,49,5719,3.210.059.524
12/02/2019 09:00,51.19,59274,1012,108,418,3641,49,5228,3.210.059.524
12/02/2019 10:00,51,58958,881,100,431,3418,50,4880,3.210.059.524
12/02/2019 11:00,50.03,58409,783,88,436,3114,51,4472,3.210.059.524
12/02/2019 12:00,49.65,57646,750,75,434,2870,49,4178,3.210.059.524
12/02/2019 13:00,49.4,57166,795,64,415,2745,48,4067,3.210.059.524
12/02/2019 14:00,49.66,56947,873,53,386,2817,47,4176,3.210.059.524
12/02/2019 15:00,49.56,57264,930,48,355,2935,42,4310,3.210.059.524
12/02/2019 16:00,50.01,58256,1096,42,332,3092,39,4601,3.210.059.524
12/02/2019 17:00,50.42,59738,1331,36,309,3213,41,4930,3.210.059.524
12/02/2019 18:00,50.34,59720,1605,35,292,3288,35,5255,3.210.059.524
12/02/2019 19:00,49.12,58690,1886,43,275,3323,29,5556,3.210.059.524
12/02/2019 20:00,47.92,57128,2115,55,255,3324,27,5776,3.210.059.524
12/02/2019 21:00,47.24,55749,2471,66,235,3329,26,6127,3.210.059.524
12/02/2019 22:00,46.81,53594,2719,79,214,3344,21,6377,3.210.059.524
12/02/2019 23:00,45.92,51128,2831,94,193,3377,18,6513,3.210.059.524
13/02/2019 00:00,44.09,48385,3637,137,149,3895,7,7825,3.210.059.524
13/02/2019 01:00,43.09,47453,3542,152,147,4082,10,7933,3.210.059.524
13/02/2019 02:00,42.86,47077,3456,164,151,4291,10,8072,3.210.059.524
13/02/2019 03:00,42.73,47142,3432,171,155,4433,10,8201,3.210.059.524
13/02/2019 04:00,43,48009,3392,176,178,4563,9,8318,3.210.059.524
13/02/2019 05:00,44.07,50286,3291,185,211,4750,14,8451,3.210.059.524
13/02/2019 06:00,45.98,54357,3199,194,257,4932,21,8603,3.210.059.524
13/02/2019 07:00,47.83,57948,2961,199,307,4974,31,8472,3.210.059.524
13/02/2019 08:00,48.27,58477,2675,204,342,4806,35,8062,3.210.059.524
13/02/2019 09:00,47.49,58126,2399,208,371,4643,40,7661,3.210.059.524
13/02/2019 10:00,47.1,57803,2230,205,382,4450,48,7315,3.210.059.524
13/02/2019 11:00,46.78,57151,2189,197,375,4468,43,7272,3.210.059.524
13/02/2019 12:00,46.33,56365,2254,191,364,4349,38,7196,3.210.059.524
13/02/2019 13:00,46.32,55715,2264,188,354,4228,38,7072,3.210.059.524
13/02/2019 14:00,46.42,55556,2276,180,341,4221,33,7051,3.210.059.524
13/02/2019 15:00,46.82,55758,2340,173,321,4174,31,7039,3.210.059.524
13/02/2019 16:00,47.55,56658,2331,167,303,4115,32,6948,3.210.059.524
13/02/2019 17:00,48.39,57856,2321,158,278,4162,32,6951,3.210.059.524
13/02/2019 18:00,48.56,57575,2225,146,249,4205,30,6855,3.210.059.524
13/02/2019 19:00,48.22,56371,2050,135,234,4081,24,6524,3.210.059.524
13/02/2019 20:00,47.48,54719,1995,121,225,3794,25,6160,3.210.059.524
13/02/2019 21:00,46.39,53228,2014,109,221,3398,24,5766,3.210.059.524
13/02/2019 22:00,45.94,50956,1982,102,215,3066,24,5389,3.210.059.524
13/02/2019 23:00,43.98,48522,1931,90,199,2924,22,5166,3.210.059.524
14/02/2019 00:00,42.32,46407,1678,71,198,2841,22,4810,3.210.059.524
14/02/2019 01:00,41.66,45488,1515,67,194,2806,24,4606,3.210.059.524
14/02/2019 02:00,41.36,45187,1397,69,184,2871,20,4541,3.210.059.524
14/02/2019 03:00,41.59,45362,1324,74,178,2957,17,4550,3.210.059.524
14/02/2019 04:00,42.5,46089,1342,83,170,3159,16,4770,3.210.059.524
14/02/2019 05:00,44.38,48214,1331,92,156,3361,17,4957,3.210.059.524
14/02/2019 06:00,45.99,52234,1318,98,141,3502,14,5073,3.210.059.524
14/02/2019 07:00,47.4,55663,1301,99,122,3720,10,5252,3.210.059.524
14/02/2019 08:00,47.65,56181,1332,99,105,3905,7,5448,3.210.059.524
14/02/2019 09:00,47.21,55851,1364,89,86,4051,6,5596,3.210.059.524
14/02/2019 10:00,46.7,55632,1400,70,74,4210,3,5757,3.210.059.524
14/02/2019 11:00,45.49,55168,1395,51,73,4373,3,5895,3.210.059.524
14/02/2019 12:00,44.71,54531,1461,43,74,4614,3,6195,3.210.059.524
14/02/2019 13:00,44.64,54192,1601,45,84,4658,6,6394,3.210.059.524
14/02/2019 14:00,44.89,53830,1622,47,92,4884,8,6653,3.210.059.524
14/02/2019 15:00,45.38,53628,1613,50,102,4943,8,6716,3.210.059.524
14/02/2019 16:00,45.84,54173,1588,61,116,5025,9,6799,3.210.059.524
14/02/2019 17:00,46.33,55379,1535,74,133,5059,16,6817,3.210.059.524
14/02/2019 18:00,46.2,55153,1514,94,150,5047,21,6826,3.210.059.524
14/02/2019 19:00,45.64,53851,1476,111,166,4964,30,6747,3.210.059.524
14/02/2019 20:00,44.86,52235,1521,119,180,4858,26,6704,3.210.059.524
14/02/2019 21:00,44.27,50671,1603,120,195,4798,31,6747,3.210.059.524
14/02/2019 22:00,43.79,48583,1594,116,212,4773,31,6726,3.210.059.524
14/02/2019 23:00,42.71,46314,1569,111,222,4710,29,6641,3.210.059.524
15/02/2019 00:00,42.96,44559,1275,135,267,4663,28,6368,3.210.059.524
15/02/2019 01:00,42,43696,1240,141,268,4565,26,6240,3.210.059.524
15/02/2019 02:00,40.96,43335,1235,136,263,4528,25,6187,3.210.059.524
15/02/2019 03:00,40.72,43451,1201,126,255,4503,23,6108,3.210.059.524
15/02/2019 04:00,41.43,44341,1173,116,243,4450,20,6002,3.210.059.524
15/02/2019 05:00,43.65,46709,1124,110,223,4441,18,5916,3.210.059.524
15/02/2019 06:00,44.54,50664,1113,103,196,4391,17,5820,3.210.059.524
15/02/2019 07:00,45.46,54126,1058,88,182,4348,17,5693,3.210.059.524
15/02/2019 08:00,45.84,54923,1018,68,177,4263,18,5544,3.210.059.524
15/02/2019 09:00,45.73,54598,1003,49,172,4071,14,5309,3.210.059.524
15/02/2019 10:00,45.78,54465,970,37,172,3881,14,5074,3.210.059.524
15/02/2019 11:00,44.61,53689,943,34,172,3667,12,4828,3.210.059.524
15/02/2019 12:00,43.7,52709,958,37,174,3399,14,4582,3.210.059.524
15/02/2019 13:00,43.34,51711,1078,45,178,3196,17,4514,3.210.059.524
15/02/2019 14:00,43.53,51292,1175,63,180,3109,17,4544,3.210.059.524
15/02/2019 15:00,44.41,51127,1256,87,181,3129,18,4671,3.210.059.524
15/02/2019 16:00,45.06,51871,1382,112,175,3238,18,4925,3.210.059.524
15/02/2019 17:00,45.55,53320,1614,135,166,3414,20,5349,3.210.059.524
15/02/2019 18:00,45.54,53450,1819,151,160,3570,19,5719,3.210.059.524
15/02/2019 19:00,44.93,52173,1857,163,154,3705,15,5894,3.210.059.524
15/02/2019 20:00,44.24,50218,1969,173,148,3865,14,6169,3.210.059.524
15/02/2019 21:00,43.31,48880,2165,176,148,4101,11,6601,3.210.059.524
15/02/2019 22:00,43.27,47255,2323,173,153,4248,17,6914,3.210.059.524
15/02/2019 23:00,41.04,45494,2376,163,161,4400,22,7122,3.210.059.524
16/02/2019 00:00,40.72,44064,2455,208,174,4387,22,7246,3.210.059.524
16/02/2019 01:00,40.13,43231,2409,203,181,4539,22,7354,3.210.059.524
16/02/2019 02:00,39.97,42897,2385,195,189,4701,22,7492,3.210.059.524
16/02/2019 03:00,39.93,42726,2266,194,195,4821,25,7501,3.210.059.524
16/02/2019 04:00,39.82,42972,2255,198,198,5006,28,7685,3.210.059.524
16/02/2019 05:00,39.67,43789,2418,204,199,5143,28,7992,3.210.059.524
16/02/2019 06:00,40.06,44861,2570,210,205,5175,26,8186,3.210.059.524
16/02/2019 07:00,40.75,46339,2626,213,204,5183,28,8254,3.210.059.524
16/02/2019 08:00,41.11,47920,2712,216,205,5171,32,8336,3.210.059.524
16/02/2019 09:00,41.26,49268,2834,219,203,5086,32,8374,3.210.059.524
16/02/2019 10:00,41.87,49637,2872,221,199,4923,33,8248,3.210.059.524
16/02/2019 11:00,41.64,49182,2863,224,201,4797,36,8121,3.210.059.524
16/02/2019 12:00,40.93,48475,2821,226,207,4674,36,7964,3.210.059.524
16/02/2019 13:00,40.72,47832,2791,227,223,4645,38,7924,3.210.059.524
16/02/2019 14:00,40.64,47446,2659,225,247,4651,37,7819,3.210.059.524
16/02/2019 15:00,41,47687,2542,224,274,4689,35,7764,3.210.059.524
16/02/2019 16:00,42.19,49023,2462,224,304,4754,32,7776,3.210.059.524
16/02/2019 17:00,43.66,50914,2384,226,328,4743,31,7712,3.210.059.524
16/02/2019 18:00,43.76,51086,2284,228,347,4768,30,7657,3.210.059.524
16/02/2019 19:00,43.35,49697,2172,229,364,4704,29,7498,3.210.059.524
16/02/2019 20:00,42.66,48084,2108,231,371,4572,29,7311,3.210.059.524
16/02/2019 21:00,41.52,47032,2045,230,373,4444,35,7127,3.210.059.524
16/02/2019 22:00,40.71,45790,1980,231,379,4290,37,6917,3.210.059.524
16/02/2019 23:00,41.34,44323,1908,227,381,4172,38,6726,3.210.059.524
17/02/2019 00:00,40.26,43780,1684,227,353,3978,28,6270,3.210.059.524
17/02/2019 01:00,40.05,42959,1532,224,324,3876,24,5980,3.210.059.524
17/02/2019 02:00,40.07,42608,1361,224,283,3692,24,5584,3.210.059.524
17/02/2019 03:00,40.03,42584,1156,230,255,3525,21,5187,3.210.059.524
17/02/2019 04:00,40.02,42776,1043,235,222,3295,17,4812,3.210.059.524
17/02/2019 05:00,40.06,43380,963,239,195,3021,13,4431,3.210.059.524
17/02/2019 06:00,40.34,44156,879,241,171,2775,10,4076,3.210.059.524
17/02/2019 07:00,41.12,45166,812,243,154,2447,7,3663,3.210.059.524
17/02/2019 08:00,41.58,46473,715,243,140,2043,6,3147,3.210.059.524
17/02/2019 09:00,42.47,48088,687,242,129,1669,5,2732,3.210.059.524
17/02/2019 10:00,43.05,49003,696,243,119,1245,5,2308,3.210.059.524
17/02/2019 11:00,43.3,49148,713,242,111,867,5,1938,3.210.059.524
17/02/2019 12:00,43.21,48888,761,238,103,641,5,1748,3.210.059.524
17/02/2019 13:00,43.24,48489,822,233,94,459,5,1613,3.210.059.524
17/02/2019 14:00,43.13,48393,876,225,87,372,5,1565,3.210.059.524
17/02/2019 15:00,43.01,48745,901,218,82,399,4,1604,3.210.059.524
17/02/2019 16:00,43.68,50113,972,213,75,495,4,1759,3.210.059.524
17/02/2019 17:00,45.4,51913,1114,210,64,748,4,2140,3.210.059.524
17/02/2019 18:00,46.34,52537,1265,209,55,1089,5,2623,3.210.059.524
17/02/2019 19:00,46.14,51758,1500,206,48,1459,4,3217,3.210.059.524
17/02/2019 20:00,45.05,50417,1786,197,35,1825,4,3847,3.210.059.524
17/02/2019 21:00,43.07,49400,1986,185,22,2239,4,4436,3.210.059.524
17/02/2019 22:00,42.91,47857,2047,171,16,2497,4,4735,3.210.059.524
17/02/2019 23:00,42.15,46107,1977,146,12,2739,3,4877,3.210.059.524
18/02/2019 00:00,40.97,44830,1846,179,8,2932,3,4968,3.067.261.905
18/02/2019 01:00,40.46,44319,1773,169,7,3090,3,5042,3.067.261.905
18/02/2019 02:00,40.44,44130,1728,163,9,3274,4,5178,3.067.261.905
18/02/2019 03:00,40.28,44375,1629,160,9,3411,4,5213,3.067.261.905
18/02/2019 04:00,40.49,45254,1574,158,9,3529,4,5274,3.067.261.905
18/02/2019 05:00,43.36,47615,1586,156,13,3602,5,5362,3.067.261.905
18/02/2019 06:00,45.81,51875,1599,154,19,3607,5,5384,3.067.261.905
18/02/2019 07:00,46.45,55419,1559,151,21,3518,6,5255,3.067.261.905
18/02/2019 08:00,46.8,56058,1525,150,21,3335,7,5038,3.067.261.905
18/02/2019 09:00,46.65,55760,1488,153,21,3223,6,4891,3.067.261.905
18/02/2019 10:00,46.45,55428,1455,164,24,3049,8,4700,3.067.261.905
18/02/2019 11:00,45.11,54732,1499,175,36,2951,8,4669,3.067.261.905
18/02/2019 12:00,44.14,54054,1567,184,60,2761,12,4584,3.067.261.905
18/02/2019 13:00,43.95,53629,1618,187,84,2679,15,4583,3.067.261.905
18/02/2019 14:00,44.78,53296,1591,184,110,2722,18,4625,3.067.261.905
18/02/2019 15:00,45.55,53206,1532,174,138,2734,22,4600,3.067.261.905
18/02/2019 16:00,46.05,53739,1561,164,175,2893,22,4815,3.067.261.905
18/02/2019 17:00,46.41,55004,1691,151,210,3089,29,5170,3.067.261.905
18/02/2019 18:00,46.32,54999,1824,135,239,3270,32,5500,3.067.261.905
18/02/2019 19:00,45.38,53908,1902,121,254,3459,33,5769,3.067.261.905
18/02/2019 20:00,44.79,52218,1950,112,264,3621,33,5980,3.067.261.905
18/02/2019 21:00,43.96,50946,1984,110,266,3727,32,6119,3.067.261.905
18/02/2019 22:00,42.39,48919,1997,112,263,3773,30,6175,3.067.261.905
18/02/2019 23:00,40.96,46706,1977,111,260,3807,26,6181,3.067.261.905
19/02/2019 00:00,40.42,44774,1964,19,201,3696,27,5907,3.067.261.905
19/02/2019 01:00,40.06,43891,1987,13,197,3694,26,5917,3.067.261.905
19/02/2019 02:00,39.9,43548,2036,11,195,3585,25,5852,3.067.261.905
19/02/2019 03:00,39.9,43712,2142,12,193,3481,25,5853,3.067.261.905
19/02/2019 04:00,39.87,44618,2350,19,190,3410,21,5990,3.067.261.905
19/02/2019 05:00,41.43,46917,2574,29,187,3377,19,6186,3.067.261.905
19/02/2019 06:00,43.84,50912,2846,41,184,3276,18,6365,3.067.261.905
19/02/2019 07:00,45.7,54300,3080,52,178,3252,18,6580,3.067.261.905
19/02/2019 08:00,45.64,54901,3232,62,167,3244,21,6726,3.067.261.905
19/02/2019 09:00,44.4,54635,3319,72,158,3309,23,6881,3.067.261.905
19/02/2019 10:00,43.68,54490,3505,83,159,3290,27,7064,3.067.261.905
19/02/2019 11:00,42.98,54215,3692,95,175,3221,39,7222,3.067.261.905
19/02/2019 12:00,42.83,53687,3884,106,192,3260,39,7481,3.067.261.905
19/02/2019 13:00,42.79,53206,4105,120,211,3262,27,7725,3.067.261.905
19/02/2019 14:00,43.04,53050,4244,142,231,3337,34,7988,3.067.261.905
19/02/2019 15:00,43.07,53312,4168,168,255,3416,34,8041,3.067.261.905
19/02/2019 16:00,43.6,54097,4046,191,280,3604,26,8147,3.067.261.905
19/02/2019 17:00,45.05,55497,3903,205,302,3978,39,8427,3.067.261.905
19/02/2019 18:00,45.08,55488,3764,215,324,4326,41,8670,3.067.261.905
19/02/2019 19:00,43.94,54432,3682,223,340,4564,47,8856,3.067.261.905
19/02/2019 20:00,43.49,52828,3652,224,339,4900,47,9162,3.067.261.905
19/02/2019 21:00,42.09,51362,3589,218,345,5079,47,9278,3.067.261.905
19/02/2019 22:00,41.42,49307,3459,210,354,5279,46,9348,3.067.261.905
19/02/2019 23:00,40.45,47053,3366,200,368,5427,46,9407,3.067.261.905
20/02/2019 00:00,40.21,45263,3366,208,430,5533,45,9582,3.067.261.905
20/02/2019 01:00,39.91,44486,3277,198,437,5524,47,9483,3.067.261.905
20/02/2019 02:00,39.66,44276,3152,187,442,5497,45,9323,3.067.261.905
20/02/2019 03:00,39.79,44459,2935,176,445,5422,47,9025,3.067.261.905
20/02/2019 04:00,39.53,45328,2798,164,444,5322,45,8773,3.067.261.905
20/02/2019 05:00,41.17,47716,2555,159,438,5196,45,8393,3.067.261.905
20/02/2019 06:00,43.4,51869,2233,160,429,4991,46,7859,3.067.261.905
20/02/2019 07:00,44.82,55632,1953,163,423,4693,44,7276,3.067.261.905
20/02/2019 08:00,45.58,56275,1667,166,418,4206,41,6498,3.067.261.905
20/02/2019 09:00,45.57,56001,1404,166,419,3760,47,5796,3.067.261.905
20/02/2019 10:00,45.49,55669,1265,162,420,3284,43,5174,3.067.261.905
20/02/2019 11:00,44.5,55230,1211,160,420,2901,41,4733,3.067.261.905
20/02/2019 12:00,43.74,54645,1194,159,420,2588,46,4407,3.067.261.905
20/02/2019 13:00,43.97,54336,1135,155,418,2230,47,3985,3.067.261.905
20/02/2019 14:00,44.64,54265,1035,148,413,1907,47,3550,3.067.261.905
20/02/2019 15:00,44.92,54393,951,141,406,1616,47,3161,3.067.261.905
20/02/2019 16:00,45.75,55295,936,137,394,1403,45,2915,3.067.261.905
20/02/2019 17:00,46.64,56916,954,135,373,1273,42,2777,3.067.261.905
20/02/2019 18:00,46.79,57197,963,132,354,1219,41,2709,3.067.261.905
20/02/2019 19:00,45.86,56288,1024,128,329,1236,42,2759,3.067.261.905
20/02/2019 20:00,45.09,54929,1187,126,290,1189,41,2833,3.067.261.905
20/02/2019 21:00,44.05,53542,1463,124,256,1129,39,3011,3.067.261.905
20/02/2019 22:00,43.26,51451,1601,122,229,1073,35,3060,3.067.261.905
20/02/2019 23:00,42.05,49139,1739,121,203,1075,29,3167,3.067.261.905
21/02/2019 00:00,41.37,47543,1921,141,171,1141,36,3410,3.067.261.905
21/02/2019 01:00,40.59,46665,1999,148,155,1187,29,3518,3.067.261.905
21/02/2019 02:00,40.54,46487,2131,146,141,1272,25,3715,3.067.261.905
21/02/2019 03:00,40.71,46728,2221,142,125,1375,23,3886,3.067.261.905
21/02/2019 04:00,41.05,47602,2297,141,109,1528,18,4093,3.067.261.905
21/02/2019 05:00,42.77,50067,2357,147,89,1647,14,4254,3.067.261.905
21/02/2019 06:00,44.46,54087,2408,150,69,1784,9,4420,3.067.261.905
21/02/2019 07:00,45.93,57708,2414,159,54,1840,5,4472,3.067.261.905
21/02/2019 08:00,46.57,58258,2341,173,37,1810,4,4365,3.067.261.905
21/02/2019 09:00,45.83,57914,2246,186,29,1762,3,4226,3.067.261.905
21/02/2019 10:00,45.05,57784,2197,200,21,1730,3,4151,3.067.261.905
21/02/2019 11:00,44.2,57469,2179,209,17,1731,3,4139,3.067.261.905
21/02/2019 12:00,43.95,56983,2109,215,15,1662,3,4004,3.067.261.905
21/02/2019 13:00,43.92,56725,2122,223,17,1629,3,3994,3.067.261.905
21/02/2019 14:00,44.13,56604,2093,236,23,1591,3,3946,3.067.261.905
21/02/2019 15:00,44.56,56592,2026,247,32,1577,4,3886,3.067.261.905
21/02/2019 16:00,45.36,57161,1864,253,50,1628,5,3800,3.067.261.905
21/02/2019 17:00,46.85,58648,1676,256,72,1741,4,3749,3.067.261.905
21/02/2019 18:00,46.87,58810,1517,258,94,1861,6,3736,3.067.261.905
21/02/2019 19:00,46.32,57774,1394,257,114,2000,7,3772,3.067.261.905
21/02/2019 20:00,45.49,56293,1321,256,130,2161,10,3878,3.067.261.905
21/02/2019 21:00,44.61,54958,1259,255,150,2345,10,4019,3.067.261.905
21/02/2019 22:00,43.98,52971,1222,252,156,2465,10,4105,3.067.261.905
21/02/2019 23:00,42.66,50718,1235,244,156,2484,12,4131,3.067.261.905
22/02/2019 00:00,42.22,49274,1180,242,187,2573,12,4194,3.067.261.905
22/02/2019 01:00,41.2,48596,1236,234,187,2599,9,4265,3.067.261.905
22/02/2019 02:00,40.82,48508,1240,224,173,2656,10,4303,3.067.261.905
22/02/2019 03:00,40.56,48792,1320,209,165,2712,10,4416,3.067.261.905
22/02/2019 04:00,41.08,49766,1402,193,154,2761,9,4519,3.067.261.905
22/02/2019 05:00,43.05,52281,1404,177,147,2842,9,4579,3.067.261.905
22/02/2019 06:00,45.09,56378,1389,160,142,2868,9,4568,3.067.261.905
22/02/2019 07:00,45.78,60034,1369,145,138,2907,9,4568,3.067.261.905
22/02/2019 08:00,45.9,60863,1388,129,132,2876,9,4534,3.067.261.905
22/02/2019 09:00,45.88,60577,1377,113,127,2916,6,4539,3.067.261.905
22/02/2019 10:00,45.58,60345,1381,97,125,2880,7,4490,3.067.261.905
22/02/2019 11:00,44.82,59460,1278,84,129,2873,7,4371,3.067.261.905
22/02/2019 12:00,43.65,58391,1170,76,130,2822,6,4204,3.067.261.905
22/02/2019 13:00,43.27,57436,1069,74,133,2828,6,4110,3.067.261.905
22/02/2019 14:00,43.64,57009,1027,75,135,2837,7,4081,3.067.261.905
22/02/2019 15:00,43.73,56610,921,77,137,2887,7,4029,3.067.261.905
22/02/2019 16:00,44.18,57123,829,81,136,2911,5,3962,3.067.261.905
22/02/2019 17:00,44.73,58880,770,88,134,3088,5,4085,3.067.261.905
22/02/2019 18:00,44.77,59174,824,96,129,3267,5,4321,3.067.261.905
22/02/2019 19:00,43.92,57669,973,102,122,3442,4,4643,3.067.261.905
22/02/2019 20:00,42.83,55341,1118,102,103,3623,3,4949,3.067.261.905
22/02/2019 21:00,42.05,53688,1258,98,86,3827,3,5272,3.067.261.905
22/02/2019 22:00,42.16,51870,1312,91,68,3994,3,5468,3.067.261.905
22/02/2019 23:00,40.29,49722,1341,84,44,4241,4,5714,3.067.261.905
23/02/2019 00:00,39.48,47208,1423,83,18,4486,7,6017,3.067.261.905
23/02/2019 01:00,38.63,46312,1358,94,22,4533,15,6022,3.067.261.905
23/02/2019 02:00,38.21,45852,1254,111,33,4592,20,6010,3.067.261.905
23/02/2019 03:00,38.24,45658,1151,134,54,4607,25,5971,3.067.261.905
23/02/2019 04:00,37.88,45804,1078,152,78,4557,32,5897,3.067.261.905
23/02/2019 05:00,38.06,46523,1028,163,114,4466,37,5808,3.067.261.905
23/02/2019 06:00,38.78,47445,1008,173,154,4372,40,5747,3.067.261.905
23/02/2019 07:00,40.63,48730,1016,185,189,4229,44,5663,3.067.261.905
23/02/2019 08:00,41.54,50259,1054,195,219,4006,44,5518,3.067.261.905
23/02/2019 09:00,41.58,51702,1037,200,247,3691,47,5222,3.067.261.905
23/02/2019 10:00,41,52152,1004,202,276,3428,47,4957,3.067.261.905
23/02/2019 11:00,40.47,51784,912,204,304,3171,47,4638,3.067.261.905
23/02/2019 12:00,40.12,51294,806,207,334,2971,44,4362,3.067.261.905
23/02/2019 13:00,39.53,50627,770,209,352,2868,40,4239,3.067.261.905
23/02/2019 14:00,39.27,50220,727,206,343,3068,34,4378,3.067.261.905
23/02/2019 15:00,39.55,50142,677,199,334,3177,32,4419,3.067.261.905
23/02/2019 16:00,41.43,51053,680,186,326,3206,23,4421,3.067.261.905
23/02/2019 17:00,43.05,52847,804,179,315,3422,18,4738,3.067.261.905
23/02/2019 18:00,43.24,53268,975,171,299,3647,12,5104,3.067.261.905
23/02/2019 19:00,42.48,51663,1029,168,282,3735,11,5225,3.067.261.905
23/02/2019 20:00,41.6,49893,1070,165,253,3740,13,5241,3.067.261.905
23/02/2019 21:00,40.39,48683,1116,157,221,3715,16,5225,3.067.261.905
23/02/2019 22:00,40.84,47234,1145,143,206,3628,16,5138,3.067.261.905
23/02/2019 23:00,39.7,45592,1117,132,190,3579,18,5036,3.067.261.905
24/02/2019 00:00,39.51,43930,1390,165,146,3578,7,5286,3.067.261.905
24/02/2019 01:00,39.08,43116,1336,175,140,3533,6,5190,3.067.261.905
24/02/2019 02:00,39.05,42652,1308,186,140,3611,7,5252,3.067.261.905
24/02/2019 03:00,38.8,42453,1233,196,137,3669,8,5243,3.067.261.905
24/02/2019 04:00,38.7,42528,1213,200,131,3889,6,5439,3.067.261.905
24/02/2019 05:00,38.92,42980,1200,202,119,4146,6,5673,3.067.261.905
24/02/2019 06:00,38.92,43602,1138,199,107,4422,7,5873,3.067.261.905
24/02/2019 07:00,39.23,44493,1044,190,96,4559,8,5897,3.067.261.905
24/02/2019 08:00,39.89,45729,877,176,89,4599,7,5748,3.067.261.905
24/02/2019 09:00,40.27,47066,760,160,84,4503,8,5515,3.067.261.905
24/02/2019 10:00,39.99,47663,707,144,91,4419,12,5373,3.067.261.905
24/02/2019 11:00,39.72,47503,690,131,106,4346,14,5287,3.067.261.905
24/02/2019 12:00,39.37,47018,659,120,125,4212,17,5133,3.067.261.905
24/02/2019 13:00,38.97,46360,672,113,150,4125,17,5077,3.067.261.905
24/02/2019 14:00,38.65,46100,728,106,177,4150,15,5176,3.067.261.905
24/02/2019 15:00,38.81,46223,804,100,206,4156,8,5274,3.067.261.905
24/02/2019 16:00,39.48,47449,876,94,228,4219,12,5429,3.067.261.905
24/02/2019 17:00,41.6,49437,926,87,236,4237,15,5501,3.067.261.905
24/02/2019 18:00,42.26,50274,971,79,237,4249,11,5547,3.067.261.905
24/02/2019 19:00,41.96,49568,981,68,229,4176,9,5463,3.067.261.905
24/02/2019 20:00,41.31,48258,977,56,206,4175,10,5424,3.067.261.905
24/02/2019 21:00,40.87,47275,891,43,183,4050,12,5179,3.067.261.905
24/02/2019 22:00,40.23,45649,842,32,161,4027,14,5076,3.067.261.905
24/02/2019 23:00,39.81,43850,881,23,140,3919,17,4980,3.067.261.905
25/02/2019 00:00,39.24,42490,838,78,117,3854,25,4912,2.933.214.286
25/02/2019 01:00,38.82,41863,864,80,107,3842,23,4916,2.933.214.286
25/02/2019 02:00,38.77,41693,850,83,109,3800,23,4865,2.933.214.286
25/02/2019 03:00,38.74,42079,900,82,117,3789,28,4916,2.933.214.286
25/02/2019 04:00,38.71,43055,1042,81,131,3740,32,5026,2.933.214.286
25/02/2019 05:00,40.28,45697,1067,81,143,3687,32,5010,2.933.214.286
25/02/2019 06:00,42.14,50141,1089,79,156,3651,31,5006,2.933.214.286
25/02/2019 07:00,43.27,53783,1096,69,168,3425,30,4788,2.933.214.286
25/02/2019 08:00,43.82,54639,1001,53,177,3050,32,4313,2.933.214.286
25/02/2019 09:00,43.85,54457,898,41,181,2674,30,3824,2.933.214.286
25/02/2019 10:00,43.51,54073,874,32,178,2518,31,3633,2.933.214.286
25/02/2019 11:00,41.81,53263,921,25,179,2362,29,3516,2.933.214.286
25/02/2019 12:00,41.04,52343,955,19,187,2297,32,3490,2.933.214.286
25/02/2019 13:00,40.87,51843,981,16,196,2240,32,3465,2.933.214.286
25/02/2019 14:00,41.03,51568,1075,16,197,2333,30,3651,2.933.214.286
25/02/2019 15:00,41.97,51402,1205,16,195,2465,31,3912,2.933.214.286
25/02/2019 16:00,42.74,51928,1317,17,194,2782,29,4339,2.933.214.286
25/02/2019 17:00,43.43,53512,1358,16,194,3158,28,4754,2.933.214.286
25/02/2019 18:00,43.52,53963,1404,18,196,3439,28,5085,2.933.214.286
25/02/2019 19:00,42.71,53009,1378,24,200,3590,29,5221,2.933.214.286
25/02/2019 20:00,41.87,51165,1355,35,195,3719,29,5333,2.933.214.286
25/02/2019 21:00,41.59,49589,1316,53,191,3760,29,5349,2.933.214.286
25/02/2019 22:00,40.77,47399,1228,75,189,3773,27,5292,2.933.214.286
25/02/2019 23:00,39.93,45001,1092,93,188,3769,25,5167,2.933.214.286
26/02/2019 00:00,39.32,43682,1294,205,194,4086,25,5804,2.933.214.286
26/02/2019 01:00,38.99,42759,1176,209,201,4017,23,5626,2.933.214.286
26/02/2019 02:00,38.7,42371,955,213,208,3948,20,5344,2.933.214.286
26/02/2019 03:00,38.01,42567,736,215,217,3911,26,5105,2.933.214.286
26/02/2019 04:00,38.84,43579,629,216,238,3866,32,4981,2.933.214.286
26/02/2019 05:00,40.49,46054,485,218,268,3829,42,4842,2.933.214.286
26/02/2019 06:00,42.64,50067,455,217,294,3841,39,4846,2.933.214.286
26/02/2019 07:00,43.8,53483,438,213,300,3503,39,4493,2.933.214.286
26/02/2019 08:00,44.65,54029,421,206,296,2953,39,3915,2.933.214.286
26/02/2019 09:00,44.92,53472,392,200,295,2317,39,3243,2.933.214.286
26/02/2019 10:00,44.33,52996,374,194,309,1751,42,2670,2.933.214.286
26/02/2019 11:00,42.56,52376,348,190,329,1399,43,2309,2.933.214.286
26/02/2019 12:00,42.2,51681,293,206,337,1057,39,1932,2.933.214.286
26/02/2019 13:00,42.17,51168,242,218,328,798,39,1625,2.933.214.286
26/02/2019 14:00,42.35,50983,207,210,299,753,39,1508,2.933.214.286
26/02/2019 15:00,42.61,51097,195,204,273,873,39,1584,2.933.214.286
26/02/2019 16:00,43.57,51688,203,198,248,1107,31,1787,2.933.214.286
26/02/2019 17:00,44.32,53215,261,195,225,1657,27,2365,2.933.214.286
26/02/2019 18:00,44.38,53743,345,193,203,2144,21,2906,2.933.214.286
26/02/2019 19:00,43.69,52969,421,190,182,2614,21,3428,2.933.214.286
26/02/2019 20:00,42.66,51437,473,187,157,2992,22,3831,2.933.214.286
26/02/2019 21:00,42.01,49923,477,186,134,3224,20,4041,2.933.214.286
26/02/2019 22:00,41.18,47856,504,183,109,3405,14,4215,2.933.214.286
26/02/2019 23:00,40.85,45435,534,174,90,3450,10,4258,2.933.214.286
27/02/2019 00:00,40.38,44282,966,168,72,3845,5,5056,2.933.214.286
27/02/2019 01:00,39.92,43477,999,172,57,3867,3,5098,2.933.214.286
27/02/2019 02:00,39.6,43191,978,181,44,3905,4,5112,2.933.214.286
27/02/2019 03:00,39.45,43355,1028,188,32,3967,8,5223,2.933.214.286
27/02/2019 04:00,39.92,44183,1112,189,28,4048,5,5382,2.933.214.286
27/02/2019 05:00,40.95,46500,1117,186,29,4132,4,5468,2.933.214.286
27/02/2019 06:00,42.23,50531,1189,176,39,4195,9,5608,2.933.214.286
27/02/2019 07:00,43.08,53998,1233,162,59,4236,16,5706,2.933.214.286
27/02/2019 08:00,43.34,54381,1330,146,84,4081,21,5662,2.933.214.286
27/02/2019 09:00,43.2,53827,1351,128,116,3945,30,5570,2.933.214.286
27/02/2019 10:00,42.75,53348,1309,114,159,3871,32,5485,2.933.214.286
27/02/2019 11:00,41.18,52597,1265,102,204,3841,37,5449,2.933.214.286
27/02/2019 12:00,40.52,51818,1255,88,245,3841,29,5458,2.933.214.286
27/02/2019 13:00,40.31,51207,1291,80,267,3860,18,5516,2.933.214.286
27/02/2019 14:00,40.34,50948,1334,74,274,3909,16,5607,2.933.214.286
27/02/2019 15:00,40.91,50845,1382,66,272,4024,11,5755,2.933.214.286
27/02/2019 16:00,42.05,51391,1432,65,269,4143,10,5919,2.933.214.286
27/02/2019 17:00,42.68,52862,1505,63,266,4446,11,6291,2.933.214.286
27/02/2019 18:00,42.73,53305,1659,56,265,4671,15,6666,2.933.214.286
27/02/2019 19:00,42.06,52422,1765,44,264,4796,19,6888,2.933.214.286
27/02/2019 20:00,41.12,51001,1835,28,267,4788,23,6941,2.933.214.286
27/02/2019 21:00,40.77,49792,1852,15,269,4784,30,6950,2.933.214.286
27/02/2019 22:00,40.03,47920,1845,9,269,4654,35,6812,2.933.214.286
27/02/2019 23:00,38.75,45707,1832,6,270,4571,33,6712,2.933.214.286
28/02/2019 00:00,37.79,43820,2560,11,0,4580,8,7159,2.933.214.286
28/02/2019 01:00,36.58,42968,2605,19,0,4593,6,7223,2.933.214.286
28/02/2019 02:00,36.02,42747,2598,32,0,4683,8,7321,2.933.214.286
28/02/2019 03:00,36.01,43031,2636,51,0,4785,10,7482,2.933.214.286
28/02/2019 04:00,36.98,43980,2678,63,0,4837,12,7590,2.933.214.286
28/02/2019 05:00,38.52,46321,2543,78,0,4876,16,7513,2.933.214.286
28/02/2019 06:00,41.33,50187,2306,97,0,4861,19,7283,2.933.214.286
28/02/2019 07:00,43.04,53509,2011,108,0,4752,24,6895,2.933.214.286
28/02/2019 08:00,43.5,54102,1714,110,0,4461,26,6311,2.933.214.286
28/02/2019 09:00,42.55,53800,1386,107,0,4213,29,5735,2.933.214.286
28/02/2019 10:00,42.46,53570,1104,98,0,3977,40,5219,2.933.214.286
28/02/2019 11:00,41.48,53035,851,87,0,3847,42,4827,2.933.214.286
28/02/2019 12:00,41.36,52388,634,78,0,3506,44,4262,2.933.214.286
28/02/2019 13:00,41.43,52043,593,75,0,3266,46,3980,2.933.214.286
28/02/2019 14:00,41.6,51963,609,79,0,2976,46,3710,2.933.214.286
28/02/2019 15:00,41.69,51964,623,88,0,2623,47,3381,2.933.214.286
28/02/2019 16:00,42.74,52454,564,101,0,2290,48,3003,2.933.214.286
28/02/2019 17:00,44.5,54216,471,115,0,2075,48,2709,2.933.214.286
28/02/2019 18:00,45.51,54925,444,133,0,1911,49,2537,2.933.214.286
28/02/2019 19:00,44.89,54199,393,148,0,1664,49,2254,2.933.214.286
28/02/2019 20:00,43.77,52642,288,164,0,1378,49,1879,2.933.214.286
28/02/2019 21:00,43.15,51330,218,176,0,1176,49,1619,2.933.214.286
28/02/2019 22:00,42.59,49529,171,184,0,1040,49,1444,2.933.214.286
28/02/2019 23:00,41.43,47433,154,181,0,948,48,1331,2.933.214.286
01/03/2019 00:00,41.46,45712,167,141,0,827,41,1176,2.933.214.286
01/03/2019 01:00,40.85,45126,192,134,0,755,38,1119,2.933.214.286
01/03/2019 02:00,40.69,45002,222,138,0,735,37,1132,2.933.214.286
01/03/2019 03:00,41.02,45344,245,145,0,814,37,1241,2.933.214.286
01/03/2019 04:00,41.92,46318,278,153,0,952,40,1423,2.933.214.286
01/03/2019 05:00,43.39,48791,307,161,0,1094,41,1603,2.933.214.286
01/03/2019 06:00,45.47,52791,335,166,0,1203,42,1746,2.933.214.286
01/03/2019 07:00,46.47,56327,337,169,0,1257,38,1801,2.933.214.286
01/03/2019 08:00,48.12,57104,301,171,0,1135,36,1643,2.933.214.286
01/03/2019 09:00,48.26,56601,252,180,0,1080,39,1551,2.933.214.286
01/03/2019 10:00,48.14,56128,238,189,0,1125,36,1588,2.933.214.286
01/03/2019 11:00,46.72,55357,224,193,0,1254,32,1703,2.933.214.286
01/03/2019 12:00,45.99,54420,216,190,0,1477,28,1911,2.933.214.286
01/03/2019 13:00,45.69,53490,209,189,0,1583,24,2005,2.933.214.286
01/03/2019 14:00,45.28,53001,193,204,0,1600,22,2019,2.933.214.286
01/03/2019 15:00,45.24,52493,158,227,0,1734,19,2138,2.933.214.286
01/03/2019 16:00,45.5,52909,129,243,0,1824,15,2211,2.933.214.286
01/03/2019 17:00,46.11,54772,120,247,0,1958,9,2334,2.933.214.286
01/03/2019 18:00,46.32,55411,127,243,0,2103,6,2479,2.933.214.286
01/03/2019 19:00,45.87,54286,124,235,0,2228,4,2591,2.933.214.286
01/03/2019 20:00,45.02,52457,118,224,0,2303,3,2648,2.933.214.286
01/03/2019 21:00,44.5,51069,123,212,0,2389,2,2726,2.933.214.286
01/03/2019 22:00,44.19,49542,141,202,0,2489,1,2833,2.933.214.286
01/03/2019 23:00,43.32,47876,193,193,0,2647,1,3034,2.933.214.286
02/03/2019 00:00,43.72,46680,196,163,20,3112,2,3493,2.933.214.286
02/03/2019 01:00,42.8,45809,234,183,16,3430,2,3865,2.933.214.286
02/03/2019 02:00,41.78,45491,263,193,19,3648,4,4127,2.933.214.286
02/03/2019 03:00,40.92,45518,278,201,28,3804,7,4318,2.933.214.286
02/03/2019 04:00,41,45747,325,208,37,4000,11,4581,2.933.214.286
02/03/2019 05:00,41.03,46551,372,214,54,4132,14,4786,2.933.214.286
02/03/2019 06:00,41.59,47544,439,218,70,4174,21,4922,2.933.214.286
02/03/2019 07:00,42.14,48823,470,217,83,4113,25,4908,2.933.214.286
02/03/2019 08:00,43.23,50485,500,215,98,4042,26,4881,2.933.214.286
02/03/2019 09:00,43.58,51838,523,212,114,3915,30,4794,2.933.214.286
02/03/2019 10:00,43.68,51899,595,207,147,3853,40,4842,2.933.214.286
02/03/2019 11:00,43.1,51326,695,202,198,3768,42,4905,2.933.214.286
02/03/2019 12:00,42.64,50726,827,198,247,3722,47,5041,2.933.214.286
02/03/2019 13:00,41.02,50150,969,192,276,3530,47,5014,2.933.214.286
02/03/2019 14:00,40.29,49849,1155,183,283,3168,46,4835,2.933.214.286
02/03/2019 15:00,40.47,49995,1280,174,276,2873,47,4650,2.933.214.286
02/03/2019 16:00,41.63,50964,1395,167,273,2640,47,4522,2.933.214.286
02/03/2019 17:00,43.73,52966,1541,162,281,2477,45,4506,2.933.214.286
02/03/2019 18:00,44.84,53798,1729,155,297,2402,44,4627,2.933.214.286
02/03/2019 19:00,43.65,52426,1928,144,311,2373,43,4799,2.933.214.286
02/03/2019 20:00,41.5,50758,2183,132,325,2346,38,5024,2.933.214.286
02/03/2019 21:00,41.06,49666,2406,120,331,2192,37,5086,2.933.214.286
02/03/2019 22:00,40.89,48365,2487,109,331,2039,34,5000,2.933.214.286
02/03/2019 23:00,39.76,46798,2529,97,315,2004,30,4975,2.933.214.286
03/03/2019 00:00,39.78,45503,3220,81,0,2139,41,5481,2.933.214.286
03/03/2019 01:00,39.1,44799,3265,73,0,2124,30,5492,2.933.214.286
03/03/2019 02:00,37.95,44465,3363,70,0,2172,24,5629,2.933.214.286
03/03/2019 03:00,37.83,44414,3583,66,0,2245,22,5916,2.933.214.286
03/03/2019 04:00,38.54,44658,3862,60,0,2339,17,6278,2.933.214.286
03/03/2019 05:00,37.58,45199,3982,59,0,2535,15,6591,2.933.214.286
03/03/2019 06:00,37,45738,3895,65,0,2712,13,6685,2.933.214.286
03/03/2019 07:00,38.58,46615,3685,71,0,2897,12,6665,2.933.214.286
03/03/2019 08:00,39.99,48178,3516,76,0,3028,8,6628,2.933.214.286
03/03/2019 09:00,41.04,49714,3348,83,0,3206,8,6645,2.933.214.286
03/03/2019 10:00,41.56,50454,3324,96,0,3275,10,6705,2.933.214.286
03/03/2019 11:00,41.31,50424,3351,112,0,3328,12,6803,2.933.214.286
03/03/2019 12:00,40.98,50033,3416,133,0,3401,18,6968,2.933.214.286
03/03/2019 13:00,40.6,49632,3433,151,0,3361,27,6972,2.933.214.286
03/03/2019 14:00,39.83,49340,3244,164,0,3238,23,6669,2.933.214.286
03/03/2019 15:00,39.15,49369,2799,169,0,3036,31,6035,2.933.214.286
03/03/2019 16:00,40.01,50343,2381,170,0,2861,33,5445,2.933.214.286
03/03/2019 17:00,41.79,52124,1965,176,0,2708,37,4886,2.933.214.286
03/03/2019 18:00,42.92,53278,1661,187,0,2579,44,4471,2.933.214.286
03/03/2019 19:00,43.14,52747,1475,199,0,2399,40,4113,2.933.214.286
03/03/2019 20:00,42.68,51453,1302,207,0,2198,47,3754,2.933.214.286
03/03/2019 21:00,41.8,50511,1220,211,0,1977,48,3456,2.933.214.286
03/03/2019 22:00,41.31,49027,1361,216,0,1787,47,3411,2.933.214.286
03/03/2019 23:00,40.91,47260,1524,217,0,1577,45,3363,2.933.214.286
04/03/2019 00:00,40.14,45218,2151,174,263,1306,37,3931,2.772.261.905
04/03/2019 01:00,39.87,44592,2648,167,229,1170,31,4245,2.772.261.905
04/03/2019 02:00,38.91,44480,3188,162,209,1117,23,4699,2.772.261.905
04/03/2019 03:00,39.15,44829,3583,161,185,1145,19,5093,2.772.261.905
04/03/2019 04:00,39.92,45729,3938,162,152,1203,15,5470,2.772.261.905
04/03/2019 05:00,41.45,48125,3892,159,118,1344,10,5523,2.772.261.905
04/03/2019 06:00,42.54,52396,3713,153,92,1471,8,5437,2.772.261.905
04/03/2019 07:00,43.22,55977,3448,142,77,1538,6,5211,2.772.261.905
04/03/2019 08:00,44.17,56887,3159,127,79,1514,7,4886,2.772.261.905
04/03/2019 09:00,44.49,56754,2987,107,88,1508,8,4698,2.772.261.905
04/03/2019 10:00,44.32,56547,3009,86,111,1491,8,4705,2.772.261.905
04/03/2019 11:00,43.75,55986,3078,70,139,1447,8,4742,2.772.261.905
04/03/2019 12:00,43.07,55349,3284,56,166,1462,10,4978,2.772.261.905
04/03/2019 13:00,42.93,55022,3494,46,194,1487,12,5233,2.772.261.905
04/03/2019 14:00,42.87,54795,3719,39,227,1646,18,5649,2.772.261.905
04/03/2019 15:00,42.82,54674,3722,34,261,1795,24,5836,2.772.261.905
04/03/2019 16:00,42.87,54882,3672,29,304,2073,28,6106,2.772.261.905
04/03/2019 17:00,43.35,56118,3728,26,349,2322,33,6458,2.772.261.905
04/03/2019 18:00,43.23,56607,3761,25,394,2643,41,6864,2.772.261.905
04/03/2019 19:00,42.93,55877,3790,21,423,2815,50,7099,2.772.261.905
04/03/2019 20:00,41.91,54132,3826,18,428,2956,51,7279,2.772.261.905
04/03/2019 21:00,41.46,52620,3798,17,429,3198,46,7488,2.772.261.905
04/03/2019 22:00,40.35,50531,3774,19,426,3338,46,7603,2.772.261.905
04/03/2019 23:00,38.54,48144,3768,23,429,3415,49,7684,2.772.261.905
05/03/2019 00:00,38.81,46835,3644,63,391,3543,51,7692,2.772.261.905
05/03/2019 01:00,37.39,46020,3593,52,411,3612,50,7718,2.772.261.905
05/03/2019 02:00,37.19,45780,3373,41,438,3718,50,7620,2.772.261.905
05/03/2019 03:00,37.69,46025,3240,31,460,3710,51,7492,2.772.261.905
05/03/2019 04:00,38.38,47073,3197,23,471,3659,51,7401,2.772.261.905
05/03/2019 05:00,40.56,49531,3029,18,476,3605,50,7178,2.772.261.905
05/03/2019 06:00,42.28,53612,2879,15,479,3534,46,6953,2.772.261.905
05/03/2019 07:00,44.29,57095,2750,10,477,3328,41,6606,2.772.261.905
05/03/2019 08:00,44.82,57821,2609,6,475,3073,29,6192,2.772.261.905
05/03/2019 09:00,44.86,57468,2414,4,470,2605,19,5512,2.772.261.905
05/03/2019 10:00,44.84,57362,2348,4,462,2300,14,5128,2.772.261.905
05/03/2019 11:00,44.53,56859,2295,4,450,2032,10,4791,2.772.261.905
05/03/2019 12:00,44.14,56417,2259,7,438,1767,13,4484,2.772.261.905
05/03/2019 13:00,43.95,56168,2252,10,426,1528,16,4232,2.772.261.905
05/03/2019 14:00,43.91,56182,2262,15,407,1360,20,4064,2.772.261.905
05/03/2019 15:00,44.49,56415,2124,22,384,1193,22,3745,2.772.261.905
05/03/2019 16:00,46.12,56785,1915,33,358,1163,24,3493,2.772.261.905
05/03/2019 17:00,47.97,58148,1626,44,324,1253,25,3272,2.772.261.905
05/03/2019 18:00,51.24,58745,1390,55,289,1319,17,3070,2.772.261.905
05/03/2019 19:00,50.74,57917,1222,67,248,1431,12,2980,2.772.261.905
05/03/2019 20:00,47.74,56502,1108,84,215,1530,10,2947,2.772.261.905
05/03/2019 21:00,46.36,55224,1014,97,189,1601,10,2911,2.772.261.905
05/03/2019 22:00,44.69,53109,905,108,163,1650,8,2834,2.772.261.905
05/03/2019 23:00,42.64,50810,815,120,141,1760,7,2843,2.772.261.905
06/03/2019 00:00,43.06,49530,719,112,85,2057,4,2977,2.772.261.905
06/03/2019 01:00,42.74,48812,641,114,75,2257,3,3090,2.772.261.905
06/03/2019 02:00,42.5,48616,658,114,63,2412,3,3250,2.772.261.905
06/03/2019 03:00,42.56,48860,744,119,50,2529,3,3445,2.772.261.905
06/03/2019 04:00,43.43,49830,877,117,35,2576,2,3607,2.772.261.905
06/03/2019 05:00,44.82,52256,1035,110,25,2543,2,3715,2.772.261.905
06/03/2019 06:00,45.58,56425,1207,102,16,2532,2,3859,2.772.261.905
06/03/2019 07:00,47.72,60101,1452,95,9,2401,3,3960,2.772.261.905
06/03/2019 08:00,47.93,60780,1715,100,8,2231,2,4056,2.772.261.905
06/03/2019 09:00,47.83,60288,1824,112,8,2047,2,3993,2.772.261.905
06/03/2019 10:00,47.39,59773,1917,135,9,1878,2,3941,2.772.261.905
06/03/2019 11:00,46.8,58838,2102,164,12,1769,2,4049,2.772.261.905
06/03/2019 12:00,46.12,58158,2389,188,17,1690,2,4286,2.772.261.905
06/03/2019 13:00,45.77,57611,2674,204,21,1697,2,4598,2.772.261.905
06/03/2019 14:00,45.19,57250,2944,209,27,1746,2,4928,2.772.261.905
06/03/2019 15:00,44.65,56990,3096,213,37,1816,3,5165,2.772.261.905
06/03/2019 16:00,45.03,57311,3175,212,58,1942,4,5391,2.772.261.905
06/03/2019 17:00,45.62,58627,3271,210,89,2186,3,5759,2.772.261.905
06/03/2019 18:00,45.96,59096,3280,206,141,2477,4,6108,2.772.261.905
06/03/2019 19:00,44.88,58114,3213,195,187,2734,6,6335,2.772.261.905
06/03/2019 20:00,43.85,56375,3065,186,219,2890,10,6370,2.772.261.905
06/03/2019 21:00,42.95,54802,2804,175,254,3036,13,6282,2.772.261.905
06/03/2019 22:00,41.52,52432,2565,163,284,3046,14,6072,2.772.261.905
06/03/2019 23:00,40.91,49969,2366,148,308,3006,17,5845,2.772.261.905
07/03/2019 00:00,40.86,48356,2535,100,273,2913,20,5841,2.772.261.905
07/03/2019 01:00,39.97,47385,2374,84,300,2854,20,5632,2.772.261.905
07/03/2019 02:00,39.93,46952,2182,65,329,2698,21,5295,2.772.261.905
07/03/2019 03:00,40.02,47032,2000,47,350,2575,28,5000,2.772.261.905
07/03/2019 04:00,40.8,47718,1908,29,360,2377,28,4702,2.772.261.905
07/03/2019 05:00,43.05,49833,1824,17,368,2231,33,4473,2.772.261.905
07/03/2019 06:00,44.8,53603,1736,10,378,2028,33,4185,2.772.261.905
07/03/2019 07:00,47.01,56944,1676,8,378,1845,33,3940,2.772.261.905
07/03/2019 08:00,47.92,57399,1632,7,371,1634,33,3677,2.772.261.905
07/03/2019 09:00,47.71,56869,1579,9,368,1485,37,3478,2.772.261.905
07/03/2019 10:00,47.5,56524,1611,13,363,1383,36,3406,2.772.261.905
07/03/2019 11:00,46.74,56164,1740,18,359,1357,38,3512,2.772.261.905
07/03/2019 12:00,45.97,55676,2018,24,354,1358,35,3789,2.772.261.905
07/03/2019 13:00,45.63,55514,2451,30,345,1463,34,4323,2.772.261.905
07/03/2019 14:00,44.95,55380,3112,35,333,1617,34,5131,2.772.261.905
07/03/2019 15:00,44.46,55171,3610,40,322,1885,30,5887,2.772.261.905
07/03/2019 16:00,44.01,55396,3643,47,317,2261,27,6295,2.772.261.905
07/03/2019 17:00,44.94,57090,3778,57,324,2542,31,6732,2.772.261.905
07/03/2019 18:00,45.23,57530,3715,69,331,2879,34,7028,2.772.261.905
07/03/2019 19:00,45,56603,3600,81,333,3120,33,7167,2.772.261.905
07/03/2019 20:00,43.02,54672,3397,89,328,3276,34,7124,2.772.261.905
07/03/2019 21:00,41.9,53005,3150,96,316,3346,35,6943,2.772.261.905
07/03/2019 22:00,40.68,50851,2934,102,308,3512,40,6896,2.772.261.905
07/03/2019 23:00,39.52,48373,2645,109,299,3591,38,6682,2.772.261.905
08/03/2019 00:00,40.04,46413,3518,107,253,3711,37,7626,2.772.261.905
08/03/2019 01:00,39.52,45555,3219,111,235,3732,40,7337,2.772.261.905
08/03/2019 02:00,38.98,45236,2916,114,233,3778,32,7073,2.772.261.905
08/03/2019 03:00,39.12,45438,2798,123,248,3798,27,6994,2.772.261.905
08/03/2019 04:00,39.1,46365,2951,132,274,3840,26,7223,2.772.261.905
08/03/2019 05:00,39.71,48775,3365,138,310,3835,32,7680,2.772.261.905
08/03/2019 06:00,41.7,52635,3769,149,347,3765,34,8064,2.772.261.905
08/03/2019 07:00,43.02,56104,4011,158,381,3716,36,8302,2.772.261.905
08/03/2019 08:00,43.45,57050,4230,167,410,3666,39,8512,2.772.261.905
08/03/2019 09:00,43.22,56724,4069,174,440,3705,44,8432,2.772.261.905
08/03/2019 10:00,42.82,56383,4027,180,462,3872,49,8590,2.772.261.905
08/03/2019 11:00,42.03,55773,4079,186,473,4151,50,8939,2.772.261.905
08/03/2019 12:00,41.44,55103,4150,192,482,4459,50,9333,2.772.261.905
08/03/2019 13:00,40.83,54516,4280,196,486,4761,50,9773,2.772.261.905
08/03/2019 14:00,40.4,53902,4368,197,487,5076,51,10179,2.772.261.905
08/03/2019 15:00,40.3,53634,4400,194,487,5333,51,10465,2.772.261.905
08/03/2019 16:00,40.75,53938,4252,191,487,5431,51,10412,2.772.261.905
08/03/2019 17:00,42.61,55457,4268,185,489,5509,51,10502,2.772.261.905
08/03/2019 18:00,44.02,56247,3994,175,493,5553,51,10266,2.772.261.905
08/03/2019 19:00,43.88,55149,3694,170,492,5502,51,9909,2.772.261.905
08/03/2019 20:00,42.93,53090,3405,165,493,5338,51,9452,2.772.261.905
08/03/2019 21:00,41.94,51573,3082,164,492,5324,51,9113,2.772.261.905
08/03/2019 22:00,41.18,49828,2831,167,491,5224,51,8764,2.772.261.905
08/03/2019 23:00,39.49,48060,2515,166,487,5082,51,8301,2.772.261.905
09/03/2019 00:00,41.17,46767,2689,49,0,4731,50,7519,2.772.261.905
09/03/2019 01:00,40.44,45884,2824,77,0,4582,50,7533,2.772.261.905
09/03/2019 02:00,39.91,45498,3107,101,0,4378,50,7636,2.772.261.905
09/03/2019 03:00,38.98,45458,3435,116,0,4126,49,7726,2.772.261.905
09/03/2019 04:00,39.31,45789,3802,124,0,4052,49,8027,2.772.261.905
09/03/2019 05:00,39.87,46821,4067,130,0,3987,47,8231,2.772.261.905
09/03/2019 06:00,39.78,48061,4192,136,0,3866,44,8238,2.772.261.905
09/03/2019 07:00,40.32,49358,4244,139,0,3780,43,8206,2.772.261.905
09/03/2019 08:00,40.34,51172,4414,142,0,3664,40,8260,2.772.261.905
09/03/2019 09:00,41.74,52660,4362,147,0,3510,42,8061,2.772.261.905
09/03/2019 10:00,42.35,53007,4332,155,0,3490,45,8022,2.772.261.905
09/03/2019 11:00,41.59,52717,4275,169,0,3384,42,7870,2.772.261.905
09/03/2019 12:00,40.22,52226,4257,188,0,3307,44,7796,2.772.261.905
09/03/2019 13:00,39.73,51775,4311,209,0,3292,45,7857,2.772.261.905
09/03/2019 14:00,39.37,51364,4305,227,0,3249,40,7821,2.772.261.905
09/03/2019 15:00,39.3,51451,4244,240,0,3232,36,7752,2.772.261.905
09/03/2019 16:00,39.99,52155,4130,243,0,3251,30,7654,2.772.261.905
09/03/2019 17:00,41.6,53666,4283,242,0,3349,32,7906,2.772.261.905
09/03/2019 18:00,42.59,54568,4308,234,0,3482,31,8055,2.772.261.905
09/03/2019 19:00,42.28,53466,4331,223,0,3593,34,8181,2.772.261.905
09/03/2019 20:00,40.5,51744,4265,201,0,3741,34,8241,2.772.261.905
09/03/2019 21:00,40.49,50662,4119,174,0,3760,38,8091,2.772.261.905
09/03/2019 22:00,40.41,49401,4048,150,0,3774,46,8018,2.772.261.905
09/03/2019 23:00,39.98,47972,3819,128,0,3791,49,7787,2.772.261.905
10/03/2019 00:00,39.98,47151,4004,97,400,3893,49,8443,2.772.261.905
10/03/2019 01:00,39.71,46594,3994,78,397,3813,47,8329,2.772.261.905
10/03/2019 02:00,39.54,46378,4092,62,394,3754,49,8351,2.772.261.905
10/03/2019 03:00,39.85,46396,4121,50,402,3663,49,8285,2.772.261.905
10/03/2019 04:00,39.95,46587,3967,40,411,3659,48,8125,2.772.261.905
10/03/2019 05:00,40.1,47110,3608,33,412,3590,48,7691,2.772.261.905
10/03/2019 06:00,40.36,47634,3203,28,405,3544,41,7221,2.772.261.905
10/03/2019 07:00,40.95,48601,2849,23,394,3383,34,6683,2.772.261.905
10/03/2019 08:00,41.37,50069,2517,18,384,3185,26,6130,2.772.261.905
10/03/2019 09:00,42.08,51372,2186,14,367,2993,28,5588,2.772.261.905
10/03/2019 10:00,42.08,51726,1975,11,340,2931,40,5297,2.772.261.905
10/03/2019 11:00,42.22,51545,1716,8,332,3043,32,5131,2.772.261.905
10/03/2019 12:00,42.02,50925,1407,7,329,3158,31,4932,2.772.261.905
10/03/2019 13:00,41.65,50451,1151,9,330,3109,27,4626,2.772.261.905
10/03/2019 14:00,41.61,50262,935,16,345,3017,27,4340,2.772.261.905
10/03/2019 15:00,41.49,50384,808,29,352,2961,26,4176,2.772.261.905
10/03/2019 16:00,42.13,51422,752,42,340,2864,29,4027,2.772.261.905
10/03/2019 17:00,43.38,53218,777,54,302,2940,32,4105,2.772.261.905
10/03/2019 18:00,44.43,54718,749,63,251,3066,29,4158,2.772.261.905
10/03/2019 19:00,44.15,54633,811,68,211,3236,23,4349,2.772.261.905
10/03/2019 20:00,43.27,53510,868,71,177,3357,24,4497,2.772.261.905
10/03/2019 21:00,42.68,52612,822,71,151,3446,23,4513,2.772.261.905
10/03/2019 22:00,42.45,51174,797,70,134,3570,21,4592,2.772.261.905
10/03/2019 23:00,41.3,49498,795,65,122,3533,31,4546,2.772.261.905
11/03/2019 00:00,42.05,47964,473,191,34,3454,8,4160,2.594.940.476
11/03/2019 01:00,41.33,47460,426,200,35,3381,9,4051,2.594.940.476
11/03/2019 02:00,41.51,47416,333,203,43,3386,8,3973,2.594.940.476
11/03/2019 03:00,41.51,47892,242,199,61,3350,13,3865,2.594.940.476
11/03/2019 04:00,42.24,49054,224,193,80,3331,16,3844,2.594.940.476
11/03/2019 05:00,43.91,51539,207,186,109,3279,17,3798,2.594.940.476
11/03/2019 06:00,45.63,55732,172,181,145,3233,18,3749,2.594.940.476
11/03/2019 07:00,47.96,59171,170,185,186,3103,22,3666,2.594.940.476
11/03/2019 08:00,49.11,60082,145,189,240,2886,28,3488,2.594.940.476
11/03/2019 09:00,48.09,59349,145,190,293,2766,25,3419,2.594.940.476
11/03/2019 10:00,47.05,58525,166,191,320,2653,30,3360,2.594.940.476
11/03/2019 11:00,46.3,57617,207,190,331,2693,34,3455,2.594.940.476
11/03/2019 12:00,45.7,56687,297,189,333,2760,36,3615,2.594.940.476
11/03/2019 13:00,45.38,56086,439,190,330,2893,37,3889,2.594.940.476
11/03/2019 14:00,45.01,55827,698,194,319,2981,37,4229,2.594.940.476
11/03/2019 15:00,44.8,55640,960,206,309,3110,36,4621,2.594.940.476
11/03/2019 16:00,44.98,55760,1154,218,281,3206,35,4894,2.594.940.476
11/03/2019 17:00,46.49,57066,1367,228,250,3430,31,5306,2.594.940.476
11/03/2019 18:00,49.03,58118,1474,231,221,3657,30,5613,2.594.940.476
11/03/2019 19:00,48.85,57888,1542,227,194,3665,27,5655,2.594.940.476
11/03/2019 20:00,47.69,56354,1587,223,173,3549,24,5556,2.594.940.476
11/03/2019 21:00,46.38,55002,1565,220,158,3406,24,5373,2.594.940.476
11/03/2019 22:00,46.08,53132,1401,224,149,3305,26,5105,2.594.940.476
11/03/2019 23:00,44.01,51012,1231,232,146,3094,25,4728,2.594.940.476
12/03/2019 00:00,42.78,49495,1108,47,122,2792,26,4095,2.594.940.476
12/03/2019 01:00,42.28,48732,1066,49,134,2620,25,3894,2.594.940.476
12/03/2019 02:00,42.2,48529,1023,53,152,2441,28,3697,2.594.940.476
12/03/2019 03:00,42.03,48798,932,59,168,2306,31,3496,2.594.940.476
12/03/2019 04:00,42.81,49922,920,66,180,2116,34,3316,2.594.940.476
12/03/2019 05:00,44.2,52335,981,71,184,1904,36,3176,2.594.940.476
12/03/2019 06:00,46.85,56452,1108,73,186,1712,36,3115,2.594.940.476
12/03/2019 07:00,52.1,59993,1320,75,196,1359,34,2984,2.594.940.476
12/03/2019 08:00,51.85,60533,1658,81,225,928,34,2926,2.594.940.476
12/03/2019 09:00,48.29,59724,1987,84,254,646,32,3003,2.594.940.476
12/03/2019 10:00,47.58,58987,2411,94,268,519,29,3321,2.594.940.476
12/03/2019 11:00,46.81,58081,2910,104,262,489,26,3791,2.594.940.476
12/03/2019 12:00,45.53,57194,3339,117,253,591,22,4322,2.594.940.476
12/03/2019 13:00,44.97,56555,3810,127,235,729,18,4919,2.594.940.476
12/03/2019 14:00,44.59,56309,4191,133,204,950,17,5495,2.594.940.476
12/03/2019 15:00,44.35,56251,4370,142,164,1304,11,5991,2.594.940.476
12/03/2019 16:00,44.27,56759,4315,146,122,1743,10,6336,2.594.940.476
12/03/2019 17:00,44.79,58215,4503,144,80,2345,7,7079,2.594.940.476
12/03/2019 18:00,45.29,59031,4533,140,51,2962,5,7691,2.594.940.476
12/03/2019 19:00,44.82,58450,4506,134,33,3506,4,8183,2.594.940.476
12/03/2019 20:00,43.42,57042,4483,125,31,3781,4,8424,2.594.940.476
12/03/2019 21:00,43.19,55719,4333,119,34,4015,5,8506,2.594.940.476
12/03/2019 22:00,42.21,53599,4132,111,55,4162,6,8466,2.594.940.476
12/03/2019 23:00,40.58,51139,3628,99,79,4260,7,8073,2.594.940.476
13/03/2019 00:00,39.71,49022,3448,81,106,4563,10,8208,2.594.940.476
13/03/2019 01:00,39.13,48146,3222,75,131,4585,11,8024,2.594.940.476
13/03/2019 02:00,38.97,47864,3017,70,151,4630,13,7881,2.594.940.476
13/03/2019 03:00,39.41,47934,2921,66,174,4642,13,7816,2.594.940.476
13/03/2019 04:00,39.81,48521,2982,65,201,4565,14,7827,2.594.940.476
13/03/2019 05:00,41.03,50612,3221,66,231,4458,15,7991,2.594.940.476
13/03/2019 06:00,42.27,54334,3449,63,269,4327,18,8126,2.594.940.476
13/03/2019 07:00,43.8,57729,3626,61,289,4206,21,8203,2.594.940.476
13/03/2019 08:00,44.36,58167,3834,60,293,4019,18,8224,2.594.940.476
13/03/2019 09:00,44.12,57540,3808,60,299,3956,19,8142,2.594.940.476
13/03/2019 10:00,43.71,57223,3839,61,301,3936,16,8153,2.594.940.476
13/03/2019 11:00,43.38,56632,3834,64,292,3908,16,8114,2.594.940.476
13/03/2019 12:00,43.03,55991,3662,68,280,3850,20,7880,2.594.940.476
13/03/2019 13:00,42.95,55550,3516,70,255,3797,18,7656,2.594.940.476
13/03/2019 14:00,42.91,55193,3243,71,216,3781,18,7329,2.594.940.476
13/03/2019 15:00,42.91,55089,2936,67,173,3734,19,6929,2.594.940.476
13/03/2019 16:00,43.15,55470,2589,60,143,3700,19,6511,2.594.940.476
13/03/2019 17:00,44,56565,2379,52,132,3656,16,6235,2.594.940.476
13/03/2019 18:00,44.41,57174,2230,42,135,3600,17,6024,2.594.940.476
13/03/2019 19:00,43.92,56587,2268,33,155,3486,15,5957,2.594.940.476
13/03/2019 20:00,42.52,54980,2488,22,184,3219,17,5930,2.594.940.476
13/03/2019 21:00,41.95,53707,2686,15,205,3050,15,5971,2.594.940.476
13/03/2019 22:00,40.89,51510,2859,10,221,2757,17,5864,2.594.940.476
13/03/2019 23:00,39.97,49003,2945,8,226,2443,18,5640,2.594.940.476
14/03/2019 00:00,39.46,47037,3212,6,264,2104,25,5611,2.594.940.476
14/03/2019 01:00,39.01,46223,3168,6,275,1857,24,5330,2.594.940.476
14/03/2019 02:00,39,45942,2877,6,284,1798,21,4986,2.594.940.476
14/03/2019 03:00,39.25,46067,2567,8,297,1734,21,4627,2.594.940.476
14/03/2019 04:00,40.08,46892,2369,11,307,1715,22,4424,2.594.940.476
14/03/2019 05:00,40.85,49067,2269,17,315,1697,25,4323,2.594.940.476
14/03/2019 06:00,41.91,52603,2175,27,321,1718,27,4268,2.594.940.476
14/03/2019 07:00,43.93,55866,2134,36,324,1732,27,4253,2.594.940.476
14/03/2019 08:00,45.03,56548,2183,51,327,1663,26,4250,2.594.940.476
14/03/2019 09:00,44.7,56057,2214,67,331,1597,26,4235,2.594.940.476
14/03/2019 10:00,44.25,55793,2292,76,354,1528,22,4272,2.594.940.476
14/03/2019 11:00,43.62,55522,2422,82,372,1446,19,4341,2.594.940.476
14/03/2019 12:00,43.44,54894,2552,85,374,1382,17,4410,2.594.940.476
14/03/2019 13:00,43.06,54740,2619,89,363,1302,18,4391,2.594.940.476
14/03/2019 14:00,42.94,54394,2460,93,343,1316,18,4230,2.594.940.476
14/03/2019 15:00,42.92,54081,2256,102,326,1287,16,3987,2.594.940.476
14/03/2019 16:00,42.94,54159,2088,112,288,1316,14,3818,2.594.940.476
14/03/2019 17:00,43.72,55490,2155,123,241,1317,18,3854,2.594.940.476
14/03/2019 18:00,44.3,56201,2291,133,198,1358,16,3996,2.594.940.476
14/03/2019 19:00,43.65,55700,2292,137,186,1321,15,3951,2.594.940.476
14/03/2019 20:00,42.93,53988,2314,139,207,1234,15,3909,2.594.940.476
14/03/2019 21:00,42.07,52491,2408,134,225,1167,12,3946,2.594.940.476
14/03/2019 22:00,41.36,50461,2515,125,235,1062,13,3950,2.594.940.476
14/03/2019 23:00,40.92,48182,2424,113,235,944,10,3726,2.594.940.476
15/03/2019 00:00,41.14,47396,2312,129,190,746,12,3389,2.594.940.476
15/03/2019 01:00,40.63,46490,2394,125,186,673,13,3391,2.594.940.476
15/03/2019 02:00,40.57,46163,2281,125,188,621,13,3228,2.594.940.476
15/03/2019 03:00,40.84,46294,2190,125,191,554,13,3073,2.594.940.476
15/03/2019 04:00,41.21,47085,2165,126,193,519,14,3017,2.594.940.476
15/03/2019 05:00,42.07,49389,2049,129,194,541,12,2925,2.594.940.476
15/03/2019 06:00,43.13,53150,1866,133,198,598,13,2808,2.594.940.476
15/03/2019 07:00,44.97,56461,1747,135,195,630,13,2720,2.594.940.476
15/03/2019 08:00,45.15,57315,1769,139,192,655,12,2767,2.594.940.476
15/03/2019 09:00,44.93,57005,1821,141,197,615,9,2783,2.594.940.476
15/03/2019 10:00,44.63,56637,1881,141,201,593,9,2825,2.594.940.476
15/03/2019 11:00,44.22,55941,1873,143,201,563,10,2790,2.594.940.476
15/03/2019 12:00,43.87,55198,1934,143,197,558,10,2842,2.594.940.476
15/03/2019 13:00,43.49,54402,1933,141,194,564,12,2844,2.594.940.476
15/03/2019 14:00,43.16,53727,1987,138,179,602,12,2918,2.594.940.476
15/03/2019 15:00,43.04,53259,2069,133,169,644,12,3027,2.594.940.476
15/03/2019 16:00,43.16,53447,2360,132,167,680,12,3351,2.594.940.476
15/03/2019 17:00,43.47,54519,2842,131,184,706,12,3875,2.594.940.476
15/03/2019 18:00,43.83,55229,3287,131,212,755,12,4397,2.594.940.476
15/03/2019 19:00,42.83,54434,3647,132,218,776,12,4785,2.594.940.476
15/03/2019 20:00,42.1,52528,3952,132,208,695,12,4999,2.594.940.476
15/03/2019 21:00,41.54,51063,4160,128,197,702,14,5201,2.594.940.476
15/03/2019 22:00,41.03,49309,4242,123,183,748,11,5307,2.594.940.476
15/03/2019 23:00,40.75,47479,4184,118,170,816,9,5297,2.594.940.476
16/03/2019 00:00,40.26,45741,4345,252,138,847,6,5588,2.594.940.476
16/03/2019 01:00,39.61,44934,4260,258,134,893,5,5550,2.594.940.476
16/03/2019 02:00,39.8,44596,4063,260,113,985,4,5425,2.594.940.476
16/03/2019 03:00,39.35,44426,3844,259,88,1056,3,5250,2.594.940.476
16/03/2019 04:00,40.07,44699,3693,256,68,1150,3,5170,2.594.940.476
16/03/2019 05:00,40.13,45822,3534,248,53,1216,2,5053,2.594.940.476
16/03/2019 06:00,40.33,46982,3276,238,50,1275,3,4842,2.594.940.476
16/03/2019 07:00,40.73,48175,3026,233,74,1297,3,4633,2.594.940.476
16/03/2019 08:00,41.01,49735,2979,229,116,1286,5,4615,2.594.940.476
16/03/2019 09:00,41.44,50815,2868,226,167,1331,5,4597,2.594.940.476
16/03/2019 10:00,41.55,51043,2762,222,209,1335,9,4537,2.594.940.476
16/03/2019 11:00,41.44,50634,2473,215,248,1346,11,4293,2.594.940.476
16/03/2019 12:00,40.92,49940,2121,201,280,1341,15,3958,2.594.940.476
16/03/2019 13:00,40.14,49427,1777,178,291,1268,16,3530,2.594.940.476
16/03/2019 14:00,40.01,48965,1422,142,290,1142,15,3011,2.594.940.476
16/03/2019 15:00,40.45,49148,1205,116,276,1017,19,2633,2.594.940.476
16/03/2019 16:00,41.11,49714,1219,106,245,938,17,2525,2.594.940.476
16/03/2019 17:00,41.96,51165,1508,109,195,992,18,2822,2.594.940.476
16/03/2019 18:00,42.77,52422,1917,118,158,1120,16,3329,2.594.940.476
16/03/2019 19:00,41.92,51795,2388,124,132,1206,13,3863,2.594.940.476
16/03/2019 20:00,41.05,50248,2952,125,115,1261,8,4461,2.594.940.476
16/03/2019 21:00,40.59,49067,3420,121,101,1340,5,4987,2.594.940.476
16/03/2019 22:00,40.26,47814,3746,113,94,1465,3,5421,2.594.940.476
16/03/2019 23:00,39.38,46441,3897,102,90,1633,3,5725,2.594.940.476
17/03/2019 00:00,36.3,44865,4264,114,82,1979,6,6445,2.594.940.476
17/03/2019 01:00,35.59,44260,4356,108,74,2255,7,6800,2.594.940.476
17/03/2019 02:00,34.51,43939,4212,102,72,2565,7,6958,2.594.940.476
17/03/2019 03:00,32.56,43847,4143,92,76,2921,8,7240,2.594.940.476
17/03/2019 04:00,34.11,43978,4444,82,92,3232,8,7858,2.594.940.476
17/03/2019 05:00,34.04,44329,4468,76,127,3379,10,8060,2.594.940.476
17/03/2019 06:00,34.03,44657,4317,77,164,3526,10,8094,2.594.940.476
17/03/2019 07:00,35.01,45706,4202,90,198,3746,13,8249,2.594.940.476
17/03/2019 08:00,35.98,47149,4318,100,223,3878,15,8534,2.594.940.476
17/03/2019 09:00,37.78,48557,4281,103,247,4026,19,8676,2.594.940.476
17/03/2019 10:00,37.89,49280,4350,102,250,4145,26,8873,2.594.940.476
17/03/2019 11:00,37.55,49309,4495,98,246,4268,30,9137,2.594.940.476
17/03/2019 12:00,35.83,49028,4651,95,242,4422,28,9438,2.594.940.476
17/03/2019 13:00,35.51,48659,4776,98,244,4488,27,9633,2.594.940.476
17/03/2019 14:00,35.06,48435,4751,100,243,4599,23,9716,2.594.940.476
17/03/2019 15:00,35.14,48340,4691,95,243,4708,23,9760,2.594.940.476
17/03/2019 16:00,35.68,48926,4625,88,247,4767,25,9752,2.594.940.476
17/03/2019 17:00,39.12,50444,4725,83,248,4843,25,9924,2.594.940.476
17/03/2019 18:00,40.04,51746,4769,76,249,4917,24,10035,2.594.940.476
17/03/2019 19:00,40.54,51870,4896,64,247,4988,23,10218,2.594.940.476
17/03/2019 20:00,39.48,50764,4987,53,236,5025,21,10322,2.594.940.476
17/03/2019 21:00,38.03,49808,4991,48,226,5020,19,10304,2.594.940.476
17/03/2019 22:00,37.16,48301,4978,49,215,4964,25,10231,2.594.940.476
17/03/2019 23:00,36.1,46430,4802,50,188,4852,25,9917,2.594.940.476
18/03/2019 00:00,37.23,44474,4689,115,186,4593,30,9613,247.952.381
18/03/2019 01:00,35.89,43820,4713,113,175,4481,33,9515,247.952.381
18/03/2019 02:00,35.75,43805,4536,111,179,4376,33,9235,247.952.381
18/03/2019 03:00,35.83,44208,4362,108,196,4279,36,8981,247.952.381
18/03/2019 04:00,37.35,45335,4245,101,205,4237,36,8824,247.952.381
18/03/2019 05:00,40.65,47881,4154,96,207,4163,39,8659,247.952.381
18/03/2019 06:00,42.59,52050,4013,91,215,4065,39,8423,247.952.381
18/03/2019 07:00,44.88,55628,3853,84,234,4038,41,8250,247.952.381
18/03/2019 08:00,44.23,56415,3880,85,267,3951,43,8226,247.952.381
18/03/2019 09:00,43.24,55962,3886,91,308,3983,45,8313,247.952.381
18/03/2019 10:00,42.71,55669,3847,96,335,3992,45,8315,247.952.381
18/03/2019 11:00,42.33,55053,3874,102,355,3988,43,8362,247.952.381
18/03/2019 12:00,42.21,54529,3868,109,374,4060,43,8454,247.952.381
18/03/2019 13:00,42.16,54239,3825,116,386,4075,45,8447,247.952.381
18/03/2019 14:00,41.98,53919,3648,119,384,4041,45,8237,247.952.381
18/03/2019 15:00,41.92,53613,3409,118,372,4068,45,8012,247.952.381
18/03/2019 16:00,42.06,53530,3147,118,366,4085,45,7761,247.952.381
18/03/2019 17:00,43.08,54444,2940,122,372,4056,45,7535,247.952.381
18/03/2019 18:00,44.78,55277,2738,129,390,3982,44,7283,247.952.381
18/03/2019 19:00,44.99,55000,2698,136,394,4010,45,7283,247.952.381
18/03/2019 20:00,44.24,53439,2686,136,392,4043,41,7298,247.952.381
18/03/2019 21:00,42.96,51893,2584,132,385,4088,41,7230,247.952.381
18/03/2019 22:00,42.05,49826,2363,124,375,4311,39,7212,247.952.381
18/03/2019 23:00,40.43,47490,2091,113,356,4322,36,6918,247.952.381
19/03/2019 00:00,40.63,46020,1626,190,0,4366,30,6212,247.952.381
19/03/2019 01:00,40.44,45276,1534,184,0,4288,24,6030,247.952.381
19/03/2019 02:00,40.37,45042,1387,182,0,4186,23,5778,247.952.381
19/03/2019 03:00,40.33,45298,1235,183,0,4139,20,5577,247.952.381
19/03/2019 04:00,40.8,46345,1119,182,0,4043,16,5360,247.952.381
19/03/2019 05:00,42.52,48803,1031,179,0,3909,11,5130,247.952.381
19/03/2019 06:00,45.44,52806,935,178,0,3695,11,4819,247.952.381
19/03/2019 07:00,50.95,56021,807,183,0,3443,11,4444,247.952.381
19/03/2019 08:00,54.03,56220,663,188,0,2913,14,3778,247.952.381
19/03/2019 09:00,49.45,55224,548,191,0,2293,20,3052,247.952.381
19/03/2019 10:00,46.25,54509,452,191,0,1920,21,2584,247.952.381
19/03/2019 11:00,44.92,53757,424,186,0,1674,20,2304,247.952.381
19/03/2019 12:00,44.38,52851,438,180,0,1445,18,2081,247.952.381
19/03/2019 13:00,43.96,52178,452,171,0,1199,22,1844,247.952.381
19/03/2019 14:00,43.74,51959,441,165,0,1041,22,1669,247.952.381
19/03/2019 15:00,43.86,51919,491,159,0,927,23,1600,247.952.381
19/03/2019 16:00,44.6,52199,520,152,0,833,20,1525,247.952.381
19/03/2019 17:00,48.87,53449,477,155,0,821,18,1471,247.952.381
19/03/2019 18:00,54.92,54534,478,160,0,881,17,1536,247.952.381
19/03/2019 19:00,59.05,54547,538,167,0,1037,11,1753,247.952.381
19/03/2019 20:00,50.64,53532,688,173,0,1312,7,2180,247.952.381
19/03/2019 21:00,45.31,52431,897,174,0,1842,6,2919,247.952.381
19/03/2019 22:00,43.7,50286,1112,172,0,2446,5,3735,247.952.381
19/03/2019 23:00,42.06,47797,1446,165,0,2992,6,4609,247.952.381
20/03/2019 00:00,41.02,45503,1989,130,91,3657,7,5874,247.952.381
20/03/2019 01:00,39.66,44922,2324,110,91,4023,6,6554,247.952.381
20/03/2019 02:00,38.15,44657,2517,92,99,4247,10,6965,247.952.381
20/03/2019 03:00,38.04,44773,2643,83,105,4408,11,7250,247.952.381
20/03/2019 04:00,38.57,45399,2773,74,112,4509,12,7480,247.952.381
20/03/2019 05:00,40.88,47372,2870,63,118,4557,12,7620,247.952.381
20/03/2019 06:00,42.57,50894,2825,53,125,4494,11,7508,247.952.381
20/03/2019 07:00,44.12,54007,2658,44,137,4458,13,7310,247.952.381
20/03/2019 08:00,43.86,54492,2505,38,150,4285,13,6991,247.952.381
20/03/2019 09:00,42.92,53835,2291,34,184,4134,19,6662,247.952.381
20/03/2019 10:00,42.14,53347,2141,32,223,3910,35,6341,247.952.381
20/03/2019 11:00,41.55,52696,2113,31,274,3888,37,6343,247.952.381
20/03/2019 12:00,41.05,51929,2124,32,316,3856,45,6373,247.952.381
20/03/2019 13:00,40.82,51327,2153,36,348,3896,49,6482,247.952.381
20/03/2019 14:00,40.89,50878,2077,40,372,3886,50,6425,247.952.381
20/03/2019 15:00,41.31,50441,1977,42,384,3793,51,6247,247.952.381
20/03/2019 16:00,42.05,50521,1780,48,395,3874,52,6149,247.952.381
20/03/2019 17:00,43.6,51280,1577,61,401,3925,47,6011,247.952.381
20/03/2019 18:00,44.5,52095,1486,73,408,4016,46,6029,247.952.381
20/03/2019 19:00,43.75,52284,1455,77,390,4018,40,5980,247.952.381
20/03/2019 20:00,43.12,51016,1439,75,355,3872,26,5767,247.952.381
20/03/2019 21:00,42.63,49812,1405,70,315,3802,20,5612,247.952.381
20/03/2019 22:00,41.64,47968,1421,63,263,3684,14,5445,247.952.381
20/03/2019 23:00,40.22,45877,1492,55,217,3534,12,5310,247.952.381
21/03/2019 00:00,38.06,44356,1691,56,174,3382,11,5314,247.952.381
21/03/2019 01:00,37.01,43668,1878,57,138,3298,10,5381,247.952.381
21/03/2019 02:00,36.49,43459,2022,61,122,3280,7,5492,247.952.381
21/03/2019 03:00,36.26,43590,2243,58,107,3276,6,5690,247.952.381
21/03/2019 04:00,35.78,44340,2432,52,98,3425,6,6013,247.952.381
21/03/2019 05:00,38.97,46342,2613,51,96,3708,6,6474,247.952.381
21/03/2019 06:00,41.12,49864,2728,57,101,3976,7,6869,247.952.381
21/03/2019 07:00,42.9,53038,2699,67,114,4216,10,7106,247.952.381
21/03/2019 08:00,43.61,53456,2797,79,134,4379,9,7398,247.952.381
21/03/2019 09:00,41.57,52806,2818,98,159,4494,10,7579,247.952.381
21/03/2019 10:00,40.14,52411,2799,126,191,4594,13,7723,247.952.381
21/03/2019 11:00,39.47,51878,2863,157,210,4712,20,7962,247.952.381
21/03/2019 12:00,39.23,51091,2990,181,232,4861,19,8283,247.952.381
21/03/2019 13:00,38.94,50708,2967,193,256,4933,21,8370,247.952.381
21/03/2019 14:00,38.87,50188,2769,192,280,4993,30,8264,247.952.381
21/03/2019 15:00,38.84,49699,2503,188,311,5041,31,8074,247.952.381
21/03/2019 16:00,39.8,49860,2209,180,337,5137,40,7903,247.952.381
21/03/2019 17:00,41.15,50834,1960,167,355,5200,38,7720,247.952.381
21/03/2019 18:00,41.96,51553,1778,152,367,5139,47,7483,247.952.381
21/03/2019 19:00,41.69,51292,1671,145,368,5082,49,7315,247.952.381
21/03/2019 20:00,40.96,50016,1555,142,358,4916,44,7015,247.952.381
21/03/2019 21:00,40.7,48561,1436,141,349,4704,41,6671,247.952.381
21/03/2019 22:00,40.06,46732,1310,141,335,4417,33,6236,247.952.381
21/03/2019 23:00,39.09,44797,1090,137,311,4056,26,5620,247.952.381
22/03/2019 00:00,38.1,43678,571,107,338,3735,34,4785,247.952.381
22/03/2019 01:00,37.06,42935,368,103,300,3401,30,4202,247.952.381
22/03/2019 02:00,37.02,42739,254,101,244,3049,26,3674,247.952.381
22/03/2019 03:00,37.09,43077,176,97,197,2652,30,3152,247.952.381
22/03/2019 04:00,38.15,44045,138,90,168,2289,31,2716,247.952.381
22/03/2019 05:00,40.4,46529,157,79,153,2041,32,2462,247.952.381
22/03/2019 06:00,42.93,50658,219,65,144,1908,29,2365,247.952.381
22/03/2019 07:00,49.95,54300,280,49,133,1730,26,2218,247.952.381
22/03/2019 08:00,48.32,55012,348,40,121,1546,28,2083,247.952.381
22/03/2019 09:00,44.15,54300,429,42,107,1346,27,1951,247.952.381
22/03/2019 10:00,41.64,53728,563,52,102,1237,26,1980,247.952.381
22/03/2019 11:00,40.56,52627,767,67,101,1538,20,2493,247.952.381
22/03/2019 12:00,40.06,51577,1021,76,102,1978,12,3189,247.952.381
22/03/2019 13:00,39.41,50641,1211,85,102,2470,12,3880,247.952.381
22/03/2019 14:00,38.62,49843,1349,94,100,2990,10,4543,247.952.381
22/03/2019 15:00,38.45,49242,1549,94,91,3545,6,5285,247.952.381
22/03/2019 16:00,39.17,49180,1663,93,79,4021,5,5861,247.952.381
22/03/2019 17:00,41.29,50320,1757,94,67,4391,3,6312,247.952.381
22/03/2019 18:00,41.64,51480,1866,96,50,4714,3,6729,247.952.381
22/03/2019 19:00,40.67,50947,1958,97,39,4962,3,7059,247.952.381
22/03/2019 20:00,39.85,49149,2031,101,35,5101,2,7270,247.952.381
22/03/2019 21:00,38.97,47654,2137,109,32,5219,3,7500,247.952.381
22/03/2019 22:00,38.15,45707,2268,134,35,5302,6,7745,247.952.381
22/03/2019 23:00,36.33,43680,2333,157,49,5326,7,7872,247.952.381
23/03/2019 00:00,36.1,42044,2059,97,31,5318,13,7518,247.952.381
23/03/2019 01:00,35.45,41350,2006,89,57,5310,16,7478,247.952.381
23/03/2019 02:00,34.54,40962,1903,80,89,5252,16,7340,247.952.381
23/03/2019 03:00,34.45,40809,1818,70,126,5150,17,7181,247.952.381
23/03/2019 04:00,34.65,41057,1718,62,153,5014,23,6970,247.952.381
23/03/2019 05:00,35.03,41818,1647,57,173,4841,27,6745,247.952.381
23/03/2019 06:00,35.67,42733,1619,51,194,4717,29,6610,247.952.381
23/03/2019 07:00,37.26,44075,1652,46,194,4626,25,6543,247.952.381
23/03/2019 08:00,37.74,45788,1795,42,173,4646,26,6682,247.952.381
23/03/2019 09:00,37.77,46958,2003,39,160,4748,27,6977,247.952.381
23/03/2019 10:00,36.59,47215,2241,36,168,4987,29,7461,247.952.381
23/03/2019 11:00,35.47,46784,2479,33,198,5306,29,8045,247.952.381
23/03/2019 12:00,35.02,46133,2721,30,225,5446,29,8451,247.952.381
23/03/2019 13:00,34.71,45612,2923,27,239,5670,35,8894,247.952.381
23/03/2019 14:00,34.5,45296,3048,24,235,5824,42,9173,247.952.381
23/03/2019 15:00,34.61,45614,3056,21,234,5905,42,9258,247.952.381
23/03/2019 16:00,35.16,46462,2883,20,230,5940,28,9101,247.952.381
23/03/2019 17:00,37.29,48161,2586,21,222,5960,19,8808,247.952.381
23/03/2019 18:00,39.14,49862,2255,23,221,5960,20,8479,247.952.381
23/03/2019 19:00,39.08,49869,2107,24,225,5933,23,8312,247.952.381
23/03/2019 20:00,38.19,48250,2059,24,233,5982,29,8327,247.952.381
23/03/2019 21:00,36.83,46871,2004,23,247,5930,38,8242,247.952.381
23/03/2019 22:00,36.59,45390,1928,22,262,5936,36,8184,247.952.381
23/03/2019 23:00,36,43842,1784,20,267,5872,46,7989,247.952.381
24/03/2019 00:00,36.35,42430,1626,23,268,5730,47,7694,247.952.381
24/03/2019 01:00,34.85,41884,1496,22,272,5594,50,7434,247.952.381
24/03/2019 02:00,34.82,41674,1318,20,269,5445,44,7096,247.952.381
24/03/2019 03:00,34.96,41717,1170,19,264,5302,43,6798,247.952.381
24/03/2019 04:00,35.19,41883,1096,20,256,5162,39,6573,247.952.381
24/03/2019 05:00,35.52,42350,1074,22,236,5007,36,6375,247.952.381
24/03/2019 06:00,35.44,42802,1049,26,216,4906,31,6228,247.952.381
24/03/2019 07:00,36.02,43825,1095,34,197,4753,27,6106,247.952.381
24/03/2019 08:00,36.77,45214,1260,48,188,4709,28,6233,247.952.381
24/03/2019 09:00,36.57,46124,1506,70,174,4669,28,6447,247.952.381
24/03/2019 10:00,36.17,46509,1837,94,162,4689,23,6805,247.952.381
24/03/2019 11:00,35.72,46230,2110,114,158,4742,23,7147,247.952.381
24/03/2019 12:00,35.55,45683,2358,132,160,4739,20,7409,247.952.381
24/03/2019 13:00,34.99,45415,2553,149,162,4716,18,7598,247.952.381
24/03/2019 14:00,34.68,45441,2781,166,157,4605,15,7724,247.952.381
24/03/2019 15:00,35.18,45744,2894,184,147,4452,17,7694,247.952.381
24/03/2019 16:00,35.78,46654,2913,202,142,4273,19,7549,247.952.381
24/03/2019 17:00,36.65,48082,3071,217,144,3972,25,7429,247.952.381
24/03/2019 18:00,39.22,49628,3082,226,149,3703,21,7181,247.952.381
24/03/2019 19:00,40.46,50094,3159,230,158,3612,17,7176,247.952.381
24/03/2019 20:00,39.26,49239,3308,230,169,3542,19,7268,247.952.381
24/03/2019 21:00,37.8,48133,3357,228,181,3445,18,7229,247.952.381
24/03/2019 22:00,37.3,46696,3265,223,186,3229,14,6917,247.952.381
24/03/2019 23:00,37.04,44842,3264,214,185,3057,14,6734,247.952.381
25/03/2019 00:00,36.08,43495,2662,228,162,2885,19,5956,241.452.381
25/03/2019 01:00,35.71,42834,2583,241,156,2787,16,5783,241.452.381
25/03/2019 02:00,35.46,42854,2451,246,141,2748,11,5597,241.452.381
25/03/2019 03:00,35.65,43240,2314,245,127,2751,6,5443,241.452.381
25/03/2019 04:00,36.23,44280,2290,243,116,2775,5,5429,241.452.381
25/03/2019 05:00,38.15,46495,2329,242,106,2723,8,5408,241.452.381
25/03/2019 06:00,39.68,50306,2389,239,100,2711,7,5446,241.452.381
25/03/2019 07:00,40.98,53555,2377,234,86,2658,5,5360,241.452.381
25/03/2019 08:00,41.85,54180,2418,231,78,2583,4,5314,241.452.381
25/03/2019 09:00,40.96,53523,2513,229,69,2539,4,5354,241.452.381
25/03/2019 10:00,40.53,52974,2519,218,65,2462,4,5268,241.452.381
25/03/2019 11:00,40.3,52273,2443,205,64,2455,5,5172,241.452.381
25/03/2019 12:00,39.88,51482,2455,191,65,2487,7,5205,241.452.381
25/03/2019 13:00,39.62,50862,2475,174,69,2374,10,5102,241.452.381
25/03/2019 14:00,39.24,50663,2391,155,76,2278,15,4915,241.452.381
25/03/2019 15:00,39.17,50371,2255,137,86,2132,11,4621,241.452.381
25/03/2019 16:00,39.35,50282,2066,122,97,1950,12,4247,241.452.381
25/03/2019 17:00,40.14,51279,1714,108,105,1896,13,3836,241.452.381
25/03/2019 18:00,41.44,52493,1360,92,117,1955,15,3539,241.452.381
25/03/2019 19:00,43.09,52922,1330,72,130,1967,14,3513,241.452.381
25/03/2019 20:00,41.8,51908,1444,56,150,2262,14,3926,241.452.381
25/03/2019 21:00,40.29,50520,1603,46,168,2503,13,4333,241.452.381
25/03/2019 22:00,40.18,48687,1852,37,174,2733,11,4807,241.452.381
25/03/2019 23:00,38.55,46475,2151,38,165,2941,8,5303,241.452.381
26/03/2019 00:00,37.22,44457,2820,108,140,3277,16,6361,241.452.381
26/03/2019 01:00,36.96,43861,3053,94,135,3511,13,6806,241.452.381
26/03/2019 02:00,36.93,43661,3237,83,139,3773,13,7245,241.452.381
26/03/2019 03:00,37.01,43972,3301,73,146,3972,13,7505,241.452.381
26/03/2019 04:00,36.89,44866,3391,63,149,4043,14,7660,241.452.381
26/03/2019 05:00,37.75,47088,3478,53,152,3891,15,7589,241.452.381
26/03/2019 06:00,39.78,50716,3413,45,159,3705,14,7336,241.452.381
26/03/2019 07:00,42.13,53803,3325,38,158,3460,17,6998,241.452.381
26/03/2019 08:00,41.93,54069,3252,33,152,2987,10,6434,241.452.381
26/03/2019 09:00,40.58,53068,3118,29,151,2674,8,5980,241.452.381
26/03/2019 10:00,40.61,52464,2853,26,138,2354,5,5376,241.452.381
26/03/2019 11:00,40.3,51837,2343,27,114,1971,6,4461,241.452.381
26/03/2019 12:00,40.13,51162,1859,36,95,1636,8,3634,241.452.381
26/03/2019 13:00,40.16,50664,1548,44,100,1311,10,3013,241.452.381
26/03/2019 14:00,40.09,50413,1356,57,135,1070,19,2637,241.452.381
26/03/2019 15:00,40.19,50245,1252,68,164,870,24,2378,241.452.381
26/03/2019 16:00,40.28,50506,1181,82,178,732,28,2201,241.452.381
26/03/2019 17:00,41.17,51452,1107,96,187,668,29,2087,241.452.381
26/03/2019 18:00,44.19,52313,1050,106,195,701,24,2076,241.452.381
26/03/2019 19:00,45.83,52499,1156,112,197,811,20,2296,241.452.381
26/03/2019 20:00,43.43,51729,1341,113,186,1057,14,2711,241.452.381
26/03/2019 21:00,42,50439,1577,110,171,1387,11,3256,241.452.381
26/03/2019 22:00,40.93,48417,1828,104,153,1781,8,3874,241.452.381
26/03/2019 23:00,39.22,46059,2095,91,136,2071,9,4402,241.452.381
27/03/2019 00:00,37.89,44047,2002,91,127,2473,10,4703,241.452.381
27/03/2019 01:00,37.17,43320,2089,78,105,2606,11,4889,241.452.381
27/03/2019 02:00,37.04,43086,2172,67,87,2650,12,4988,241.452.381
27/03/2019 03:00,37.01,43182,2187,55,70,2755,12,5079,241.452.381
27/03/2019 04:00,36.91,43906,2151,46,56,2859,10,5122,241.452.381
27/03/2019 05:00,38.67,45975,2203,41,42,2879,8,5173,241.452.381
27/03/2019 06:00,40.57,49585,2233,41,31,2916,5,5226,241.452.381
27/03/2019 07:00,43.59,52970,2243,43,25,2809,4,5124,241.452.381
27/03/2019 08:00,45.25,53266,2285,47,20,2635,3,4990,241.452.381
27/03/2019 09:00,42.9,52660,2293,53,20,2458,3,4827,241.452.381
27/03/2019 10:00,41.42,51951,2182,63,23,2317,3,4588,241.452.381
27/03/2019 11:00,40.58,51236,2050,75,31,2345,3,4504,241.452.381
27/03/2019 12:00,39.97,50447,1952,91,37,2309,3,4392,241.452.381
27/03/2019 13:00,39.54,49922,1905,106,39,2216,4,4270,241.452.381
27/03/2019 14:00,39.19,49312,1884,116,38,2084,5,4127,241.452.381
27/03/2019 15:00,39.45,48917,1856,121,37,1946,6,3966,241.452.381
27/03/2019 16:00,39.66,48967,1830,117,31,1798,6,3782,241.452.381
27/03/2019 17:00,40.67,49714,1823,112,25,1706,4,3670,241.452.381
27/03/2019 18:00,42.1,50503,1759,106,19,1666,5,3555,241.452.381
27/03/2019 19:00,42.9,50757,1762,98,17,1629,5,3511,241.452.381
27/03/2019 20:00,41.07,49808,1773,90,17,1613,5,3498,241.452.381
27/03/2019 21:00,40.35,48410,1695,84,19,1656,6,3460,241.452.381
27/03/2019 22:00,40.03,46486,1525,78,21,1748,4,3376,241.452.381
27/03/2019 23:00,37.86,44236,1365,69,25,1881,4,3344,241.452.381
28/03/2019 00:00,36.29,42341,1697,47,10,1874,3,3631,241.452.381
28/03/2019 01:00,36.47,41506,1615,40,9,2158,3,3825,241.452.381
28/03/2019 02:00,36.41,41242,1521,34,8,2511,3,4077,241.452.381
28/03/2019 03:00,36.26,41458,1461,29,6,2982,3,4481,241.452.381
28/03/2019 04:00,36.32,42278,1428,23,6,3238,3,4698,241.452.381
28/03/2019 05:00,37.52,44469,1398,16,6,3411,3,4834,241.452.381
28/03/2019 06:00,39.87,48344,1342,11,5,3544,3,4905,241.452.381
28/03/2019 07:00,41.39,51721,1299,7,3,3519,3,4831,241.452.381
28/03/2019 08:00,41.81,52001,1286,6,3,3263,3,4561,241.452.381
28/03/2019 09:00,41.06,51025,1263,6,4,3048,3,4324,241.452.381
28/03/2019 10:00,40.8,50279,1233,7,7,2999,3,4249,241.452.381
28/03/2019 11:00,40.47,49363,1281,10,11,3172,5,4479,241.452.381
28/03/2019 12:00,39.94,48420,1351,12,18,3311,7,4699,241.452.381
28/03/2019 13:00,39.66,47927,1394,14,30,3475,9,4922,241.452.381
28/03/2019 14:00,39.29,47540,1389,16,41,3650,13,5109,241.452.381
28/03/2019 15:00,39.1,47060,1376,17,51,3872,16,5332,241.452.381
28/03/2019 16:00,39.29,47006,1369,19,61,4111,17,5577,241.452.381
28/03/2019 17:00,39.44,47871,1340,25,73,4467,20,5925,241.452.381
28/03/2019 18:00,39.83,48671,1275,34,84,4752,20,6165,241.452.381
28/03/2019 19:00,39.54,48847,1305,41,100,5012,21,6479,241.452.381
28/03/2019 20:00,38.95,48017,1395,47,123,5155,24,6744,241.452.381
28/03/2019 21:00,38.87,46522,1501,52,148,5248,23,6972,241.452.381
28/03/2019 22:00,37.76,44577,1602,55,172,5365,18,7212,241.452.381
28/03/2019 23:00,36.47,42418,1709,53,189,5426,18,7395,241.452.381
29/03/2019 00:00,34.33,40853,1980,44,0,5601,21,7646,241.452.381
29/03/2019 01:00,31.75,40061,2074,45,0,5661,18,7798,241.452.381
29/03/2019 02:00,31.84,39903,2173,45,0,5662,17,7897,241.452.381
29/03/2019 03:00,31.94,40196,2258,43,0,5692,15,8008,241.452.381
29/03/2019 04:00,32.81,41102,2391,39,0,5704,20,8154,241.452.381
29/03/2019 05:00,36.79,43199,2605,34,0,5740,20,8399,241.452.381
29/03/2019 06:00,38.87,47022,2684,30,0,5744,24,8482,241.452.381
29/03/2019 07:00,39.92,50222,2777,26,0,5745,28,8576,241.452.381
29/03/2019 08:00,39.93,50861,2892,25,0,5656,25,8598,241.452.381
29/03/2019 09:00,39.48,50209,2962,26,0,5639,34,8661,241.452.381
29/03/2019 10:00,38.1,49736,3005,34,0,5712,36,8787,241.452.381
29/03/2019 11:00,36.5,48871,3091,47,0,5770,40,8948,241.452.381
29/03/2019 12:00,35.2,47855,3188,69,0,5732,42,9031,241.452.381
29/03/2019 13:00,34.75,46889,3203,82,0,5642,39,8966,241.452.381
29/03/2019 14:00,34.64,46277,3127,94,0,5587,35,8843,241.452.381
29/03/2019 15:00,34.72,45727,2899,107,0,5354,27,8387,241.452.381
29/03/2019 16:00,35.71,45639,2631,122,0,5225,23,8001,241.452.381
29/03/2019 17:00,37.58,46459,2392,142,0,5163,19,7716,241.452.381
29/03/2019 18:00,38.96,47702,2215,159,0,4981,21,7376,241.452.381
29/03/2019 19:00,38.41,47647,2235,161,0,4940,28,7364,241.452.381
29/03/2019 20:00,37.62,46481,2241,157,0,4945,35,7378,241.452.381
29/03/2019 21:00,37.3,45178,2181,150,0,4954,36,7321,241.452.381
29/03/2019 22:00,36.17,43485,2080,138,0,4971,35,7224,241.452.381
29/03/2019 23:00,35.42,41655,1910,124,0,5054,36,7124,241.452.381
30/03/2019 00:00,36.09,40391,1490,59,336,5014,28,6927,241.452.381
30/03/2019 01:00,34.02,39827,1305,84,322,4998,35,6744,241.452.381
30/03/2019 02:00,33.07,39660,1103,106,306,4846,37,6398,241.452.381
30/03/2019 03:00,33.8,39771,979,136,294,4637,37,6083,241.452.381
30/03/2019 04:00,35.54,40097,951,170,280,4482,31,5914,241.452.381
30/03/2019 05:00,35.11,40788,1033,193,264,4272,26,5788,241.452.381
30/03/2019 06:00,35.33,41539,1145,210,253,4063,25,5696,241.452.381
30/03/2019 07:00,35.94,42940,1249,221,247,3830,17,5564,241.452.381
30/03/2019 08:00,36.34,44681,1386,227,246,3686,15,5560,241.452.381
30/03/2019 09:00,36.24,45683,1562,231,251,3617,17,5678,241.452.381
30/03/2019 10:00,36.09,45861,1686,234,256,3579,21,5776,241.452.381
30/03/2019 11:00,35.55,45566,1828,236,270,3700,22,6056,241.452.381
30/03/2019 12:00,33.93,45081,1992,234,278,3817,21,6342,241.452.381
30/03/2019 13:00,32.89,44730,2053,229,282,3866,20,6450,241.452.381
30/03/2019 14:00,32.44,44461,2098,218,277,3813,20,6426,241.452.381
30/03/2019 15:00,33.96,44720,2137,205,260,3798,20,6420,241.452.381
30/03/2019 16:00,35.69,45334,2185,193,254,3700,18,6350,241.452.381
30/03/2019 17:00,37.01,46371,2278,186,255,3735,24,6478,241.452.381
30/03/2019 18:00,38.61,47639,2302,187,254,3754,29,6526,241.452.381
30/03/2019 19:00,38.61,47731,2368,190,269,3709,38,6574,241.452.381
30/03/2019 20:00,37.75,46572,2431,191,282,3764,41,6709,241.452.381
30/03/2019 21:00,36.85,45323,2528,195,291,3898,45,6957,241.452.381
30/03/2019 22:00,35.82,43964,2645,204,302,4035,51,7237,241.452.381
30/03/2019 23:00,33.86,42668,2812,212,307,4171,50,7552,241.452.381
31/03/2019 00:00,35.26,40679,2894,221,319,4394,37,7865,241.452.381
31/03/2019 01:00,33.91,40010,3014,225,334,4601,37,8211,241.452.381
31/03/2019 02:00,34.12,40105,3086,224,340,4900,44,8594,241.452.381
31/03/2019 03:00,33.25,40384,3166,218,343,5053,43,8823,241.452.381
31/03/2019 04:00,33.34,40871,3262,212,342,5106,42,8964,241.452.381
31/03/2019 05:00,33.48,41488,3342,205,341,5078,43,9009,241.452.381
31/03/2019 06:00,34.77,42599,3338,199,338,4987,43,8905,241.452.381
31/03/2019 07:00,35.32,44150,3273,195,345,4988,49,8850,241.452.381
31/03/2019 08:00,35.4,45477,3377,197,365,4945,51,8935,241.452.381
31/03/2019 09:00,35.09,46101,3378,202,390,4870,50,8890,241.452.381
31/03/2019 10:00,34.95,45942,3209,204,403,4841,47,8704,241.452.381
31/03/2019 11:00,35.05,45376,2884,207,412,4657,50,8210,241.452.381
31/03/2019 12:00,33.74,44967,2545,211,420,4527,47,7750,241.452.381
31/03/2019 13:00,32.56,44749,2357,205,419,4492,39,7512,241.452.381
31/03/2019 14:00,31.08,44688,2199,201,407,4464,36,7307,241.452.381
31/03/2019 15:00,32.13,45090,2061,190,391,4325,34,7001,241.452.381
31/03/2019 16:00,33.75,46143,1893,177,364,4134,41,6609,241.452.381
31/03/2019 17:00,36.48,47341,1582,170,325,3998,32,6107,241.452.381
31/03/2019 18:00,38.65,48104,1122,165,287,3855,21,5450,241.452.381
31/03/2019 19:00,39.35,48069,813,157,257,3727,12,4966,241.452.381
31/03/2019 20:00,38.64,47415,654,148,221,3567,10,4600,241.452.381
31/03/2019 21:00,38.36,46053,538,136,189,3484,10,4357,241.452.381
31/03/2019 22:00,37.36,44364,398,120,168,3449,21,4156,241.452.381
31/03/2019 23:00,36.51,42992,341,101,133,3225,21,3821,241.452.381
01/04/2019 00:00,36,42492,234,139,136,2983,25,3517,2.295.357.143
01/04/2019 01:00,36.26,42563,150,137,137,2686,25,3135,2.295.357.143
01/04/2019 02:00,36.18,42971,88,136,136,2462,25,2847,2.295.357.143
01/04/2019 03:00,35.3,43821,52,143,134,2263,24,2616,2.295.357.143
01/04/2019 04:00,38.31,46134,45,153,125,2081,19,2423,2.295.357.143
01/04/2019 05:00,41.69,49987,51,164,109,2009,17,2350,2.295.357.143
01/04/2019 06:00,45.16,53464,64,176,94,1960,16,2310,2.295.357.143
01/04/2019 07:00,49.05,54254,82,179,76,1948,11,2296,2.295.357.143
01/04/2019 08:00,44.64,53590,115,181,68,2083,10,2457,2.295.357.143
01/04/2019 09:00,41.69,52695,182,182,70,2147,10,2591,2.295.357.143
01/04/2019 10:00,40.13,51717,260,185,79,2382,8,2914,2.295.357.143
01/04/2019 11:00,39.25,50731,300,189,76,2513,8,3086,2.295.357.143
01/04/2019 12:00,38.95,49969,344,190,72,2692,8,3306,2.295.357.143
01/04/2019 13:00,37.5,49478,416,189,70,2729,7,3411,2.295.357.143
01/04/2019 14:00,37.23,48951,492,183,71,2729,6,3481,2.295.357.143
01/04/2019 15:00,37.77,48772,560,177,73,2642,6,3458,2.295.357.143
01/04/2019 16:00,38.4,49364,657,173,72,2545,5,3452,2.295.357.143
01/04/2019 17:00,40.56,49992,791,175,67,2495,3,3531,2.295.357.143
01/04/2019 18:00,41.29,50253,970,179,65,2550,3,3767,2.295.357.143
01/04/2019 19:00,40.92,50022,1140,180,60,2666,2,4048,2.295.357.143
01/04/2019 20:00,39.38,49194,1536,177,44,2731,2,4490,2.295.357.143
01/04/2019 21:00,37.45,47526,1825,175,33,2848,2,4883,2.295.357.143
01/04/2019 22:00,36.56,45317,2020,170,30,2959,2,5181,2.295.357.143
01/04/2019 23:00,34.96,43612,2191,175,0,3066,8,5440,2.295.357.143
02/04/2019 00:00,34.36,42949,2228,169,0,3152,10,5559,2.295.357.143
02/04/2019 01:00,33.83,42667,2366,160,0,3222,10,5758,2.295.357.143
02/04/2019 02:00,33.81,42966,2432,150,0,3285,11,5878,2.295.357.143
02/04/2019 03:00,33.27,43892,2460,140,0,3391,11,6002,2.295.357.143
02/04/2019 04:00,35.27,46042,2614,127,0,3331,11,6083,2.295.357.143
02/04/2019 05:00,39.67,49961,2841,112,0,3298,11,6262,2.295.357.143
02/04/2019 06:00,42.3,53355,2934,100,0,3239,12,6285,2.295.357.143
02/04/2019 07:00,42.35,53740,2955,88,0,3042,10,6095,2.295.357.143
02/04/2019 08:00,40.53,52713,3025,79,0,2944,7,6055,2.295.357.143
02/04/2019 09:00,39.23,51710,3137,79,0,2907,7,6130,2.295.357.143
02/04/2019 10:00,38.51,50634,3241,83,0,3035,8,6367,2.295.357.143
02/04/2019 11:00,37.98,49590,3326,89,0,3329,14,6758,2.295.357.143
02/04/2019 12:00,37.7,48808,3445,94,0,3516,13,7068,2.295.357.143
02/04/2019 13:00,36.71,48355,3605,97,0,3571,15,7288,2.295.357.143
02/04/2019 14:00,36.57,48069,3718,92,0,3646,19,7475,2.295.357.143
02/04/2019 15:00,36.51,48041,3737,86,0,3646,21,7490,2.295.357.143
02/04/2019 16:00,37,48754,3701,80,0,3622,19,7422,2.295.357.143
02/04/2019 17:00,38.98,49427,3659,77,0,3694,21,7451,2.295.357.143
02/04/2019 18:00,39.54,49739,3545,72,0,3781,21,7419,2.295.357.143
02/04/2019 19:00,39,49768,3545,66,0,3868,28,7507,2.295.357.143
02/04/2019 20:00,37.79,48984,3541,62,0,3889,35,7527,2.295.357.143
02/04/2019 21:00,36.17,47010,3490,61,0,3878,36,7465,2.295.357.143
02/04/2019 22:00,34.89,44659,3330,61,0,3847,36,7274,2.295.357.143
02/04/2019 23:00,35.72,42588,3052,85,374,3780,34,7325,2.295.357.143
03/04/2019 00:00,35.69,41849,2806,91,376,3666,34,6973,2.295.357.143
03/04/2019 01:00,35.61,41535,2589,91,382,3595,33,6690,2.295.357.143
03/04/2019 02:00,35.52,41619,2396,88,387,3542,34,6447,2.295.357.143
03/04/2019 03:00,35.42,42341,2188,82,390,3443,34,6137,2.295.357.143
03/04/2019 04:00,36.83,44229,2010,77,398,3339,35,5859,2.295.357.143
03/04/2019 05:00,40.92,48088,1887,73,401,2915,35,5311,2.295.357.143
03/04/2019 06:00,44.09,51768,1662,63,404,2716,38,4883,2.295.357.143
03/04/2019 07:00,47.56,52326,1431,53,409,2455,39,4387,2.295.357.143
03/04/2019 08:00,45.99,51786,1195,44,423,2214,39,3915,2.295.357.143
03/04/2019 09:00,45.29,51087,1029,39,436,1858,43,3405,2.295.357.143
03/04/2019 10:00,44.04,50233,900,40,446,1760,45,3191,2.295.357.143
03/04/2019 11:00,42.4,49594,760,41,448,1826,46,3121,2.295.357.143
03/04/2019 12:00,41.74,49198,663,40,443,1947,46,3139,2.295.357.143
03/04/2019 13:00,40.77,48799,630,37,441,2071,46,3225,2.295.357.143
03/04/2019 14:00,40.48,48489,628,36,437,2130,45,3276,2.295.357.143
03/04/2019 15:00,40.73,48357,630,38,430,2126,43,3267,2.295.357.143
03/04/2019 16:00,41.09,48882,622,44,418,2214,37,3335,2.295.357.143
03/04/2019 17:00,41.31,49276,694,55,410,2402,36,3597,2.295.357.143
03/04/2019 18:00,41.99,49253,784,72,404,2755,29,4044,2.295.357.143
03/04/2019 19:00,41.32,48605,807,89,402,2994,31,4323,2.295.357.143
03/04/2019 20:00,40.23,47381,809,103,399,3027,35,4373,2.295.357.143
03/04/2019 21:00,38.49,45289,830,112,398,3058,37,4435,2.295.357.143
03/04/2019 22:00,37.21,42924,843,114,394,2991,35,4377,2.295.357.143
03/04/2019 23:00,36.38,41150,1383,117,378,2788,33,4699,2.295.357.143
04/04/2019 00:00,36.23,40354,1364,124,385,2613,31,4517,2.295.357.143
04/04/2019 01:00,36.27,40162,1432,128,384,2449,33,4426,2.295.357.143
04/04/2019 02:00,36.12,40370,1543,128,382,2407,33,4493,2.295.357.143
04/04/2019 03:00,36.06,41161,1697,128,376,2387,33,4621,2.295.357.143
04/04/2019 04:00,37.81,43174,1911,127,378,2404,32,4852,2.295.357.143
04/04/2019 05:00,40.68,47005,2150,126,377,2299,31,4983,2.295.357.143
04/04/2019 06:00,44.51,50405,2170,118,374,2192,29,4883,2.295.357.143
04/04/2019 07:00,45.91,50887,2126,108,377,2101,29,4741,2.295.357.143
04/04/2019 08:00,43.97,50328,2024,105,386,1946,29,4490,2.295.357.143
04/04/2019 09:00,42.55,49804,1972,108,404,1817,30,4331,2.295.357.143
04/04/2019 10:00,41.51,49070,1999,120,420,1805,38,4382,2.295.357.143
04/04/2019 11:00,40.75,48119,2045,134,423,1883,39,4524,2.295.357.143
04/04/2019 12:00,40.34,47443,2111,143,417,1853,39,4563,2.295.357.143
04/04/2019 13:00,38.73,46936,2257,140,407,1890,38,4732,2.295.357.143
04/04/2019 14:00,38.37,46533,2375,129,391,1950,36,4881,2.295.357.143
04/04/2019 15:00,39.04,46267,2423,120,376,1962,33,4914,2.295.357.143
04/04/2019 16:00,39.86,46904,2389,117,356,2011,26,4899,2.295.357.143
04/04/2019 17:00,40.79,47552,2221,120,344,2181,23,4889,2.295.357.143
04/04/2019 18:00,40.98,47773,2064,129,336,2578,20,5127,2.295.357.143
04/04/2019 19:00,40.44,47394,2091,138,332,2792,26,5379,2.295.357.143
04/04/2019 20:00,39.67,46368,2158,147,331,2878,26,5540,2.295.357.143
04/04/2019 21:00,38.34,44570,2206,153,329,2998,27,5713,2.295.357.143
04/04/2019 22:00,36.7,42481,2165,151,323,3013,27,5679,2.295.357.143
04/04/2019 23:00,36.13,40310,1748,147,316,2939,25,5175,2.295.357.143
05/04/2019 00:00,36.18,39615,1569,141,308,2899,22,4939,2.295.357.143
05/04/2019 01:00,35.96,39425,1456,134,299,2894,22,4805,2.295.357.143
05/04/2019 02:00,35.73,39702,1366,129,299,2988,22,4804,2.295.357.143
05/04/2019 03:00,37.23,40510,1317,126,296,3006,22,4767,2.295.357.143
05/04/2019 04:00,39.15,42653,1403,124,292,3099,22,4940,2.295.357.143
05/04/2019 05:00,41.11,46384,1561,118,281,3108,22,5090,2.295.357.143
05/04/2019 06:00,43.85,49507,1642,105,264,3048,22,5081,2.295.357.143
05/04/2019 07:00,46.45,50203,1621,93,246,2840,15,4815,2.295.357.143
05/04/2019 08:00,44.97,49515,1679,87,242,2610,11,4629,2.295.357.143
05/04/2019 09:00,43.04,48870,1802,87,242,2496,11,4638,2.295.357.143
05/04/2019 10:00,41.46,49086,2010,95,259,2464,10,4838,2.295.357.143
05/04/2019 11:00,40.94,47992,2259,108,281,2461,12,5121,2.295.357.143
05/04/2019 12:00,40.25,47196,2407,113,290,2417,18,5245,2.295.357.143
05/04/2019 13:00,39.06,46440,2584,106,286,2416,18,5410,2.295.357.143
05/04/2019 14:00,38.79,45943,2679,90,278,2436,17,5500,2.295.357.143
05/04/2019 15:00,39.26,45787,2724,74,269,2479,17,5563,2.295.357.143
05/04/2019 16:00,40.11,46446,2723,63,263,2530,14,5593,2.295.357.143
05/04/2019 17:00,40.8,47074,2652,59,261,2644,12,5628,2.295.357.143
05/04/2019 18:00,40.82,47038,2554,60,269,2782,14,5679,2.295.357.143
05/04/2019 19:00,40.16,46487,2589,67,290,2913,19,5878,2.295.357.143
05/04/2019 20:00,40.43,45535,2692,74,303,2890,25,5984,2.295.357.143
05/04/2019 21:00,39.45,43956,2721,83,312,2814,29,5959,2.295.357.143
05/04/2019 22:00,39,42128,2598,85,310,2701,31,5725,2.295.357.143
05/04/2019 23:00,39.71,39319,2090,210,336,2339,27,5002,2.295.357.143
06/04/2019 00:00,39.16,38592,1852,165,331,2156,29,4533,2.295.357.143
06/04/2019 01:00,38.21,38323,1671,159,321,2060,26,4237,2.295.357.143
06/04/2019 02:00,37.76,38449,1452,156,311,2013,26,3958,2.295.357.143
06/04/2019 03:00,37.75,38897,1294,155,301,2047,27,3824,2.295.357.143
06/04/2019 04:00,37.91,39563,1245,150,289,2075,26,3785,2.295.357.143
06/04/2019 05:00,39.09,40486,1267,138,276,2031,26,3738,2.295.357.143
06/04/2019 06:00,39.92,42056,1252,124,261,2003,22,3662,2.295.357.143
06/04/2019 07:00,40.9,43859,1162,107,236,1903,20,3428,2.295.357.143
06/04/2019 08:00,41.4,44905,1065,90,223,1726,14,3118,2.295.357.143
06/04/2019 09:00,41.13,44821,1023,77,216,1605,12,2933,2.295.357.143
06/04/2019 10:00,40.21,44074,1057,73,231,1567,15,2943,2.295.357.143
06/04/2019 11:00,38.79,43348,1145,72,251,1674,18,3160,2.295.357.143
06/04/2019 12:00,38.18,42544,1278,74,255,1772,22,3401,2.295.357.143
06/04/2019 13:00,37.8,42090,1381,78,246,1813,17,3535,2.295.357.143
06/04/2019 14:00,37.72,41976,1396,77,228,1684,14,3399,2.295.357.143
06/04/2019 15:00,38.06,42208,1378,74,210,1607,14,3283,2.295.357.143
06/04/2019 16:00,38.79,42985,1364,75,199,1526,9,3173,2.295.357.143
06/04/2019 17:00,40.27,43897,1348,83,196,1532,6,3165,2.295.357.143
06/04/2019 18:00,40.88,44050,1360,100,205,1543,10,3218,2.295.357.143
06/04/2019 19:00,41.04,43585,1444,118,219,1475,17,3273,2.295.357.143
06/04/2019 20:00,40.18,42818,1509,135,234,1329,18,3225,2.295.357.143
06/04/2019 21:00,39.57,41566,1445,146,244,1246,18,3099,2.295.357.143
06/04/2019 22:00,38.13,40289,1298,159,245,1169,18,2889,2.295.357.143
06/04/2019 23:00,39.39,39215,760,169,210,1088,18,2245,2.295.357.143
07/04/2019 00:00,38.98,38467,605,185,199,1058,15,2062,2.295.357.143
07/04/2019 01:00,38.63,38290,514,194,184,1047,15,1954,2.295.357.143
07/04/2019 02:00,38.6,38309,419,200,172,1117,13,1921,2.295.357.143
07/04/2019 03:00,38.81,38366,359,205,161,1310,14,2049,2.295.357.143
07/04/2019 04:00,38.85,38778,304,200,148,1458,12,2122,2.295.357.143
07/04/2019 05:00,38.6,39125,295,195,129,1500,12,2131,2.295.357.143
07/04/2019 06:00,39.46,40141,305,184,108,1561,10,2168,2.295.357.143
07/04/2019 07:00,40.52,41469,287,175,81,1555,7,2105,2.295.357.143
07/04/2019 08:00,40.66,42478,247,170,57,1606,4,2084,2.295.357.143
07/04/2019 09:00,39.66,42832,211,165,35,1717,4,2132,2.295.357.143
07/04/2019 10:00,39.54,42539,225,165,24,1808,3,2225,2.295.357.143
07/04/2019 11:00,39.2,41958,255,158,24,1938,3,2378,2.295.357.143
07/04/2019 12:00,38.88,41438,282,147,24,2033,3,2489,2.295.357.143
07/04/2019 13:00,38.57,41116,304,147,22,2172,3,2648,2.295.357.143
07/04/2019 14:00,38.36,40991,351,165,19,2329,3,2867,2.295.357.143
07/04/2019 15:00,38.33,41212,405,183,16,2486,3,3093,2.295.357.143
07/04/2019 16:00,38.74,41926,468,187,16,2608,3,3282,2.295.357.143
07/04/2019 17:00,40.97,42754,522,187,19,2761,3,3492,2.295.357.143
07/04/2019 18:00,42.26,43419,622,173,27,2944,3,3769,2.295.357.143
07/04/2019 19:00,42.42,43903,771,158,32,3200,3,4164,2.295.357.143
07/04/2019 20:00,41.91,43589,957,151,34,3306,4,4452,2.295.357.143
07/04/2019 21:00,41.24,42424,1044,145,39,3434,5,4667,2.295.357.143
07/04/2019 22:00,40.78,40771,1071,134,37,3506,5,4753,2.295.357.143
07/04/2019 23:00,38.96,39808,1191,86,30,3696,5,5008,2.295.357.143
08/04/2019 00:00,37.82,39340,1181,83,26,3747,4,5041,2.136.428.571
08/04/2019 01:00,37.09,39213,1221,79,24,3807,6,5137,2.136.428.571
08/04/2019 02:00,36.99,39525,1281,76,24,3850,6,5237,2.136.428.571
08/04/2019 03:00,37.53,40322,1419,72,25,3948,5,5469,2.136.428.571
08/04/2019 04:00,40.55,42503,1642,66,26,3983,5,5722,2.136.428.571
08/04/2019 05:00,42.52,46265,1877,59,27,3968,5,5936,2.136.428.571
08/04/2019 06:00,44.38,49820,1990,47,28,3910,4,5979,2.136.428.571
08/04/2019 07:00,44.79,50826,1974,32,23,3801,4,5834,2.136.428.571
08/04/2019 08:00,44.46,50381,1895,22,20,3816,4,5757,2.136.428.571
08/04/2019 09:00,44.12,49868,1799,19,21,3714,4,5557,2.136.428.571
08/04/2019 10:00,42.97,49294,1741,20,30,3693,6,5490,2.136.428.571
08/04/2019 11:00,42.34,48488,1648,26,45,3667,11,5397,2.136.428.571
08/04/2019 12:00,41.84,47969,1508,28,68,3609,14,5227,2.136.428.571
08/04/2019 13:00,40.41,47653,1418,24,88,3588,17,5135,2.136.428.571
08/04/2019 14:00,40.16,47229,1404,18,109,3587,15,5133,2.136.428.571
08/04/2019 15:00,40.7,47018,1435,15,133,3579,21,5183,2.136.428.571
08/04/2019 16:00,41.8,47350,1437,18,150,3535,26,5166,2.136.428.571
08/04/2019 17:00,43.08,47758,1334,28,155,3435,29,4981,2.136.428.571
08/04/2019 18:00,43.82,47866,1172,46,162,3340,31,4751,2.136.428.571
08/04/2019 19:00,43.22,47760,1061,64,163,3363,34,4685,2.136.428.571
08/04/2019 20:00,42.38,46964,1032,76,162,3405,34,4709,2.136.428.571
08/04/2019 21:00,41.07,45427,969,78,159,3472,31,4709,2.136.428.571
08/04/2019 22:00,38.92,43234,860,75,148,3546,31,4660,2.136.428.571
08/04/2019 23:00,38.59,41986,1067,50,102,3656,33,4908,2.136.428.571
09/04/2019 00:00,38.91,41311,1019,51,98,3732,33,4933,2.136.428.571
09/04/2019 01:00,38.99,41053,1122,49,96,3772,31,5070,2.136.428.571
09/04/2019 02:00,38.96,41382,1237,44,99,3891,30,5301,2.136.428.571
09/04/2019 03:00,38.94,42223,1239,34,99,3959,28,5359,2.136.428.571
09/04/2019 04:00,40.59,44322,1256,29,101,3960,29,5375,2.136.428.571
09/04/2019 05:00,44.06,48167,1323,28,104,3878,29,5362,2.136.428.571
09/04/2019 06:00,46.92,51715,1301,29,113,3861,30,5334,2.136.428.571
09/04/2019 07:00,50.07,52428,1221,31,128,3760,31,5171,2.136.428.571
09/04/2019 08:00,46.8,51809,1289,34,141,3653,32,5149,2.136.428.571
09/04/2019 09:00,45.52,51491,1261,36,152,3639,30,5118,2.136.428.571
09/04/2019 10:00,44.32,50775,1285,36,168,3541,29,5059,2.136.428.571
09/04/2019 11:00,43.05,50047,1245,38,190,3445,31,4949,2.136.428.571
09/04/2019 12:00,42.19,49557,1180,42,206,3438,33,4899,2.136.428.571
09/04/2019 13:00,40.85,49221,1210,43,215,3344,32,4844,2.136.428.571
09/04/2019 14:00,40.56,48975,1318,46,217,3365,26,4972,2.136.428.571
09/04/2019 15:00,41.3,48894,1453,50,219,3345,24,5091,2.136.428.571
09/04/2019 16:00,41.99,49249,1580,51,208,3367,22,5228,2.136.428.571
09/04/2019 17:00,43.44,49446,1537,51,178,3289,22,5077,2.136.428.571
09/04/2019 18:00,44.95,49484,1347,52,150,3189,22,4760,2.136.428.571
09/04/2019 19:00,44.37,49347,1163,56,131,3126,19,4495,2.136.428.571
09/04/2019 20:00,42.7,48456,1052,64,121,3142,16,4395,2.136.428.571
09/04/2019 21:00,42.07,46425,1022,70,111,3108,16,4327,2.136.428.571
09/04/2019 22:00,40.28,44188,979,72,103,3068,12,4234,2.136.428.571
09/04/2019 23:00,40.24,43543,841,71,106,3077,20,4115,2.136.428.571
10/04/2019 00:00,39.98,42687,802,69,103,3017,18,4009,2.136.428.571
10/04/2019 01:00,39.89,42335,826,66,100,2972,19,3983,2.136.428.571
10/04/2019 02:00,39.87,42434,948,61,97,2993,15,4114,2.136.428.571
10/04/2019 03:00,40.15,43412,986,55,92,3033,11,4177,2.136.428.571
10/04/2019 04:00,42.11,45733,1059,51,88,3061,11,4270,2.136.428.571
10/04/2019 05:00,44.39,49496,1155,47,77,3029,11,4319,2.136.428.571
10/04/2019 06:00,49.35,52836,1188,40,67,3010,10,4315,2.136.428.571
10/04/2019 07:00,55.73,53397,1232,35,59,2865,9,4200,2.136.428.571
10/04/2019 08:00,49.35,52992,1351,30,51,2654,10,4096,2.136.428.571
10/04/2019 09:00,46.11,52633,1444,27,44,2451,9,3975,2.136.428.571
10/04/2019 10:00,44.5,52153,1440,27,39,2361,8,3875,2.136.428.571
10/04/2019 11:00,43.89,51715,1296,28,42,2210,9,3585,2.136.428.571
10/04/2019 12:00,43.54,51415,1110,29,47,2002,9,3197,2.136.428.571
10/04/2019 13:00,42.42,51109,1026,31,53,1784,9,2903,2.136.428.571
10/04/2019 14:00,42.44,50730,988,34,60,1685,10,2777,2.136.428.571
10/04/2019 15:00,43.47,50471,1030,36,68,1525,10,2669,2.136.428.571
10/04/2019 16:00,44.01,50659,1087,39,71,1427,9,2633,2.136.428.571
10/04/2019 17:00,45.1,50727,1038,39,67,1388,8,2540,2.136.428.571
10/04/2019 18:00,46.02,50864,899,39,64,1320,7,2329,2.136.428.571
10/04/2019 19:00,45.81,50671,780,41,64,1301,6,2192,2.136.428.571
10/04/2019 20:00,44.26,49944,712,43,63,1343,5,2166,2.136.428.571
10/04/2019 21:00,43.6,48042,641,45,63,1380,5,2134,2.136.428.571
10/04/2019 22:00,42.01,45666,562,48,62,1459,3,2134,2.136.428.571
10/04/2019 23:00,42.6,43927,525,71,45,1365,4,2010,2.136.428.571
11/04/2019 00:00,42.19,43057,452,80,39,1334,3,1908,2.136.428.571
11/04/2019 01:00,42.07,42803,411,88,35,1307,3,1844,2.136.428.571
11/04/2019 02:00,42.17,42951,425,92,35,1279,3,1834,2.136.428.571
11/04/2019 03:00,42.54,43817,391,92,36,1249,3,1771,2.136.428.571
11/04/2019 04:00,43.9,45980,405,90,37,1210,3,1745,2.136.428.571
11/04/2019 05:00,47.88,49698,466,90,36,1133,4,1729,2.136.428.571
11/04/2019 06:00,56.05,52232,492,89,31,954,4,1570,2.136.428.571
11/04/2019 07:00,60.06,52639,481,85,28,818,3,1415,2.136.428.571
11/04/2019 08:00,51.2,52027,512,78,26,725,6,1347,2.136.428.571
11/04/2019 09:00,48.96,51622,538,69,25,573,7,1212,2.136.428.571
11/04/2019 10:00,47.58,51055,561,63,22,524,7,1177,2.136.428.571
11/04/2019 11:00,47.68,50191,542,60,22,521,5,1150,2.136.428.571
11/04/2019 12:00,47.59,49806,539,61,23,513,6,1142,2.136.428.571
11/04/2019 13:00,45.96,49540,531,60,31,493,10,1125,2.136.428.571
11/04/2019 14:00,45.28,49251,591,57,37,475,13,1173,2.136.428.571
11/04/2019 15:00,46.09,48923,671,56,49,475,17,1268,2.136.428.571
11/04/2019 16:00,46.3,49309,732,54,61,465,17,1329,2.136.428.571
11/04/2019 17:00,47.71,49504,707,51,68,492,17,1335,2.136.428.571
11/04/2019 18:00,50.18,49614,607,52,80,561,12,1312,2.136.428.571
11/04/2019 19:00,50.81,49773,546,53,89,621,12,1321,2.136.428.571
11/04/2019 20:00,47.96,49380,519,53,98,635,9,1314,2.136.428.571
11/04/2019 21:00,47.2,47749,513,51,111,705,9,1389,2.136.428.571
11/04/2019 22:00,45.1,45523,465,48,114,722,8,1357,2.136.428.571
11/04/2019 23:00,43.91,43568,590,50,98,698,6,1442,2.136.428.571
12/04/2019 00:00,43.68,42825,545,45,85,727,6,1408,2.136.428.571
12/04/2019 01:00,43.59,42689,553,41,81,732,6,1413,2.136.428.571
12/04/2019 02:00,43.7,43031,549,39,87,734,5,1414,2.136.428.571
12/04/2019 03:00,44.19,43909,543,39,89,746,4,1421,2.136.428.571
12/04/2019 04:00,45.92,46183,555,39,84,730,4,1412,2.136.428.571
12/04/2019 05:00,47.86,49797,591,39,72,682,4,1388,2.136.428.571
12/04/2019 06:00,60.6,52877,625,38,59,589,4,1315,2.136.428.571
12/04/2019 07:00,62.73,53473,619,37,45,485,2,1188,2.136.428.571
12/04/2019 08:00,53.21,52717,650,34,50,397,4,1135,2.136.428.571
12/04/2019 09:00,49.8,52137,692,33,53,364,5,1147,2.136.428.571
12/04/2019 10:00,47.36,51286,736,31,53,347,6,1173,2.136.428.571
12/04/2019 11:00,46.63,50396,732,30,56,349,7,1174,2.136.428.571
12/04/2019 12:00,45.81,49416,703,29,58,350,7,1147,2.136.428.571
12/04/2019 13:00,44.16,48556,732,29,62,329,6,1158,2.136.428.571
12/04/2019 14:00,43.57,47961,812,29,69,339,7,1256,2.136.428.571
12/04/2019 15:00,43.93,47679,909,28,78,335,8,1358,2.136.428.571
12/04/2019 16:00,44.23,47820,949,25,85,341,10,1410,2.136.428.571
12/04/2019 17:00,45.94,48264,871,22,90,414,8,1405,2.136.428.571
12/04/2019 18:00,46.99,48156,742,17,98,526,5,1388,2.136.428.571
12/04/2019 19:00,46.63,47609,672,15,107,598,6,1398,2.136.428.571
12/04/2019 20:00,45.36,46890,612,14,116,578,6,1326,2.136.428.571
12/04/2019 21:00,44.72,45379,567,14,123,603,5,1312,2.136.428.571
12/04/2019 22:00,43.82,43541,494,13,122,639,7,1275,2.136.428.571
12/04/2019 23:00,44.78,42008,554,81,142,600,10,1387,2.136.428.571
13/04/2019 00:00,43.89,41412,517,78,134,633,9,1371,2.136.428.571
13/04/2019 01:00,43.41,41239,506,74,127,652,8,1367,2.136.428.571
13/04/2019 02:00,43.09,41361,562,69,120,672,7,1430,2.136.428.571
13/04/2019 03:00,43.32,41720,675,63,113,707,8,1566,2.136.428.571
13/04/2019 04:00,43.3,42287,758,58,107,731,9,1663,2.136.428.571
13/04/2019 05:00,43.88,42958,874,53,97,730,12,1766,2.136.428.571
13/04/2019 06:00,44.99,44299,1025,43,86,649,8,1811,2.136.428.571
13/04/2019 07:00,46.14,46046,1047,31,80,600,3,1761,2.136.428.571
13/04/2019 08:00,45.9,46956,1133,21,98,612,4,1868,2.136.428.571
13/04/2019 09:00,44.58,46936,1280,18,116,647,5,2066,2.136.428.571
13/04/2019 10:00,44,46343,1565,19,118,736,9,2447,2.136.428.571
13/04/2019 11:00,43.71,45723,1873,19,108,792,10,2802,2.136.428.571
13/04/2019 12:00,43.34,45225,1984,19,95,833,9,2940,2.136.428.571
13/04/2019 13:00,43.12,44848,1980,18,99,875,9,2981,2.136.428.571
13/04/2019 14:00,42.94,44746,1940,18,111,934,10,3013,2.136.428.571
13/04/2019 15:00,42.91,44998,1927,18,126,998,12,3081,2.136.428.571
13/04/2019 16:00,43.46,45692,1856,20,144,1028,13,3061,2.136.428.571
13/04/2019 17:00,44.14,46271,1633,25,161,1084,10,2913,2.136.428.571
13/04/2019 18:00,44.99,46215,1445,36,178,1143,7,2809,2.136.428.571
13/04/2019 19:00,45.27,45775,1382,47,195,1201,11,2836,2.136.428.571
13/04/2019 20:00,44.11,45217,1511,57,204,1185,17,2974,2.136.428.571
13/04/2019 21:00,43.32,43981,1565,64,212,1208,17,3066,2.136.428.571
13/04/2019 22:00,42.26,42696,1508,63,209,1210,16,3006,2.136.428.571
13/04/2019 23:00,41.76,41381,1648,78,196,1239,13,3174,2.136.428.571
14/04/2019 00:00,41.61,40625,1584,76,178,1221,11,3070,2.136.428.571
14/04/2019 01:00,41.61,40270,1523,71,172,1187,11,2964,2.136.428.571
14/04/2019 02:00,41.64,40160,1471,67,167,1221,11,2937,2.136.428.571
14/04/2019 03:00,41.8,40260,1447,61,160,1271,10,2949,2.136.428.571
14/04/2019 04:00,41.65,40566,1522,57,151,1289,11,3030,2.136.428.571
14/04/2019 05:00,41.66,40933,1658,53,133,1228,12,3084,2.136.428.571
14/04/2019 06:00,41.99,41976,1798,44,114,1181,10,3147,2.136.428.571
14/04/2019 07:00,43.06,43485,1876,35,105,1163,5,3184,2.136.428.571
14/04/2019 08:00,43.5,44232,2055,31,128,1153,5,3372,2.136.428.571
14/04/2019 09:00,43.28,44352,2208,32,168,1149,7,3564,2.136.428.571
14/04/2019 10:00,42.95,43810,2276,36,186,1085,13,3596,2.136.428.571
14/04/2019 11:00,42.61,43277,2210,39,173,1128,14,3564,2.136.428.571
14/04/2019 12:00,42.38,42834,2067,40,159,1100,11,3377,2.136.428.571
14/04/2019 13:00,42.17,42432,1997,37,156,1052,11,3253,2.136.428.571
14/04/2019 14:00,42.06,41951,1951,32,158,1004,11,3156,2.136.428.571
14/04/2019 15:00,41.95,42111,1912,28,158,947,14,3059,2.136.428.571
14/04/2019 16:00,42.01,42714,1892,29,156,917,13,3007,2.136.428.571
14/04/2019 17:00,43.15,43460,1736,36,147,900,11,2830,2.136.428.571
14/04/2019 18:00,44.72,43985,1536,47,136,913,8,2640,2.136.428.571
14/04/2019 19:00,45.61,44355,1472,53,141,926,10,2602,2.136.428.571
14/04/2019 20:00,44.4,44517,1551,53,163,903,16,2686,2.136.428.571
14/04/2019 21:00,43.81,43512,1622,53,179,919,16,2789,2.136.428.571
14/04/2019 22:00,43.09,41930,1529,51,181,905,16,2682,2.136.428.571
14/04/2019 23:00,43.38,40924,1548,11,184,886,14,2643,2.136.428.571
15/04/2019 00:00,42.39,40392,1406,9,176,820,14,2425,205.75
15/04/2019 01:00,42.34,40292,1316,10,168,770,14,2278,205.75
15/04/2019 02:00,42.74,40674,1271,10,166,745,10,2202,205.75
15/04/2019 03:00,43.23,41460,1214,12,164,755,11,2156,205.75
15/04/2019 04:00,45.06,43573,1198,12,152,710,11,2083,205.75
15/04/2019 05:00,47.52,47082,1203,11,132,660,12,2018,205.75
15/04/2019 06:00,52.77,50275,1200,10,101,598,11,1920,205.75
15/04/2019 07:00,53.23,50993,1214,11,82,521,7,1835,205.75
15/04/2019 08:00,47.75,50216,1391,12,100,494,7,2004,205.75
15/04/2019 09:00,46.23,49320,1606,14,137,454,9,2220,205.75
15/04/2019 10:00,45.15,48406,1812,16,159,440,16,2443,205.75
15/04/2019 11:00,44.8,47431,1919,17,155,504,21,2616,205.75
15/04/2019 12:00,44.59,46682,1934,19,153,591,17,2714,205.75
15/04/2019 13:00,43.86,46208,1958,20,156,623,16,2773,205.75
15/04/2019 14:00,43.63,45769,1934,22,160,603,15,2734,205.75
15/04/2019 15:00,44,45552,1893,24,166,560,15,2658,205.75
15/04/2019 16:00,44.5,45790,1897,26,167,574,14,2678,205.75
15/04/2019 17:00,46.05,45845,1831,28,159,608,10,2636,205.75
15/04/2019 18:00,47.2,46094,1664,30,145,668,9,2516,205.75
15/04/2019 19:00,47.01,46187,1599,33,121,721,12,2486,205.75
15/04/2019 20:00,45.7,45738,1603,34,101,762,18,2518,205.75
15/04/2019 21:00,43.96,44242,1608,33,86,805,18,2550,205.75
15/04/2019 22:00,42.53,42183,1624,29,78,838,17,2586,205.75
15/04/2019 23:00,43.17,40800,1658,45,73,911,14,2701,205.75
16/04/2019 00:00,43.05,40182,1559,42,67,896,13,2577,205.75
16/04/2019 01:00,43.04,39947,1465,41,64,923,18,2511,205.75
16/04/2019 02:00,43.18,40178,1435,41,64,944,16,2500,205.75
16/04/2019 03:00,43.5,40912,1403,38,71,972,15,2499,205.75
16/04/2019 04:00,44.11,43044,1464,33,70,1022,12,2601,205.75
16/04/2019 05:00,46.52,46449,1587,26,60,1015,10,2698,205.75
16/04/2019 06:00,50.66,49515,1712,18,53,982,7,2772,205.75
16/04/2019 07:00,50.67,50159,1812,15,43,943,5,2818,205.75
16/04/2019 08:00,47.04,49503,2072,16,34,957,4,3083,205.75
16/04/2019 09:00,44.9,48964,2368,20,28,947,4,3367,205.75
16/04/2019 10:00,44.56,48124,2546,25,30,1020,5,3626,205.75
16/04/2019 11:00,44.26,47095,2632,28,41,1125,7,3833,205.75
16/04/2019 12:00,44.23,46471,2634,31,54,1271,6,3996,205.75
16/04/2019 13:00,43.59,45825,2623,34,67,1367,8,4099,205.75
16/04/2019 14:00,43.49,45416,2534,36,80,1310,10,3970,205.75
16/04/2019 15:00,43.7,45265,2431,36,97,1268,13,3845,205.75
16/04/2019 16:00,44.59,45462,2410,35,115,1269,14,3843,205.75
16/04/2019 17:00,46.35,45759,2292,35,132,1220,11,3690,205.75
16/04/2019 18:00,47.09,46128,2127,38,156,1231,8,3560,205.75
16/04/2019 19:00,47.2,46146,2172,41,179,1303,12,3707,205.75
16/04/2019 20:00,46.35,45464,2387,42,199,1293,16,3937,205.75
16/04/2019 21:00,44.13,43517,2596,42,209,1306,16,4169,205.75
16/04/2019 22:00,41.89,41331,2700,40,208,1288,19,4255,205.75
16/04/2019 23:00,42.06,39316,2748,51,199,1280,16,4294,205.75
17/04/2019 00:00,41.69,38550,2757,55,182,1256,14,4264,205.75
17/04/2019 01:00,41.44,38353,2699,53,174,1232,11,4169,205.75
17/04/2019 02:00,41.91,38507,2547,51,170,1175,10,3953,205.75
17/04/2019 03:00,42.25,39362,2349,47,163,1165,10,3734,205.75
17/04/2019 04:00,43.29,41424,2270,41,149,1101,10,3571,205.75
17/04/2019 05:00,45.82,44768,2205,32,123,936,11,3307,205.75
17/04/2019 06:00,47.05,47172,2059,22,91,801,10,2983,205.75
17/04/2019 07:00,48.88,47502,1799,16,62,650,6,2533,205.75
17/04/2019 08:00,46.86,46839,1531,13,51,520,5,2120,205.75
17/04/2019 09:00,46.14,46195,1367,15,54,382,4,1822,205.75
17/04/2019 10:00,44.68,45710,1355,18,67,314,6,1760,205.75
17/04/2019 11:00,43.98,44987,1406,23,77,301,9,1816,205.75
17/04/2019 12:00,43.5,44453,1452,29,78,336,10,1905,205.75
17/04/2019 13:00,42.97,44043,1478,35,72,364,10,1959,205.75
17/04/2019 14:00,42.89,43669,1463,41,66,371,7,1948,205.75
17/04/2019 15:00,43.03,43376,1400,45,62,385,7,1899,205.75
17/04/2019 16:00,43.35,43414,1354,49,62,396,6,1867,205.75
17/04/2019 17:00,44.69,43592,1260,56,71,422,6,1815,205.75
17/04/2019 18:00,45.56,43808,1136,67,82,510,7,1802,205.75
17/04/2019 19:00,45.75,43888,1139,77,93,606,9,1924,205.75
17/04/2019 20:00,44.27,43815,1199,81,99,665,9,2053,205.75
17/04/2019 21:00,42.97,42182,1212,81,102,751,9,2155,205.75
17/04/2019 22:00,41.8,40101,1227,76,98,830,10,2241,205.75
17/04/2019 23:00,42.65,38715,1036,71,0,830,11,1948,205.75
18/04/2019 00:00,42.52,38345,1068,63,0,818,11,1960,205.75
18/04/2019 01:00,42.51,38300,1090,54,0,814,10,1968,205.75
18/04/2019 02:00,42.63,38599,1014,42,0,762,7,1825,205.75
18/04/2019 03:00,42.73,39210,985,32,0,733,6,1756,205.75
18/04/2019 04:00,43.84,40492,1018,25,0,719,6,1768,205.75
18/04/2019 05:00,44.88,42219,1057,19,0,767,5,1848,205.75
18/04/2019 06:00,46.29,43925,1063,12,0,751,5,1831,205.75
18/04/2019 07:00,46.95,44608,972,6,0,607,4,1589,205.75
18/04/2019 08:00,45.94,44573,901,4,0,473,3,1381,205.75
18/04/2019 09:00,44.71,44253,826,4,0,345,4,1179,205.75
18/04/2019 10:00,43.81,43526,875,6,0,323,5,1209,205.75
18/04/2019 11:00,43.23,42622,983,6,0,415,6,1410,205.75
18/04/2019 12:00,42.61,41875,1069,7,0,531,6,1613,205.75
18/04/2019 13:00,42.03,41198,1104,8,0,638,7,1757,205.75
18/04/2019 14:00,41.99,40759,1066,11,0,720,7,1804,205.75
18/04/2019 15:00,42.29,40713,1033,14,0,793,6,1846,205.75
18/04/2019 16:00,42.69,41042,1017,18,0,822,7,1864,205.75
18/04/2019 17:00,44,41297,945,19,0,917,8,1889,205.75
18/04/2019 18:00,44.8,41580,862,20,0,1038,11,1931,205.75
18/04/2019 19:00,44.89,41868,879,20,0,1130,11,2040,205.75
18/04/2019 20:00,44.19,41705,960,20,0,1160,12,2152,205.75
18/04/2019 21:00,43.1,40661,1002,22,0,1214,11,2249,205.75
18/04/2019 22:00,41.25,39188,992,21,0,1338,10,2361,205.75
18/04/2019 23:00,40.65,37605,969,25,114,1325,8,2441,205.75
19/04/2019 00:00,40.51,37063,895,25,112,1396,7,2435,205.75
19/04/2019 01:00,40.05,36884,859,25,102,1393,5,2384,205.75
19/04/2019 02:00,40.08,37024,812,22,84,1390,5,2313,205.75
19/04/2019 03:00,39.92,37348,783,18,66,1442,5,2314,205.75
19/04/2019 04:00,40.92,37733,751,13,44,1461,5,2274,205.75
19/04/2019 05:00,41.73,38244,712,11,29,1350,4,2106,205.75
19/04/2019 06:00,42.72,39153,687,9,14,1233,4,1947,205.75
19/04/2019 07:00,43.82,40095,609,8,7,1039,3,1666,205.75
19/04/2019 08:00,43.72,40758,527,7,5,831,3,1373,205.75
19/04/2019 09:00,42.97,40809,433,9,5,739,3,1189,205.75
19/04/2019 10:00,42.75,40290,416,13,8,638,3,1078,205.75
19/04/2019 11:00,42.27,39542,441,16,10,646,4,1117,205.75
19/04/2019 12:00,41.92,38842,450,18,15,705,4,1192,205.75
19/04/2019 13:00,41.39,38395,456,19,21,719,5,1220,205.75
19/04/2019 14:00,40.98,38274,437,20,29,694,6,1186,205.75
19/04/2019 15:00,41.78,38323,430,20,39,716,6,1211,205.75
19/04/2019 16:00,42.29,38790,418,21,54,725,6,1224,205.75
19/04/2019 17:00,43.15,39120,412,23,68,846,5,1354,205.75
19/04/2019 18:00,43.82,39359,386,27,81,1015,5,1514,205.75
19/04/2019 19:00,43.2,39924,372,27,90,1178,5,1672,205.75
19/04/2019 20:00,44.07,40173,360,24,93,1265,6,1748,205.75
19/04/2019 21:00,43.86,39500,334,19,95,1393,5,1846,205.75
19/04/2019 22:00,41.62,38183,277,13,94,1459,4,1847,205.75
19/04/2019 23:00,42.42,36558,241,33,86,1387,5,1752,205.75
20/04/2019 00:00,40.94,36052,211,31,70,1324,5,1641,205.75
20/04/2019 01:00,40.42,35997,195,31,63,1295,6,1590,205.75
20/04/2019 02:00,40.71,36139,170,30,61,1249,4,1514,205.75
20/04/2019 03:00,41.23,36447,137,29,61,1180,5,1412,205.75
20/04/2019 04:00,40.32,36813,116,26,58,1126,5,1331,205.75
20/04/2019 05:00,40.87,37101,100,22,48,1007,5,1182,205.75
20/04/2019 06:00,41.41,37877,93,16,40,843,7,999,205.75
20/04/2019 07:00,42.67,38752,87,14,34,672,6,813,205.75
20/04/2019 08:00,42.99,39479,79,15,36,396,5,531,205.75
20/04/2019 09:00,42.88,39539,64,21,51,256,6,398,205.75
20/04/2019 10:00,42.01,38987,63,25,66,211,7,372,205.75
20/04/2019 11:00,41.5,38222,66,28,86,204,11,395,205.75
20/04/2019 12:00,40.99,37472,67,30,103,259,13,472,205.75
20/04/2019 13:00,40.71,36995,85,32,112,344,14,587,205.75
20/04/2019 14:00,40.18,36785,126,33,111,424,13,707,205.75
20/04/2019 15:00,40.46,36846,166,34,110,513,13,836,205.75
20/04/2019 16:00,41.32,37170,200,36,110,645,11,1002,205.75
20/04/2019 17:00,43.38,37442,224,41,109,885,8,1267,205.75
20/04/2019 18:00,43.84,37738,222,47,109,1203,6,1587,205.75
20/04/2019 19:00,43.84,38395,209,54,108,1448,7,1826,205.75
20/04/2019 20:00,43.4,38676,225,58,107,1569,7,1966,205.75
20/04/2019 21:00,42.44,38097,228,56,106,1680,7,2077,205.75
20/04/2019 22:00,41.11,36974,221,52,89,1815,8,2185,205.75
20/04/2019 23:00,39.52,35396,178,52,0,1965,4,2199,205.75
21/04/2019 00:00,38.1,34698,154,48,0,1957,4,2163,205.75
21/04/2019 01:00,37.56,34437,135,47,0,2005,4,2191,205.75
21/04/2019 02:00,37.59,34548,134,47,0,2009,4,2194,205.75
21/04/2019 03:00,38.11,34796,144,44,0,1982,4,2174,205.75
21/04/2019 04:00,39.42,35113,154,39,0,1968,4,2165,205.75
21/04/2019 05:00,39.4,35296,168,31,0,1779,6,1984,205.75
21/04/2019 06:00,39.53,36032,183,22,0,1642,5,1852,205.75
21/04/2019 07:00,40.91,37043,177,17,0,1480,6,1680,205.75
21/04/2019 08:00,41.7,37684,167,20,0,1273,6,1466,205.75
21/04/2019 09:00,41.41,37816,162,26,0,1078,7,1273,205.75
21/04/2019 10:00,41.12,37395,157,31,0,1023,8,1219,205.75
21/04/2019 11:00,40.92,36771,156,35,0,1029,9,1229,205.75
21/04/2019 12:00,40.25,36214,155,36,0,1118,10,1319,205.75
21/04/2019 13:00,39.85,35750,150,38,0,1133,10,1331,205.75
21/04/2019 14:00,38.53,35542,161,39,0,1124,9,1333,205.75
21/04/2019 15:00,38.61,35543,184,38,0,1165,8,1395,205.75
21/04/2019 16:00,39.91,36059,209,40,0,1190,9,1448,205.75
21/04/2019 17:00,41.94,36674,198,41,0,1210,7,1456,205.75
21/04/2019 18:00,43.46,37425,173,44,0,1228,5,1450,205.75
21/04/2019 19:00,43.81,38322,170,46,0,1334,7,1557,205.75
21/04/2019 20:00,43.17,38433,167,47,0,1419,9,1642,205.75
21/04/2019 21:00,41.65,37681,192,49,0,1463,11,1715,205.75
21/04/2019 22:00,39.53,36251,218,47,0,1418,16,1699,205.75
21/04/2019 23:00,38.39,33618,337,11,169,1295,11,1823,205.75
22/04/2019 00:00,37.41,33151,401,10,171,1240,11,1833,2.424.285.714
22/04/2019 01:00,37.11,33152,497,10,176,1217,10,1910,2.424.285.714
22/04/2019 02:00,37.25,33258,580,12,179,1239,9,2019,2.424.285.714
22/04/2019 03:00,36.52,33548,661,13,181,1241,10,2106,2.424.285.714
22/04/2019 04:00,37.5,33891,772,15,176,1236,13,2212,2.424.285.714
22/04/2019 05:00,38.04,34385,858,14,159,1147,15,2193,2.424.285.714
22/04/2019 06:00,39.35,35241,877,13,134,986,13,2023,2.424.285.714
22/04/2019 07:00,40.79,36076,849,10,120,845,7,1831,2.424.285.714
22/04/2019 08:00,41.19,36740,876,10,127,770,6,1789,2.424.285.714
22/04/2019 09:00,41.34,37128,978,13,146,718,6,1861,2.424.285.714
22/04/2019 10:00,40.79,36971,1165,18,165,747,8,2103,2.424.285.714
22/04/2019 11:00,40.01,36239,1434,23,181,847,11,2496,2.424.285.714
22/04/2019 12:00,39.51,35754,1703,27,189,961,13,2893,2.424.285.714
22/04/2019 13:00,38.02,35316,2002,29,181,1059,10,3281,2.424.285.714
22/04/2019 14:00,38.18,35126,2293,30,161,1126,8,3618,2.424.285.714
22/04/2019 15:00,38.86,35422,2557,32,140,1210,8,3947,2.424.285.714
22/04/2019 16:00,39.91,35862,2718,36,126,1409,7,4296,2.424.285.714
22/04/2019 17:00,40.3,36133,2807,42,118,1679,6,4652,2.424.285.714
22/04/2019 18:00,40.78,36478,2861,52,121,2041,6,5081,2.424.285.714
22/04/2019 19:00,39.81,36954,2918,63,143,2437,11,5572,2.424.285.714
22/04/2019 20:00,38.99,37263,2981,70,175,2784,17,6027,2.424.285.714
22/04/2019 21:00,34.22,36507,3100,76,205,3138,23,6542,2.424.285.714
22/04/2019 22:00,27.31,35248,3080,74,219,3331,26,6730,2.424.285.714
22/04/2019 23:00,28.37,33231,3262,41,0,3415,23,6741,2.424.285.714
23/04/2019 00:00,29.87,32758,3065,57,0,3350,22,6494,2.424.285.714
23/04/2019 01:00,30.01,32724,2948,71,0,3264,22,6305,2.424.285.714
23/04/2019 02:00,29.89,33001,2948,78,0,3167,22,6215,2.424.285.714
23/04/2019 03:00,31.89,33654,2984,79,0,3051,19,6133,2.424.285.714
23/04/2019 04:00,37.91,35324,3124,73,0,2849,18,6064,2.424.285.714
23/04/2019 05:00,41.23,38678,3217,62,0,2508,16,5803,2.424.285.714
23/04/2019 06:00,43.6,41417,3341,47,0,2113,14,5515,2.424.285.714
23/04/2019 07:00,43.94,41977,3365,32,0,1934,8,5339,2.424.285.714
23/04/2019 08:00,43.11,41451,3645,22,0,1780,6,5453,2.424.285.714
23/04/2019 09:00,42.47,41127,4034,20,0,1725,6,5785,2.424.285.714
23/04/2019 10:00,41.45,40578,4353,22,0,1917,9,6301,2.424.285.714
23/04/2019 11:00,39.95,39691,4602,25,0,2169,15,6811,2.424.285.714
23/04/2019 12:00,39.21,39135,4755,28,0,2440,18,7241,2.424.285.714
23/04/2019 13:00,37.56,38616,4871,29,0,2583,20,7503,2.424.285.714
23/04/2019 14:00,38.63,38322,4915,27,0,2601,22,7565,2.424.285.714
23/04/2019 15:00,38.7,38105,4915,23,0,2675,22,7635,2.424.285.714
23/04/2019 16:00,39.71,38363,4834,19,0,2757,17,7627,2.424.285.714
23/04/2019 17:00,40.24,38546,4729,18,0,2916,18,7681,2.424.285.714
23/04/2019 18:00,40.92,38787,4587,20,0,3205,16,7828,2.424.285.714
23/04/2019 19:00,40.64,38872,4517,24,0,3391,16,7948,2.424.285.714
23/04/2019 20:00,40.06,38603,4322,27,0,3461,19,7829,2.424.285.714
23/04/2019 21:00,38.97,36659,4236,32,0,3544,25,7837,2.424.285.714
23/04/2019 22:00,35.29,34546,4087,35,0,3552,25,7699,2.424.285.714
23/04/2019 23:00,21.4,34296,4065,48,329,3593,28,8063,2.424.285.714
24/04/2019 00:00,27.59,33680,4024,57,327,3518,29,7955,2.424.285.714
24/04/2019 01:00,27.27,33537,3957,60,330,3478,32,7857,2.424.285.714
24/04/2019 02:00,26,33704,3862,61,338,3422,30,7713,2.424.285.714
24/04/2019 03:00,27.73,34303,3892,58,350,3297,31,7628,2.424.285.714
24/04/2019 04:00,36.74,35932,3986,52,356,3178,33,7605,2.424.285.714
24/04/2019 05:00,40.21,38906,3890,43,349,3003,31,7316,2.424.285.714
24/04/2019 06:00,43.17,41533,3889,31,332,2778,24,7054,2.424.285.714
24/04/2019 07:00,43.85,42038,3720,20,329,2655,21,6745,2.424.285.714
24/04/2019 08:00,42,41518,3754,16,361,2632,20,6783,2.424.285.714
24/04/2019 09:00,40.96,41240,3873,16,413,2621,26,6949,2.424.285.714
24/04/2019 10:00,39.82,40818,3904,17,458,2726,35,7140,2.424.285.714
24/04/2019 11:00,38.65,40197,3894,18,468,2977,45,7402,2.424.285.714
24/04/2019 12:00,37.55,39866,3809,17,470,3269,48,7613,2.424.285.714
24/04/2019 13:00,36.07,39568,3703,17,471,3437,50,7678,2.424.285.714
24/04/2019 14:00,36.43,39267,3476,15,465,3373,49,7378,2.424.285.714
24/04/2019 15:00,37.17,39134,3203,14,458,3237,43,6955,2.424.285.714
24/04/2019 16:00,40.86,39232,3026,12,439,3092,37,6606,2.424.285.714
24/04/2019 17:00,42.35,39354,2894,10,404,3063,32,6403,2.424.285.714
24/04/2019 18:00,42.55,39341,2806,10,372,3052,23,6263,2.424.285.714
24/04/2019 19:00,42.27,39159,2814,11,355,3033,31,6244,2.424.285.714
24/04/2019 20:00,41.39,39045,2811,13,346,2997,37,6204,2.424.285.714
24/04/2019 21:00,38.68,37654,2833,18,338,3026,35,6250,2.424.285.714
24/04/2019 22:00,35.91,35570,2740,21,330,3010,35,6136,2.424.285.714
24/04/2019 23:00,34.36,34984,2793,22,298,2878,28,6019,2.424.285.714
25/04/2019 00:00,33.36,34255,2765,30,300,2783,22,5900,2.424.285.714
25/04/2019 01:00,32.12,33989,2788,35,301,2681,18,5823,2.424.285.714
25/04/2019 02:00,33.25,34162,2718,37,299,2660,21,5735,2.424.285.714
25/04/2019 03:00,31.29,34621,2498,40,299,2591,16,5444,2.424.285.714
25/04/2019 04:00,38.82,36215,2244,42,292,2459,14,5051,2.424.285.714
25/04/2019 05:00,43.11,38667,1928,41,277,2208,17,4471,2.424.285.714
25/04/2019 06:00,46.15,41222,1641,36,260,1941,18,3896,2.424.285.714
25/04/2019 07:00,46.73,41831,1331,26,248,1776,18,3399,2.424.285.714
25/04/2019 08:00,44.67,41437,1094,15,232,1682,18,3041,2.424.285.714
25/04/2019 09:00,42.62,41108,910,13,217,1535,15,2690,2.424.285.714
25/04/2019 10:00,41.49,40788,730,15,206,1503,15,2469,2.424.285.714
25/04/2019 11:00,40.98,40105,601,17,195,1608,17,2438,2.424.285.714
25/04/2019 12:00,40.76,39729,536,18,184,1782,17,2537,2.424.285.714
25/04/2019 13:00,40.29,39329,455,15,175,1837,13,2495,2.424.285.714
25/04/2019 14:00,40.21,39095,403,15,163,1826,10,2417,2.424.285.714
25/04/2019 15:00,40.34,39071,404,18,151,1805,9,2387,2.424.285.714
25/04/2019 16:00,41.46,39469,473,20,137,1759,8,2397,2.424.285.714
25/04/2019 17:00,43.24,39558,537,23,138,1734,7,2439,2.424.285.714
25/04/2019 18:00,43.9,39477,601,29,151,1800,6,2587,2.424.285.714
25/04/2019 19:00,43.39,39474,682,38,166,1851,10,2747,2.424.285.714
25/04/2019 20:00,42.93,39377,775,50,176,1821,17,2839,2.424.285.714
25/04/2019 21:00,41.46,38055,943,62,179,1827,17,3028,2.424.285.714
25/04/2019 22:00,39.36,36057,1117,69,178,1822,17,3203,2.424.285.714
25/04/2019 23:00,36.73,34414,1757,70,156,1658,9,3650,2.424.285.714
26/04/2019 00:00,35,33716,1907,75,147,1497,9,3635,2.424.285.714
26/04/2019 01:00,33.53,33513,2043,75,138,1420,9,3685,2.424.285.714
26/04/2019 02:00,34.88,33945,2109,72,128,1373,7,3689,2.424.285.714
26/04/2019 03:00,36.35,34648,2136,66,123,1358,9,3692,2.424.285.714
26/04/2019 04:00,40.08,36489,2121,61,115,1295,9,3601,2.424.285.714
26/04/2019 05:00,43.91,39416,2056,54,99,1201,9,3419,2.424.285.714
26/04/2019 06:00,44.64,42528,1908,42,75,1072,5,3102,2.424.285.714
26/04/2019 07:00,45.02,43454,1618,30,59,959,3,2669,2.424.285.714
26/04/2019 08:00,44.89,43080,1406,23,62,872,3,2366,2.424.285.714
26/04/2019 09:00,44.59,42656,1270,20,68,702,3,2063,2.424.285.714
26/04/2019 10:00,44.26,42045,1171,19,70,683,2,1945,2.424.285.714
26/04/2019 11:00,43.72,41361,1091,20,67,708,3,1889,2.424.285.714
26/04/2019 12:00,42.67,40578,1037,23,57,797,3,1917,2.424.285.714
26/04/2019 13:00,41.28,39867,1017,26,44,865,3,1955,2.424.285.714
26/04/2019 14:00,41.49,39391,945,30,37,944,2,1958,2.424.285.714
26/04/2019 15:00,42.15,39251,937,35,37,991,11,2011,2.424.285.714
26/04/2019 16:00,43.19,39645,909,43,41,1043,11,2047,2.424.285.714
26/04/2019 17:00,43.37,39647,901,57,60,1065,5,2088,2.424.285.714
26/04/2019 18:00,43.59,39397,933,71,87,1143,7,2241,2.424.285.714
26/04/2019 19:00,43.09,38771,982,79,108,1282,6,2457,2.424.285.714
26/04/2019 20:00,42.97,38474,1038,85,121,1316,9,2569,2.424.285.714
26/04/2019 21:00,41.05,37218,1056,86,137,1350,12,2641,2.424.285.714
26/04/2019 22:00,37.5,35503,998,81,141,1395,11,2626,2.424.285.714
26/04/2019 23:00,33.89,34557,1040,63,152,1355,10,2620,2.424.285.714
27/04/2019 00:00,30.86,33751,1016,60,140,1354,11,2581,2.424.285.714
27/04/2019 01:00,29.44,33528,962,55,131,1344,9,2501,2.424.285.714
27/04/2019 02:00,28.51,33553,894,50,128,1340,9,2421,2.424.285.714
27/04/2019 03:00,27.92,33742,871,45,132,1420,7,2475,2.424.285.714
27/04/2019 04:00,27.94,33886,806,39,128,1501,8,2482,2.424.285.714
27/04/2019 05:00,28.07,34760,722,30,110,1435,8,2305,2.424.285.714
27/04/2019 06:00,32.58,35928,668,20,84,1343,6,2121,2.424.285.714
27/04/2019 07:00,37.22,37577,539,15,61,1287,5,1907,2.424.285.714
27/04/2019 08:00,38.04,38461,450,14,59,1297,6,1826,2.424.285.714
27/04/2019 09:00,38.02,38658,409,17,62,1353,6,1847,2.424.285.714
27/04/2019 10:00,37.57,38186,427,21,68,1411,6,1933,2.424.285.714
27/04/2019 11:00,34.36,37677,435,24,62,1606,8,2135,2.424.285.714
27/04/2019 12:00,32.05,37352,420,26,51,1828,9,2334,2.424.285.714
27/04/2019 13:00,31.13,37086,431,30,36,1896,11,2404,2.424.285.714
27/04/2019 14:00,31.3,37042,440,31,34,1897,11,2413,2.424.285.714
27/04/2019 15:00,32.06,37468,419,30,42,1965,10,2466,2.424.285.714
27/04/2019 16:00,33.95,38382,382,27,59,1999,10,2477,2.424.285.714
27/04/2019 17:00,38.02,38964,365,25,69,2084,11,2554,2.424.285.714
27/04/2019 18:00,38.97,38809,374,22,84,2183,15,2678,2.424.285.714
27/04/2019 19:00,38.61,38490,331,20,90,2388,20,2849,2.424.285.714
27/04/2019 20:00,37.05,38241,276,18,92,2501,26,2913,2.424.285.714
27/04/2019 21:00,34.79,37180,266,15,102,2580,26,2989,2.424.285.714
27/04/2019 22:00,31.21,35820,266,14,96,2602,22,3000,2.424.285.714
27/04/2019 23:00,15.67,34112,148,18,94,2650,25,2935,2.424.285.714
28/04/2019 00:00,14.66,33220,225,19,82,2703,23,3052,2.424.285.714
28/04/2019 01:00,11.99,32756,258,22,75,2478,23,2856,2.424.285.714
28/04/2019 02:00,11.29,32645,272,26,71,2435,23,2827,2.424.285.714
28/04/2019 03:00,11.21,32572,330,32,68,2409,20,2859,2.424.285.714
28/04/2019 04:00,11.98,32655,352,35,64,2295,20,2766,2.424.285.714
28/04/2019 05:00,17.99,32942,353,30,61,2090,20,2554,2.424.285.714
28/04/2019 06:00,27.19,33907,358,21,53,1902,22,2356,2.424.285.714
28/04/2019 07:00,32.22,35326,311,15,54,1799,23,2202,2.424.285.714
28/04/2019 08:00,34.56,36281,331,13,61,1732,29,2166,2.424.285.714
28/04/2019 09:00,34.64,36738,367,11,71,1692,30,2171,2.424.285.714
28/04/2019 10:00,35.71,36733,429,10,88,1703,30,2260,2.424.285.714
28/04/2019 11:00,33.21,36449,520,10,108,1817,30,2485,2.424.285.714
28/04/2019 12:00,32.35,36102,600,10,124,1911,29,2674,2.424.285.714
28/04/2019 13:00,31.91,35694,616,10,136,1917,28,2707,2.424.285.714
28/04/2019 14:00,31.41,35571,603,10,150,1862,25,2650,2.424.285.714
28/04/2019 15:00,34.74,35849,619,9,167,1755,22,2572,2.424.285.714
28/04/2019 16:00,37.57,36686,585,8,177,1717,25,2512,2.424.285.714
28/04/2019 17:00,40.25,37558,547,7,186,1627,27,2394,2.424.285.714
28/04/2019 18:00,40.97,38237,507,9,210,1612,25,2363,2.424.285.714
28/04/2019 19:00,41.37,38572,501,10,244,1647,24,2426,2.424.285.714
28/04/2019 20:00,41.33,38794,489,14,285,1753,25,2566,2.424.285.714
28/04/2019 21:00,39.75,37764,499,18,329,1844,23,2713,2.424.285.714
28/04/2019 22:00,38.19,36098,483,21,338,1895,24,2761,2.424.285.714
28/04/2019 23:00,37.16,34945,421,69,272,1873,20,2655,2.424.285.714
29/04/2019 00:00,34.69,34317,462,66,260,1928,18,2734,2.815.654.762
29/04/2019 01:00,34.02,34210,561,62,248,1900,18,2789,2.815.654.762
29/04/2019 02:00,33.3,34315,618,55,238,1842,17,2770,2.815.654.762
29/04/2019 03:00,34.12,34770,706,48,233,1904,16,2907,2.815.654.762
29/04/2019 04:00,37.3,36568,732,42,220,1794,16,2804,2.815.654.762
29/04/2019 05:00,42,39747,704,34,196,1503,13,2450,2.815.654.762
29/04/2019 06:00,44.01,42944,665,28,175,1212,11,2091,2.815.654.762
29/04/2019 07:00,44.78,44158,576,24,161,959,11,1731,2.815.654.762
29/04/2019 08:00,44.38,44281,576,21,148,785,11,1541,2.815.654.762
29/04/2019 09:00,43.79,44103,583,20,148,656,12,1419,2.815.654.762
29/04/2019 10:00,43.9,43535,630,19,153,585,12,1399,2.815.654.762
29/04/2019 11:00,43.45,42723,724,19,147,567,12,1469,2.815.654.762
29/04/2019 12:00,42.91,42082,797,19,136,566,12,1530,2.815.654.762
29/04/2019 13:00,40.5,41481,797,18,128,544,11,1498,2.815.654.762
29/04/2019 14:00,39.36,40980,833,17,123,534,13,1520,2.815.654.762
29/04/2019 15:00,40.41,40784,879,18,120,522,13,1552,2.815.654.762
29/04/2019 16:00,41.65,41148,889,20,117,544,13,1583,2.815.654.762
29/04/2019 17:00,41.62,41324,819,22,118,612,13,1584,2.815.654.762
29/04/2019 18:00,41.31,41358,733,26,122,748,14,1643,2.815.654.762
29/04/2019 19:00,41.62,41065,662,28,132,909,12,1743,2.815.654.762
29/04/2019 20:00,41.33,40806,634,28,145,1031,15,1853,2.815.654.762
29/04/2019 21:00,40.36,39217,566,27,154,1117,16,1880,2.815.654.762
29/04/2019 22:00,36.91,36912,505,26,152,1175,16,1874,2.815.654.762
29/04/2019 23:00,34.39,35715,471,73,181,1137,16,1878,2.815.654.762
30/04/2019 00:00,34.56,34829,476,66,171,1171,16,1900,2.815.654.762
30/04/2019 01:00,34.48,34515,475,61,160,1267,16,1979,2.815.654.762
30/04/2019 02:00,34.91,34680,441,56,150,1244,14,1905,2.815.654.762
30/04/2019 03:00,34.55,35204,390,49,138,1260,13,1850,2.815.654.762
30/04/2019 04:00,37.19,37094,332,38,118,1189,13,1690,2.815.654.762
30/04/2019 05:00,40.51,41019,319,24,87,932,13,1375,2.815.654.762
30/04/2019 06:00,42.91,44837,317,13,49,739,10,1128,2.815.654.762
30/04/2019 07:00,43.93,45753,313,8,29,538,7,895,2.815.654.762
30/04/2019 08:00,43.68,45315,353,6,27,392,7,785,2.815.654.762
30/04/2019 09:00,43.13,45291,449,6,29,310,7,801,2.815.654.762
30/04/2019 10:00,42.8,44672,564,8,28,272,7,879,2.815.654.762
30/04/2019 11:00,41.77,43935,690,10,21,283,6,1010,2.815.654.762
30/04/2019 12:00,40.32,43602,809,14,17,341,6,1187,2.815.654.762
30/04/2019 13:00,39.92,43117,878,19,15,406,6,1324,2.815.654.762
30/04/2019 14:00,39.47,42711,925,26,17,486,7,1461,2.815.654.762
30/04/2019 15:00,39.94,42393,947,31,19,573,7,1577,2.815.654.762
30/04/2019 16:00,41.3,42421,934,33,21,659,8,1655,2.815.654.762
30/04/2019 17:00,42.27,42080,930,32,27,792,10,1791,2.815.654.762
30/04/2019 18:00,42.4,41769,939,34,35,960,12,1980,2.815.654.762
30/04/2019 19:00,41.66,41388,970,38,53,1116,11,2188,2.815.654.762
30/04/2019 20:00,41.17,41336,1033,40,66,1341,10,2490,2.815.654.762
30/04/2019 21:00,40.09,39612,1080,41,77,1584,13,2795,2.815.654.762
30/04/2019 22:00,36.06,37161,1103,36,83,1710,12,2944,2.815.654.762
30/04/2019 23:00,24.69,35130,1624,40,67,1704,10,3445,2.815.654.762
01/05/2019 00:00,26.15,34490,1637,35,70,1773,10,3525,2.815.654.762
01/05/2019 01:00,19.71,34215,1555,31,62,1683,9,3340,2.815.654.762
01/05/2019 02:00,18.86,34209,1585,28,46,1656,8,3323,2.815.654.762
01/05/2019 03:00,18.83,34251,1735,26,38,1594,8,3401,2.815.654.762
01/05/2019 04:00,12.36,34547,1929,21,31,1570,7,3558,2.815.654.762
01/05/2019 05:00,18.91,35290,2098,14,22,1381,6,3521,2.815.654.762
01/05/2019 06:00,28.03,36340,2342,8,13,1254,6,3623,2.815.654.762
01/05/2019 07:00,35.18,37211,2413,4,9,1193,6,3625,2.815.654.762
01/05/2019 08:00,35.54,38041,2550,4,9,1144,6,3713,2.815.654.762
01/05/2019 09:00,35,38545,2733,4,9,1196,6,3948,2.815.654.762
01/05/2019 10:00,34.03,38603,2871,5,11,1283,6,4176,2.815.654.762
01/05/2019 11:00,33.7,38360,3020,6,13,1369,6,4414,2.815.654.762
01/05/2019 12:00,32.55,38085,3195,8,21,1405,6,4635,2.815.654.762
01/05/2019 13:00,26,37842,3466,9,30,1465,9,4979,2.815.654.762
01/05/2019 14:00,24.56,37800,3774,11,52,1524,8,5369,2.815.654.762
01/05/2019 15:00,26.53,37909,3998,14,65,1620,8,5705,2.815.654.762
01/05/2019 16:00,30.8,38271,4109,17,79,1732,7,5944,2.815.654.762
01/05/2019 17:00,33.31,38527,4220,20,80,1806,7,6133,2.815.654.762
01/05/2019 18:00,36.27,38461,4215,22,77,1998,8,6320,2.815.654.762
01/05/2019 19:00,35.85,38438,4227,23,75,2114,7,6446,2.815.654.762
01/05/2019 20:00,37.69,38773,4177,23,83,2207,9,6499,2.815.654.762
01/05/2019 21:00,37.06,38193,4135,23,100,2354,9,6621,2.815.654.762
01/05/2019 22:00,31.78,36869,4229,21,128,2594,14,6986,2.815.654.762
01/05/2019 23:00,13.94,35872,4416,27,162,2961,19,7585,2.815.654.762
02/05/2019 00:00,9.87,35240,4427,30,195,3272,24,7948,2.815.654.762
02/05/2019 01:00,5.08,35212,4381,29,225,3490,15,8140,2.815.654.762
02/05/2019 02:00,4.78,35354,4350,27,259,3639,7,8282,2.815.654.762
02/05/2019 03:00,3.1,35790,4456,23,301,3822,5,8607,2.815.654.762
02/05/2019 04:00,10.65,37361,4391,19,324,4035,4,8773,2.815.654.762
02/05/2019 05:00,35.5,40777,4325,14,334,4209,4,8886,2.815.654.762
02/05/2019 06:00,40.02,43496,4321,10,343,4396,5,9075,2.815.654.762
02/05/2019 07:00,40.41,44449,4057,7,361,4318,9,8752,2.815.654.762
02/05/2019 08:00,40.19,44468,4230,7,377,4234,15,8863,2.815.654.762
02/05/2019 09:00,39.6,44386,4383,11,385,4268,21,9068,2.815.654.762
02/05/2019 10:00,38.62,44336,4447,19,392,4253,31,9142,2.815.654.762
02/05/2019 11:00,37.87,43855,4369,28,397,4306,35,9135,2.815.654.762
02/05/2019 12:00,37.96,43739,4338,36,398,4241,43,9056,2.815.654.762
02/05/2019 13:00,37.7,43569,4310,42,388,4214,41,8995,2.815.654.762
02/05/2019 14:00,36.05,43527,4221,44,371,4107,33,8776,2.815.654.762
02/05/2019 15:00,37.33,43507,4135,45,345,4072,28,8625,2.815.654.762
02/05/2019 16:00,38.58,44145,4114,43,324,3915,28,8424,2.815.654.762
02/05/2019 17:00,39.56,44215,4097,42,299,3596,22,8056,2.815.654.762
02/05/2019 18:00,39.86,44005,3849,43,279,3139,29,7339,2.815.654.762
02/05/2019 19:00,40.43,43864,3506,48,257,2759,31,6601,2.815.654.762
02/05/2019 20:00,40.66,43866,3202,54,243,2587,33,6119,2.815.654.762
02/05/2019 21:00,40.17,42338,2936,66,224,2473,34,5733,2.815.654.762
02/05/2019 22:00,38.69,40021,2786,72,203,2410,30,5501,2.815.654.762
02/05/2019 23:00,36.4,38947,2819,76,337,2376,37,5645,2.815.654.762
03/05/2019 00:00,34.89,38261,2742,65,320,2442,28,5597,2.815.654.762
03/05/2019 01:00,32.41,38312,2648,55,283,2464,27,5477,2.815.654.762
03/05/2019 02:00,32.71,38780,2545,47,257,2456,27,5332,2.815.654.762
03/05/2019 03:00,34.46,39545,2502,41,225,2369,28,5165,2.815.654.762
03/05/2019 04:00,37.34,41430,2447,37,196,2322,30,5032,2.815.654.762
03/05/2019 05:00,40.54,44972,2390,31,176,2155,29,4781,2.815.654.762
03/05/2019 06:00,42.67,48427,2461,26,167,2114,33,4801,2.815.654.762
03/05/2019 07:00,43.06,49709,2527,28,178,2063,31,4827,2.815.654.762
03/05/2019 08:00,42.73,49379,2809,37,184,2115,23,5168,2.815.654.762
03/05/2019 09:00,42.43,49069,2994,45,191,2307,20,5557,2.815.654.762
03/05/2019 10:00,41.93,48521,3217,52,194,2465,16,5944,2.815.654.762
03/05/2019 11:00,41.7,47999,3401,61,188,2540,14,6204,2.815.654.762
03/05/2019 12:00,39.87,47371,3629,77,173,2621,19,6519,2.815.654.762
03/05/2019 13:00,38.82,46671,3745,98,156,2569,13,6581,2.815.654.762
03/05/2019 14:00,37.25,46257,3710,118,131,2531,10,6500,2.815.654.762
03/05/2019 15:00,36.94,46006,3592,137,102,2466,8,6305,2.815.654.762
03/05/2019 16:00,39.16,46163,3469,148,80,2248,6,5951,2.815.654.762
03/05/2019 17:00,40.23,46134,3216,160,56,1975,7,5414,2.815.654.762
03/05/2019 18:00,41.43,45825,2863,172,38,1710,6,4789,2.815.654.762
03/05/2019 19:00,41.55,45060,2566,175,33,1568,5,4347,2.815.654.762
03/05/2019 20:00,41.82,44861,2325,175,39,1578,6,4123,2.815.654.762
03/05/2019 21:00,41.21,43599,2119,177,57,1594,7,3954,2.815.654.762
03/05/2019 22:00,40.43,41603,2030,176,76,1697,11,3990,2.815.654.762
03/05/2019 23:00,40.44,39555,2295,15,98,1764,13,4185,2.815.654.762
04/05/2019 00:00,39.54,38780,2104,16,121,1905,13,4159,2.815.654.762
04/05/2019 01:00,37.7,38549,1991,19,136,1939,11,4096,2.815.654.762
04/05/2019 02:00,36.85,38546,1888,21,137,1950,12,4008,2.815.654.762
04/05/2019 03:00,36.86,38645,1867,23,138,1920,13,3961,2.815.654.762
04/05/2019 04:00,36.98,39015,1886,25,139,1725,18,3793,2.815.654.762
04/05/2019 05:00,38.93,39952,1872,22,138,1399,14,3445,2.815.654.762
04/05/2019 06:00,40.95,41315,1878,18,145,1133,14,3188,2.815.654.762
04/05/2019 07:00,42.92,43002,1751,15,164,980,17,2927,2.815.654.762
04/05/2019 08:00,43.39,44091,1759,15,194,923,25,2916,2.815.654.762
04/05/2019 09:00,43.01,44348,1736,18,213,887,26,2880,2.815.654.762
04/05/2019 10:00,42.27,43931,1779,24,227,869,31,2930,2.815.654.762
04/05/2019 11:00,40.77,43423,1865,31,225,903,27,3051,2.815.654.762
04/05/2019 12:00,39.92,42973,1939,39,217,967,35,3197,2.815.654.762
04/05/2019 13:00,39.36,42580,1923,49,202,1032,33,3239,2.815.654.762
04/05/2019 14:00,38.86,42343,1821,58,180,1239,42,3340,2.815.654.762
04/05/2019 15:00,38.7,42488,1704,67,145,1316,45,3277,2.815.654.762
04/05/2019 16:00,40.25,43231,1583,80,118,1380,41,3202,2.815.654.762
04/05/2019 17:00,41.06,43721,1379,98,85,1449,39,3050,2.815.654.762
04/05/2019 18:00,42.51,43491,1108,121,62,1435,34,2760,2.815.654.762
04/05/2019 19:00,42.95,42883,826,139,41,1430,25,2461,2.815.654.762
04/05/2019 20:00,43.15,42770,608,153,38,1509,14,2322,2.815.654.762
04/05/2019 21:00,43.11,41802,543,166,37,1659,10,2415,2.815.654.762
04/05/2019 22:00,42.15,40353,523,174,32,1713,9,2451,2.815.654.762
04/05/2019 23:00,40.32,38593,612,166,0,1776,9,2563,2.815.654.762
05/05/2019 00:00,39.84,37928,709,174,0,1795,8,2686,2.815.654.762
05/05/2019 01:00,38.55,37560,779,182,0,1727,8,2696,2.815.654.762
05/05/2019 02:00,36.86,37434,793,188,0,1623,7,2611,2.815.654.762
05/05/2019 03:00,36.72,37414,874,190,0,1482,6,2552,2.815.654.762
05/05/2019 04:00,37.36,37448,953,187,0,1273,5,2418,2.815.654.762
05/05/2019 05:00,37.82,37712,1026,183,0,941,5,2155,2.815.654.762
05/05/2019 06:00,39.97,38616,1094,174,0,738,5,2011,2.815.654.762
05/05/2019 07:00,40.82,40233,1221,166,0,622,5,2014,2.815.654.762
05/05/2019 08:00,41.27,41327,1456,160,0,594,5,2215,2.815.654.762
05/05/2019 09:00,41.35,41815,1680,157,0,628,5,2470,2.815.654.762
05/05/2019 10:00,41.23,41806,1844,155,0,735,6,2740,2.815.654.762
05/05/2019 11:00,41.36,41405,2009,154,0,837,7,3007,2.815.654.762
05/05/2019 12:00,41.14,40986,2189,152,0,932,8,3281,2.815.654.762
05/05/2019 13:00,40.76,40607,2353,149,0,1061,8,3571,2.815.654.762
05/05/2019 14:00,40.52,40443,2496,147,0,1139,8,3790,2.815.654.762
05/05/2019 15:00,40.65,40582,2704,142,0,1241,7,4094,2.815.654.762
05/05/2019 16:00,41.14,41402,2889,136,0,1202,6,4233,2.815.654.762
05/05/2019 17:00,41.22,42087,2883,130,0,1149,6,4168,2.815.654.762
05/05/2019 18:00,41.74,42539,2801,125,0,1110,6,4042,2.815.654.762
05/05/2019 19:00,42.55,42544,2803,117,0,1157,6,4083,2.815.654.762
05/05/2019 20:00,42.54,42709,2802,107,0,1252,6,4167,2.815.654.762
05/05/2019 21:00,42.34,41750,2729,97,0,1341,7,4174,2.815.654.762
05/05/2019 22:00,41,39523,2732,85,0,1448,8,4273,2.815.654.762
05/05/2019 23:00,41.04,38794,2869,154,28,1674,13,4738,2.815.654.762
06/05/2019 00:00,39.95,38265,2760,152,22,1684,13,4631,2.914.642.857
06/05/2019 01:00,39.66,38234,2720,143,19,1652,13,4547,2.914.642.857
06/05/2019 02:00,39.31,38490,2702,134,19,1618,14,4487,2.914.642.857
06/05/2019 03:00,38.68,38897,2781,129,19,1631,13,4573,2.914.642.857
06/05/2019 04:00,41.74,40654,2757,134,19,1582,13,4505,2.914.642.857
06/05/2019 05:00,44.89,44146,2697,137,17,1535,13,4399,2.914.642.857
06/05/2019 06:00,48.95,47483,2759,141,15,1523,10,4448,2.914.642.857
06/05/2019 07:00,48.48,48708,2733,149,16,1547,10,4455,2.914.642.857
06/05/2019 08:00,46.28,48712,2953,158,18,1586,14,4729,2.914.642.857
06/05/2019 09:00,45.63,48442,3113,163,22,1645,16,4959,2.914.642.857
06/05/2019 10:00,45.39,47744,3294,165,25,1704,14,5202,2.914.642.857
06/05/2019 11:00,44.89,47205,3444,170,30,1824,12,5480,2.914.642.857
06/05/2019 12:00,44.04,46910,3560,174,35,1907,12,5688,2.914.642.857
06/05/2019 13:00,43.02,46555,3625,168,37,1981,12,5823,2.914.642.857
06/05/2019 14:00,42.05,46221,3648,157,48,2060,12,5925,2.914.642.857
06/05/2019 15:00,42.02,46058,3635,146,53,2102,12,5948,2.914.642.857
06/05/2019 16:00,43.48,46280,3663,131,55,2081,12,5942,2.914.642.857
06/05/2019 17:00,44.35,46252,3618,113,55,1976,10,5772,2.914.642.857
06/05/2019 18:00,44.34,46043,3469,95,59,1905,10,5538,2.914.642.857
06/05/2019 19:00,43.91,45575,3264,82,61,1892,9,5308,2.914.642.857
06/05/2019 20:00,44.07,45455,3140,74,62,1964,10,5250,2.914.642.857
06/05/2019 21:00,43.43,44175,3204,67,61,2044,14,5390,2.914.642.857
06/05/2019 22:00,41.89,41886,3222,57,59,2086,14,5438,2.914.642.857
06/05/2019 23:00,41.69,38954,3025,21,74,2045,12,5177,2.914.642.857
07/05/2019 00:00,40.55,38104,3016,26,76,2067,13,5198,2.914.642.857
07/05/2019 01:00,39.88,37959,2980,30,81,1991,13,5095,2.914.642.857
07/05/2019 02:00,39.96,38066,2920,34,84,1958,13,5009,2.914.642.857
07/05/2019 03:00,40.29,38473,3019,38,86,1959,13,5115,2.914.642.857
07/05/2019 04:00,42.64,40174,3017,40,87,2023,10,5177,2.914.642.857
07/05/2019 05:00,45.01,43676,2975,37,89,1971,10,5082,2.914.642.857
07/05/2019 06:00,46.88,47286,2953,34,101,1994,11,5093,2.914.642.857
07/05/2019 07:00,47.31,48100,2818,35,126,2064,15,5058,2.914.642.857
07/05/2019 08:00,46.27,47750,2861,36,153,2173,21,5244,2.914.642.857
07/05/2019 09:00,45.91,47563,2800,37,180,2289,24,5330,2.914.642.857
07/05/2019 10:00,45.29,47206,2821,36,200,2456,27,5540,2.914.642.857
07/05/2019 11:00,44.91,46718,2855,33,209,2481,27,5605,2.914.642.857
07/05/2019 12:00,44.5,46444,2882,30,215,2546,27,5700,2.914.642.857
07/05/2019 13:00,43.73,46033,2942,26,220,2620,29,5837,2.914.642.857
07/05/2019 14:00,43.31,45514,2961,24,220,2593,32,5830,2.914.642.857
07/05/2019 15:00,43.28,45284,2953,21,211,2587,29,5801,2.914.642.857
07/05/2019 16:00,43.95,45302,2879,20,193,2647,31,5770,2.914.642.857
07/05/2019 17:00,44.98,44996,2632,21,164,2329,27,5173,2.914.642.857
07/05/2019 18:00,45.52,44694,2245,22,132,2076,21,4496,2.914.642.857
07/05/2019 19:00,45.84,44286,1865,22,111,1940,19,3957,2.914.642.857
07/05/2019 20:00,45.8,44019,1534,22,113,1828,20,3517,2.914.642.857
07/05/2019 21:00,44.73,42632,1286,23,118,1952,21,3400,2.914.642.857
07/05/2019 22:00,43.28,40416,1109,21,123,2048,24,3325,2.914.642.857
07/05/2019 23:00,42.82,38620,642,22,0,2055,20,2739,2.914.642.857
08/05/2019 00:00,41.97,37847,559,19,0,2023,15,2616,2.914.642.857
08/05/2019 01:00,41.34,37572,460,16,0,1969,13,2458,2.914.642.857
08/05/2019 02:00,41.07,37646,469,15,0,1914,11,2409,2.914.642.857
08/05/2019 03:00,40.96,38134,477,14,0,1871,10,2372,2.914.642.857
08/05/2019 04:00,42.01,39594,444,12,0,1749,11,2216,2.914.642.857
08/05/2019 05:00,44.08,42758,402,11,0,1595,12,2020,2.914.642.857
08/05/2019 06:00,47.91,45786,402,11,0,1509,9,1931,2.914.642.857
08/05/2019 07:00,47.97,46916,425,13,0,1538,23,1999,2.914.642.857
08/05/2019 08:00,46.04,46768,518,18,0,1594,15,2145,2.914.642.857
08/05/2019 09:00,44.66,46687,634,24,0,1690,18,2366,2.914.642.857
08/05/2019 10:00,43.6,46446,738,33,0,1799,18,2588,2.914.642.857
08/05/2019 11:00,42.98,45905,872,42,0,1810,19,2743,2.914.642.857
08/05/2019 12:00,42.57,45498,1019,51,0,1873,20,2963,2.914.642.857
08/05/2019 13:00,42.04,45186,1159,58,0,1916,16,3149,2.914.642.857
08/05/2019 14:00,41.39,44748,1324,65,0,2036,13,3438,2.914.642.857
08/05/2019 15:00,41.16,44622,1527,68,0,2060,9,3664,2.914.642.857
08/05/2019 16:00,41.58,44927,1778,68,0,2047,9,3902,2.914.642.857
08/05/2019 17:00,41.85,44773,2046,65,0,2107,7,4225,2.914.642.857
08/05/2019 18:00,42.07,44336,2279,60,0,1941,5,4285,2.914.642.857
08/05/2019 19:00,41.6,43751,2500,64,0,1961,5,4530,2.914.642.857
08/05/2019 20:00,41.25,43601,2714,74,0,2196,7,4991,2.914.642.857
08/05/2019 21:00,41.11,42240,2919,89,0,2497,15,5520,2.914.642.857
08/05/2019 22:00,40.01,39944,2978,102,0,2707,23,5810,2.914.642.857
08/05/2019 23:00,40.79,38445,2543,99,191,2784,24,5641,2.914.642.857
09/05/2019 00:00,40.26,37757,2373,106,215,2872,25,5591,2.914.642.857
09/05/2019 01:00,39.96,37561,2175,106,233,2921,25,5460,2.914.642.857
09/05/2019 02:00,39.98,37819,1974,100,245,2936,29,5284,2.914.642.857
09/05/2019 03:00,40.09,38346,1808,92,258,2996,28,5182,2.914.642.857
09/05/2019 04:00,41.36,39931,1648,79,249,3031,27,5034,2.914.642.857
09/05/2019 05:00,43.45,42921,1436,66,223,3036,23,4784,2.914.642.857
09/05/2019 06:00,45,45868,1263,59,202,2921,16,4461,2.914.642.857
09/05/2019 07:00,45.82,46906,1096,61,221,2923,12,4313,2.914.642.857
09/05/2019 08:00,44.77,46761,1074,71,272,3130,14,4561,2.914.642.857
09/05/2019 09:00,44.29,46508,1031,84,303,3396,32,4846,2.914.642.857
09/05/2019 10:00,43.93,46240,1003,89,300,3593,40,5025,2.914.642.857
09/05/2019 11:00,43.95,45714,964,85,280,3787,40,5156,2.914.642.857
09/05/2019 12:00,43.9,45550,871,79,260,3888,38,5136,2.914.642.857
09/05/2019 13:00,43.84,45202,775,71,242,3896,35,5019,2.914.642.857
09/05/2019 14:00,43.68,44911,714,59,225,3863,29,4890,2.914.642.857
09/05/2019 15:00,43.62,44615,642,47,205,3769,23,4686,2.914.642.857
09/05/2019 16:00,43.63,44982,587,35,183,3645,20,4470,2.914.642.857
09/05/2019 17:00,43.47,44790,506,24,157,3461,17,4165,2.914.642.857
09/05/2019 18:00,43.6,44382,442,17,130,3354,14,3957,2.914.642.857
09/05/2019 19:00,43.68,44029,422,13,128,3197,19,3779,2.914.642.857
09/05/2019 20:00,43.72,43853,496,13,142,3070,23,3744,2.914.642.857
09/05/2019 21:00,43.46,42620,631,14,160,2921,27,3753,2.914.642.857
09/05/2019 22:00,42.73,40361,709,18,161,2796,29,3713,2.914.642.857
09/05/2019 23:00,41.3,37433,818,20,0,2634,19,3491,2.914.642.857
10/05/2019 00:00,40.5,36521,869,28,0,2488,16,3401,2.914.642.857
10/05/2019 01:00,39.53,36363,817,40,0,2278,16,3151,2.914.642.857
10/05/2019 02:00,38.84,36627,755,54,0,2054,15,2878,2.914.642.857
10/05/2019 03:00,39.57,37163,702,69,0,1966,16,2753,2.914.642.857
10/05/2019 04:00,41.31,38651,627,71,0,1781,14,2493,2.914.642.857
10/05/2019 05:00,43.31,41936,689,60,0,1468,14,2231,2.914.642.857
10/05/2019 06:00,45.85,45227,773,46,0,1153,9,1981,2.914.642.857
10/05/2019 07:00,46.65,46413,797,37,0,913,7,1754,2.914.642.857
10/05/2019 08:00,46.1,46236,888,37,0,819,7,1751,2.914.642.857
10/05/2019 09:00,45.62,46054,1050,39,0,865,7,1961,2.914.642.857
10/05/2019 10:00,44.81,45695,1211,43,0,971,7,2232,2.914.642.857
10/05/2019 11:00,43.52,45353,1437,52,0,1204,7,2700,2.914.642.857
10/05/2019 12:00,42.83,44723,1715,66,0,1355,6,3142,2.914.642.857
10/05/2019 13:00,42.21,44173,1984,84,0,1453,5,3526,2.914.642.857
10/05/2019 14:00,41.84,43807,2287,101,0,1354,5,3747,2.914.642.857
10/05/2019 15:00,42.03,43527,2493,114,0,1339,4,3950,2.914.642.857
10/05/2019 16:00,42.98,43562,2676,121,0,1311,4,4112,2.914.642.857
10/05/2019 17:00,43.77,43385,2706,125,0,1273,4,4108,2.914.642.857
10/05/2019 18:00,43.68,42874,2528,127,0,1264,5,3924,2.914.642.857
10/05/2019 19:00,43.41,41952,2369,131,0,1352,4,3856,2.914.642.857
10/05/2019 20:00,43.58,41583,2243,129,0,1287,4,3663,2.914.642.857
10/05/2019 21:00,43.35,40445,2227,121,0,1247,4,3599,2.914.642.857
10/05/2019 22:00,42.75,38670,2288,107,0,1193,5,3593,2.914.642.857
10/05/2019 23:00,42.47,35583,1622,49,37,1115,6,2829,2.914.642.857
11/05/2019 00:00,40.8,34679,1569,40,35,1063,7,2714,2.914.642.857
11/05/2019 01:00,39.69,34248,1463,35,31,1008,6,2543,2.914.642.857
11/05/2019 02:00,39.62,34003,1385,33,25,928,6,2377,2.914.642.857
11/05/2019 03:00,39.61,33846,1346,33,22,869,5,2275,2.914.642.857
11/05/2019 04:00,39.34,33977,1258,33,16,758,5,2070,2.914.642.857
11/05/2019 05:00,39.43,34715,1164,32,11,642,5,1854,2.914.642.857
11/05/2019 06:00,39.64,35998,1137,29,7,569,4,1746,2.914.642.857
11/05/2019 07:00,41.74,37709,1151,33,4,495,4,1687,2.914.642.857
11/05/2019 08:00,42.44,38735,1179,36,5,461,4,1685,2.914.642.857
11/05/2019 09:00,42.22,39227,1194,48,8,436,4,1690,2.914.642.857
11/05/2019 10:00,41.93,38962,1244,59,14,479,4,1800,2.914.642.857
11/05/2019 11:00,41.16,38456,1376,62,27,548,5,2018,2.914.642.857
11/05/2019 12:00,40.42,38123,1577,62,38,655,5,2337,2.914.642.857
11/05/2019 13:00,40.25,37734,1770,56,57,707,6,2596,2.914.642.857
11/05/2019 14:00,39.7,37586,1981,49,69,745,6,2850,2.914.642.857
11/05/2019 15:00,39.72,37854,2194,45,81,801,5,3126,2.914.642.857
11/05/2019 16:00,40.19,38612,2340,44,83,876,6,3349,2.914.642.857
11/05/2019 17:00,40.24,39047,2411,43,82,978,5,3519,2.914.642.857
11/05/2019 18:00,40.85,38918,2374,45,82,1078,5,3584,2.914.642.857
11/05/2019 19:00,40.24,38465,2276,53,75,1250,5,3659,2.914.642.857
11/05/2019 20:00,41.04,38419,2234,60,64,1602,4,3964,2.914.642.857
11/05/2019 21:00,40.9,37695,2358,64,57,1957,4,4440,2.914.642.857
11/05/2019 22:00,40.59,36404,2461,59,49,2198,4,4771,2.914.642.857
11/05/2019 23:00,38.93,35083,2596,60,0,2522,4,5182,2.914.642.857
12/05/2019 00:00,37.95,34233,2599,53,0,2831,4,5487,2.914.642.857
12/05/2019 01:00,34.87,33826,2630,45,0,3138,4,5817,2.914.642.857
12/05/2019 02:00,28.88,33731,2586,39,0,3303,4,5932,2.914.642.857
12/05/2019 03:00,27.96,33692,2602,32,0,3543,4,6181,2.914.642.857
12/05/2019 04:00,28.26,33730,2567,28,0,3746,4,6345,2.914.642.857
12/05/2019 05:00,30.93,34124,2480,23,0,3785,4,6292,2.914.642.857
12/05/2019 06:00,34.41,35207,2347,20,0,3713,4,6084,2.914.642.857
12/05/2019 07:00,36.31,36894,2206,20,0,3800,4,6030,2.914.642.857
12/05/2019 08:00,37.6,38192,2185,21,0,3894,4,6104,2.914.642.857
12/05/2019 09:00,36.96,38916,2132,24,0,3951,4,6111,2.914.642.857
12/05/2019 10:00,36.32,39092,2177,27,0,4035,4,6243,2.914.642.857
12/05/2019 11:00,35.91,38822,2206,28,0,4115,4,6353,2.914.642.857
12/05/2019 12:00,24.05,38567,2233,27,0,4146,4,6410,2.914.642.857
12/05/2019 13:00,19.92,38335,2266,26,0,4179,3,6474,2.914.642.857
12/05/2019 14:00,16.28,38179,2304,23,0,4159,3,6489,2.914.642.857
12/05/2019 15:00,20.62,38285,2374,19,0,4106,4,6503,2.914.642.857
12/05/2019 16:00,35.95,38953,2403,15,0,3988,4,6410,2.914.642.857
12/05/2019 17:00,38.89,39537,2376,12,0,3833,4,6225,2.914.642.857
12/05/2019 18:00,38.54,40000,2258,11,0,3663,4,5936,2.914.642.857
12/05/2019 19:00,38.74,39985,2069,10,0,3550,4,5633,2.914.642.857
12/05/2019 20:00,39.61,40163,1931,11,0,3471,4,5417,2.914.642.857
12/05/2019 21:00,39.75,39382,1905,12,0,3484,5,5406,2.914.642.857
12/05/2019 22:00,39.5,37762,1925,13,0,3488,6,5432,2.914.642.857
12/05/2019 23:00,39.73,36409,1843,101,91,3418,2,5455,2.914.642.857
13/05/2019 00:00,39.21,35853,1864,93,96,3362,3,5418,3.139.107.143
13/05/2019 01:00,38.37,35802,1857,85,100,3316,3,5361,3.139.107.143
13/05/2019 02:00,38.6,35902,1768,75,103,3256,2,5204,3.139.107.143
13/05/2019 03:00,38.78,36290,1646,67,109,3169,3,4994,3.139.107.143
13/05/2019 04:00,39.79,37941,1615,55,109,3028,4,4811,3.139.107.143
13/05/2019 05:00,42.5,41597,1539,38,108,2857,8,4550,3.139.107.143
13/05/2019 06:00,43.86,45299,1416,24,106,2678,7,4231,3.139.107.143
13/05/2019 07:00,44.82,46467,1389,16,107,2639,8,4159,3.139.107.143
13/05/2019 08:00,43.92,46424,1383,13,108,2493,16,4013,3.139.107.143
13/05/2019 09:00,43.08,46160,1458,14,114,2384,7,3977,3.139.107.143
13/05/2019 10:00,42.42,45447,1532,15,125,2430,8,4110,3.139.107.143
13/05/2019 11:00,41.99,44829,1525,18,136,2387,7,4073,3.139.107.143
13/05/2019 12:00,41.98,44636,1567,19,147,2377,12,4122,3.139.107.143
13/05/2019 13:00,41.5,44151,1531,19,161,2356,11,4078,3.139.107.143
13/05/2019 14:00,41.43,43636,1412,16,167,2366,13,3974,3.139.107.143
13/05/2019 15:00,41.38,43393,1319,15,169,2319,14,3836,3.139.107.143
13/05/2019 16:00,42.14,43467,1314,18,172,2202,18,3724,3.139.107.143
13/05/2019 17:00,43.17,43257,1226,23,176,2008,23,3456,3.139.107.143
13/05/2019 18:00,43.68,42893,1065,30,182,1759,25,3061,3.139.107.143
13/05/2019 19:00,43.78,42253,964,32,180,1576,25,2777,3.139.107.143
13/05/2019 20:00,43.63,42013,936,34,171,1622,27,2790,3.139.107.143
13/05/2019 21:00,43.5,40949,895,35,163,1684,26,2803,3.139.107.143
13/05/2019 22:00,42.08,38872,779,32,158,1818,26,2813,3.139.107.143
13/05/2019 23:00,40.73,37066,666,15,141,1834,15,2671,3.139.107.143
14/05/2019 00:00,40.06,36235,560,19,151,1879,16,2625,3.139.107.143
14/05/2019 01:00,39.73,36058,402,21,155,1799,17,2394,3.139.107.143
14/05/2019 02:00,39.84,36058,293,24,155,1650,18,2140,3.139.107.143
14/05/2019 03:00,39.97,36426,206,24,155,1590,18,1993,3.139.107.143
14/05/2019 04:00,41.59,38063,155,22,150,1373,17,1717,3.139.107.143
14/05/2019 05:00,43.62,41890,105,21,149,1091,14,1380,3.139.107.143
14/05/2019 06:00,47.03,45685,73,21,149,897,17,1157,3.139.107.143
14/05/2019 07:00,48.4,46555,61,22,150,746,26,1005,3.139.107.143
14/05/2019 08:00,45.53,45975,63,25,155,754,14,1011,3.139.107.143
14/05/2019 09:00,43.9,45859,76,30,166,828,15,1115,3.139.107.143
14/05/2019 10:00,43.69,45436,96,36,169,905,17,1223,3.139.107.143
14/05/2019 11:00,43.61,44853,122,41,162,1020,18,1363,3.139.107.143
14/05/2019 12:00,43.35,44529,149,51,157,1144,18,1519,3.139.107.143
14/05/2019 13:00,42.84,43965,182,61,156,1241,18,1658,3.139.107.143
14/05/2019 14:00,42.18,43482,225,71,159,1292,17,1764,3.139.107.143
14/05/2019 15:00,41.95,43060,275,79,164,1307,21,1846,3.139.107.143
14/05/2019 16:00,42.34,43066,314,83,171,1220,22,1810,3.139.107.143
14/05/2019 17:00,43.23,42676,321,86,177,974,20,1578,3.139.107.143
14/05/2019 18:00,43.71,42356,299,87,183,872,13,1454,3.139.107.143
14/05/2019 19:00,43.96,41787,258,91,185,784,9,1327,3.139.107.143
14/05/2019 20:00,43.68,41353,221,101,179,813,9,1323,3.139.107.143
14/05/2019 21:00,43.28,40164,224,112,173,902,13,1424,3.139.107.143
14/05/2019 22:00,41.48,37954,215,118,170,935,13,1451,3.139.107.143
14/05/2019 23:00,40.29,36591,95,94,184,914,19,1306,3.139.107.143
15/05/2019 00:00,39.72,35811,88,95,188,855,18,1244,3.139.107.143
15/05/2019 01:00,39.4,35534,86,92,191,811,15,1195,3.139.107.143
15/05/2019 02:00,39.52,35480,83,90,200,725,15,1113,3.139.107.143
15/05/2019 03:00,39.06,35730,90,88,209,661,15,1063,3.139.107.143
15/05/2019 04:00,40.92,36993,102,84,206,551,15,958,3.139.107.143
15/05/2019 05:00,42.77,40034,114,78,192,449,14,847,3.139.107.143
15/05/2019 06:00,47.09,42855,123,71,184,323,8,709,3.139.107.143
15/05/2019 07:00,47.92,43916,122,66,182,293,10,673,3.139.107.143
15/05/2019 08:00,45.79,43615,117,63,187,294,15,676,3.139.107.143
15/05/2019 09:00,44.4,43401,125,64,193,282,23,687,3.139.107.143
15/05/2019 10:00,43.45,43091,140,62,201,324,27,754,3.139.107.143
15/05/2019 11:00,43.07,42565,174,59,219,354,26,832,3.139.107.143
15/05/2019 12:00,42.86,42225,222,57,236,430,27,972,3.139.107.143
15/05/2019 13:00,42.62,41926,275,58,248,497,26,1104,3.139.107.143
15/05/2019 14:00,42.33,41669,360,59,261,582,26,1288,3.139.107.143
15/05/2019 15:00,42.15,41521,463,62,271,688,27,1511,3.139.107.143
15/05/2019 16:00,42.33,41710,546,62,282,758,26,1674,3.139.107.143
15/05/2019 17:00,42.79,41556,599,59,289,728,22,1697,3.139.107.143
15/05/2019 18:00,43.05,41190,598,53,299,743,15,1708,3.139.107.143
15/05/2019 19:00,42.88,40679,639,48,311,790,14,1802,3.139.107.143
15/05/2019 20:00,42.47,40452,694,49,319,925,19,2006,3.139.107.143
15/05/2019 21:00,42.14,39380,735,53,323,1075,23,2209,3.139.107.143
15/05/2019 22:00,39.82,37300,738,53,322,1217,22,2352,3.139.107.143
15/05/2019 23:00,37.2,35530,762,50,325,1298,22,2457,3.139.107.143
16/05/2019 00:00,36.65,34795,707,49,326,1267,23,2372,3.139.107.143
16/05/2019 01:00,36.08,34542,790,46,326,1294,23,2479,3.139.107.143
16/05/2019 02:00,35.74,34647,974,42,330,1336,23,2705,3.139.107.143
16/05/2019 03:00,35.45,34977,1123,36,333,1410,23,2925,3.139.107.143
16/05/2019 04:00,38.06,36270,1293,28,324,1418,23,3086,3.139.107.143
16/05/2019 05:00,41.82,39003,1410,18,309,1353,21,3111,3.139.107.143
16/05/2019 06:00,42.97,41930,1439,11,298,1277,15,3040,3.139.107.143
16/05/2019 07:00,44.24,42834,1523,8,298,1228,17,3074,3.139.107.143
16/05/2019 08:00,43.75,42634,1753,8,321,1269,17,3368,3.139.107.143
16/05/2019 09:00,43.02,42513,2024,11,343,1371,19,3768,3.139.107.143
16/05/2019 10:00,42.73,42285,2223,14,363,1552,27,4179,3.139.107.143
16/05/2019 11:00,42,41832,2307,18,371,1678,32,4406,3.139.107.143
16/05/2019 12:00,41.5,41719,2366,24,374,1791,36,4591,3.139.107.143
16/05/2019 13:00,40.72,41433,2389,27,374,1884,37,4711,3.139.107.143
16/05/2019 14:00,40.25,41228,2432,28,368,1917,36,4781,3.139.107.143
16/05/2019 15:00,39.33,41016,2476,30,359,1972,34,4871,3.139.107.143
16/05/2019 16:00,40.34,41316,2530,30,353,2032,34,4979,3.139.107.143
16/05/2019 17:00,41.04,41082,2521,30,347,2016,26,4940,3.139.107.143
16/05/2019 18:00,41.59,40877,2500,31,347,2009,19,4906,3.139.107.143
16/05/2019 19:00,41.1,40495,2530,31,347,2044,18,4970,3.139.107.143
16/05/2019 20:00,40.78,40095,2650,30,349,2096,23,5148,3.139.107.143
16/05/2019 21:00,39.46,39116,2829,28,355,2154,25,5391,3.139.107.143
16/05/2019 22:00,36.64,37056,2921,24,362,2201,30,5538,3.139.107.143
16/05/2019 23:00,35.85,34416,2809,28,349,2182,35,5403,3.139.107.143
17/05/2019 00:00,35.36,33867,2783,26,370,2094,33,5306,3.139.107.143
17/05/2019 01:00,33.13,33822,2795,28,378,2068,32,5301,3.139.107.143
17/05/2019 02:00,32.78,33821,2768,31,384,2092,31,5306,3.139.107.143
17/05/2019 03:00,29.98,33924,2716,35,382,2173,31,5337,3.139.107.143
17/05/2019 04:00,36.69,34767,2623,31,386,2127,31,5198,3.139.107.143
17/05/2019 05:00,40.66,36603,2609,23,383,2011,30,5056,3.139.107.143
17/05/2019 06:00,42.1,38709,2563,12,376,1916,28,4895,3.139.107.143
17/05/2019 07:00,42.4,39724,2546,7,372,1869,24,4818,3.139.107.143
17/05/2019 08:00,42.2,40057,2587,5,366,1900,27,4885,3.139.107.143
17/05/2019 09:00,42.03,40334,2532,6,363,2076,33,5010,3.139.107.143
17/05/2019 10:00,41.82,40246,2495,8,359,2245,37,5144,3.139.107.143
17/05/2019 11:00,41.62,39952,2485,13,352,2356,39,5245,3.139.107.143
17/05/2019 12:00,41.08,39430,2533,17,338,2498,33,5419,3.139.107.143
17/05/2019 13:00,39.15,39135,2483,21,331,2599,28,5462,3.139.107.143
17/05/2019 14:00,38.5,38942,2372,24,322,2621,34,5373,3.139.107.143
17/05/2019 15:00,39.11,38726,2268,24,307,2556,23,5178,3.139.107.143
17/05/2019 16:00,40.66,38815,2247,23,290,2459,15,5034,3.139.107.143
17/05/2019 17:00,41.61,38771,2175,23,283,2399,15,4895,3.139.107.143
17/05/2019 18:00,41.64,38449,2041,25,282,2355,17,4720,3.139.107.143
17/05/2019 19:00,41.17,37842,1907,30,280,2354,18,4589,3.139.107.143
17/05/2019 20:00,41.11,37713,1727,34,282,2407,20,4470,3.139.107.143
17/05/2019 21:00,40.73,37242,1583,36,279,2444,21,4363,3.139.107.143
17/05/2019 22:00,39.63,36079,1443,36,272,2468,21,4240,3.139.107.143
17/05/2019 23:00,37.72,34112,1178,26,213,2323,19,3759,3.139.107.143
18/05/2019 00:00,35.97,33314,993,22,200,2206,18,3439,3.139.107.143
18/05/2019 01:00,33,33016,835,19,188,2076,19,3137,3.139.107.143
18/05/2019 02:00,31.25,32891,802,15,176,1962,20,2975,3.139.107.143
18/05/2019 03:00,30.4,32675,771,11,161,1808,19,2770,3.139.107.143
18/05/2019 04:00,31.14,32693,774,8,148,1658,18,2606,3.139.107.143
18/05/2019 05:00,33.8,32404,835,5,132,1401,16,2389,3.139.107.143
18/05/2019 06:00,35.63,33336,860,4,121,1138,17,2140,3.139.107.143
18/05/2019 07:00,38.36,34929,855,5,119,948,14,1941,3.139.107.143
18/05/2019 08:00,38.76,35926,843,7,131,862,11,1854,3.139.107.143
18/05/2019 09:00,38.28,36302,852,10,144,794,13,1813,3.139.107.143
18/05/2019 10:00,37.27,35983,893,14,151,768,14,1840,3.139.107.143
18/05/2019 11:00,36.26,35452,941,21,152,790,16,1920,3.139.107.143
18/05/2019 12:00,35.49,35100,1010,30,152,866,16,2074,3.139.107.143
18/05/2019 13:00,34.54,34774,1083,36,145,871,12,2147,3.139.107.143
18/05/2019 14:00,34.32,34600,1116,44,124,845,10,2139,3.139.107.143
18/05/2019 15:00,35.32,34705,1135,51,99,823,9,2117,3.139.107.143
18/05/2019 16:00,36.91,35342,1147,55,92,835,8,2137,3.139.107.143
18/05/2019 17:00,40.05,35649,1148,56,102,858,10,2174,3.139.107.143
18/05/2019 18:00,40.5,35390,1126,58,112,875,13,2184,3.139.107.143
18/05/2019 19:00,40.38,34856,1083,61,123,932,18,2217,3.139.107.143
18/05/2019 20:00,40.45,34773,1104,67,135,1060,22,2388,3.139.107.143
18/05/2019 21:00,39.89,34606,1103,73,146,1217,18,2557,3.139.107.143
18/05/2019 22:00,38.92,33581,1061,75,152,1200,14,2502,3.139.107.143
18/05/2019 23:00,38.86,31873,1022,92,148,1059,16,2337,3.139.107.143
19/05/2019 00:00,36.24,31057,901,86,146,930,12,2075,3.139.107.143
19/05/2019 01:00,35,30653,834,82,150,851,14,1931,3.139.107.143
19/05/2019 02:00,34.03,30430,775,77,159,800,17,1828,3.139.107.143
19/05/2019 03:00,34.3,30282,705,72,164,782,19,1742,3.139.107.143
19/05/2019 04:00,34.03,30224,664,67,159,713,18,1621,3.139.107.143
19/05/2019 05:00,33.37,30530,666,62,137,615,14,1494,3.139.107.143
19/05/2019 06:00,34.04,31503,670,58,125,565,10,1428,3.139.107.143
19/05/2019 07:00,36.23,33003,680,54,121,488,5,1348,3.139.107.143
19/05/2019 08:00,36.8,34186,639,51,125,406,5,1226,3.139.107.143
19/05/2019 09:00,37.18,34831,595,51,136,330,3,1115,3.139.107.143
19/05/2019 10:00,37.88,34981,623,49,153,295,5,1125,3.139.107.143
19/05/2019 11:00,37.4,34787,668,45,176,325,8,1222,3.139.107.143
19/05/2019 12:00,36.83,34487,741,39,199,380,9,1368,3.139.107.143
19/05/2019 13:00,36.25,34209,785,32,210,434,12,1473,3.139.107.143
19/05/2019 14:00,35.85,34119,819,25,197,519,14,1574,3.139.107.143
19/05/2019 15:00,36.22,34303,853,20,186,610,13,1682,3.139.107.143
19/05/2019 16:00,37.13,34948,887,17,181,654,14,1753,3.139.107.143
19/05/2019 17:00,38.9,35415,880,12,183,649,10,1734,3.139.107.143
19/05/2019 18:00,40.93,35694,886,9,194,704,12,1805,3.139.107.143
19/05/2019 19:00,40.98,35602,883,9,210,822,14,1938,3.139.107.143
19/05/2019 20:00,40.72,35635,868,10,229,865,17,1989,3.139.107.143
19/05/2019 21:00,40.85,34975,858,11,238,895,27,2029,3.139.107.143
19/05/2019 22:00,38.92,33521,787,12,238,969,27,2033,3.139.107.143
19/05/2019 23:00,37.3,32088,704,36,270,954,23,1987,3.139.107.143
20/05/2019 00:00,35,31427,637,37,274,937,20,1905,3.722.202.381
20/05/2019 01:00,34.55,31309,519,37,273,894,21,1744,3.722.202.381
20/05/2019 02:00,34.13,31360,454,38,264,835,17,1608,3.722.202.381
20/05/2019 03:00,33.78,31649,409,38,254,820,14,1535,3.722.202.381
20/05/2019 04:00,38.13,33221,340,34,241,876,15,1506,3.722.202.381
20/05/2019 05:00,42.53,36844,300,24,228,766,17,1335,3.722.202.381
20/05/2019 06:00,43.88,40313,282,16,220,693,15,1226,3.722.202.381
20/05/2019 07:00,46.02,41488,255,14,221,655,11,1156,3.722.202.381
20/05/2019 08:00,45.07,41608,289,17,228,614,9,1157,3.722.202.381
20/05/2019 09:00,44.97,41542,333,23,242,579,6,1183,3.722.202.381
20/05/2019 10:00,44.78,40996,376,29,255,521,8,1189,3.722.202.381
20/05/2019 11:00,44.82,40445,436,35,265,508,7,1251,3.722.202.381
20/05/2019 12:00,44.37,40285,496,40,272,491,10,1309,3.722.202.381
20/05/2019 13:00,43.92,39999,533,44,275,464,11,1327,3.722.202.381
20/05/2019 14:00,43.19,39643,580,46,268,419,9,1322,3.722.202.381
20/05/2019 15:00,42.91,39436,637,48,259,389,7,1340,3.722.202.381
20/05/2019 16:00,43.47,39376,681,49,249,411,5,1395,3.722.202.381
20/05/2019 17:00,43.63,39020,696,50,233,405,5,1389,3.722.202.381
20/05/2019 18:00,43.54,38804,719,52,218,467,5,1461,3.722.202.381
20/05/2019 19:00,42.78,38215,749,55,225,536,9,1574,3.722.202.381
20/05/2019 20:00,42.68,37803,764,59,235,664,11,1733,3.722.202.381
20/05/2019 21:00,42.34,36738,827,63,246,722,17,1875,3.722.202.381
20/05/2019 22:00,38.57,34719,878,61,246,740,16,1941,3.722.202.381
20/05/2019 23:00,35.2,32657,961,85,232,800,21,2099,3.722.202.381
21/05/2019 00:00,34.44,31611,996,86,224,834,17,2157,3.722.202.381
21/05/2019 01:00,33.12,31239,898,85,211,834,10,2038,3.722.202.381
21/05/2019 02:00,31.49,31116,804,82,206,863,10,1965,3.722.202.381
21/05/2019 03:00,32.37,31252,754,78,200,870,7,1909,3.722.202.381
21/05/2019 04:00,35.38,32688,715,68,187,854,5,1829,3.722.202.381
21/05/2019 05:00,40.95,36369,698,50,168,724,5,1645,3.722.202.381
21/05/2019 06:00,43.4,40141,602,35,153,647,3,1440,3.722.202.381
21/05/2019 07:00,43.9,41264,520,29,152,573,3,1277,3.722.202.381
21/05/2019 08:00,43.71,40867,510,29,166,557,4,1266,3.722.202.381
21/05/2019 09:00,43.65,40888,527,32,170,559,5,1293,3.722.202.381
21/05/2019 10:00,43.47,40693,525,36,179,562,5,1307,3.722.202.381
21/05/2019 11:00,43.4,40404,502,40,189,579,7,1317,3.722.202.381
21/05/2019 12:00,43.2,40164,487,45,194,633,6,1365,3.722.202.381
21/05/2019 13:00,42.8,39834,476,44,190,669,5,1384,3.722.202.381
21/05/2019 14:00,42.06,39605,496,38,172,676,5,1387,3.722.202.381
21/05/2019 15:00,41.42,39289,494,32,156,710,5,1397,3.722.202.381
21/05/2019 16:00,41.92,39325,504,29,142,740,4,1419,3.722.202.381
21/05/2019 17:00,42.33,38973,528,31,129,784,3,1475,3.722.202.381
21/05/2019 18:00,42.19,38677,571,37,117,798,5,1528,3.722.202.381
21/05/2019 19:00,41.4,38075,601,46,118,855,7,1627,3.722.202.381
21/05/2019 20:00,41.12,37533,613,55,128,996,10,1802,3.722.202.381
21/05/2019 21:00,40.19,36324,616,66,137,1170,12,2001,3.722.202.381
21/05/2019 22:00,36.35,34066,645,69,136,1265,12,2127,3.722.202.381
21/05/2019 23:00,32.66,32420,1023,61,134,1204,11,2433,3.722.202.381
22/05/2019 00:00,32.5,31486,1074,60,125,1125,9,2393,3.722.202.381
22/05/2019 01:00,29.81,31162,1130,58,118,1043,7,2356,3.722.202.381
22/05/2019 02:00,29.09,31156,1219,56,113,946,6,2340,3.722.202.381
22/05/2019 03:00,29.76,31384,1344,51,110,854,6,2365,3.722.202.381
22/05/2019 04:00,35.2,32807,1499,42,95,751,6,2393,3.722.202.381
22/05/2019 05:00,40.09,36118,1655,29,69,597,15,2365,3.722.202.381
22/05/2019 06:00,42.45,39524,1734,18,42,547,14,2355,3.722.202.381
22/05/2019 07:00,43.27,40836,1855,13,35,464,6,2373,3.722.202.381
22/05/2019 08:00,43.51,40819,2001,10,37,409,6,2463,3.722.202.381
22/05/2019 09:00,42.8,40801,2057,9,40,395,3,2504,3.722.202.381
22/05/2019 10:00,42.37,40723,2128,8,42,399,3,2580,3.722.202.381
22/05/2019 11:00,41.37,40366,2234,8,37,464,4,2747,3.722.202.381
22/05/2019 12:00,40.78,40129,2333,10,31,543,6,2923,3.722.202.381
22/05/2019 13:00,39.92,39875,2409,10,26,622,8,3075,3.722.202.381
22/05/2019 14:00,38.64,39606,2535,11,23,771,9,3349,3.722.202.381
22/05/2019 15:00,38.69,39452,2608,12,22,1021,22,3685,3.722.202.381
22/05/2019 16:00,40.03,39680,2605,12,21,1225,8,3871,3.722.202.381
22/05/2019 17:00,41.28,39475,2528,14,20,1401,5,3968,3.722.202.381
22/05/2019 18:00,41.81,39068,2336,17,18,1621,6,3998,3.722.202.381
22/05/2019 19:00,41.42,38390,2084,21,19,1889,4,4017,3.722.202.381
22/05/2019 20:00,41.15,37910,1750,25,19,1962,4,3760,3.722.202.381
22/05/2019 21:00,40.61,36906,1606,28,20,2233,4,3891,3.722.202.381
22/05/2019 22:00,38.89,34659,1532,29,19,2399,4,3983,3.722.202.381
22/05/2019 23:00,34.94,33056,1362,21,15,2522,2,3922,3.722.202.381
23/05/2019 00:00,32.52,32160,1332,20,11,2513,3,3879,3.722.202.381
23/05/2019 01:00,31.59,31797,1213,19,12,2466,3,3713,3.722.202.381
23/05/2019 02:00,31.08,31777,1117,20,12,2402,2,3553,3.722.202.381
23/05/2019 03:00,31.74,32048,1032,19,12,2332,2,3397,3.722.202.381
23/05/2019 04:00,35.72,33572,905,16,11,2230,2,3164,3.722.202.381
23/05/2019 05:00,40.2,36964,888,10,10,2021,2,2931,3.722.202.381
23/05/2019 06:00,41.92,40625,906,6,10,1901,1,2824,3.722.202.381
23/05/2019 07:00,42.2,41963,997,4,11,1841,1,2854,3.722.202.381
23/05/2019 08:00,40.89,41912,1223,5,17,1697,1,2943,3.722.202.381
23/05/2019 09:00,39.49,41932,1434,6,24,1658,1,3123,3.722.202.381
23/05/2019 10:00,39.06,41756,1577,8,34,1566,2,3187,3.722.202.381
23/05/2019 11:00,38.67,41371,1712,10,53,1509,2,3286,3.722.202.381
23/05/2019 12:00,38.64,41237,1832,12,66,1499,2,3411,3.722.202.381
23/05/2019 13:00,39.02,40986,1871,16,77,1428,5,3397,3.722.202.381
23/05/2019 14:00,39.02,40826,1849,18,85,1448,7,3407,3.722.202.381
23/05/2019 15:00,39.2,40658,1798,20,93,1403,9,3323,3.722.202.381
23/05/2019 16:00,40.95,40880,1703,21,96,1421,6,3247,3.722.202.381
23/05/2019 17:00,41.58,40540,1553,20,98,1386,5,3062,3.722.202.381
23/05/2019 18:00,41.78,40320,1381,22,101,1309,3,2816,3.722.202.381
23/05/2019 19:00,41.37,39827,1263,23,100,1317,3,2706,3.722.202.381
23/05/2019 20:00,41.49,39401,1126,27,96,1321,3,2573,3.722.202.381
23/05/2019 21:00,40.96,38463,1095,32,92,1339,3,2561,3.722.202.381
23/05/2019 22:00,40.1,36230,1123,33,91,1360,3,2610,3.722.202.381
23/05/2019 23:00,37.54,33825,1303,12,79,1389,3,2786,3.722.202.381
24/05/2019 00:00,35.14,32793,1409,12,71,1353,3,2848,3.722.202.381
24/05/2019 01:00,34.28,32536,1526,14,62,1407,3,3012,3.722.202.381
24/05/2019 02:00,34.1,32558,1733,19,54,1476,6,3288,3.722.202.381
24/05/2019 03:00,33.95,32839,1900,28,43,1398,6,3375,3.722.202.381
24/05/2019 04:00,36.02,34296,1982,35,36,1320,3,3376,3.722.202.381
24/05/2019 05:00,39.79,37659,2047,42,32,1116,2,3239,3.722.202.381
24/05/2019 06:00,42.5,41128,1996,52,28,1088,2,3166,3.722.202.381
24/05/2019 07:00,43.08,42718,1998,60,28,1159,1,3246,3.722.202.381
24/05/2019 08:00,42.84,42744,2056,69,29,1312,1,3467,3.722.202.381
24/05/2019 09:00,42.05,42758,2085,80,32,1476,1,3674,3.722.202.381
24/05/2019 10:00,39.8,42399,2193,87,41,1632,1,3954,3.722.202.381
24/05/2019 11:00,38.82,41884,2320,90,57,1746,3,4216,3.722.202.381
24/05/2019 12:00,37.46,41194,2499,94,72,1807,4,4476,3.722.202.381
24/05/2019 13:00,36.59,40634,2520,97,85,1779,4,4485,3.722.202.381
24/05/2019 14:00,36.21,40137,2462,99,88,1712,6,4367,3.722.202.381
24/05/2019 15:00,36.58,39865,2422,98,85,1540,6,4151,3.722.202.381
24/05/2019 16:00,37.96,39832,2394,96,76,1431,7,4004,3.722.202.381
24/05/2019 17:00,40.03,39528,2300,96,58,1301,6,3761,3.722.202.381
24/05/2019 18:00,40.46,39005,2158,96,42,1234,5,3535,3.722.202.381
24/05/2019 19:00,39.77,38014,2049,95,37,1196,7,3384,3.722.202.381
24/05/2019 20:00,39.4,37516,1900,92,37,1154,11,3194,3.722.202.381
24/05/2019 21:00,38.78,36779,1838,87,43,1138,14,3120,3.722.202.381
24/05/2019 22:00,37.92,35267,1851,80,54,1194,16,3195,3.722.202.381
24/05/2019 23:00,38.1,33563,2042,69,0,1303,16,3430,3.722.202.381
25/05/2019 00:00,36.26,32576,1933,69,0,1364,16,3382,3.722.202.381
25/05/2019 01:00,35.07,32030,1847,67,0,1390,16,3320,3.722.202.381
25/05/2019 02:00,34.03,31643,1854,64,0,1372,13,3303,3.722.202.381
25/05/2019 03:00,33.84,31436,1852,60,0,1337,12,3261,3.722.202.381
25/05/2019 04:00,33.09,31583,1791,54,0,1294,7,3146,3.722.202.381
25/05/2019 05:00,34.05,32439,1878,43,0,1201,6,3128,3.722.202.381
25/05/2019 06:00,35.11,33832,1963,31,0,1149,10,3153,3.722.202.381
25/05/2019 07:00,37.28,35683,2041,26,0,1104,8,3179,3.722.202.381
25/05/2019 08:00,37.5,36911,2099,26,0,982,10,3117,3.722.202.381
25/05/2019 09:00,36.37,37502,2139,30,0,910,11,3090,3.722.202.381
25/05/2019 10:00,35.89,37504,2208,34,0,862,18,3122,3.722.202.381
25/05/2019 11:00,35.36,37156,2255,38,0,856,19,3168,3.722.202.381
25/05/2019 12:00,34.16,36846,2331,43,0,860,19,3253,3.722.202.381
25/05/2019 13:00,33.08,36473,2419,51,0,881,20,3371,3.722.202.381
25/05/2019 14:00,32.36,36182,2633,56,0,900,16,3605,3.722.202.381
25/05/2019 15:00,33.11,36241,2831,58,0,997,16,3902,3.722.202.381
25/05/2019 16:00,35.11,36919,3013,60,0,1095,11,4179,3.722.202.381
25/05/2019 17:00,36.56,37247,3106,64,0,1184,10,4364,3.722.202.381
25/05/2019 18:00,37.8,36936,3113,71,0,1298,8,4490,3.722.202.381
25/05/2019 19:00,36.99,36201,3070,79,0,1471,5,4625,3.722.202.381
25/05/2019 20:00,36.82,35956,2988,87,0,1704,7,4786,3.722.202.381
25/05/2019 21:00,36.53,35438,3030,92,0,1913,7,5042,3.722.202.381
25/05/2019 22:00,35.61,34287,3096,90,0,2032,5,5223,3.722.202.381
25/05/2019 23:00,35.53,33353,2850,87,97,2103,3,5140,3.722.202.381
26/05/2019 00:00,32.75,32396,2750,87,107,2199,5,5148,3.722.202.381
26/05/2019 01:00,29.44,31874,2652,87,121,2300,7,5167,3.722.202.381
26/05/2019 02:00,28.59,31619,2561,88,139,2410,10,5208,3.722.202.381
26/05/2019 03:00,23.39,31452,2533,85,153,2529,10,5310,3.722.202.381
26/05/2019 04:00,18.45,31537,2514,72,170,2599,14,5369,3.722.202.381
26/05/2019 05:00,14.98,32007,2435,53,194,2709,19,5410,3.722.202.381
26/05/2019 06:00,18.91,33182,2262,33,233,2778,20,5326,3.722.202.381
26/05/2019 07:00,25.07,34806,2149,24,279,2878,31,5361,3.722.202.381
26/05/2019 08:00,28.51,36304,2146,21,335,2974,36,5512,3.722.202.381
26/05/2019 09:00,30.68,37170,2164,22,374,3123,41,5724,3.722.202.381
26/05/2019 10:00,32.35,37558,2203,23,402,3213,40,5881,3.722.202.381
26/05/2019 11:00,31.48,37539,2121,23,413,3353,40,5950,3.722.202.381
26/05/2019 12:00,28.55,37211,2031,24,419,3393,44,5911,3.722.202.381
26/05/2019 13:00,27.52,37009,1860,22,413,3225,43,5563,3.722.202.381
26/05/2019 14:00,28.4,36925,1612,22,385,2988,45,5052,3.722.202.381
26/05/2019 15:00,32.99,37150,1329,21,338,2705,45,4438,3.722.202.381
26/05/2019 16:00,35.03,37739,1083,25,317,2384,45,3854,3.722.202.381
26/05/2019 17:00,35.38,38107,947,31,320,2031,45,3374,3.722.202.381
26/05/2019 18:00,36.6,38284,866,39,337,1693,44,2979,3.722.202.381
26/05/2019 19:00,37.13,38079,772,50,340,1436,38,2636,3.722.202.381
26/05/2019 20:00,36.57,38022,718,62,325,1298,34,2437,3.722.202.381
26/05/2019 21:00,36.34,37458,753,70,304,1256,29,2412,3.722.202.381
26/05/2019 22:00,33.46,35841,790,74,286,1232,31,2413,3.722.202.381
26/05/2019 23:00,28.96,33859,1299,59,304,1120,26,2808,3.722.202.381
27/05/2019 00:00,21.01,33168,1455,52,260,1078,22,2867,3.967.142.857
27/05/2019 01:00,19.92,32982,1528,47,213,1047,17,2852,3.967.142.857
27/05/2019 02:00,20.39,33004,1595,44,164,962,11,2776,3.967.142.857
27/05/2019 03:00,21.71,33250,1665,40,124,883,5,2717,3.967.142.857
27/05/2019 04:00,32.91,34986,1744,36,105,771,2,2658,3.967.142.857
27/05/2019 05:00,38.07,38886,1803,32,117,701,2,2655,3.967.142.857
27/05/2019 06:00,40.56,42484,1923,32,138,676,2,2771,3.967.142.857
27/05/2019 07:00,41.6,43760,2139,32,170,660,2,3003,3.967.142.857
27/05/2019 08:00,41.31,44019,2346,32,203,729,3,3313,3.967.142.857
27/05/2019 09:00,40.1,44068,2476,33,242,757,5,3513,3.967.142.857
27/05/2019 10:00,39.69,43669,2664,33,264,853,4,3818,3.967.142.857
27/05/2019 11:00,38.86,43301,2838,34,276,999,9,4156,3.967.142.857
27/05/2019 12:00,38.41,43101,2915,31,283,1158,14,4401,3.967.142.857
27/05/2019 13:00,37.74,42702,2948,25,282,1428,15,4698,3.967.142.857
27/05/2019 14:00,37.36,42308,3028,22,260,1501,20,4831,3.967.142.857
27/05/2019 15:00,36.86,42133,3030,20,239,1657,20,4966,3.967.142.857
27/05/2019 16:00,38.79,42055,2889,20,216,1637,26,4788,3.967.142.857
27/05/2019 17:00,39.58,41616,2601,18,189,1570,27,4405,3.967.142.857
27/05/2019 18:00,40.01,41025,2282,18,164,1479,28,3971,3.967.142.857
27/05/2019 19:00,39.96,40226,1998,21,144,1424,18,3605,3.967.142.857
27/05/2019 20:00,39.93,39684,1683,24,129,1414,14,3264,3.967.142.857
27/05/2019 21:00,39.72,38693,1465,28,118,1457,9,3077,3.967.142.857
27/05/2019 22:00,37.45,36743,1363,33,103,1423,6,2928,3.967.142.857
27/05/2019 23:00,35.07,34914,1670,158,0,1493,6,3327,3.967.142.857
28/05/2019 00:00,33.26,33992,1708,156,0,1461,6,3331,3.967.142.857
28/05/2019 01:00,31.66,33662,1679,150,0,1437,9,3275,3.967.142.857
28/05/2019 02:00,31.49,33559,1733,140,0,1452,10,3335,3.967.142.857
28/05/2019 03:00,31.72,33703,1805,126,0,1457,12,3400,3.967.142.857
28/05/2019 04:00,35.5,35282,1824,114,0,1390,10,3338,3.967.142.857
28/05/2019 05:00,39.86,38916,1812,104,0,1296,9,3221,3.967.142.857
28/05/2019 06:00,40.45,42614,1871,94,0,1241,6,3212,3.967.142.857
28/05/2019 07:00,40.76,43644,2053,84,0,1210,6,3353,3.967.142.857
28/05/2019 08:00,40.7,43405,2140,71,0,1239,4,3454,3.967.142.857
28/05/2019 09:00,40.49,43541,2197,56,0,1269,3,3525,3.967.142.857
28/05/2019 10:00,40.13,43419,2286,44,0,1266,3,3599,3.967.142.857
28/05/2019 11:00,40.02,43123,2384,35,0,1251,2,3672,3.967.142.857
28/05/2019 12:00,39.88,42914,2474,26,0,1253,2,3755,3.967.142.857
28/05/2019 13:00,38.98,42511,2600,19,0,1279,2,3900,3.967.142.857
28/05/2019 14:00,38.37,42178,2764,14,0,1206,4,3988,3.967.142.857
28/05/2019 15:00,38.39,41833,2997,12,0,1273,5,4287,3.967.142.857
28/05/2019 16:00,39.13,41776,3157,13,0,1366,4,4540,3.967.142.857
28/05/2019 17:00,39.25,41379,3248,18,0,1403,6,4675,3.967.142.857
28/05/2019 18:00,39.19,41007,3223,26,0,1501,7,4757,3.967.142.857
28/05/2019 19:00,38.32,40319,3021,35,0,1558,8,4622,3.967.142.857
28/05/2019 20:00,38.34,39758,2760,41,0,1662,6,4469,3.967.142.857
28/05/2019 21:00,37.5,38758,2570,48,0,1790,7,4415,3.967.142.857
28/05/2019 22:00,35,36674,2497,50,0,1976,3,4526,3.967.142.857
28/05/2019 23:00,34.14,35294,2352,67,90,2211,2,4722,3.967.142.857
29/05/2019 00:00,32.71,34486,2308,71,101,2337,2,4819,3.967.142.857
29/05/2019 01:00,30.16,34174,2225,69,105,2450,2,4851,3.967.142.857
29/05/2019 02:00,30.05,34135,2129,60,103,2497,2,4791,3.967.142.857
29/05/2019 03:00,33.12,34370,1988,52,102,2502,2,4646,3.967.142.857
29/05/2019 04:00,35.15,35858,1845,47,102,2482,3,4479,3.967.142.857
29/05/2019 05:00,38.51,39263,1702,49,103,2497,3,4354,3.967.142.857
29/05/2019 06:00,40.38,42505,1643,52,110,2607,3,4415,3.967.142.857
29/05/2019 07:00,40.86,43690,1685,55,120,2713,4,4577,3.967.142.857
29/05/2019 08:00,40.65,43622,1559,54,132,2970,4,4719,3.967.142.857
29/05/2019 09:00,40.28,43656,1412,51,146,3175,7,4791,3.967.142.857
29/05/2019 10:00,39.9,43474,1302,44,161,3341,11,4859,3.967.142.857
29/05/2019 11:00,39.48,43124,1176,38,170,3506,12,4902,3.967.142.857
29/05/2019 12:00,38.76,42965,1106,30,177,3764,15,5092,3.967.142.857
29/05/2019 13:00,38.06,42671,1040,23,187,3835,22,5107,3.967.142.857
29/05/2019 14:00,36.93,42423,935,14,190,3749,26,4914,3.967.142.857
29/05/2019 15:00,37.51,42324,865,10,186,3839,22,4922,3.967.142.857
29/05/2019 16:00,38.34,42303,798,11,175,3932,16,4932,3.967.142.857
29/05/2019 17:00,38.53,41952,703,17,158,3753,8,4639,3.967.142.857
29/05/2019 18:00,38.51,41523,578,30,133,3480,5,4226,3.967.142.857
29/05/2019 19:00,37.81,40838,513,43,118,3306,3,3983,3.967.142.857
29/05/2019 20:00,37.55,40405,537,51,114,3349,3,4054,3.967.142.857
29/05/2019 21:00,36.66,39493,720,53,111,3335,3,4222,3.967.142.857
29/05/2019 22:00,34.61,37411,1014,52,101,3342,3,4512,3.967.142.857
29/05/2019 23:00,32.29,34999,1524,34,0,3262,3,4823,3.967.142.857
30/05/2019 00:00,31.14,34032,1885,35,0,3181,3,5104,3.967.142.857
30/05/2019 01:00,29.05,33790,2260,33,0,3157,3,5453,3.967.142.857
30/05/2019 02:00,23.35,33573,2620,30,0,3308,3,5961,3.967.142.857
30/05/2019 03:00,15.92,33178,2866,28,0,3354,3,6251,3.967.142.857
30/05/2019 04:00,19.66,33465,3034,24,0,3203,3,6264,3.967.142.857
30/05/2019 05:00,14.82,34403,3146,22,0,3117,4,6289,3.967.142.857
30/05/2019 06:00,28.72,35918,3270,25,0,3097,3,6395,3.967.142.857
30/05/2019 07:00,29.63,37297,3493,29,0,3277,2,6801,3.967.142.857
30/05/2019 08:00,28.94,38347,3669,37,0,3792,3,7501,3.967.142.857
30/05/2019 09:00,25.91,38747,3594,48,0,4372,4,8018,3.967.142.857
30/05/2019 10:00,22.65,38977,3512,63,0,4648,6,8229,3.967.142.857
30/05/2019 11:00,25.87,38645,3395,79,0,4848,9,8331,3.967.142.857
30/05/2019 12:00,9.93,38378,3297,95,0,4977,11,8380,3.967.142.857
30/05/2019 13:00,7.84,38262,3153,108,0,5048,11,8320,3.967.142.857
30/05/2019 14:00,13.97,37843,3015,114,0,5009,12,8150,3.967.142.857
30/05/2019 15:00,26.81,37928,2881,117,0,5088,13,8099,3.967.142.857
30/05/2019 16:00,31.12,38400,2678,118,0,5028,11,7835,3.967.142.857
30/05/2019 17:00,32.44,38359,2404,117,0,4990,6,7517,3.967.142.857
30/05/2019 18:00,33.66,38363,2136,110,0,4819,3,7068,3.967.142.857
30/05/2019 19:00,33.16,38045,1831,100,0,4758,3,6692,3.967.142.857
30/05/2019 20:00,34.32,37855,1526,89,0,4593,7,6215,3.967.142.857
30/05/2019 21:00,35.25,37566,1296,78,0,4521,15,5910,3.967.142.857
30/05/2019 22:00,34,36068,1166,67,0,4495,22,5750,3.967.142.857
30/05/2019 23:00,29.44,34082,1230,48,91,4428,25,5822,3.967.142.857
31/05/2019 00:00,18.55,33221,1090,45,118,4108,33,5394,3.967.142.857
31/05/2019 01:00,15.81,33034,973,42,144,3886,35,5080,3.967.142.857
31/05/2019 02:00,14.92,32987,853,38,164,3667,34,4756,3.967.142.857
31/05/2019 03:00,12.38,33161,691,31,182,3576,37,4517,3.967.142.857
31/05/2019 04:00,27.75,34351,591,20,182,3602,42,4437,3.967.142.857
31/05/2019 05:00,35.15,37169,547,11,168,3542,34,4302,3.967.142.857
31/05/2019 06:00,38.06,39686,470,7,153,3563,34,4227,3.967.142.857
31/05/2019 07:00,39.02,41258,430,8,143,3568,31,4180,3.967.142.857
31/05/2019 08:00,38.84,41670,395,12,146,3541,31,4125,3.967.142.857
31/05/2019 09:00,37.49,41784,362,21,141,3685,31,4240,3.967.142.857
31/05/2019 10:00,35.89,41649,349,30,139,3755,25,4298,3.967.142.857
31/05/2019 11:00,34.76,41104,358,35,144,3777,20,4334,3.967.142.857
31/05/2019 12:00,32.65,40443,402,37,138,3823,15,4415,3.967.142.857
31/05/2019 13:00,31.42,40016,459,39,133,3899,13,4543,3.967.142.857
31/05/2019 14:00,30.53,39555,533,40,118,3940,9,4640,3.967.142.857
31/05/2019 15:00,32.77,39280,615,41,108,3902,10,4676,3.967.142.857
31/05/2019 16:00,35.51,39298,652,42,103,3889,6,4692,3.967.142.857
31/05/2019 17:00,37.49,39044,607,42,102,3675,5,4431,3.967.142.857
31/05/2019 18:00,38.51,38510,570,47,97,3302,4,4020,3.967.142.857
31/05/2019 19:00,37.88,37493,495,58,93,3135,3,3784,3.967.142.857
31/05/2019 20:00,37.21,37159,423,73,82,3032,2,3612,3.967.142.857
31/05/2019 21:00,36.95,36694,405,94,75,3118,2,3694,3.967.142.857
31/05/2019 22:00,36.72,35499,482,114,66,3070,4,3736,3.967.142.857
31/05/2019 23:00,34.44,34575,647,61,34,3081,2,3825,3.967.142.857
01/06/2019 00:00,31.68,33664,827,70,27,3016,2,3942,3.967.142.857
01/06/2019 01:00,28.03,33166,1020,77,24,2907,3,4031,3.967.142.857
01/06/2019 02:00,23.76,32816,1272,79,22,2722,3,4098,3.967.142.857
01/06/2019 03:00,19.91,32603,1556,81,19,2475,3,4134,3.967.142.857
01/06/2019 04:00,23.57,32820,1803,79,19,2316,4,4221,3.967.142.857
01/06/2019 05:00,27.99,33662,1990,73,19,2145,4,4231,3.967.142.857
01/06/2019 06:00,31.29,34905,2191,68,20,2125,4,4408,3.967.142.857
01/06/2019 07:00,32.27,36722,2416,67,22,2216,4,4725,3.967.142.857
01/06/2019 08:00,33.16,37975,2611,72,27,2415,4,5129,3.967.142.857
01/06/2019 09:00,32.67,38564,2678,82,33,2629,5,5427,3.967.142.857
01/06/2019 10:00,32.16,38535,2746,97,42,2832,8,5725,3.967.142.857
01/06/2019 11:00,31.89,38194,2702,113,54,3044,11,5924,3.967.142.857
01/06/2019 12:00,31.14,37876,2622,129,60,3311,13,6135,3.967.142.857
01/06/2019 13:00,29.68,37549,2561,138,65,3386,12,6162,3.967.142.857
01/06/2019 14:00,30.95,37348,2564,138,61,3305,12,6080,3.967.142.857
01/06/2019 15:00,31.25,37398,2586,135,57,3131,9,5918,3.967.142.857
01/06/2019 16:00,32.46,37949,2476,131,59,3092,11,5769,3.967.142.857
01/06/2019 17:00,34.85,38282,2251,127,69,2960,12,5419,3.967.142.857
01/06/2019 18:00,36.75,37998,1935,124,81,2870,20,5030,3.967.142.857
01/06/2019 19:00,37.06,37236,1607,119,96,2733,30,4585,3.967.142.857
01/06/2019 20:00,37.19,36772,1290,112,116,2621,30,4169,3.967.142.857
01/06/2019 21:00,37.09,36333,1062,104,145,2652,38,4001,3.967.142.857
01/06/2019 22:00,34.5,35267,926,94,164,2721,35,3940,3.967.142.857
01/06/2019 23:00,30.94,33553,962,82,139,2817,32,4032,3.967.142.857
02/06/2019 00:00,28.09,32604,834,70,150,2874,25,3953,3.967.142.857
02/06/2019 01:00,19.92,32201,710,58,156,2806,13,3743,3.967.142.857
02/06/2019 02:00,19.42,31937,597,47,152,2717,8,3521,3.967.142.857
02/06/2019 03:00,11.81,31698,441,37,142,2488,7,3115,3.967.142.857
02/06/2019 04:00,14.06,31746,317,29,128,2203,12,2689,3.967.142.857
02/06/2019 05:00,17.91,32319,240,29,117,1970,8,2364,3.967.142.857
02/06/2019 06:00,27.83,33405,230,37,112,1805,8,2192,3.967.142.857
02/06/2019 07:00,28.66,34910,268,49,118,1633,9,2077,3.967.142.857
02/06/2019 08:00,30.05,36274,364,66,141,1519,15,2105,3.967.142.857
02/06/2019 09:00,30.87,37115,508,87,158,1415,16,2184,3.967.142.857
02/06/2019 10:00,30.29,37449,689,106,163,1375,13,2346,3.967.142.857
02/06/2019 11:00,29.08,37344,913,119,157,1432,13,2634,3.967.142.857
02/06/2019 12:00,25.98,37037,1109,129,149,1482,12,2881,3.967.142.857
02/06/2019 13:00,23.35,36801,1243,135,138,1390,10,2916,3.967.142.857
02/06/2019 14:00,25.27,36660,1386,142,115,1256,8,2907,3.967.142.857
02/06/2019 15:00,27.98,36849,1617,145,94,1177,5,3038,3.967.142.857
02/06/2019 16:00,31.16,37300,1855,143,72,1018,3,3091,3.967.142.857
02/06/2019 17:00,32.79,37693,2060,136,51,811,2,3060,3.967.142.857
02/06/2019 18:00,36.37,37768,2172,132,32,633,1,2970,3.967.142.857
02/06/2019 19:00,36.99,37503,2224,127,25,646,1,3023,3.967.142.857
02/06/2019 20:00,36.29,37404,2388,123,21,831,1,3364,3.967.142.857
02/06/2019 21:00,35.64,36948,2442,122,19,1090,1,3674,3.967.142.857
02/06/2019 22:00,30.39,35543,2445,116,13,1417,1,3992,3.967.142.857
02/06/2019 23:00,26.28,33980,2428,157,9,1747,2,4343,3.967.142.857
03/06/2019 00:00,23.25,33181,2441,179,7,2119,2,4748,4.516.845.238
03/06/2019 01:00,21.84,32947,2491,192,6,2387,2,5078,4.516.845.238
03/06/2019 02:00,20.08,32881,2320,202,11,2517,3,5053,4.516.845.238
03/06/2019 03:00,20.06,32960,2058,207,21,2656,4,4946,4.516.845.238
03/06/2019 04:00,29.11,34581,1799,206,29,2718,5,4757,4.516.845.238
03/06/2019 05:00,36.59,38397,1503,193,31,2673,7,4407,4.516.845.238
03/06/2019 06:00,38.09,41964,1303,178,28,2718,8,4235,4.516.845.238
03/06/2019 07:00,39.09,43128,1256,165,30,2571,16,4038,4.516.845.238
03/06/2019 08:00,38.72,43211,1410,150,34,2494,8,4096,4.516.845.238
03/06/2019 09:00,38.26,43217,1461,137,40,2477,9,4124,4.516.845.238
03/06/2019 10:00,37.93,42815,1451,129,48,2494,11,4133,4.516.845.238
03/06/2019 11:00,36.88,42383,1392,123,51,2636,11,4213,4.516.845.238
03/06/2019 12:00,36.55,42166,1367,116,52,2827,12,4374,4.516.845.238
03/06/2019 13:00,36.14,41855,1321,110,53,2873,12,4369,4.516.845.238
03/06/2019 14:00,36.52,41464,1305,101,55,2866,11,4338,4.516.845.238
03/06/2019 15:00,36.5,41316,1280,94,57,2811,12,4254,4.516.845.238
03/06/2019 16:00,37.62,41222,1158,85,63,2681,15,4002,4.516.845.238
03/06/2019 17:00,37.99,40810,988,71,75,2471,19,3624,4.516.845.238
03/06/2019 18:00,38.08,40267,811,57,94,2348,15,3325,4.516.845.238
03/06/2019 19:00,37.63,39446,607,50,123,2321,22,3123,4.516.845.238
03/06/2019 20:00,37.1,38799,519,49,163,2374,33,3138,4.516.845.238
03/06/2019 21:00,36.34,37937,505,51,196,2434,37,3223,4.516.845.238
03/06/2019 22:00,33.9,36094,508,53,209,2398,39,3207,4.516.845.238
03/06/2019 23:00,27,33664,580,59,0,2404,35,3078,4.516.845.238
04/06/2019 00:00,24.31,32698,539,49,0,2306,39,2933,4.516.845.238
04/06/2019 01:00,22.61,32369,499,37,0,2233,38,2807,4.516.845.238
04/06/2019 02:00,20.61,32184,467,24,0,2233,36,2760,4.516.845.238
04/06/2019 03:00,20.46,32303,447,15,0,2114,30,2606,4.516.845.238
04/06/2019 04:00,29.81,34005,422,7,0,1875,32,2336,4.516.845.238
04/06/2019 05:00,36.29,37620,390,4,0,1561,25,1980,4.516.845.238
04/06/2019 06:00,37.23,41193,375,2,0,1370,15,1762,4.516.845.238
04/06/2019 07:00,37.81,42227,392,3,0,1203,12,1610,4.516.845.238
04/06/2019 08:00,37.75,41955,415,5,0,1175,12,1607,4.516.845.238
04/06/2019 09:00,37.41,42072,428,8,0,1149,12,1597,4.516.845.238
04/06/2019 10:00,37.16,41991,433,13,0,1079,13,1538,4.516.845.238
04/06/2019 11:00,36.57,41671,414,21,0,1097,13,1545,4.516.845.238
04/06/2019 12:00,36.17,41414,379,29,0,1101,13,1522,4.516.845.238
04/06/2019 13:00,35.47,41028,354,40,0,1084,13,1491,4.516.845.238
04/06/2019 14:00,34.41,40645,341,49,0,1017,13,1420,4.516.845.238
04/06/2019 15:00,34.79,40304,333,57,0,947,9,1346,4.516.845.238
04/06/2019 16:00,36.22,40159,363,67,0,867,6,1303,4.516.845.238
04/06/2019 17:00,36.53,39724,528,83,0,759,3,1373,4.516.845.238
04/06/2019 18:00,36.35,39315,762,101,0,634,2,1499,4.516.845.238
04/06/2019 19:00,35.78,38516,937,122,0,641,2,1702,4.516.845.238
04/06/2019 20:00,34.63,37912,1252,142,0,711,2,2107,4.516.845.238
04/06/2019 21:00,32.11,36951,1605,157,0,801,2,2565,4.516.845.238
04/06/2019 22:00,25.48,34856,1942,166,0,894,3,3005,4.516.845.238
04/06/2019 23:00,27.08,33308,2447,185,0,883,5,3520,4.516.845.238
05/06/2019 00:00,24.96,32338,2823,188,0,962,6,3979,4.516.845.238
05/06/2019 01:00,20.54,31908,3165,187,0,995,7,4354,4.516.845.238
05/06/2019 02:00,19.17,31764,3377,184,0,1051,9,4621,4.516.845.238
05/06/2019 03:00,12.14,31804,3410,175,0,1135,9,4729,4.516.845.238
05/06/2019 04:00,25.14,33167,3103,162,0,1136,8,4409,4.516.845.238
05/06/2019 05:00,33.13,36422,2698,148,0,1141,8,3995,4.516.845.238
05/06/2019 06:00,35.38,39734,2345,136,0,1147,4,3632,4.516.845.238
05/06/2019 07:00,36.36,40977,2106,124,0,1119,3,3352,4.516.845.238
05/06/2019 08:00,36.28,41107,1818,114,0,1111,2,3045,4.516.845.238
05/06/2019 09:00,36.26,41201,1439,107,0,1114,12,2672,4.516.845.238
05/06/2019 10:00,36.09,41060,1159,101,0,1180,2,2442,4.516.845.238
05/06/2019 11:00,36.04,40739,870,93,0,1306,3,2272,4.516.845.238
05/06/2019 12:00,35.47,40408,624,84,0,1425,3,2136,4.516.845.238
05/06/2019 13:00,35.18,40129,468,75,0,1437,2,1982,4.516.845.238
05/06/2019 14:00,34.77,39864,366,64,0,1382,2,1814,4.516.845.238
05/06/2019 15:00,34.44,39676,309,51,0,1348,2,1710,4.516.845.238
05/06/2019 16:00,34.6,39684,341,38,0,1389,2,1770,4.516.845.238
05/06/2019 17:00,34.92,39293,507,28,0,1436,4,1975,4.516.845.238
05/06/2019 18:00,34.81,38716,721,24,0,1534,5,2284,4.516.845.238
05/06/2019 19:00,34.45,37966,883,23,0,1635,8,2549,4.516.845.238
05/06/2019 20:00,34.04,37417,1120,24,0,1860,14,3018,4.516.845.238
05/06/2019 21:00,32.67,36585,1344,26,0,2080,16,3466,4.516.845.238
05/06/2019 22:00,28.48,34711,1518,27,0,2200,21,3766,4.516.845.238
05/06/2019 23:00,13.83,32503,1633,35,142,2141,9,3960,4.516.845.238
06/06/2019 00:00,10.21,31499,1716,37,127,2124,10,4014,4.516.845.238
06/06/2019 01:00,7.78,30905,1876,35,119,2121,13,4164,4.516.845.238
06/06/2019 02:00,7.18,30682,2072,30,124,2088,14,4328,4.516.845.238
06/06/2019 03:00,4.3,30574,2149,24,130,1938,13,4254,4.516.845.238
06/06/2019 04:00,9.03,31568,2150,17,121,1824,12,4124,4.516.845.238
06/06/2019 05:00,29.21,33729,2260,11,101,1513,11,3896,4.516.845.238
06/06/2019 06:00,31.13,36311,2376,7,85,1235,6,3709,4.516.845.238
06/06/2019 07:00,32.14,37512,2567,6,92,1098,5,3768,4.516.845.238
06/06/2019 08:00,32.21,38089,2760,6,118,1131,5,4020,4.516.845.238
06/06/2019 09:00,31.52,38733,2783,7,134,1299,8,4231,4.516.845.238
06/06/2019 10:00,31.04,38834,2876,8,141,1579,12,4616,4.516.845.238
06/06/2019 11:00,28.62,38568,2946,9,143,1875,15,4988,4.516.845.238
06/06/2019 12:00,27.89,38311,2955,10,144,2171,16,5296,4.516.845.238
06/06/2019 13:00,26.76,37893,2778,10,142,2326,14,5270,4.516.845.238
06/06/2019 14:00,26.34,37641,2634,9,140,2362,16,5161,4.516.845.238
06/06/2019 15:00,25.6,37517,2522,8,144,2340,15,5029,4.516.845.238
06/06/2019 16:00,28.64,37764,2324,7,135,2282,18,4766,4.516.845.238
06/06/2019 17:00,29.99,37643,2198,7,126,2209,12,4552,4.516.845.238
06/06/2019 18:00,30.48,37177,2076,9,128,2151,17,4381,4.516.845.238
06/06/2019 19:00,29.51,36515,1918,12,132,2110,9,4181,4.516.845.238
06/06/2019 20:00,28.88,35949,1790,17,149,2210,5,4171,4.516.845.238
06/06/2019 21:00,28.41,35174,1692,22,161,2274,6,4155,4.516.845.238
06/06/2019 22:00,26.68,33780,1632,27,160,2309,9,4137,4.516.845.238
06/06/2019 23:00,22.31,32516,1151,25,137,2215,8,3536,4.516.845.238
07/06/2019 00:00,19.93,31485,1065,26,137,2240,9,3477,4.516.845.238
07/06/2019 01:00,19.01,31142,1052,26,134,2155,4,3371,4.516.845.238
07/06/2019 02:00,19.07,30956,1045,26,129,2000,3,3203,4.516.845.238
07/06/2019 03:00,19,31009,946,25,124,1895,3,2993,4.516.845.238
07/06/2019 04:00,27.79,32469,779,21,111,1666,5,2582,4.516.845.238
07/06/2019 05:00,30.54,35613,585,16,90,1427,4,2122,4.516.845.238
07/06/2019 06:00,33.44,38875,461,10,79,1103,5,1658,4.516.845.238
07/06/2019 07:00,33.89,40419,388,8,74,904,16,1390,4.516.845.238
07/06/2019 08:00,33.72,40542,328,8,79,902,9,1326,4.516.845.238
07/06/2019 09:00,33.56,40728,272,11,82,1127,18,1510,4.516.845.238
07/06/2019 10:00,33.23,40371,212,13,80,1332,8,1645,4.516.845.238
07/06/2019 11:00,31.91,39784,172,13,75,1567,18,1845,4.516.845.238
07/06/2019 12:00,29.8,39158,140,12,67,1678,5,1902,4.516.845.238
07/06/2019 13:00,28.93,38533,142,12,61,1740,3,1958,4.516.845.238
07/06/2019 14:00,28.04,38038,163,13,56,1723,4,1959,4.516.845.238
07/06/2019 15:00,28.57,37789,213,14,55,1636,3,1921,4.516.845.238
07/06/2019 16:00,30.97,37826,282,15,53,1606,2,1958,4.516.845.238
07/06/2019 17:00,32.29,37561,377,19,56,1462,3,1917,4.516.845.238
07/06/2019 18:00,32,36997,488,24,64,1359,13,1948,4.516.845.238
07/06/2019 19:00,29.82,35955,631,32,70,1324,17,2074,4.516.845.238
07/06/2019 20:00,28.43,35401,842,37,77,1270,10,2236,4.516.845.238
07/06/2019 21:00,26.2,34751,1139,43,84,1240,13,2519,4.516.845.238
07/06/2019 22:00,25.06,33282,1407,49,91,1199,10,2756,4.516.845.238
07/06/2019 23:00,14.44,31682,1792,65,93,1202,8,3160,4.516.845.238
08/06/2019 00:00,12.08,30725,1959,68,98,1188,10,3323,4.516.845.238
08/06/2019 01:00,10.61,30074,2075,67,97,1053,10,3302,4.516.845.238
08/06/2019 02:00,6.37,29630,2167,63,95,1029,12,3366,4.516.845.238
08/06/2019 03:00,3.98,29331,2205,57,90,1067,10,3429,4.516.845.238
08/06/2019 04:00,4.87,29444,2198,43,80,1094,7,3422,4.516.845.238
08/06/2019 05:00,4.69,30203,2112,31,61,1113,5,3322,4.516.845.238
08/06/2019 06:00,11.34,31535,2097,23,41,979,4,3144,4.516.845.238
08/06/2019 07:00,15.03,33267,2412,23,39,865,3,3342,4.516.845.238
08/06/2019 08:00,20.03,34677,2805,28,53,900,4,3790,4.516.845.238
08/06/2019 09:00,20.04,35385,3041,39,59,1006,5,4150,4.516.845.238
08/06/2019 10:00,14.92,35380,3277,48,68,1205,9,4607,4.516.845.238
08/06/2019 11:00,14.16,34996,3465,53,65,1479,9,5071,4.516.845.238
08/06/2019 12:00,11.12,34831,3581,57,59,1699,7,5403,4.516.845.238
08/06/2019 13:00,9.57,34500,3726,60,49,1858,4,5697,4.516.845.238
08/06/2019 14:00,7.75,34175,3853,62,43,2016,3,5977,4.516.845.238
08/06/2019 15:00,8.57,34261,3976,63,45,2122,3,6209,4.516.845.238
08/06/2019 16:00,10.88,34853,4022,65,56,2096,2,6241,4.516.845.238
08/06/2019 17:00,11.02,35042,3967,71,65,2099,2,6204,4.516.845.238
08/06/2019 18:00,8.86,34770,3761,85,88,2069,2,6005,4.516.845.238
08/06/2019 19:00,5.36,34134,3614,108,110,2134,3,5969,4.516.845.238
08/06/2019 20:00,3.98,33713,3492,129,125,2299,3,6048,4.516.845.238
08/06/2019 21:00,3.02,33281,3461,141,132,2389,5,6128,4.516.845.238
08/06/2019 22:00,2.31,32353,3621,142,137,2554,6,6460,4.516.845.238
08/06/2019 23:00,13.61,30993,3758,150,158,2702,15,6783,4.516.845.238
09/06/2019 00:00,5.79,29946,3813,143,142,2800,13,6911,4.516.845.238
09/06/2019 01:00,3.82,29471,3858,134,120,2823,13,6948,4.516.845.238
09/06/2019 02:00,2.94,29186,3800,126,102,2894,15,6937,4.516.845.238
09/06/2019 03:00,2.47,28920,3709,120,91,2916,15,6851,4.516.845.238
09/06/2019 04:00,2.71,28994,3642,120,74,2932,19,6787,4.516.845.238
09/06/2019 05:00,2.56,29496,3516,119,51,3024,15,6725,4.516.845.238
09/06/2019 06:00,4.05,30578,3457,113,32,3177,10,6789,4.516.845.238
09/06/2019 07:00,13.26,32024,3600,108,29,3301,11,7049,4.516.845.238
09/06/2019 08:00,14.54,33403,3567,103,31,3463,9,7173,4.516.845.238
09/06/2019 09:00,13.94,34292,3411,95,37,3650,11,7204,4.516.845.238
09/06/2019 10:00,15.07,34671,3233,89,55,3803,13,7193,4.516.845.238
09/06/2019 11:00,15.95,34597,2947,85,65,3945,15,7057,4.516.845.238
09/06/2019 12:00,13.69,34357,2648,84,73,4083,17,6905,4.516.845.238
09/06/2019 13:00,12.26,34246,2370,85,78,4260,19,6812,4.516.845.238
09/06/2019 14:00,11.92,34196,2049,84,75,4229,17,6454,4.516.845.238
09/06/2019 15:00,18.33,34438,1681,82,70,4200,19,6052,4.516.845.238
09/06/2019 16:00,26.61,35018,1367,79,56,4003,19,5524,4.516.845.238
09/06/2019 17:00,28.62,35434,1099,75,39,3748,17,4978,4.516.845.238
09/06/2019 18:00,29.04,35484,813,69,27,3388,16,4313,4.516.845.238
09/06/2019 19:00,28.62,35279,572,66,19,3070,10,3737,4.516.845.238
09/06/2019 20:00,28.4,35106,433,64,17,3111,7,3632,4.516.845.238
09/06/2019 21:00,27.82,34561,365,62,17,3019,8,3471,4.516.845.238
09/06/2019 22:00,24.13,33369,320,56,17,3072,9,3474,4.516.845.238
09/06/2019 23:00,14.59,31428,252,53,13,2977,12,3307,4.516.845.238
10/06/2019 00:00,4.53,30792,240,57,14,2947,10,3268,4.915.714.286
10/06/2019 01:00,4.31,30461,237,58,14,2827,9,3145,4.915.714.286
10/06/2019 02:00,4.11,30259,263,59,15,2686,8,3031,4.915.714.286
10/06/2019 03:00,3.79,30231,320,57,18,2509,5,2909,4.915.714.286
10/06/2019 04:00,9.66,31349,369,46,22,2353,4,2794,4.915.714.286
10/06/2019 05:00,26.36,33524,425,33,22,2138,3,2621,4.915.714.286
10/06/2019 06:00,30,35671,518,25,21,1976,2,2542,4.915.714.286
10/06/2019 07:00,31.22,37029,704,23,23,1902,2,2654,4.915.714.286
10/06/2019 08:00,30.98,37686,893,25,27,2109,2,3056,4.915.714.286
10/06/2019 09:00,30.36,38061,1065,28,31,2363,3,3490,4.915.714.286
10/06/2019 10:00,29.94,38307,1235,31,36,2369,3,3674,4.915.714.286
10/06/2019 11:00,29.04,38228,1408,32,41,2377,3,3861,4.915.714.286
10/06/2019 12:00,27.38,38069,1564,31,41,2445,3,4084,4.915.714.286
10/06/2019 13:00,27.31,37852,1697,25,43,2365,3,4133,4.915.714.286
10/06/2019 14:00,27.47,37528,1842,22,44,2331,2,4241,4.915.714.286
10/06/2019 15:00,28.07,37405,1948,19,53,2262,2,4284,4.915.714.286
10/06/2019 16:00,30.67,37628,1979,18,62,2241,2,4302,4.915.714.286
10/06/2019 17:00,32.61,37558,1993,20,83,2146,3,4245,4.915.714.286
10/06/2019 18:00,32.68,37452,1956,23,110,1934,5,4028,4.915.714.286
10/06/2019 19:00,31.51,36967,1853,27,141,1896,5,3922,4.915.714.286
10/06/2019 20:00,30.54,36462,1869,32,183,1813,9,3906,4.915.714.286
10/06/2019 21:00,29.2,35815,1913,39,224,1802,11,3989,4.915.714.286
10/06/2019 22:00,28,34482,2011,45,242,1852,13,4163,4.915.714.286
10/06/2019 23:00,27.2,32545,1882,106,249,1926,15,4178,4.915.714.286
11/06/2019 00:00,23.74,31792,1999,98,244,2024,10,4375,4.915.714.286
11/06/2019 01:00,22.9,31475,2026,89,233,2098,20,4466,4.915.714.286
11/06/2019 02:00,19.46,31346,2113,81,221,2149,28,4592,4.915.714.286
11/06/2019 03:00,16.05,31432,2159,73,213,2215,28,4688,4.915.714.286
11/06/2019 04:00,24.05,33009,2116,65,185,2219,32,4617,4.915.714.286
11/06/2019 05:00,32.2,36461,2023,53,146,2114,23,4359,4.915.714.286
11/06/2019 06:00,34.52,39852,1938,45,116,1918,23,4040,4.915.714.286
11/06/2019 07:00,35.6,40932,2029,47,115,1849,21,4061,4.915.714.286
11/06/2019 08:00,35.4,40865,2120,55,135,1904,17,4231,4.915.714.286
11/06/2019 09:00,35.09,41239,2201,66,162,1917,14,4360,4.915.714.286
11/06/2019 10:00,34.53,41219,2239,71,181,1946,13,4450,4.915.714.286
11/06/2019 11:00,34.28,40917,2157,69,179,2050,9,4464,4.915.714.286
11/06/2019 12:00,34,40673,2104,68,163,2167,8,4510,4.915.714.286
11/06/2019 13:00,34,40420,2067,65,145,2247,8,4532,4.915.714.286
11/06/2019 14:00,32.62,40139,2096,61,125,2371,6,4659,4.915.714.286
11/06/2019 15:00,31.93,39844,2089,58,105,2462,7,4721,4.915.714.286
11/06/2019 16:00,32.98,39943,2003,53,89,2628,11,4784,4.915.714.286
11/06/2019 17:00,33.54,39552,1916,43,73,2669,10,4711,4.915.714.286
11/06/2019 18:00,33.07,39124,1762,35,62,2717,8,4584,4.915.714.286
11/06/2019 19:00,30.92,38410,1658,28,70,2804,10,4570,4.915.714.286
11/06/2019 20:00,29.56,37708,1614,23,96,2893,10,4636,4.915.714.286
11/06/2019 21:00,28.85,36734,1558,22,125,3021,17,4743,4.915.714.286
11/06/2019 22:00,26.97,34893,1464,20,144,3207,22,4857,4.915.714.286
11/06/2019 23:00,21.93,33494,1337,14,147,3246,14,4758,4.915.714.286
12/06/2019 00:00,21.39,32617,1303,13,152,3304,20,4792,4.915.714.286
12/06/2019 01:00,19.86,32312,1196,11,140,3277,22,4646,4.915.714.286
12/06/2019 02:00,19.31,32109,1204,11,118,3194,17,4544,4.915.714.286
12/06/2019 03:00,16.81,32184,1384,13,98,3090,16,4601,4.915.714.286
12/06/2019 04:00,24.99,33829,1573,13,79,3012,17,4694,4.915.714.286
12/06/2019 05:00,31.01,37322,1786,13,57,2980,15,4851,4.915.714.286
12/06/2019 06:00,33.08,40857,1934,12,36,2954,10,4946,4.915.714.286
12/06/2019 07:00,34.28,42099,2159,12,25,2979,13,5188,4.915.714.286
12/06/2019 08:00,34.32,42303,2297,13,30,3036,12,5388,4.915.714.286
12/06/2019 09:00,34.5,42606,2383,16,39,3176,13,5627,4.915.714.286
12/06/2019 10:00,34.49,42446,2397,22,56,3167,14,5656,4.915.714.286
12/06/2019 11:00,34.09,42066,2396,27,66,3093,12,5594,4.915.714.286
12/06/2019 12:00,33.83,41794,2300,37,68,3094,12,5511,4.915.714.286
12/06/2019 13:00,33.81,41690,2102,44,67,3043,14,5270,4.915.714.286
12/06/2019 14:00,33.15,41443,1777,54,66,3058,18,4973,4.915.714.286
12/06/2019 15:00,33.09,41172,1510,63,63,3171,18,4825,4.915.714.286
12/06/2019 16:00,32.99,41170,1390,68,64,3202,17,4741,4.915.714.286
12/06/2019 17:00,32.8,40661,1310,73,67,3152,16,4618,4.915.714.286
12/06/2019 18:00,32.56,40218,1167,81,76,3115,20,4459,4.915.714.286
12/06/2019 19:00,31.96,39499,1033,89,95,3110,23,4350,4.915.714.286
12/06/2019 20:00,31.89,38833,887,96,126,3104,26,4239,4.915.714.286
12/06/2019 21:00,31.02,37872,764,106,163,3062,27,4122,4.915.714.286
12/06/2019 22:00,29.08,35830,734,116,180,3017,32,4079,4.915.714.286
12/06/2019 23:00,19.74,34070,2198,92,193,2927,34,5444,4.915.714.286
13/06/2019 00:00,19.47,33029,2306,101,196,2715,30,5348,4.915.714.286
13/06/2019 01:00,18.93,32598,2292,104,189,2547,27,5159,4.915.714.286
13/06/2019 02:00,19.06,32448,2217,110,177,2389,28,4921,4.915.714.286
13/06/2019 03:00,18.15,32514,2162,117,171,2219,29,4698,4.915.714.286
13/06/2019 04:00,26.9,34033,2107,126,150,2093,26,4502,4.915.714.286
13/06/2019 05:00,31.45,37271,1910,134,125,1958,24,4151,4.915.714.286
13/06/2019 06:00,33.5,40579,1744,141,99,1811,16,3811,4.915.714.286
13/06/2019 07:00,35.18,41727,1677,147,94,1657,8,3583,4.915.714.286
13/06/2019 08:00,35.01,41946,1588,152,112,1650,10,3512,4.915.714.286
13/06/2019 09:00,33.04,42269,1533,153,138,1695,10,3529,4.915.714.286
13/06/2019 10:00,31.04,42263,1602,153,168,1804,11,3738,4.915.714.286
13/06/2019 11:00,29.92,41907,1812,153,182,1696,9,3852,4.915.714.286
13/06/2019 12:00,29.11,41710,1964,153,167,1712,10,4006,4.915.714.286
13/06/2019 13:00,29.89,41366,2067,155,155,1568,13,3958,4.915.714.286
13/06/2019 14:00,30.03,41277,2030,157,129,1476,11,3803,4.915.714.286
13/06/2019 15:00,31.16,40981,1843,162,105,1342,8,3460,4.915.714.286
13/06/2019 16:00,32.93,41062,1597,163,85,1115,5,2965,4.915.714.286
13/06/2019 17:00,33.58,40446,1246,162,69,927,4,2408,4.915.714.286
13/06/2019 18:00,33.48,39894,940,158,63,825,9,1995,4.915.714.286
13/06/2019 19:00,32.92,39006,753,159,60,828,8,1808,4.915.714.286
13/06/2019 20:00,32.95,38261,675,160,67,910,10,1822,4.915.714.286
13/06/2019 21:00,32.24,37368,644,160,76,894,5,1779,4.915.714.286
13/06/2019 22:00,30.62,35588,618,155,76,925,8,1782,4.915.714.286
13/06/2019 23:00,28.98,33334,1127,151,38,891,3,2210,4.915.714.286
14/06/2019 00:00,28.08,32308,1202,141,39,890,5,2277,4.915.714.286
14/06/2019 01:00,25.98,31956,1252,132,42,915,8,2349,4.915.714.286
14/06/2019 02:00,25.23,31758,1195,132,42,832,9,2210,4.915.714.286
14/06/2019 03:00,25.35,31857,1076,136,44,838,7,2101,4.915.714.286
14/06/2019 04:00,28.52,33474,1014,136,43,780,4,1977,4.915.714.286
14/06/2019 05:00,31.82,36723,949,131,34,654,4,1772,4.915.714.286
14/06/2019 06:00,33.32,40093,854,122,29,561,5,1571,4.915.714.286
14/06/2019 07:00,34.99,41626,922,111,27,464,4,1528,4.915.714.286
14/06/2019 08:00,34.92,41756,1015,106,34,379,5,1539,4.915.714.286
14/06/2019 09:00,34.85,41969,1052,101,42,353,6,1554,4.915.714.286
14/06/2019 10:00,34.9,41630,1069,92,54,446,6,1667,4.915.714.286
14/06/2019 11:00,34.11,41153,1072,88,60,298,8,1526,4.915.714.286
14/06/2019 12:00,32.82,40509,1046,88,70,299,6,1509,4.915.714.286
14/06/2019 13:00,32.58,39994,1009,85,76,319,7,1496,4.915.714.286
14/06/2019 14:00,32.75,39449,1033,80,78,383,7,1581,4.915.714.286
14/06/2019 15:00,32.02,39165,1058,77,82,398,7,1622,4.915.714.286
14/06/2019 16:00,32.8,39092,1061,73,82,424,6,1646,4.915.714.286
14/06/2019 17:00,32.91,38524,949,63,74,422,5,1513,4.915.714.286
14/06/2019 18:00,32.7,37965,799,57,70,429,4,1359,4.915.714.286
14/06/2019 19:00,31.61,36808,783,57,72,481,3,1396,4.915.714.286
14/06/2019 20:00,31,36115,805,61,78,624,3,1571,4.915.714.286
14/06/2019 21:00,30.26,35445,947,65,88,797,3,1900,4.915.714.286
14/06/2019 22:00,29.56,34072,1135,62,88,961,3,2249,4.915.714.286
14/06/2019 23:00,29.22,32662,1296,44,0,993,4,2337,4.915.714.286
15/06/2019 00:00,28.29,31516,1319,48,0,1124,4,2495,4.915.714.286
15/06/2019 01:00,27.07,30795,1305,52,0,1173,5,2535,4.915.714.286
15/06/2019 02:00,24.91,30340,1332,51,0,1163,4,2550,4.915.714.286
15/06/2019 03:00,21.94,29958,1338,49,0,1180,4,2571,4.915.714.286
15/06/2019 04:00,22.93,30201,1312,40,0,1067,3,2422,4.915.714.286
15/06/2019 05:00,22.88,31103,1361,28,0,906,3,2298,4.915.714.286
15/06/2019 06:00,26.57,32534,1500,21,0,772,3,2296,4.915.714.286
15/06/2019 07:00,28.62,34272,1762,20,0,739,3,2524,4.915.714.286
15/06/2019 08:00,29.5,35715,1915,21,0,745,3,2684,4.915.714.286
15/06/2019 09:00,29.36,36482,2108,23,0,730,3,2864,4.915.714.286
15/06/2019 10:00,27.73,36559,2316,28,0,720,3,3067,4.915.714.286
15/06/2019 11:00,25.02,36189,2583,32,0,757,4,3376,4.915.714.286
15/06/2019 12:00,24.76,35917,2828,34,0,798,4,3664,4.915.714.286
15/06/2019 13:00,23.38,35573,2966,33,0,836,4,3839,4.915.714.286
15/06/2019 14:00,23.43,35318,3113,31,0,884,4,4032,4.915.714.286
15/06/2019 15:00,23.79,35363,3069,29,0,925,4,4027,4.915.714.286
15/06/2019 16:00,28.11,35816,2845,24,0,1012,4,3885,4.915.714.286
15/06/2019 17:00,29.08,35980,2402,18,0,1124,4,3548,4.915.714.286
15/06/2019 18:00,28.73,35478,1818,17,0,1236,4,3075,4.915.714.286
15/06/2019 19:00,27.8,34744,1533,19,0,1309,4,2865,4.915.714.286
15/06/2019 20:00,27.39,34157,1407,25,0,1383,5,2820,4.915.714.286
15/06/2019 21:00,26.57,33697,1335,32,0,1527,7,2901,4.915.714.286
15/06/2019 22:00,23.82,32735,1465,37,0,1572,6,3080,4.915.714.286
15/06/2019 23:00,26.38,31517,1555,56,197,1473,10,3291,4.915.714.286
16/06/2019 00:00,23.39,30511,1465,54,193,1298,12,3022,4.915.714.286
16/06/2019 01:00,21.96,30053,1426,54,178,1180,12,2850,4.915.714.286
16/06/2019 02:00,19.97,29702,1389,61,172,1121,17,2760,4.915.714.286
16/06/2019 03:00,19.71,29285,1394,62,170,970,9,2605,4.915.714.286
16/06/2019 04:00,19.96,29388,1412,64,166,877,9,2528,4.915.714.286
16/06/2019 05:00,21.48,29943,1276,67,164,741,8,2256,4.915.714.286
16/06/2019 06:00,26.2,31150,1200,68,145,634,11,2058,4.915.714.286
16/06/2019 07:00,28.2,32746,1220,73,123,544,6,1966,4.915.714.286
16/06/2019 08:00,28.09,34190,1198,80,102,554,3,1937,4.915.714.286
16/06/2019 09:00,27.59,35217,1214,89,81,577,4,1965,4.915.714.286
16/06/2019 10:00,28.05,35593,1254,96,67,626,5,2048,4.915.714.286
16/06/2019 11:00,27.41,35530,1304,95,58,681,5,2143,4.915.714.286
16/06/2019 12:00,24.15,35215,1285,96,55,786,4,2226,4.915.714.286
16/06/2019 13:00,23.8,35095,1240,102,61,876,3,2282,4.915.714.286
16/06/2019 14:00,25.98,35043,1185,110,69,975,3,2342,4.915.714.286
16/06/2019 15:00,27.87,35314,1152,116,77,1070,3,2418,4.915.714.286
16/06/2019 16:00,29.07,35851,1067,114,82,1178,3,2444,4.915.714.286
16/06/2019 17:00,29.94,36137,943,108,85,1271,3,2410,4.915.714.286
16/06/2019 18:00,30.67,36125,818,100,87,1330,2,2337,4.915.714.286
16/06/2019 19:00,30.31,35636,704,94,85,1437,2,2322,4.915.714.286
16/06/2019 20:00,30.14,35301,593,95,82,1573,2,2345,4.915.714.286
16/06/2019 21:00,29.89,34738,555,97,82,1664,2,2400,4.915.714.286
16/06/2019 22:00,29.03,33529,546,93,86,1871,1,2597,4.915.714.286
16/06/2019 23:00,28.5,31959,617,53,84,1780,1,2535,4.915.714.286
17/06/2019 00:00,26.26,31218,617,45,85,1827,1,2575,5.215.297.619
17/06/2019 01:00,25.81,30900,631,35,89,1819,1,2575,5.215.297.619
17/06/2019 02:00,23.4,30688,665,29,92,1809,1,2596,5.215.297.619
17/06/2019 03:00,23.07,30785,722,24,98,1686,1,2531,5.215.297.619
17/06/2019 04:00,28.11,32551,727,19,108,1496,2,2352,5.215.297.619
17/06/2019 05:00,31.15,36113,719,13,129,1339,2,2202,5.215.297.619
17/06/2019 06:00,33.19,39335,751,11,153,1253,2,2170,5.215.297.619
17/06/2019 07:00,35.13,40645,870,12,172,1208,3,2265,5.215.297.619
17/06/2019 08:00,35.07,40961,1011,18,177,1298,5,2509,5.215.297.619
17/06/2019 09:00,33.92,41333,1183,28,180,1407,7,2805,5.215.297.619
17/06/2019 10:00,33.32,41286,1318,35,186,1587,10,3136,5.215.297.619
17/06/2019 11:00,33.25,41041,1459,40,194,1753,9,3455,5.215.297.619
17/06/2019 12:00,32.5,40984,1485,48,197,1901,10,3641,5.215.297.619
17/06/2019 13:00,32.79,40681,1440,56,197,2048,9,3750,5.215.297.619
17/06/2019 14:00,31.76,40368,1338,64,187,2244,7,3840,5.215.297.619
17/06/2019 15:00,31.09,39934,1206,69,173,2182,6,3636,5.215.297.619
17/06/2019 16:00,31.44,39904,985,71,161,2235,6,3458,5.215.297.619
17/06/2019 17:00,31.91,39375,725,70,138,2153,5,3091,5.215.297.619
17/06/2019 18:00,31.91,38700,515,70,109,1949,5,2648,5.215.297.619
17/06/2019 19:00,31.17,37748,384,70,91,1959,4,2508,5.215.297.619
17/06/2019 20:00,30.69,36980,394,70,84,1981,5,2534,5.215.297.619
17/06/2019 21:00,29.6,36084,527,68,78,2122,6,2801,5.215.297.619
17/06/2019 22:00,28.92,34121,719,68,71,2098,8,2964,5.215.297.619
17/06/2019 23:00,28.3,32646,776,16,63,2055,6,2916,5.215.297.619
18/06/2019 00:00,27.17,31600,1006,21,57,1990,5,3079,5.215.297.619
18/06/2019 01:00,25.49,31048,1167,22,46,1990,5,3230,5.215.297.619
18/06/2019 02:00,23.8,30820,1243,20,41,1829,5,3138,5.215.297.619
18/06/2019 03:00,22.62,30958,1260,17,35,1835,3,3150,5.215.297.619
18/06/2019 04:00,28.08,32651,1066,12,29,1710,2,2819,5.215.297.619
18/06/2019 05:00,31.31,36136,907,8,19,1569,2,2505,5.215.297.619
18/06/2019 06:00,34.09,39565,891,5,12,1506,2,2416,5.215.297.619
18/06/2019 07:00,35.12,40698,940,6,9,1531,2,2488,5.215.297.619
18/06/2019 08:00,36.01,40818,932,9,10,1842,2,2795,5.215.297.619
18/06/2019 09:00,35.58,41346,921,13,11,2047,2,2994,5.215.297.619
18/06/2019 10:00,34.97,41389,912,19,12,2225,2,3170,5.215.297.619
18/06/2019 11:00,34.33,41068,883,26,13,2383,2,3307,5.215.297.619
18/06/2019 12:00,33.36,40822,891,33,13,2533,3,3473,5.215.297.619
18/06/2019 13:00,32.79,40593,914,44,14,2649,3,3624,5.215.297.619
18/06/2019 14:00,31.7,40179,880,53,16,2724,3,3676,5.215.297.619
18/06/2019 15:00,30.96,39823,749,60,17,2573,3,3402,5.215.297.619
18/06/2019 16:00,31.41,39703,679,64,18,2482,3,3246,5.215.297.619
18/06/2019 17:00,31.68,39049,489,65,15,2236,3,2808,5.215.297.619
18/06/2019 18:00,31.72,38551,369,65,16,2009,3,2462,5.215.297.619
18/06/2019 19:00,30.99,37812,328,67,16,1988,2,2401,5.215.297.619
18/06/2019 20:00,30.65,37072,363,72,14,1995,2,2446,5.215.297.619
18/06/2019 21:00,30.32,36087,459,78,14,1930,2,2483,5.215.297.619
18/06/2019 22:00,29.57,34307,421,81,12,1912,2,2428,5.215.297.619
18/06/2019 23:00,29.08,32469,179,95,0,1913,3,2190,5.215.297.619
19/06/2019 00:00,28.42,31430,242,96,0,1952,4,2294,5.215.297.619
19/06/2019 01:00,28.26,30981,231,98,0,1898,4,2231,5.215.297.619
19/06/2019 02:00,28.16,30766,219,97,0,1780,5,2101,5.215.297.619
19/06/2019 03:00,28.41,30802,230,91,0,1565,4,1890,5.215.297.619
19/06/2019 04:00,29.79,32336,239,83,0,1302,5,1629,5.215.297.619
19/06/2019 05:00,32.06,35695,277,76,0,976,5,1334,5.215.297.619
19/06/2019 06:00,34.07,39089,294,73,0,714,3,1084,5.215.297.619
19/06/2019 07:00,34.9,40342,315,77,0,608,3,1003,5.215.297.619
19/06/2019 08:00,34.64,40594,347,80,0,578,3,1008,5.215.297.619
19/06/2019 09:00,35.06,40967,384,83,0,590,4,1061,5.215.297.619
19/06/2019 10:00,35,41027,445,85,0,632,5,1167,5.215.297.619
19/06/2019 11:00,35.57,40740,547,91,0,655,5,1298,5.215.297.619
19/06/2019 12:00,35.15,40532,695,100,0,677,5,1477,5.215.297.619
19/06/2019 13:00,35.12,40243,788,102,0,671,4,1565,5.215.297.619
19/06/2019 14:00,33.4,40074,889,98,0,689,4,1680,5.215.297.619
19/06/2019 15:00,32.39,39710,1023,90,0,718,3,1834,5.215.297.619
19/06/2019 16:00,32.68,39569,1173,82,0,708,3,1966,5.215.297.619
19/06/2019 17:00,32.97,38910,1174,72,0,677,2,1925,5.215.297.619
19/06/2019 18:00,33.55,38461,1062,60,0,667,2,1791,5.215.297.619
19/06/2019 19:00,32.54,37737,1059,54,0,738,2,1853,5.215.297.619
19/06/2019 20:00,31.79,37088,1167,54,0,884,2,2107,5.215.297.619
19/06/2019 21:00,30.99,36109,1180,55,0,1071,5,2311,5.215.297.619
19/06/2019 22:00,30.71,34330,935,55,0,1131,8,2129,5.215.297.619
19/06/2019 23:00,30.3,32649,825,49,125,1233,12,2244,5.215.297.619
20/06/2019 00:00,29.42,31624,772,49,135,1278,11,2245,5.215.297.619
20/06/2019 01:00,28.34,31095,918,49,140,1338,11,2456,5.215.297.619
20/06/2019 02:00,27.28,30762,929,49,138,1296,11,2423,5.215.297.619
20/06/2019 03:00,25.2,30811,924,48,139,1272,9,2392,5.215.297.619
20/06/2019 04:00,26.78,32356,951,41,121,1243,5,2361,5.215.297.619
20/06/2019 05:00,30.62,35549,1057,33,90,1201,5,2386,5.215.297.619
20/06/2019 06:00,32.6,38929,1089,31,67,1241,5,2433,5.215.297.619
20/06/2019 07:00,32.79,40213,1104,33,46,1287,4,2474,5.215.297.619
20/06/2019 08:00,32.6,40471,1119,36,41,1490,5,2691,5.215.297.619
20/06/2019 09:00,32.53,40821,1163,37,38,1596,4,2838,5.215.297.619
20/06/2019 10:00,32.08,40763,1232,38,38,1714,4,3026,5.215.297.619
20/06/2019 11:00,31.98,40419,1360,37,34,1843,5,3279,5.215.297.619
20/06/2019 12:00,31.37,39931,1420,34,31,1979,5,3469,5.215.297.619
20/06/2019 13:00,31.13,39520,1405,31,29,2068,5,3538,5.215.297.619
20/06/2019 14:00,30.58,39132,1408,27,28,2080,4,3547,5.215.297.619
20/06/2019 15:00,30.12,38725,1367,22,26,2066,3,3484,5.215.297.619
20/06/2019 16:00,30.16,38712,1226,17,24,2069,3,3339,5.215.297.619
20/06/2019 17:00,30.5,38087,1096,13,24,2058,3,3194,5.215.297.619
20/06/2019 18:00,30.59,37386,916,11,24,1986,2,2939,5.215.297.619
20/06/2019 19:00,30,36540,710,11,25,1939,1,2686,5.215.297.619
20/06/2019 20:00,29.11,36026,556,10,30,1978,1,2575,5.215.297.619
20/06/2019 21:00,28.51,35245,498,11,33,2062,2,2606,5.215.297.619
20/06/2019 22:00,28.02,33711,474,13,35,2081,2,2605,5.215.297.619
20/06/2019 23:00,29.1,31656,507,13,32,2048,6,2606,5.215.297.619
21/06/2019 00:00,28.35,30639,464,16,27,2087,6,2600,5.215.297.619
21/06/2019 01:00,27.78,30007,422,21,24,2063,5,2535,5.215.297.619
21/06/2019 02:00,27.75,29585,443,27,23,1911,6,2410,5.215.297.619
21/06/2019 03:00,27.46,29513,468,34,23,1822,9,2356,5.215.297.619
21/06/2019 04:00,29.02,30129,485,33,23,1655,7,2203,5.215.297.619
21/06/2019 05:00,30.31,31987,498,26,20,1476,4,2024,5.215.297.619
21/06/2019 06:00,31.38,34560,554,17,16,1391,5,1983,5.215.297.619
21/06/2019 07:00,31.84,36348,628,13,15,1422,5,2083,5.215.297.619
21/06/2019 08:00,31.9,37204,682,14,19,1432,7,2154,5.215.297.619
21/06/2019 09:00,32,37637,756,17,24,1533,5,2335,5.215.297.619
21/06/2019 10:00,31.9,37443,859,18,34,1670,4,2585,5.215.297.619
21/06/2019 11:00,31.64,37170,1062,19,48,1821,3,2953,5.215.297.619
21/06/2019 12:00,31.1,36445,1257,21,59,1962,3,3302,5.215.297.619
21/06/2019 13:00,30.12,35849,1420,21,66,2089,5,3601,5.215.297.619
21/06/2019 14:00,29.96,35388,1572,21,74,2157,5,3829,5.215.297.619
21/06/2019 15:00,29.95,35279,1745,23,76,2228,5,4077,5.215.297.619
21/06/2019 16:00,29.9,35191,1797,22,80,2271,4,4174,5.215.297.619
21/06/2019 17:00,29.99,34990,1847,21,79,2375,4,4326,5.215.297.619
21/06/2019 18:00,29.98,34505,1788,20,79,2385,5,4277,5.215.297.619
21/06/2019 19:00,29.1,33766,1611,22,80,2343,4,4060,5.215.297.619
21/06/2019 20:00,29.56,33572,1464,29,86,2408,4,3991,5.215.297.619
21/06/2019 21:00,28.94,33321,1411,37,97,2571,7,4123,5.215.297.619
21/06/2019 22:00,28.42,32431,1367,41,99,2775,7,4289,5.215.297.619
21/06/2019 23:00,29.29,30735,1193,64,72,2892,3,4224,5.215.297.619
22/06/2019 00:00,27.21,29734,1089,66,77,3087,4,4323,5.215.297.619
22/06/2019 01:00,25.08,29132,1013,65,80,3143,4,4305,5.215.297.619
22/06/2019 02:00,24.18,28652,992,62,84,3183,5,4326,5.215.297.619
22/06/2019 03:00,20.83,28215,954,58,89,3266,5,4372,5.215.297.619
22/06/2019 04:00,21.63,28245,916,54,91,3272,5,4338,5.215.297.619
22/06/2019 05:00,25.45,28944,860,50,90,3282,5,4287,5.215.297.619
22/06/2019 06:00,28.19,30210,793,47,93,3331,7,4271,5.215.297.619
22/06/2019 07:00,29.14,31847,744,46,97,3298,10,4195,5.215.297.619
22/06/2019 08:00,29.03,33350,620,47,107,3253,11,4038,5.215.297.619
22/06/2019 09:00,28.82,34198,507,50,117,3426,10,4110,5.215.297.619
22/06/2019 10:00,28.06,34357,393,53,130,3469,10,4055,5.215.297.619
22/06/2019 11:00,27.74,34050,361,56,148,3552,12,4129,5.215.297.619
22/06/2019 12:00,26.44,33997,353,56,155,3643,12,4219,5.215.297.619
22/06/2019 13:00,25.92,33706,363,55,156,3657,10,4241,5.215.297.619
22/06/2019 14:00,26.28,33569,371,52,147,3669,9,4248,5.215.297.619
22/06/2019 15:00,27.56,33610,381,47,130,3641,8,4207,5.215.297.619
22/06/2019 16:00,28.88,34156,359,41,109,3484,7,4000,5.215.297.619
22/06/2019 17:00,29.3,34297,350,34,85,3225,4,3698,5.215.297.619
22/06/2019 18:00,29.68,34015,334,27,70,3010,3,3444,5.215.297.619
22/06/2019 19:00,29.37,33296,295,24,64,2854,2,3239,5.215.297.619
22/06/2019 20:00,29.27,32567,271,23,66,2779,1,3140,5.215.297.619
22/06/2019 21:00,29.28,32128,286,21,68,2741,2,3118,5.215.297.619
22/06/2019 22:00,27.28,31509,294,16,63,2667,2,3042,5.215.297.619
22/06/2019 23:00,25.21,30812,300,11,32,2723,4,3070,5.215.297.619
23/06/2019 00:00,20.4,29927,280,7,29,2642,3,2961,5.215.297.619
23/06/2019 01:00,20,29460,292,5,28,2598,3,2926,5.215.297.619
23/06/2019 02:00,19.04,29012,293,5,28,2468,4,2798,5.215.297.619
23/06/2019 03:00,15.41,28547,285,4,27,2293,4,2613,5.215.297.619
23/06/2019 04:00,19.74,28484,284,3,25,2056,4,2372,5.215.297.619
23/06/2019 05:00,21.81,29035,282,2,17,1717,2,2020,5.215.297.619
23/06/2019 06:00,22.2,30215,286,1,11,1471,2,1771,5.215.297.619
23/06/2019 07:00,25.79,31714,318,2,8,1307,2,1637,5.215.297.619
23/06/2019 08:00,26.31,33139,294,2,7,1332,2,1637,5.215.297.619
23/06/2019 09:00,25.37,34375,270,3,6,1412,2,1693,5.215.297.619
23/06/2019 10:00,24.17,34793,241,4,7,1521,2,1775,5.215.297.619
23/06/2019 11:00,22.04,34740,217,6,11,1529,3,1766,5.215.297.619
23/06/2019 12:00,21.8,34605,210,7,14,1443,4,1678,5.215.297.619
23/06/2019 13:00,22.14,34486,207,7,21,1396,4,1635,5.215.297.619
23/06/2019 14:00,23.18,34520,245,6,30,1267,4,1552,5.215.297.619
23/06/2019 15:00,26.38,34651,295,7,34,1310,4,1650,5.215.297.619
23/06/2019 16:00,28.19,35030,338,7,40,1237,4,1626,5.215.297.619
23/06/2019 17:00,30.07,35158,391,7,44,1198,3,1643,5.215.297.619
23/06/2019 18:00,31,34955,398,7,58,1196,3,1662,5.215.297.619
23/06/2019 19:00,31.28,34414,403,8,69,1125,2,1607,5.215.297.619
23/06/2019 20:00,31.03,34160,439,9,79,1176,2,1705,5.215.297.619
23/06/2019 21:00,30.92,33695,488,11,90,1330,3,1922,5.215.297.619
23/06/2019 22:00,28.79,32654,530,12,86,1348,2,1978,5.215.297.619
23/06/2019 23:00,26.74,31137,514,67,72,1494,1,2148,5.215.297.619
24/06/2019 00:00,25.38,30410,571,66,69,1528,1,2235,5.388.690.476
24/06/2019 01:00,23.62,29968,664,60,65,1665,1,2455,5.388.690.476
24/06/2019 02:00,24.11,29854,763,54,59,1703,1,2580,5.388.690.476
24/06/2019 03:00,24.37,29919,825,47,54,1628,1,2555,5.388.690.476
24/06/2019 04:00,26.73,31748,795,35,41,1407,1,2279,5.388.690.476
24/06/2019 05:00,32.31,35456,796,21,30,1257,1,2105,5.388.690.476
24/06/2019 06:00,35.18,38938,814,14,17,1052,1,1898,5.388.690.476
24/06/2019 07:00,35.66,40397,894,12,11,898,1,1816,5.388.690.476
24/06/2019 08:00,35.1,40833,914,13,11,824,1,1763,5.388.690.476
24/06/2019 09:00,34.01,41353,935,15,9,656,1,1616,5.388.690.476
24/06/2019 10:00,33.81,41390,925,18,8,602,1,1554,5.388.690.476
24/06/2019 11:00,33.78,41088,959,19,7,627,1,1613,5.388.690.476
24/06/2019 12:00,33.14,40823,993,20,9,635,1,1658,5.388.690.476
24/06/2019 13:00,32.93,40353,1036,22,11,681,4,1754,5.388.690.476
24/06/2019 14:00,32.24,39890,1123,27,15,709,5,1879,5.388.690.476
24/06/2019 15:00,32.81,39520,1194,29,19,746,5,1993,5.388.690.476
24/06/2019 16:00,34.74,39623,1258,26,27,724,6,2041,5.388.690.476
24/06/2019 17:00,34.66,39126,1272,23,32,663,5,1995,5.388.690.476
24/06/2019 18:00,34.52,38377,1214,20,49,701,5,1989,5.388.690.476
24/06/2019 19:00,33.43,37370,1175,21,63,762,3,2024,5.388.690.476
24/06/2019 20:00,32.37,36762,1276,25,80,921,3,2305,5.388.690.476
24/06/2019 21:00,32.06,35859,1381,31,100,1124,4,2640,5.388.690.476
24/06/2019 22:00,28.82,34319,1503,35,108,1303,4,2953,5.388.690.476
24/06/2019 23:00,28.12,32718,1776,28,94,1443,8,3349,5.388.690.476
25/06/2019 00:00,24.75,31699,1849,28,97,1549,5,3528,5.388.690.476
25/06/2019 01:00,24.08,31277,1962,25,96,1617,5,3705,5.388.690.476
25/06/2019 02:00,24.2,31145,1924,22,93,1532,4,3575,5.388.690.476
25/06/2019 03:00,23.6,31189,1873,18,89,1445,4,3429,5.388.690.476
25/06/2019 04:00,27.23,32711,1764,14,75,1245,5,3103,5.388.690.476
25/06/2019 05:00,32.44,35761,1612,9,52,966,4,2643,5.388.690.476
25/06/2019 06:00,35.15,39106,1455,7,27,725,2,2216,5.388.690.476
25/06/2019 07:00,35.33,40485,1372,8,16,593,1,1990,5.388.690.476
25/06/2019 08:00,35.51,40637,1260,10,12,557,1,1840,5.388.690.476
25/06/2019 09:00,35.59,41047,1150,15,10,516,1,1692,5.388.690.476
25/06/2019 10:00,35.46,41109,1084,21,8,514,1,1628,5.388.690.476
25/06/2019 11:00,34.96,40861,1135,27,7,546,1,1716,5.388.690.476
25/06/2019 12:00,34.83,40552,1150,36,6,565,1,1758,5.388.690.476
25/06/2019 13:00,34.81,40321,1092,44,6,558,1,1701,5.388.690.476
25/06/2019 14:00,33.81,39892,1050,50,7,576,2,1685,5.388.690.476
25/06/2019 15:00,33.57,39599,995,55,7,569,2,1628,5.388.690.476
25/06/2019 16:00,35.05,39452,902,56,8,591,2,1559,5.388.690.476
25/06/2019 17:00,35.22,39018,792,54,9,605,3,1463,5.388.690.476
25/06/2019 18:00,35.18,38599,700,53,9,655,3,1420,5.388.690.476
25/06/2019 19:00,34,37915,681,50,15,735,3,1484,5.388.690.476
25/06/2019 20:00,33.15,37263,804,47,27,773,5,1656,5.388.690.476
25/06/2019 21:00,31.77,36395,914,44,49,909,8,1924,5.388.690.476
25/06/2019 22:00,30.36,34722,975,38,64,970,9,2056,5.388.690.476
25/06/2019 23:00,29.82,32913,596,29,66,977,7,1675,5.388.690.476
26/06/2019 00:00,29.82,31784,555,23,77,1004,7,1666,5.388.690.476
26/06/2019 01:00,29.71,31302,520,18,85,901,4,1528,5.388.690.476
26/06/2019 02:00,29.59,31012,454,15,86,765,3,1323,5.388.690.476
26/06/2019 03:00,29.08,31077,428,11,90,644,2,1175,5.388.690.476
26/06/2019 04:00,30.22,32604,474,8,82,511,1,1076,5.388.690.476
26/06/2019 05:00,33.2,36005,545,4,61,381,1,992,5.388.690.476
26/06/2019 06:00,34.95,39311,593,3,40,274,1,911,5.388.690.476
26/06/2019 07:00,35.99,40893,742,2,30,266,1,1041,5.388.690.476
26/06/2019 08:00,36.08,41414,1021,3,29,276,1,1330,5.388.690.476
26/06/2019 09:00,35.82,41842,1395,4,29,296,1,1725,5.388.690.476
26/06/2019 10:00,34.95,41870,1711,6,33,370,1,2121,5.388.690.476
26/06/2019 11:00,34.61,41594,2051,7,41,511,1,2611,5.388.690.476
26/06/2019 12:00,33.56,41358,2298,8,56,669,2,3033,5.388.690.476
26/06/2019 13:00,32.64,41043,2533,8,67,851,6,3465,5.388.690.476
26/06/2019 14:00,30.86,40775,2819,8,75,1082,7,3991,5.388.690.476
26/06/2019 15:00,30.53,40457,3037,7,86,1378,11,4519,5.388.690.476
26/06/2019 16:00,31.73,40303,3133,7,90,1620,11,4861,5.388.690.476
26/06/2019 17:00,31.69,39714,3244,7,81,1915,14,5261,5.388.690.476
26/06/2019 18:00,31.11,39064,3241,7,78,2164,11,5501,5.388.690.476
26/06/2019 19:00,29.93,38117,3113,9,99,2353,14,5588,5.388.690.476
26/06/2019 20:00,29.35,37537,3164,12,150,2552,17,5895,5.388.690.476
26/06/2019 21:00,28.26,36601,3249,16,217,2878,7,6367,5.388.690.476
26/06/2019 22:00,22.1,34949,3348,20,257,3102,6,6733,5.388.690.476
26/06/2019 23:00,22.98,32850,3442,13,101,3082,2,6640,5.388.690.476
27/06/2019 00:00,23.52,31655,3416,14,120,3209,4,6763,5.388.690.476
27/06/2019 01:00,22.09,31149,3444,16,146,3299,11,6916,5.388.690.476
27/06/2019 02:00,21.16,30959,3399,20,170,3324,22,6935,5.388.690.476
27/06/2019 03:00,19.28,30936,3332,22,198,3305,32,6889,5.388.690.476
27/06/2019 04:00,23.27,32442,3248,22,222,3288,32,6812,5.388.690.476
27/06/2019 05:00,28.65,35718,3121,21,235,3139,29,6545,5.388.690.476
27/06/2019 06:00,30.6,39052,2996,17,237,3268,37,6555,5.388.690.476
27/06/2019 07:00,31.05,40422,3013,14,243,3213,33,6516,5.388.690.476
27/06/2019 08:00,31.87,40843,2751,14,259,3237,40,6301,5.388.690.476
27/06/2019 09:00,32.45,41452,2522,13,269,3174,48,6026,5.388.690.476
27/06/2019 10:00,32.56,41477,2315,13,294,3263,49,5934,5.388.690.476
27/06/2019 11:00,31.7,41202,2194,12,323,3407,55,5991,5.388.690.476
27/06/2019 12:00,31.12,41040,2039,12,337,3449,56,5893,5.388.690.476
27/06/2019 13:00,30.98,40718,1886,13,358,3414,57,5728,5.388.690.476
27/06/2019 14:00,30.31,40465,1792,14,358,3456,59,5679,5.388.690.476
27/06/2019 15:00,30.47,40078,1724,13,350,3390,59,5536,5.388.690.476
27/06/2019 16:00,31.07,40111,1600,12,338,3282,60,5292,5.388.690.476
27/06/2019 17:00,31.36,39532,1484,13,327,3152,59,5035,5.388.690.476
27/06/2019 18:00,31.88,38953,1364,14,304,3052,57,4791,5.388.690.476
27/06/2019 19:00,30.82,38003,1216,20,284,2856,53,4429,5.388.690.476
27/06/2019 20:00,30.38,37289,1120,22,269,2785,48,4244,5.388.690.476
27/06/2019 21:00,30.35,36408,1149,26,259,2752,44,4230,5.388.690.476
27/06/2019 22:00,28.64,34838,1154,24,254,2682,42,4156,5.388.690.476
27/06/2019 23:00,28.12,33530,1082,12,0,2591,38,3723,5.388.690.476
28/06/2019 00:00,28.31,32487,960,15,0,2503,37,3515,5.388.690.476
28/06/2019 01:00,28.13,32066,887,20,0,2461,32,3400,5.388.690.476
28/06/2019 02:00,28.06,31710,805,29,0,2402,31,3267,5.388.690.476
28/06/2019 03:00,27.34,31756,732,40,0,2243,30,3045,5.388.690.476
28/06/2019 04:00,29.32,33281,676,49,0,2115,22,2862,5.388.690.476
28/06/2019 05:00,31.59,36415,582,56,0,1923,19,2580,5.388.690.476
28/06/2019 06:00,32.54,39768,516,62,0,1786,21,2385,5.388.690.476
28/06/2019 07:00,33.42,41445,498,69,0,1694,31,2292,5.388.690.476
28/06/2019 08:00,33.51,41786,416,80,0,1685,32,2213,5.388.690.476
28/06/2019 09:00,33.53,42107,394,87,0,1647,32,2160,5.388.690.476
28/06/2019 10:00,33.17,41882,398,99,0,1677,32,2206,5.388.690.476
28/06/2019 11:00,32.81,41378,445,112,0,1706,32,2295,5.388.690.476
28/06/2019 12:00,32.29,40864,472,121,0,1828,29,2450,5.388.690.476
28/06/2019 13:00,31.97,40253,479,130,0,1949,29,2587,5.388.690.476
28/06/2019 14:00,30.85,39571,460,142,0,2109,28,2739,5.388.690.476
28/06/2019 15:00,30.39,39189,462,154,0,2135,27,2778,5.388.690.476
28/06/2019 16:00,30.87,39041,485,162,0,1965,25,2637,5.388.690.476
28/06/2019 17:00,31.43,38494,522,165,0,1774,19,2480,5.388.690.476
28/06/2019 18:00,31.48,37834,555,167,0,1564,16,2302,5.388.690.476
28/06/2019 19:00,30.42,36647,553,169,0,1525,12,2259,5.388.690.476
28/06/2019 20:00,29.79,35946,582,172,0,1562,9,2325,5.388.690.476
28/06/2019 21:00,28.88,35282,600,181,0,1804,10,2595,5.388.690.476
28/06/2019 22:00,28.4,34157,654,189,0,2159,9,3011,5.388.690.476
28/06/2019 23:00,28.47,32810,819,47,127,2271,5,3269,5.388.690.476
29/06/2019 00:00,27.14,31728,852,48,111,2517,8,3536,5.388.690.476
29/06/2019 01:00,26.56,31092,947,45,99,2662,9,3762,5.388.690.476
29/06/2019 02:00,25.08,30571,1078,41,88,2771,9,3987,5.388.690.476
29/06/2019 03:00,24.39,30157,1160,38,73,2811,8,4090,5.388.690.476
29/06/2019 04:00,23.92,30294,1182,34,63,2873,7,4159,5.388.690.476
29/06/2019 05:00,24.93,31125,1150,36,49,2823,6,4064,5.388.690.476
29/06/2019 06:00,26.32,32566,1109,44,45,2826,3,4027,5.388.690.476
29/06/2019 07:00,26.61,34440,1158,56,58,2916,3,4191,5.388.690.476
29/06/2019 08:00,27.54,35964,1110,79,71,3015,2,4277,5.388.690.476
29/06/2019 09:00,27.58,36855,1140,105,90,3201,2,4538,5.388.690.476
29/06/2019 10:00,27.46,36928,1154,129,112,3198,4,4597,5.388.690.476
29/06/2019 11:00,27.38,36616,1153,142,137,3303,8,4743,5.388.690.476
29/06/2019 12:00,25.57,36408,1078,144,168,3380,18,4788,5.388.690.476
29/06/2019 13:00,24.95,36032,1014,144,192,3429,30,4809,5.388.690.476
29/06/2019 14:00,24.97,35762,992,140,214,3493,26,4865,5.388.690.476
29/06/2019 15:00,26.26,35777,976,130,227,3447,23,4803,5.388.690.476
29/06/2019 16:00,27.57,36096,920,113,215,3362,15,4625,5.388.690.476
29/06/2019 17:00,29.23,36135,823,95,182,3210,7,4317,5.388.690.476
29/06/2019 18:00,29.3,35615,671,78,150,3085,4,3988,5.388.690.476
29/06/2019 19:00,29.02,34849,538,63,131,2943,2,3677,5.388.690.476
29/06/2019 20:00,28.64,34378,468,55,117,2810,1,3451,5.388.690.476
29/06/2019 21:00,27.91,33978,466,51,103,2718,1,3339,5.388.690.476
29/06/2019 22:00,27.35,33107,451,50,91,2556,1,3149,5.388.690.476
29/06/2019 23:00,26.54,31810,537,62,103,2515,8,3225,5.388.690.476
30/06/2019 00:00,25.08,30774,624,60,103,2347,10,3144,5.388.690.476
30/06/2019 01:00,24.01,30275,668,55,106,2114,14,2957,5.388.690.476
30/06/2019 02:00,20.75,29836,708,47,111,2008,18,2892,5.388.690.476
30/06/2019 03:00,16.68,29365,821,37,116,1740,16,2730,5.388.690.476
30/06/2019 04:00,12.02,29394,935,25,117,1401,12,2490,5.388.690.476
30/06/2019 05:00,14.14,29882,1075,15,117,1104,7,2318,5.388.690.476
30/06/2019 06:00,15.94,31067,1190,10,116,818,4,2138,5.388.690.476
30/06/2019 07:00,21.26,32616,1380,10,119,707,6,2222,5.388.690.476
30/06/2019 08:00,22.15,34002,1624,11,123,722,7,2487,5.388.690.476
30/06/2019 09:00,23.05,35057,1927,15,133,853,6,2934,5.388.690.476
30/06/2019 10:00,23.56,35541,2178,19,147,1161,5,3510,5.388.690.476
30/06/2019 11:00,24.1,35591,2474,25,160,1620,6,4285,5.388.690.476
30/06/2019 12:00,23.01,35326,2703,33,168,2106,6,5016,5.388.690.476
30/06/2019 13:00,20,35167,3007,36,165,2699,10,5917,5.388.690.476
30/06/2019 14:00,15.02,35141,3426,35,153,3233,17,6864,5.388.690.476
30/06/2019 15:00,12.07,35299,3675,33,138,3779,19,7644,5.388.690.476
30/06/2019 16:00,21.11,35673,3687,28,122,4335,17,8189,5.388.690.476
30/06/2019 17:00,26.16,35846,3552,23,99,4717,17,8408,5.388.690.476
30/06/2019 18:00,26.01,35654,3206,21,94,4878,15,8214,5.388.690.476
30/06/2019 19:00,25.91,35109,2742,21,129,4979,21,7892,5.388.690.476
30/06/2019 20:00,25.88,34869,2446,24,196,4948,29,7643,5.388.690.476
30/06/2019 21:00,24.49,34418,2342,28,251,4874,36,7531,5.388.690.476
30/06/2019 22:00,21.73,33294,2367,28,279,4828,39,7541,5.388.690.476
30/06/2019 23:00,24.37,32023,2376,201,306,4787,43,7713,5.388.690.476
01/07/2019 00:00,20.51,31136,2409,201,304,4668,43,7625,5.515.119.048
01/07/2019 01:00,20.09,30759,2446,197,308,4555,32,7538,5.515.119.048
01/07/2019 02:00,20.83,30617,2365,191,300,4025,29,6910,5.515.119.048
01/07/2019 03:00,21.87,30679,2256,183,295,3859,27,6620,5.515.119.048
01/07/2019 04:00,24.54,32131,2149,174,286,3689,29,6327,5.515.119.048
01/07/2019 05:00,27.67,35490,2096,164,283,3627,32,6202,5.515.119.048
01/07/2019 06:00,30.8,38819,2217,152,292,3626,33,6320,5.515.119.048
01/07/2019 07:00,32.21,40325,2594,136,308,3643,35,6716,5.515.119.048
01/07/2019 08:00,32.27,40719,2719,126,335,3763,38,6981,5.515.119.048
01/07/2019 09:00,32.11,41127,2915,123,368,3925,36,7367,5.515.119.048
01/07/2019 10:00,31.46,41234,3147,127,385,4070,36,7765,5.515.119.048
01/07/2019 11:00,29.45,41055,3482,137,404,4040,37,8100,5.515.119.048
01/07/2019 12:00,28.1,41078,3717,148,412,4036,41,8354,5.515.119.048
01/07/2019 13:00,27.94,40878,3897,163,410,3998,43,8511,5.515.119.048
01/07/2019 14:00,27.64,40526,4067,182,401,3936,46,8632,5.515.119.048
01/07/2019 15:00,27.16,40214,4129,192,391,3807,47,8566,5.515.119.048
01/07/2019 16:00,27.87,40195,4063,186,369,3758,45,8421,5.515.119.048
01/07/2019 17:00,28.88,39704,3970,170,340,3627,45,8152,5.515.119.048
01/07/2019 18:00,28.73,39016,3704,149,298,3461,43,7655,5.515.119.048
01/07/2019 19:00,28.13,38063,3440,130,269,3428,37,7304,5.515.119.048
01/07/2019 20:00,27.75,37329,3391,116,280,3514,25,7326,5.515.119.048
01/07/2019 21:00,27.44,36478,3445,109,296,3718,28,7596,5.515.119.048
01/07/2019 22:00,26.08,34861,3533,105,304,3804,29,7775,5.515.119.048
01/07/2019 23:00,25.02,33010,3556,147,316,3952,27,7998,5.515.119.048
02/07/2019 00:00,24.09,32061,3632,147,338,4094,34,8245,5.515.119.048
02/07/2019 01:00,22.73,31652,3746,137,337,4147,37,8404,5.515.119.048
02/07/2019 02:00,21.53,31451,3818,130,310,4136,37,8431,5.515.119.048
02/07/2019 03:00,20.57,31563,3803,145,295,4098,32,8373,5.515.119.048
02/07/2019 04:00,21.49,32966,3764,159,287,3998,29,8237,5.515.119.048
02/07/2019 05:00,25.24,35863,3733,162,292,3961,28,8176,5.515.119.048
02/07/2019 06:00,27.54,39161,3774,166,309,3964,25,8238,5.515.119.048
02/07/2019 07:00,28.3,40744,4051,171,322,3891,25,8460,5.515.119.048
02/07/2019 08:00,29.49,41224,4045,176,340,3837,24,8422,5.515.119.048
02/07/2019 09:00,29.87,41790,4063,183,363,3669,25,8303,5.515.119.048
02/07/2019 10:00,30.36,41867,3955,190,382,3421,32,7980,5.515.119.048
02/07/2019 11:00,29.25,41794,4018,195,402,3244,39,7898,5.515.119.048
02/07/2019 12:00,29.79,41548,4037,198,419,3014,41,7709,5.515.119.048
02/07/2019 13:00,29.52,41267,4059,198,427,2922,39,7645,5.515.119.048
02/07/2019 14:00,29.45,40914,4163,197,435,2821,38,7654,5.515.119.048
02/07/2019 15:00,29.58,40538,4212,195,442,2833,46,7728,5.515.119.048
02/07/2019 16:00,30.32,40546,4141,189,439,2828,43,7640,5.515.119.048
02/07/2019 17:00,29.91,40121,4062,180,430,2692,39,7403,5.515.119.048
02/07/2019 18:00,31.1,39629,3779,166,421,2441,39,6846,5.515.119.048
02/07/2019 19:00,30.99,38815,3341,151,412,2303,40,6247,5.515.119.048
02/07/2019 20:00,29.87,38146,3035,137,397,2286,43,5898,5.515.119.048
02/07/2019 21:00,28.91,37227,2868,128,378,2359,42,5775,5.515.119.048
02/07/2019 22:00,27.49,35535,2840,119,371,2423,23,5776,5.515.119.048
02/07/2019 23:00,26.12,33550,2666,110,366,2519,22,5683,5.515.119.048
03/07/2019 00:00,25.7,32608,2547,107,353,2634,18,5659,5.515.119.048
03/07/2019 01:00,25.37,32210,2514,105,326,2621,18,5584,5.515.119.048
03/07/2019 02:00,25.15,31963,2486,96,278,2676,15,5551,5.515.119.048
03/07/2019 03:00,25.33,31986,2369,85,212,2653,19,5338,5.515.119.048
03/07/2019 04:00,26.52,33367,2346,76,159,2512,23,5116,5.515.119.048
03/07/2019 05:00,29.35,36436,2429,69,147,2332,17,4994,5.515.119.048
03/07/2019 06:00,30.98,39636,2642,63,155,2163,6,5029,5.515.119.048
03/07/2019 07:00,31.5,41190,3002,57,173,2059,15,5306,5.515.119.048
03/07/2019 08:00,31.63,41791,2960,52,194,2088,20,5314,5.515.119.048
03/07/2019 09:00,31.78,42249,3002,47,222,2047,11,5329,5.515.119.048
03/07/2019 10:00,31.54,42275,3045,51,251,2110,14,5471,5.515.119.048
03/07/2019 11:00,30.46,42151,3213,54,277,2167,14,5725,5.515.119.048
03/07/2019 12:00,29.98,41978,3361,63,308,2245,18,5995,5.515.119.048
03/07/2019 13:00,29.7,41767,3485,65,331,2292,17,6190,5.515.119.048
03/07/2019 14:00,29.81,41432,3714,66,334,2390,28,6532,5.515.119.048
03/07/2019 15:00,29.29,41055,3874,63,336,2400,23,6696,5.515.119.048
03/07/2019 16:00,29.96,40981,3870,58,319,2361,15,6623,5.515.119.048
03/07/2019 17:00,30.24,40355,3853,49,279,2230,7,6418,5.515.119.048
03/07/2019 18:00,30.26,39752,3643,44,229,2131,8,6055,5.515.119.048
03/07/2019 19:00,29.98,38823,3299,42,197,2139,4,5681,5.515.119.048
03/07/2019 20:00,29.21,38205,3072,48,186,2151,4,5461,5.515.119.048
03/07/2019 21:00,28.76,37340,3005,61,174,2219,5,5464,5.515.119.048
03/07/2019 22:00,27.32,35661,3030,81,173,2312,8,5604,5.515.119.048
03/07/2019 23:00,27.77,33962,2974,124,0,2283,6,5387,5.515.119.048
04/07/2019 00:00,27.29,32979,2805,124,0,2455,5,5389,5.515.119.048
04/07/2019 01:00,26.82,32471,2688,128,0,2494,8,5318,5.515.119.048
04/07/2019 02:00,26.98,32193,2575,137,0,2378,5,5095,5.515.119.048
04/07/2019 03:00,27.11,32151,2486,148,0,2292,5,4931,5.515.119.048
04/07/2019 04:00,28.01,33616,2480,155,0,2121,5,4761,5.515.119.048
04/07/2019 05:00,29.16,36676,2589,154,0,2124,5,4872,5.515.119.048
04/07/2019 06:00,30.9,39883,2808,157,0,2171,6,5142,5.515.119.048
04/07/2019 07:00,31.86,41506,3175,163,0,2191,8,5537,5.515.119.048
04/07/2019 08:00,31.9,42052,3326,168,0,2301,8,5803,5.515.119.048
04/07/2019 09:00,31.63,42542,3575,172,0,2440,11,6198,5.515.119.048
04/07/2019 10:00,31.07,42504,3664,177,0,2551,14,6406,5.515.119.048
04/07/2019 11:00,29.93,42301,3846,181,0,2560,19,6606,5.515.119.048
04/07/2019 12:00,29.86,42139,3926,184,0,2557,28,6695,5.515.119.048
04/07/2019 13:00,29.63,41848,3968,186,0,2620,33,6807,5.515.119.048
04/07/2019 14:00,29.68,41543,4065,184,0,2636,34,6919,5.515.119.048
04/07/2019 15:00,29.41,41132,4075,179,0,2681,41,6976,5.515.119.048
04/07/2019 16:00,29.98,41253,4013,171,0,2657,39,6880,5.515.119.048
04/07/2019 17:00,29.73,40713,3947,158,0,2613,44,6762,5.515.119.048
04/07/2019 18:00,29.7,40117,3675,143,0,2554,47,6419,5.515.119.048
04/07/2019 19:00,29.6,39140,3359,127,0,2583,46,6115,5.515.119.048
04/07/2019 20:00,28.95,38451,3220,115,0,2591,47,5973,5.515.119.048
04/07/2019 21:00,28.48,37650,3158,105,0,2795,49,6107,5.515.119.048
04/07/2019 22:00,27.28,36023,3138,95,0,2966,50,6249,5.515.119.048
04/07/2019 23:00,26.19,33891,3305,83,404,3225,48,7065,5.515.119.048
05/07/2019 00:00,25.83,32932,3058,73,404,3351,49,6935,5.515.119.048
05/07/2019 01:00,25.45,32537,2823,66,396,3381,48,6714,5.515.119.048
05/07/2019 02:00,25.52,32207,2536,60,385,3406,35,6422,5.515.119.048
05/07/2019 03:00,25.89,32303,2235,51,370,3402,32,6090,5.515.119.048
05/07/2019 04:00,26.85,33716,1971,41,358,3290,32,5692,5.515.119.048
05/07/2019 05:00,28.74,36559,1672,37,337,3182,27,5255,5.515.119.048
05/07/2019 06:00,31.01,39637,1390,35,319,3033,34,4811,5.515.119.048
05/07/2019 07:00,31.41,41280,1271,36,333,2919,38,4597,5.515.119.048
05/07/2019 08:00,31.74,41739,1063,39,373,2779,41,4295,5.515.119.048
05/07/2019 09:00,31.82,42011,990,44,396,2817,46,4293,5.515.119.048
05/07/2019 10:00,31.78,41759,967,48,413,2838,49,4315,5.515.119.048
05/07/2019 11:00,31.58,41337,1014,52,421,2962,50,4499,5.515.119.048
05/07/2019 12:00,31.04,40807,1065,57,427,2972,50,4571,5.515.119.048
05/07/2019 13:00,30.48,40331,1144,60,427,2911,50,4592,5.515.119.048
05/07/2019 14:00,30.17,39676,1295,58,427,2828,50,4658,5.515.119.048
05/07/2019 15:00,29.84,39346,1444,56,423,2666,50,4639,5.515.119.048
05/07/2019 16:00,30.95,39219,1529,54,408,2448,50,4489,5.515.119.048
05/07/2019 17:00,31.25,38778,1671,49,383,2202,49,4354,5.515.119.048
05/07/2019 18:00,31.19,38093,1731,49,347,1992,48,4167,5.515.119.048
05/07/2019 19:00,30.15,36956,1655,55,312,1933,46,4001,5.515.119.048
05/07/2019 20:00,29.9,36317,1470,68,281,2039,45,3903,5.515.119.048
05/07/2019 21:00,29.47,35709,1416,83,256,2210,42,4007,5.515.119.048
05/07/2019 22:00,28.56,34584,1443,86,234,2327,40,4130,5.515.119.048
05/07/2019 23:00,29.42,33157,1598,98,298,2474,40,4508,5.515.119.048
06/07/2019 00:00,28.47,32134,1517,94,287,2526,40,4464,5.515.119.048
06/07/2019 01:00,27.77,31549,1412,84,281,2401,38,4216,5.515.119.048
06/07/2019 02:00,27.68,31255,1242,70,270,2280,38,3900,5.515.119.048
06/07/2019 03:00,27.49,30863,1097,57,252,2143,38,3587,5.515.119.048
06/07/2019 04:00,27.98,31106,1039,47,231,1907,38,3262,5.515.119.048
06/07/2019 05:00,28.51,31935,1075,41,207,1609,25,2957,5.515.119.048
06/07/2019 06:00,29.03,33284,1163,45,198,1375,27,2808,5.515.119.048
06/07/2019 07:00,30.06,35043,1333,46,200,1132,26,2737,5.515.119.048
06/07/2019 08:00,30.25,36513,1411,46,219,1028,24,2728,5.515.119.048
06/07/2019 09:00,29.7,37349,1637,47,231,982,22,2919,5.515.119.048
06/07/2019 10:00,28.54,37511,1884,53,236,924,19,3116,5.515.119.048
06/07/2019 11:00,27.53,37303,2239,61,236,868,16,3420,5.515.119.048
06/07/2019 12:00,27.18,37073,2540,74,242,944,18,3818,5.515.119.048
06/07/2019 13:00,26.78,36712,2804,84,234,895,14,4031,5.515.119.048
06/07/2019 14:00,26.54,36508,3235,95,206,966,12,4514,5.515.119.048
06/07/2019 15:00,27.79,36511,3515,100,176,1022,12,4825,5.515.119.048
06/07/2019 16:00,29.13,36872,3552,96,147,1046,12,4853,5.515.119.048
06/07/2019 17:00,30,36863,3647,90,113,1094,10,4954,5.515.119.048
06/07/2019 18:00,30.41,36338,3545,85,89,1159,8,4886,5.515.119.048
06/07/2019 19:00,29.2,35568,3273,82,78,1111,7,4551,5.515.119.048
06/07/2019 20:00,28.98,35150,3058,83,82,1149,8,4380,5.515.119.048
06/07/2019 21:00,29.44,34630,3035,86,83,1199,8,4411,5.515.119.048
06/07/2019 22:00,28.39,33742,3087,81,87,1261,8,4524,5.515.119.048
06/07/2019 23:00,28.21,32396,3161,76,97,1258,6,4598,5.515.119.048
07/07/2019 00:00,26.49,31443,3068,68,133,1363,8,4640,5.515.119.048
07/07/2019 01:00,25.88,30953,3054,60,160,1434,10,4718,5.515.119.048
07/07/2019 02:00,24.27,30619,2974,51,175,1432,10,4642,5.515.119.048
07/07/2019 03:00,23.36,30212,2879,45,189,1458,22,4593,5.515.119.048
07/07/2019 04:00,24.19,30235,2804,35,194,1394,13,4440,5.515.119.048
07/07/2019 05:00,25.13,30643,2725,27,208,1296,18,4274,5.515.119.048
07/07/2019 06:00,25.66,31725,2666,23,227,1242,21,4179,5.515.119.048
07/07/2019 07:00,26.85,33094,2720,20,233,1193,13,4179,5.515.119.048
07/07/2019 08:00,27.99,34312,2529,18,230,1109,16,3902,5.515.119.048
07/07/2019 09:00,28.54,35265,2402,17,233,1058,14,3724,5.515.119.048
07/07/2019 10:00,28.38,35774,2233,18,256,1075,18,3600,5.515.119.048
07/07/2019 11:00,27.94,35760,2195,18,289,1036,18,3556,5.515.119.048
07/07/2019 12:00,27.59,35566,2233,19,307,1065,15,3639,5.515.119.048
07/07/2019 13:00,26.91,35496,2311,18,313,1117,11,3770,5.515.119.048
07/07/2019 14:00,26.84,35429,2482,19,307,1126,7,3941,5.515.119.048
07/07/2019 15:00,27.33,35689,2576,24,297,1198,6,4101,5.515.119.048
07/07/2019 16:00,28.12,36097,2530,28,277,1228,7,4070,5.515.119.048
07/07/2019 17:00,29.2,36347,2510,33,255,1246,5,4049,5.515.119.048
07/07/2019 18:00,30.98,36183,2344,40,231,1319,9,3943,5.515.119.048
07/07/2019 19:00,31.21,35689,2088,55,202,1411,11,3767,5.515.119.048
07/07/2019 20:00,31.72,35415,1778,84,177,1628,8,3675,5.515.119.048
07/07/2019 21:00,31.25,34952,1620,123,161,1917,7,3828,5.515.119.048
07/07/2019 22:00,30.01,33763,1592,142,145,2095,8,3982,5.515.119.048
07/07/2019 23:00,29.62,32180,1658,122,125,2377,13,4295,5.515.119.048
08/07/2019 00:00,29.03,31305,1585,126,131,2519,16,4377,5.524.464.286
08/07/2019 01:00,28.56,30925,1547,118,143,2565,16,4389,5.524.464.286
08/07/2019 02:00,28.49,30720,1510,104,140,2575,15,4344,5.524.464.286
08/07/2019 03:00,28.53,30823,1470,93,132,2534,13,4242,5.524.464.286
08/07/2019 04:00,29.11,32118,1447,89,128,2436,14,4114,5.524.464.286
08/07/2019 05:00,31.18,35089,1394,94,125,2371,9,3993,5.524.464.286
08/07/2019 06:00,31.4,38276,1402,97,129,2309,9,3946,5.524.464.286
08/07/2019 07:00,31.66,39993,1509,95,149,2274,9,4036,5.524.464.286
08/07/2019 08:00,31.5,40645,1415,90,176,2291,8,3980,5.524.464.286
08/07/2019 09:00,31.52,41060,1387,82,198,2348,7,4022,5.524.464.286
08/07/2019 10:00,31.28,41058,1379,82,218,2357,5,4041,5.524.464.286
08/07/2019 11:00,31.3,40882,1429,75,233,2284,5,4026,5.524.464.286
08/07/2019 12:00,31.14,40707,1551,67,249,2294,6,4167,5.524.464.286
08/07/2019 13:00,31.03,40426,1702,58,249,2220,7,4236,5.524.464.286
08/07/2019 14:00,31.27,40136,1943,68,240,2171,9,4431,5.524.464.286
08/07/2019 15:00,31.16,39810,2076,84,230,2178,9,4577,5.524.464.286
08/07/2019 16:00,31.21,39791,2114,91,216,1986,10,4417,5.524.464.286
08/07/2019 17:00,31.49,39285,2162,95,192,1832,9,4290,5.524.464.286
08/07/2019 18:00,31.47,38713,2063,100,170,1701,10,4044,5.524.464.286
08/07/2019 19:00,31.43,37920,1979,101,146,1637,9,3872,5.524.464.286
08/07/2019 20:00,31.17,37290,1945,104,126,1730,9,3914,5.524.464.286
08/07/2019 21:00,30.78,36412,2048,106,105,1852,9,4120,5.524.464.286
08/07/2019 22:00,29.75,34811,2143,107,89,1995,9,4343,5.524.464.286
08/07/2019 23:00,30.52,32837,1701,24,0,2142,4,3871,5.524.464.286
09/07/2019 00:00,29.48,31859,1701,23,0,2144,3,3871,5.524.464.286
09/07/2019 01:00,29.19,31442,1700,19,0,2109,3,3831,5.524.464.286
09/07/2019 02:00,29.08,31274,1643,16,0,2058,3,3720,5.524.464.286
09/07/2019 03:00,29.21,31297,1559,14,0,1983,4,3560,5.524.464.286
09/07/2019 04:00,30.06,32517,1490,12,0,1802,4,3308,5.524.464.286
09/07/2019 05:00,32.19,35113,1397,8,0,1619,3,3027,5.524.464.286
09/07/2019 06:00,33.27,38064,1381,5,0,1479,2,2867,5.524.464.286
09/07/2019 07:00,33.62,39548,1421,3,0,1470,2,2896,5.524.464.286
09/07/2019 08:00,33.86,40143,1264,3,0,1587,2,2856,5.524.464.286
09/07/2019 09:00,33.86,40639,1187,4,0,1778,2,2971,5.524.464.286
09/07/2019 10:00,33.79,40595,1120,7,0,1893,2,3022,5.524.464.286
09/07/2019 11:00,33.64,40410,1126,11,0,1905,3,3045,5.524.464.286
09/07/2019 12:00,33.03,40130,1166,18,0,1837,4,3025,5.524.464.286
09/07/2019 13:00,32.78,39891,1190,20,0,1636,7,2853,5.524.464.286
09/07/2019 14:00,32.46,39575,1258,17,0,1488,13,2776,5.524.464.286
09/07/2019 15:00,32.66,39215,1307,16,0,1341,16,2680,5.524.464.286
09/07/2019 16:00,32.99,39175,1392,16,0,1195,16,2619,5.524.464.286
09/07/2019 17:00,33.92,38667,1481,16,0,1039,14,2550,5.524.464.286
09/07/2019 18:00,33.97,38123,1490,16,0,880,13,2399,5.524.464.286
09/07/2019 19:00,33.86,37314,1413,17,0,841,10,2281,5.524.464.286
09/07/2019 20:00,33.22,36660,1322,22,0,910,10,2264,5.524.464.286
09/07/2019 21:00,32.52,35922,1283,27,0,908,9,2227,5.524.464.286
09/07/2019 22:00,31.48,34383,1264,32,0,999,9,2304,5.524.464.286
09/07/2019 23:00,32.88,32718,1196,45,114,1125,8,2488,5.524.464.286
10/07/2019 00:00,32.31,31721,1125,46,106,1357,11,2645,5.524.464.286
10/07/2019 01:00,31.69,31244,1094,50,99,1549,10,2802,5.524.464.286
10/07/2019 02:00,31.55,30976,1061,53,97,1603,9,2823,5.524.464.286
10/07/2019 03:00,31.63,30916,1015,55,96,1630,7,2803,5.524.464.286
10/07/2019 04:00,32.31,32038,1002,51,92,1507,6,2658,5.524.464.286
10/07/2019 05:00,33.23,34763,939,48,90,1211,4,2292,5.524.464.286
10/07/2019 06:00,33.79,37655,934,51,85,1004,3,2077,5.524.464.286
10/07/2019 07:00,34.11,39186,975,56,81,907,3,2022,5.524.464.286
10/07/2019 08:00,34.25,39909,934,63,74,869,3,1943,5.524.464.286
10/07/2019 09:00,34.33,40302,916,72,75,882,3,1948,5.524.464.286
10/07/2019 10:00,34.12,40334,913,82,78,918,5,1996,5.524.464.286
10/07/2019 11:00,33.95,40055,1015,90,87,1002,6,2200,5.524.464.286
10/07/2019 12:00,33.78,39802,1103,99,109,1038,8,2357,5.524.464.286
10/07/2019 13:00,33.73,39492,1127,104,123,1026,8,2388,5.524.464.286
10/07/2019 14:00,33.66,39097,1174,109,128,984,9,2404,5.524.464.286
10/07/2019 15:00,33.51,38780,1109,109,131,937,10,2296,5.524.464.286
10/07/2019 16:00,33.58,38661,1069,109,121,848,8,2155,5.524.464.286
10/07/2019 17:00,33.61,38284,1042,106,110,815,9,2082,5.524.464.286
10/07/2019 18:00,34.07,37772,939,96,93,722,8,1858,5.524.464.286
10/07/2019 19:00,33.85,36984,822,87,92,691,6,1698,5.524.464.286
10/07/2019 20:00,33.95,36433,745,84,97,713,7,1646,5.524.464.286
10/07/2019 21:00,33.56,35712,694,85,102,722,8,1611,5.524.464.286
10/07/2019 22:00,32.89,34136,635,86,103,724,7,1555,5.524.464.286
10/07/2019 23:00,34.4,32507,537,85,91,693,7,1413,5.524.464.286
11/07/2019 00:00,34.19,31615,497,87,88,685,8,1365,5.524.464.286
11/07/2019 01:00,33.97,31182,424,90,84,711,8,1317,5.524.464.286
11/07/2019 02:00,33.79,30909,387,88,81,691,8,1255,5.524.464.286
11/07/2019 03:00,33.59,30804,345,85,78,671,9,1188,5.524.464.286
11/07/2019 04:00,34.11,31927,287,79,70,594,9,1039,5.524.464.286
11/07/2019 05:00,34.82,34527,252,71,57,460,7,847,5.524.464.286
11/07/2019 06:00,35.67,37398,231,61,40,347,5,684,5.524.464.286
11/07/2019 07:00,36.08,38931,235,54,37,312,7,645,5.524.464.286
11/07/2019 08:00,36.54,39542,233,52,52,275,7,619,5.524.464.286
11/07/2019 09:00,37.01,39966,245,53,63,233,8,602,5.524.464.286
11/07/2019 10:00,36.51,40036,257,51,79,220,9,616,5.524.464.286
11/07/2019 11:00,36.5,39770,270,48,108,240,11,677,5.524.464.286
11/07/2019 12:00,36.07,39578,276,45,138,245,10,714,5.524.464.286
11/07/2019 13:00,36.23,39343,273,47,171,271,10,772,5.524.464.286
11/07/2019 14:00,36.24,38969,277,49,186,306,8,826,5.524.464.286
11/07/2019 15:00,35.97,38603,269,47,200,322,6,844,5.524.464.286
11/07/2019 16:00,35.8,38738,245,44,196,341,5,831,5.524.464.286
11/07/2019 17:00,35.58,38299,215,38,167,342,6,768,5.524.464.286
11/07/2019 18:00,35.48,37783,171,36,142,408,6,763,5.524.464.286
11/07/2019 19:00,35.3,36951,138,33,121,427,6,725,5.524.464.286
11/07/2019 20:00,35.04,36424,115,30,112,467,5,729,5.524.464.286
11/07/2019 21:00,34.86,35701,112,25,102,556,5,800,5.524.464.286
11/07/2019 22:00,34.37,34176,106,21,92,590,5,814,5.524.464.286
11/07/2019 23:00,36.75,32172,83,18,79,547,5,732,5.524.464.286
12/07/2019 00:00,36.33,31282,99,17,69,549,5,739,5.524.464.286
12/07/2019 01:00,35.96,30855,104,19,62,527,5,717,5.524.464.286
12/07/2019 02:00,35.82,30645,87,23,55,465,6,636,5.524.464.286
12/07/2019 03:00,35.47,30611,89,27,45,412,6,579,5.524.464.286
12/07/2019 04:00,35.89,31810,90,30,36,343,6,505,5.524.464.286
12/07/2019 05:00,36.39,34308,96,29,27,275,5,432,5.524.464.286
12/07/2019 06:00,37.09,37046,108,27,21,185,4,345,5.524.464.286
12/07/2019 07:00,37.7,38696,117,28,19,173,4,341,5.524.464.286
12/07/2019 08:00,38.19,39380,129,28,18,156,4,335,5.524.464.286
12/07/2019 09:00,38.28,39743,132,28,16,173,4,353,5.524.464.286
12/07/2019 10:00,38.21,39539,128,29,20,205,4,386,5.524.464.286
12/07/2019 11:00,38.08,39222,127,29,25,260,4,445,5.524.464.286
12/07/2019 12:00,37.49,38792,127,31,27,281,4,470,5.524.464.286
12/07/2019 13:00,37.39,38320,135,33,32,310,5,515,5.524.464.286
12/07/2019 14:00,36.93,37854,140,34,35,332,6,547,5.524.464.286
12/07/2019 15:00,36.92,37495,121,33,34,322,5,515,5.524.464.286
12/07/2019 16:00,36.93,37379,119,31,32,337,6,525,5.524.464.286
12/07/2019 17:00,36.93,36940,134,28,31,340,6,539,5.524.464.286
12/07/2019 18:00,36.87,36296,146,24,31,331,5,537,5.524.464.286
12/07/2019 19:00,36.61,35296,161,21,33,339,5,559,5.524.464.286
12/07/2019 20:00,36.56,34660,170,20,48,368,4,610,5.524.464.286
12/07/2019 21:00,36.07,34064,186,19,60,438,5,708,5.524.464.286
12/07/2019 22:00,35.64,32977,192,16,63,486,5,762,5.524.464.286
12/07/2019 23:00,37.65,31234,264,87,18,453,4,826,5.524.464.286
13/07/2019 00:00,37.15,30291,274,102,16,446,3,841,5.524.464.286
13/07/2019 01:00,36.48,29761,295,115,15,453,3,881,5.524.464.286
13/07/2019 02:00,36.12,29428,314,120,13,427,3,877,5.524.464.286
13/07/2019 03:00,36.15,29086,313,117,12,397,3,842,5.524.464.286
13/07/2019 04:00,35.36,29188,303,109,11,354,3,780,5.524.464.286
13/07/2019 05:00,36.07,29777,275,95,9,264,3,646,5.524.464.286
13/07/2019 06:00,36.55,30984,255,82,7,207,3,554,5.524.464.286
13/07/2019 07:00,37.22,32626,293,73,6,164,3,539,5.524.464.286
13/07/2019 08:00,38.05,33993,339,64,6,163,3,575,5.524.464.286
13/07/2019 09:00,38.3,34845,370,58,7,202,2,639,5.524.464.286
13/07/2019 10:00,37.74,35036,385,57,7,237,3,689,5.524.464.286
13/07/2019 11:00,36.82,34843,430,58,10,262,3,763,5.524.464.286
13/07/2019 12:00,35.63,34581,491,61,14,287,3,856,5.524.464.286
13/07/2019 13:00,35.12,34288,560,63,21,310,6,960,5.524.464.286
13/07/2019 14:00,34.84,34197,676,60,31,355,7,1129,5.524.464.286
13/07/2019 15:00,34.8,34267,781,57,42,407,7,1294,5.524.464.286
13/07/2019 16:00,35.69,34649,844,52,53,396,7,1352,5.524.464.286
13/07/2019 17:00,36.7,34667,902,47,53,383,7,1392,5.524.464.286
13/07/2019 18:00,37.37,34110,879,41,55,391,6,1372,5.524.464.286
13/07/2019 19:00,36.9,33439,810,37,65,406,4,1322,5.524.464.286
13/07/2019 20:00,36.79,33100,736,32,77,467,5,1317,5.524.464.286
13/07/2019 21:00,37.22,32747,775,28,85,527,6,1421,5.524.464.286
13/07/2019 22:00,36.93,31951,868,24,81,572,6,1551,5.524.464.286
13/07/2019 23:00,36.98,30734,1083,11,82,581,3,1760,5.524.464.286
14/07/2019 00:00,35.41,29878,1007,8,78,644,3,1740,5.524.464.286
14/07/2019 01:00,34.34,29394,931,6,72,653,3,1665,5.524.464.286
14/07/2019 02:00,33.77,29044,851,5,67,671,3,1597,5.524.464.286
14/07/2019 03:00,33.21,28642,776,5,62,764,3,1610,5.524.464.286
14/07/2019 04:00,33.2,28600,736,6,55,650,3,1450,5.524.464.286
14/07/2019 05:00,33.87,29046,656,6,33,520,3,1218,5.524.464.286
14/07/2019 06:00,34.76,30089,582,6,20,409,3,1020,5.524.464.286
14/07/2019 07:00,36.33,31424,585,6,16,333,3,943,5.524.464.286
14/07/2019 08:00,36.92,32617,529,6,17,298,2,852,5.524.464.286
14/07/2019 09:00,37.44,33520,462,8,18,260,3,751,5.524.464.286
14/07/2019 10:00,37.94,34026,427,11,22,238,3,701,5.524.464.286
14/07/2019 11:00,37.22,34049,464,15,30,292,4,805,5.524.464.286
14/07/2019 12:00,36.11,33859,499,21,40,307,5,872,5.524.464.286
14/07/2019 13:00,35.33,33793,542,26,57,341,6,972,5.524.464.286
14/07/2019 14:00,35.09,33678,643,26,75,417,6,1167,5.524.464.286
14/07/2019 15:00,35.28,33885,803,23,95,467,7,1395,5.524.464.286
14/07/2019 16:00,36.57,34227,963,23,99,547,8,1640,5.524.464.286
14/07/2019 17:00,37.84,34490,1079,22,92,603,8,1804,5.524.464.286
14/07/2019 18:00,38.29,34297,1121,22,82,708,7,1940,5.524.464.286
14/07/2019 19:00,38.94,33947,1090,23,76,799,5,1993,5.524.464.286
14/07/2019 20:00,38.45,33770,1077,24,77,934,5,2117,5.524.464.286
14/07/2019 21:00,38.61,33407,1135,26,76,1101,4,2342,5.524.464.286
14/07/2019 22:00,37.7,32228,1209,28,69,1211,4,2521,5.524.464.286
14/07/2019 23:00,37.33,30732,1117,11,59,1312,4,2503,5.524.464.286
15/07/2019 00:00,36.6,29870,1147,10,47,1347,3,2554,5.538.630.952
15/07/2019 01:00,36.45,29516,1156,8,42,1282,2,2490,5.538.630.952
15/07/2019 02:00,35.16,29398,1136,6,37,1235,3,2417,5.538.630.952
15/07/2019 03:00,34.93,29395,1105,6,34,1228,2,2375,5.538.630.952
15/07/2019 04:00,36.84,30512,1097,7,26,1196,1,2327,5.538.630.952
15/07/2019 05:00,39.43,33322,1088,6,16,1178,2,2290,5.538.630.952
15/07/2019 06:00,39.64,36297,1130,5,8,1154,2,2299,5.538.630.952
15/07/2019 07:00,39.61,38077,1237,6,6,1112,2,2363,5.538.630.952
15/07/2019 08:00,39.5,38984,1221,7,6,1096,2,2332,5.538.630.952
15/07/2019 09:00,39.64,39534,1198,7,8,1057,2,2272,5.538.630.952
15/07/2019 10:00,39.66,39569,1190,8,9,1097,2,2306,5.538.630.952
15/07/2019 11:00,39.55,39346,1254,9,12,1207,2,2484,5.538.630.952
15/07/2019 12:00,39.49,39162,1344,10,18,1242,4,2618,5.538.630.952
15/07/2019 13:00,38.49,38897,1426,11,26,1382,6,2851,5.538.630.952
15/07/2019 14:00,38.45,38544,1528,11,31,1434,8,3012,5.538.630.952
15/07/2019 15:00,38.01,38209,1567,11,34,1495,9,3116,5.538.630.952
15/07/2019 16:00,38.47,38175,1583,11,35,1477,7,3113,5.538.630.952
15/07/2019 17:00,39.29,37720,1616,10,34,1384,3,3047,5.538.630.952
15/07/2019 18:00,39.23,37154,1548,10,32,1310,3,2903,5.538.630.952
15/07/2019 19:00,38.94,36286,1434,10,29,1247,3,2723,5.538.630.952
15/07/2019 20:00,38.65,35717,1406,12,28,1237,3,2686,5.538.630.952
15/07/2019 21:00,38.48,34919,1433,14,31,1290,5,2773,5.538.630.952
15/07/2019 22:00,37.34,33366,1448,17,32,1383,7,2887,5.538.630.952
15/07/2019 23:00,36.82,31687,1256,7,27,1577,14,2881,5.538.630.952
16/07/2019 00:00,36.27,30782,1153,7,42,1755,14,2971,5.538.630.952
16/07/2019 01:00,34.93,30428,1080,7,50,2026,17,3180,5.538.630.952
16/07/2019 02:00,33.89,30232,1004,6,53,2194,25,3282,5.538.630.952
16/07/2019 03:00,33.13,30227,951,5,58,2318,15,3347,5.538.630.952
16/07/2019 04:00,35.81,31272,926,4,63,2396,11,3400,5.538.630.952
16/07/2019 05:00,38.15,33713,882,3,64,2303,6,3258,5.538.630.952
16/07/2019 06:00,38.21,36465,853,3,68,2316,3,3243,5.538.630.952
16/07/2019 07:00,38.43,38072,912,2,71,2357,5,3347,5.538.630.952
16/07/2019 08:00,38.61,38818,895,2,69,2432,2,3400,5.538.630.952
16/07/2019 09:00,38.69,39313,845,4,68,2439,2,3358,5.538.630.952
16/07/2019 10:00,38.71,39484,798,6,66,2452,1,3323,5.538.630.952
16/07/2019 11:00,38.68,39327,809,8,72,2490,2,3381,5.538.630.952
16/07/2019 12:00,38.53,39047,844,10,77,2449,2,3382,5.538.630.952
16/07/2019 13:00,38.5,38831,846,11,85,2363,5,3310,5.538.630.952
16/07/2019 14:00,38.2,38485,931,12,101,2291,2,3337,5.538.630.952
16/07/2019 15:00,38.24,38162,966,13,113,2234,7,3333,5.538.630.952
16/07/2019 16:00,38.66,38101,961,11,119,2126,2,3219,5.538.630.952
16/07/2019 17:00,38.82,37703,910,11,107,1966,2,2996,5.538.630.952
16/07/2019 18:00,38.98,37302,816,14,96,1757,2,2685,5.538.630.952
16/07/2019 19:00,38.91,36566,699,18,81,1520,2,2320,5.538.630.952
16/07/2019 20:00,39.09,36054,662,24,62,1324,1,2073,5.538.630.952
16/07/2019 21:00,38.91,35290,708,34,47,1220,1,2010,5.538.630.952
16/07/2019 22:00,38.36,33681,667,42,39,1149,1,1898,5.538.630.952
16/07/2019 23:00,38.45,31895,537,81,31,1036,3,1688,5.538.630.952
17/07/2019 00:00,37.63,30999,457,91,29,981,3,1561,5.538.630.952
17/07/2019 01:00,37.36,30622,384,102,26,896,4,1412,5.538.630.952
17/07/2019 02:00,36.93,30328,323,113,26,865,6,1333,5.538.630.952
17/07/2019 03:00,37.27,30234,278,118,30,831,7,1264,5.538.630.952
17/07/2019 04:00,37.95,31169,239,110,31,709,7,1096,5.538.630.952
17/07/2019 05:00,38.66,33590,186,90,30,534,5,845,5.538.630.952
17/07/2019 06:00,38.92,36304,143,76,31,419,4,673,5.538.630.952
17/07/2019 07:00,39.23,37901,125,63,37,331,5,561,5.538.630.952
17/07/2019 08:00,39.43,38745,94,53,44,258,7,456,5.538.630.952
17/07/2019 09:00,39.61,39104,78,47,54,218,6,403,5.538.630.952
17/07/2019 10:00,39.52,39067,72,39,61,215,3,390,5.538.630.952
17/07/2019 11:00,39.43,38842,89,35,79,210,3,416,5.538.630.952
17/07/2019 12:00,39.22,38687,123,29,97,232,3,484,5.538.630.952
17/07/2019 13:00,39.12,38411,153,23,118,245,7,546,5.538.630.952
17/07/2019 14:00,39.12,38090,191,24,128,311,10,664,5.538.630.952
17/07/2019 15:00,38.98,37762,207,22,132,328,14,703,5.538.630.952
17/07/2019 16:00,39.07,37678,209,19,128,311,12,679,5.538.630.952
17/07/2019 17:00,39.04,37305,205,20,121,338,8,692,5.538.630.952
17/07/2019 18:00,39.16,36844,194,26,112,329,6,667,5.538.630.952
17/07/2019 19:00,38.94,36119,176,32,110,387,5,710,5.538.630.952
17/07/2019 20:00,39.14,35547,142,37,110,433,5,727,5.538.630.952
17/07/2019 21:00,39.06,34848,111,43,110,480,6,750,5.538.630.952
17/07/2019 22:00,38.6,33376,102,48,102,513,6,771,5.538.630.952
17/07/2019 23:00,38.75,31079,78,41,81,518,8,726,5.538.630.952
18/07/2019 00:00,38,30216,70,36,76,504,5,691,5.538.630.952
18/07/2019 01:00,37.33,29750,69,35,71,481,5,661,5.538.630.952
18/07/2019 02:00,37.27,29537,80,33,66,430,4,613,5.538.630.952
18/07/2019 03:00,37.12,29510,91,31,62,394,4,582,5.538.630.952
18/07/2019 04:00,37.69,30383,107,25,54,362,4,552,5.538.630.952
18/07/2019 05:00,38.55,32664,126,18,39,296,3,482,5.538.630.952
18/07/2019 06:00,38.89,35273,144,13,31,266,3,457,5.538.630.952
18/07/2019 07:00,39.22,36831,188,11,27,231,3,460,5.538.630.952
18/07/2019 08:00,39.58,37609,233,14,27,247,2,523,5.538.630.952
18/07/2019 09:00,39.74,38134,276,19,27,297,2,621,5.538.630.952
18/07/2019 10:00,39.65,38224,305,23,32,351,3,714,5.538.630.952
18/07/2019 11:00,39.28,37954,369,27,39,366,4,805,5.538.630.952
18/07/2019 12:00,39.05,37795,423,33,59,411,5,931,5.538.630.952
18/07/2019 13:00,38.98,37606,457,39,73,475,7,1051,5.538.630.952
18/07/2019 14:00,38.97,37184,489,48,85,514,7,1143,5.538.630.952
18/07/2019 15:00,38.91,36788,494,52,95,551,6,1198,5.538.630.952
18/07/2019 16:00,39.23,36794,470,47,97,580,6,1200,5.538.630.952
18/07/2019 17:00,39.08,36393,448,37,90,607,6,1188,5.538.630.952
18/07/2019 18:00,39.2,35907,443,35,80,624,5,1187,5.538.630.952
18/07/2019 19:00,38.92,35115,442,36,77,705,3,1263,5.538.630.952
18/07/2019 20:00,38.75,34561,490,36,75,835,3,1439,5.538.630.952
18/07/2019 21:00,38.85,33870,538,37,72,1002,4,1653,5.538.630.952
18/07/2019 22:00,38.64,32500,604,36,61,1096,4,1801,5.538.630.952
18/07/2019 23:00,37.92,30860,609,33,62,1105,2,1811,5.538.630.952
19/07/2019 00:00,37.06,29990,578,29,52,1067,2,1728,5.538.630.952
19/07/2019 01:00,37,29578,559,25,41,993,2,1620,5.538.630.952
19/07/2019 02:00,36.66,29387,500,21,37,943,2,1503,5.538.630.952
19/07/2019 03:00,36.68,29385,435,21,34,906,3,1399,5.538.630.952
19/07/2019 04:00,37.67,30359,372,22,27,777,3,1201,5.538.630.952
19/07/2019 05:00,38.34,32509,312,24,20,630,3,989,5.538.630.952
19/07/2019 06:00,38.77,35028,240,24,14,554,2,834,5.538.630.952
19/07/2019 07:00,39.32,36699,251,25,12,503,2,793,5.538.630.952
19/07/2019 08:00,39.66,37412,238,29,16,507,3,793,5.538.630.952
19/07/2019 09:00,39.88,37834,231,35,20,534,3,823,5.538.630.952
19/07/2019 10:00,39.71,37689,227,42,25,591,3,888,5.538.630.952
19/07/2019 11:00,39.68,37386,236,51,31,624,3,945,5.538.630.952
19/07/2019 12:00,38.98,37060,230,58,41,675,5,1009,5.538.630.952
19/07/2019 13:00,38.7,36671,230,64,44,743,5,1086,5.538.630.952
19/07/2019 14:00,38.78,36213,245,69,48,711,4,1077,5.538.630.952
19/07/2019 15:00,38.56,35881,270,78,47,703,4,1102,5.538.630.952
19/07/2019 16:00,39.12,35795,245,85,44,656,3,1033,5.538.630.952
19/07/2019 17:00,39.34,35409,209,88,39,643,3,982,5.538.630.952
19/07/2019 18:00,39.51,34761,174,87,36,631,3,931,5.538.630.952
19/07/2019 19:00,38.87,33789,123,83,34,685,2,927,5.538.630.952
19/07/2019 20:00,39.09,33335,93,82,33,855,3,1066,5.538.630.952
19/07/2019 21:00,38.82,32803,92,84,32,923,3,1134,5.538.630.952
19/07/2019 22:00,38.41,31764,99,84,25,1002,3,1213,5.538.630.952
19/07/2019 23:00,39.2,30090,136,18,10,1007,2,1173,5.538.630.952
20/07/2019 00:00,38.08,29157,190,17,11,954,3,1175,5.538.630.952
20/07/2019 01:00,36.81,28658,281,12,12,854,3,1162,5.538.630.952
20/07/2019 02:00,35.61,28389,373,10,12,698,3,1096,5.538.630.952
20/07/2019 03:00,34.36,28122,485,8,13,659,2,1167,5.538.630.952
20/07/2019 04:00,34.03,28151,597,6,13,582,2,1200,5.538.630.952
20/07/2019 05:00,34.97,28737,706,4,13,434,2,1159,5.538.630.952
20/07/2019 06:00,35.88,29826,814,3,9,319,2,1147,5.538.630.952
20/07/2019 07:00,37.01,31345,919,3,6,262,2,1192,5.538.630.952
20/07/2019 08:00,37.08,32665,989,4,6,299,2,1300,5.538.630.952
20/07/2019 09:00,36.57,33445,1066,7,5,346,2,1426,5.538.630.952
20/07/2019 10:00,36.44,33657,1101,8,5,459,2,1575,5.538.630.952
20/07/2019 11:00,35.85,33437,1100,9,5,593,2,1709,5.538.630.952
20/07/2019 12:00,35.44,33165,1136,11,6,764,2,1919,5.538.630.952
20/07/2019 13:00,35.16,32899,1173,12,9,869,3,2066,5.538.630.952
20/07/2019 14:00,34.91,32737,1323,13,12,971,3,2322,5.538.630.952
20/07/2019 15:00,35.02,32831,1506,15,12,1043,3,2579,5.538.630.952
20/07/2019 16:00,36.32,33168,1695,18,12,1092,3,2820,5.538.630.952
20/07/2019 17:00,37.32,33316,1843,20,10,1149,3,3025,5.538.630.952
20/07/2019 18:00,37.97,32886,1861,19,11,1275,3,3169,5.538.630.952
20/07/2019 19:00,37.9,32268,1742,16,11,1386,3,3158,5.538.630.952
20/07/2019 20:00,37.66,31950,1662,14,15,1648,3,3342,5.538.630.952
20/07/2019 21:00,38.03,31570,1508,12,26,2025,4,3575,5.538.630.952
20/07/2019 22:00,37.24,30684,1361,12,32,2164,5,3574,5.538.630.952
20/07/2019 23:00,35.42,29847,1120,12,82,2278,8,3500,5.538.630.952
21/07/2019 00:00,33.47,28927,1032,11,96,2286,11,3436,5.538.630.952
21/07/2019 01:00,33,28433,1078,14,97,2187,16,3392,5.538.630.952
21/07/2019 02:00,31.27,28089,1003,15,86,2021,14,3139,5.538.630.952
21/07/2019 03:00,30.99,27702,931,15,77,1904,16,2943,5.538.630.952
21/07/2019 04:00,31.55,27610,948,13,65,1694,16,2736,5.538.630.952
21/07/2019 05:00,33.35,28084,991,9,51,1390,14,2455,5.538.630.952
21/07/2019 06:00,35.13,29108,1003,8,35,1190,8,2244,5.538.630.952
21/07/2019 07:00,36,30396,1103,10,29,1183,5,2330,5.538.630.952
21/07/2019 08:00,36.5,31685,1180,11,30,1222,4,2447,5.538.630.952
21/07/2019 09:00,36.96,32528,1296,12,34,1371,5,2718,5.538.630.952
21/07/2019 10:00,36.62,32954,1469,14,40,1548,6,3077,5.538.630.952
21/07/2019 11:00,36.03,32993,1792,16,41,1747,7,3603,5.538.630.952
21/07/2019 12:00,35.24,32889,2190,17,43,1955,6,4211,5.538.630.952
21/07/2019 13:00,34.39,32829,2409,19,42,2055,7,4532,5.538.630.952
21/07/2019 14:00,33.87,32777,2584,22,40,2112,10,4768,5.538.630.952
21/07/2019 15:00,34.36,32977,2668,22,40,2142,5,4877,5.538.630.952
21/07/2019 16:00,35.54,33320,2689,22,33,2149,5,4898,5.538.630.952
21/07/2019 17:00,36.71,33606,2547,21,33,2083,6,4690,5.538.630.952
21/07/2019 18:00,38.13,33456,2304,18,31,1989,2,4344,5.538.630.952
21/07/2019 19:00,38.91,33107,1926,16,30,1940,2,3914,5.538.630.952
21/07/2019 20:00,39.05,33004,1730,14,34,1889,2,3669,5.538.630.952
21/07/2019 21:00,38.76,32639,1610,12,39,1917,2,3580,5.538.630.952
21/07/2019 22:00,37.98,31469,1585,11,43,1954,4,3597,5.538.630.952
21/07/2019 23:00,37.47,29709,1402,103,52,1994,6,3557,5.538.630.952
22/07/2019 00:00,35.11,28934,1279,99,61,1961,4,3404,5.603.392.857
22/07/2019 01:00,34.23,28579,1146,94,73,1910,3,3226,5.603.392.857
22/07/2019 02:00,34.22,28481,1028,88,74,1855,3,3048,5.603.392.857
22/07/2019 03:00,34.16,28506,976,81,75,1743,4,2879,5.603.392.857
22/07/2019 04:00,36.18,29505,939,75,80,1531,4,2629,5.603.392.857
22/07/2019 05:00,37.88,31982,923,69,86,1298,3,2379,5.603.392.857
22/07/2019 06:00,38.04,34648,928,63,101,1179,3,2274,5.603.392.857
22/07/2019 07:00,38.18,36330,1036,64,125,1133,4,2362,5.603.392.857
22/07/2019 08:00,38.4,37081,1137,67,157,1178,4,2543,5.603.392.857
22/07/2019 09:00,38.44,37556,1326,72,196,1267,5,2866,5.603.392.857
22/07/2019 10:00,38.29,37645,1501,76,227,1377,10,3191,5.603.392.857
22/07/2019 11:00,37.99,37548,1598,79,248,1466,15,3406,5.603.392.857
22/07/2019 12:00,37.65,37400,1832,84,258,1499,18,3691,5.603.392.857
22/07/2019 13:00,37.46,37233,1931,87,267,1517,19,3821,5.603.392.857
22/07/2019 14:00,37.72,36933,1932,87,262,1471,19,3771,5.603.392.857
22/07/2019 15:00,37.99,36614,1908,84,257,1432,14,3695,5.603.392.857
22/07/2019 16:00,38.14,36654,1876,79,243,1287,11,3496,5.603.392.857
22/07/2019 17:00,38.71,36316,1752,71,220,1193,10,3246,5.603.392.857
22/07/2019 18:00,38.67,35762,1585,62,195,1101,9,2952,5.603.392.857
22/07/2019 19:00,38.51,34918,1384,54,174,1062,7,2681,5.603.392.857
22/07/2019 20:00,38.3,34463,1300,50,159,1062,8,2579,5.603.392.857
22/07/2019 21:00,38.22,33707,1263,50,142,1118,9,2582,5.603.392.857
22/07/2019 22:00,37.84,32096,1238,50,130,1183,10,2611,5.603.392.857
22/07/2019 23:00,37.97,30519,1307,49,100,1144,3,2603,5.603.392.857
23/07/2019 00:00,37.57,29627,1276,44,91,1146,3,2560,5.603.392.857
23/07/2019 01:00,36.96,29268,1206,39,85,1078,3,2411,5.603.392.857
23/07/2019 02:00,36.49,29118,1098,35,77,977,2,2189,5.603.392.857
23/07/2019 03:00,36.3,29105,986,30,70,844,2,1932,5.603.392.857
23/07/2019 04:00,37.73,30018,863,24,65,719,2,1673,5.603.392.857
23/07/2019 05:00,37.78,32195,724,16,52,566,2,1360,5.603.392.857
23/07/2019 06:00,38.04,34778,635,9,43,474,1,1162,5.603.392.857
23/07/2019 07:00,38.35,36422,601,6,45,447,1,1100,5.603.392.857
23/07/2019 08:00,38.5,37259,560,6,58,443,2,1069,5.603.392.857
23/07/2019 09:00,38.64,37739,549,7,69,476,3,1104,5.603.392.857
23/07/2019 10:00,38.57,37858,554,8,87,520,5,1174,5.603.392.857
23/07/2019 11:00,38.58,37679,561,9,104,598,5,1277,5.603.392.857
23/07/2019 12:00,38.41,37415,544,9,114,646,7,1320,5.603.392.857
23/07/2019 13:00,38.3,37179,525,11,127,631,9,1303,5.603.392.857
23/07/2019 14:00,38.25,36856,502,12,137,595,10,1256,5.603.392.857
23/07/2019 15:00,38.28,36548,447,10,144,549,9,1159,5.603.392.857
23/07/2019 16:00,38.24,36532,394,9,137,477,8,1025,5.603.392.857
23/07/2019 17:00,38.58,36128,320,9,119,382,7,837,5.603.392.857
23/07/2019 18:00,38.53,35683,248,10,100,333,5,696,5.603.392.857
23/07/2019 19:00,38.39,34937,162,9,91,357,4,623,5.603.392.857
23/07/2019 20:00,38.26,34443,123,9,87,394,3,616,5.603.392.857
23/07/2019 21:00,38.11,33713,100,10,82,479,3,674,5.603.392.857
23/07/2019 22:00,37.61,32171,89,11,76,519,2,697,5.603.392.857
23/07/2019 23:00,39.63,30193,111,9,55,487,3,665,5.603.392.857
24/07/2019 00:00,38.63,29259,98,8,44,481,3,634,5.603.392.857
24/07/2019 01:00,38.29,28797,88,8,39,444,2,581,5.603.392.857
24/07/2019 02:00,38.16,28614,76,8,36,391,3,514,5.603.392.857
24/07/2019 03:00,37.93,28554,75,7,34,319,3,438,5.603.392.857
24/07/2019 04:00,38.39,29372,92,4,31,248,2,377,5.603.392.857
24/07/2019 05:00,38.65,31520,101,3,19,189,1,313,5.603.392.857
24/07/2019 06:00,38.84,33955,109,3,11,177,1,301,5.603.392.857
24/07/2019 07:00,39.18,35547,118,3,6,144,1,272,5.603.392.857
24/07/2019 08:00,39.34,36476,134,3,5,160,2,304,5.603.392.857
24/07/2019 09:00,39.36,37059,147,4,6,176,2,335,5.603.392.857
24/07/2019 10:00,39.28,37176,164,6,7,187,2,366,5.603.392.857
24/07/2019 11:00,39.06,36998,209,8,10,233,4,464,5.603.392.857
24/07/2019 12:00,39.15,36859,252,10,14,261,4,541,5.603.392.857
24/07/2019 13:00,39.17,36611,283,12,21,290,5,611,5.603.392.857
24/07/2019 14:00,39.27,36288,327,14,33,310,6,690,5.603.392.857
24/07/2019 15:00,39.19,35998,386,16,44,317,6,769,5.603.392.857
24/07/2019 16:00,39.14,35948,439,17,52,322,5,835,5.603.392.857
24/07/2019 17:00,39.52,35636,492,18,57,326,4,897,5.603.392.857
24/07/2019 18:00,39.54,35167,600,17,61,307,4,989,5.603.392.857
24/07/2019 19:00,39.16,34412,694,19,66,380,2,1161,5.603.392.857
24/07/2019 20:00,38.98,34018,848,22,68,487,2,1427,5.603.392.857
24/07/2019 21:00,38.81,33382,1061,24,68,578,2,1733,5.603.392.857
24/07/2019 22:00,38.56,31876,1189,24,65,686,2,1966,5.603.392.857
24/07/2019 23:00,40.06,29986,1318,26,41,664,0,2049,5.603.392.857
25/07/2019 00:00,39.76,29084,1331,23,33,730,0,2117,5.603.392.857
25/07/2019 01:00,38.88,28569,1306,21,24,774,0,2125,5.603.392.857
25/07/2019 02:00,38.65,28410,1203,22,21,750,0,1996,5.603.392.857
25/07/2019 03:00,38.52,28351,1127,20,17,694,0,1858,5.603.392.857
25/07/2019 04:00,38.93,29220,1026,16,13,578,0,1633,5.603.392.857
25/07/2019 05:00,38.91,31329,918,11,9,415,0,1353,5.603.392.857
25/07/2019 06:00,39.49,33779,783,8,7,223,0,1021,5.603.392.857
25/07/2019 07:00,40.14,35384,687,8,6,163,0,864,5.603.392.857
25/07/2019 08:00,40.28,36203,575,10,10,170,0,765,5.603.392.857
25/07/2019 09:00,40.42,36785,540,15,16,177,1,749,5.603.392.857
25/07/2019 10:00,40.31,36888,556,20,29,224,1,830,5.603.392.857
25/07/2019 11:00,40.35,36738,572,26,45,277,2,922,5.603.392.857
25/07/2019 12:00,40.28,36661,610,35,66,338,4,1053,5.603.392.857
25/07/2019 13:00,40.12,36512,620,43,81,391,6,1141,5.603.392.857
25/07/2019 14:00,39.97,36234,645,49,98,409,10,1211,5.603.392.857
25/07/2019 15:00,39.89,35950,690,51,112,423,11,1287,5.603.392.857
25/07/2019 16:00,39.87,35964,740,51,119,421,11,1342,5.603.392.857
25/07/2019 17:00,40.6,35624,807,51,108,453,10,1429,5.603.392.857
25/07/2019 18:00,40.48,35134,809,50,101,478,7,1445,5.603.392.857
25/07/2019 19:00,40.37,34363,745,51,100,540,4,1440,5.603.392.857
25/07/2019 20:00,40.09,34004,775,53,99,691,5,1623,5.603.392.857
25/07/2019 21:00,39.63,33327,815,54,97,869,7,1842,5.603.392.857
25/07/2019 22:00,39.25,31891,949,54,95,1001,5,2104,5.603.392.857
25/07/2019 23:00,38.65,30099,996,57,67,1011,11,2142,5.603.392.857
26/07/2019 00:00,37.74,29139,958,55,66,991,10,2080,5.603.392.857
26/07/2019 01:00,37.2,28738,947,52,64,874,9,1946,5.603.392.857
26/07/2019 02:00,36.58,28547,928,51,68,765,7,1819,5.603.392.857
26/07/2019 03:00,36.37,28557,910,48,70,689,4,1721,5.603.392.857
26/07/2019 04:00,38.34,29509,895,40,69,577,3,1584,5.603.392.857
26/07/2019 05:00,38.69,31662,863,32,60,412,3,1370,5.603.392.857
26/07/2019 06:00,39.55,34072,845,27,57,270,2,1201,5.603.392.857
26/07/2019 07:00,40.14,35857,840,25,61,237,2,1165,5.603.392.857
26/07/2019 08:00,40.4,36681,809,24,85,229,3,1150,5.603.392.857
26/07/2019 09:00,40.52,37307,813,27,106,232,9,1187,5.603.392.857
26/07/2019 10:00,40.49,37254,801,31,117,284,9,1242,5.603.392.857
26/07/2019 11:00,39.99,36957,779,38,117,377,9,1320,5.603.392.857
26/07/2019 12:00,39.73,36585,827,43,117,484,9,1480,5.603.392.857
26/07/2019 13:00,39.38,36276,896,45,116,561,7,1625,5.603.392.857
26/07/2019 14:00,39.56,35811,956,43,114,597,7,1717,5.603.392.857
26/07/2019 15:00,39.9,35503,1014,42,111,669,7,1843,5.603.392.857
26/07/2019 16:00,39.96,35414,1053,37,107,745,9,1951,5.603.392.857
26/07/2019 17:00,40.76,34984,1081,32,98,801,10,2022,5.603.392.857
26/07/2019 18:00,40.47,34308,1097,30,86,922,10,2145,5.603.392.857
26/07/2019 19:00,40.18,33353,1028,31,86,1085,9,2239,5.603.392.857
26/07/2019 20:00,39.91,32894,1041,34,101,1257,8,2441,5.603.392.857
26/07/2019 21:00,39.59,32360,1141,40,115,1408,12,2716,5.603.392.857
26/07/2019 22:00,38.67,31184,1294,41,120,1458,14,2927,5.603.392.857
26/07/2019 23:00,39.01,29824,1223,58,165,1358,13,2817,5.603.392.857
27/07/2019 00:00,37.59,28797,1236,57,165,1311,13,2782,5.603.392.857
27/07/2019 01:00,37.01,28249,1260,55,165,1220,15,2715,5.603.392.857
27/07/2019 02:00,36.04,27882,1288,52,156,1112,15,2623,5.603.392.857
27/07/2019 03:00,35.1,27532,1333,46,149,1104,15,2647,5.603.392.857
27/07/2019 04:00,35.28,27498,1415,38,139,1022,15,2629,5.603.392.857
27/07/2019 05:00,35.22,28041,1530,30,125,928,12,2625,5.603.392.857
27/07/2019 06:00,35.91,29207,1661,24,111,857,7,2660,5.603.392.857
27/07/2019 07:00,37.56,30870,1834,20,106,883,9,2852,5.603.392.857
27/07/2019 08:00,39.46,32289,1963,17,107,1022,11,3120,5.603.392.857
27/07/2019 09:00,38.67,33109,2125,15,108,1241,16,3505,5.603.392.857
27/07/2019 10:00,38.23,33343,2287,15,111,1421,25,3859,5.603.392.857
27/07/2019 11:00,37.45,33214,2500,15,114,1568,26,4223,5.603.392.857
27/07/2019 12:00,37.35,33035,2712,15,118,1663,28,4536,5.603.392.857
27/07/2019 13:00,37.29,32820,2817,15,121,1692,34,4679,5.603.392.857
27/07/2019 14:00,37.17,32660,2861,15,121,1729,37,4763,5.603.392.857
27/07/2019 15:00,37.22,32768,2887,16,126,1718,35,4782,5.603.392.857
27/07/2019 16:00,37.27,33086,2953,16,128,1736,30,4863,5.603.392.857
27/07/2019 17:00,38.59,33292,2754,15,111,1669,25,4574,5.603.392.857
27/07/2019 18:00,39.22,32789,2458,14,99,1594,15,4180,5.603.392.857
27/07/2019 19:00,38.27,32104,2115,14,100,1559,9,3797,5.603.392.857
27/07/2019 20:00,36.44,31834,1939,14,108,1615,8,3684,5.603.392.857
27/07/2019 21:00,36.2,31479,1850,14,113,1659,7,3643,5.603.392.857
27/07/2019 22:00,35,30376,1871,14,116,1672,9,3682,5.603.392.857
27/07/2019 23:00,34.71,29435,2019,11,130,1714,17,3891,5.603.392.857
28/07/2019 00:00,32.29,28581,1978,10,135,1711,15,3849,5.603.392.857
28/07/2019 01:00,28.95,28099,1982,9,140,1775,15,3921,5.603.392.857
28/07/2019 02:00,27.04,27679,1940,8,142,1824,16,3930,5.603.392.857
28/07/2019 03:00,27.1,27247,1869,8,143,1967,15,4002,5.603.392.857
28/07/2019 04:00,26.8,27077,1851,7,135,1916,13,3922,5.603.392.857
28/07/2019 05:00,29.91,27458,1838,5,119,1852,9,3823,5.603.392.857
28/07/2019 06:00,34.39,28466,1891,4,105,1792,5,3797,5.603.392.857
28/07/2019 07:00,35.53,29825,1910,2,102,1827,3,3844,5.603.392.857
28/07/2019 08:00,36.98,31100,1904,4,112,1794,2,3816,5.603.392.857
28/07/2019 09:00,37.6,31971,2003,4,123,1827,4,3961,5.603.392.857
28/07/2019 10:00,37.73,32407,1948,6,124,1964,5,4047,5.603.392.857
28/07/2019 11:00,37.51,32457,1889,7,123,2084,6,4109,5.603.392.857
28/07/2019 12:00,37.39,32440,1929,9,115,2202,6,4261,5.603.392.857
28/07/2019 13:00,37.26,32383,1926,11,110,2264,6,4317,5.603.392.857
28/07/2019 14:00,37.16,32299,1905,12,106,2267,5,4295,5.603.392.857
28/07/2019 15:00,37.15,32513,1886,13,98,2213,6,4216,5.603.392.857
28/07/2019 16:00,37.91,32914,1735,13,93,2098,7,3946,5.603.392.857
28/07/2019 17:00,38.62,33172,1466,13,87,1917,6,3489,5.603.392.857
28/07/2019 18:00,39.96,33043,1201,15,84,1777,5,3082,5.603.392.857
28/07/2019 19:00,40.18,32700,988,23,92,1760,5,2868,5.603.392.857
28/07/2019 20:00,39.91,32740,990,31,102,1906,5,3034,5.603.392.857
28/07/2019 21:00,40.03,32393,923,41,112,1971,3,3050,5.603.392.857
28/07/2019 22:00,38.72,31061,944,47,113,2058,2,3164,5.603.392.857
28/07/2019 23:00,36.96,30153,785,39,86,1946,3,2859,5.603.392.857
29/07/2019 00:00,35.18,29310,725,38,85,1894,3,2745,5.563.571.429
29/07/2019 01:00,33.73,28977,659,37,82,1814,2,2594,5.563.571.429
29/07/2019 02:00,34.37,28883,603,37,84,1677,2,2403,5.563.571.429
29/07/2019 03:00,34.8,28941,548,35,83,1568,2,2236,5.563.571.429
29/07/2019 04:00,36.41,29910,514,30,80,1470,2,2096,5.563.571.429
29/07/2019 05:00,39.93,32231,490,25,51,1284,2,1852,5.563.571.429
29/07/2019 06:00,41.08,34831,434,23,26,1006,2,1491,5.563.571.429
29/07/2019 07:00,41.6,36507,364,28,11,846,2,1251,5.563.571.429
29/07/2019 08:00,41.89,37289,309,36,9,791,2,1147,5.563.571.429
29/07/2019 09:00,42.01,37736,275,42,10,778,2,1107,5.563.571.429
29/07/2019 10:00,42.1,37843,274,49,9,786,2,1120,5.563.571.429
29/07/2019 11:00,42.08,37679,277,53,11,769,4,1114,5.563.571.429
29/07/2019 12:00,41.61,37539,303,54,16,803,4,1180,5.563.571.429
29/07/2019 13:00,41.47,37344,325,54,26,862,4,1271,5.563.571.429
29/07/2019 14:00,40.98,37132,338,55,36,924,6,1359,5.563.571.429
29/07/2019 15:00,40.99,36909,340,55,51,980,5,1431,5.563.571.429
29/07/2019 16:00,41.19,36978,315,57,58,1142,3,1575,5.563.571.429
29/07/2019 17:00,41.51,36679,267,57,56,1200,3,1583,5.563.571.429
29/07/2019 18:00,41.27,36209,229,50,60,1364,4,1707,5.563.571.429
29/07/2019 19:00,40.95,35455,189,46,72,1451,5,1763,5.563.571.429
29/07/2019 20:00,40.45,35013,182,47,82,1674,4,1989,5.563.571.429
29/07/2019 21:00,39.99,34243,194,47,83,1762,3,2089,5.563.571.429
29/07/2019 22:00,39.32,32563,197,47,80,1971,3,2298,5.563.571.429
29/07/2019 23:00,38.8,30953,246,69,77,2134,4,2530,5.563.571.429
30/07/2019 00:00,38.35,30004,245,58,79,2190,4,2576,5.563.571.429
30/07/2019 01:00,38.16,29641,261,48,72,2172,3,2556,5.563.571.429
30/07/2019 02:00,38,29528,270,43,63,2257,2,2635,5.563.571.429
30/07/2019 03:00,38.16,29581,276,39,58,2342,3,2718,5.563.571.429
30/07/2019 04:00,38.6,30491,277,32,50,2386,4,2749,5.563.571.429
30/07/2019 05:00,39.82,32613,269,25,36,2458,4,2792,5.563.571.429
30/07/2019 06:00,40.58,35169,252,20,25,2489,3,2789,5.563.571.429
30/07/2019 07:00,41.1,36922,220,17,16,2448,5,2706,5.563.571.429
30/07/2019 08:00,41.21,37805,196,14,11,2405,8,2634,5.563.571.429
30/07/2019 09:00,41.16,38435,190,13,9,2543,11,2766,5.563.571.429
30/07/2019 10:00,41.26,38695,191,13,11,2466,11,2692,5.563.571.429
30/07/2019 11:00,40.97,38609,197,14,19,2451,7,2688,5.563.571.429
30/07/2019 12:00,40.68,38363,229,13,29,2399,8,2678,5.563.571.429
30/07/2019 13:00,40.12,38159,296,12,46,2356,13,2723,5.563.571.429
30/07/2019 14:00,40.05,37829,374,9,68,2286,13,2750,5.563.571.429
30/07/2019 15:00,39.78,37453,605,8,94,2184,14,2905,5.563.571.429
30/07/2019 16:00,40.74,37470,722,9,112,2063,15,2921,5.563.571.429
30/07/2019 17:00,41.18,37134,691,14,119,1966,15,2805,5.563.571.429
30/07/2019 18:00,41.12,36657,696,19,127,1902,12,2756,5.563.571.429
30/07/2019 19:00,40.9,35901,598,24,142,1881,11,2656,5.563.571.429
30/07/2019 20:00,40.54,35539,669,27,167,1846,7,2716,5.563.571.429
30/07/2019 21:00,39.97,34785,810,40,184,1980,6,3020,5.563.571.429
30/07/2019 22:00,38.68,33051,938,47,184,2001,5,3175,5.563.571.429
30/07/2019 23:00,37.98,31204,1503,32,145,2004,5,3689,5.563.571.429
31/07/2019 00:00,37.56,30231,1499,32,126,2127,4,3788,5.563.571.429
31/07/2019 01:00,36.01,29758,1526,35,109,2095,4,3769,5.563.571.429
31/07/2019 02:00,35.8,29547,1531,42,93,2116,3,3785,5.563.571.429
31/07/2019 03:00,36.23,29560,1486,51,76,2118,3,3734,5.563.571.429
31/07/2019 04:00,37.81,30490,1434,59,59,2048,2,3602,5.563.571.429
31/07/2019 05:00,39.71,32861,1358,67,37,1817,3,3282,5.563.571.429
31/07/2019 06:00,40.28,35597,1372,80,21,1554,3,3030,5.563.571.429
31/07/2019 07:00,40.99,37223,1463,93,17,1344,2,2919,5.563.571.429
31/07/2019 08:00,41.34,38135,1513,97,22,1259,3,2894,5.563.571.429
31/07/2019 09:00,41.11,38693,1638,98,31,1053,5,2825,5.563.571.429
31/07/2019 10:00,41.38,38763,1705,87,42,884,6,2724,5.563.571.429
31/07/2019 11:00,41.25,38545,1553,78,56,806,6,2499,5.563.571.429
31/07/2019 12:00,41,38468,1486,75,75,691,6,2333,5.563.571.429
31/07/2019 13:00,41.01,38244,1507,78,88,590,7,2270,5.563.571.429
31/07/2019 14:00,40.92,37951,1437,82,94,534,7,2154,5.563.571.429
31/07/2019 15:00,40.52,37648,1431,85,97,451,8,2072,5.563.571.429
31/07/2019 16:00,40.8,37572,1340,86,87,422,7,1942,5.563.571.429
31/07/2019 17:00,41.57,37197,1152,86,74,388,5,1705,5.563.571.429
31/07/2019 18:00,41.49,36632,1026,87,58,361,4,1536,5.563.571.429
31/07/2019 19:00,41.22,35850,879,90,49,331,3,1352,5.563.571.429
31/07/2019 20:00,41.01,35523,832,98,41,361,2,1334,5.563.571.429
31/07/2019 21:00,40.67,34501,815,108,36,388,2,1349,5.563.571.429
31/07/2019 22:00,40.12,32777,756,113,30,381,2,1282,5.563.571.429
31/07/2019 23:00,38.95,30930,696,110,0,330,2,1138,5.563.571.429
01/08/2019 00:00,37.92,29939,689,111,0,329,2,1131,5.563.571.429
01/08/2019 01:00,37.37,29497,625,110,0,349,2,1086,5.563.571.429
01/08/2019 02:00,37.19,29316,555,107,0,373,2,1037,5.563.571.429
01/08/2019 03:00,37.3,29346,535,102,0,412,2,1051,5.563.571.429
01/08/2019 04:00,38.36,30287,514,100,0,429,2,1045,5.563.571.429
01/08/2019 05:00,40.43,32662,473,96,0,380,2,951,5.563.571.429
01/08/2019 06:00,41.4,35370,444,90,0,323,3,860,5.563.571.429
01/08/2019 07:00,41.64,37119,444,86,0,295,2,827,5.563.571.429
01/08/2019 08:00,41.47,37932,398,77,0,232,2,709,5.563.571.429
01/08/2019 09:00,41.03,38586,387,67,0,221,2,677,5.563.571.429
01/08/2019 10:00,41.03,38745,388,60,0,221,2,671,5.563.571.429
01/08/2019 11:00,40.46,38544,410,56,0,251,2,719,5.563.571.429
01/08/2019 12:00,40.63,38382,438,50,0,253,2,743,5.563.571.429
01/08/2019 13:00,40.45,38155,405,43,0,309,2,759,5.563.571.429
01/08/2019 14:00,40.42,37741,326,35,0,325,3,689,5.563.571.429
01/08/2019 15:00,40.47,37290,286,26,0,380,3,695,5.563.571.429
01/08/2019 16:00,41.62,37257,276,19,0,408,3,706,5.563.571.429
01/08/2019 17:00,41.69,36882,269,16,0,417,3,705,5.563.571.429
01/08/2019 18:00,41.58,36328,271,13,0,473,4,761,5.563.571.429
01/08/2019 19:00,41.23,35478,226,12,0,561,3,802,5.563.571.429
01/08/2019 20:00,40.7,35101,214,11,0,776,3,1004,5.563.571.429
01/08/2019 21:00,40.07,34271,221,10,0,1032,4,1267,5.563.571.429
01/08/2019 22:00,39.73,32503,212,10,0,1236,4,1462,5.563.571.429
01/08/2019 23:00,39.04,30783,155,10,21,1373,5,1564,5.563.571.429
02/08/2019 00:00,38.9,29867,128,11,22,1457,6,1624,5.563.571.429
02/08/2019 01:00,38.21,29495,115,11,23,1532,6,1687,5.563.571.429
02/08/2019 02:00,37.94,29301,94,12,23,1617,6,1752,5.563.571.429
02/08/2019 03:00,38.11,29327,88,13,23,1611,5,1740,5.563.571.429
02/08/2019 04:00,39.25,30340,89,13,23,1532,5,1662,5.563.571.429
02/08/2019 05:00,40.48,32623,86,12,21,1245,7,1371,5.563.571.429
02/08/2019 06:00,41.06,35251,75,13,19,956,5,1068,5.563.571.429
02/08/2019 07:00,41.74,37001,77,13,18,770,3,881,5.563.571.429
02/08/2019 08:00,41.93,37762,74,13,20,685,3,795,5.563.571.429
02/08/2019 09:00,41.9,38284,69,12,22,635,3,741,5.563.571.429
02/08/2019 10:00,41.98,38256,67,11,28,538,3,647,5.563.571.429
02/08/2019 11:00,41.86,37943,58,13,31,461,3,566,5.563.571.429
02/08/2019 12:00,41.07,37544,70,14,36,461,4,585,5.563.571.429
02/08/2019 13:00,40.36,37120,90,15,47,450,5,607,5.563.571.429
02/08/2019 14:00,40.22,36496,120,19,47,458,6,650,5.563.571.429
02/08/2019 15:00,40.62,36138,163,20,48,466,5,702,5.563.571.429
02/08/2019 16:00,41.65,36088,193,18,48,477,5,741,5.563.571.429
02/08/2019 17:00,41.9,35696,191,16,45,478,7,737,5.563.571.429
02/08/2019 18:00,41.73,34947,179,15,47,528,5,774,5.563.571.429
02/08/2019 19:00,41.24,34020,141,13,47,548,4,753,5.563.571.429
02/08/2019 20:00,41.01,33634,113,13,46,601,4,777,5.563.571.429
02/08/2019 21:00,40.31,32915,97,13,48,661,4,823,5.563.571.429
02/08/2019 22:00,39.82,31530,92,13,47,728,4,884,5.563.571.429
02/08/2019 23:00,38.96,30496,106,41,45,680,6,878,5.563.571.429
03/08/2019 00:00,38.16,29478,97,38,51,674,6,866,5.563.571.429
03/08/2019 01:00,38.05,28932,93,35,52,615,8,803,5.563.571.429
03/08/2019 02:00,37.74,28535,92,34,54,556,7,743,5.563.571.429
03/08/2019 03:00,37.66,28211,92,36,55,582,9,774,5.563.571.429
03/08/2019 04:00,37.87,28155,98,34,37,538,7,714,5.563.571.429
03/08/2019 05:00,38.11,28733,100,27,22,474,7,630,5.563.571.429
03/08/2019 06:00,38.41,29984,100,19,12,383,6,520,5.563.571.429
03/08/2019 07:00,38.97,31681,106,19,10,314,6,455,5.563.571.429
03/08/2019 08:00,39.73,33092,124,27,16,255,5,427,5.563.571.429
03/08/2019 09:00,39.79,33796,148,40,23,251,3,465,5.563.571.429
03/08/2019 10:00,39.61,34006,173,48,36,262,6,525,5.563.571.429
03/08/2019 11:00,39.42,33811,227,50,61,283,6,627,5.563.571.429
03/08/2019 12:00,39.14,33560,306,48,82,294,8,738,5.563.571.429
03/08/2019 13:00,38.95,33344,374,46,102,340,9,871,5.563.571.429
03/08/2019 14:00,38.91,33172,435,44,111,372,10,972,5.563.571.429
03/08/2019 15:00,38.89,33242,463,42,114,442,9,1070,5.563.571.429
03/08/2019 16:00,38.96,33554,481,38,108,444,8,1079,5.563.571.429
03/08/2019 17:00,39.75,33676,460,31,91,401,8,991,5.563.571.429
03/08/2019 18:00,40.33,33252,425,24,76,395,9,929,5.563.571.429
03/08/2019 19:00,40.28,32676,361,23,70,414,9,877,5.563.571.429
03/08/2019 20:00,40.39,32542,348,28,67,457,7,907,5.563.571.429
03/08/2019 21:00,40.51,32106,354,30,63,443,7,897,5.563.571.429
03/08/2019 22:00,39.47,30933,409,27,56,433,6,931,5.563.571.429
03/08/2019 23:00,38.93,29843,348,29,0,446,6,829,5.563.571.429
04/08/2019 00:00,38.04,28946,366,28,0,452,5,851,5.563.571.429
04/08/2019 01:00,37.45,28523,402,25,0,432,4,863,5.563.571.429
04/08/2019 02:00,37.18,28205,434,22,0,405,3,864,5.563.571.429
04/08/2019 03:00,37.06,27940,468,18,0,388,3,877,5.563.571.429
04/08/2019 04:00,36.48,27789,477,15,0,361,3,856,5.563.571.429
04/08/2019 05:00,37.4,28231,464,12,0,314,3,793,5.563.571.429
04/08/2019 06:00,38.09,29370,456,6,0,240,3,705,5.563.571.429
04/08/2019 07:00,38.69,30775,473,3,0,215,5,696,5.563.571.429
04/08/2019 08:00,39.43,32077,495,3,0,186,7,691,5.563.571.429
04/08/2019 09:00,39.85,32973,531,6,0,174,5,716,5.563.571.429
04/08/2019 10:00,39.85,33398,565,12,0,168,6,751,5.563.571.429
04/08/2019 11:00,39.84,33475,605,19,0,201,7,832,5.563.571.429
04/08/2019 12:00,39.46,33319,689,30,0,249,8,976,5.563.571.429
04/08/2019 13:00,39.3,33175,757,43,0,285,9,1094,5.563.571.429
04/08/2019 14:00,39.2,33084,792,60,0,314,10,1176,5.563.571.429
04/08/2019 15:00,39.12,33337,796,72,0,335,10,1213,5.563.571.429
04/08/2019 16:00,39.28,33768,749,74,0,379,11,1213,5.563.571.429
04/08/2019 17:00,39.86,33963,668,82,0,385,10,1145,5.563.571.429
04/08/2019 18:00,40.77,33735,589,93,0,416,8,1106,5.563.571.429
04/08/2019 19:00,41.85,33438,473,105,0,474,5,1057,5.563.571.429
04/08/2019 20:00,41.92,33508,391,112,0,588,4,1095,5.563.571.429
04/08/2019 21:00,41,32990,354,111,0,688,4,1157,5.563.571.429
04/08/2019 22:00,40.14,31553,347,102,0,825,4,1278,5.563.571.429
04/08/2019 23:00,39.04,30556,243,18,61,814,5,1141,5.563.571.429
05/08/2019 00:00,36.88,29756,230,16,45,817,4,1112,5.543.630.952
05/08/2019 01:00,36.54,29420,205,13,38,789,4,1049,5.543.630.952
05/08/2019 02:00,36.54,29359,173,13,33,734,5,958,5.543.630.952
05/08/2019 03:00,36.8,29439,155,13,29,629,5,831,5.543.630.952
05/08/2019 04:00,39.33,30478,145,14,22,473,5,659,5.543.630.952
05/08/2019 05:00,42.41,32988,150,13,17,333,5,518,5.543.630.952
05/08/2019 06:00,42.84,35784,161,13,13,264,4,455,5.543.630.952
05/08/2019 07:00,43.93,37495,174,15,11,217,4,421,5.543.630.952
05/08/2019 08:00,44.25,38356,171,13,12,201,5,402,5.543.630.952
05/08/2019 09:00,44.26,38934,187,14,15,206,5,427,5.543.630.952
05/08/2019 10:00,43.96,39007,202,16,20,245,4,487,5.543.630.952
05/08/2019 11:00,43.49,38889,224,25,26,267,4,546,5.543.630.952
05/08/2019 12:00,43.44,38671,256,37,31,298,4,626,5.543.630.952
05/08/2019 13:00,42.4,38390,284,47,34,325,4,694,5.543.630.952
05/08/2019 14:00,41.7,37985,324,54,35,368,3,784,5.543.630.952
05/08/2019 15:00,41.91,37622,323,60,34,386,3,806,5.543.630.952
05/08/2019 16:00,42.59,37670,321,64,32,411,3,831,5.543.630.952
05/08/2019 17:00,42.94,37260,317,65,29,419,2,832,5.543.630.952
05/08/2019 18:00,42.95,36644,307,59,25,424,2,817,5.543.630.952
05/08/2019 19:00,42.57,35892,304,57,21,465,2,849,5.543.630.952
05/08/2019 20:00,42.4,35476,309,63,17,495,2,886,5.543.630.952
05/08/2019 21:00,41.74,34513,315,59,16,567,2,959,5.543.630.952
05/08/2019 22:00,39.63,32816,357,55,15,573,2,1002,5.543.630.952
05/08/2019 23:00,38.79,31779,489,46,7,535,4,1081,5.543.630.952
06/08/2019 00:00,37.83,30829,580,49,11,531,5,1176,5.543.630.952
06/08/2019 01:00,36.91,30400,659,50,15,542,6,1272,5.543.630.952
06/08/2019 02:00,36.83,30231,705,55,24,511,7,1302,5.543.630.952
06/08/2019 03:00,36.78,30279,760,60,34,468,8,1330,5.543.630.952
06/08/2019 04:00,38.47,31219,815,61,39,434,9,1358,5.543.630.952
06/08/2019 05:00,39.58,33544,895,62,35,392,8,1392,5.543.630.952
06/08/2019 06:00,41.74,36316,1011,66,28,420,7,1532,5.543.630.952
06/08/2019 07:00,43.35,37947,1126,64,24,392,4,1610,5.543.630.952
06/08/2019 08:00,43.51,38714,1256,59,27,418,4,1764,5.543.630.952
06/08/2019 09:00,41.92,39302,1446,56,31,475,5,2013,5.543.630.952
06/08/2019 10:00,41.64,39441,1560,59,38,522,6,2185,5.543.630.952
06/08/2019 11:00,40.5,39263,1623,71,46,592,5,2337,5.543.630.952
06/08/2019 12:00,40.29,39022,1729,86,62,701,6,2584,5.543.630.952
06/08/2019 13:00,40.25,38755,1822,97,76,788,6,2789,5.543.630.952
06/08/2019 14:00,40.24,38430,1763,106,74,885,10,2838,5.543.630.952
06/08/2019 15:00,40.42,38055,1607,110,78,996,14,2805,5.543.630.952
06/08/2019 16:00,41.96,38035,1500,109,72,1025,11,2717,5.543.630.952
06/08/2019 17:00,42.6,37719,1260,104,61,1061,10,2496,5.543.630.952
06/08/2019 18:00,42.32,37195,1020,96,56,1038,10,2220,5.543.630.952
06/08/2019 19:00,41.73,36413,757,86,60,1104,10,2017,5.543.630.952
06/08/2019 20:00,41.59,36042,615,76,74,1245,9,2019,5.543.630.952
06/08/2019 21:00,40.7,35042,545,67,92,1360,10,2074,5.543.630.952
06/08/2019 22:00,39.56,33235,582,60,98,1449,8,2197,5.543.630.952
06/08/2019 23:00,38.28,31694,722,64,88,1425,3,2302,5.543.630.952
07/08/2019 00:00,36.3,30676,738,61,85,1402,3,2289,5.543.630.952
07/08/2019 01:00,35.78,30222,746,56,80,1265,5,2152,5.543.630.952
07/08/2019 02:00,35.78,29954,792,50,80,1259,6,2187,5.543.630.952
07/08/2019 03:00,35.72,29979,850,45,73,1201,6,2175,5.543.630.952
07/08/2019 04:00,37.6,30862,885,39,64,1055,7,2050,5.543.630.952
07/08/2019 05:00,39.94,33518,941,32,54,881,7,1915,5.543.630.952
07/08/2019 06:00,41.12,36415,954,25,37,750,4,1770,5.543.630.952
07/08/2019 07:00,42.04,38115,1029,22,34,695,7,1787,5.543.630.952
07/08/2019 08:00,42.44,38904,1137,20,31,697,8,1893,5.543.630.952
07/08/2019 09:00,42.42,39412,1222,22,31,662,7,1944,5.543.630.952
07/08/2019 10:00,42.25,39394,1304,25,33,704,6,2072,5.543.630.952
07/08/2019 11:00,41.74,39167,1352,24,38,747,5,2166,5.543.630.952
07/08/2019 12:00,41.68,39063,1458,25,49,814,5,2351,5.543.630.952
07/08/2019 13:00,39.99,38757,1580,22,52,875,5,2534,5.543.630.952
07/08/2019 14:00,39.96,38475,1508,19,43,871,5,2446,5.543.630.952
07/08/2019 15:00,40.39,38151,1278,15,37,878,6,2214,5.543.630.952
07/08/2019 16:00,41.86,38203,1166,13,31,857,5,2072,5.543.630.952
07/08/2019 17:00,41.73,37804,1059,10,23,813,5,1910,5.543.630.952
07/08/2019 18:00,41.76,37175,908,9,18,797,4,1736,5.543.630.952
07/08/2019 19:00,41.02,36375,791,11,12,799,3,1616,5.543.630.952
07/08/2019 20:00,40.66,36009,726,12,10,815,5,1568,5.543.630.952
07/08/2019 21:00,39.49,34948,726,14,12,865,5,1622,5.543.630.952
07/08/2019 22:00,38.07,33125,777,17,11,878,3,1686,5.543.630.952
07/08/2019 23:00,36.52,31640,1005,15,33,828,3,1884,5.543.630.952
08/08/2019 00:00,35.41,30657,1071,17,43,754,4,1889,5.543.630.952
08/08/2019 01:00,35.07,30232,1068,16,49,739,4,1876,5.543.630.952
08/08/2019 02:00,34.97,30064,1054,13,43,687,4,1801,5.543.630.952
08/08/2019 03:00,35.4,30146,1055,13,37,652,3,1760,5.543.630.952
08/08/2019 04:00,36.68,31093,1046,12,31,616,3,1708,5.543.630.952
08/08/2019 05:00,38.03,33573,1043,11,27,569,3,1653,5.543.630.952
08/08/2019 06:00,40.06,36420,1060,9,29,508,2,1608,5.543.630.952
08/08/2019 07:00,39.71,38047,1182,9,31,487,2,1711,5.543.630.952
08/08/2019 08:00,39.83,38779,1313,8,32,473,2,1828,5.543.630.952
08/08/2019 09:00,39.43,39344,1456,10,42,464,2,1974,5.543.630.952
08/08/2019 10:00,39.38,39563,1646,11,65,493,2,2217,5.543.630.952
08/08/2019 11:00,39.2,39463,1879,14,86,543,2,2524,5.543.630.952
08/08/2019 12:00,39.04,39322,2090,19,109,613,2,2833,5.543.630.952
08/08/2019 13:00,38.89,39055,2196,23,135,663,2,3019,5.543.630.952
08/08/2019 14:00,38.3,38608,2219,30,168,706,2,3125,5.543.630.952
08/08/2019 15:00,38.03,38175,2192,32,209,800,5,3238,5.543.630.952
08/08/2019 16:00,38.18,38255,2271,27,223,812,8,3341,5.543.630.952
08/08/2019 17:00,39.2,37834,2161,22,206,775,7,3171,5.543.630.952
08/08/2019 18:00,40.32,37256,2027,17,180,711,8,2943,5.543.630.952
08/08/2019 19:00,40.09,36524,1834,16,161,704,6,2721,5.543.630.952
08/08/2019 20:00,40.11,36084,1737,15,157,731,8,2648,5.543.630.952
08/08/2019 21:00,39.43,35070,1798,17,158,803,8,2784,5.543.630.952
08/08/2019 22:00,38.08,33265,1721,20,160,839,9,2749,5.543.630.952
08/08/2019 23:00,36.25,32042,1711,6,124,826,11,2678,5.543.630.952
09/08/2019 00:00,35.02,31108,1674,8,125,832,11,2650,5.543.630.952
09/08/2019 01:00,34,30669,1587,10,122,781,7,2507,5.543.630.952
09/08/2019 02:00,34.08,30472,1465,11,118,750,7,2351,5.543.630.952
09/08/2019 03:00,33.86,30544,1403,12,115,684,5,2219,5.543.630.952
09/08/2019 04:00,37.23,31553,1248,12,103,619,4,1986,5.543.630.952
09/08/2019 05:00,39.59,33977,966,12,91,525,4,1598,5.543.630.952
09/08/2019 06:00,40.61,36777,767,11,84,442,4,1308,5.543.630.952
09/08/2019 07:00,41.42,38498,610,8,85,346,3,1052,5.543.630.952
09/08/2019 08:00,40.92,39273,478,7,88,270,3,846,5.543.630.952
09/08/2019 09:00,40.01,39790,371,7,86,220,4,688,5.543.630.952
09/08/2019 10:00,39.95,39717,301,7,88,194,5,595,5.543.630.952
09/08/2019 11:00,39.53,39427,236,7,91,174,6,514,5.543.630.952
09/08/2019 12:00,39.46,39001,187,7,93,159,6,452,5.543.630.952
09/08/2019 13:00,39.45,38500,169,6,93,150,7,425,5.543.630.952
09/08/2019 14:00,38.97,37882,187,6,96,141,7,437,5.543.630.952
09/08/2019 15:00,38.74,37550,276,6,101,141,6,530,5.543.630.952
09/08/2019 16:00,39.61,37549,381,6,96,138,5,626,5.543.630.952
09/08/2019 17:00,40.3,37180,566,6,85,155,4,816,5.543.630.952
09/08/2019 18:00,40.05,36464,760,6,70,226,3,1065,5.543.630.952
09/08/2019 19:00,39.07,35632,1012,6,64,331,3,1416,5.543.630.952
09/08/2019 20:00,37.32,35221,1352,7,62,480,3,1904,5.543.630.952
09/08/2019 21:00,35.38,34379,1865,7,58,735,3,2668,5.543.630.952
09/08/2019 22:00,34.98,32923,2265,8,46,955,3,3277,5.543.630.952
09/08/2019 23:00,34.87,31487,2457,52,31,1137,2,3679,5.543.630.952
10/08/2019 00:00,34.62,30438,2648,55,20,1328,2,4053,5.543.630.952
10/08/2019 01:00,33.91,29879,2591,59,13,1496,2,4161,5.543.630.952
10/08/2019 02:00,32.49,29535,2352,62,8,1662,2,4086,5.543.630.952
10/08/2019 03:00,31.41,29253,2169,63,5,1844,2,4083,5.543.630.952
10/08/2019 04:00,31.14,29269,2024,62,3,2023,2,4114,5.543.630.952
10/08/2019 05:00,32.01,29889,1905,58,4,2103,2,4072,5.543.630.952
10/08/2019 06:00,33.97,31315,1809,55,7,2138,3,4012,5.543.630.952
10/08/2019 07:00,35.2,33113,1760,55,10,2241,3,4069,5.543.630.952
10/08/2019 08:00,36.01,34593,1728,52,16,2325,3,4124,5.543.630.952
10/08/2019 09:00,35.86,35427,1895,49,24,2410,4,4382,5.543.630.952
10/08/2019 10:00,35.68,35729,2296,48,37,2500,5,4886,5.543.630.952
10/08/2019 11:00,34.56,35650,2764,49,58,2656,5,5532,5.543.630.952
10/08/2019 12:00,33.38,35378,3044,49,71,2740,5,5909,5.543.630.952
10/08/2019 13:00,32.48,35141,3260,47,84,2801,7,6199,5.543.630.952
10/08/2019 14:00,31.82,35016,3371,44,98,2817,8,6338,5.543.630.952
10/08/2019 15:00,32.55,35087,3566,42,113,2770,8,6499,5.543.630.952
10/08/2019 16:00,34.4,35395,3776,42,128,2713,10,6669,5.543.630.952
10/08/2019 17:00,35.04,35375,3565,36,155,2690,11,6457,5.543.630.952
10/08/2019 18:00,33.98,34880,3379,27,180,2629,13,6228,5.543.630.952
10/08/2019 19:00,33.98,34293,3179,22,188,2740,13,6142,5.543.630.952
10/08/2019 20:00,32.29,34096,3258,19,181,2859,15,6332,5.543.630.952
10/08/2019 21:00,31.83,33464,3486,22,171,2941,15,6635,5.543.630.952
10/08/2019 22:00,31.87,32085,3541,22,152,3083,15,6813,5.543.630.952
10/08/2019 23:00,30.92,30429,3571,12,76,3034,7,6700,5.543.630.952
11/08/2019 00:00,25.28,29501,3742,11,64,3022,7,6846,5.543.630.952
11/08/2019 01:00,21.13,28987,3786,13,62,2998,9,6868,5.543.630.952
11/08/2019 02:00,20.08,28688,3655,15,71,3035,9,6785,5.543.630.952
11/08/2019 03:00,20.09,28414,3634,16,77,2966,8,6701,5.543.630.952
11/08/2019 04:00,20.09,28273,3619,17,79,2967,6,6688,5.543.630.952
11/08/2019 05:00,20.14,28722,3541,18,73,2943,7,6582,5.543.630.952
11/08/2019 06:00,27.68,29886,3466,20,67,2960,6,6519,5.543.630.952
11/08/2019 07:00,31.14,31458,3502,21,72,3138,5,6738,5.543.630.952
11/08/2019 08:00,32.55,32988,3589,23,87,3240,11,6950,5.543.630.952
11/08/2019 09:00,32.77,33990,3694,26,107,3414,16,7257,5.543.630.952
11/08/2019 10:00,31.95,34494,3929,28,131,3510,22,7620,5.543.630.952
11/08/2019 11:00,26.32,34510,3978,33,159,3611,23,7804,5.543.630.952
11/08/2019 12:00,21.18,34370,3949,37,185,3690,26,7887,5.543.630.952
11/08/2019 13:00,30.93,34214,3928,38,193,3810,29,7998,5.543.630.952
11/08/2019 14:00,32.77,34130,3734,39,176,3847,32,7828,5.543.630.952
11/08/2019 15:00,33.17,34354,3742,41,155,3711,34,7683,5.543.630.952
11/08/2019 16:00,34.22,34905,3794,41,126,3474,34,7469,5.543.630.952
11/08/2019 17:00,36.12,35154,3410,35,90,3304,31,6870,5.543.630.952
11/08/2019 18:00,37.38,34905,2884,31,63,3021,25,6024,5.543.630.952
11/08/2019 19:00,37.81,34653,2357,30,49,2827,17,5280,5.543.630.952
11/08/2019 20:00,37.91,34664,2078,32,46,2738,13,4907,5.543.630.952
11/08/2019 21:00,37.76,33856,1963,37,46,2677,12,4735,5.543.630.952
11/08/2019 22:00,36.56,32150,1863,44,47,2616,12,4582,5.543.630.952
11/08/2019 23:00,34.16,30656,1914,7,59,2555,11,4546,5.543.630.952
12/08/2019 00:00,30.71,29854,1960,7,72,2553,10,4602,5.653.154.762
12/08/2019 01:00,29.57,29513,1962,6,85,2432,11,4496,5.653.154.762
12/08/2019 02:00,29.27,29480,1966,6,95,2366,9,4442,5.653.154.762
12/08/2019 03:00,29.32,29629,2025,5,107,2419,10,4566,5.653.154.762
12/08/2019 04:00,32.04,30866,2061,4,110,2345,11,4531,5.653.154.762
12/08/2019 05:00,37.88,33856,2206,4,101,2302,11,4624,5.653.154.762
12/08/2019 06:00,39.39,37013,2383,3,91,2292,7,4776,5.653.154.762
12/08/2019 07:00,39.32,38639,2517,3,79,2316,4,4919,5.653.154.762
12/08/2019 08:00,38.91,39236,2714,3,69,2349,3,5138,5.653.154.762
12/08/2019 09:00,38.57,39771,2764,4,67,2403,3,5241,5.653.154.762
12/08/2019 10:00,38.59,39892,2834,5,66,2452,2,5359,5.653.154.762
12/08/2019 11:00,38.07,39702,2821,6,59,2525,2,5413,5.653.154.762
12/08/2019 12:00,37.89,39583,2763,8,50,2628,3,5452,5.653.154.762
12/08/2019 13:00,38.1,39353,2696,10,45,2715,2,5468,5.653.154.762
12/08/2019 14:00,37.7,38962,2492,11,44,2729,3,5279,5.653.154.762
12/08/2019 15:00,38.75,38568,2321,12,43,2790,2,5168,5.653.154.762
12/08/2019 16:00,39.34,38612,2161,12,42,2770,2,4987,5.653.154.762
12/08/2019 17:00,39.26,38189,1780,10,42,2664,2,4498,5.653.154.762
12/08/2019 18:00,39.35,37592,1392,9,42,2525,2,3970,5.653.154.762
12/08/2019 19:00,38.95,36832,1063,9,43,2430,3,3548,5.653.154.762
12/08/2019 20:00,38.93,36370,943,8,48,2376,4,3379,5.653.154.762
12/08/2019 21:00,38.43,35087,888,7,52,2275,4,3226,5.653.154.762
12/08/2019 22:00,36.08,33087,815,7,53,2194,4,3073,5.653.154.762
12/08/2019 23:00,34.97,31774,886,75,33,2071,5,3070,5.653.154.762
13/08/2019 00:00,34.01,30707,846,71,31,1973,5,2926,5.653.154.762
13/08/2019 01:00,33.07,30333,854,66,27,1908,8,2863,5.653.154.762
13/08/2019 02:00,33.27,30270,856,62,23,1775,8,2724,5.653.154.762
13/08/2019 03:00,33.19,30448,864,60,22,1670,8,2624,5.653.154.762
13/08/2019 04:00,35.55,31579,818,59,21,1576,6,2480,5.653.154.762
13/08/2019 05:00,38.31,34422,739,58,22,1534,6,2359,5.653.154.762
13/08/2019 06:00,39.01,37587,712,60,24,1468,3,2267,5.653.154.762
13/08/2019 07:00,39.94,39221,759,59,27,1489,2,2336,5.653.154.762
13/08/2019 08:00,39.82,39887,799,59,35,1474,2,2369,5.653.154.762
13/08/2019 09:00,38.7,40400,876,61,42,1419,2,2400,5.653.154.762
13/08/2019 10:00,37.92,40523,1020,65,49,1487,2,2623,5.653.154.762
13/08/2019 11:00,37.51,40320,1209,66,62,1552,5,2894,5.653.154.762
13/08/2019 12:00,37.46,40074,1451,60,68,1558,8,3145,5.653.154.762
13/08/2019 13:00,37.13,39825,1692,55,70,1649,12,3478,5.653.154.762
13/08/2019 14:00,36.63,39466,1828,45,63,1789,13,3738,5.653.154.762
13/08/2019 15:00,36.56,39074,1995,37,60,1942,11,4045,5.653.154.762
13/08/2019 16:00,36.86,39116,2133,36,55,1908,13,4145,5.653.154.762
13/08/2019 17:00,37.52,38659,1944,34,49,1899,13,3939,5.653.154.762
13/08/2019 18:00,38.4,38101,1757,32,43,1887,10,3729,5.653.154.762
13/08/2019 19:00,38,37467,1544,35,51,1862,8,3500,5.653.154.762
13/08/2019 20:00,37.87,37089,1397,39,68,1914,13,3431,5.653.154.762
13/08/2019 21:00,37.14,35766,1333,40,83,1955,15,3426,5.653.154.762
13/08/2019 22:00,35.38,33683,1224,38,90,2029,13,3394,5.653.154.762
13/08/2019 23:00,33.08,32216,1328,21,80,2116,13,3558,5.653.154.762
14/08/2019 00:00,30.76,31200,1200,22,86,2166,13,3487,5.653.154.762
14/08/2019 01:00,29.7,30744,1179,23,93,2142,14,3451,5.653.154.762
14/08/2019 02:00,29.59,30595,1138,23,93,2155,16,3425,5.653.154.762
14/08/2019 03:00,30.29,30794,1094,22,89,2140,18,3363,5.653.154.762
14/08/2019 04:00,33.07,31891,1023,20,83,2122,12,3260,5.653.154.762
14/08/2019 05:00,36.27,34938,948,17,69,2032,10,3076,5.653.154.762
14/08/2019 06:00,38.22,38105,919,14,59,2035,9,3036,5.653.154.762
14/08/2019 07:00,38.82,39728,929,13,55,2011,7,3015,5.653.154.762
14/08/2019 08:00,37.98,40313,978,16,57,2015,8,3074,5.653.154.762
14/08/2019 09:00,36.91,40785,1053,17,64,1986,11,3131,5.653.154.762
14/08/2019 10:00,36.1,40921,1188,18,67,1995,11,3279,5.653.154.762
14/08/2019 11:00,35.68,40675,1305,19,73,2001,15,3413,5.653.154.762
14/08/2019 12:00,35.46,40543,1424,20,76,1956,18,3494,5.653.154.762
14/08/2019 13:00,35.38,40234,1481,21,76,1962,22,3562,5.653.154.762
14/08/2019 14:00,35.2,39941,1418,22,77,2030,22,3569,5.653.154.762
14/08/2019 15:00,35.28,39494,1299,25,77,2076,24,3501,5.653.154.762
14/08/2019 16:00,37.12,39479,1195,26,75,2035,24,3355,5.653.154.762
14/08/2019 17:00,37.96,39005,934,25,68,1891,18,2936,5.653.154.762
14/08/2019 18:00,38.05,38485,712,25,61,1810,11,2619,5.653.154.762
14/08/2019 19:00,37.86,37776,532,29,60,1760,7,2388,5.653.154.762
14/08/2019 20:00,37.52,37399,449,37,67,1761,7,2321,5.653.154.762
14/08/2019 21:00,36.34,36053,466,46,79,1789,13,2393,5.653.154.762
14/08/2019 22:00,35.03,33940,450,57,80,1951,8,2546,5.653.154.762
14/08/2019 23:00,32.95,32606,591,61,88,2136,13,2889,5.653.154.762
15/08/2019 00:00,31.2,31651,739,60,89,2140,12,3040,5.653.154.762
15/08/2019 01:00,29.07,31264,939,63,85,2170,12,3269,5.653.154.762
15/08/2019 02:00,28.17,31206,1119,71,80,2125,11,3406,5.653.154.762
15/08/2019 03:00,27.76,31427,1297,80,81,2039,9,3506,5.653.154.762
15/08/2019 04:00,30.04,32672,1387,79,74,1893,7,3440,5.653.154.762
15/08/2019 05:00,33.06,35607,1515,76,62,1814,6,3473,5.653.154.762
15/08/2019 06:00,34.95,38839,1557,74,47,1653,6,3337,5.653.154.762
15/08/2019 07:00,35.74,40423,1733,82,42,1560,7,3424,5.653.154.762
15/08/2019 08:00,35.65,40878,2115,90,53,1559,11,3828,5.653.154.762
15/08/2019 09:00,35.42,41280,2362,99,62,1522,12,4057,5.653.154.762
15/08/2019 10:00,35.31,41286,2586,110,67,1527,12,4302,5.653.154.762
15/08/2019 11:00,34.87,41004,2582,120,66,1526,12,4306,5.653.154.762
15/08/2019 12:00,34.44,40816,2496,127,65,1553,12,4253,5.653.154.762
15/08/2019 13:00,33.9,40612,2378,120,61,1569,11,4139,5.653.154.762
15/08/2019 14:00,33.89,40200,2158,111,55,1557,8,3889,5.653.154.762
15/08/2019 15:00,34.04,39893,2056,103,42,1497,7,3705,5.653.154.762
15/08/2019 16:00,34.74,40005,1948,92,34,1420,5,3499,5.653.154.762
15/08/2019 17:00,35.59,39565,1752,79,23,1286,3,3143,5.653.154.762
15/08/2019 18:00,36.98,39101,1576,67,13,1249,2,2907,5.653.154.762
15/08/2019 19:00,36.68,38452,1375,67,10,1310,2,2764,5.653.154.762
15/08/2019 20:00,35.82,38017,1257,74,12,1359,2,2704,5.653.154.762
15/08/2019 21:00,34.46,36565,1230,82,21,1422,2,2757,5.653.154.762
15/08/2019 22:00,33.31,34607,1232,85,32,1467,2,2818,5.653.154.762
15/08/2019 23:00,30.93,33013,1110,78,57,1311,4,2560,5.653.154.762
16/08/2019 00:00,29.82,32065,1021,84,80,1283,5,2473,5.653.154.762
16/08/2019 01:00,29.13,31623,1010,85,92,1181,7,2375,5.653.154.762
16/08/2019 02:00,29.18,31547,1069,79,101,1115,7,2371,5.653.154.762
16/08/2019 03:00,30.05,31755,1156,76,103,1082,8,2425,5.653.154.762
16/08/2019 04:00,31.91,33012,1162,77,102,947,7,2295,5.653.154.762
16/08/2019 05:00,34.87,35794,1176,76,91,844,9,2196,5.653.154.762
16/08/2019 06:00,37.11,38911,1189,80,75,735,8,2087,5.653.154.762
16/08/2019 07:00,38.95,40588,1191,93,57,706,7,2054,5.653.154.762
16/08/2019 08:00,38.58,41177,1271,105,53,736,5,2170,5.653.154.762
16/08/2019 09:00,36.61,41644,1351,108,59,777,5,2300,5.653.154.762
16/08/2019 10:00,35.79,41582,1447,109,63,1020,6,2645,5.653.154.762
16/08/2019 11:00,35.41,41204,1362,109,60,1156,6,2693,5.653.154.762
16/08/2019 12:00,34.66,40730,1292,107,57,1261,6,2723,5.653.154.762
16/08/2019 13:00,34.28,40214,1284,102,45,1388,6,2825,5.653.154.762
16/08/2019 14:00,33.68,39639,1270,90,35,1409,4,2808,5.653.154.762
16/08/2019 15:00,33.99,39157,1248,76,28,1486,4,2842,5.653.154.762
16/08/2019 16:00,36.15,39077,1163,62,23,1445,4,2697,5.653.154.762
16/08/2019 17:00,37.14,38645,1009,50,24,1470,3,2556,5.653.154.762
16/08/2019 18:00,36.96,37916,862,43,30,1429,2,2366,5.653.154.762
16/08/2019 19:00,36.15,37094,762,43,38,1581,2,2426,5.653.154.762
16/08/2019 20:00,35.97,36705,825,46,52,1760,2,2685,5.653.154.762
16/08/2019 21:00,34.93,35511,995,47,65,1850,2,2959,5.653.154.762
16/08/2019 22:00,31.93,33783,1136,46,74,1853,1,3110,5.653.154.762
16/08/2019 23:00,32.11,31941,1558,5,34,1754,4,3355,5.653.154.762
17/08/2019 00:00,28.52,30864,1880,5,31,1657,4,3577,5.653.154.762
17/08/2019 01:00,25.34,30251,2151,5,29,1684,4,3873,5.653.154.762
17/08/2019 02:00,24.7,29940,2463,5,26,1752,4,4250,5.653.154.762
17/08/2019 03:00,24,29742,2767,3,22,1842,4,4638,5.653.154.762
17/08/2019 04:00,24.35,29798,2914,4,17,2009,3,4947,5.653.154.762
17/08/2019 05:00,27.06,30503,2989,2,12,2017,3,5023,5.653.154.762
17/08/2019 06:00,29.83,32052,2928,3,9,2074,3,5017,5.653.154.762
17/08/2019 07:00,31.59,33919,2941,2,9,2263,2,5217,5.653.154.762
17/08/2019 08:00,33.16,35390,3204,2,13,2536,3,5758,5.653.154.762
17/08/2019 09:00,33.28,36181,3242,4,21,2787,3,6057,5.653.154.762
17/08/2019 10:00,32.88,36413,3380,7,40,3127,4,6558,5.653.154.762
17/08/2019 11:00,31.36,36180,3183,10,53,3371,6,6623,5.653.154.762
17/08/2019 12:00,31.15,35978,2978,13,66,3542,7,6606,5.653.154.762
17/08/2019 13:00,30.7,35720,2839,15,64,3655,6,6579,5.653.154.762
17/08/2019 14:00,30.76,35609,2785,16,47,3699,4,6551,5.653.154.762
17/08/2019 15:00,31.17,35776,2817,16,38,3731,4,6606,5.653.154.762
17/08/2019 16:00,32.7,36054,2651,17,31,3642,4,6345,5.653.154.762
17/08/2019 17:00,33.34,36117,2289,23,22,3631,3,5968,5.653.154.762
17/08/2019 18:00,34.56,35570,1887,32,19,3640,2,5580,5.653.154.762
17/08/2019 19:00,34.94,35021,1486,45,21,3748,2,5302,5.653.154.762
17/08/2019 20:00,35.17,34780,1219,61,32,3731,3,5046,5.653.154.762
17/08/2019 21:00,34.51,33914,1078,74,55,3701,5,4913,5.653.154.762
17/08/2019 22:00,33.25,32428,908,84,68,3709,8,4777,5.653.154.762
17/08/2019 23:00,31.63,31136,715,50,51,3513,5,4334,5.653.154.762
18/08/2019 00:00,29.44,30201,619,57,60,3334,7,4077,5.653.154.762
18/08/2019 01:00,29.31,29739,527,62,63,3139,8,3799,5.653.154.762
18/08/2019 02:00,29.62,29468,440,64,66,3016,9,3595,5.653.154.762
18/08/2019 03:00,29.32,29215,407,66,68,2824,11,3376,5.653.154.762
18/08/2019 04:00,28.99,29088,419,69,64,2678,12,3242,5.653.154.762
18/08/2019 05:00,31.02,29439,458,73,58,2445,12,3046,5.653.154.762
18/08/2019 06:00,33.23,30493,475,68,43,2250,10,2846,5.653.154.762
18/08/2019 07:00,33.62,32045,512,60,36,2130,8,2746,5.653.154.762
18/08/2019 08:00,34.27,33605,589,52,37,1946,7,2631,5.653.154.762
18/08/2019 09:00,34.92,34673,640,48,54,1850,7,2599,5.653.154.762
18/08/2019 10:00,34.86,35103,744,51,68,1836,8,2707,5.653.154.762
18/08/2019 11:00,34.33,35127,797,60,82,1903,10,2852,5.653.154.762
18/08/2019 12:00,34.24,35009,773,66,90,1884,13,2826,5.653.154.762
18/08/2019 13:00,34.31,34920,705,63,93,1912,12,2785,5.653.154.762
18/08/2019 14:00,34.27,34820,699,64,88,1799,9,2659,5.653.154.762
18/08/2019 15:00,34.48,35105,785,63,82,1781,8,2719,5.653.154.762
18/08/2019 16:00,35.17,35614,865,60,79,1764,8,2776,5.653.154.762
18/08/2019 17:00,35.2,35866,963,57,90,1715,7,2832,5.653.154.762
18/08/2019 18:00,35.85,35718,1031,57,110,1701,5,2904,5.653.154.762
18/08/2019 19:00,36.63,35441,1096,64,136,1700,5,3001,5.653.154.762
18/08/2019 20:00,36.73,35503,1295,75,159,1808,5,3342,5.653.154.762
18/08/2019 21:00,35.79,34441,1423,83,177,1765,10,3458,5.653.154.762
18/08/2019 22:00,33.74,32604,1435,85,184,1724,18,3446,5.653.154.762
18/08/2019 23:00,29.89,31387,1558,51,195,1676,20,3500,5.653.154.762
19/08/2019 00:00,29.15,30691,1529,49,182,1613,18,3391,5.756.428.571
19/08/2019 01:00,28.35,30365,1496,43,165,1609,16,3329,5.756.428.571
19/08/2019 02:00,29.05,30382,1488,35,151,1668,13,3355,5.756.428.571
19/08/2019 03:00,28.37,30700,1560,30,137,1770,11,3508,5.756.428.571
19/08/2019 04:00,31.96,32156,1623,28,115,1776,10,3552,5.756.428.571
19/08/2019 05:00,35.9,35335,1752,23,98,1828,7,3708,5.756.428.571
19/08/2019 06:00,37.61,38657,1763,16,88,1815,10,3692,5.756.428.571
19/08/2019 07:00,38.44,40200,1832,13,88,1908,11,3852,5.756.428.571
19/08/2019 08:00,36.93,40728,2111,14,97,2092,8,4322,5.756.428.571
19/08/2019 09:00,35.81,41173,2392,17,105,2306,7,4827,5.756.428.571
19/08/2019 10:00,35.33,41181,2718,20,109,2456,7,5310,5.756.428.571
19/08/2019 11:00,34.96,40950,2818,22,105,2779,9,5733,5.756.428.571
19/08/2019 12:00,34.84,40851,2856,22,101,3053,10,6042,5.756.428.571
19/08/2019 13:00,34.46,40630,2857,22,87,3283,12,6261,5.756.428.571
19/08/2019 14:00,34.24,40263,2885,21,75,3341,12,6334,5.756.428.571
19/08/2019 15:00,34.48,39829,2886,21,62,3467,14,6450,5.756.428.571
19/08/2019 16:00,35.09,39830,2649,22,48,3641,14,6374,5.756.428.571
19/08/2019 17:00,36.42,39452,2326,27,38,3410,12,5813,5.756.428.571
19/08/2019 18:00,36.76,38868,1959,36,26,3475,8,5504,5.756.428.571
19/08/2019 19:00,36.56,38266,1624,49,19,3405,5,5102,5.756.428.571
19/08/2019 20:00,36.51,37796,1583,63,18,3452,5,5121,5.756.428.571
19/08/2019 21:00,35.79,36203,1684,71,17,3586,6,5364,5.756.428.571
19/08/2019 22:00,33.97,33994,1601,72,18,3712,7,5410,5.756.428.571
19/08/2019 23:00,32,31728,1417,113,20,3595,5,5150,5.756.428.571
20/08/2019 00:00,30.88,30875,1324,119,21,3355,5,4824,5.756.428.571
20/08/2019 01:00,30.52,30647,1239,119,24,3166,7,4555,5.756.428.571
20/08/2019 02:00,30.04,30707,1150,124,26,2993,8,4301,5.756.428.571
20/08/2019 03:00,30.61,31042,1105,125,29,2795,9,4063,5.756.428.571
20/08/2019 04:00,33.33,32406,1065,127,29,2598,7,3826,5.756.428.571
20/08/2019 05:00,36.57,35601,1003,127,24,2303,7,3464,5.756.428.571
20/08/2019 06:00,36.68,38903,933,122,20,1995,5,3075,5.756.428.571
20/08/2019 07:00,37.52,40413,966,111,18,1887,6,2988,5.756.428.571
20/08/2019 08:00,37.52,40767,1072,105,23,1845,8,3053,5.756.428.571
20/08/2019 09:00,37.41,41115,1269,104,33,1861,7,3274,5.756.428.571
20/08/2019 10:00,37.13,41172,1497,102,38,1894,9,3540,5.756.428.571
20/08/2019 11:00,36.95,40979,1581,95,49,1992,11,3728,5.756.428.571
20/08/2019 12:00,36.93,40944,1682,93,55,2102,10,3942,5.756.428.571
20/08/2019 13:00,36.86,40676,1688,96,57,2198,11,4050,5.756.428.571
20/08/2019 14:00,36.84,40370,1579,93,52,2147,11,3882,5.756.428.571
20/08/2019 15:00,36.69,40087,1503,85,49,2184,8,3829,5.756.428.571
20/08/2019 16:00,36.85,40086,1401,69,38,2155,6,3669,5.756.428.571
20/08/2019 17:00,36.99,39462,1178,56,31,2012,5,3282,5.756.428.571
20/08/2019 18:00,36.94,38967,908,50,25,1960,5,2948,5.756.428.571
20/08/2019 19:00,36.58,38237,717,48,21,2097,4,2887,5.756.428.571
20/08/2019 20:00,36.71,37769,672,49,17,2255,6,2999,5.756.428.571
20/08/2019 21:00,35.84,36097,688,52,16,2376,6,3138,5.756.428.571
20/08/2019 22:00,34.83,33802,678,54,17,2342,6,3097,5.756.428.571
20/08/2019 23:00,33.07,32654,820,58,8,2211,8,3105,5.756.428.571
21/08/2019 00:00,33.11,31624,788,62,9,2073,7,2939,5.756.428.571
21/08/2019 01:00,32.01,31260,763,64,12,1942,6,2787,5.756.428.571
21/08/2019 02:00,31.23,31186,730,66,13,1784,4,2597,5.756.428.571
21/08/2019 03:00,31.93,31470,707,67,17,1639,3,2433,5.756.428.571
21/08/2019 04:00,33.88,32807,659,66,24,1445,2,2196,5.756.428.571
21/08/2019 05:00,36.93,36073,647,61,32,1268,2,2010,5.756.428.571
21/08/2019 06:00,37.93,39369,610,56,47,1158,1,1872,5.756.428.571
21/08/2019 07:00,39.03,40808,620,58,55,1091,1,1825,5.756.428.571
21/08/2019 08:00,38.71,41154,698,65,55,1015,1,1834,5.756.428.571
21/08/2019 09:00,37.79,41449,754,71,50,1025,1,1901,5.756.428.571
21/08/2019 10:00,37.36,41388,831,74,48,1056,2,2011,5.756.428.571
21/08/2019 11:00,36.57,41164,892,78,51,1204,2,2227,5.756.428.571
21/08/2019 12:00,35.93,40869,956,83,56,1360,8,2463,5.756.428.571
21/08/2019 13:00,35.84,40607,1005,82,77,1507,13,2684,5.756.428.571
21/08/2019 14:00,35.67,40379,981,77,83,1676,13,2830,5.756.428.571
21/08/2019 15:00,35.95,39977,946,63,90,1781,10,2890,5.756.428.571
21/08/2019 16:00,37.3,39983,829,51,89,1743,8,2720,5.756.428.571
21/08/2019 17:00,36.97,39627,672,44,82,1775,6,2579,5.756.428.571
21/08/2019 18:00,37.01,39186,528,42,78,1726,5,2379,5.756.428.571
21/08/2019 19:00,36.93,38620,418,43,74,1760,5,2300,5.756.428.571
21/08/2019 20:00,36.93,38258,410,49,76,1868,8,2411,5.756.428.571
21/08/2019 21:00,35.89,36624,445,59,75,2004,8,2591,5.756.428.571
21/08/2019 22:00,35,34311,450,63,73,2171,7,2764,5.756.428.571
21/08/2019 23:00,33.25,32726,721,56,78,2121,12,2988,5.756.428.571
22/08/2019 00:00,32.36,31807,823,54,75,2123,11,3086,5.756.428.571
22/08/2019 01:00,31.18,31496,892,49,67,2024,8,3040,5.756.428.571
22/08/2019 02:00,31.08,31517,943,43,55,1968,5,3014,5.756.428.571
22/08/2019 03:00,31.12,31858,1013,41,48,1852,3,2957,5.756.428.571
22/08/2019 04:00,33.22,33264,1077,37,38,1761,4,2917,5.756.428.571
22/08/2019 05:00,35.74,36325,1182,32,35,1556,5,2810,5.756.428.571
22/08/2019 06:00,38.05,39541,1195,26,34,1286,5,2546,5.756.428.571
22/08/2019 07:00,39.56,40905,1257,21,32,1096,6,2412,5.756.428.571
22/08/2019 08:00,38.06,41212,1451,20,31,1046,7,2555,5.756.428.571
22/08/2019 09:00,36.54,41787,1673,20,40,1110,9,2852,5.756.428.571
22/08/2019 10:00,36.04,41811,1952,20,48,1296,9,3325,5.756.428.571
22/08/2019 11:00,35.72,41556,2099,20,51,1539,11,3720,5.756.428.571
22/08/2019 12:00,35.13,41353,2149,20,54,1925,11,4159,5.756.428.571
22/08/2019 13:00,34.5,41231,2111,18,53,2136,11,4329,5.756.428.571
22/08/2019 14:00,35.01,40805,2007,17,46,2259,9,4338,5.756.428.571
22/08/2019 15:00,35.38,40509,1909,15,35,2295,9,4263,5.756.428.571
22/08/2019 16:00,36.33,40564,1774,14,28,2351,8,4175,5.756.428.571
22/08/2019 17:00,36.92,40095,1551,15,25,2389,6,3986,5.756.428.571
22/08/2019 18:00,36.77,39771,1236,18,23,2501,5,3783,5.756.428.571
22/08/2019 19:00,36.46,39184,981,21,18,2570,4,3594,5.756.428.571
22/08/2019 20:00,36.01,38693,859,24,16,2652,5,3556,5.756.428.571
22/08/2019 21:00,35.56,37020,862,30,15,2690,6,3603,5.756.428.571
22/08/2019 22:00,33.19,34909,817,33,17,2704,6,3577,5.756.428.571
22/08/2019 23:00,31.47,33119,1321,46,26,2604,10,4007,5.756.428.571
23/08/2019 00:00,30.89,32176,1475,49,42,2411,10,3987,5.756.428.571
23/08/2019 01:00,30.7,31752,1522,53,60,2279,13,3927,5.756.428.571
23/08/2019 02:00,30.62,31741,1579,55,71,2169,13,3887,5.756.428.571
23/08/2019 03:00,31.3,32050,1685,55,83,2102,13,3938,5.756.428.571
23/08/2019 04:00,32.74,33523,1750,52,85,2136,18,4041,5.756.428.571
23/08/2019 05:00,35.51,36565,1739,48,81,2181,19,4068,5.756.428.571
23/08/2019 06:00,36.29,39811,1567,48,70,2232,19,3936,5.756.428.571
23/08/2019 07:00,36.96,41335,1530,53,60,2238,12,3893,5.756.428.571
23/08/2019 08:00,36.31,41795,1595,65,61,2263,15,3999,5.756.428.571
23/08/2019 09:00,35.38,42224,1619,75,75,2405,26,4200,5.756.428.571
23/08/2019 10:00,35.05,42050,1611,79,83,2456,34,4263,5.756.428.571
23/08/2019 11:00,34.42,41628,1523,85,90,2487,36,4221,5.756.428.571
23/08/2019 12:00,34.04,41128,1396,90,91,2568,36,4181,5.756.428.571
23/08/2019 13:00,33.88,40542,1280,88,89,2601,36,4094,5.756.428.571
23/08/2019 14:00,33.99,39917,1145,80,78,2605,40,3948,5.756.428.571
23/08/2019 15:00,34.79,39450,1039,71,68,2630,40,3848,5.756.428.571
23/08/2019 16:00,36.13,39381,908,65,59,2563,37,3632,5.756.428.571
23/08/2019 17:00,36.63,38953,712,61,53,2390,28,3244,5.756.428.571
23/08/2019 18:00,36.59,38218,453,55,50,2308,25,2891,5.756.428.571
23/08/2019 19:00,36.11,37501,284,51,54,2372,24,2785,5.756.428.571
23/08/2019 20:00,36,37004,225,48,62,2420,26,2781,5.756.428.571
23/08/2019 21:00,35.29,35596,211,51,74,2453,28,2817,5.756.428.571
23/08/2019 22:00,33.76,33830,182,56,82,2559,28,2907,5.756.428.571
23/08/2019 23:00,33.2,32422,269,91,140,2563,23,3086,5.756.428.571
24/08/2019 00:00,31.91,31358,235,90,142,2496,16,2979,5.756.428.571
24/08/2019 01:00,30.72,30855,197,85,137,2294,14,2727,5.756.428.571
24/08/2019 02:00,30.68,30584,153,77,127,2091,10,2458,5.756.428.571
24/08/2019 03:00,29.91,30437,124,72,116,1935,9,2256,5.756.428.571
24/08/2019 04:00,30.85,30555,105,64,98,1708,6,1981,5.756.428.571
24/08/2019 05:00,31.91,31143,98,52,73,1378,4,1605,5.756.428.571
24/08/2019 06:00,33.17,32623,103,38,48,991,3,1183,5.756.428.571
24/08/2019 07:00,35.02,34495,110,32,33,689,2,866,5.756.428.571
24/08/2019 08:00,35.34,35929,131,35,29,507,2,704,5.756.428.571
24/08/2019 09:00,35.19,36674,143,43,30,331,3,550,5.756.428.571
24/08/2019 10:00,34.38,36804,166,51,33,239,3,492,5.756.428.571
24/08/2019 11:00,33.92,36488,186,55,38,172,3,454,5.756.428.571
24/08/2019 12:00,33.39,36184,206,55,48,207,3,519,5.756.428.571
24/08/2019 13:00,33.08,35911,244,52,48,200,3,547,5.756.428.571
24/08/2019 14:00,33.17,35804,283,46,39,202,4,574,5.756.428.571
24/08/2019 15:00,33.6,35966,348,39,35,220,3,645,5.756.428.571
24/08/2019 16:00,34.26,36326,404,32,33,250,3,722,5.756.428.571
24/08/2019 17:00,35.56,36316,472,32,30,313,2,849,5.756.428.571
24/08/2019 18:00,36.21,35910,498,37,31,424,2,992,5.756.428.571
24/08/2019 19:00,36,35529,571,45,32,617,2,1267,5.756.428.571
24/08/2019 20:00,35.2,35373,694,55,34,917,2,1702,5.756.428.571
24/08/2019 21:00,33.8,34291,804,61,37,1181,3,2086,5.756.428.571
24/08/2019 22:00,31.54,32751,857,62,35,1373,3,2330,5.756.428.571
24/08/2019 23:00,31.37,31374,823,72,0,1486,3,2384,5.756.428.571
25/08/2019 00:00,29.98,30533,856,74,0,1571,4,2505,5.756.428.571
25/08/2019 01:00,29.65,30106,817,71,0,1618,3,2509,5.756.428.571
25/08/2019 02:00,29.43,29873,760,67,0,1661,3,2491,5.756.428.571
25/08/2019 03:00,29.43,29704,681,61,0,1691,3,2436,5.756.428.571
25/08/2019 04:00,28.96,29583,636,53,0,1691,3,2383,5.756.428.571
25/08/2019 05:00,29.17,29819,644,45,0,1581,3,2273,5.756.428.571
25/08/2019 06:00,31.37,30929,595,37,0,1410,4,2046,5.756.428.571
25/08/2019 07:00,32.24,32497,538,33,0,1249,3,1823,5.756.428.571
25/08/2019 08:00,33.06,34008,478,33,0,1150,3,1664,5.756.428.571
25/08/2019 09:00,33.64,35054,400,35,0,1311,4,1750,5.756.428.571
25/08/2019 10:00,33.48,35408,372,36,0,1386,4,1798,5.756.428.571
25/08/2019 11:00,32.98,35380,378,38,0,1479,4,1899,5.756.428.571
25/08/2019 12:00,32.63,35207,397,41,0,1689,3,2130,5.756.428.571
25/08/2019 13:00,32.42,35106,405,42,0,1719,2,2168,5.756.428.571
25/08/2019 14:00,32.42,35040,397,40,0,1633,3,2073,5.756.428.571
25/08/2019 15:00,32.52,35293,398,38,0,1690,3,2129,5.756.428.571
25/08/2019 16:00,34.36,35863,393,37,0,1780,2,2212,5.756.428.571
25/08/2019 17:00,36.13,36135,417,42,0,1964,2,2425,5.756.428.571
25/08/2019 18:00,36.43,36033,424,54,0,2158,2,2638,5.756.428.571
25/08/2019 19:00,36.43,35924,468,65,0,2245,3,2781,5.756.428.571
25/08/2019 20:00,36.09,35836,577,75,0,2301,4,2957,5.756.428.571
25/08/2019 21:00,35.18,34609,666,88,0,2297,7,3058,5.756.428.571
25/08/2019 22:00,33.3,32887,685,96,0,2368,7,3156,5.756.428.571
25/08/2019 23:00,32.86,31502,616,75,50,2396,2,3139,5.756.428.571
26/08/2019 00:00,32.18,30748,570,79,53,2283,2,2987,5.820.297.619
26/08/2019 01:00,32.06,30410,477,86,46,2137,2,2748,5.820.297.619
26/08/2019 02:00,32.23,30499,380,89,33,2025,2,2529,5.820.297.619
26/08/2019 03:00,32.63,30880,325,92,30,1890,2,2339,5.820.297.619
26/08/2019 04:00,33.61,32468,327,96,25,1663,2,2113,5.820.297.619
26/08/2019 05:00,37.32,35861,351,97,20,1535,2,2005,5.820.297.619
26/08/2019 06:00,39.48,39143,356,101,14,1338,1,1810,5.820.297.619
26/08/2019 07:00,39.77,40564,317,111,10,1132,1,1571,5.820.297.619
26/08/2019 08:00,40.41,40867,311,123,7,1034,1,1476,5.820.297.619
26/08/2019 09:00,40.2,41081,292,131,7,881,1,1312,5.820.297.619
26/08/2019 10:00,40.07,41036,338,137,6,714,1,1196,5.820.297.619
26/08/2019 11:00,39.37,40789,386,144,8,669,2,1209,5.820.297.619
26/08/2019 12:00,38.42,40624,401,151,11,658,2,1223,5.820.297.619
26/08/2019 13:00,38.02,40434,411,157,11,661,2,1242,5.820.297.619
26/08/2019 14:00,37.64,40054,441,163,11,648,2,1265,5.820.297.619
26/08/2019 15:00,39.37,39757,487,160,11,599,2,1259,5.820.297.619
26/08/2019 16:00,39.55,39822,517,149,11,557,2,1236,5.820.297.619
26/08/2019 17:00,39.48,39370,515,141,15,563,2,1236,5.820.297.619
26/08/2019 18:00,40.1,38964,460,140,22,656,2,1280,5.820.297.619
26/08/2019 19:00,39.41,38475,444,146,30,766,3,1389,5.820.297.619
26/08/2019 20:00,39.61,37927,518,155,38,933,3,1647,5.820.297.619
26/08/2019 21:00,38.37,36090,584,158,43,1125,2,1912,5.820.297.619
26/08/2019 22:00,35.54,33789,579,150,43,1185,2,1959,5.820.297.619
26/08/2019 23:00,36.01,32324,709,67,0,1211,3,1990,5.820.297.619
27/08/2019 00:00,34.8,31384,701,71,0,1193,4,1969,5.820.297.619
27/08/2019 01:00,34.43,31078,638,71,0,1228,3,1940,5.820.297.619
27/08/2019 02:00,33.75,31096,548,67,0,1247,4,1866,5.820.297.619
27/08/2019 03:00,34.5,31434,510,57,0,1330,5,1902,5.820.297.619
27/08/2019 04:00,35.32,32863,541,47,0,1351,5,1944,5.820.297.619
27/08/2019 05:00,37.6,36045,581,41,0,1291,5,1918,5.820.297.619
27/08/2019 06:00,39.9,39384,553,30,0,1180,5,1768,5.820.297.619
27/08/2019 07:00,40.69,40659,456,20,0,1070,4,1550,5.820.297.619
27/08/2019 08:00,40.28,40884,425,19,0,991,3,1438,5.820.297.619
27/08/2019 09:00,40.43,41090,373,21,0,890,2,1286,5.820.297.619
27/08/2019 10:00,40.52,40991,395,26,0,683,2,1106,5.820.297.619
27/08/2019 11:00,40.12,40795,419,31,0,768,2,1220,5.820.297.619
27/08/2019 12:00,40.12,40452,414,38,0,828,2,1282,5.820.297.619
27/08/2019 13:00,40.09,40307,419,45,0,873,2,1339,5.820.297.619
27/08/2019 14:00,39.31,40089,453,45,0,911,2,1411,5.820.297.619
27/08/2019 15:00,39.09,39779,528,44,0,902,2,1476,5.820.297.619
27/08/2019 16:00,38.91,39764,626,42,0,927,3,1598,5.820.297.619
27/08/2019 17:00,38.99,39364,670,40,0,1047,7,1764,5.820.297.619
27/08/2019 18:00,38.97,39125,598,39,0,1228,10,1875,5.820.297.619
27/08/2019 19:00,38.3,38708,641,37,0,1486,11,2175,5.820.297.619
27/08/2019 20:00,37.49,38176,801,35,0,1617,15,2468,5.820.297.619
27/08/2019 21:00,36.06,36264,948,32,0,1809,15,2804,5.820.297.619
27/08/2019 22:00,35.15,33905,801,29,0,1894,15,2739,5.820.297.619
27/08/2019 23:00,35.07,32307,759,33,119,1802,19,2732,5.820.297.619
28/08/2019 00:00,34.71,31306,747,31,127,1647,17,2569,5.820.297.619
28/08/2019 01:00,33.86,30980,694,25,127,1539,17,2402,5.820.297.619
28/08/2019 02:00,33.75,30909,634,19,123,1390,20,2186,5.820.297.619
28/08/2019 03:00,34.26,31291,604,15,121,1327,19,2086,5.820.297.619
28/08/2019 04:00,35.4,32758,576,10,113,1258,17,1974,5.820.297.619
28/08/2019 05:00,37.36,36112,612,5,104,1202,17,1940,5.820.297.619
28/08/2019 06:00,39.78,39551,551,3,86,1106,16,1762,5.820.297.619
28/08/2019 07:00,41.75,40906,508,2,67,998,9,1584,5.820.297.619
28/08/2019 08:00,41.21,41159,483,2,68,933,5,1491,5.820.297.619
28/08/2019 09:00,41.25,41440,450,3,80,873,5,1411,5.820.297.619
28/08/2019 10:00,40.28,41303,457,3,99,964,4,1527,5.820.297.619
28/08/2019 11:00,40.08,41082,486,4,121,1107,5,1723,5.820.297.619
28/08/2019 12:00,39.82,40892,506,4,136,1392,6,2044,5.820.297.619
28/08/2019 13:00,40.14,40659,509,4,148,1643,6,2310,5.820.297.619
28/08/2019 14:00,39.27,40456,497,3,155,1672,7,2334,5.820.297.619
28/08/2019 15:00,39.52,40223,495,3,161,1641,8,2308,5.820.297.619
28/08/2019 16:00,38.95,40271,478,3,165,1758,9,2413,5.820.297.619
28/08/2019 17:00,38.92,39879,436,3,169,1867,10,2485,5.820.297.619
28/08/2019 18:00,38.93,39651,369,4,186,2015,11,2585,5.820.297.619
28/08/2019 19:00,38.24,39261,407,5,211,2215,21,2859,5.820.297.619
28/08/2019 20:00,37.74,38590,480,8,230,2386,20,3124,5.820.297.619
28/08/2019 21:00,36.14,36617,611,11,245,2530,25,3422,5.820.297.619
28/08/2019 22:00,35.1,34155,678,16,246,2497,24,3461,5.820.297.619
28/08/2019 23:00,34.17,32114,502,17,220,2385,24,3148,5.820.297.619
29/08/2019 00:00,33.31,31139,472,22,211,2372,28,3105,5.820.297.619
29/08/2019 01:00,32.95,30785,439,24,200,2347,22,3032,5.820.297.619
29/08/2019 02:00,32.4,30794,431,27,192,2408,22,3080,5.820.297.619
29/08/2019 03:00,32.42,31173,465,33,186,2181,21,2886,5.820.297.619
29/08/2019 04:00,33.84,32702,485,38,173,1998,23,2717,5.820.297.619
29/08/2019 05:00,36.45,35983,425,40,162,1815,23,2465,5.820.297.619
29/08/2019 06:00,38,39397,314,32,145,1641,17,2149,5.820.297.619
29/08/2019 07:00,39.94,40757,291,20,128,1535,14,1988,5.820.297.619
29/08/2019 08:00,39.2,41004,385,14,114,1515,12,2040,5.820.297.619
29/08/2019 09:00,39.52,41367,493,15,104,1646,12,2270,5.820.297.619
29/08/2019 10:00,39.66,41330,615,17,106,1842,12,2592,5.820.297.619
29/08/2019 11:00,38.82,41122,744,20,111,1918,9,2802,5.820.297.619
29/08/2019 12:00,37.9,41000,861,22,119,2173,7,3182,5.820.297.619
29/08/2019 13:00,37.09,40896,997,22,112,2344,9,3484,5.820.297.619
29/08/2019 14:00,36.95,40561,1093,21,91,2374,10,3589,5.820.297.619
29/08/2019 15:00,36.58,40238,1155,17,66,2440,22,3700,5.820.297.619
29/08/2019 16:00,37.47,40426,1116,18,52,2504,8,3698,5.820.297.619
29/08/2019 17:00,37.65,39906,1046,23,41,2574,6,3690,5.820.297.619
29/08/2019 18:00,37.67,39620,752,35,40,2631,4,3462,5.820.297.619
29/08/2019 19:00,37.49,39270,542,55,38,2818,3,3456,5.820.297.619
29/08/2019 20:00,36.79,38451,510,74,38,2728,4,3354,5.820.297.619
29/08/2019 21:00,35.02,36438,527,90,43,2724,4,3388,5.820.297.619
29/08/2019 22:00,33.71,34151,511,92,45,2721,5,3374,5.820.297.619
29/08/2019 23:00,31.89,32277,532,95,56,2609,4,3296,5.820.297.619
30/08/2019 00:00,31.31,31366,547,90,56,2552,4,3249,5.820.297.619
30/08/2019 01:00,30.78,31058,541,85,53,2467,6,3152,5.820.297.619
30/08/2019 02:00,30.45,31051,551,81,52,2372,7,3063,5.820.297.619
30/08/2019 03:00,30.87,31475,556,78,50,2114,4,2802,5.820.297.619
30/08/2019 04:00,31.88,33073,560,75,42,2033,4,2714,5.820.297.619
30/08/2019 05:00,35.75,36387,585,67,34,1883,2,2571,5.820.297.619
30/08/2019 06:00,37.21,39831,603,54,29,1688,2,2376,5.820.297.619
30/08/2019 07:00,38.06,41281,670,46,28,1499,2,2245,5.820.297.619
30/08/2019 08:00,38.34,41690,861,42,30,1531,2,2466,5.820.297.619
30/08/2019 09:00,37.87,41955,1088,43,40,1602,2,2775,5.820.297.619
30/08/2019 10:00,37.03,41732,1364,47,56,1722,4,3193,5.820.297.619
30/08/2019 11:00,35.96,41286,1590,52,74,1914,3,3633,5.820.297.619
30/08/2019 12:00,35.72,40794,1732,57,85,2160,4,4038,5.820.297.619
30/08/2019 13:00,35.41,40275,1760,59,95,2322,4,4240,5.820.297.619
30/08/2019 14:00,34.99,39650,1736,58,93,2238,5,4130,5.820.297.619
30/08/2019 15:00,35.49,39352,1698,55,88,2347,5,4193,5.820.297.619
30/08/2019 16:00,36.82,39350,1580,49,81,2178,4,3892,5.820.297.619
30/08/2019 17:00,36.86,38923,1331,48,72,2124,2,3577,5.820.297.619
30/08/2019 18:00,36.57,38341,937,54,63,2146,2,3202,5.820.297.619
30/08/2019 19:00,35.97,37778,751,62,56,2255,2,3126,5.820.297.619
30/08/2019 20:00,35.17,37044,702,64,53,2556,2,3377,5.820.297.619
30/08/2019 21:00,34.2,35395,727,63,51,2946,2,3789,5.820.297.619
30/08/2019 22:00,32.7,33502,752,59,36,3140,2,3989,5.820.297.619
30/08/2019 23:00,34.32,31673,917,135,20,3120,3,4195,5.820.297.619
31/08/2019 00:00,30.97,30622,987,123,18,3287,3,4418,5.820.297.619
31/08/2019 01:00,29.66,30100,966,107,15,3264,3,4355,5.820.297.619
31/08/2019 02:00,29.21,29839,915,93,12,3275,3,4298,5.820.297.619
31/08/2019 03:00,28.85,29775,920,82,11,3146,2,4161,5.820.297.619
31/08/2019 04:00,28.7,29934,928,69,8,2939,2,3946,5.820.297.619
31/08/2019 05:00,29.62,30553,951,59,7,2887,2,3906,5.820.297.619
31/08/2019 06:00,30.12,32139,879,55,6,2584,2,3526,5.820.297.619
31/08/2019 07:00,32.29,34187,843,54,5,2318,2,3222,5.820.297.619
31/08/2019 08:00,33.82,35699,912,55,5,2152,2,3126,5.820.297.619
31/08/2019 09:00,33.88,36482,984,60,5,2014,2,3065,5.820.297.619
31/08/2019 10:00,32.93,36547,1095,68,6,1944,2,3115,5.820.297.619
31/08/2019 11:00,32.29,36229,1143,73,6,1792,2,3016,5.820.297.619
31/08/2019 12:00,31.26,35908,1133,72,7,1902,2,3116,5.820.297.619
31/08/2019 13:00,30.91,35574,1045,67,7,1856,2,2977,5.820.297.619
31/08/2019 14:00,31.13,35498,948,61,6,1773,2,2790,5.820.297.619
31/08/2019 15:00,31.72,35728,842,54,6,1841,1,2744,5.820.297.619
31/08/2019 16:00,33.15,36149,746,48,7,1791,1,2593,5.820.297.619
31/08/2019 17:00,35.73,36236,647,42,9,1766,1,2465,5.820.297.619
31/08/2019 18:00,36.34,35950,525,38,13,1981,1,2558,5.820.297.619
31/08/2019 19:00,35.83,35637,551,33,20,2180,1,2785,5.820.297.619
31/08/2019 20:00,35.14,35179,720,26,30,2463,2,3241,5.820.297.619
31/08/2019 21:00,33.95,33825,929,20,52,2765,2,3768,5.820.297.619
31/08/2019 22:00,31.13,32199,986,15,65,3001,3,4070,5.820.297.619
31/08/2019 23:00,28.77,30979,923,6,0,3181,3,4113,5.820.297.619
01/09/2019 00:00,27.38,30163,1051,4,0,3164,5,4224,5.820.297.619
01/09/2019 01:00,26.54,29751,978,3,0,3143,7,4131,5.820.297.619
01/09/2019 02:00,26.61,29529,867,2,0,3250,10,4129,5.820.297.619
01/09/2019 03:00,26.02,29387,638,1,0,3296,12,3947,5.820.297.619
01/09/2019 04:00,26.67,29304,590,1,0,3304,12,3907,5.820.297.619
01/09/2019 05:00,27.18,29483,608,1,0,3180,14,3803,5.820.297.619
01/09/2019 06:00,27.42,30677,675,1,0,3262,15,3953,5.820.297.619
01/09/2019 07:00,29.82,32470,827,1,0,2973,10,3811,5.820.297.619
01/09/2019 08:00,32.82,34073,978,1,0,3033,8,4020,5.820.297.619
01/09/2019 09:00,33.95,35161,1129,2,0,3135,10,4276,5.820.297.619
01/09/2019 10:00,33.96,35461,1313,2,0,3385,10,4710,5.820.297.619
01/09/2019 11:00,33.59,35449,1487,3,0,3724,7,5221,5.820.297.619
01/09/2019 12:00,32.18,35339,1597,4,0,3970,6,5577,5.820.297.619
01/09/2019 13:00,31.19,35342,1652,5,0,3978,7,5642,5.820.297.619
01/09/2019 14:00,30.55,35182,1671,5,0,3840,8,5524,5.820.297.619
01/09/2019 15:00,30.27,35530,1634,5,0,3673,8,5320,5.820.297.619
01/09/2019 16:00,32.11,36282,1538,5,0,3465,8,5016,5.820.297.619
01/09/2019 17:00,33.55,36784,1453,8,0,3351,12,4824,5.820.297.619
01/09/2019 18:00,35.72,36803,1216,14,0,3066,15,4311,5.820.297.619
01/09/2019 19:00,36.66,36698,1059,25,0,3079,20,4183,5.820.297.619
01/09/2019 20:00,36.38,36333,1026,36,0,3006,25,4093,5.820.297.619
01/09/2019 21:00,35.16,34796,1105,44,0,3061,27,4237,5.820.297.619
01/09/2019 22:00,32.61,32838,1201,47,0,2928,27,4203,5.820.297.619
01/09/2019 23:00,30,31314,1261,55,192,2703,31,4242,5.820.297.619
02/09/2019 00:00,26.97,30494,1273,48,181,2561,24,4087,5.879.285.714
02/09/2019 01:00,25.96,30288,1278,40,158,2347,22,3845,5.879.285.714
02/09/2019 02:00,25,30247,1365,33,134,2194,17,3743,5.879.285.714
02/09/2019 03:00,26.26,31036,1430,27,112,2093,17,3679,5.879.285.714
02/09/2019 04:00,29.99,33068,1488,21,89,2071,14,3683,5.879.285.714
02/09/2019 05:00,36.39,36922,1510,17,66,1992,10,3595,5.879.285.714
02/09/2019 06:00,37.97,40609,1427,16,41,1754,5,3243,5.879.285.714
02/09/2019 07:00,38.84,41939,1426,16,29,1626,2,3099,5.879.285.714
02/09/2019 08:00,39.07,42064,1619,18,37,1638,2,3314,5.879.285.714
02/09/2019 09:00,39.07,42296,1819,19,56,1743,8,3645,5.879.285.714
02/09/2019 10:00,38.95,42510,1984,21,84,1790,16,3895,5.879.285.714
02/09/2019 11:00,38.22,42306,2093,23,111,1888,8,4123,5.879.285.714
02/09/2019 12:00,37.94,41661,2167,23,144,1979,9,4322,5.879.285.714
02/09/2019 13:00,37,41413,2110,25,158,2105,9,4407,5.879.285.714
02/09/2019 14:00,36.92,40895,2108,27,149,2150,8,4442,5.879.285.714
02/09/2019 15:00,37.28,40754,2083,28,143,2189,7,4450,5.879.285.714
02/09/2019 16:00,38.53,40912,1920,26,130,2161,8,4245,5.879.285.714
02/09/2019 17:00,38.75,40332,1675,26,116,2063,6,3886,5.879.285.714
02/09/2019 18:00,38.86,40200,1291,26,103,2009,7,3436,5.879.285.714
02/09/2019 19:00,38.5,40080,1133,25,93,2058,5,3314,5.879.285.714
02/09/2019 20:00,38.24,39239,1157,25,90,2058,6,3336,5.879.285.714
02/09/2019 21:00,36.99,37011,1225,25,89,2124,8,3471,5.879.285.714
02/09/2019 22:00,32.64,34561,1278,26,83,2231,8,3626,5.879.285.714
02/09/2019 23:00,31.63,32968,1816,105,65,2160,6,4152,5.879.285.714
03/09/2019 00:00,30.74,32037,1954,104,56,1927,9,4050,5.879.285.714
03/09/2019 01:00,30.21,31792,2149,101,43,1794,7,4094,5.879.285.714
03/09/2019 02:00,30.25,31806,2437,97,38,1823,5,4400,5.879.285.714
03/09/2019 03:00,30.91,32271,2681,94,36,1827,5,4643,5.879.285.714
03/09/2019 04:00,31.78,34014,2809,89,33,1940,3,4874,5.879.285.714
03/09/2019 05:00,35.6,37624,2797,80,34,2009,3,4923,5.879.285.714
03/09/2019 06:00,38.1,41264,2589,67,30,2035,3,4724,5.879.285.714
03/09/2019 07:00,38.67,42581,2400,60,30,2019,4,4513,5.879.285.714
03/09/2019 08:00,37.93,42808,2446,60,32,2197,4,4739,5.879.285.714
03/09/2019 09:00,37.83,43081,2445,60,38,2365,7,4915,5.879.285.714
03/09/2019 10:00,36.89,43104,2532,58,44,2512,7,5153,5.879.285.714
03/09/2019 11:00,36.14,42960,2583,57,54,2501,8,5203,5.879.285.714
03/09/2019 12:00,36.02,42606,2666,54,60,2510,7,5297,5.879.285.714
03/09/2019 13:00,35.78,42450,2643,60,66,2509,8,5286,5.879.285.714
03/09/2019 14:00,35.92,42233,2674,74,66,2358,6,5178,5.879.285.714
03/09/2019 15:00,37.18,41989,2606,72,64,2211,5,4958,5.879.285.714
03/09/2019 16:00,38.32,41942,2385,63,65,2129,6,4648,5.879.285.714
03/09/2019 17:00,38.83,41360,2110,56,59,2069,5,4299,5.879.285.714
03/09/2019 18:00,39.11,41187,1636,50,54,2007,5,3752,5.879.285.714
03/09/2019 19:00,38.91,40725,1384,47,59,2109,5,3604,5.879.285.714
03/09/2019 20:00,38.16,40005,1257,46,74,2347,6,3730,5.879.285.714
03/09/2019 21:00,36.93,37909,1173,45,90,2445,7,3760,5.879.285.714
03/09/2019 22:00,34.6,35309,1048,44,105,2538,10,3745,5.879.285.714
03/09/2019 23:00,31.81,33199,1251,47,113,2531,12,3954,5.879.285.714
04/09/2019 00:00,30.83,32240,1183,39,131,2577,13,3943,5.879.285.714
04/09/2019 01:00,29.8,31997,1141,34,139,2481,15,3810,5.879.285.714
04/09/2019 02:00,29.72,32049,1224,33,130,2366,15,3768,5.879.285.714
04/09/2019 03:00,30.91,32531,1319,31,119,2218,14,3701,5.879.285.714
04/09/2019 04:00,33.37,34209,1486,29,109,2116,13,3753,5.879.285.714
04/09/2019 05:00,37.36,37695,1744,28,99,1911,14,3796,5.879.285.714
04/09/2019 06:00,38.92,41074,1916,24,89,1630,11,3670,5.879.285.714
04/09/2019 07:00,39.94,42328,2133,20,82,1282,14,3531,5.879.285.714
04/09/2019 08:00,39.93,42504,2490,18,86,1088,13,3695,5.879.285.714
04/09/2019 09:00,39.85,42656,2746,18,90,891,12,3757,5.879.285.714
04/09/2019 10:00,38.91,42497,3016,19,94,866,12,4007,5.879.285.714
04/09/2019 11:00,37.46,42246,3097,20,100,996,11,4224,5.879.285.714
04/09/2019 12:00,36.9,42026,3126,21,101,1137,11,4396,5.879.285.714
04/09/2019 13:00,36.36,41865,3008,21,92,1353,11,4485,5.879.285.714
04/09/2019 14:00,35.97,41694,3117,20,81,1546,12,4776,5.879.285.714
04/09/2019 15:00,36.59,41475,3156,18,64,1665,10,4913,5.879.285.714
04/09/2019 16:00,37,41598,3059,17,51,1835,8,4970,5.879.285.714
04/09/2019 17:00,37.47,41274,2794,17,31,2032,6,4880,5.879.285.714
04/09/2019 18:00,38.28,41048,2275,20,22,2315,5,4637,5.879.285.714
04/09/2019 19:00,38.27,40521,2084,21,22,2645,5,4777,5.879.285.714
04/09/2019 20:00,37.16,39581,2233,21,37,2880,5,5176,5.879.285.714
04/09/2019 21:00,34.89,37556,2359,25,58,3054,5,5501,5.879.285.714
04/09/2019 22:00,31.29,35053,2292,37,78,3178,8,5593,5.879.285.714
04/09/2019 23:00,29.39,33105,2090,66,110,3221,11,5498,5.879.285.714
05/09/2019 00:00,28.13,32231,1785,75,137,3104,14,5115,5.879.285.714
05/09/2019 01:00,27.34,31951,1534,81,152,3208,16,4991,5.879.285.714
05/09/2019 02:00,26.78,32031,1337,87,159,3298,17,4898,5.879.285.714
05/09/2019 03:00,27.68,32574,1191,95,165,3349,20,4820,5.879.285.714
05/09/2019 04:00,29.67,34337,1204,98,169,3372,23,4866,5.879.285.714
05/09/2019 05:00,33.39,37654,1240,94,170,3397,26,4927,5.879.285.714
05/09/2019 06:00,36.52,40811,1362,77,167,3217,23,4846,5.879.285.714
05/09/2019 07:00,37.74,41989,1580,59,162,3232,22,5055,5.879.285.714
05/09/2019 08:00,36.24,42176,1997,52,161,3279,17,5506,5.879.285.714
05/09/2019 09:00,34.99,42499,2452,54,164,3364,16,6050,5.879.285.714
05/09/2019 10:00,34.12,42456,2912,62,171,3479,21,6645,5.879.285.714
05/09/2019 11:00,32.58,42217,3379,69,175,3574,18,7215,5.879.285.714
05/09/2019 12:00,32.37,42056,3741,70,170,3484,10,7475,5.879.285.714
05/09/2019 13:00,31.29,41865,3887,63,156,3381,12,7499,5.879.285.714
05/09/2019 14:00,31.6,41533,4128,58,133,3433,10,7762,5.879.285.714
05/09/2019 15:00,32.91,41336,4408,55,114,3463,8,8048,5.879.285.714
05/09/2019 16:00,34.27,41545,4386,50,101,3581,10,8128,5.879.285.714
05/09/2019 17:00,34.73,41230,4397,41,90,3483,9,8020,5.879.285.714
05/09/2019 18:00,35.85,41103,3913,37,87,3313,11,7361,5.879.285.714
05/09/2019 19:00,35.61,40728,3717,38,85,3319,8,7167,5.879.285.714
05/09/2019 20:00,35.33,39736,3761,39,82,3402,14,7298,5.879.285.714
05/09/2019 21:00,33.6,37715,3818,40,84,3513,14,7469,5.879.285.714
05/09/2019 22:00,30.12,35375,3625,42,87,3658,15,7427,5.879.285.714
05/09/2019 23:00,26.28,33832,3603,37,107,3701,13,7461,5.879.285.714
06/09/2019 00:00,25.64,32897,3215,43,126,3726,16,7126,5.879.285.714
06/09/2019 01:00,24.36,32535,2785,50,145,3568,24,6572,5.879.285.714
06/09/2019 02:00,24.67,32524,2439,59,151,3562,24,6235,5.879.285.714
06/09/2019 03:00,26.3,32965,2132,67,161,3470,23,5853,5.879.285.714
06/09/2019 04:00,28.07,34669,1917,79,171,3518,27,5712,5.879.285.714
06/09/2019 05:00,33.41,37994,1831,91,183,3276,25,5406,5.879.285.714
06/09/2019 06:00,35.8,41179,1862,101,183,3074,31,5251,5.879.285.714
06/09/2019 07:00,37.34,42411,1965,114,196,2830,32,5137,5.879.285.714
06/09/2019 08:00,37.33,42659,2121,131,221,2737,36,5246,5.879.285.714
06/09/2019 09:00,36.16,42836,2240,143,240,2572,39,5234,5.879.285.714
06/09/2019 10:00,34.48,42547,2404,150,240,2637,38,5469,5.879.285.714
06/09/2019 11:00,34.16,41996,2612,155,226,2543,30,5566,5.879.285.714
06/09/2019 12:00,33.67,41462,2777,156,207,2585,27,5752,5.879.285.714
06/09/2019 13:00,33.4,40900,2739,146,193,2641,23,5742,5.879.285.714
06/09/2019 14:00,33.32,40431,2912,131,172,2470,19,5704,5.879.285.714
06/09/2019 15:00,33.7,40327,3169,126,156,2400,16,5867,5.879.285.714
06/09/2019 16:00,34.55,40529,3196,125,131,2269,13,5734,5.879.285.714
06/09/2019 17:00,36.29,40266,3113,116,99,2100,13,5441,5.879.285.714
06/09/2019 18:00,36.5,39882,2582,109,72,2193,10,4966,5.879.285.714
06/09/2019 19:00,36.03,39299,2181,112,54,2271,10,4628,5.879.285.714
06/09/2019 20:00,35.19,38352,2104,114,47,2461,9,4735,5.879.285.714
06/09/2019 21:00,34.29,36718,2150,111,49,2593,9,4912,5.879.285.714
06/09/2019 22:00,33.24,34853,2152,110,50,2555,8,4875,5.879.285.714
06/09/2019 23:00,31.99,33422,2179,29,52,2400,7,4667,5.879.285.714
07/09/2019 00:00,30.31,32484,2032,32,55,2272,8,4399,5.879.285.714
07/09/2019 01:00,29.64,31944,1876,33,59,2083,9,4060,5.879.285.714
07/09/2019 02:00,29.5,31728,1740,30,70,2073,11,3924,5.879.285.714
07/09/2019 03:00,29.76,31637,1532,27,86,2070,7,3722,5.879.285.714
07/09/2019 04:00,30.17,31904,1356,23,91,1934,7,3411,5.879.285.714
07/09/2019 05:00,31.05,32566,1171,19,90,1776,8,3064,5.879.285.714
07/09/2019 06:00,33.32,34036,980,13,81,1694,8,2776,5.879.285.714
07/09/2019 07:00,34.16,35954,823,9,67,1633,9,2541,5.879.285.714
07/09/2019 08:00,35.26,37359,811,10,60,1472,9,2362,5.879.285.714
07/09/2019 09:00,35.6,38104,846,11,59,1388,8,2312,5.879.285.714
07/09/2019 10:00,35.21,38087,882,12,58,1315,9,2276,5.879.285.714
07/09/2019 11:00,34.9,37792,880,14,57,1289,9,2249,5.879.285.714
07/09/2019 12:00,33.85,37535,887,15,55,1308,10,2275,5.879.285.714
07/09/2019 13:00,33.7,37270,875,14,51,1252,8,2200,5.879.285.714
07/09/2019 14:00,33.56,37059,957,12,37,1202,7,2215,5.879.285.714
07/09/2019 15:00,33.85,37319,1075,10,29,1130,6,2250,5.879.285.714
07/09/2019 16:00,35.16,37875,1064,8,23,1018,5,2118,5.879.285.714
07/09/2019 17:00,35.27,38030,978,6,24,993,3,2004,5.879.285.714
07/09/2019 18:00,35.3,37774,840,6,33,1017,3,1899,5.879.285.714
07/09/2019 19:00,35.3,37381,718,6,42,999,3,1768,5.879.285.714
07/09/2019 20:00,34.96,36747,596,6,55,939,3,1599,5.879.285.714
07/09/2019 21:00,34.25,35453,490,8,64,909,5,1476,5.879.285.714
07/09/2019 22:00,33.16,33897,386,10,72,897,6,1371,5.879.285.714
07/09/2019 23:00,33.91,32598,203,17,0,871,4,1095,5.879.285.714
08/09/2019 00:00,32.06,31650,171,19,0,873,4,1067,5.879.285.714
08/09/2019 01:00,31.8,31171,166,20,0,736,3,925,5.879.285.714
08/09/2019 02:00,31.54,31059,176,21,0,674,4,875,5.879.285.714
08/09/2019 03:00,31.42,31024,199,26,0,671,7,903,5.879.285.714
08/09/2019 04:00,31.35,31091,224,30,0,630,10,894,5.879.285.714
08/09/2019 05:00,31.92,31315,246,33,0,612,13,904,5.879.285.714
08/09/2019 06:00,33.13,32472,246,30,0,573,10,859,5.879.285.714
08/09/2019 07:00,33.98,34142,251,22,0,504,12,789,5.879.285.714
08/09/2019 08:00,35.09,35788,302,18,0,407,8,735,5.879.285.714
08/09/2019 09:00,34.99,36752,324,21,0,312,7,664,5.879.285.714
08/09/2019 10:00,35.02,36943,346,24,0,288,7,665,5.879.285.714
08/09/2019 11:00,34.78,36908,347,27,0,283,6,663,5.879.285.714
08/09/2019 12:00,34.33,36718,349,31,0,280,7,667,5.879.285.714
08/09/2019 13:00,34.26,36645,331,36,0,319,7,693,5.879.285.714
08/09/2019 14:00,34.37,36581,329,39,0,376,8,752,5.879.285.714
08/09/2019 15:00,34.6,36883,351,42,0,420,13,826,5.879.285.714
08/09/2019 16:00,35.87,37535,331,40,0,466,19,856,5.879.285.714
08/09/2019 17:00,35.95,38110,335,41,0,536,19,931,5.879.285.714
08/09/2019 18:00,36.19,38249,308,50,0,689,22,1069,5.879.285.714
08/09/2019 19:00,36.29,38219,277,65,0,854,24,1220,5.879.285.714
08/09/2019 20:00,35.6,37645,295,79,0,1013,22,1409,5.879.285.714
08/09/2019 21:00,34.85,36108,323,93,0,1128,21,1565,5.879.285.714
08/09/2019 22:00,34.16,34179,320,103,0,1149,13,1585,5.879.285.714
08/09/2019 23:00,34.35,33033,203,96,0,1143,6,1448,5.879.285.714
09/09/2019 00:00,33.43,32280,176,98,0,1143,6,1423,6.013.035.714
09/09/2019 01:00,32.29,32005,159,108,0,1132,5,1404,6.013.035.714
09/09/2019 02:00,31.52,32244,148,117,0,1112,5,1382,6.013.035.714
09/09/2019 03:00,32.38,32906,135,117,0,1105,7,1364,6.013.035.714
09/09/2019 04:00,34.04,34772,123,114,0,1082,5,1324,6.013.035.714
09/09/2019 05:00,35.91,38349,117,114,0,1066,5,1302,6.013.035.714
09/09/2019 06:00,37.93,41698,112,117,0,1059,6,1294,6.013.035.714
09/09/2019 07:00,39.89,42940,97,126,0,989,5,1217,6.013.035.714
09/09/2019 08:00,38.92,43164,108,132,0,910,3,1153,6.013.035.714
09/09/2019 09:00,38.91,43304,112,124,0,831,4,1071,6.013.035.714
09/09/2019 10:00,38.19,43269,133,129,0,764,4,1030,6.013.035.714
09/09/2019 11:00,37.98,43053,147,132,0,771,4,1054,6.013.035.714
09/09/2019 12:00,37.99,42874,174,122,0,775,5,1076,6.013.035.714
09/09/2019 13:00,37.65,42663,190,118,0,783,5,1096,6.013.035.714
09/09/2019 14:00,37.61,42228,215,103,0,760,4,1082,6.013.035.714
09/09/2019 15:00,37.83,42001,246,82,0,745,4,1077,6.013.035.714
09/09/2019 16:00,37.83,42147,285,64,0,807,4,1160,6.013.035.714
09/09/2019 17:00,38.3,41823,383,54,0,999,5,1441,6.013.035.714
09/09/2019 18:00,38.22,41729,462,49,0,1175,11,1697,6.013.035.714
09/09/2019 19:00,37.91,41368,487,45,0,1373,18,1923,6.013.035.714
09/09/2019 20:00,37.02,40292,599,41,0,1389,26,2055,6.013.035.714
09/09/2019 21:00,35.68,38222,725,37,0,1362,31,2155,6.013.035.714
09/09/2019 22:00,33.64,35793,814,36,0,1379,32,2261,6.013.035.714
09/09/2019 23:00,32.79,33393,953,93,279,1494,28,2847,6.013.035.714
10/09/2019 00:00,32.34,32449,1099,93,286,1392,26,2896,6.013.035.714
10/09/2019 01:00,31.2,32199,1277,89,284,1451,31,3132,6.013.035.714
10/09/2019 02:00,30.51,32222,1491,83,285,1396,34,3289,6.013.035.714
10/09/2019 03:00,30.82,32644,1635,88,283,1458,33,3497,6.013.035.714
10/09/2019 04:00,32.7,34293,1787,91,283,1523,33,3717,6.013.035.714
10/09/2019 05:00,35.31,37683,1977,87,275,1494,31,3864,6.013.035.714
10/09/2019 06:00,36.86,40945,2084,80,261,1510,31,3966,6.013.035.714
10/09/2019 07:00,37.71,42054,2102,75,249,1484,26,3936,6.013.035.714
10/09/2019 08:00,37.35,42114,2306,68,254,1510,22,4160,6.013.035.714
10/09/2019 09:00,35.54,42343,2555,57,263,1642,20,4537,6.013.035.714
10/09/2019 10:00,34.76,42258,2816,49,269,1625,19,4778,6.013.035.714
10/09/2019 11:00,34.68,41990,2963,41,274,1530,23,4831,6.013.035.714
10/09/2019 12:00,34.54,41642,3109,33,279,1463,23,4907,6.013.035.714
10/09/2019 13:00,34.29,41489,3100,26,286,1483,29,4924,6.013.035.714
10/09/2019 14:00,34.01,41299,3214,20,282,1396,27,4939,6.013.035.714
10/09/2019 15:00,34.6,41148,3419,16,272,1420,27,5154,6.013.035.714
10/09/2019 16:00,35.92,41265,3521,17,259,1371,25,5193,6.013.035.714
10/09/2019 17:00,36.06,41053,3568,24,239,1464,18,5313,6.013.035.714
10/09/2019 18:00,36.56,41080,3157,35,228,1578,14,5012,6.013.035.714
10/09/2019 19:00,35.61,40686,3046,49,224,1769,16,5104,6.013.035.714
10/09/2019 20:00,35.01,39606,3160,66,235,1665,24,5150,6.013.035.714
10/09/2019 21:00,33.91,37569,3320,79,238,1670,37,5344,6.013.035.714
10/09/2019 22:00,31.2,35064,3293,84,235,1638,33,5283,6.013.035.714
10/09/2019 23:00,30.36,32991,2647,78,317,1565,46,4653,6.013.035.714
11/09/2019 00:00,29.58,32080,2549,81,318,1569,51,4568,6.013.035.714
11/09/2019 01:00,28.59,31722,2362,85,303,1650,52,4452,6.013.035.714
11/09/2019 02:00,28.25,31764,2183,89,302,1737,52,4363,6.013.035.714
11/09/2019 03:00,28.47,32275,1996,91,295,1850,52,4284,6.013.035.714
11/09/2019 04:00,29.95,34022,1970,91,296,1998,52,4407,6.013.035.714
11/09/2019 05:00,34.73,37486,2034,89,295,2030,53,4501,6.013.035.714
11/09/2019 06:00,35.6,40771,2034,81,286,2027,52,4480,6.013.035.714
11/09/2019 07:00,36.87,41871,2142,66,280,2081,52,4621,6.013.035.714
11/09/2019 08:00,36.16,41965,2510,59,281,2236,52,5138,6.013.035.714
11/09/2019 09:00,35.27,42132,3000,60,289,2554,51,5954,6.013.035.714
11/09/2019 10:00,33.86,41974,3487,67,292,2876,51,6773,6.013.035.714
11/09/2019 11:00,33.13,41683,3790,78,289,3040,50,7247,6.013.035.714
11/09/2019 12:00,32.08,41481,4034,88,272,3292,50,7736,6.013.035.714
11/09/2019 13:00,31.16,41315,3962,93,248,3522,50,7875,6.013.035.714
11/09/2019 14:00,31.37,41160,3980,92,207,3801,50,8130,6.013.035.714
11/09/2019 15:00,31.53,41061,4047,92,162,3969,47,8317,6.013.035.714
11/09/2019 16:00,32.82,41205,3972,101,123,4058,43,8297,6.013.035.714
11/09/2019 17:00,34.27,40975,3611,104,91,4092,38,7936,6.013.035.714
11/09/2019 18:00,34.29,41011,2905,101,73,4259,32,7370,6.013.035.714
11/09/2019 19:00,34.05,40620,2623,105,66,4480,27,7301,6.013.035.714
11/09/2019 20:00,32.74,39270,2615,107,68,4484,26,7300,6.013.035.714
11/09/2019 21:00,31.18,37141,2562,106,71,4511,25,7275,6.013.035.714
11/09/2019 22:00,29.29,34722,2422,100,70,4383,20,6995,6.013.035.714
11/09/2019 23:00,26.9,33068,2820,123,168,4145,25,7281,6.013.035.714
12/09/2019 00:00,26.42,32143,2614,129,170,3909,22,6844,6.013.035.714
12/09/2019 01:00,26.43,31817,2471,136,176,3774,24,6581,6.013.035.714
12/09/2019 02:00,26.33,31889,2407,140,184,3472,27,6230,6.013.035.714
12/09/2019 03:00,27.57,32384,2265,147,196,3400,29,6037,6.013.035.714
12/09/2019 04:00,29.39,34226,2116,158,203,3414,31,5922,6.013.035.714
12/09/2019 05:00,32.51,37635,1999,170,209,3435,33,5846,6.013.035.714
12/09/2019 06:00,34.01,40771,1851,180,207,3394,26,5658,6.013.035.714
12/09/2019 07:00,35,41856,1776,191,206,3342,25,5540,6.013.035.714
12/09/2019 08:00,34.95,41867,1929,201,214,3282,31,5657,6.013.035.714
12/09/2019 09:00,34.27,42060,2184,208,238,3431,36,6097,6.013.035.714
12/09/2019 10:00,33.9,41899,2487,214,250,3513,35,6499,6.013.035.714
12/09/2019 11:00,33.28,41655,2690,219,246,3622,22,6799,6.013.035.714
12/09/2019 12:00,33.41,41518,2977,224,246,3814,26,7287,6.013.035.714
12/09/2019 13:00,32.14,41343,3002,224,242,3896,27,7391,6.013.035.714
12/09/2019 14:00,32.16,41068,3018,216,229,4043,28,7534,6.013.035.714
12/09/2019 15:00,32.42,40883,3146,205,213,4168,29,7761,6.013.035.714
12/09/2019 16:00,32.99,41142,3158,193,199,3985,27,7562,6.013.035.714
12/09/2019 17:00,32.94,40914,3068,188,188,3837,22,7303,6.013.035.714
12/09/2019 18:00,33.77,40968,2686,192,180,4029,19,7106,6.013.035.714
12/09/2019 19:00,33.46,40559,2439,201,176,4137,22,6975,6.013.035.714
12/09/2019 20:00,32.71,39312,2302,203,177,4191,25,6898,6.013.035.714
12/09/2019 21:00,30.92,37204,2129,194,180,4217,25,6745,6.013.035.714
12/09/2019 22:00,29.31,34916,2050,181,179,4112,30,6552,6.013.035.714
12/09/2019 23:00,29.03,32969,1543,187,209,3961,25,5925,6.013.035.714
13/09/2019 00:00,28.11,32124,1485,184,211,3840,31,5751,6.013.035.714
13/09/2019 01:00,27.02,31928,1580,181,211,3924,33,5929,6.013.035.714
13/09/2019 02:00,26.04,31962,1868,179,214,3881,33,6175,6.013.035.714
13/09/2019 03:00,26.96,32426,2128,181,219,3801,33,6362,6.013.035.714
13/09/2019 04:00,29.94,34190,2424,185,223,3720,31,6583,6.013.035.714
13/09/2019 05:00,33.66,37736,2721,190,217,3721,29,6878,6.013.035.714
13/09/2019 06:00,35.52,41005,2928,193,214,3614,27,6976,6.013.035.714
13/09/2019 07:00,35.97,42218,2980,197,221,3609,30,7037,6.013.035.714
13/09/2019 08:00,35.71,42368,3156,206,253,3907,29,7551,6.013.035.714
13/09/2019 09:00,35.18,42461,3373,208,278,4112,28,7999,6.013.035.714
13/09/2019 10:00,34.3,42110,3621,207,303,4296,30,8457,6.013.035.714
13/09/2019 11:00,34.01,41474,3713,198,304,4584,25,8824,6.013.035.714
13/09/2019 12:00,33.39,40944,3808,187,290,4795,28,9108,6.013.035.714
13/09/2019 13:00,32.38,40361,3721,191,291,4974,22,9199,6.013.035.714
13/09/2019 14:00,31.2,39843,3679,191,304,5121,20,9315,6.013.035.714
13/09/2019 15:00,31.65,39750,3661,180,319,5218,27,9405,6.013.035.714
13/09/2019 16:00,32.38,40023,3533,167,313,5142,27,9182,6.013.035.714
13/09/2019 17:00,32.66,39973,3378,155,301,4985,30,8849,6.013.035.714
13/09/2019 18:00,33.46,39755,2915,144,290,4855,28,8232,6.013.035.714
13/09/2019 19:00,33,39078,2713,137,269,4786,31,7936,6.013.035.714
13/09/2019 20:00,31.52,37924,2670,136,251,4692,34,7783,6.013.035.714
13/09/2019 21:00,29.84,36289,2559,135,228,4540,36,7498,6.013.035.714
13/09/2019 22:00,28.86,34412,2431,134,212,4411,33,7221,6.013.035.714
13/09/2019 23:00,27.96,32891,2360,36,185,4388,33,7002,6.013.035.714
14/09/2019 00:00,27.33,31919,2199,36,181,4355,32,6803,6.013.035.714
14/09/2019 01:00,26.95,31492,2111,38,180,4267,32,6628,6.013.035.714
14/09/2019 02:00,27.07,31350,2019,45,183,4309,30,6586,6.013.035.714
14/09/2019 03:00,27.34,31406,1887,52,187,4160,28,6314,6.013.035.714
14/09/2019 04:00,27.97,31881,1730,57,188,4004,27,6006,6.013.035.714
14/09/2019 05:00,28.96,32670,1578,57,191,3776,27,5629,6.013.035.714
14/09/2019 06:00,30.91,34069,1405,54,193,3575,27,5254,6.013.035.714
14/09/2019 07:00,32.11,36043,1306,49,212,3314,29,4910,6.013.035.714
14/09/2019 08:00,33.61,37484,1377,49,248,3327,35,5036,6.013.035.714
14/09/2019 09:00,33.99,38088,1553,49,278,3309,36,5225,6.013.035.714
14/09/2019 10:00,32.02,37912,1798,47,300,3261,36,5442,6.013.035.714
14/09/2019 11:00,30.94,37586,1925,45,314,3286,35,5605,6.013.035.714
14/09/2019 12:00,29.71,37296,2081,44,321,3386,35,5867,6.013.035.714
14/09/2019 13:00,28.05,36947,2205,40,316,3340,33,5934,6.013.035.714
14/09/2019 14:00,28.02,36848,2298,35,303,3206,33,5875,6.013.035.714
14/09/2019 15:00,29.92,37119,2447,33,271,3149,31,5931,6.013.035.714
14/09/2019 16:00,32.79,37721,2526,32,233,3049,29,5869,6.013.035.714
14/09/2019 17:00,32.88,38142,2511,34,192,2883,20,5640,6.013.035.714
14/09/2019 18:00,32.56,38077,2317,40,159,2857,17,5390,6.013.035.714
14/09/2019 19:00,31.27,37666,2491,45,142,3144,15,5837,6.013.035.714
14/09/2019 20:00,30.08,36828,2917,47,135,3461,14,6574,6.013.035.714
14/09/2019 21:00,27.99,35422,3370,49,129,3933,15,7496,6.013.035.714
14/09/2019 22:00,26.81,33742,3685,45,136,4322,16,8204,6.013.035.714
14/09/2019 23:00,26.51,32568,3990,51,167,4662,23,8893,6.013.035.714
15/09/2019 00:00,24.31,31675,4208,50,186,5039,24,9507,6.013.035.714
15/09/2019 01:00,18.96,31229,4298,48,205,5232,24,9807,6.013.035.714
15/09/2019 02:00,17.29,31130,4328,44,234,5173,26,9805,6.013.035.714
15/09/2019 03:00,15.9,31156,4254,36,269,5067,31,9657,6.013.035.714
15/09/2019 04:00,17,31303,4270,31,306,5055,45,9707,6.013.035.714
15/09/2019 05:00,17.92,31559,4244,29,333,4903,46,9555,6.013.035.714
15/09/2019 06:00,19.15,32617,4093,28,351,4628,45,9145,6.013.035.714
15/09/2019 07:00,24.24,34211,3886,25,366,4430,46,8753,6.013.035.714
15/09/2019 08:00,24.29,35789,3929,23,386,4471,47,8856,6.013.035.714
15/09/2019 09:00,22.47,36677,4065,21,409,4563,47,9105,6.013.035.714
15/09/2019 10:00,22.03,36916,4211,22,420,4633,47,9333,6.013.035.714
15/09/2019 11:00,17.81,36959,4271,26,427,4735,47,9506,6.013.035.714
15/09/2019 12:00,13.67,36838,4360,31,429,4735,47,9602,6.013.035.714
15/09/2019 13:00,10.63,36695,4345,38,429,4704,47,9563,6.013.035.714
15/09/2019 14:00,16.57,36631,4371,46,429,4758,47,9651,6.013.035.714
15/09/2019 15:00,23.92,37032,4439,56,429,4714,47,9685,6.013.035.714
15/09/2019 16:00,28.01,37810,4499,66,428,4709,47,9749,6.013.035.714
15/09/2019 17:00,30.08,38528,4565,75,431,4569,47,9687,6.013.035.714
15/09/2019 18:00,30.89,38775,4193,82,431,4449,47,9202,6.013.035.714
15/09/2019 19:00,30.63,38565,4038,86,430,4556,47,9157,6.013.035.714
15/09/2019 20:00,27.48,37787,4000,86,429,4715,47,9277,6.013.035.714
15/09/2019 21:00,24.42,36233,4055,86,427,4754,47,9369,6.013.035.714
15/09/2019 22:00,23.6,34348,4033,82,420,4773,46,9354,6.013.035.714
15/09/2019 23:00,15.03,32875,4200,145,0,4802,49,9196,6.013.035.714
16/09/2019 00:00,6.56,32136,4122,141,0,4767,49,9079,6.082.321.429
16/09/2019 01:00,6.6,31841,4019,139,0,4695,49,8902,6.082.321.429
16/09/2019 02:00,9.26,31970,3848,137,0,4706,49,8740,6.082.321.429
16/09/2019 03:00,17.22,32615,3634,137,0,4628,49,8448,6.082.321.429
16/09/2019 04:00,25.5,34634,3533,144,0,4525,49,8251,6.082.321.429
16/09/2019 05:00,33.1,38217,3450,148,0,4406,49,8053,6.082.321.429
16/09/2019 06:00,34.7,41455,3342,150,0,4174,49,7715,6.082.321.429
16/09/2019 07:00,36.27,42661,3195,148,0,3939,48,7330,6.082.321.429
16/09/2019 08:00,36.08,42753,3271,144,0,3793,47,7255,6.082.321.429
16/09/2019 09:00,36.01,42814,3485,142,0,3723,45,7395,6.082.321.429
16/09/2019 10:00,35.43,42667,3661,143,0,3618,45,7467,6.082.321.429
16/09/2019 11:00,35.11,42441,3678,133,0,3549,47,7407,6.082.321.429
16/09/2019 12:00,35.16,42183,3697,132,0,3452,47,7328,6.082.321.429
16/09/2019 13:00,34.76,41968,3656,130,0,3439,47,7272,6.082.321.429
16/09/2019 14:00,34.53,41727,3631,129,0,3311,47,7118,6.082.321.429
16/09/2019 15:00,35.03,41525,3748,134,0,3239,47,7168,6.082.321.429
16/09/2019 16:00,35.66,41761,3818,139,0,3164,47,7168,6.082.321.429
16/09/2019 17:00,35.94,41675,3784,147,0,3076,45,7052,6.082.321.429
16/09/2019 18:00,36.34,41812,3364,154,0,2990,44,6552,6.082.321.429
16/09/2019 19:00,36.06,41371,3219,156,0,3024,45,6444,6.082.321.429
16/09/2019 20:00,35.15,40160,3173,156,0,2999,43,6371,6.082.321.429
16/09/2019 21:00,34.2,38099,3232,155,0,2969,43,6399,6.082.321.429
16/09/2019 22:00,30.75,35808,3321,153,0,2960,42,6476,6.082.321.429
16/09/2019 23:00,30.63,34811,3562,162,234,2931,41,6930,6.082.321.429
17/09/2019 00:00,29.96,33833,3791,162,217,2775,40,6985,6.082.321.429
17/09/2019 01:00,28.99,33565,3935,161,208,2665,33,7002,6.082.321.429
17/09/2019 02:00,28.81,33651,3995,160,200,2650,23,7028,6.082.321.429
17/09/2019 03:00,29.21,34190,3973,158,191,2639,19,6980,6.082.321.429
17/09/2019 04:00,32.22,36079,3967,160,181,2584,16,6908,6.082.321.429
17/09/2019 05:00,35.91,39702,3927,160,168,2532,19,6806,6.082.321.429
17/09/2019 06:00,38.32,42835,3916,159,163,2566,19,6823,6.082.321.429
17/09/2019 07:00,40.75,43861,3848,166,170,2445,16,6645,6.082.321.429
17/09/2019 08:00,39.7,43787,3930,174,181,2411,17,6713,6.082.321.429
17/09/2019 09:00,37.11,43901,4185,178,188,2385,11,6947,6.082.321.429
17/09/2019 10:00,35.68,43695,4318,182,199,2347,11,7057,6.082.321.429
17/09/2019 11:00,34.56,43383,4445,189,216,2343,8,7201,6.082.321.429
17/09/2019 12:00,33.91,43083,4529,192,238,2490,8,7457,6.082.321.429
17/09/2019 13:00,33.15,42833,4423,190,256,2596,10,7475,6.082.321.429
17/09/2019 14:00,32.95,42699,4378,187,254,2700,11,7530,6.082.321.429
17/09/2019 15:00,33.42,42595,4465,185,242,2891,8,7791,6.082.321.429
17/09/2019 16:00,33.84,42769,4498,181,227,2909,7,7822,6.082.321.429
17/09/2019 17:00,35.2,42705,4462,168,210,2866,8,7714,6.082.321.429
17/09/2019 18:00,36.86,42958,3998,154,190,2810,7,7159,6.082.321.429
17/09/2019 19:00,36.72,42522,3817,130,171,2908,7,7033,6.082.321.429
17/09/2019 20:00,33.87,41341,3682,108,162,2983,7,6942,6.082.321.429
17/09/2019 21:00,31.51,39260,3554,92,148,3000,7,6801,6.082.321.429
17/09/2019 22:00,28.92,36928,3397,81,141,2903,8,6530,6.082.321.429
17/09/2019 23:00,28.64,35382,3411,56,102,2997,10,6576,6.082.321.429
18/09/2019 00:00,28.05,34514,3414,46,108,2912,16,6496,6.082.321.429
18/09/2019 01:00,27.77,34225,3396,40,114,2899,13,6462,6.082.321.429
18/09/2019 02:00,27.79,34284,3429,34,129,2835,13,6440,6.082.321.429
18/09/2019 03:00,29.21,34945,3456,31,148,2781,16,6432,6.082.321.429
18/09/2019 04:00,31.56,36879,3486,27,150,2730,15,6408,6.082.321.429
18/09/2019 05:00,35.79,40476,3510,24,148,2536,13,6231,6.082.321.429
18/09/2019 06:00,37.63,43747,3461,20,142,2367,10,6000,6.082.321.429
18/09/2019 07:00,38.56,44748,3310,17,132,2095,8,5562,6.082.321.429
18/09/2019 08:00,38.08,44714,3323,13,137,1878,7,5358,6.082.321.429
18/09/2019 09:00,36.19,44732,3481,12,163,1812,6,5474,6.082.321.429
18/09/2019 10:00,35.89,44492,3507,9,194,1811,7,5528,6.082.321.429
18/09/2019 11:00,35.61,44182,3497,9,233,1838,15,5592,6.082.321.429
18/09/2019 12:00,35.49,43888,3539,10,265,1979,16,5809,6.082.321.429
18/09/2019 13:00,34.92,43627,3510,9,279,1992,10,5800,6.082.321.429
18/09/2019 14:00,35.16,43423,3487,11,277,2032,9,5816,6.082.321.429
18/09/2019 15:00,35.35,43197,3579,11,265,2129,11,5995,6.082.321.429
18/09/2019 16:00,36.38,43502,3563,13,247,2090,13,5926,6.082.321.429
18/09/2019 17:00,37.06,43493,3440,17,220,2242,11,5930,6.082.321.429
18/09/2019 18:00,37.56,43698,3034,23,196,2360,18,5631,6.082.321.429
18/09/2019 19:00,37.25,43225,2851,29,179,2689,17,5765,6.082.321.429
18/09/2019 20:00,36.12,41810,2668,33,163,2934,12,5810,6.082.321.429
18/09/2019 21:00,35.03,39683,2491,36,151,3248,14,5940,6.082.321.429
18/09/2019 22:00,32.18,37256,2324,35,133,3395,9,5896,6.082.321.429
18/09/2019 23:00,30.15,35678,1944,43,111,3493,5,5596,6.082.321.429
19/09/2019 00:00,28.86,34785,1768,44,104,3601,5,5522,6.082.321.429
19/09/2019 01:00,28.47,34581,1608,42,98,3663,5,5416,6.082.321.429
19/09/2019 02:00,28.4,34638,1499,37,97,3646,8,5287,6.082.321.429
19/09/2019 03:00,29.49,35257,1410,38,93,3523,6,5070,6.082.321.429
19/09/2019 04:00,33.09,37162,1374,43,90,3505,6,5018,6.082.321.429
19/09/2019 05:00,35.4,40785,1322,51,87,3498,5,4963,6.082.321.429
19/09/2019 06:00,39.06,43842,1259,59,93,3358,8,4777,6.082.321.429
19/09/2019 07:00,40.93,44862,1151,59,99,2873,8,4190,6.082.321.429
19/09/2019 08:00,41.67,44769,1081,50,107,2482,13,3733,6.082.321.429
19/09/2019 09:00,39.83,44816,1080,45,118,2216,17,3476,6.082.321.429
19/09/2019 10:00,38.61,44513,1095,45,135,2174,27,3476,6.082.321.429
19/09/2019 11:00,37.63,44088,1082,48,160,2225,28,3543,6.082.321.429
19/09/2019 12:00,36.88,43940,1101,53,187,2353,32,3726,6.082.321.429
19/09/2019 13:00,35.6,43644,1119,54,221,2402,34,3830,6.082.321.429
19/09/2019 14:00,35.38,43373,1108,56,236,2366,29,3795,6.082.321.429
19/09/2019 15:00,35.77,43269,1176,60,238,2265,31,3770,6.082.321.429
19/09/2019 16:00,35.72,43599,1203,59,232,2122,24,3640,6.082.321.429
19/09/2019 17:00,36.56,43535,1155,53,218,1957,28,3411,6.082.321.429
19/09/2019 18:00,39.72,43766,962,50,209,1999,31,3251,6.082.321.429
19/09/2019 19:00,37.56,43327,948,43,196,2071,29,3287,6.082.321.429
19/09/2019 20:00,35.69,41915,1066,35,177,2174,30,3482,6.082.321.429
19/09/2019 21:00,34.8,39911,1182,28,161,2039,30,3440,6.082.321.429
19/09/2019 22:00,33.62,37661,1241,22,151,1989,31,3434,6.082.321.429
19/09/2019 23:00,34.06,36525,1104,23,156,1876,19,3178,6.082.321.429
20/09/2019 00:00,33.05,35613,1061,17,156,1778,21,3033,6.082.321.429
20/09/2019 01:00,31.2,35272,1069,14,150,1599,13,2845,6.082.321.429
20/09/2019 02:00,31.58,35334,1112,13,143,1587,11,2866,6.082.321.429
20/09/2019 03:00,32.94,35890,1154,13,134,1536,10,2847,6.082.321.429
20/09/2019 04:00,34.21,37775,1229,13,123,1486,7,2858,6.082.321.429
20/09/2019 05:00,35.69,41410,1277,13,107,1388,5,2790,6.082.321.429
20/09/2019 06:00,39.86,44637,1356,12,86,1232,5,2691,6.082.321.429
20/09/2019 07:00,40.58,45763,1455,8,71,1018,4,2556,6.082.321.429
20/09/2019 08:00,39.51,45782,1646,5,60,805,4,2520,6.082.321.429
20/09/2019 09:00,37.43,45647,1852,4,51,788,4,2699,6.082.321.429
20/09/2019 10:00,36.95,45186,1963,6,49,827,4,2849,6.082.321.429
20/09/2019 11:00,35.52,44610,2041,8,61,880,4,2994,6.082.321.429
20/09/2019 12:00,34.5,44127,2224,9,68,1052,4,3357,6.082.321.429
20/09/2019 13:00,33.15,43518,2375,11,78,1183,4,3651,6.082.321.429
20/09/2019 14:00,33.11,42971,2412,17,78,1237,6,3750,6.082.321.429
20/09/2019 15:00,34.63,42748,2410,28,74,1397,8,3917,6.082.321.429
20/09/2019 16:00,35.21,42970,2359,36,70,1417,6,3888,6.082.321.429
20/09/2019 17:00,35.49,43061,2172,45,69,1637,6,3929,6.082.321.429
20/09/2019 18:00,35.54,42942,1822,64,73,1923,7,3889,6.082.321.429
20/09/2019 19:00,35.07,42020,1770,77,80,2104,7,4038,6.082.321.429
20/09/2019 20:00,33.12,40685,1832,87,92,2230,8,4249,6.082.321.429
20/09/2019 21:00,31.63,39051,1854,96,109,2349,10,4418,6.082.321.429
20/09/2019 22:00,29.45,37229,1860,98,123,2330,8,4419,6.082.321.429
20/09/2019 23:00,30.94,35082,1730,159,121,2278,10,4298,6.082.321.429
21/09/2019 00:00,29.55,34143,1618,149,122,2234,12,4135,6.082.321.429
21/09/2019 01:00,28.8,33658,1463,140,122,2305,15,4045,6.082.321.429
21/09/2019 02:00,29.03,33422,1306,134,131,2219,17,3807,6.082.321.429
21/09/2019 03:00,29.75,33393,1102,130,139,2254,25,3650,6.082.321.429
21/09/2019 04:00,30.28,33826,951,123,149,2228,26,3477,6.082.321.429
21/09/2019 05:00,30.84,34533,834,118,158,2181,25,3316,6.082.321.429
21/09/2019 06:00,31.78,35730,719,116,168,2120,23,3146,6.082.321.429
21/09/2019 07:00,33.64,37536,636,123,185,1964,24,2932,6.082.321.429
21/09/2019 08:00,34.16,38860,576,137,211,1734,22,2680,6.082.321.429
21/09/2019 09:00,31.93,39370,554,149,234,1633,21,2591,6.082.321.429
21/09/2019 10:00,30.97,39037,558,161,246,1599,17,2581,6.082.321.429
21/09/2019 11:00,30.66,38526,533,174,252,1587,16,2562,6.082.321.429
21/09/2019 12:00,29.92,38085,503,185,251,1564,17,2520,6.082.321.429
21/09/2019 13:00,29.93,37676,423,188,248,1507,18,2384,6.082.321.429
21/09/2019 14:00,30.48,37497,319,193,240,1464,18,2234,6.082.321.429
21/09/2019 15:00,30.99,37814,233,191,226,1357,15,2022,6.082.321.429
21/09/2019 16:00,34.02,38513,180,183,215,1549,10,2137,6.082.321.429
21/09/2019 17:00,34.61,39010,189,170,198,1682,11,2250,6.082.321.429
21/09/2019 18:00,34.75,39106,174,146,180,1804,11,2315,6.082.321.429
21/09/2019 19:00,34.43,38529,179,114,165,1990,14,2462,6.082.321.429
21/09/2019 20:00,32.73,37535,198,85,156,2069,12,2520,6.082.321.429
21/09/2019 21:00,31.54,36283,216,62,147,2028,11,2464,6.082.321.429
21/09/2019 22:00,30.29,34788,224,50,136,2057,12,2479,6.082.321.429
21/09/2019 23:00,30.31,33445,234,63,137,1861,8,2303,6.082.321.429
22/09/2019 00:00,29.32,32638,281,72,132,1680,13,2178,6.082.321.429
22/09/2019 01:00,29.1,32281,289,83,127,1543,14,2056,6.082.321.429
22/09/2019 02:00,29.15,32139,292,93,134,1443,14,1976,6.082.321.429
22/09/2019 03:00,29.8,32177,316,104,143,1440,12,2015,6.082.321.429
22/09/2019 04:00,29.28,32486,356,124,145,1339,10,1974,6.082.321.429
22/09/2019 05:00,29.01,32906,388,150,141,1322,8,2009,6.082.321.429
22/09/2019 06:00,29.72,33835,411,174,140,1220,6,1951,6.082.321.429
22/09/2019 07:00,30.39,35406,444,193,138,1024,6,1805,6.082.321.429
22/09/2019 08:00,31.68,36875,497,205,140,864,6,1712,6.082.321.429
22/09/2019 09:00,31.66,37627,574,214,146,692,7,1633,6.082.321.429
22/09/2019 10:00,31.79,37824,622,222,147,597,8,1596,6.082.321.429
22/09/2019 11:00,31.39,37709,707,232,139,646,16,1740,6.082.321.429
22/09/2019 12:00,30.57,37446,789,239,127,767,16,1938,6.082.321.429
22/09/2019 13:00,30.49,37303,794,242,114,853,15,2018,6.082.321.429
22/09/2019 14:00,30.94,37217,858,243,99,971,14,2185,6.082.321.429
22/09/2019 15:00,31.98,37553,1030,238,94,1134,9,2505,6.082.321.429
22/09/2019 16:00,33.36,38447,1226,229,102,1254,8,2819,6.082.321.429
22/09/2019 17:00,34.71,39196,1463,222,125,1454,7,3271,6.082.321.429
22/09/2019 18:00,35.03,39647,1754,209,152,1772,7,3894,6.082.321.429
22/09/2019 19:00,34.4,39395,2046,196,160,1982,7,4391,6.082.321.429
22/09/2019 20:00,32.27,38458,2281,186,148,2179,9,4803,6.082.321.429
22/09/2019 21:00,31.79,36870,2552,175,130,2230,9,5096,6.082.321.429
22/09/2019 22:00,31.02,35102,2735,163,113,2232,11,5254,6.082.321.429
22/09/2019 23:00,28.54,33926,2872,94,117,2135,8,5226,6.082.321.429
23/09/2019 00:00,27.24,33226,3013,84,114,2056,8,5275,6.054.166.667
23/09/2019 01:00,27.43,33103,3170,76,110,1951,7,5314,6.054.166.667
23/09/2019 02:00,27.29,33273,3326,66,111,1914,6,5423,6.054.166.667
23/09/2019 03:00,27.55,33945,3305,55,112,1862,5,5339,6.054.166.667
23/09/2019 04:00,31.29,35930,3287,43,110,1933,5,5378,6.054.166.667
23/09/2019 05:00,34.93,39676,3244,34,101,1847,5,5231,6.054.166.667
23/09/2019 06:00,36.11,42933,3107,26,90,1807,5,5035,6.054.166.667
23/09/2019 07:00,36.55,44005,2967,20,73,1712,5,4777,6.054.166.667
23/09/2019 08:00,36.11,43986,2920,19,63,1719,4,4725,6.054.166.667
23/09/2019 09:00,36.14,43962,2987,25,64,1604,3,4683,6.054.166.667
23/09/2019 10:00,35.98,43806,2909,27,67,1542,4,4549,6.054.166.667
23/09/2019 11:00,35.8,43409,2809,30,65,1488,4,4396,6.054.166.667
23/09/2019 12:00,35.73,43071,2820,33,60,1437,4,4354,6.054.166.667
23/09/2019 13:00,35.28,42794,2640,30,55,1289,5,4019,6.054.166.667
23/09/2019 14:00,35.42,42526,2411,28,46,1183,4,3672,6.054.166.667
23/09/2019 15:00,35.57,42414,2301,29,43,1115,4,3492,6.054.166.667
23/09/2019 16:00,35.8,42900,2229,31,45,1035,4,3344,6.054.166.667
23/09/2019 17:00,36.07,42972,2056,35,61,1028,4,3184,6.054.166.667
23/09/2019 18:00,36.52,43243,1867,39,78,1104,4,3092,6.054.166.667
23/09/2019 19:00,36.09,42660,1853,42,94,1183,4,3176,6.054.166.667
23/09/2019 20:00,35.35,41293,1846,42,106,1190,4,3188,6.054.166.667
23/09/2019 21:00,34.85,39259,1896,41,111,1157,3,3208,6.054.166.667
23/09/2019 22:00,32.97,37093,1792,39,107,1105,4,3047,6.054.166.667
23/09/2019 23:00,33.78,35788,1052,29,107,1014,4,2206,6.054.166.667
24/09/2019 00:00,32.92,34902,910,23,100,913,4,1950,6.054.166.667
24/09/2019 01:00,32.4,34650,751,21,91,856,5,1724,6.054.166.667
24/09/2019 02:00,32.86,34775,643,22,82,833,6,1586,6.054.166.667
24/09/2019 03:00,33.42,35353,531,26,77,797,5,1436,6.054.166.667
24/09/2019 04:00,34.22,37259,491,33,69,749,5,1347,6.054.166.667
24/09/2019 05:00,35.85,40837,489,38,66,677,5,1275,6.054.166.667
24/09/2019 06:00,38.32,43964,471,43,58,646,6,1224,6.054.166.667
24/09/2019 07:00,39.04,44806,467,45,43,572,5,1132,6.054.166.667
24/09/2019 08:00,38.62,44645,525,47,29,533,5,1139,6.054.166.667
24/09/2019 09:00,37.83,44566,545,44,25,461,4,1079,6.054.166.667
24/09/2019 10:00,37.56,44250,535,41,24,446,4,1050,6.054.166.667
24/09/2019 11:00,36.54,43794,501,37,27,425,6,996,6.054.166.667
24/09/2019 12:00,36.53,43447,490,35,27,412,5,969,6.054.166.667
24/09/2019 13:00,35.75,43168,517,35,27,391,4,974,6.054.166.667
24/09/2019 14:00,35.75,42943,559,33,28,379,4,1003,6.054.166.667
24/09/2019 15:00,35.85,42812,543,29,32,359,4,967,6.054.166.667
24/09/2019 16:00,35.99,43091,518,27,50,382,4,981,6.054.166.667
24/09/2019 17:00,36.56,43159,527,29,90,421,4,1071,6.054.166.667
24/09/2019 18:00,37.15,43579,569,30,138,513,6,1256,6.054.166.667
24/09/2019 19:00,36.78,42988,696,28,172,597,8,1501,6.054.166.667
24/09/2019 20:00,35.62,41624,859,24,181,625,9,1698,6.054.166.667
24/09/2019 21:00,34.96,39648,1077,21,184,622,12,1916,6.054.166.667
24/09/2019 22:00,32.37,37256,1204,20,183,645,13,2065,6.054.166.667
24/09/2019 23:00,32.91,35538,1141,16,0,590,15,1762,6.054.166.667
25/09/2019 00:00,32.18,34616,1147,17,0,603,14,1781,6.054.166.667
25/09/2019 01:00,31.59,34313,1149,17,0,612,14,1792,6.054.166.667
25/09/2019 02:00,31.86,34386,1165,16,0,639,14,1834,6.054.166.667
25/09/2019 03:00,32.17,34977,1121,15,0,676,17,1829,6.054.166.667
25/09/2019 04:00,33.78,36901,1124,13,0,787,15,1939,6.054.166.667
25/09/2019 05:00,35.47,40550,1125,12,0,954,15,2106,6.054.166.667
25/09/2019 06:00,37.49,43615,1112,10,0,1055,15,2192,6.054.166.667
25/09/2019 07:00,38.88,44470,1092,9,0,1061,12,2174,6.054.166.667
25/09/2019 08:00,38.61,44497,1082,8,0,1074,7,2171,6.054.166.667
25/09/2019 09:00,38.02,44508,1115,7,0,1070,6,2198,6.054.166.667
25/09/2019 10:00,37.1,44172,1093,6,0,1081,6,2186,6.054.166.667
25/09/2019 11:00,36.39,43766,1039,6,0,1054,7,2106,6.054.166.667
25/09/2019 12:00,36.15,43587,1051,5,0,1071,6,2133,6.054.166.667
25/09/2019 13:00,35.46,43321,1004,5,0,1074,5,2088,6.054.166.667
25/09/2019 14:00,35.37,43128,1008,5,0,1109,4,2126,6.054.166.667
25/09/2019 15:00,35.64,43029,1027,4,0,1193,3,2227,6.054.166.667
25/09/2019 16:00,35.9,43366,1076,4,0,1286,3,2369,6.054.166.667
25/09/2019 17:00,35.95,43482,1068,4,0,1427,3,2502,6.054.166.667
25/09/2019 18:00,36.66,43806,1001,5,0,1551,5,2562,6.054.166.667
25/09/2019 19:00,35.52,43017,978,7,0,1764,7,2756,6.054.166.667
25/09/2019 20:00,34.57,41436,1033,10,0,1730,8,2781,6.054.166.667
25/09/2019 21:00,33.79,39363,1125,12,0,1649,10,2796,6.054.166.667
25/09/2019 22:00,32.9,36968,1181,15,0,1611,9,2816,6.054.166.667
25/09/2019 23:00,32.34,35254,1369,30,156,1608,14,3177,6.054.166.667
26/09/2019 00:00,32.02,34452,1379,32,151,1514,14,3090,6.054.166.667
26/09/2019 01:00,31.45,34216,1400,38,148,1487,13,3086,6.054.166.667
26/09/2019 02:00,31.24,34362,1489,38,153,1428,14,3122,6.054.166.667
26/09/2019 03:00,31.72,34944,1561,33,159,1411,14,3178,6.054.166.667
26/09/2019 04:00,33.14,36941,1620,29,162,1458,17,3286,6.054.166.667
26/09/2019 05:00,35.33,40687,1657,27,157,1324,19,3184,6.054.166.667
26/09/2019 06:00,37.48,43922,1692,25,152,1214,18,3101,6.054.166.667
26/09/2019 07:00,38.87,44898,1762,23,126,1009,18,2938,6.054.166.667
26/09/2019 08:00,38.19,44760,1916,21,87,933,9,2966,6.054.166.667
26/09/2019 09:00,37.03,44741,2143,20,66,863,6,3098,6.054.166.667
26/09/2019 10:00,36.96,44410,2220,18,59,778,7,3082,6.054.166.667
26/09/2019 11:00,36.13,43892,2234,17,55,741,7,3054,6.054.166.667
26/09/2019 12:00,35.86,43700,2366,15,47,730,7,3165,6.054.166.667
26/09/2019 13:00,35.44,43401,2365,12,45,693,7,3122,6.054.166.667
26/09/2019 14:00,35.39,43130,2272,10,46,673,6,3007,6.054.166.667
26/09/2019 15:00,35.67,43031,2288,8,49,701,5,3051,6.054.166.667
26/09/2019 16:00,36.16,43539,2381,9,66,758,5,3219,6.054.166.667
26/09/2019 17:00,36.47,43709,2588,11,89,881,8,3577,6.054.166.667
26/09/2019 18:00,36.95,44066,2700,14,116,1095,13,3938,6.054.166.667
26/09/2019 19:00,35.84,43229,2927,15,132,1282,17,4373,6.054.166.667
26/09/2019 20:00,34.22,41713,3081,16,138,1400,18,4653,6.054.166.667
26/09/2019 21:00,32.35,39604,3175,15,140,1450,14,4794,6.054.166.667
26/09/2019 22:00,30.8,37255,2994,15,129,1482,12,4632,6.054.166.667
26/09/2019 23:00,30.7,35802,2803,25,111,1515,8,4462,6.054.166.667
27/09/2019 00:00,29.97,34893,2439,21,97,1591,8,4156,6.054.166.667
27/09/2019 01:00,30.08,34548,2160,17,81,1559,7,3824,6.054.166.667
27/09/2019 02:00,30.98,34560,1927,16,68,1540,6,3557,6.054.166.667
27/09/2019 03:00,31.43,35055,1690,14,63,1640,6,3413,6.054.166.667
27/09/2019 04:00,32.84,37017,1544,11,60,1773,6,3394,6.054.166.667
27/09/2019 05:00,34.9,40665,1431,8,61,1858,6,3364,6.054.166.667
27/09/2019 06:00,36.5,43764,1278,6,63,1896,6,3249,6.054.166.667
27/09/2019 07:00,37.32,44773,1170,5,49,1898,5,3127,6.054.166.667
27/09/2019 08:00,36.97,44837,1095,3,33,1894,3,3028,6.054.166.667
27/09/2019 09:00,36.25,44715,1138,2,25,1908,3,3076,6.054.166.667
27/09/2019 10:00,35.68,44144,1180,3,27,1969,2,3181,6.054.166.667
27/09/2019 11:00,35.82,43489,1183,4,35,1968,2,3192,6.054.166.667
27/09/2019 12:00,35.01,42862,1182,6,47,1920,3,3158,6.054.166.667
27/09/2019 13:00,33.88,42290,1140,6,62,1927,3,3138,6.054.166.667
27/09/2019 14:00,33.78,41770,1036,6,67,1808,3,2920,6.054.166.667
27/09/2019 15:00,34.18,41731,976,6,73,1783,2,2840,6.054.166.667
27/09/2019 16:00,34.67,42029,943,6,93,1760,2,2804,6.054.166.667
27/09/2019 17:00,34.46,42176,942,8,132,1881,3,2966,6.054.166.667
27/09/2019 18:00,34.69,42216,1028,8,175,2066,5,3282,6.054.166.667
27/09/2019 19:00,34.17,40989,1091,7,209,2189,9,3505,6.054.166.667
27/09/2019 20:00,33.83,39613,1118,6,224,2048,11,3407,6.054.166.667
27/09/2019 21:00,32.99,37933,1195,7,238,1954,15,3409,6.054.166.667
27/09/2019 22:00,31,35968,1385,8,247,1864,14,3518,6.054.166.667
27/09/2019 23:00,31.7,34820,1694,39,224,1820,14,3791,6.054.166.667
28/09/2019 00:00,30.99,33889,1847,37,235,1699,16,3834,6.054.166.667
28/09/2019 01:00,29.69,33493,2012,36,240,1619,16,3923,6.054.166.667
28/09/2019 02:00,28.5,33363,2217,41,245,1685,16,4204,6.054.166.667
28/09/2019 03:00,28.65,33363,2447,46,254,1553,16,4316,6.054.166.667
28/09/2019 04:00,29.64,33856,2660,50,246,1554,21,4531,6.054.166.667
28/09/2019 05:00,29.88,34604,2733,56,229,1584,25,4627,6.054.166.667
28/09/2019 06:00,30.55,35742,2752,64,211,1764,25,4816,6.054.166.667
28/09/2019 07:00,32.47,37439,2709,72,191,1561,26,4559,6.054.166.667
28/09/2019 08:00,33.41,38773,2658,75,161,1641,24,4559,6.054.166.667
28/09/2019 09:00,32.61,39417,2816,81,146,1764,22,4829,6.054.166.667
28/09/2019 10:00,32.13,39413,2909,92,137,1630,24,4792,6.054.166.667
28/09/2019 11:00,31.54,39126,2887,106,135,1562,26,4716,6.054.166.667
28/09/2019 12:00,31.39,38831,2986,116,142,1543,26,4813,6.054.166.667
28/09/2019 13:00,31.19,38568,2870,127,151,1630,23,4801,6.054.166.667
28/09/2019 14:00,31.03,38520,2666,143,147,1615,28,4599,6.054.166.667
28/09/2019 15:00,31.34,38821,2439,156,138,1536,31,4300,6.054.166.667
28/09/2019 16:00,32.53,39594,2337,160,133,1462,26,4118,6.054.166.667
28/09/2019 17:00,34.01,40115,2427,162,131,1592,24,4336,6.054.166.667
28/09/2019 18:00,34.34,40050,2466,165,131,1738,20,4520,6.054.166.667
28/09/2019 19:00,33.13,39055,2572,166,135,1912,21,4806,6.054.166.667
28/09/2019 20:00,31.06,37889,2717,162,144,1990,25,5038,6.054.166.667
28/09/2019 21:00,30.02,36699,2849,152,150,2002,25,5178,6.054.166.667
28/09/2019 22:00,29.89,35209,2974,139,154,2040,25,5332,6.054.166.667
28/09/2019 23:00,29.52,33590,3374,126,123,1967,10,5600,6.054.166.667
29/09/2019 00:00,29.27,32796,3240,129,115,1793,11,5288,6.054.166.667
29/09/2019 01:00,27.74,32465,3177,124,105,1673,11,5090,6.054.166.667
29/09/2019 02:00,27.19,32367,3088,117,103,1630,9,4947,6.054.166.667
29/09/2019 03:00,27.34,32426,2972,112,106,1650,8,4848,6.054.166.667
29/09/2019 04:00,27.74,32736,2899,107,117,1607,8,4738,6.054.166.667
29/09/2019 05:00,28.25,33190,2579,107,138,1505,6,4335,6.054.166.667
29/09/2019 06:00,28.98,34073,2288,107,163,1450,6,4014,6.054.166.667
29/09/2019 07:00,30.63,35562,1972,107,189,1403,6,3677,6.054.166.667
29/09/2019 08:00,31.61,37067,1705,107,216,1366,7,3401,6.054.166.667
29/09/2019 09:00,32.39,37892,1480,102,245,1310,5,3142,6.054.166.667
29/09/2019 10:00,32.15,38161,1375,96,259,1293,17,3040,6.054.166.667
29/09/2019 11:00,31.99,38152,1254,92,267,1273,12,2898,6.054.166.667
29/09/2019 12:00,31.9,37838,1169,88,278,1223,18,2776,6.054.166.667
29/09/2019 13:00,31.88,37685,955,83,286,1194,23,2541,6.054.166.667
29/09/2019 14:00,31.73,37585,865,81,293,1169,27,2435,6.054.166.667
29/09/2019 15:00,32.02,37897,916,78,297,1201,25,2517,6.054.166.667
29/09/2019 16:00,32.61,38895,890,72,293,1159,18,2432,6.054.166.667
29/09/2019 17:00,33.97,39830,892,69,287,1208,23,2479,6.054.166.667
29/09/2019 18:00,34.91,40247,897,68,282,1323,19,2589,6.054.166.667
29/09/2019 19:00,34,39485,930,66,285,1379,13,2673,6.054.166.667
29/09/2019 20:00,33.02,38517,965,59,284,1424,15,2747,6.054.166.667
29/09/2019 21:00,31.74,37009,967,49,271,1411,14,2712,6.054.166.667
29/09/2019 22:00,29.04,35244,1047,38,244,1417,9,2755,6.054.166.667
29/09/2019 23:00,28.76,34061,962,14,211,1437,8,2632,6.054.166.667
30/09/2019 00:00,27.32,33354,1121,15,185,1342,8,2671,599.625
30/09/2019 01:00,26.83,33174,1251,16,168,1190,8,2633,599.625
30/09/2019 02:00,27.13,33357,1360,14,160,1296,6,2836,599.625
30/09/2019 03:00,27.9,34035,1541,13,153,1290,4,3001,599.625
30/09/2019 04:00,31.03,36203,1856,12,145,1326,5,3344,599.625
30/09/2019 05:00,33.41,40006,2236,9,141,1379,6,3771,599.625
30/09/2019 06:00,34.94,43270,2717,6,136,1211,5,4075,599.625
30/09/2019 07:00,36.72,44288,3078,5,131,1121,4,4339,599.625
30/09/2019 08:00,34.79,44350,3461,5,128,1062,4,4660,599.625
30/09/2019 09:00,34.68,44429,4128,3,127,1059,3,5320,599.625
30/09/2019 10:00,34.39,44388,4446,3,122,1075,3,5649,599.625
30/09/2019 11:00,34.12,44089,4418,3,114,1327,3,5865,599.625
30/09/2019 12:00,34.03,43769,4666,4,106,1428,3,6207,599.625
30/09/2019 13:00,33.46,43503,4637,4,102,1696,3,6442,599.625
30/09/2019 14:00,33.36,43171,4486,5,102,1971,3,6567,599.625
30/09/2019 15:00,33.71,43086,4530,5,113,2211,4,6863,599.625
30/09/2019 16:00,34.74,43606,4626,8,151,2421,4,7210,599.625
30/09/2019 17:00,35.3,43942,4501,12,221,2673,6,7413,599.625
30/09/2019 18:00,35.7,44238,4230,18,291,2748,8,7295,599.625
30/09/2019 19:00,34.75,43268,3931,26,328,2741,8,7034,599.625
30/09/2019 20:00,34.04,41847,3659,33,345,2856,19,6912,599.625
30/09/2019 21:00,33.29,39823,3371,39,365,2907,18,6700,599.625
30/09/2019 22:00,32.15,37626,3020,40,393,3087,21,6561,599.625
30/09/2019 23:00,32.04,36650,3169,68,432,3423,42,7134,599.625
01/10/2019 00:00,31.21,35794,2862,59,444,3658,42,7065,599.625
01/10/2019 01:00,29.93,35564,2577,52,456,3883,43,7011,599.625
01/10/2019 02:00,30.07,35706,2203,49,447,4120,41,6860,599.625
01/10/2019 03:00,30.65,36298,1876,44,428,4476,37,6861,599.625
01/10/2019 04:00,33.01,38280,1608,40,403,4595,32,6678,599.625
01/10/2019 05:00,34.46,41984,1317,37,372,4746,35,6507,599.625
01/10/2019 06:00,35.58,45133,1105,36,343,4678,41,6203,599.625
01/10/2019 07:00,35.73,45964,953,34,340,4472,41,5840,599.625
01/10/2019 08:00,35.54,45919,901,32,372,4352,41,5698,599.625
01/10/2019 09:00,35.38,45906,947,30,401,4417,42,5837,599.625
01/10/2019 10:00,35.18,45569,958,27,417,4283,41,5726,599.625
01/10/2019 11:00,34.99,45123,905,22,421,4209,42,5599,599.625
01/10/2019 12:00,34.83,44811,981,16,416,4173,42,5628,599.625
01/10/2019 13:00,34.89,44602,1044,13,381,4147,42,5627,599.625
01/10/2019 14:00,34.85,44443,1158,12,322,4105,42,5639,599.625
01/10/2019 15:00,34.78,44427,1373,11,266,4290,40,5980,599.625
01/10/2019 16:00,34.93,44851,1569,11,210,4278,37,6105,599.625
01/10/2019 17:00,35.19,45194,1662,12,181,4284,35,6174,599.625
01/10/2019 18:00,35.5,45653,1751,13,151,4312,31,6258,599.625
01/10/2019 19:00,34.95,44765,1844,15,129,4334,30,6352,599.625
01/10/2019 20:00,34.08,43395,1997,19,114,4327,26,6483,599.625
01/10/2019 21:00,33.42,41459,2151,23,101,4331,21,6627,599.625
01/10/2019 22:00,32.51,39092,2183,31,94,4245,16,6569,599.625
01/10/2019 23:00,32.73,36660,2480,49,130,4241,6,6906,599.625
02/10/2019 00:00,32.03,35799,2481,66,124,4144,7,6822,599.625
02/10/2019 01:00,30.89,35540,2535,93,116,4120,9,6873,599.625
02/10/2019 02:00,31.18,35704,2577,123,107,4066,14,6887,599.625
02/10/2019 03:00,32.09,36342,2607,151,109,4079,18,6964,599.625
02/10/2019 04:00,33.54,38251,2616,172,110,4108,19,7025,599.625
02/10/2019 05:00,35.09,42008,2674,197,103,4066,22,7062,599.625
02/10/2019 06:00,36.89,45179,2692,224,97,4056,25,7094,599.625
02/10/2019 07:00,37.29,46043,2577,239,86,3805,31,6738,599.625
02/10/2019 08:00,37.15,46041,2577,247,77,3664,36,6601,599.625
02/10/2019 09:00,36.79,45941,2782,256,74,3506,37,6655,599.625
02/10/2019 10:00,36.41,45561,2884,260,68,3604,37,6853,599.625
02/10/2019 11:00,36.12,45196,2747,259,62,3515,35,6618,599.625
02/10/2019 12:00,35.44,45030,2774,256,50,3217,32,6329,599.625
02/10/2019 13:00,35.15,44658,2709,256,44,3170,29,6208,599.625
02/10/2019 14:00,34.93,44529,2593,255,40,3082,23,5993,599.625
02/10/2019 15:00,35.32,44475,2595,250,35,2855,16,5751,599.625
02/10/2019 16:00,36.32,45030,2677,246,36,2793,10,5762,599.625
02/10/2019 17:00,36.72,45437,2738,241,40,2930,7,5956,599.625
02/10/2019 18:00,37.28,45810,2695,240,41,2840,5,5821,599.625
02/10/2019 19:00,36.22,44645,2595,238,42,2962,5,5842,599.625
02/10/2019 20:00,35.48,43128,2532,232,39,2873,4,5680,599.625
02/10/2019 21:00,34.23,41004,2415,224,39,2830,3,5511,599.625
02/10/2019 22:00,32.91,38506,2200,211,38,2814,3,5266,599.625
02/10/2019 23:00,33.35,37021,2161,178,30,2666,3,5038,599.625
03/10/2019 00:00,32.29,36160,1953,179,27,2620,3,4782,599.625
03/10/2019 01:00,30.79,35906,1793,180,25,2557,3,4558,599.625
03/10/2019 02:00,30.79,36049,1652,177,25,2661,2,4517,599.625
03/10/2019 03:00,32.95,36646,1621,173,28,2701,2,4525,599.625
03/10/2019 04:00,34.16,38644,1541,171,29,2625,1,4367,599.625
03/10/2019 05:00,35.95,42391,1395,165,28,2639,1,4228,599.625
03/10/2019 06:00,37.12,45491,1210,156,30,2570,1,3967,599.625
03/10/2019 07:00,38.72,46375,1023,146,29,2480,1,3679,599.625
03/10/2019 08:00,38.58,46376,810,137,29,2322,1,3299,599.625
03/10/2019 09:00,38.17,46493,727,131,33,2360,1,3252,599.625
03/10/2019 10:00,38.24,46339,636,117,40,2214,1,3008,599.625
03/10/2019 11:00,37.83,45874,521,98,49,2091,2,2761,599.625
03/10/2019 12:00,37.48,45657,504,82,62,1972,2,2622,599.625
03/10/2019 13:00,37.14,45436,463,64,73,1982,2,2584,599.625
03/10/2019 14:00,37.15,45193,412,43,77,1997,1,2530,599.625
03/10/2019 15:00,37.13,45128,395,26,71,1911,3,2406,599.625
03/10/2019 16:00,37.23,45633,350,18,74,1890,3,2335,599.625
03/10/2019 17:00,37.82,45947,351,14,79,2044,2,2490,599.625
03/10/2019 18:00,38.33,46196,360,12,84,2065,3,2524,599.625
03/10/2019 19:00,37.12,45008,387,12,90,2225,6,2720,599.625
03/10/2019 20:00,35.98,43612,445,13,96,2290,8,2852,599.625
03/10/2019 21:00,35.65,41613,515,14,107,2247,5,2888,599.625
03/10/2019 22:00,34.76,39352,587,16,109,2079,6,2797,599.625
03/10/2019 23:00,36,38544,501,55,129,2068,2,2755,599.625
04/10/2019 00:00,34.66,37703,647,55,126,2061,2,2891,599.625
04/10/2019 01:00,34.03,37406,802,57,117,1916,2,2894,599.625
04/10/2019 02:00,33.65,37524,941,61,104,1875,2,2983,599.625
04/10/2019 03:00,34.41,38130,980,65,95,1873,2,3015,599.625
04/10/2019 04:00,35.45,40265,1049,66,80,1906,2,3103,599.625
04/10/2019 05:00,37.34,44170,1177,64,67,1980,3,3291,599.625
04/10/2019 06:00,38.78,47457,1315,57,54,1987,2,3415,599.625
04/10/2019 07:00,40.47,48451,1414,47,48,1775,3,3287,599.625
04/10/2019 08:00,40.38,48486,1516,40,43,1594,3,3196,599.625
04/10/2019 09:00,40.3,48340,1748,39,42,1523,2,3354,599.625
04/10/2019 10:00,40.05,47889,1917,41,42,1477,3,3480,599.625
04/10/2019 11:00,39.44,47316,1888,47,41,1399,3,3378,599.625
04/10/2019 12:00,39.01,46648,2044,52,43,1299,4,3442,599.625
04/10/2019 13:00,38.06,46121,2057,61,45,1348,5,3516,599.625
04/10/2019 14:00,37.64,45731,1955,76,51,1345,5,3432,599.625
04/10/2019 15:00,37.51,45749,1989,92,54,1316,9,3460,599.625
04/10/2019 16:00,37.81,46229,2080,102,66,1361,9,3618,599.625
04/10/2019 17:00,38.55,46707,2251,106,75,1518,8,3958,599.625
04/10/2019 18:00,38.6,46606,2417,109,88,1758,8,4380,599.625
04/10/2019 19:00,37.23,45107,2520,108,99,1987,10,4724,599.625
04/10/2019 20:00,36.33,43729,2570,110,101,2136,11,4928,599.625
04/10/2019 21:00,35.64,42074,2519,111,101,2199,8,4938,599.625
04/10/2019 22:00,34.23,40209,2408,110,98,2098,8,4722,599.625
04/10/2019 23:00,34.83,38981,2677,50,85,2062,5,4879,599.625
05/10/2019 00:00,34.31,37986,2607,48,88,2129,6,4878,599.625
05/10/2019 01:00,33.2,37597,2570,48,87,2130,5,4840,599.625
05/10/2019 02:00,32.33,37579,2558,48,89,2157,3,4855,599.625
05/10/2019 03:00,32.2,37737,2556,50,98,2236,2,4942,599.625
05/10/2019 04:00,32.91,38394,2569,52,101,2266,3,4991,599.625
05/10/2019 05:00,33.91,39304,2509,54,99,2278,3,4943,599.625
05/10/2019 06:00,34.49,40578,2407,52,99,2221,4,4783,599.625
05/10/2019 07:00,35.74,42293,2244,45,89,1973,5,4356,599.625
05/10/2019 08:00,36.88,43743,2102,37,73,1655,4,3871,599.625
05/10/2019 09:00,37.56,44295,2062,34,66,1409,2,3573,599.625
05/10/2019 10:00,37.88,44021,1916,37,64,1247,4,3268,599.625
05/10/2019 11:00,37.25,43512,1626,43,65,1129,4,2867,599.625
05/10/2019 12:00,36.57,43055,1452,49,69,1067,4,2641,599.625
05/10/2019 13:00,35.96,42729,1238,53,74,957,4,2326,599.625
05/10/2019 14:00,36.36,42713,978,58,81,971,4,2092,599.625
05/10/2019 15:00,37.43,43180,850,64,89,950,5,1958,599.625
05/10/2019 16:00,38.7,44202,754,74,95,1031,5,1959,599.625
05/10/2019 17:00,39.49,45057,718,81,107,1212,5,2123,599.625
05/10/2019 18:00,40.34,45061,717,85,119,1433,6,2360,599.625
05/10/2019 19:00,38.11,43797,728,83,125,1785,7,2728,599.625
05/10/2019 20:00,37.63,42753,765,83,118,1858,5,2829,599.625
05/10/2019 21:00,37.09,41459,769,83,114,1716,4,2686,599.625
05/10/2019 22:00,35.9,39969,749,80,104,1772,2,2707,599.625
05/10/2019 23:00,35.35,39328,886,80,72,1728,3,2769,599.625
06/10/2019 00:00,34.63,38468,841,75,63,1690,2,2671,599.625
06/10/2019 01:00,34,38121,844,70,55,1646,3,2618,599.625
06/10/2019 02:00,33.57,38105,887,66,45,1623,2,2623,599.625
06/10/2019 03:00,33.6,38243,882,71,43,1615,3,2614,599.625
06/10/2019 04:00,33.85,38660,891,71,41,1601,3,2607,599.625
06/10/2019 05:00,34.02,39231,906,71,38,1601,3,2619,599.625
06/10/2019 06:00,34.21,40158,923,67,32,1602,2,2626,599.625
06/10/2019 07:00,35,41732,970,63,24,1380,4,2441,599.625
06/10/2019 08:00,35.81,43200,1026,57,18,1099,3,2203,599.625
06/10/2019 09:00,36.53,43813,1099,51,15,854,2,2021,599.625
06/10/2019 10:00,36.61,43747,1157,48,15,700,3,1923,599.625
06/10/2019 11:00,36.18,43427,1088,47,18,630,3,1786,599.625
06/10/2019 12:00,35.72,43132,1020,46,20,660,3,1749,599.625
06/10/2019 13:00,35.42,42910,973,43,24,697,3,1740,599.625
06/10/2019 14:00,35.44,42905,877,39,28,705,3,1652,599.625
06/10/2019 15:00,35.73,43425,869,35,29,805,2,1740,599.625
06/10/2019 16:00,36.58,44694,903,35,31,1027,2,1998,599.625
06/10/2019 17:00,37.87,45910,989,38,33,1390,2,2452,599.625
06/10/2019 18:00,39.48,46437,1116,42,35,1746,1,2940,599.625
06/10/2019 19:00,37.24,45508,1142,46,38,2122,1,3349,599.625
06/10/2019 20:00,36.15,44518,1080,46,28,2380,2,3536,599.625
06/10/2019 21:00,35.34,42911,927,47,20,2379,2,3375,599.625
06/10/2019 22:00,34.36,41000,803,47,13,2355,2,3220,599.625
06/10/2019 23:00,33.39,39565,825,112,14,2457,1,3409,599.625
07/10/2019 00:00,33.27,38800,736,109,13,2421,2,3281,5.954.107.143
07/10/2019 01:00,33.21,38630,644,104,13,2440,2,3203,5.954.107.143
07/10/2019 02:00,33.33,38825,549,101,14,2459,4,3127,5.954.107.143
07/10/2019 03:00,34.18,39669,464,101,15,2478,3,3061,5.954.107.143
07/10/2019 04:00,36.36,42026,404,100,14,2334,3,2855,5.954.107.143
07/10/2019 05:00,39.36,46007,347,96,15,2195,2,2655,5.954.107.143
07/10/2019 06:00,47.6,49340,305,90,16,2030,3,2444,5.954.107.143
07/10/2019 07:00,55.43,50205,268,83,17,1688,5,2061,5.954.107.143
07/10/2019 08:00,56.53,50095,249,76,18,1188,3,1534,5.954.107.143
07/10/2019 09:00,59.64,49998,229,68,20,799,4,1120,5.954.107.143
07/10/2019 10:00,55.47,49582,216,61,26,599,2,904,5.954.107.143
07/10/2019 11:00,49.73,49020,202,56,36,498,2,794,5.954.107.143
07/10/2019 12:00,47.72,48532,202,54,46,452,2,756,5.954.107.143
07/10/2019 13:00,46.4,48209,232,56,54,392,2,736,5.954.107.143
07/10/2019 14:00,46.47,47957,278,58,60,361,2,759,5.954.107.143
07/10/2019 15:00,46.63,47927,332,63,64,345,2,806,5.954.107.143
07/10/2019 16:00,47.52,48600,372,68,64,392,2,898,5.954.107.143
07/10/2019 17:00,47.67,49153,491,70,56,451,1,1069,5.954.107.143
07/10/2019 18:00,51.66,49419,680,70,55,506,1,1312,5.954.107.143
07/10/2019 19:00,44.3,48205,915,71,57,469,1,1513,5.954.107.143
07/10/2019 20:00,39.22,46837,1212,67,57,459,2,1797,5.954.107.143
07/10/2019 21:00,37.62,44696,1436,63,58,417,3,1977,5.954.107.143
07/10/2019 22:00,35.74,42385,1643,58,54,465,4,2224,5.954.107.143
07/10/2019 23:00,35.63,40424,1988,9,94,591,1,2683,5.954.107.143
08/10/2019 00:00,34.81,39482,2165,7,101,655,1,2929,5.954.107.143
08/10/2019 01:00,34,39181,2366,6,98,788,2,3260,5.954.107.143
08/10/2019 02:00,33.88,39339,2607,4,97,904,2,3614,5.954.107.143
08/10/2019 03:00,34.13,40106,2846,3,95,1028,2,3974,5.954.107.143
08/10/2019 04:00,35.55,42137,3095,2,101,1158,2,4358,5.954.107.143
08/10/2019 05:00,37.59,45980,3164,3,105,1220,3,4495,5.954.107.143
08/10/2019 06:00,40.62,49078,3008,3,111,1360,4,4486,5.954.107.143
08/10/2019 07:00,46.7,49929,2660,3,115,1433,4,4215,5.954.107.143
08/10/2019 08:00,46.36,49757,2397,2,121,1402,5,3927,5.954.107.143
08/10/2019 09:00,44.52,49708,2341,1,133,1396,4,3875,5.954.107.143
08/10/2019 10:00,41.5,49358,2332,1,147,1389,3,3872,5.954.107.143
08/10/2019 11:00,39.63,48962,2289,2,161,1454,3,3909,5.954.107.143
08/10/2019 12:00,38.88,48697,2305,2,165,1505,4,3981,5.954.107.143
08/10/2019 13:00,37.79,48429,2241,2,166,1597,4,4010,5.954.107.143
08/10/2019 14:00,37.93,48211,2182,3,180,1497,5,3867,5.954.107.143
08/10/2019 15:00,39.96,48209,2180,4,197,1407,6,3794,5.954.107.143
08/10/2019 16:00,43.25,48630,2196,4,222,1430,6,3858,5.954.107.143
08/10/2019 17:00,45.89,49028,2000,5,248,1434,5,3692,5.954.107.143
08/10/2019 18:00,46.02,49209,2046,5,278,1540,11,3880,5.954.107.143
08/10/2019 19:00,39.37,47940,2096,4,289,1643,12,4044,5.954.107.143
08/10/2019 20:00,36.33,46389,2118,4,285,1579,17,4003,5.954.107.143
08/10/2019 21:00,35.02,44326,2037,4,272,1521,17,3851,5.954.107.143
08/10/2019 22:00,33.55,41932,2018,4,260,1456,17,3755,5.954.107.143
08/10/2019 23:00,34.13,39725,1897,12,199,1344,11,3463,5.954.107.143
09/10/2019 00:00,34.01,38828,1952,15,203,1215,10,3395,5.954.107.143
09/10/2019 01:00,33.85,38455,2064,15,219,1186,10,3494,5.954.107.143
09/10/2019 02:00,33.85,38496,2099,17,240,1201,6,3563,5.954.107.143
09/10/2019 03:00,34,39041,2123,19,250,1187,9,3588,5.954.107.143
09/10/2019 04:00,35.41,41060,2119,18,250,1211,12,3610,5.954.107.143
09/10/2019 05:00,37.95,44986,2184,17,247,1201,9,3658,5.954.107.143
09/10/2019 06:00,41.76,48279,2230,14,245,1196,7,3692,5.954.107.143
09/10/2019 07:00,46.99,48983,2300,12,240,1082,6,3640,5.954.107.143
09/10/2019 08:00,47.96,48969,2380,13,232,1003,6,3634,5.954.107.143
09/10/2019 09:00,45.92,48991,2510,16,237,1036,7,3806,5.954.107.143
09/10/2019 10:00,44.7,48681,2529,18,245,977,7,3776,5.954.107.143
09/10/2019 11:00,39.92,48262,2436,21,254,895,7,3613,5.954.107.143
09/10/2019 12:00,38.42,48084,2378,24,264,915,6,3587,5.954.107.143
09/10/2019 13:00,37.83,47817,2253,26,260,861,4,3404,5.954.107.143
09/10/2019 14:00,37.27,47684,2151,23,235,908,7,3324,5.954.107.143
09/10/2019 15:00,37.49,47699,2116,20,212,903,5,3256,5.954.107.143
09/10/2019 16:00,39.13,48207,1911,18,191,1015,4,3139,5.954.107.143
09/10/2019 17:00,45.16,48616,1858,19,170,1125,7,3179,5.954.107.143
09/10/2019 18:00,46.31,48598,1801,22,154,1226,6,3209,5.954.107.143
09/10/2019 19:00,39.09,47126,1685,26,147,1275,4,3137,5.954.107.143
09/10/2019 20:00,37.06,45579,1641,29,140,1207,4,3021,5.954.107.143
09/10/2019 21:00,35.76,43429,1566,33,138,1100,3,2840,5.954.107.143
09/10/2019 22:00,34,40986,1546,40,124,1049,3,2762,5.954.107.143
09/10/2019 23:00,33.45,38650,1248,38,120,936,3,2345,5.954.107.143
10/10/2019 00:00,33.1,37711,1300,36,101,886,2,2325,5.954.107.143
10/10/2019 01:00,32.95,37367,1378,33,79,802,2,2294,5.954.107.143
10/10/2019 02:00,32.94,37464,1434,30,70,718,1,2253,5.954.107.143
10/10/2019 03:00,33.36,38095,1517,28,64,676,2,2287,5.954.107.143
10/10/2019 04:00,34.93,40209,1627,26,59,673,3,2388,5.954.107.143
10/10/2019 05:00,36.52,44103,1636,24,58,683,3,2404,5.954.107.143
10/10/2019 06:00,39.03,47389,1625,24,55,689,3,2396,5.954.107.143
10/10/2019 07:00,45.3,48380,1656,22,55,658,3,2394,5.954.107.143
10/10/2019 08:00,43.16,48209,1731,20,54,605,3,2413,5.954.107.143
10/10/2019 09:00,39.13,48224,1910,17,62,624,2,2615,5.954.107.143
10/10/2019 10:00,37.71,47963,2098,15,75,678,1,2867,5.954.107.143
10/10/2019 11:00,36.53,47467,2276,12,91,795,1,3175,5.954.107.143
10/10/2019 12:00,36.1,47167,2561,11,115,805,1,3493,5.954.107.143
10/10/2019 13:00,35.63,46904,2755,10,141,889,3,3798,5.954.107.143
10/10/2019 14:00,35.38,46802,2808,10,147,940,2,3907,5.954.107.143
10/10/2019 15:00,35.68,46807,3043,11,155,1048,2,4259,5.954.107.143
10/10/2019 16:00,36.52,47539,3147,12,161,1193,3,4516,5.954.107.143
10/10/2019 17:00,37.75,48145,3244,15,161,1381,4,4805,5.954.107.143
10/10/2019 18:00,38.89,48144,3151,17,158,1597,5,4928,5.954.107.143
10/10/2019 19:00,36.62,46820,3054,19,155,1757,7,4992,5.954.107.143
10/10/2019 20:00,35.28,45156,2943,21,169,1875,6,5014,5.954.107.143
10/10/2019 21:00,34.06,42906,2844,20,186,1979,6,5035,5.954.107.143
10/10/2019 22:00,32.57,40532,2800,18,198,2094,6,5116,5.954.107.143
10/10/2019 23:00,32.29,38045,2764,25,213,2208,12,5222,5.954.107.143
11/10/2019 00:00,31.95,37163,2631,23,219,2256,11,5140,5.954.107.143
11/10/2019 01:00,31.22,36810,2732,22,224,2320,13,5311,5.954.107.143
11/10/2019 02:00,31.25,36813,2935,20,225,2268,14,5462,5.954.107.143
11/10/2019 03:00,32.17,37451,3158,15,227,2145,18,5563,5.954.107.143
11/10/2019 04:00,33.3,39576,3349,12,240,2091,15,5707,5.954.107.143
11/10/2019 05:00,34.57,43532,3395,11,254,2066,20,5746,5.954.107.143
11/10/2019 06:00,36.39,46938,3338,9,271,1991,19,5628,5.954.107.143
11/10/2019 07:00,38.08,47919,3265,8,286,1945,24,5528,5.954.107.143
11/10/2019 08:00,37.14,48012,3357,6,295,1939,27,5624,5.954.107.143
11/10/2019 09:00,35.96,47934,3660,3,319,1931,34,5947,5.954.107.143
11/10/2019 10:00,35.69,47314,3666,3,339,1941,35,5984,5.954.107.143
11/10/2019 11:00,35.21,46644,3518,3,342,1941,34,5838,5.954.107.143
11/10/2019 12:00,34.79,45903,3687,3,328,2018,34,6070,5.954.107.143
11/10/2019 13:00,34.48,45254,3739,2,328,2054,36,6159,5.954.107.143
11/10/2019 14:00,34.27,44870,3488,2,334,2055,33,5912,5.954.107.143
11/10/2019 15:00,34.27,44879,3396,3,349,2098,42,5888,5.954.107.143
11/10/2019 16:00,34.6,45481,3331,5,368,2195,43,5942,5.954.107.143
11/10/2019 17:00,35.12,46032,3199,6,380,2111,44,5740,5.954.107.143
11/10/2019 18:00,35.36,45568,2870,8,388,2190,44,5500,5.954.107.143
11/10/2019 19:00,34.36,43743,2795,11,391,2287,42,5526,5.954.107.143
11/10/2019 20:00,33.38,42185,2957,13,386,2210,43,5609,5.954.107.143
11/10/2019 21:00,32.7,40417,3164,16,374,2225,43,5822,5.954.107.143
11/10/2019 22:00,30.74,38541,3199,20,365,2174,42,5800,5.954.107.143
11/10/2019 23:00,32.6,37022,3211,39,0,2160,41,5451,5.954.107.143
12/10/2019 00:00,32.43,36019,3171,34,0,2154,42,5401,5.954.107.143
12/10/2019 01:00,30.99,35604,3144,33,0,2245,43,5465,5.954.107.143
12/10/2019 02:00,31.3,35499,3095,34,0,2263,43,5435,5.954.107.143
12/10/2019 03:00,32.13,35605,3023,34,0,2299,44,5400,5.954.107.143
12/10/2019 04:00,32.55,36216,3066,34,0,2291,44,5435,5.954.107.143
12/10/2019 05:00,32.85,37198,3138,34,0,2305,35,5512,5.954.107.143
12/10/2019 06:00,33.2,38457,3118,34,0,2340,39,5531,5.954.107.143
12/10/2019 07:00,33.63,39928,3145,31,0,2352,35,5563,5.954.107.143
12/10/2019 08:00,34.54,41358,3257,29,0,2351,37,5674,5.954.107.143
12/10/2019 09:00,35.06,42037,3513,27,0,2438,35,6013,5.954.107.143
12/10/2019 10:00,34.77,41927,3588,23,0,2532,30,6173,5.954.107.143
12/10/2019 11:00,34.26,41570,3541,20,0,2537,32,6130,5.954.107.143
12/10/2019 12:00,33.95,41183,3639,17,0,2595,28,6279,5.954.107.143
12/10/2019 13:00,33.61,40874,3612,18,0,2620,24,6274,5.954.107.143
12/10/2019 14:00,33.51,40844,3368,21,0,2681,27,6097,5.954.107.143
12/10/2019 15:00,33.72,41261,3277,25,0,2710,27,6039,5.954.107.143
12/10/2019 16:00,35.34,42331,3178,29,0,2710,30,5947,5.954.107.143
12/10/2019 17:00,36.99,43189,2913,34,0,2763,30,5740,5.954.107.143
12/10/2019 18:00,37.27,42881,2574,37,0,2810,31,5452,5.954.107.143
12/10/2019 19:00,36.04,41495,2287,38,0,2807,34,5166,5.954.107.143
12/10/2019 20:00,34.67,40323,2072,34,0,2744,33,4883,5.954.107.143
12/10/2019 21:00,33.63,39007,1797,28,0,2659,31,4515,5.954.107.143
12/10/2019 22:00,32.61,37404,1539,24,0,2586,31,4180,5.954.107.143
12/10/2019 23:00,33.4,36329,1544,22,295,2597,33,4491,5.954.107.143
13/10/2019 00:00,33.38,35396,1266,20,290,2497,32,4105,5.954.107.143
13/10/2019 01:00,33.26,34971,1048,19,290,2377,32,3766,5.954.107.143
13/10/2019 02:00,33.27,34848,796,18,289,2298,32,3433,5.954.107.143
13/10/2019 03:00,33.41,34963,619,19,282,2211,32,3163,5.954.107.143
13/10/2019 04:00,33.83,35336,488,21,268,2067,28,2872,5.954.107.143
13/10/2019 05:00,33.8,35947,446,24,245,2042,25,2782,5.954.107.143
13/10/2019 06:00,34.29,36893,390,25,224,1875,22,2536,5.954.107.143
13/10/2019 07:00,35.04,38399,368,23,211,1703,22,2327,5.954.107.143
13/10/2019 08:00,35.61,39826,398,20,203,1360,20,2001,5.954.107.143
13/10/2019 09:00,35.97,40569,410,19,197,1217,25,1868,5.954.107.143
13/10/2019 10:00,35.94,40612,425,18,175,1039,23,1680,5.954.107.143
13/10/2019 11:00,35.75,40370,479,16,145,997,19,1656,5.954.107.143
13/10/2019 12:00,35.45,40079,630,14,111,897,16,1668,5.954.107.143
13/10/2019 13:00,35.26,39970,799,14,87,796,13,1709,5.954.107.143
13/10/2019 14:00,35.19,40036,925,13,66,746,9,1759,5.954.107.143
13/10/2019 15:00,35.31,40670,1133,12,45,687,6,1883,5.954.107.143
13/10/2019 16:00,35.72,41994,1424,13,43,770,6,2256,5.954.107.143
13/10/2019 17:00,36.15,43335,1779,13,67,926,4,2789,5.954.107.143
13/10/2019 18:00,36.44,43582,2192,11,109,1127,5,3444,5.954.107.143
13/10/2019 19:00,35.41,42460,2483,10,140,1302,5,3940,5.954.107.143
13/10/2019 20:00,34.9,41452,2746,9,169,1334,4,4262,5.954.107.143
13/10/2019 21:00,34.38,39818,2940,9,202,1512,4,4667,5.954.107.143
13/10/2019 22:00,33.64,37914,3142,7,224,1690,4,5067,5.954.107.143
13/10/2019 23:00,31.05,36945,4144,37,153,2215,8,6557,5.954.107.143
14/10/2019 00:00,31.25,36160,4247,42,186,2465,13,6953,5.916.071.429
14/10/2019 01:00,31.09,35899,4308,46,225,2609,17,7205,5.916.071.429
14/10/2019 02:00,31.25,36031,4335,49,267,2723,30,7404,5.916.071.429
14/10/2019 03:00,31.91,36724,4281,59,306,2845,38,7529,5.916.071.429
14/10/2019 04:00,33.42,38970,4338,64,337,2988,48,7775,5.916.071.429
14/10/2019 05:00,35.46,42900,4280,67,346,3046,48,7787,5.916.071.429
14/10/2019 06:00,37.92,46165,3997,70,349,3090,50,7556,5.916.071.429
14/10/2019 07:00,39.65,47163,3431,74,350,3136,52,7043,5.916.071.429
14/10/2019 08:00,39.38,47152,2957,76,345,3107,52,6537,5.916.071.429
14/10/2019 09:00,39.4,47145,2558,79,341,2973,53,6004,5.916.071.429
14/10/2019 10:00,38.93,46886,1924,86,348,2781,53,5192,5.916.071.429
14/10/2019 11:00,38.53,46483,1265,93,367,2547,52,4324,5.916.071.429
14/10/2019 12:00,38.76,46149,847,102,383,2210,52,3594,5.916.071.429
14/10/2019 13:00,38.24,45881,576,105,392,1806,52,2931,5.916.071.429
14/10/2019 14:00,37.74,45714,352,109,385,1388,52,2286,5.916.071.429
14/10/2019 15:00,37.98,45721,247,109,381,1025,51,1813,5.916.071.429
14/10/2019 16:00,38.44,46409,190,112,374,706,51,1433,5.916.071.429
14/10/2019 17:00,39.99,47026,216,112,360,632,50,1370,5.916.071.429
14/10/2019 18:00,40.4,47012,312,126,343,577,48,1406,5.916.071.429
14/10/2019 19:00,37.91,45633,487,132,305,570,46,1540,5.916.071.429
14/10/2019 20:00,37.12,44104,822,133,242,625,26,1848,5.916.071.429
14/10/2019 21:00,35.36,42123,1198,140,185,680,25,2228,5.916.071.429
14/10/2019 22:00,34.3,39778,1542,144,139,760,14,2599,5.916.071.429
14/10/2019 23:00,34.37,38611,2192,13,78,805,4,3092,5.916.071.429
15/10/2019 00:00,34.01,37728,2436,15,53,943,4,3451,5.916.071.429
15/10/2019 01:00,33.82,37396,2724,20,33,980,5,3762,5.916.071.429
15/10/2019 02:00,33.82,37430,2935,31,25,1078,6,4075,5.916.071.429
15/10/2019 03:00,34.04,38042,3087,46,19,1172,6,4330,5.916.071.429
15/10/2019 04:00,35.01,40042,3263,63,18,1239,9,4592,5.916.071.429
15/10/2019 05:00,36.92,43911,3398,83,26,1417,10,4934,5.916.071.429
15/10/2019 06:00,38.66,46961,3355,100,37,1546,11,5049,5.916.071.429
15/10/2019 07:00,39.41,47641,3225,112,47,1606,11,5001,5.916.071.429
15/10/2019 08:00,38.96,47631,3055,135,53,1582,9,4834,5.916.071.429
15/10/2019 09:00,38.7,47633,2902,154,68,1600,8,4732,5.916.071.429
15/10/2019 10:00,38.41,47314,2541,158,85,1604,8,4396,5.916.071.429
15/10/2019 11:00,38.27,46898,2118,160,104,1595,8,3985,5.916.071.429
15/10/2019 12:00,38.36,46608,1854,164,124,1541,10,3693,5.916.071.429
15/10/2019 13:00,37.83,46378,1622,169,149,1510,12,3462,5.916.071.429
15/10/2019 14:00,37.61,46219,1323,165,183,1507,13,3191,5.916.071.429
15/10/2019 15:00,37.62,46397,1076,167,224,1574,13,3054,5.916.071.429
15/10/2019 16:00,37.58,46867,984,182,258,1605,15,3044,5.916.071.429
15/10/2019 17:00,37.96,47404,920,184,288,1636,22,3050,5.916.071.429
15/10/2019 18:00,38.79,47585,753,168,305,1660,29,2915,5.916.071.429
15/10/2019 19:00,37.5,46498,644,140,300,1496,30,2610,5.916.071.429
15/10/2019 20:00,36.86,44579,507,112,282,1369,28,2298,5.916.071.429
15/10/2019 21:00,35.99,42705,427,91,264,1119,28,1929,5.916.071.429
15/10/2019 22:00,34.17,40586,363,68,247,1040,27,1745,5.916.071.429
15/10/2019 23:00,34.86,38899,325,33,235,940,29,1562,5.916.071.429
16/10/2019 00:00,34.15,37749,244,24,228,872,26,1394,5.916.071.429
16/10/2019 01:00,34.01,37166,201,19,221,818,22,1281,5.916.071.429
16/10/2019 02:00,34.02,37072,181,16,214,810,22,1243,5.916.071.429
16/10/2019 03:00,34.48,37521,157,15,206,802,19,1199,5.916.071.429
16/10/2019 04:00,35.53,39128,133,15,197,793,19,1157,5.916.071.429
16/10/2019 05:00,38.28,43377,114,13,188,852,15,1182,5.916.071.429
16/10/2019 06:00,40.12,47008,116,12,183,884,15,1210,5.916.071.429
16/10/2019 07:00,40.12,47926,135,11,174,896,16,1232,5.916.071.429
16/10/2019 08:00,39.95,48061,198,11,152,833,14,1208,5.916.071.429
16/10/2019 09:00,39.79,48186,350,13,134,820,9,1326,5.916.071.429
16/10/2019 10:00,39.77,47984,501,13,129,845,6,1494,5.916.071.429
16/10/2019 11:00,39.01,47753,589,15,139,977,6,1726,5.916.071.429
16/10/2019 12:00,38.71,47568,732,18,152,938,6,1846,5.916.071.429
16/10/2019 13:00,38.22,47329,844,21,165,1056,6,2092,5.916.071.429
16/10/2019 14:00,38.08,47215,898,28,176,1093,6,2201,5.916.071.429
16/10/2019 15:00,38.62,47467,919,37,184,1213,6,2359,5.916.071.429
16/10/2019 16:00,38.94,48083,848,48,198,1351,8,2453,5.916.071.429
16/10/2019 17:00,39.04,48499,805,59,218,1607,9,2698,5.916.071.429
16/10/2019 18:00,38.75,48473,819,68,232,1706,9,2834,5.916.071.429
16/10/2019 19:00,37.36,47228,867,73,246,1743,9,2938,5.916.071.429
16/10/2019 20:00,36.33,45138,888,77,267,1769,10,3011,5.916.071.429
16/10/2019 21:00,35.35,43003,978,81,286,1667,10,3022,5.916.071.429
16/10/2019 22:00,33.33,40654,1070,82,302,1675,12,3141,5.916.071.429
16/10/2019 23:00,33.84,38508,1025,104,345,1624,16,3114,5.916.071.429
17/10/2019 00:00,33.28,37446,1104,104,359,1576,20,3163,5.916.071.429
17/10/2019 01:00,32.84,36997,1165,101,361,1571,23,3221,5.916.071.429
17/10/2019 02:00,32.79,36947,1207,98,362,1334,23,3024,5.916.071.429
17/10/2019 03:00,33.6,37401,1173,94,363,1314,17,2961,5.916.071.429
17/10/2019 04:00,34.71,39092,1218,91,367,1261,14,2951,5.916.071.429
17/10/2019 05:00,37.28,43349,1290,88,372,1112,11,2873,5.916.071.429
17/10/2019 06:00,39.22,46908,1276,82,378,1165,8,2909,5.916.071.429
17/10/2019 07:00,39.88,47868,1253,73,389,1094,5,2814,5.916.071.429
17/10/2019 08:00,40.22,47893,1333,63,395,970,4,2765,5.916.071.429
17/10/2019 09:00,40.04,48067,1484,53,402,907,7,2853,5.916.071.429
17/10/2019 10:00,39.8,47906,1485,42,391,836,16,2770,5.916.071.429
17/10/2019 11:00,39.42,47608,1341,33,365,737,16,2492,5.916.071.429
17/10/2019 12:00,39.25,47298,1300,26,327,747,17,2417,5.916.071.429
17/10/2019 13:00,38.67,47063,1212,21,267,683,23,2206,5.916.071.429
17/10/2019 14:00,38.05,46879,1026,19,197,692,22,1956,5.916.071.429
17/10/2019 15:00,38.6,46941,896,19,138,667,22,1742,5.916.071.429
17/10/2019 16:00,38.93,47619,835,20,107,686,18,1666,5.916.071.429
17/10/2019 17:00,39.62,48094,750,20,103,767,13,1653,5.916.071.429
17/10/2019 18:00,40.05,48009,722,20,102,804,11,1659,5.916.071.429
17/10/2019 19:00,39.27,46737,714,20,106,766,6,1612,5.916.071.429
17/10/2019 20:00,37.91,44754,665,21,111,752,7,1556,5.916.071.429
17/10/2019 21:00,37.24,42752,631,22,114,740,6,1513,5.916.071.429
17/10/2019 22:00,35.61,40508,665,24,108,702,5,1504,5.916.071.429
17/10/2019 23:00,35.81,38655,798,51,102,671,4,1626,5.916.071.429
18/10/2019 00:00,35.62,37576,839,51,90,694,3,1677,5.916.071.429
18/10/2019 01:00,35.43,37093,878,50,82,689,3,1702,5.916.071.429
18/10/2019 02:00,35.47,37006,951,49,80,697,4,1781,5.916.071.429
18/10/2019 03:00,35.72,37430,1061,50,77,723,5,1916,5.916.071.429
18/10/2019 04:00,36.77,39064,1178,55,72,730,5,2040,5.916.071.429
18/10/2019 05:00,39.15,43323,1373,59,71,843,5,2351,5.916.071.429
18/10/2019 06:00,40.29,47103,1567,67,68,925,6,2633,5.916.071.429
18/10/2019 07:00,40.77,48060,1675,67,58,1011,6,2817,5.916.071.429
18/10/2019 08:00,40.5,48385,1661,62,48,1008,4,2783,5.916.071.429
18/10/2019 09:00,40.12,48405,1802,53,42,950,4,2851,5.916.071.429
18/10/2019 10:00,39.51,47881,1833,43,37,908,4,2825,5.916.071.429
18/10/2019 11:00,38.93,47276,1843,35,34,889,4,2805,5.916.071.429
18/10/2019 12:00,38.64,46504,1976,27,34,894,4,2935,5.916.071.429
18/10/2019 13:00,38.21,45919,2051,21,39,897,4,3012,5.916.071.429
18/10/2019 14:00,37.63,45543,2030,18,49,939,3,3039,5.916.071.429
18/10/2019 15:00,37.61,45451,2078,17,66,943,3,3107,5.916.071.429
18/10/2019 16:00,38.56,45993,2257,17,83,1130,5,3492,5.916.071.429
18/10/2019 17:00,39.64,46584,2615,19,101,1225,8,3968,5.916.071.429
18/10/2019 18:00,39.07,46195,2818,22,119,1411,9,4379,5.916.071.429
18/10/2019 19:00,36.45,44566,3029,26,132,1526,12,4725,5.916.071.429
18/10/2019 20:00,35.66,42633,3261,31,132,1615,12,5051,5.916.071.429
18/10/2019 21:00,35.12,41032,3421,34,135,1688,12,5290,5.916.071.429
18/10/2019 22:00,34.07,39264,3476,37,135,1835,11,5494,5.916.071.429
18/10/2019 23:00,34.96,37164,3967,144,144,1940,11,6206,5.916.071.429
19/10/2019 00:00,34.29,35959,3843,147,140,2016,11,6157,5.916.071.429
19/10/2019 01:00,33.91,35338,3759,145,138,2140,11,6193,5.916.071.429
19/10/2019 02:00,33.84,35123,3591,140,141,2278,11,6161,5.916.071.429
19/10/2019 03:00,33.85,35137,3397,135,145,2409,15,6101,5.916.071.429
19/10/2019 04:00,33.94,35690,3411,133,143,2450,16,6153,5.916.071.429
19/10/2019 05:00,34.47,37060,3390,138,125,2576,16,6245,5.916.071.429
19/10/2019 06:00,34.24,38497,3259,149,110,2684,16,6218,5.916.071.429
19/10/2019 07:00,34.58,39987,3167,169,94,2773,14,6217,5.916.071.429
19/10/2019 08:00,35.63,41569,3071,189,78,2787,13,6138,5.916.071.429
19/10/2019 09:00,36.51,42199,3107,199,64,2945,14,6329,5.916.071.429
19/10/2019 10:00,36.57,42141,3033,209,56,3123,15,6436,5.916.071.429
19/10/2019 11:00,35.54,41761,2899,214,47,3216,17,6393,5.916.071.429
19/10/2019 12:00,35.05,41350,2712,212,41,3204,17,6186,5.916.071.429
19/10/2019 13:00,34.79,40973,2470,206,35,3186,15,5912,5.916.071.429
19/10/2019 14:00,34.66,41118,2140,190,29,3067,12,5438,5.916.071.429
19/10/2019 15:00,35.63,41603,1944,165,26,2906,9,5050,5.916.071.429
19/10/2019 16:00,37.81,42825,1902,143,25,2930,8,5008,5.916.071.429
19/10/2019 17:00,38.42,44056,1877,118,26,2944,9,4974,5.916.071.429
19/10/2019 18:00,38.25,43865,1846,101,30,2931,9,4917,5.916.071.429
19/10/2019 19:00,37.59,42454,1799,92,36,3030,8,4965,5.916.071.429
19/10/2019 20:00,35.35,40766,1744,92,39,2967,7,4849,5.916.071.429
19/10/2019 21:00,35.11,39611,1681,94,39,2852,7,4673,5.916.071.429
19/10/2019 22:00,34,38293,1565,89,40,2733,7,4434,5.916.071.429
19/10/2019 23:00,34.76,37473,1388,125,61,2612,7,4193,5.916.071.429
20/10/2019 00:00,34.38,36475,1369,119,60,2439,8,3995,5.916.071.429
20/10/2019 01:00,34.32,35890,1366,122,61,2350,7,3906,5.916.071.429
20/10/2019 02:00,34.28,35653,1240,134,71,2318,7,3770,5.916.071.429
20/10/2019 03:00,34.29,35774,1077,138,89,2195,7,3506,5.916.071.429
20/10/2019 04:00,34.33,36130,1099,144,108,1960,7,3318,5.916.071.429
20/10/2019 05:00,34.24,36905,1128,146,124,1935,6,3339,5.916.071.429
20/10/2019 06:00,34.39,37822,1075,148,138,1773,7,3141,5.916.071.429
20/10/2019 07:00,34.94,39198,1010,148,136,1579,8,2881,5.916.071.429
20/10/2019 08:00,36.8,40689,953,147,99,1374,8,2581,5.916.071.429
20/10/2019 09:00,37.65,41710,931,147,77,1293,9,2457,5.916.071.429
20/10/2019 10:00,38.21,42041,826,150,68,1140,8,2192,5.916.071.429
20/10/2019 11:00,37.97,41934,703,148,63,1080,9,2003,5.916.071.429
20/10/2019 12:00,36.57,41723,567,140,61,1011,8,1787,5.916.071.429
20/10/2019 13:00,36.53,41605,454,129,60,943,8,1594,5.916.071.429
20/10/2019 14:00,36.57,41763,328,111,57,889,7,1392,5.916.071.429
20/10/2019 15:00,37,42475,227,94,57,850,8,1236,5.916.071.429
20/10/2019 16:00,38.67,43909,166,82,62,832,10,1152,5.916.071.429
20/10/2019 17:00,39.48,45159,127,72,72,843,9,1123,5.916.071.429
20/10/2019 18:00,39.5,45356,107,61,85,845,10,1108,5.916.071.429
20/10/2019 19:00,39.09,44226,79,50,93,804,12,1038,5.916.071.429
20/10/2019 20:00,38.58,42683,58,40,96,736,9,939,5.916.071.429
20/10/2019 21:00,38.01,41236,76,30,95,675,9,885,5.916.071.429
20/10/2019 22:00,35.98,39637,94,23,87,633,7,844,5.916.071.429
20/10/2019 23:00,35.3,38608,135,26,65,600,4,830,5.916.071.429
21/10/2019 00:00,35.26,37750,223,23,51,639,2,938,5.951.547.619
21/10/2019 01:00,35.3,37452,330,17,40,678,2,1067,5.951.547.619
21/10/2019 02:00,35.44,37484,458,13,30,739,2,1242,5.951.547.619
21/10/2019 03:00,36.09,38078,595,10,23,821,2,1451,5.951.547.619
21/10/2019 04:00,37.73,39866,741,7,17,879,2,1646,5.951.547.619
21/10/2019 05:00,39.42,44519,874,6,15,899,1,1795,5.951.547.619
21/10/2019 06:00,41.49,48450,963,7,15,936,2,1923,5.951.547.619
21/10/2019 07:00,42.43,49352,1018,9,14,776,2,1819,5.951.547.619
21/10/2019 08:00,43.23,49387,1003,9,13,594,1,1620,5.951.547.619
21/10/2019 09:00,41.9,49485,1038,11,11,500,1,1561,5.951.547.619
21/10/2019 10:00,41.3,49216,1068,14,10,469,1,1562,5.951.547.619
21/10/2019 11:00,41.03,48906,1131,18,11,424,1,1585,5.951.547.619
21/10/2019 12:00,40.6,48500,1276,23,14,567,1,1881,5.951.547.619
21/10/2019 13:00,40.09,48234,1321,25,19,584,1,1950,5.951.547.619
21/10/2019 14:00,40,48192,1259,25,25,769,1,2079,5.951.547.619
21/10/2019 15:00,40.02,48353,1263,27,32,923,1,2246,5.951.547.619
21/10/2019 16:00,40.73,49136,1191,30,43,1174,1,2439,5.951.547.619
21/10/2019 17:00,41.23,49680,1046,34,55,1370,2,2507,5.951.547.619
21/10/2019 18:00,41.24,49636,910,40,67,1574,2,2593,5.951.547.619
21/10/2019 19:00,39.62,48349,816,47,74,1700,2,2639,5.951.547.619
21/10/2019 20:00,39.05,46349,717,51,78,1828,2,2676,5.951.547.619
21/10/2019 21:00,38.16,44287,740,55,84,1861,3,2743,5.951.547.619
21/10/2019 22:00,36.79,42073,683,59,84,1964,4,2794,5.951.547.619
21/10/2019 23:00,36.03,40210,262,84,69,2186,5,2606,5.951.547.619
22/10/2019 00:00,35.23,39167,308,90,68,2454,6,2926,5.951.547.619
22/10/2019 01:00,34.58,38706,408,97,66,2635,7,3213,5.951.547.619
22/10/2019 02:00,34.08,38716,505,97,64,2823,7,3496,5.951.547.619
22/10/2019 03:00,34.5,39168,525,96,69,3038,9,3737,5.951.547.619
22/10/2019 04:00,35.48,40813,547,91,76,3348,7,4069,5.951.547.619
22/10/2019 05:00,38,45223,609,85,83,3627,6,4410,5.951.547.619
22/10/2019 06:00,39.13,49119,663,76,95,3925,9,4768,5.951.547.619
22/10/2019 07:00,39.28,49844,755,66,104,4172,8,5105,5.951.547.619
22/10/2019 08:00,39.09,49729,890,58,109,4412,11,5480,5.951.547.619
22/10/2019 09:00,38.69,49654,1113,50,115,4627,11,5916,5.951.547.619
22/10/2019 10:00,38.04,49349,1316,43,127,4903,13,6402,5.951.547.619
22/10/2019 11:00,37.28,49031,1432,35,145,5170,22,6804,5.951.547.619
22/10/2019 12:00,36.99,48830,1661,29,159,5434,30,7313,5.951.547.619
22/10/2019 13:00,36.75,48756,1871,22,159,5477,32,7561,5.951.547.619
22/10/2019 14:00,36.72,48754,2038,17,150,5628,24,7857,5.951.547.619
22/10/2019 15:00,36.73,48984,2164,13,144,5701,26,8048,5.951.547.619
22/10/2019 16:00,37.42,49598,2250,10,151,5746,34,8191,5.951.547.619
22/10/2019 17:00,37.64,50039,2272,7,163,5703,37,8182,5.951.547.619
22/10/2019 18:00,37.6,49835,2226,6,187,5715,34,8168,5.951.547.619
22/10/2019 19:00,36.23,48558,2201,6,195,5738,36,8176,5.951.547.619
22/10/2019 20:00,35.32,46507,2128,6,188,5701,36,8059,5.951.547.619
22/10/2019 21:00,34.66,44503,2077,9,182,5694,35,7997,5.951.547.619
22/10/2019 22:00,33.18,42280,2010,11,178,5631,34,7864,5.951.547.619
22/10/2019 23:00,33.35,39468,2069,25,198,5593,33,7918,5.951.547.619
23/10/2019 00:00,33.25,38300,1963,32,184,5357,29,7565,5.951.547.619
23/10/2019 01:00,33.3,37799,1928,42,171,5098,25,7264,5.951.547.619
23/10/2019 02:00,33.46,37764,1780,54,168,4798,26,6826,5.951.547.619
23/10/2019 03:00,33.85,38197,1542,65,165,4347,25,6144,5.951.547.619
23/10/2019 04:00,35.47,39894,1435,75,156,3992,28,5686,5.951.547.619
23/10/2019 05:00,38.68,44345,1396,84,146,3816,25,5467,5.951.547.619
23/10/2019 06:00,39.68,48223,1344,97,135,3581,21,5178,5.951.547.619
23/10/2019 07:00,39.8,48998,1285,108,129,3280,18,4820,5.951.547.619
23/10/2019 08:00,39.8,48907,1201,115,136,3013,15,4480,5.951.547.619
23/10/2019 09:00,39.94,48914,1166,120,151,2912,17,4366,5.951.547.619
23/10/2019 10:00,39.67,48651,1162,129,161,2890,15,4357,5.951.547.619
23/10/2019 11:00,39.49,48361,1127,140,161,2718,13,4159,5.951.547.619
23/10/2019 12:00,39.16,48120,1157,151,158,2745,13,4224,5.951.547.619
23/10/2019 13:00,39.04,47853,1084,161,144,2512,11,3912,5.951.547.619
23/10/2019 14:00,39.19,47733,932,172,118,2447,14,3683,5.951.547.619
23/10/2019 15:00,39.27,48075,788,183,99,2411,13,3494,5.951.547.619
23/10/2019 16:00,39.8,48947,729,191,88,2404,14,3426,5.951.547.619
23/10/2019 17:00,40.69,49434,724,191,82,2374,11,3382,5.951.547.619
23/10/2019 18:00,40.63,49133,751,195,77,2368,11,3402,5.951.547.619
23/10/2019 19:00,39.39,47714,858,196,70,2360,10,3494,5.951.547.619
23/10/2019 20:00,38.51,45648,1003,194,64,2243,9,3513,5.951.547.619
23/10/2019 21:00,37.71,43450,1128,194,58,2179,8,3567,5.951.547.619
23/10/2019 22:00,34.59,41126,1233,190,43,2188,8,3662,5.951.547.619
23/10/2019 23:00,34.23,38946,1379,63,33,2171,5,3651,5.951.547.619
24/10/2019 00:00,32.95,37917,1523,63,27,2122,4,3739,5.951.547.619
24/10/2019 01:00,32.18,37481,1628,60,23,2149,4,3864,5.951.547.619
24/10/2019 02:00,32.13,37444,1702,59,26,2202,7,3996,5.951.547.619
24/10/2019 03:00,32.92,37922,1818,62,32,2276,7,4195,5.951.547.619
24/10/2019 04:00,34.96,39668,1971,63,49,2333,6,4422,5.951.547.619
24/10/2019 05:00,38.74,44034,2166,62,66,2352,6,4652,5.951.547.619
24/10/2019 06:00,40.48,47755,2264,62,83,2250,5,4664,5.951.547.619
24/10/2019 07:00,40.95,48487,2347,62,91,2217,5,4722,5.951.547.619
24/10/2019 08:00,40.87,48314,2386,62,81,2188,5,4722,5.951.547.619
24/10/2019 09:00,40.75,48367,2459,64,72,2151,4,4750,5.951.547.619
24/10/2019 10:00,40.46,48089,2400,66,69,2111,4,4650,5.951.547.619
24/10/2019 11:00,40.16,47717,2180,69,74,2032,4,4359,5.951.547.619
24/10/2019 12:00,39.86,47444,1941,64,84,1993,5,4087,5.951.547.619
24/10/2019 13:00,39.1,47223,1828,55,97,1871,5,3856,5.951.547.619
24/10/2019 14:00,38.32,47153,1829,48,123,1926,5,3931,5.951.547.619
24/10/2019 15:00,38.86,47353,1787,47,156,2014,6,4010,5.951.547.619
24/10/2019 16:00,39.7,48192,1831,55,192,2109,10,4197,5.951.547.619
24/10/2019 17:00,40.3,48673,2056,68,224,2233,17,4598,5.951.547.619
24/10/2019 18:00,39.81,48201,2305,83,251,2332,19,4990,5.951.547.619
24/10/2019 19:00,36.83,46856,2533,99,264,2425,25,5346,5.951.547.619
24/10/2019 20:00,35.63,44916,2682,113,261,2448,27,5531,5.951.547.619
24/10/2019 21:00,34.56,42965,2891,123,255,2389,27,5685,5.951.547.619
24/10/2019 22:00,33.02,40672,3127,125,244,2415,27,5938,5.951.547.619
24/10/2019 23:00,33.05,38776,3278,63,229,2541,28,6139,5.951.547.619
25/10/2019 00:00,32.07,37721,3584,63,224,2619,30,6520,5.951.547.619
25/10/2019 01:00,31.68,37236,3838,60,215,2883,30,7026,5.951.547.619
25/10/2019 02:00,31.31,37154,3866,59,205,3111,31,7272,5.951.547.619
25/10/2019 03:00,31.72,37563,3616,62,196,3313,30,7217,5.951.547.619
25/10/2019 04:00,33.21,39129,3427,63,179,3635,29,7333,5.951.547.619
25/10/2019 05:00,37.02,43375,3257,62,164,3828,26,7337,5.951.547.619
25/10/2019 06:00,39.2,47181,3133,62,154,4278,26,7653,5.951.547.619
25/10/2019 07:00,39.46,47935,3019,62,146,4211,25,7463,5.951.547.619
25/10/2019 08:00,39.19,47939,2870,62,139,4093,25,7189,5.951.547.619
25/10/2019 09:00,39.17,47901,2859,64,134,4153,20,7230,5.951.547.619
25/10/2019 10:00,38.7,47489,2787,66,150,4029,24,7056,5.951.547.619
25/10/2019 11:00,35.86,46941,2515,69,179,4082,31,6876,5.951.547.619
25/10/2019 12:00,36.04,46324,2327,64,205,4186,34,6816,5.951.547.619
25/10/2019 13:00,34.79,45751,2166,55,227,4279,47,6774,5.951.547.619
25/10/2019 14:00,35.48,45385,1962,48,244,4459,53,6766,5.951.547.619
25/10/2019 15:00,36.35,45460,1845,47,273,4645,56,6866,5.951.547.619
25/10/2019 16:00,37.88,46262,1874,55,297,4717,55,6998,5.951.547.619
25/10/2019 17:00,38.52,47003,1997,68,304,4854,52,7275,5.951.547.619
25/10/2019 18:00,38.23,46492,2100,83,301,4815,50,7349,5.951.547.619
25/10/2019 19:00,34.93,44882,2272,99,293,4828,53,7545,5.951.547.619
25/10/2019 20:00,33.57,42916,2600,113,282,4870,56,7921,5.951.547.619
25/10/2019 21:00,32.1,41493,2986,123,269,4875,57,8310,5.951.547.619
25/10/2019 22:00,30.93,39927,3445,125,248,4797,56,8671,5.951.547.619
25/10/2019 23:00,30.29,38947,4071,54,274,4823,55,9277,5.951.547.619
26/10/2019 00:00,29.63,37884,4312,60,233,4812,52,9469,5.951.547.619
26/10/2019 01:00,29.78,37222,4345,66,203,4864,43,9521,5.951.547.619
26/10/2019 02:00,29.23,36935,4342,71,185,4892,33,9523,5.951.547.619
26/10/2019 03:00,29.15,36960,4232,77,178,4966,21,9474,5.951.547.619
26/10/2019 04:00,30.59,37423,4340,85,188,5087,17,9717,5.951.547.619
26/10/2019 05:00,31.01,38697,4338,92,219,5103,21,9773,5.951.547.619
26/10/2019 06:00,32.41,40194,3933,101,256,4905,26,9221,5.951.547.619
26/10/2019 07:00,33.4,41559,3408,116,292,4654,34,8504,5.951.547.619
26/10/2019 08:00,34.26,42986,2839,129,327,4268,50,7613,5.951.547.619
26/10/2019 09:00,34.82,43778,2396,139,363,3850,58,6806,5.951.547.619
26/10/2019 10:00,34.93,43829,2109,138,390,3633,58,6328,5.951.547.619
26/10/2019 11:00,34.85,43582,1947,127,408,3251,58,5791,5.951.547.619
26/10/2019 12:00,34.82,43353,1877,116,417,2843,58,5311,5.951.547.619
26/10/2019 13:00,34.93,43047,1791,103,421,2610,58,4983,5.951.547.619
26/10/2019 14:00,34.97,43104,1736,92,418,2485,58,4789,5.951.547.619
26/10/2019 15:00,35.76,43819,1722,87,415,2398,58,4680,5.951.547.619
26/10/2019 16:00,37.24,45130,1766,82,413,2264,58,4583,5.951.547.619
26/10/2019 17:00,38.26,46245,1845,80,412,2133,58,4528,5.951.547.619
26/10/2019 18:00,38.01,45650,1845,79,413,2011,58,4406,5.951.547.619
26/10/2019 19:00,36.82,44184,1868,75,412,1996,58,4409,5.951.547.619
26/10/2019 20:00,35.78,42556,1834,70,406,1914,58,4282,5.951.547.619
26/10/2019 21:00,34.45,41391,1796,64,402,1800,57,4119,5.951.547.619
26/10/2019 22:00,33.74,40162,1880,53,400,1626,53,4012,5.951.547.619
26/10/2019 23:00,34.11,39466,1684,71,364,1479,27,3625,5.951.547.619
27/10/2019 00:00,33.84,38506,1986,66,358,1436,25,3871,5.951.547.619
27/10/2019 01:00,33.43,38021,2356,56,351,1373,23,4159,5.951.547.619
27/10/2019 02:00,33.18,37633,2784,46,351,1350,23,4554,5.951.547.619
27/10/2019 03:00,33.05,37811,3041,42,346,1329,23,4781,5.951.547.619
27/10/2019 04:00,33.32,38016,3204,38,331,1378,24,4975,5.951.547.619
27/10/2019 05:00,34.14,38633,3278,36,333,1475,31,5153,5.951.547.619
27/10/2019 06:00,34.57,39504,3230,35,339,1635,44,5283,5.951.547.619
27/10/2019 07:00,34.77,40621,3177,34,343,1757,51,5362,5.951.547.619
27/10/2019 08:00,35.43,42140,3106,33,353,1895,53,5440,5.951.547.619
27/10/2019 09:00,36.2,43506,3192,31,375,2018,54,5670,5.951.547.619
27/10/2019 10:00,36.95,44472,3319,28,403,2078,55,5883,5.951.547.619
27/10/2019 11:00,36.83,44770,3412,25,422,2077,55,5991,5.951.547.619
27/10/2019 12:00,36.35,44619,3532,22,441,2062,56,6113,5.951.547.619
27/10/2019 13:00,36.06,44445,3600,22,452,1984,56,6114,5.951.547.619
27/10/2019 14:00,36.28,44396,3572,24,456,1957,56,6065,5.951.547.619
27/10/2019 15:00,37.07,44782,3564,30,451,1994,56,6095,5.951.547.619
27/10/2019 16:00,38.61,46008,3762,35,441,1894,54,6186,5.951.547.619
27/10/2019 17:00,40.63,47638,4002,42,419,1792,54,6309,5.951.547.619
27/10/2019 18:00,41.33,48269,4062,49,393,1786,55,6345,5.951.547.619
27/10/2019 19:00,40.28,47677,4153,56,364,1837,54,6464,5.951.547.619
27/10/2019 20:00,38.47,46371,4208,62,333,1833,54,6490,5.951.547.619
27/10/2019 21:00,37.54,45387,4162,69,300,1701,54,6286,5.951.547.619
27/10/2019 22:00,36.94,43902,4015,69,265,1714,43,6106,5.951.547.619
27/10/2019 23:00,35.51,42102,3768,130,246,1723,38,5905,5.951.547.619
28/10/2019 00:00,36.03,41391,3338,141,199,1689,15,5382,585.327.381
28/10/2019 01:00,35.64,40676,3200,151,186,1755,13,5305,585.327.381
28/10/2019 02:00,35.58,40496,2919,159,176,1682,7,4943,585.327.381
28/10/2019 03:00,35.68,40729,2606,166,166,1702,6,4646,585.327.381
28/10/2019 04:00,36.87,41643,2345,175,159,1736,7,4422,585.327.381
28/10/2019 05:00,38.85,43981,2119,185,147,1718,6,4175,585.327.381
28/10/2019 06:00,40.34,48343,1887,195,131,1750,5,3968,585.327.381
28/10/2019 07:00,42.02,51729,1712,197,119,1580,5,3613,585.327.381
28/10/2019 08:00,44.59,52602,1612,195,111,1369,4,3291,585.327.381
28/10/2019 09:00,44.72,52279,1569,194,107,1158,4,3032,585.327.381
28/10/2019 10:00,43.51,51886,1574,197,103,1010,3,2887,585.327.381
28/10/2019 11:00,41.97,51350,1625,202,99,922,4,2852,585.327.381
28/10/2019 12:00,40.99,50760,1709,197,93,897,6,2902,585.327.381
28/10/2019 13:00,41.63,50441,1760,195,86,1075,9,3125,585.327.381
28/10/2019 14:00,41.52,50357,1678,201,83,1205,12,3179,585.327.381
28/10/2019 15:00,41.73,50722,1674,207,84,1440,13,3418,585.327.381
28/10/2019 16:00,42.29,51593,1708,213,89,1918,12,3940,585.327.381
28/10/2019 17:00,43.55,52898,1738,219,94,2135,17,4203,585.327.381
28/10/2019 18:00,42.96,52967,1739,221,93,2413,17,4483,585.327.381
28/10/2019 19:00,41.06,52189,1689,226,83,2706,16,4720,585.327.381
28/10/2019 20:00,40.49,50574,1559,232,74,2784,16,4665,585.327.381
28/10/2019 21:00,40.25,49081,1363,235,68,2824,13,4503,585.327.381
28/10/2019 22:00,39.35,47112,1144,232,65,2886,14,4341,585.327.381
28/10/2019 23:00,37.49,44790,912,188,65,3050,19,4234,585.327.381
29/10/2019 00:00,37.02,42687,703,53,88,3027,18,3889,585.327.381
29/10/2019 01:00,36.6,41835,691,56,91,3050,17,3905,585.327.381
29/10/2019 02:00,35.83,41558,637,44,92,3058,18,3849,585.327.381
29/10/2019 03:00,35.22,41684,610,32,90,3245,14,3991,585.327.381
29/10/2019 04:00,36.06,42432,628,22,90,3303,11,4054,585.327.381
29/10/2019 05:00,38.24,44736,665,15,85,3407,12,4184,585.327.381
29/10/2019 06:00,40.39,48821,658,9,84,3543,13,4307,585.327.381
29/10/2019 07:00,41.42,52059,612,6,77,3473,13,4181,585.327.381
29/10/2019 08:00,42.36,52590,577,4,65,3262,13,3921,585.327.381
29/10/2019 09:00,42.23,52242,538,4,60,2880,17,3499,585.327.381
29/10/2019 10:00,42.14,51938,499,4,61,2689,23,3276,585.327.381
29/10/2019 11:00,41.66,51246,455,5,77,2475,15,3027,585.327.381
29/10/2019 12:00,41.28,50626,415,7,96,2278,20,2816,585.327.381
29/10/2019 13:00,41.23,50423,383,8,115,2221,37,2764,585.327.381
29/10/2019 14:00,41.3,50342,368,10,126,2100,27,2631,585.327.381
29/10/2019 15:00,41.82,50642,301,11,134,2029,34,2509,585.327.381
29/10/2019 16:00,42.94,51497,287,11,139,1994,27,2458,585.327.381
29/10/2019 17:00,43.91,52625,301,11,135,1998,25,2470,585.327.381
29/10/2019 18:00,44.19,52812,316,12,129,1914,23,2394,585.327.381
29/10/2019 19:00,41.97,51978,291,16,120,1819,31,2277,585.327.381
29/10/2019 20:00,40.8,50452,229,22,111,1620,40,2022,585.327.381
29/10/2019 21:00,40.59,49075,183,28,105,1438,42,1796,585.327.381
29/10/2019 22:00,39.92,46991,152,33,103,1291,45,1624,585.327.381
29/10/2019 23:00,38.61,44627,139,34,96,1162,39,1470,585.327.381
30/10/2019 00:00,38.4,43090,131,54,126,882,19,1212,585.327.381
30/10/2019 01:00,37.53,42231,155,48,117,900,12,1232,585.327.381
30/10/2019 02:00,37.3,42010,185,44,108,900,13,1250,585.327.381
30/10/2019 03:00,36.87,42218,229,42,104,992,13,1380,585.327.381
30/10/2019 04:00,37.87,43120,273,40,91,1091,8,1503,585.327.381
30/10/2019 05:00,39.65,45615,319,39,76,1211,6,1651,585.327.381
30/10/2019 06:00,41.28,49738,358,38,64,1216,6,1682,585.327.381
30/10/2019 07:00,44.62,52763,380,36,44,1399,6,1865,585.327.381
30/10/2019 08:00,45.72,53339,380,37,29,1516,6,1968,585.327.381
30/10/2019 09:00,44.84,53046,389,46,19,1398,6,1858,585.327.381
30/10/2019 10:00,43.69,52813,436,59,13,1502,5,2015,585.327.381
30/10/2019 11:00,41.94,52370,507,73,9,1640,5,2234,585.327.381
30/10/2019 12:00,41.1,51932,591,88,9,1630,5,2323,585.327.381
30/10/2019 13:00,41.04,51759,653,95,9,1904,5,2666,585.327.381
30/10/2019 14:00,41.16,51533,725,100,10,2455,6,3296,585.327.381
30/10/2019 15:00,41.16,51648,709,100,14,2984,6,3813,585.327.381
30/10/2019 16:00,41.55,52228,743,94,17,3380,6,4240,585.327.381
30/10/2019 17:00,41.6,53057,744,89,23,3634,6,4496,585.327.381
30/10/2019 18:00,41.36,52938,727,85,29,3710,7,4558,585.327.381
30/10/2019 19:00,40.46,51989,727,82,35,3732,9,4585,585.327.381
30/10/2019 20:00,39.81,50597,695,74,43,3780,13,4605,585.327.381
30/10/2019 21:00,39.33,49160,665,66,59,3770,14,4574,585.327.381
30/10/2019 22:00,38.26,47000,630,62,74,3700,14,4480,585.327.381
30/10/2019 23:00,36.6,44617,637,60,84,3886,13,4680,585.327.381
31/10/2019 00:00,36.08,43359,631,55,97,3974,13,4770,585.327.381
31/10/2019 01:00,35.02,42479,655,57,107,3939,15,4773,585.327.381
31/10/2019 02:00,34.67,42258,678,59,116,4141,14,5008,585.327.381
31/10/2019 03:00,33.81,42433,685,58,121,4132,13,5009,585.327.381
31/10/2019 04:00,34.83,43164,668,54,130,4140,14,5006,585.327.381
31/10/2019 05:00,38.2,45429,642,51,144,4059,12,4908,585.327.381
31/10/2019 06:00,40.17,49366,623,44,164,4061,15,4907,585.327.381
31/10/2019 07:00,41.36,52489,594,33,179,3968,17,4791,585.327.381
31/10/2019 08:00,41.91,53164,611,24,191,3645,18,4489,585.327.381
31/10/2019 09:00,41.64,52875,614,17,205,3459,18,4313,585.327.381
31/10/2019 10:00,40.88,52713,591,13,214,3186,18,4022,585.327.381
31/10/2019 11:00,40.46,52150,561,11,221,2934,15,3742,585.327.381
31/10/2019 12:00,39.86,51565,534,10,222,2624,16,3406,585.327.381
31/10/2019 13:00,40.44,51301,549,8,215,2412,16,3200,585.327.381
31/10/2019 14:00,40.86,51242,516,6,201,2461,15,3199,585.327.381
31/10/2019 15:00,41.13,51582,443,5,196,2590,14,3248,585.327.381
31/10/2019 16:00,41.96,52414,437,7,184,2541,15,3184,585.327.381
31/10/2019 17:00,42.55,53562,383,11,174,2634,15,3217,585.327.381
31/10/2019 18:00,42.42,53421,335,20,165,2482,15,3017,585.327.381
31/10/2019 19:00,41.3,52445,349,27,157,2414,13,2960,585.327.381
31/10/2019 20:00,40.56,50808,376,34,141,2162,11,2724,585.327.381
31/10/2019 21:00,40.4,49435,437,40,125,2167,11,2780,585.327.381
31/10/2019 22:00,39.62,47404,548,46,114,2155,11,2874,585.327.381
31/10/2019 23:00,37.44,45271,701,48,105,2027,10,2891,585.327.381
01/11/2019 00:00,36.73,43365,903,82,98,2020,9,3112,585.327.381
01/11/2019 01:00,34.98,42488,928,88,89,1889,10,3004,585.327.381
01/11/2019 02:00,34.84,42186,890,90,83,1756,9,2828,585.327.381
01/11/2019 03:00,34.82,42255,899,93,80,1639,7,2718,585.327.381
01/11/2019 04:00,35.48,42977,981,95,78,1539,6,2699,585.327.381
01/11/2019 05:00,37.77,45195,1140,99,75,1350,6,2670,585.327.381
01/11/2019 06:00,38.88,48874,1339,104,74,1324,6,2847,585.327.381
01/11/2019 07:00,40.2,52128,1579,100,70,1145,6,2900,585.327.381
01/11/2019 08:00,40.7,53106,1889,92,69,1083,5,3138,585.327.381
01/11/2019 09:00,40.07,53053,2270,93,78,985,5,3431,585.327.381
01/11/2019 10:00,39.91,52699,2441,93,84,938,6,3562,585.327.381
01/11/2019 11:00,39.5,52107,2531,93,92,913,7,3636,585.327.381
01/11/2019 12:00,39.03,51467,2550,93,98,947,8,3696,585.327.381
01/11/2019 13:00,39.01,50949,2560,91,104,1010,8,3773,585.327.381
01/11/2019 14:00,38.78,50569,2512,91,107,1137,7,3854,585.327.381
01/11/2019 15:00,38.51,50853,2407,94,109,1444,8,4062,585.327.381
01/11/2019 16:00,39.11,51670,2451,95,115,1694,6,4361,585.327.381
01/11/2019 17:00,39.72,52339,2561,93,132,1904,7,4697,585.327.381
01/11/2019 18:00,39.49,51783,2623,94,150,2213,6,5086,585.327.381
01/11/2019 19:00,38.42,50513,2606,93,169,2349,7,5224,585.327.381
01/11/2019 20:00,37.24,48597,2505,91,187,2479,7,5269,585.327.381
01/11/2019 21:00,36.21,47351,2368,89,208,2339,9,5013,585.327.381
01/11/2019 22:00,34.64,45484,2177,87,231,2252,13,4760,585.327.381
01/11/2019 23:00,33.03,43575,2055,82,248,2153,15,4553,585.327.381
02/11/2019 00:00,34.34,42120,1407,222,260,1971,18,3878,585.327.381
02/11/2019 01:00,33.94,41133,1389,216,271,1822,18,3716,585.327.381
02/11/2019 02:00,33.43,40692,1395,209,284,1839,18,3745,585.327.381
02/11/2019 03:00,33.14,40664,1424,196,301,1710,18,3649,585.327.381
02/11/2019 04:00,33.12,40798,1475,178,322,1594,21,3590,585.327.381
02/11/2019 05:00,32.95,41454,1497,166,332,1306,21,3322,585.327.381
02/11/2019 06:00,35.05,42490,1464,158,340,1141,21,3124,585.327.381
02/11/2019 07:00,35.95,43722,1450,158,341,962,21,2932,585.327.381
02/11/2019 08:00,36.99,45297,1424,160,338,762,21,2705,585.327.381
02/11/2019 09:00,38.41,46755,1498,174,341,555,21,2589,585.327.381
02/11/2019 10:00,38.72,47576,1612,197,343,454,18,2624,585.327.381
02/11/2019 11:00,38.18,47613,1730,224,341,397,18,2710,585.327.381
02/11/2019 12:00,37.43,47372,1847,249,335,386,18,2835,585.327.381
02/11/2019 13:00,37.05,47135,1980,261,322,437,17,3017,585.327.381
02/11/2019 14:00,36.97,47101,2028,260,316,588,18,3210,585.327.381
02/11/2019 15:00,37.12,47658,1895,257,308,759,18,3237,585.327.381
02/11/2019 16:00,38.31,49008,1842,249,294,995,18,3398,585.327.381
02/11/2019 17:00,39.01,50026,1785,230,277,1287,21,3600,585.327.381
02/11/2019 18:00,39.53,49620,1710,210,261,1474,20,3675,585.327.381
02/11/2019 19:00,37.92,48436,1717,184,247,1708,18,3874,585.327.381
02/11/2019 20:00,37.38,46827,1821,155,232,1872,16,4096,585.327.381
02/11/2019 21:00,36.66,45849,1803,128,218,1973,15,4137,585.327.381
02/11/2019 22:00,36.1,44514,1717,98,209,2091,12,4127,585.327.381
02/11/2019 23:00,35.03,42907,1618,53,198,2102,11,3982,585.327.381
03/11/2019 00:00,35.19,42032,1766,39,226,2130,11,4172,585.327.381
03/11/2019 01:00,34.99,41228,1738,24,218,2148,10,4138,585.327.381
03/11/2019 02:00,34.49,40556,1645,24,212,2172,11,4064,585.327.381
03/11/2019 03:00,33.87,40589,1621,14,206,2311,11,4163,585.327.381
03/11/2019 04:00,34.29,40759,1649,11,194,2401,11,4266,585.327.381
03/11/2019 05:00,34.65,41260,1610,11,178,2505,11,4315,585.327.381
03/11/2019 06:00,34.99,42045,1503,11,168,2482,10,4174,585.327.381
03/11/2019 07:00,35.42,43104,1427,11,162,2492,8,4100,585.327.381
03/11/2019 08:00,36.45,44573,1350,17,156,2579,8,4110,585.327.381
03/11/2019 09:00,37.14,46040,1260,28,145,2504,9,3946,585.327.381
03/11/2019 10:00,37.81,46953,1128,37,141,2444,11,3761,585.327.381
03/11/2019 11:00,38.14,47249,959,52,136,2294,8,3449,585.327.381
03/11/2019 12:00,38.69,47209,802,64,132,2200,8,3206,585.327.381
03/11/2019 13:00,38.09,47108,675,85,135,2275,9,3179,585.327.381
03/11/2019 14:00,38.23,47191,587,112,148,2484,10,3341,585.327.381
03/11/2019 15:00,38.54,47811,512,123,161,2770,10,3576,585.327.381
03/11/2019 16:00,39.88,49104,494,119,175,3003,14,3805,585.327.381
03/11/2019 17:00,41.26,50461,545,110,181,3045,15,3896,585.327.381
03/11/2019 18:00,41.46,50598,625,93,184,3170,15,4087,585.327.381
03/11/2019 19:00,40.66,49840,720,76,179,3064,15,4054,585.327.381
03/11/2019 20:00,39.28,48514,910,69,159,3033,14,4185,585.327.381
03/11/2019 21:00,37.66,47561,1079,62,139,2986,12,4278,585.327.381
03/11/2019 22:00,36.67,45971,1232,55,124,3037,12,4460,585.327.381
03/11/2019 23:00,35.34,44112,1420,52,109,2960,9,4550,585.327.381
04/11/2019 00:00,35.52,42665,1612,76,76,2956,6,4726,5.647.619.048
04/11/2019 01:00,35.53,42011,1838,71,66,2905,6,4886,5.647.619.048
04/11/2019 02:00,35.48,41787,2066,70,56,2880,7,5079,5.647.619.048
04/11/2019 03:00,35.45,42119,2381,72,60,2759,7,5279,5.647.619.048
04/11/2019 04:00,36.1,43143,2735,73,64,2735,8,5615,5.647.619.048
04/11/2019 05:00,36.93,45804,3014,73,71,2668,9,5835,5.647.619.048
04/11/2019 06:00,39.91,50164,3266,68,83,2683,9,6109,5.647.619.048
04/11/2019 07:00,42.21,53495,3329,57,95,2675,10,6166,5.647.619.048
04/11/2019 08:00,44.16,54177,3344,47,107,2539,12,6049,5.647.619.048
04/11/2019 09:00,44.38,54016,3370,40,122,2517,13,6062,5.647.619.048
04/11/2019 10:00,43.2,53868,3421,37,136,2519,16,6129,5.647.619.048
04/11/2019 11:00,42.73,53521,3422,35,147,2505,17,6126,5.647.619.048
04/11/2019 12:00,42,53117,3444,30,156,2505,17,6152,5.647.619.048
04/11/2019 13:00,42.67,53011,3402,25,162,2516,18,6123,5.647.619.048
04/11/2019 14:00,42.63,53091,3336,21,163,2600,21,6141,5.647.619.048
04/11/2019 15:00,42.96,53691,3263,19,168,2739,22,6211,5.647.619.048
04/11/2019 16:00,44.15,54600,3273,18,176,2881,26,6374,5.647.619.048
04/11/2019 17:00,45.51,55460,3357,19,187,2919,29,6511,5.647.619.048
04/11/2019 18:00,44.2,55059,3408,19,201,3045,27,6700,5.647.619.048
04/11/2019 19:00,43.07,54071,3450,23,206,3050,28,6757,5.647.619.048
04/11/2019 20:00,41.76,52377,3444,36,204,2956,29,6669,5.647.619.048
04/11/2019 21:00,39.99,50715,3538,48,206,2947,26,6765,5.647.619.048
04/11/2019 22:00,39.21,48542,3471,58,209,2891,21,6650,5.647.619.048
04/11/2019 23:00,37.91,46110,3353,65,210,2842,21,6491,5.647.619.048
05/11/2019 00:00,38.2,44958,3083,117,0,2731,38,5969,5.647.619.048
05/11/2019 01:00,37.76,44091,3026,128,0,2617,37,5808,5.647.619.048
05/11/2019 02:00,37.58,43806,2906,136,0,2553,35,5630,5.647.619.048
05/11/2019 03:00,37.79,44004,2816,145,0,2397,34,5392,5.647.619.048
05/11/2019 04:00,38.71,44828,2822,154,0,2366,33,5375,5.647.619.048
05/11/2019 05:00,40.84,47240,2792,158,0,2332,33,5315,5.647.619.048
05/11/2019 06:00,41.79,51545,2743,163,0,2270,32,5208,5.647.619.048
05/11/2019 07:00,45.22,54872,2619,166,0,2248,28,5061,5.647.619.048
05/11/2019 08:00,49.34,55468,2563,170,0,2133,26,4892,5.647.619.048
05/11/2019 09:00,46.48,55249,2523,175,0,2168,25,4891,5.647.619.048
05/11/2019 10:00,45.82,55117,2447,184,0,2115,23,4769,5.647.619.048
05/11/2019 11:00,45.71,54549,2249,192,0,2048,22,4511,5.647.619.048
05/11/2019 12:00,44.88,53988,2156,201,0,1924,20,4301,5.647.619.048
05/11/2019 13:00,45.57,53875,1977,211,0,1907,20,4115,5.647.619.048
05/11/2019 14:00,46.42,54030,1817,221,0,1992,21,4051,5.647.619.048
05/11/2019 15:00,45.25,54482,1672,228,0,2112,18,4030,5.647.619.048
05/11/2019 16:00,46.59,55530,1530,235,0,2198,19,3982,5.647.619.048
05/11/2019 17:00,51.49,56661,1543,239,0,2214,13,4009,5.647.619.048
05/11/2019 18:00,51.23,56242,1545,242,0,2153,11,3951,5.647.619.048
05/11/2019 19:00,48.39,55203,1477,244,0,2101,11,3833,5.647.619.048
05/11/2019 20:00,44.84,53599,1398,245,0,2008,12,3663,5.647.619.048
05/11/2019 21:00,42.14,52063,1260,245,0,1866,9,3380,5.647.619.048
05/11/2019 22:00,41.11,49781,1049,244,0,1785,8,3086,5.647.619.048
05/11/2019 23:00,39.47,47376,928,244,0,1674,8,2854,5.647.619.048
06/11/2019 00:00,40.39,45863,853,244,0,1651,18,2766,5.647.619.048
06/11/2019 01:00,39.98,44912,791,246,0,1553,16,2606,5.647.619.048
06/11/2019 02:00,39.96,44587,749,247,0,1536,16,2548,5.647.619.048
06/11/2019 03:00,40.19,44778,688,246,0,1508,15,2457,5.647.619.048
06/11/2019 04:00,41.03,45567,648,246,0,1449,16,2359,5.647.619.048
06/11/2019 05:00,41.75,47925,607,245,0,1390,17,2259,5.647.619.048
06/11/2019 06:00,46.9,52233,554,244,0,1441,16,2255,5.647.619.048
06/11/2019 07:00,54.93,55925,502,239,0,1306,14,2061,5.647.619.048
06/11/2019 08:00,59.94,56609,429,230,0,1226,16,1901,5.647.619.048
06/11/2019 09:00,54.92,56388,357,225,0,1087,16,1685,5.647.619.048
06/11/2019 10:00,54.41,56265,305,218,0,932,16,1471,5.647.619.048
06/11/2019 11:00,53.88,55885,257,212,0,851,15,1335,5.647.619.048
06/11/2019 12:00,51.4,55372,246,206,0,783,15,1250,5.647.619.048
06/11/2019 13:00,54.95,55259,231,202,0,723,15,1171,5.647.619.048
06/11/2019 14:00,54.96,55274,212,200,0,726,14,1152,5.647.619.048
06/11/2019 15:00,56.14,55727,201,198,0,802,12,1213,5.647.619.048
06/11/2019 16:00,63.24,56842,179,197,0,882,13,1271,5.647.619.048
06/11/2019 17:00,76.41,57833,153,195,0,1015,14,1377,5.647.619.048
06/11/2019 18:00,84.95,57490,127,189,0,953,11,1280,5.647.619.048
06/11/2019 19:00,63.28,56391,107,181,0,982,10,1280,5.647.619.048
06/11/2019 20:00,53.1,54663,87,174,0,901,9,1171,5.647.619.048
06/11/2019 21:00,46.53,52883,75,167,0,908,7,1157,5.647.619.048
06/11/2019 22:00,43.53,50438,77,158,0,924,6,1165,5.647.619.048
06/11/2019 23:00,41.39,47837,96,152,0,897,7,1152,5.647.619.048
07/11/2019 00:00,41.96,46196,64,161,199,898,5,1327,5.647.619.048
07/11/2019 01:00,41.13,45272,66,161,182,888,5,1302,5.647.619.048
07/11/2019 02:00,40.67,45066,74,163,164,837,4,1242,5.647.619.048
07/11/2019 03:00,40.96,45194,87,163,148,767,3,1168,5.647.619.048
07/11/2019 04:00,42.11,45966,111,165,132,772,3,1183,5.647.619.048
07/11/2019 05:00,43.41,48396,135,165,116,743,3,1162,5.647.619.048
07/11/2019 06:00,46.4,52682,182,164,105,764,3,1218,5.647.619.048
07/11/2019 07:00,56.85,56068,233,158,92,698,3,1184,5.647.619.048
07/11/2019 08:00,59.87,56702,286,153,80,711,4,1234,5.647.619.048
07/11/2019 09:00,52.53,56466,339,152,70,585,3,1149,5.647.619.048
07/11/2019 10:00,49.55,56392,375,150,64,558,3,1150,5.647.619.048
07/11/2019 11:00,48.49,56057,407,146,58,529,3,1143,5.647.619.048
07/11/2019 12:00,47.79,55728,462,140,46,491,3,1142,5.647.619.048
07/11/2019 13:00,50.11,55509,508,141,36,553,3,1241,5.647.619.048
07/11/2019 14:00,50.54,55604,601,146,27,549,3,1326,5.647.619.048
07/11/2019 15:00,50.06,55931,734,149,23,584,3,1493,5.647.619.048
07/11/2019 16:00,54.06,56749,913,153,23,650,4,1743,5.647.619.048
07/11/2019 17:00,56.82,57575,1152,154,26,723,4,2059,5.647.619.048
07/11/2019 18:00,51.28,57012,1408,147,32,889,4,2480,5.647.619.048
07/11/2019 19:00,47.26,55941,1597,136,36,743,4,2516,5.647.619.048
07/11/2019 20:00,44.37,54185,1664,125,36,761,4,2590,5.647.619.048
07/11/2019 21:00,42.55,52713,1756,115,36,764,4,2675,5.647.619.048
07/11/2019 22:00,41.93,50424,1785,106,36,779,3,2709,5.647.619.048
07/11/2019 23:00,41.27,47861,1868,100,35,815,4,2822,5.647.619.048
08/11/2019 00:00,40.03,46404,2061,89,27,937,7,3121,5.647.619.048
08/11/2019 01:00,39.43,45417,2150,86,26,1075,8,3345,5.647.619.048
08/11/2019 02:00,39.23,45007,2198,84,27,1128,8,3445,5.647.619.048
08/11/2019 03:00,39.26,45084,2184,81,28,1134,7,3434,5.647.619.048
08/11/2019 04:00,39.98,45927,2191,77,31,1193,7,3499,5.647.619.048
08/11/2019 05:00,42.12,48192,2183,73,36,1254,8,3554,5.647.619.048
08/11/2019 06:00,45.81,52414,2082,68,48,1349,9,3556,5.647.619.048
08/11/2019 07:00,60.93,56133,1718,58,55,1367,8,3206,5.647.619.048
08/11/2019 08:00,62.77,56792,1624,46,56,1289,8,3023,5.647.619.048
08/11/2019 09:00,57.42,56715,1633,37,57,1224,5,2956,5.647.619.048
08/11/2019 10:00,56.84,56681,1538,30,57,1211,5,2841,5.647.619.048
08/11/2019 11:00,56.83,56144,1393,26,59,1205,5,2688,5.647.619.048
08/11/2019 12:00,55.62,55647,1262,24,61,1219,5,2571,5.647.619.048
08/11/2019 13:00,56.79,55128,1113,24,72,1178,5,2392,5.647.619.048
08/11/2019 14:00,56.75,54848,941,26,101,1192,5,2265,5.647.619.048
08/11/2019 15:00,53.4,55139,782,31,132,1184,9,2138,5.647.619.048
08/11/2019 16:00,52.65,55667,754,33,164,1205,12,2168,5.647.619.048
08/11/2019 17:00,58.84,56410,764,32,178,1192,12,2178,5.647.619.048
08/11/2019 18:00,51.29,55975,796,29,185,1247,12,2269,5.647.619.048
08/11/2019 19:00,47.42,54625,693,25,188,1242,12,2160,5.647.619.048
08/11/2019 20:00,45.08,52659,543,21,185,1204,12,1965,5.647.619.048
08/11/2019 21:00,43.84,51142,437,18,184,1191,11,1841,5.647.619.048
08/11/2019 22:00,42.98,49156,348,16,188,1111,10,1673,5.647.619.048
08/11/2019 23:00,40.64,47172,320,14,184,1242,10,1770,5.647.619.048
09/11/2019 00:00,41.86,45526,253,57,150,1197,5,1662,5.647.619.048
09/11/2019 01:00,40.46,44542,257,68,138,1146,6,1615,5.647.619.048
09/11/2019 02:00,39.71,44130,268,72,131,1259,5,1735,5.647.619.048
09/11/2019 03:00,39.19,43958,291,75,128,1357,5,1856,5.647.619.048
09/11/2019 04:00,39.25,44066,334,85,131,1444,6,2000,5.647.619.048
09/11/2019 05:00,39.45,44808,366,98,136,1581,6,2187,5.647.619.048
09/11/2019 06:00,40.5,46064,398,112,142,1598,6,2256,5.647.619.048
09/11/2019 07:00,41.52,47588,410,123,139,1675,5,2352,5.647.619.048
09/11/2019 08:00,41.97,49023,417,133,127,1740,4,2421,5.647.619.048
09/11/2019 09:00,44.34,50657,432,141,113,1812,4,2502,5.647.619.048
09/11/2019 10:00,43.99,51496,438,146,103,1878,4,2569,5.647.619.048
09/11/2019 11:00,42.74,51609,454,152,96,1940,4,2646,5.647.619.048
09/11/2019 12:00,41.97,51355,486,158,88,1925,4,2661,5.647.619.048
09/11/2019 13:00,41.26,51145,522,160,91,2140,3,2916,5.647.619.048
09/11/2019 14:00,41.17,51263,552,154,104,2299,3,3112,5.647.619.048
09/11/2019 15:00,41.57,52100,617,150,123,2512,4,3406,5.647.619.048
09/11/2019 16:00,43.73,53154,638,148,145,2673,3,3607,5.647.619.048
09/11/2019 17:00,46.49,54338,684,143,180,2721,4,3732,5.647.619.048
09/11/2019 18:00,45.69,54002,704,131,212,2811,6,3864,5.647.619.048
09/11/2019 19:00,44.32,52572,756,114,229,2893,6,3998,5.647.619.048
09/11/2019 20:00,41.81,50924,798,104,231,3036,8,4177,5.647.619.048
09/11/2019 21:00,40.69,49751,763,99,232,3019,11,4124,5.647.619.048
09/11/2019 22:00,39.63,48416,730,93,234,3099,13,4169,5.647.619.048
09/11/2019 23:00,38,46880,755,84,233,3182,14,4268,5.647.619.048
10/11/2019 00:00,39.04,44673,511,64,0,3011,14,3600,5.647.619.048
10/11/2019 01:00,38.74,43918,549,56,0,3066,14,3685,5.647.619.048
10/11/2019 02:00,38.48,43247,590,48,0,2982,19,3639,5.647.619.048
10/11/2019 03:00,38.4,43377,613,39,0,3031,22,3705,5.647.619.048
10/11/2019 04:00,38.58,43581,638,33,0,2991,27,3689,5.647.619.048
10/11/2019 05:00,38.73,44123,627,28,0,2995,27,3677,5.647.619.048
10/11/2019 06:00,38.65,44990,664,24,0,2983,35,3706,5.647.619.048
10/11/2019 07:00,39.06,46316,628,20,0,2911,37,3596,5.647.619.048
10/11/2019 08:00,39.97,47883,587,16,0,2819,39,3461,5.647.619.048
10/11/2019 09:00,40.41,49558,568,16,0,2771,39,3394,5.647.619.048
10/11/2019 10:00,40.92,50571,490,15,0,2644,47,3196,5.647.619.048
10/11/2019 11:00,41,50883,427,14,0,2585,49,3075,5.647.619.048
10/11/2019 12:00,41.33,50731,372,14,0,2450,49,2885,5.647.619.048
10/11/2019 13:00,40.88,50650,343,15,0,2297,46,2701,5.647.619.048
10/11/2019 14:00,41.07,50881,330,19,0,2113,42,2504,5.647.619.048
10/11/2019 15:00,42.37,51658,361,24,0,2082,34,2501,5.647.619.048
10/11/2019 16:00,45.3,53193,376,31,0,2051,27,2485,5.647.619.048
10/11/2019 17:00,50.66,54569,390,37,0,1922,20,2369,5.647.619.048
10/11/2019 18:00,51.46,54454,421,46,0,1830,15,2312,5.647.619.048
10/11/2019 19:00,49.51,53380,463,58,0,1716,16,2253,5.647.619.048
10/11/2019 20:00,47.48,51967,528,72,0,1605,11,2216,5.647.619.048
10/11/2019 21:00,44.79,50933,629,83,0,1550,8,2270,5.647.619.048
10/11/2019 22:00,43.13,49274,776,93,0,1551,8,2428,5.647.619.048
10/11/2019 23:00,40.84,47301,979,99,0,1545,6,2629,5.647.619.048
11/11/2019 00:00,40.18,45713,1643,10,22,1475,3,3153,5.472.440.476
11/11/2019 01:00,39.8,45080,1877,9,22,1552,3,3463,5.472.440.476
11/11/2019 02:00,39.7,44873,1971,9,23,1555,3,3561,5.472.440.476
11/11/2019 03:00,39.75,45170,1930,8,25,1656,3,3622,5.472.440.476
11/11/2019 04:00,40.09,46226,1752,9,27,1745,3,3536,5.472.440.476
11/11/2019 05:00,41.16,48949,1380,10,30,1816,3,3239,5.472.440.476
11/11/2019 06:00,43.98,53563,1176,10,31,1905,3,3125,5.472.440.476
11/11/2019 07:00,47.86,57145,1098,11,31,1906,3,3049,5.472.440.476
11/11/2019 08:00,51.94,57803,1208,11,31,1830,2,3082,5.472.440.476
11/11/2019 09:00,48.06,57596,1572,11,34,1886,2,3505,5.472.440.476
11/11/2019 10:00,47.17,57501,1847,12,36,1805,2,3702,5.472.440.476
11/11/2019 11:00,46.17,57181,2027,13,36,1797,2,3875,5.472.440.476
11/11/2019 12:00,45.3,56698,2175,15,37,1731,2,3960,5.472.440.476
11/11/2019 13:00,46.41,56536,2329,21,40,1719,2,4111,5.472.440.476
11/11/2019 14:00,44.55,56516,2516,28,43,1699,2,4288,5.472.440.476
11/11/2019 15:00,45.24,57218,2731,41,42,1779,2,4595,5.472.440.476
11/11/2019 16:00,45.82,58234,2918,54,40,1949,2,4963,5.472.440.476
11/11/2019 17:00,48.99,58877,3225,64,46,1976,2,5313,5.472.440.476
11/11/2019 18:00,46.15,58194,3498,71,53,2134,2,5758,5.472.440.476
11/11/2019 19:00,42.5,57049,3724,74,65,2393,3,6259,5.472.440.476
11/11/2019 20:00,41.42,55190,3814,79,71,2475,4,6443,5.472.440.476
11/11/2019 21:00,40.92,53410,3910,84,85,2642,6,6727,5.472.440.476
11/11/2019 22:00,40.36,51101,3864,88,98,2732,8,6790,5.472.440.476
11/11/2019 23:00,39.33,48552,3800,85,109,2614,8,6616,5.472.440.476
12/11/2019 00:00,37.98,46786,3737,55,98,2748,11,6649,5.472.440.476
12/11/2019 01:00,37.74,45913,3705,43,109,2696,12,6565,5.472.440.476
12/11/2019 02:00,37.38,45617,3644,34,132,2844,13,6667,5.472.440.476
12/11/2019 03:00,37.34,45803,3636,27,161,2914,17,6755,5.472.440.476
12/11/2019 04:00,38.5,46666,3772,22,193,2978,16,6981,5.472.440.476
12/11/2019 05:00,40.65,49059,3811,18,232,2969,17,7047,5.472.440.476
12/11/2019 06:00,41.48,53417,3789,14,270,2896,19,6988,5.472.440.476
12/11/2019 07:00,43.94,57065,3738,12,296,2904,21,6971,5.472.440.476
12/11/2019 08:00,44.6,57576,3753,12,316,2819,24,6924,5.472.440.476
12/11/2019 09:00,43.3,57429,3833,12,328,2813,24,7010,5.472.440.476
12/11/2019 10:00,42.35,57346,3915,13,332,2690,27,6977,5.472.440.476
12/11/2019 11:00,41.99,56890,3894,15,318,2533,26,6786,5.472.440.476
12/11/2019 12:00,41.91,56535,3932,16,303,2540,27,6818,5.472.440.476
12/11/2019 13:00,42.96,56385,3858,18,288,2606,30,6800,5.472.440.476
12/11/2019 14:00,43.62,56454,3774,20,281,2522,28,6625,5.472.440.476
12/11/2019 15:00,44.48,56984,3641,21,267,2681,30,6640,5.472.440.476
12/11/2019 16:00,46.88,57848,3420,22,265,2840,32,6579,5.472.440.476
12/11/2019 17:00,47.93,58458,3330,22,260,2915,33,6560,5.472.440.476
12/11/2019 18:00,45.43,57720,3310,21,250,2980,32,6593,5.472.440.476
12/11/2019 19:00,42.59,56508,3333,19,240,2912,29,6533,5.472.440.476
12/11/2019 20:00,41.52,54683,3175,20,225,2847,26,6293,5.472.440.476
12/11/2019 21:00,40.95,52990,3067,21,212,2967,21,6288,5.472.440.476
12/11/2019 22:00,40.2,50566,2872,22,203,2876,17,5990,5.472.440.476
12/11/2019 23:00,38.4,47967,2656,25,196,2825,17,5719,5.472.440.476
13/11/2019 00:00,36.57,44548,2220,18,225,2800,13,5276,5.472.440.476
13/11/2019 01:00,36.51,43594,2161,23,226,2704,13,5127,5.472.440.476
13/11/2019 02:00,36.45,43269,2040,28,228,2472,14,4782,5.472.440.476
13/11/2019 03:00,36.61,43436,1876,29,229,2510,13,4657,5.472.440.476
13/11/2019 04:00,38.59,44217,1831,32,234,2351,12,4460,5.472.440.476
13/11/2019 05:00,40.76,46553,1827,37,230,2073,12,4179,5.472.440.476
13/11/2019 06:00,42.19,50698,1863,46,225,2135,15,4284,5.472.440.476
13/11/2019 07:00,45.24,54317,1905,60,218,1924,13,4120,5.472.440.476
13/11/2019 08:00,47.16,54929,1985,73,209,1827,13,4107,5.472.440.476
13/11/2019 09:00,46.11,54671,2099,79,196,1649,13,4036,5.472.440.476
13/11/2019 10:00,45.85,54649,2200,78,178,1431,12,3899,5.472.440.476
13/11/2019 11:00,45.73,54321,2275,74,163,1215,12,3739,5.472.440.476
13/11/2019 12:00,45.65,53976,2371,76,149,1070,11,3677,5.472.440.476
13/11/2019 13:00,47.75,53756,2422,85,144,921,9,3581,5.472.440.476
13/11/2019 14:00,48.45,53833,2446,101,153,803,7,3510,5.472.440.476
13/11/2019 15:00,48.4,54442,2457,118,170,842,7,3594,5.472.440.476
13/11/2019 16:00,49.93,55407,2415,137,180,815,6,3553,5.472.440.476
13/11/2019 17:00,50.03,56104,2413,159,186,812,6,3576,5.472.440.476
13/11/2019 18:00,47.47,55428,2516,181,188,845,7,3737,5.472.440.476
13/11/2019 19:00,46.56,54185,2491,200,184,803,5,3683,5.472.440.476
13/11/2019 20:00,44.35,52359,2240,213,175,765,5,3398,5.472.440.476
13/11/2019 21:00,42.8,50805,2003,216,167,610,4,3000,5.472.440.476
13/11/2019 22:00,41.41,48295,1802,210,162,633,3,2810,5.472.440.476
13/11/2019 23:00,40.69,45756,1591,196,159,569,3,2518,5.472.440.476
14/11/2019 00:00,40.19,43491,1662,173,268,555,5,2663,5.472.440.476
14/11/2019 01:00,39.86,42508,1500,156,298,492,7,2453,5.472.440.476
14/11/2019 02:00,39.52,42175,1232,143,325,445,9,2154,5.472.440.476
14/11/2019 03:00,39.65,42285,990,135,354,394,11,1884,5.472.440.476
14/11/2019 04:00,40.18,43111,861,132,368,404,17,1782,5.472.440.476
14/11/2019 05:00,41.19,45439,829,128,381,418,24,1780,5.472.440.476
14/11/2019 06:00,43.72,49663,831,126,393,441,28,1819,5.472.440.476
14/11/2019 07:00,48.9,53324,788,132,387,441,31,1779,5.472.440.476
14/11/2019 08:00,49.74,53851,791,135,367,406,34,1733,5.472.440.476
14/11/2019 09:00,47.86,53605,859,134,344,384,42,1763,5.472.440.476
14/11/2019 10:00,46.35,53491,894,134,306,372,48,1754,5.472.440.476
14/11/2019 11:00,46.4,53192,854,137,255,369,48,1663,5.472.440.476
14/11/2019 12:00,47.28,52690,878,139,206,364,46,1633,5.472.440.476
14/11/2019 13:00,48.39,52502,915,137,154,377,44,1627,5.472.440.476
14/11/2019 14:00,49.12,52659,862,131,107,438,41,1579,5.472.440.476
14/11/2019 15:00,49.51,53203,837,123,68,538,36,1602,5.472.440.476
14/11/2019 16:00,50.22,54123,866,119,40,643,26,1694,5.472.440.476
14/11/2019 17:00,51.8,54810,989,115,31,728,15,1878,5.472.440.476
14/11/2019 18:00,47.84,54147,1152,113,23,825,9,2122,5.472.440.476
14/11/2019 19:00,44.44,53009,1325,119,18,916,6,2384,5.472.440.476
14/11/2019 20:00,42.65,51250,1445,125,21,999,4,2594,5.472.440.476
14/11/2019 21:00,42.03,49831,1550,131,30,1082,3,2796,5.472.440.476
14/11/2019 22:00,40.92,47625,1547,132,45,1150,3,2877,5.472.440.476
14/11/2019 23:00,40.62,45217,1530,121,63,1192,3,2909,5.472.440.476
15/11/2019 00:00,38.81,44069,1855,113,65,1082,2,3117,5.472.440.476
15/11/2019 01:00,37.95,43103,2040,113,90,1258,4,3505,5.472.440.476
15/11/2019 02:00,37.46,42709,2177,118,115,1241,4,3655,5.472.440.476
15/11/2019 03:00,37.68,42876,2395,122,147,1194,5,3863,5.472.440.476
15/11/2019 04:00,38.28,43754,2620,133,179,1223,10,4165,5.472.440.476
15/11/2019 05:00,40.12,46052,2889,152,198,1336,12,4587,5.472.440.476
15/11/2019 06:00,41.4,50262,3161,172,222,1559,12,5126,5.472.440.476
15/11/2019 07:00,42.33,54066,3358,192,234,1632,11,5427,5.472.440.476
15/11/2019 08:00,42.77,54686,3490,206,237,1674,12,5619,5.472.440.476
15/11/2019 09:00,41.97,54598,3649,214,238,1845,12,5958,5.472.440.476
15/11/2019 10:00,41.69,54600,3851,220,225,1839,12,6147,5.472.440.476
15/11/2019 11:00,41.61,54119,3989,223,207,1914,14,6347,5.472.440.476
15/11/2019 12:00,41.37,53427,4112,229,187,2042,13,6583,5.472.440.476
15/11/2019 13:00,41.61,52955,4166,234,173,2187,12,6772,5.472.440.476
15/11/2019 14:00,42.26,52785,4292,236,176,2158,12,6874,5.472.440.476
15/11/2019 15:00,43.2,53421,4270,234,170,2235,14,6923,5.472.440.476
15/11/2019 16:00,43.93,54114,4123,223,175,2305,15,6841,5.472.440.476
15/11/2019 17:00,44.69,54623,4145,205,179,2345,12,6886,5.472.440.476
15/11/2019 18:00,43.62,53886,4189,177,181,2368,11,6926,5.472.440.476
15/11/2019 19:00,42.3,52424,4232,149,176,2444,12,7013,5.472.440.476
15/11/2019 20:00,41.52,50566,4058,121,166,2453,10,6808,5.472.440.476
15/11/2019 21:00,41.29,49017,3997,93,158,2422,8,6678,5.472.440.476
15/11/2019 22:00,40.16,47163,3790,70,151,2376,7,6394,5.472.440.476
15/11/2019 23:00,39.11,45209,3554,53,141,2381,7,6136,5.472.440.476
16/11/2019 00:00,38.69,43816,3196,90,140,2399,5,5830,5.472.440.476
16/11/2019 01:00,38.94,42759,2946,80,132,2347,4,5509,5.472.440.476
16/11/2019 02:00,38.62,42278,2503,72,131,2331,5,5042,5.472.440.476
16/11/2019 03:00,38.8,42110,2225,65,134,2315,8,4747,5.472.440.476
16/11/2019 04:00,38.79,42218,2123,61,136,2314,7,4641,5.472.440.476
16/11/2019 05:00,38.84,42858,1994,60,141,2360,8,4563,5.472.440.476
16/11/2019 06:00,39.03,44080,1922,59,147,2385,9,4522,5.472.440.476
16/11/2019 07:00,40.01,45668,1805,55,156,2428,8,4452,5.472.440.476
16/11/2019 08:00,41.24,47177,1637,50,168,2496,8,4359,5.472.440.476
16/11/2019 09:00,41.88,48809,1532,48,177,2478,8,4243,5.472.440.476
16/11/2019 10:00,41.63,49741,1478,46,187,2455,7,4173,5.472.440.476
16/11/2019 11:00,41.18,49824,1390,44,199,2534,7,4174,5.472.440.476
16/11/2019 12:00,40.4,49612,1306,41,212,2495,8,4062,5.472.440.476
16/11/2019 13:00,40.25,49395,1260,42,225,2536,9,4072,5.472.440.476
16/11/2019 14:00,40.33,49499,1353,42,238,2628,9,4270,5.472.440.476
16/11/2019 15:00,40.56,50402,1458,45,253,2670,10,4436,5.472.440.476
16/11/2019 16:00,41.55,51586,1449,46,269,2735,13,4512,5.472.440.476
16/11/2019 17:00,42.45,52305,1488,45,273,2788,16,4610,5.472.440.476
16/11/2019 18:00,41.43,51696,1540,44,270,2983,17,4854,5.472.440.476
16/11/2019 19:00,40.11,50140,1682,44,264,3131,16,5137,5.472.440.476
16/11/2019 20:00,39.05,48405,1867,45,260,3106,17,5295,5.472.440.476
16/11/2019 21:00,39.03,47288,2062,46,254,3014,20,5396,5.472.440.476
16/11/2019 22:00,38.34,45818,2260,51,240,3178,21,5750,5.472.440.476
16/11/2019 23:00,37.76,44198,2404,56,210,3186,21,5877,5.472.440.476
17/11/2019 00:00,37.71,42511,2770,33,228,3291,21,6343,5.472.440.476
17/11/2019 01:00,37.44,41586,2763,41,204,3330,19,6357,5.472.440.476
17/11/2019 02:00,37.12,41080,2519,50,173,3260,16,6018,5.472.440.476
17/11/2019 03:00,36.98,40848,2427,61,144,3165,17,5814,5.472.440.476
17/11/2019 04:00,37.08,40921,2320,76,113,3054,18,5581,5.472.440.476
17/11/2019 05:00,37.23,41362,2058,92,86,2896,16,5148,5.472.440.476
17/11/2019 06:00,37.19,42069,1678,105,63,2805,19,4670,5.472.440.476
17/11/2019 07:00,37.64,43334,1549,116,45,2659,14,4383,5.472.440.476
17/11/2019 08:00,38.77,44866,1462,121,34,2392,11,4020,5.472.440.476
17/11/2019 09:00,39.42,46495,1426,119,32,2218,9,3804,5.472.440.476
17/11/2019 10:00,39.98,47519,1183,119,29,2070,5,3406,5.472.440.476
17/11/2019 11:00,40.71,47790,1050,119,31,1755,4,2959,5.472.440.476
17/11/2019 12:00,40.39,47572,794,116,38,1490,3,2441,5.472.440.476
17/11/2019 13:00,40.38,47665,532,110,59,1310,2,2013,5.472.440.476
17/11/2019 14:00,40.36,47680,410,108,83,1090,2,1693,5.472.440.476
17/11/2019 15:00,40.83,48423,335,105,117,961,3,1521,5.472.440.476
17/11/2019 16:00,41.85,49843,297,98,148,914,4,1461,5.472.440.476
17/11/2019 17:00,44.15,50745,307,88,169,765,4,1333,5.472.440.476
17/11/2019 18:00,43.54,50418,356,79,187,651,4,1277,5.472.440.476
17/11/2019 19:00,41.92,49417,517,74,194,618,6,1409,5.472.440.476
17/11/2019 20:00,40.85,48056,701,68,192,701,9,1671,5.472.440.476
17/11/2019 21:00,40.27,47004,814,62,190,694,9,1769,5.472.440.476
17/11/2019 22:00,39.46,45294,942,55,187,770,9,1963,5.472.440.476
17/11/2019 23:00,38.98,43321,1126,48,189,898,8,2269,5.472.440.476
18/11/2019 00:00,38.64,42038,1518,28,168,1055,5,2774,5.335.714.286
18/11/2019 01:00,38.19,41395,1723,19,168,1212,6,3128,5.335.714.286
18/11/2019 02:00,37.95,41160,1965,15,173,1418,6,3577,5.335.714.286
18/11/2019 03:00,38.05,41415,2243,12,183,1621,5,4064,5.335.714.286
18/11/2019 04:00,38.9,42387,2584,9,189,1821,7,4610,5.335.714.286
18/11/2019 05:00,40.18,44868,2791,6,196,2022,9,5024,5.335.714.286
18/11/2019 06:00,41.74,49305,2817,6,205,2241,9,5278,5.335.714.286
18/11/2019 07:00,43.73,52919,2728,7,217,2378,11,5341,5.335.714.286
18/11/2019 08:00,45.3,53563,2503,8,224,2479,10,5224,5.335.714.286
18/11/2019 09:00,45.38,53353,2273,9,227,2562,11,5082,5.335.714.286
18/11/2019 10:00,45.35,53247,2021,11,228,2603,12,4875,5.335.714.286
18/11/2019 11:00,44.95,52908,1773,12,233,2639,12,4669,5.335.714.286
18/11/2019 12:00,44.74,52394,1642,12,237,2709,14,4614,5.335.714.286
18/11/2019 13:00,44.61,52185,1517,16,240,2799,14,4586,5.335.714.286
18/11/2019 14:00,44.82,52225,1533,25,247,2888,15,4708,5.335.714.286
18/11/2019 15:00,45.13,52940,1470,36,250,2980,15,4751,5.335.714.286
18/11/2019 16:00,46,53996,1401,47,257,3060,15,4780,5.335.714.286
18/11/2019 17:00,45.93,54369,1448,54,263,3167,15,4947,5.335.714.286
18/11/2019 18:00,43.64,53426,1563,61,262,3055,17,4958,5.335.714.286
18/11/2019 19:00,41.79,52367,1742,68,252,2913,15,4990,5.335.714.286
18/11/2019 20:00,40.73,50616,1856,73,233,2732,13,4907,5.335.714.286
18/11/2019 21:00,40.37,48929,2014,73,216,2637,13,4953,5.335.714.286
18/11/2019 22:00,39.76,46662,2009,69,206,2542,13,4839,5.335.714.286
18/11/2019 23:00,38.76,44214,1986,62,204,2572,15,4839,5.335.714.286
19/11/2019 00:00,36.45,42550,1961,28,261,2582,24,4856,5.335.714.286
19/11/2019 01:00,35.83,41496,2117,19,250,2583,22,4991,5.335.714.286
19/11/2019 02:00,35.36,41101,2113,13,235,2628,19,5008,5.335.714.286
19/11/2019 03:00,35.22,41228,2215,9,218,2727,19,5188,5.335.714.286
19/11/2019 04:00,36.16,42014,2274,10,202,2727,23,5236,5.335.714.286
19/11/2019 05:00,38.16,44339,2201,12,180,2794,20,5207,5.335.714.286
19/11/2019 06:00,39.95,48477,2015,15,160,2744,20,4954,5.335.714.286
19/11/2019 07:00,42.15,52010,1888,19,146,2741,16,4810,5.335.714.286
19/11/2019 08:00,44,52607,1853,22,123,2752,16,4766,5.335.714.286
19/11/2019 09:00,41.94,52467,1837,23,107,2834,15,4816,5.335.714.286
19/11/2019 10:00,41.59,52487,1804,25,94,2731,10,4664,5.335.714.286
19/11/2019 11:00,41.7,52188,1845,27,86,2860,9,4827,5.335.714.286
19/11/2019 12:00,41.91,51901,1970,30,89,2913,7,5009,5.335.714.286
19/11/2019 13:00,43.56,51903,2047,38,101,2954,9,5149,5.335.714.286
19/11/2019 14:00,43.61,52155,2186,49,132,3060,11,5438,5.335.714.286
19/11/2019 15:00,44.54,52781,2201,58,166,3279,11,5715,5.335.714.286
19/11/2019 16:00,45.68,53654,2119,64,186,3373,15,5757,5.335.714.286
19/11/2019 17:00,46.57,54085,2123,68,193,3416,21,5821,5.335.714.286
19/11/2019 18:00,44.54,53245,2160,71,194,3309,24,5758,5.335.714.286
19/11/2019 19:00,42.36,52078,2105,75,186,3267,24,5657,5.335.714.286
19/11/2019 20:00,41.69,50343,1965,78,170,3089,18,5320,5.335.714.286
19/11/2019 21:00,41.28,48802,1845,81,158,3042,17,5143,5.335.714.286
19/11/2019 22:00,40.54,46693,1633,84,145,2968,13,4843,5.335.714.286
19/11/2019 23:00,39.19,44387,1373,85,133,2649,11,4251,5.335.714.286
20/11/2019 00:00,38.69,42269,880,90,114,2488,10,3582,5.335.714.286
20/11/2019 01:00,38.87,41314,605,93,107,2379,9,3193,5.335.714.286
20/11/2019 02:00,38.66,40980,423,96,108,2128,9,2764,5.335.714.286
20/11/2019 03:00,39.07,41205,327,98,118,1944,9,2496,5.335.714.286
20/11/2019 04:00,39.46,42022,257,103,131,1830,9,2330,5.335.714.286
20/11/2019 05:00,40.89,44435,184,110,149,1760,10,2213,5.335.714.286
20/11/2019 06:00,42.97,48700,131,119,168,1454,6,1878,5.335.714.286
20/11/2019 07:00,46.4,52563,89,125,187,1307,6,1714,5.335.714.286
20/11/2019 08:00,54.84,53144,64,129,197,1238,7,1635,5.335.714.286
20/11/2019 09:00,49.34,52967,72,130,205,1105,8,1520,5.335.714.286
20/11/2019 10:00,47.19,52994,79,126,209,1029,8,1451,5.335.714.286
20/11/2019 11:00,47.13,52729,100,113,219,1026,8,1466,5.335.714.286
20/11/2019 12:00,49.06,52391,133,101,230,993,10,1467,5.335.714.286
20/11/2019 13:00,50.49,52325,170,92,238,1065,11,1576,5.335.714.286
20/11/2019 14:00,49.99,52446,220,85,245,1182,13,1745,5.335.714.286
20/11/2019 15:00,49.7,53044,283,85,257,1358,14,1997,5.335.714.286
20/11/2019 16:00,49.3,53984,384,91,272,1589,14,2350,5.335.714.286
20/11/2019 17:00,53.35,54413,543,96,283,1788,13,2723,5.335.714.286
20/11/2019 18:00,48.6,53657,727,99,295,2039,16,3176,5.335.714.286
20/11/2019 19:00,44.74,52480,887,101,298,2198,17,3501,5.335.714.286
20/11/2019 20:00,42.68,50783,1003,104,299,2292,17,3715,5.335.714.286
20/11/2019 21:00,41.49,49241,1087,102,301,2337,18,3845,5.335.714.286
20/11/2019 22:00,40.03,46869,1076,98,306,2532,19,4031,5.335.714.286
20/11/2019 23:00,38.48,44260,1070,92,313,2660,19,4154,5.335.714.286
21/11/2019 00:00,38.44,42909,1073,92,318,2649,15,4147,5.335.714.286
21/11/2019 01:00,37.57,41979,1049,86,328,2761,16,4240,5.335.714.286
21/11/2019 02:00,37.01,41614,938,83,339,2646,18,4024,5.335.714.286
21/11/2019 03:00,37.47,41720,815,81,348,2610,17,3871,5.335.714.286
21/11/2019 04:00,38.37,42522,706,77,352,2652,16,3803,5.335.714.286
21/11/2019 05:00,39.95,44944,595,75,359,2718,18,3765,5.335.714.286
21/11/2019 06:00,42.1,49251,517,71,365,2618,19,3590,5.335.714.286
21/11/2019 07:00,46.38,53035,501,64,367,2719,19,3670,5.335.714.286
21/11/2019 08:00,46.43,53630,478,56,370,2779,18,3701,5.335.714.286
21/11/2019 09:00,44.51,53347,487,47,379,2898,21,3832,5.335.714.286
21/11/2019 10:00,43.8,53338,454,41,385,2871,23,3774,5.335.714.286
21/11/2019 11:00,43.59,53168,406,35,391,3045,23,3900,5.335.714.286
21/11/2019 12:00,43.7,52851,422,30,397,2891,21,3761,5.335.714.286
21/11/2019 13:00,44.91,52792,451,26,403,2851,22,3753,5.335.714.286
21/11/2019 14:00,44.73,52901,589,26,409,2850,26,3900,5.335.714.286
21/11/2019 15:00,44.65,53541,781,27,415,2801,25,4049,5.335.714.286
21/11/2019 16:00,45.82,54396,1024,30,422,2830,26,4332,5.335.714.286
21/11/2019 17:00,45.86,54739,1270,32,424,2928,32,4686,5.335.714.286
21/11/2019 18:00,44.5,53860,1555,35,428,2921,34,4973,5.335.714.286
21/11/2019 19:00,42.92,52693,1781,37,430,2968,34,5250,5.335.714.286
21/11/2019 20:00,41.52,50913,1883,41,427,2885,34,5270,5.335.714.286
21/11/2019 21:00,40.15,49446,1925,43,425,2781,34,5208,5.335.714.286
21/11/2019 22:00,39.14,47180,1881,44,422,2791,32,5170,5.335.714.286
21/11/2019 23:00,37.02,44722,1801,44,424,2833,31,5133,5.335.714.286
22/11/2019 00:00,35.78,42323,1854,43,420,2933,29,5279,5.335.714.286
22/11/2019 01:00,35.43,41412,1827,45,423,2759,29,5083,5.335.714.286
22/11/2019 02:00,35.47,41051,1811,50,417,2811,27,5116,5.335.714.286
22/11/2019 03:00,35.49,41217,1837,53,417,2810,27,5144,5.335.714.286
22/11/2019 04:00,36.04,42141,1850,57,418,2870,27,5222,5.335.714.286
22/11/2019 05:00,37.6,44609,1823,61,416,2921,27,5248,5.335.714.286
22/11/2019 06:00,40.26,48904,1755,66,417,2852,29,5119,5.335.714.286
22/11/2019 07:00,42.95,52801,1656,74,411,2927,28,5096,5.335.714.286
22/11/2019 08:00,43.75,53538,1619,82,403,2962,28,5094,5.335.714.286
22/11/2019 09:00,42.77,53491,1577,91,400,2804,27,4899,5.335.714.286
22/11/2019 10:00,42.47,53516,1444,93,392,2787,27,4743,5.335.714.286
22/11/2019 11:00,42.44,53184,1253,90,385,2704,27,4459,5.335.714.286
22/11/2019 12:00,42.3,52734,1201,87,374,2587,27,4276,5.335.714.286
22/11/2019 13:00,42.94,52348,1127,85,367,2537,25,4141,5.335.714.286
22/11/2019 14:00,43.06,52300,1102,86,362,2568,25,4143,5.335.714.286
22/11/2019 15:00,42.7,52871,1093,90,355,2588,25,4151,5.335.714.286
22/11/2019 16:00,43.01,53470,1121,97,354,2740,23,4335,5.335.714.286
22/11/2019 17:00,42.98,53720,1233,101,351,2759,23,4467,5.335.714.286
22/11/2019 18:00,41.79,52923,1367,106,344,2715,22,4554,5.335.714.286
22/11/2019 19:00,40.29,51470,1440,105,336,2685,19,4585,5.335.714.286
22/11/2019 20:00,39.55,49364,1468,104,323,2562,17,4474,5.335.714.286
22/11/2019 21:00,39.27,47965,1541,107,316,2422,17,4403,5.335.714.286
22/11/2019 22:00,38.32,46070,1602,104,309,2268,17,4300,5.335.714.286
22/11/2019 23:00,36.16,44064,1638,100,305,2213,17,4273,5.335.714.286
23/11/2019 00:00,35.65,42027,1752,59,296,2194,16,4317,5.335.714.286
23/11/2019 01:00,35.4,40971,1822,58,288,2126,15,4309,5.335.714.286
23/11/2019 02:00,34.87,40607,1908,55,286,1974,13,4236,5.335.714.286
23/11/2019 03:00,34.66,40486,2101,54,293,1909,11,4368,5.335.714.286
23/11/2019 04:00,34.75,40695,2293,52,292,1831,10,4478,5.335.714.286
23/11/2019 05:00,35.26,41430,2446,47,292,1825,11,4621,5.335.714.286
23/11/2019 06:00,35.89,42618,2686,42,290,1877,12,4907,5.335.714.286
23/11/2019 07:00,36.92,44266,2889,35,284,1922,13,5143,5.335.714.286
23/11/2019 08:00,37.96,45977,3039,28,277,2018,13,5375,5.335.714.286
23/11/2019 09:00,38.78,47569,3089,22,272,1987,14,5384,5.335.714.286
23/11/2019 10:00,39.14,48444,3051,17,264,1997,15,5344,5.335.714.286
23/11/2019 11:00,39.15,48602,2978,16,259,1948,13,5214,5.335.714.286
23/11/2019 12:00,39.12,48382,3071,16,253,1943,11,5294,5.335.714.286
23/11/2019 13:00,39.03,48229,3070,18,249,1923,10,5270,5.335.714.286
23/11/2019 14:00,39.04,48491,3233,23,252,1924,11,5443,5.335.714.286
23/11/2019 15:00,39.32,49446,3314,29,250,1982,9,5584,5.335.714.286
23/11/2019 16:00,39.71,50747,3326,35,252,2048,12,5673,5.335.714.286
23/11/2019 17:00,40.36,51407,3489,42,250,2105,12,5898,5.335.714.286
23/11/2019 18:00,40.01,50666,3682,50,242,2169,11,6154,5.335.714.286
23/11/2019 19:00,38.75,49250,3723,56,232,2221,11,6243,5.335.714.286
23/11/2019 20:00,38.39,47571,3645,60,219,2195,11,6130,5.335.714.286
23/11/2019 21:00,38.14,46545,3540,65,209,2137,9,5960,5.335.714.286
23/11/2019 22:00,37.51,45269,3341,75,197,2099,8,5720,5.335.714.286
23/11/2019 23:00,36.33,43708,3288,89,183,2048,7,5615,5.335.714.286
24/11/2019 00:00,35.59,42204,3352,116,189,2108,7,5772,5.335.714.286
24/11/2019 01:00,35.63,41255,3388,124,177,2063,7,5759,5.335.714.286
24/11/2019 02:00,35.36,40770,3389,132,170,2034,6,5731,5.335.714.286
24/11/2019 03:00,34.92,40637,3462,135,171,2017,6,5791,5.335.714.286
24/11/2019 04:00,35.04,40705,3509,132,170,2062,6,5879,5.335.714.286
24/11/2019 05:00,35.64,41253,3468,133,165,2073,7,5846,5.335.714.286
24/11/2019 06:00,35.74,42016,3483,132,162,2034,7,5818,5.335.714.286
24/11/2019 07:00,36.47,43345,3531,129,156,2010,7,5833,5.335.714.286
24/11/2019 08:00,37.31,44805,3566,127,147,2000,8,5848,5.335.714.286
24/11/2019 09:00,38.23,46439,3523,121,140,1992,6,5782,5.335.714.286
24/11/2019 10:00,38.82,47651,3427,117,130,1924,6,5604,5.335.714.286
24/11/2019 11:00,39.74,48144,3273,116,123,1794,5,5311,5.335.714.286
24/11/2019 12:00,39.81,47935,3242,115,116,1691,4,5168,5.335.714.286
24/11/2019 13:00,39.76,47822,3204,106,114,1738,4,5166,5.335.714.286
24/11/2019 14:00,40.05,48110,3311,95,121,1689,6,5222,5.335.714.286
24/11/2019 15:00,40.68,49163,3310,90,127,1714,6,5247,5.335.714.286
24/11/2019 16:00,41.35,50642,3177,87,133,1712,7,5116,5.335.714.286
24/11/2019 17:00,41.42,51466,3206,83,133,1754,11,5187,5.335.714.286
24/11/2019 18:00,40.96,51066,3226,80,133,1770,11,5220,5.335.714.286
24/11/2019 19:00,41.16,50060,3156,78,130,1726,7,5097,5.335.714.286
24/11/2019 20:00,40.92,48714,2938,72,126,1663,7,4806,5.335.714.286
24/11/2019 21:00,40.63,47714,2633,61,123,1526,7,4350,5.335.714.286
24/11/2019 22:00,40.23,46057,2324,45,118,1421,10,3918,5.335.714.286
24/11/2019 23:00,39.29,44058,2181,32,110,1356,7,3686,5.335.714.286
25/11/2019 00:00,39.1,42723,1762,107,110,1253,2,3234,5.163.809.524
25/11/2019 01:00,37.45,42013,1555,106,100,1212,2,2975,5.163.809.524
25/11/2019 02:00,37.18,41721,1353,107,97,1161,1,2719,5.163.809.524
25/11/2019 03:00,36.97,41906,1279,106,101,1153,1,2640,5.163.809.524
25/11/2019 04:00,38.28,42846,1301,107,105,1210,3,2726,5.163.809.524
25/11/2019 05:00,40.62,45427,1380,106,108,1126,4,2724,5.163.809.524
25/11/2019 06:00,43.1,50093,1411,104,113,1096,4,2728,5.163.809.524
25/11/2019 07:00,45.04,53937,1367,102,112,1066,3,2650,5.163.809.524
25/11/2019 08:00,46.08,54612,1328,103,106,995,1,2533,5.163.809.524
25/11/2019 09:00,43.93,54425,1281,103,103,939,3,2429,5.163.809.524
25/11/2019 10:00,43.93,54401,1248,100,98,863,3,2312,5.163.809.524
25/11/2019 11:00,43.98,54204,1131,95,89,756,1,2072,5.163.809.524
25/11/2019 12:00,44.52,53850,1048,88,83,625,2,1846,5.163.809.524
25/11/2019 13:00,45.87,53853,989,82,81,601,2,1755,5.163.809.524
25/11/2019 14:00,46,54058,1031,79,90,603,2,1805,5.163.809.524
25/11/2019 15:00,48.05,54810,1058,84,100,566,2,1810,5.163.809.524
25/11/2019 16:00,49.72,55610,1033,89,110,602,2,1836,5.163.809.524
25/11/2019 17:00,50.53,55761,1076,92,116,593,2,1879,5.163.809.524
25/11/2019 18:00,47.73,54848,1142,91,117,644,2,1996,5.163.809.524
25/11/2019 19:00,43.88,53696,1120,90,114,679,4,2007,5.163.809.524
25/11/2019 20:00,42.94,51846,1085,90,108,647,3,1933,5.163.809.524
25/11/2019 21:00,42.34,50342,995,88,106,626,1,1816,5.163.809.524
25/11/2019 22:00,41.44,48097,887,86,106,545,3,1627,5.163.809.524
25/11/2019 23:00,40.56,45637,814,81,99,461,3,1458,5.163.809.524
26/11/2019 00:00,40.64,44067,706,14,90,433,2,1245,5.163.809.524
26/11/2019 01:00,40.05,42960,681,13,84,404,2,1184,5.163.809.524
26/11/2019 02:00,39.4,42490,624,14,83,454,2,1177,5.163.809.524
26/11/2019 03:00,38.97,42618,596,14,85,407,1,1103,5.163.809.524
26/11/2019 04:00,40.18,43450,612,14,87,410,2,1125,5.163.809.524
26/11/2019 05:00,40.99,45791,654,16,91,423,2,1186,5.163.809.524
26/11/2019 06:00,43.58,50103,685,17,95,481,1,1279,5.163.809.524
26/11/2019 07:00,50,53990,743,18,98,515,2,1376,5.163.809.524
26/11/2019 08:00,57.94,54668,812,18,100,513,2,1445,5.163.809.524
26/11/2019 09:00,49.85,54453,866,16,100,529,3,1514,5.163.809.524
26/11/2019 10:00,47.97,54480,886,14,93,586,2,1581,5.163.809.524
26/11/2019 11:00,47.37,54211,798,12,92,584,2,1488,5.163.809.524
26/11/2019 12:00,48.14,53966,767,11,88,591,2,1459,5.163.809.524
26/11/2019 13:00,49.11,54071,748,11,89,633,2,1483,5.163.809.524
26/11/2019 14:00,48.16,54326,817,13,102,685,2,1619,5.163.809.524
26/11/2019 15:00,49.66,54974,837,17,119,832,3,1808,5.163.809.524
26/11/2019 16:00,51.34,55757,862,20,133,1052,3,2070,5.163.809.524
26/11/2019 17:00,50.32,55958,905,22,146,1143,4,2220,5.163.809.524
26/11/2019 18:00,48.07,55078,913,23,153,1241,4,2334,5.163.809.524
26/11/2019 19:00,44.45,53859,951,25,158,1381,4,2519,5.163.809.524
26/11/2019 20:00,43.44,52088,966,27,159,1377,4,2533,5.163.809.524
26/11/2019 21:00,42.47,50430,924,28,161,1440,5,2558,5.163.809.524
26/11/2019 22:00,41.22,48138,865,26,164,1429,6,2490,5.163.809.524
26/11/2019 23:00,39.69,45631,831,23,162,1429,7,2452,5.163.809.524
27/11/2019 00:00,38.79,43979,1222,25,169,1463,10,2889,5.163.809.524
27/11/2019 01:00,37.75,42967,1225,23,165,1388,10,2811,5.163.809.524
27/11/2019 02:00,37.54,42561,1180,21,166,1365,10,2742,5.163.809.524
27/11/2019 03:00,37.62,42726,1188,18,167,1406,9,2788,5.163.809.524
27/11/2019 04:00,38.64,43595,1198,17,166,1347,8,2736,5.163.809.524
27/11/2019 05:00,40.42,46079,1172,18,163,1369,8,2730,5.163.809.524
27/11/2019 06:00,41.99,50536,1199,20,167,1187,9,2582,5.163.809.524
27/11/2019 07:00,45.06,54532,1296,22,170,1134,9,2631,5.163.809.524
27/11/2019 08:00,49.05,55248,1359,24,170,1057,11,2621,5.163.809.524
27/11/2019 09:00,45.86,55125,1472,27,173,980,11,2663,5.163.809.524
27/11/2019 10:00,44.11,55231,1506,28,159,942,9,2644,5.163.809.524
27/11/2019 11:00,43.99,55060,1538,29,149,939,9,2664,5.163.809.524
27/11/2019 12:00,44.81,54882,1672,29,142,910,9,2762,5.163.809.524
27/11/2019 13:00,44.79,54765,1776,28,141,995,9,2949,5.163.809.524
27/11/2019 14:00,43.75,54933,2021,28,150,1147,9,3355,5.163.809.524
27/11/2019 15:00,43.95,55751,2137,29,158,1387,9,3720,5.163.809.524
27/11/2019 16:00,44.92,56648,2193,31,167,1523,9,3923,5.163.809.524
27/11/2019 17:00,45.94,56880,2216,31,173,1473,9,3902,5.163.809.524
27/11/2019 18:00,43.52,56128,2145,31,177,1640,8,4001,5.163.809.524
27/11/2019 19:00,41.9,54896,2105,33,184,1552,8,3882,5.163.809.524
27/11/2019 20:00,41.2,53059,1987,37,192,1534,8,3758,5.163.809.524
27/11/2019 21:00,40.72,51469,1863,40,202,1551,9,3665,5.163.809.524
27/11/2019 22:00,40.19,49083,1698,43,209,1576,9,3535,5.163.809.524
27/11/2019 23:00,39.19,46378,1499,46,215,1591,9,3360,5.163.809.524
28/11/2019 00:00,38.65,44029,1460,52,207,1469,9,3197,5.163.809.524
28/11/2019 01:00,37.31,43083,1409,55,214,1511,9,3198,5.163.809.524
28/11/2019 02:00,36.8,42614,1325,59,224,1519,9,3136,5.163.809.524
28/11/2019 03:00,36.93,42736,1286,62,229,1512,11,3100,5.163.809.524
28/11/2019 04:00,38,43638,1222,66,236,1556,12,3092,5.163.809.524
28/11/2019 05:00,40.05,46124,1185,73,242,1608,12,3120,5.163.809.524
28/11/2019 06:00,41.31,50488,1171,79,245,1632,14,3141,5.163.809.524
28/11/2019 07:00,43.33,54375,1203,78,245,1683,13,3222,5.163.809.524
28/11/2019 08:00,43.68,55075,1105,76,245,1625,14,3065,5.163.809.524
28/11/2019 09:00,42.67,54842,1055,82,246,1657,16,3056,5.163.809.524
28/11/2019 10:00,42.73,54953,1032,88,238,1796,16,3170,5.163.809.524
28/11/2019 11:00,42.49,54758,1042,90,232,1746,16,3126,5.163.809.524
28/11/2019 12:00,43.27,54445,1030,96,223,1840,16,3205,5.163.809.524
28/11/2019 13:00,43.45,54466,1002,102,220,1902,13,3239,5.163.809.524
28/11/2019 14:00,43,54783,1157,100,228,1998,15,3498,5.163.809.524
28/11/2019 15:00,42.47,55595,1317,101,237,2198,16,3869,5.163.809.524
28/11/2019 16:00,42.49,56365,1553,103,251,2336,16,4259,5.163.809.524
28/11/2019 17:00,42.38,56524,1792,104,262,2410,16,4584,5.163.809.524
28/11/2019 18:00,41.88,55693,1938,106,271,2573,17,4905,5.163.809.524
28/11/2019 19:00,40.91,54586,2120,107,276,2620,17,5140,5.163.809.524
28/11/2019 20:00,40.42,52890,2302,108,272,2797,18,5497,5.163.809.524
28/11/2019 21:00,40.05,51332,2486,107,268,2850,17,5728,5.163.809.524
28/11/2019 22:00,39.21,49106,2753,102,272,3050,19,6196,5.163.809.524
28/11/2019 23:00,37.07,46768,3043,98,274,3195,17,6627,5.163.809.524
29/11/2019 00:00,37.57,45393,3146,98,269,3417,16,6946,5.163.809.524
29/11/2019 01:00,35.95,44489,3444,100,272,3463,16,7295,5.163.809.524
29/11/2019 02:00,35.02,44276,3531,101,278,3725,16,7651,5.163.809.524
29/11/2019 03:00,35.21,44590,3720,101,288,3813,16,7938,5.163.809.524
29/11/2019 04:00,35.73,45689,3831,106,300,4075,16,8328,5.163.809.524
29/11/2019 05:00,39.37,48228,3823,117,310,4150,16,8416,5.163.809.524
29/11/2019 06:00,40.95,52687,3828,128,323,4373,16,8668,5.163.809.524
29/11/2019 07:00,42.26,56829,3840,142,331,4529,17,8859,5.163.809.524
29/11/2019 08:00,42.95,57662,3716,157,328,4365,18,8584,5.163.809.524
29/11/2019 09:00,42.65,57536,3597,170,326,4397,17,8507,5.163.809.524
29/11/2019 10:00,42.41,57519,3473,177,320,4301,23,8294,5.163.809.524
29/11/2019 11:00,42.26,57187,3326,179,307,4324,19,8155,5.163.809.524
29/11/2019 12:00,41.76,56561,3192,181,299,4307,22,8001,5.163.809.524
29/11/2019 13:00,42.47,56098,2984,182,311,4532,21,8030,5.163.809.524
29/11/2019 14:00,42.89,56043,2718,184,323,4666,23,7914,5.163.809.524
29/11/2019 15:00,43.41,56658,2500,186,328,4928,15,7957,5.163.809.524
29/11/2019 16:00,44.06,57501,2366,185,338,5058,17,7964,5.163.809.524
29/11/2019 17:00,44.73,57861,2317,183,344,5050,13,7907,5.163.809.524
29/11/2019 18:00,44.39,57072,2217,185,352,4872,7,7633,5.163.809.524
29/11/2019 19:00,43.07,55704,2038,188,360,4906,27,7519,5.163.809.524
29/11/2019 20:00,42.18,53898,1852,189,372,4892,34,7339,5.163.809.524
29/11/2019 21:00,41.41,52525,1808,190,379,4926,34,7337,5.163.809.524
29/11/2019 22:00,40.81,50812,1607,190,374,4960,33,7164,5.163.809.524
29/11/2019 23:00,39.57,49000,1491,189,354,4899,31,6964,5.163.809.524
30/11/2019 00:00,38.01,47687,1584,74,370,4976,42,7046,5.163.809.524
30/11/2019 01:00,37.63,46620,1442,69,342,4832,41,6726,5.163.809.524
30/11/2019 02:00,37.37,46200,1451,64,310,4626,40,6491,5.163.809.524
30/11/2019 03:00,37.37,46124,1467,59,286,4624,35,6471,5.163.809.524
30/11/2019 04:00,37.42,46370,1486,57,275,4468,35,6321,5.163.809.524
30/11/2019 05:00,37.88,47110,1438,55,266,4362,42,6163,5.163.809.524
30/11/2019 06:00,38.37,48418,1393,55,251,4232,42,5973,5.163.809.524
30/11/2019 07:00,39.95,50178,1503,56,242,4154,43,5998,5.163.809.524
30/11/2019 08:00,40.8,51933,1539,52,235,4201,40,6067,5.163.809.524
30/11/2019 09:00,41.22,53492,1553,48,232,4234,40,6107,5.163.809.524
30/11/2019 10:00,41.39,54326,1400,43,235,4232,40,5950,5.163.809.524
30/11/2019 11:00,41.19,54150,1226,36,248,4274,40,5824,5.163.809.524
30/11/2019 12:00,40.89,53527,1231,31,251,4172,39,5724,5.163.809.524
30/11/2019 13:00,40.59,53285,1144,28,246,4097,36,5551,5.163.809.524
30/11/2019 14:00,40.84,53605,1038,30,230,4109,39,5446,5.163.809.524
30/11/2019 15:00,41.42,54797,922,31,206,4074,32,5265,5.163.809.524
30/11/2019 16:00,43.19,56326,806,32,195,4153,27,5213,5.163.809.524
30/11/2019 17:00,43.28,56984,705,30,191,4036,34,4996,5.163.809.524
30/11/2019 18:00,43.1,56399,658,29,185,3997,27,4896,5.163.809.524
30/11/2019 19:00,42.57,55160,557,27,175,3946,22,4727,5.163.809.524
30/11/2019 20:00,41.65,53672,427,26,164,3810,15,4442,5.163.809.524
30/11/2019 21:00,40.99,52731,362,25,150,3784,11,4332,5.163.809.524
30/11/2019 22:00,40.72,51392,325,24,141,3852,10,4352,5.163.809.524
30/11/2019 23:00,40.18,49825,326,24,129,3935,10,4424,5.163.809.524
01/12/2019 00:00,39.22,48558,517,25,120,4003,21,4686,5.163.809.524
01/12/2019 01:00,38.12,47635,505,26,98,4048,17,4694,5.163.809.524
01/12/2019 02:00,37.63,47118,547,25,80,4172,15,4839,5.163.809.524
01/12/2019 03:00,37.37,46907,594,24,68,4249,11,4946,5.163.809.524
01/12/2019 04:00,37.34,47044,594,22,52,4245,8,4921,5.163.809.524
01/12/2019 05:00,37.49,47545,576,21,43,4294,7,4941,5.163.809.524
01/12/2019 06:00,37.63,48488,578,20,36,4329,5,4968,5.163.809.524
01/12/2019 07:00,38.11,49812,579,18,32,4366,6,5001,5.163.809.524
01/12/2019 08:00,39.57,51224,591,16,31,4341,9,4988,5.163.809.524
01/12/2019 09:00,40.61,52661,616,12,37,4223,9,4897,5.163.809.524
01/12/2019 10:00,41.8,53680,714,10,40,4212,11,4987,5.163.809.524
01/12/2019 11:00,42.01,53876,798,8,48,4249,12,5115,5.163.809.524
01/12/2019 12:00,41.79,53442,905,7,61,4330,11,5314,5.163.809.524
01/12/2019 13:00,41.62,53268,1044,8,72,4443,11,5578,5.163.809.524
01/12/2019 14:00,41.78,53518,1171,11,97,4513,9,5801,5.163.809.524
01/12/2019 15:00,42.11,54602,1314,14,127,4664,9,6128,5.163.809.524
01/12/2019 16:00,42.7,56094,1474,16,153,4625,12,6280,5.163.809.524
01/12/2019 17:00,42.93,56820,1658,17,166,4697,14,6552,5.163.809.524
01/12/2019 18:00,42.85,56420,1777,17,185,4555,16,6550,5.163.809.524
01/12/2019 19:00,42.42,55441,1905,16,202,4559,18,6700,5.163.809.524
01/12/2019 20:00,41.59,54176,1978,14,212,4497,17,6718,5.163.809.524
01/12/2019 21:00,40.61,53156,2091,14,222,4434,16,6777,5.163.809.524
01/12/2019 22:00,39.9,51488,2125,13,224,4489,13,6864,5.163.809.524
01/12/2019 23:00,38.53,49548,2193,13,216,4526,9,6957,5.163.809.524
02/12/2019 00:00,37.8,48021,2756,194,222,4491,8,7671,5.070.119.048
02/12/2019 01:00,37.77,47323,2634,191,209,4485,8,7527,5.070.119.048
02/12/2019 02:00,37.28,47145,2459,191,204,4456,7,7317,5.070.119.048
02/12/2019 03:00,36.3,47412,2552,192,195,4384,8,7331,5.070.119.048
02/12/2019 04:00,37.47,48443,2639,190,183,4201,9,7222,5.070.119.048
02/12/2019 05:00,39.94,51052,2475,189,167,4260,6,7097,5.070.119.048
02/12/2019 06:00,42.21,55674,2403,189,157,4323,5,7077,5.070.119.048
02/12/2019 07:00,45.46,59620,2446,188,149,4335,2,7120,5.070.119.048
02/12/2019 08:00,47.99,60388,2431,186,152,4226,1,6996,5.070.119.048
02/12/2019 09:00,46.57,60056,2418,185,154,4186,0,6943,5.070.119.048
02/12/2019 10:00,43.96,59823,2356,182,151,4139,0,6828,5.070.119.048
02/12/2019 11:00,43.07,59391,2187,178,138,4077,1,6581,5.070.119.048
02/12/2019 12:00,42.1,58714,2154,175,121,4082,2,6534,5.070.119.048
02/12/2019 13:00,42.86,58689,2054,172,112,4137,2,6477,5.070.119.048
02/12/2019 14:00,44.36,59015,1928,173,108,4281,1,6491,5.070.119.048
02/12/2019 15:00,45.78,59860,1743,170,114,4442,1,6470,5.070.119.048
02/12/2019 16:00,47.07,60858,1547,156,126,4563,3,6395,5.070.119.048
02/12/2019 17:00,47.09,61014,1339,149,136,4542,3,6169,5.070.119.048
02/12/2019 18:00,46.15,60166,1210,164,145,4512,4,6035,5.070.119.048
02/12/2019 19:00,44.31,59064,1086,181,150,4394,5,5816,5.070.119.048
02/12/2019 20:00,43.28,57330,988,191,150,4268,6,5603,5.070.119.048
02/12/2019 21:00,42.69,55827,914,194,152,4166,9,5435,5.070.119.048
02/12/2019 22:00,41.53,53703,758,190,150,3988,11,5097,5.070.119.048
02/12/2019 23:00,40.44,51236,649,187,144,3916,14,4910,5.070.119.048
03/12/2019 00:00,39.96,49656,321,110,112,3646,15,4204,5.070.119.048
03/12/2019 01:00,39.43,48711,292,99,111,3432,13,3947,5.070.119.048
03/12/2019 02:00,39.24,48380,302,90,114,3442,18,3966,5.070.119.048
03/12/2019 03:00,38.96,48544,367,86,119,3224,15,3811,5.070.119.048
03/12/2019 04:00,39.69,49317,446,79,121,3116,15,3777,5.070.119.048
03/12/2019 05:00,41.23,51600,562,72,114,3161,19,3928,5.070.119.048
03/12/2019 06:00,43.24,55707,764,66,106,3258,20,4214,5.070.119.048
03/12/2019 07:00,46.38,59556,948,63,96,3463,17,4587,5.070.119.048
03/12/2019 08:00,49.15,60244,1183,60,85,3637,16,4981,5.070.119.048
03/12/2019 09:00,48.5,59795,1510,57,77,3943,15,5602,5.070.119.048
03/12/2019 10:00,45.34,59675,1922,55,77,4230,13,6297,5.070.119.048
03/12/2019 11:00,44.82,59190,2303,55,85,4416,13,6872,5.070.119.048
03/12/2019 12:00,44.66,58749,2677,55,92,4593,15,7432,5.070.119.048
03/12/2019 13:00,44.13,58577,2894,57,99,4674,16,7740,5.070.119.048
03/12/2019 14:00,44.12,58646,3121,57,115,4817,16,8126,5.070.119.048
03/12/2019 15:00,43.91,59129,3104,61,128,4842,16,8151,5.070.119.048
03/12/2019 16:00,44.61,59591,3138,62,147,4962,16,8325,5.070.119.048
03/12/2019 17:00,44.1,59446,3246,59,172,4981,17,8475,5.070.119.048
03/12/2019 18:00,42.82,58319,3270,59,200,5141,21,8691,5.070.119.048
03/12/2019 19:00,41.31,57012,3301,58,236,5065,26,8686,5.070.119.048
03/12/2019 20:00,40.58,55166,3285,58,278,5072,27,8720,5.070.119.048
03/12/2019 21:00,39.8,53556,3191,58,316,5130,33,8728,5.070.119.048
03/12/2019 22:00,39.1,51184,3026,60,334,5233,35,8688,5.070.119.048
03/12/2019 23:00,37.32,48608,2842,63,346,5330,33,8614,5.070.119.048
04/12/2019 00:00,36.3,46044,2621,71,367,5433,43,8535,5.070.119.048
04/12/2019 01:00,36.36,44917,2411,74,376,5377,44,8282,5.070.119.048
04/12/2019 02:00,35.99,44382,2153,81,367,5326,35,7962,5.070.119.048
04/12/2019 03:00,36.1,44468,1945,90,347,5263,22,7667,5.070.119.048
04/12/2019 04:00,37.01,45208,1827,95,321,5155,20,7418,5.070.119.048
04/12/2019 05:00,38.75,47500,1776,97,305,5140,19,7337,5.070.119.048
04/12/2019 06:00,40.42,51648,1745,96,287,5085,22,7235,5.070.119.048
04/12/2019 07:00,42.45,55512,1788,92,279,4874,23,7056,5.070.119.048
04/12/2019 08:00,43.33,56194,1757,87,273,4734,17,6868,5.070.119.048
04/12/2019 09:00,43.02,55806,1899,83,267,4592,17,6858,5.070.119.048
04/12/2019 10:00,41.88,55781,2035,79,268,4456,18,6856,5.070.119.048
04/12/2019 11:00,41.6,55437,2111,76,271,4423,19,6900,5.070.119.048
04/12/2019 12:00,41.8,55061,2176,80,279,4373,20,6928,5.070.119.048
04/12/2019 13:00,41.62,54852,2217,85,288,4383,18,6991,5.070.119.048
04/12/2019 14:00,42.12,55204,2322,79,293,4468,18,7180,5.070.119.048
04/12/2019 15:00,42.57,55935,2263,72,287,4624,21,7267,5.070.119.048
04/12/2019 16:00,43.26,56719,2185,76,288,4796,21,7366,5.070.119.048
04/12/2019 17:00,42.42,56936,2257,83,291,4787,24,7442,5.070.119.048
04/12/2019 18:00,41.75,56179,2431,97,295,4859,22,7704,5.070.119.048
04/12/2019 19:00,40.63,54951,2643,115,304,4944,24,8030,5.070.119.048
04/12/2019 20:00,39.93,53270,2841,135,316,5152,34,8478,5.070.119.048
04/12/2019 21:00,39.38,51735,2945,147,326,5448,36,8902,5.070.119.048
04/12/2019 22:00,38.49,49394,2963,151,332,5478,43,8967,5.070.119.048
04/12/2019 23:00,37.26,46734,2967,148,334,5632,44,9125,5.070.119.048
05/12/2019 00:00,34.11,44335,3203,172,341,5732,47,9495,5.070.119.048
05/12/2019 01:00,32.95,43359,3290,162,342,5728,43,9565,5.070.119.048
05/12/2019 02:00,32.64,42914,3210,155,336,5893,41,9635,5.070.119.048
05/12/2019 03:00,32.94,42995,3045,153,326,5884,44,9452,5.070.119.048
05/12/2019 04:00,34.79,43741,2915,153,320,5809,51,9248,5.070.119.048
05/12/2019 05:00,37.3,46113,2944,155,320,5761,52,9232,5.070.119.048
05/12/2019 06:00,39.28,50403,3054,154,317,5930,57,9512,5.070.119.048
05/12/2019 07:00,40.9,54272,3235,160,314,5979,57,9745,5.070.119.048
05/12/2019 08:00,41.59,54951,3331,170,312,6016,57,9886,5.070.119.048
05/12/2019 09:00,41.17,54547,3444,174,317,6072,56,10063,5.070.119.048
05/12/2019 10:00,40.4,54556,3509,167,318,6166,57,10217,5.070.119.048
05/12/2019 11:00,40.09,54273,3542,156,316,6199,57,10270,5.070.119.048
05/12/2019 12:00,39.99,53923,3651,150,317,6206,58,10382,5.070.119.048
05/12/2019 13:00,40.04,53961,3713,143,316,6213,60,10445,5.070.119.048
05/12/2019 14:00,39.96,54271,3889,130,313,6279,59,10670,5.070.119.048
05/12/2019 15:00,40.59,55128,3896,122,311,6335,58,10722,5.070.119.048
05/12/2019 16:00,40.73,55878,3956,115,315,6368,58,10812,5.070.119.048
05/12/2019 17:00,40.68,56000,4102,115,320,6482,58,11077,5.070.119.048
05/12/2019 18:00,39.7,55189,4249,115,328,6508,60,11260,5.070.119.048
05/12/2019 19:00,38.33,53934,4363,113,335,6584,60,11455,5.070.119.048
05/12/2019 20:00,37.22,52256,4429,118,340,6496,60,11443,5.070.119.048
05/12/2019 21:00,35.75,50743,4402,129,345,6474,60,11410,5.070.119.048
05/12/2019 22:00,33.33,48471,4327,133,348,6393,62,11263,5.070.119.048
05/12/2019 23:00,30.46,46083,4292,135,350,6392,60,11229,5.070.119.048
06/12/2019 00:00,30,44144,4396,151,344,6275,56,11222,5.070.119.048
06/12/2019 01:00,30.38,43102,4477,158,351,6042,56,11084,5.070.119.048
06/12/2019 02:00,29.93,42745,4466,167,358,5905,56,10952,5.070.119.048
06/12/2019 03:00,29.73,42863,4486,181,368,5819,56,10910,5.070.119.048
06/12/2019 04:00,31.22,43510,4470,195,381,5547,56,10649,5.070.119.048
06/12/2019 05:00,34.37,45225,4538,209,398,5275,58,10478,5.070.119.048
06/12/2019 06:00,36.35,48832,4503,216,410,5058,58,10245,5.070.119.048
06/12/2019 07:00,38.9,52719,4378,220,424,4697,59,9778,5.070.119.048
06/12/2019 08:00,40.03,53613,4061,222,430,4603,59,9375,5.070.119.048
06/12/2019 09:00,39.42,53522,3975,219,435,4325,59,9013,5.070.119.048
06/12/2019 10:00,39.27,53566,3889,217,436,4359,59,8960,5.070.119.048
06/12/2019 11:00,39.2,53173,3809,219,433,4503,59,9023,5.070.119.048
06/12/2019 12:00,39.14,52702,3792,222,427,4293,59,8793,5.070.119.048
06/12/2019 13:00,38.97,52395,3755,226,417,4496,59,8953,5.070.119.048
06/12/2019 14:00,38.98,52505,3832,232,409,4476,59,9008,5.070.119.048
06/12/2019 15:00,38.94,53285,3784,237,395,4644,59,9119,5.070.119.048
06/12/2019 16:00,39.37,53851,3761,238,388,4419,59,8865,5.070.119.048
06/12/2019 17:00,39.93,53864,3883,238,379,4327,58,8885,5.070.119.048
06/12/2019 18:00,38.82,52668,3984,239,368,4383,56,9030,5.070.119.048
06/12/2019 19:00,37.63,51376,3967,239,357,4235,56,8854,5.070.119.048
06/12/2019 20:00,36.33,49828,3889,237,341,4316,56,8839,5.070.119.048
06/12/2019 21:00,35.65,48548,3775,236,333,4318,56,8718,5.070.119.048
06/12/2019 22:00,34.63,46979,3756,234,327,4315,56,8688,5.070.119.048
06/12/2019 23:00,33.01,45093,3779,232,322,4214,53,8600,5.070.119.048
07/12/2019 00:00,32.29,43786,3920,206,278,4190,48,8642,5.070.119.048
07/12/2019 01:00,31.93,42648,3731,204,275,4039,51,8300,5.070.119.048
07/12/2019 02:00,31.01,42076,3601,198,278,3953,51,8081,5.070.119.048
07/12/2019 03:00,30.01,41867,3734,195,287,3848,50,8114,5.070.119.048
07/12/2019 04:00,30.02,42078,3960,187,294,3741,51,8233,5.070.119.048
07/12/2019 05:00,30.42,42794,4049,179,307,3691,48,8274,5.070.119.048
07/12/2019 06:00,31.94,43943,4074,169,317,3523,47,8130,5.070.119.048
07/12/2019 07:00,34.1,45652,4150,155,323,3535,48,8211,5.070.119.048
07/12/2019 08:00,35.22,47483,4089,139,328,3604,48,8208,5.070.119.048
07/12/2019 09:00,36.67,49063,4128,123,335,3774,48,8408,5.070.119.048
07/12/2019 10:00,36.99,50190,4117,112,337,3896,46,8508,5.070.119.048
07/12/2019 11:00,37.05,50332,4140,107,342,4149,48,8786,5.070.119.048
07/12/2019 12:00,36.66,50185,4156,104,350,4362,48,9020,5.070.119.048
07/12/2019 13:00,36.47,50127,4077,104,364,4532,46,9123,5.070.119.048
07/12/2019 14:00,37.03,50448,4029,100,380,4801,49,9359,5.070.119.048
07/12/2019 15:00,38.09,51497,3735,91,386,4865,48,9125,5.070.119.048
07/12/2019 16:00,38.99,52809,3391,83,398,4972,48,8892,5.070.119.048
07/12/2019 17:00,40.17,53370,3052,77,407,5135,54,8725,5.070.119.048
07/12/2019 18:00,40.25,52714,2688,79,423,5200,55,8445,5.070.119.048
07/12/2019 19:00,38.97,51418,2328,81,431,5164,54,8058,5.070.119.048
07/12/2019 20:00,37.26,49981,1961,89,433,5106,54,7643,5.070.119.048
07/12/2019 21:00,36.42,49071,1674,97,430,4986,54,7241,5.070.119.048
07/12/2019 22:00,35.6,47830,1525,100,424,4889,53,6991,5.070.119.048
07/12/2019 23:00,33.79,46370,1592,95,413,4750,52,6902,5.070.119.048
08/12/2019 00:00,32.3,44689,2401,88,428,4454,52,7423,5.070.119.048
08/12/2019 01:00,31.66,43931,2833,80,401,4244,51,7609,5.070.119.048
08/12/2019 02:00,30.63,43597,3279,85,366,4089,50,7869,5.070.119.048
08/12/2019 03:00,30.01,43546,3766,95,329,3864,38,8092,5.070.119.048
08/12/2019 04:00,29.5,43767,4166,104,286,3727,33,8316,5.070.119.048
08/12/2019 05:00,29.52,44338,4356,122,260,3647,29,8414,5.070.119.048
08/12/2019 06:00,30.52,45210,4367,132,232,3747,29,8507,5.070.119.048
08/12/2019 07:00,31.76,46666,4432,137,223,3772,28,8592,5.070.119.048
08/12/2019 08:00,33.4,48157,4313,145,241,3777,27,8503,5.070.119.048
08/12/2019 09:00,34.8,49678,4434,153,257,3762,21,8627,5.070.119.048
08/12/2019 10:00,36.02,50885,4476,162,279,3745,23,8685,5.070.119.048
08/12/2019 11:00,36.55,51439,4488,174,304,3725,24,8715,5.070.119.048
08/12/2019 12:00,35.81,51373,4512,182,338,3813,28,8873,5.070.119.048
08/12/2019 13:00,36.13,51310,4489,187,370,3987,31,9064,5.070.119.048
08/12/2019 14:00,36.13,51561,4545,192,398,4150,44,9329,5.070.119.048
08/12/2019 15:00,36.95,52527,4387,196,424,4429,54,9490,5.070.119.048
08/12/2019 16:00,37.74,53615,4291,199,441,4487,54,9472,5.070.119.048
08/12/2019 17:00,37.95,54024,4242,195,451,4635,55,9578,5.070.119.048
08/12/2019 18:00,37.67,53493,4204,185,459,4633,55,9536,5.070.119.048
08/12/2019 19:00,37.25,52410,4228,171,463,4677,55,9594,5.070.119.048
08/12/2019 20:00,35.95,51025,4225,151,461,4772,55,9664,5.070.119.048
08/12/2019 21:00,34.5,50028,4221,129,456,4858,55,9719,5.070.119.048
08/12/2019 22:00,33.48,48475,4143,113,452,4918,54,9680,5.070.119.048
08/12/2019 23:00,30.02,46520,4048,100,448,4997,54,9647,5.070.119.048
09/12/2019 00:00,28.37,44426,3881,235,441,4978,51,9586,4.951.607.143
09/12/2019 01:00,25.79,43708,3778,231,435,4936,50,9430,4.951.607.143
09/12/2019 02:00,21.4,43427,3802,228,429,4880,49,9388,4.951.607.143
09/12/2019 03:00,26.69,43743,3875,227,422,4914,51,9489,4.951.607.143
09/12/2019 04:00,31.53,44623,4085,225,415,4899,51,9675,4.951.607.143
09/12/2019 05:00,34.8,47125,4130,222,407,4806,51,9616,4.951.607.143
09/12/2019 06:00,36.66,51657,4095,218,398,4790,52,9553,4.951.607.143
09/12/2019 07:00,38.52,55568,4168,213,386,4725,51,9543,4.951.607.143
09/12/2019 08:00,39.99,56383,4089,209,383,4402,50,9133,4.951.607.143
09/12/2019 09:00,39.77,56141,4061,205,378,4274,50,8968,4.951.607.143
09/12/2019 10:00,39.53,56101,4023,202,370,4119,51,8765,4.951.607.143
09/12/2019 11:00,39.69,55901,3982,200,367,3935,50,8534,4.951.607.143
09/12/2019 12:00,39.92,55573,3875,199,356,3847,50,8327,4.951.607.143
09/12/2019 13:00,39.94,55650,3821,198,346,3775,50,8190,4.951.607.143
09/12/2019 14:00,40.02,56052,3832,198,327,3723,50,8130,4.951.607.143
09/12/2019 15:00,39.69,56902,3791,200,304,3925,50,8270,4.951.607.143
09/12/2019 16:00,40.28,57642,3871,200,296,4154,48,8569,4.951.607.143
09/12/2019 17:00,40.78,57785,4085,197,296,4419,48,9045,4.951.607.143
09/12/2019 18:00,39.38,57036,4248,190,300,4560,50,9348,4.951.607.143
09/12/2019 19:00,37.95,55952,4256,182,301,4759,50,9548,4.951.607.143
09/12/2019 20:00,37.07,54403,4283,172,300,4920,49,9724,4.951.607.143
09/12/2019 21:00,36.78,53116,4236,162,303,5021,47,9769,4.951.607.143
09/12/2019 22:00,35.99,51074,4091,154,301,5099,42,9687,4.951.607.143
09/12/2019 23:00,34.54,48678,3859,145,298,5099,41,9442,4.951.607.143
10/12/2019 00:00,34.31,47230,3492,258,284,5333,40,9407,4.951.607.143
10/12/2019 01:00,34.32,46251,3276,256,276,5207,38,9053,4.951.607.143
10/12/2019 02:00,34.3,45952,2899,255,271,5287,43,8755,4.951.607.143
10/12/2019 03:00,34.87,46168,2459,254,265,5214,35,8227,4.951.607.143
10/12/2019 04:00,35.73,47156,2016,251,259,4773,28,7327,4.951.607.143
10/12/2019 05:00,37.98,49712,1557,248,248,4406,19,6478,4.951.607.143
10/12/2019 06:00,41.25,53995,1025,248,229,3978,14,5494,4.951.607.143
10/12/2019 07:00,46.83,58115,692,247,207,3445,16,4607,4.951.607.143
10/12/2019 08:00,47.78,59017,436,244,184,2886,27,3777,4.951.607.143
10/12/2019 09:00,47.34,58693,353,240,170,2349,42,3154,4.951.607.143
10/12/2019 10:00,47.35,58778,467,235,165,1830,33,2730,4.951.607.143
10/12/2019 11:00,47.33,58522,801,229,168,1273,24,2495,4.951.607.143
10/12/2019 12:00,47.14,58122,1322,222,176,1036,31,2787,4.951.607.143
10/12/2019 13:00,46.47,58056,1750,215,187,923,34,3109,4.951.607.143
10/12/2019 14:00,45.71,58761,2293,207,196,1034,26,3756,4.951.607.143
10/12/2019 15:00,44.42,59659,2765,200,200,1689,26,4880,4.951.607.143
10/12/2019 16:00,44.61,60556,3392,194,193,2199,23,6001,4.951.607.143
10/12/2019 17:00,42.31,60854,3892,190,169,2949,22,7222,4.951.607.143
10/12/2019 18:00,39.72,60115,4056,188,135,3818,15,8212,4.951.607.143
10/12/2019 19:00,38.77,59008,4058,187,105,4490,13,8853,4.951.607.143
10/12/2019 20:00,37.68,57378,4095,187,79,5093,10,9464,4.951.607.143
10/12/2019 21:00,36.88,56057,4079,185,57,5662,7,9990,4.951.607.143
10/12/2019 22:00,35.92,53502,4088,180,38,6194,6,10506,4.951.607.143
10/12/2019 23:00,34.58,50964,4048,166,32,6576,6,10828,4.951.607.143
11/12/2019 00:00,30.71,48473,4153,174,20,6961,11,11319,4.951.607.143
11/12/2019 01:00,28.92,47401,4223,155,23,7137,13,11551,4.951.607.143
11/12/2019 02:00,23.72,46814,4425,131,39,7216,18,11829,4.951.607.143
11/12/2019 03:00,25.02,46778,4506,124,67,7281,23,12001,4.951.607.143
11/12/2019 04:00,30.22,47441,4290,124,97,7315,27,11853,4.951.607.143
11/12/2019 05:00,33.13,49546,4091,115,127,7301,28,11662,4.951.607.143
11/12/2019 06:00,35.97,53380,3803,107,153,7267,30,11360,4.951.607.143
11/12/2019 07:00,37.9,57117,3544,102,178,7120,34,10978,4.951.607.143
11/12/2019 08:00,39.23,57722,3195,98,201,6816,37,10347,4.951.607.143
11/12/2019 09:00,39.4,57214,2921,94,217,6491,38,9761,4.951.607.143
11/12/2019 10:00,39.34,57165,2650,87,226,6130,38,9131,4.951.607.143
11/12/2019 11:00,39.54,56776,2392,80,231,5743,42,8488,4.951.607.143
11/12/2019 12:00,39.68,56503,2137,75,229,5384,40,7865,4.951.607.143
11/12/2019 13:00,39.72,56381,1885,68,231,5039,40,7263,4.951.607.143
11/12/2019 14:00,39.7,56624,1822,64,239,4751,40,6916,4.951.607.143
11/12/2019 15:00,39.89,57193,1701,60,252,4566,38,6617,4.951.607.143
11/12/2019 16:00,39.95,57626,1631,49,261,4507,35,6483,4.951.607.143
11/12/2019 17:00,39.88,57876,1624,39,271,4330,36,6300,4.951.607.143
11/12/2019 18:00,39.72,57203,1633,28,282,4301,34,6278,4.951.607.143
11/12/2019 19:00,39.19,55985,1693,18,286,4169,33,6199,4.951.607.143
11/12/2019 20:00,38.95,54285,1753,13,286,4049,33,6134,4.951.607.143
11/12/2019 21:00,38.5,52796,1751,10,285,3967,32,6045,4.951.607.143
11/12/2019 22:00,37.33,50493,1738,9,284,3927,30,5988,4.951.607.143
11/12/2019 23:00,36.46,48042,1663,15,279,3825,30,5812,4.951.607.143
12/12/2019 00:00,34.89,45227,928,37,282,3748,30,5025,4.951.607.143
12/12/2019 01:00,35.4,44042,834,49,270,3785,30,4968,4.951.607.143
12/12/2019 02:00,35.02,43629,794,60,256,3619,27,4756,4.951.607.143
12/12/2019 03:00,34.77,43684,782,74,240,3448,27,4571,4.951.607.143
12/12/2019 04:00,35.42,44603,796,94,228,3519,26,4663,4.951.607.143
12/12/2019 05:00,36.9,47392,908,120,217,3347,26,4618,4.951.607.143
12/12/2019 06:00,38.73,52057,1050,146,216,3244,19,4675,4.951.607.143
12/12/2019 07:00,40.01,55880,1198,169,220,3083,19,4689,4.951.607.143
12/12/2019 08:00,41,56729,1309,187,225,3097,23,4841,4.951.607.143
12/12/2019 09:00,41.06,56325,1398,203,221,3047,19,4888,4.951.607.143
12/12/2019 10:00,40.92,56306,1339,215,219,2906,14,4693,4.951.607.143
12/12/2019 11:00,40.56,56100,1297,222,221,2711,12,4463,4.951.607.143
12/12/2019 12:00,40.6,55797,1379,229,222,2618,13,4461,4.951.607.143
12/12/2019 13:00,40.6,55904,1416,234,225,2598,16,4489,4.951.607.143
12/12/2019 14:00,40.52,56233,1455,240,227,2459,17,4398,4.951.607.143
12/12/2019 15:00,40.89,57076,1467,244,235,2414,18,4378,4.951.607.143
12/12/2019 16:00,40.61,57665,1572,245,247,2446,19,4529,4.951.607.143
12/12/2019 17:00,40.55,57718,1731,244,260,2578,20,4833,4.951.607.143
12/12/2019 18:00,40.3,56840,1891,240,261,2547,21,4960,4.951.607.143
12/12/2019 19:00,38.84,55694,2112,234,256,2575,22,5199,4.951.607.143
12/12/2019 20:00,37.72,54141,2281,228,244,2667,23,5443,4.951.607.143
12/12/2019 21:00,36.89,52704,2336,220,229,2725,25,5535,4.951.607.143
12/12/2019 22:00,35.98,50246,2370,212,217,2641,25,5465,4.951.607.143
12/12/2019 23:00,34.74,47722,2462,204,205,2497,21,5389,4.951.607.143
13/12/2019 00:00,33.5,45467,3055,204,211,2504,25,5999,4.951.607.143
13/12/2019 01:00,32.98,44450,3348,203,199,2465,22,6237,4.951.607.143
13/12/2019 02:00,32.19,44119,3697,206,199,2630,19,6751,4.951.607.143
13/12/2019 03:00,32,44216,3949,204,200,2639,18,7010,4.951.607.143
13/12/2019 04:00,33.42,45080,4116,197,209,2708,17,7247,4.951.607.143
13/12/2019 05:00,35.35,47467,4290,195,225,2757,18,7485,4.951.607.143
13/12/2019 06:00,36.48,51826,4330,198,243,2820,16,7607,4.951.607.143
13/12/2019 07:00,38.2,55988,4390,194,267,2822,16,7689,4.951.607.143
13/12/2019 08:00,39.1,56944,4311,177,298,2651,16,7453,4.951.607.143
13/12/2019 09:00,39.43,56702,4305,160,325,2731,15,7536,4.951.607.143
13/12/2019 10:00,38.56,56732,4256,152,344,2500,17,7269,4.951.607.143
13/12/2019 11:00,38.26,56183,4191,136,349,2467,22,7165,4.951.607.143
13/12/2019 12:00,38.62,55563,4139,119,356,2441,24,7079,4.951.607.143
13/12/2019 13:00,38.56,55189,4054,108,366,2394,30,6952,4.951.607.143
13/12/2019 14:00,38.25,55317,4060,110,373,2368,32,6943,4.951.607.143
13/12/2019 15:00,38.66,56059,3840,119,373,2347,33,6712,4.951.607.143
13/12/2019 16:00,39.07,56555,3637,125,379,2342,32,6515,4.951.607.143
13/12/2019 17:00,39.42,56542,3520,132,383,2340,31,6406,4.951.607.143
13/12/2019 18:00,38.96,55430,3261,135,383,2305,29,6113,4.951.607.143
13/12/2019 19:00,38.28,53911,2916,136,382,2231,29,5694,4.951.607.143
13/12/2019 20:00,37.45,52030,2621,137,380,2229,28,5395,4.951.607.143
13/12/2019 21:00,36.54,50481,2362,138,379,2142,27,5048,4.951.607.143
13/12/2019 22:00,35.75,48683,2168,138,374,2049,28,4757,4.951.607.143
13/12/2019 23:00,34.87,46708,2070,134,373,2023,28,4628,4.951.607.143
14/12/2019 00:00,35.22,44636,1546,142,356,1888,28,3960,4.951.607.143
14/12/2019 01:00,34.3,43579,1537,146,359,2037,27,4106,4.951.607.143
14/12/2019 02:00,33.72,43096,1589,153,360,2064,28,4194,4.951.607.143
14/12/2019 03:00,33.23,42973,1706,168,363,2258,26,4521,4.951.607.143
14/12/2019 04:00,33.27,43170,1816,187,358,2459,25,4845,4.951.607.143
14/12/2019 05:00,33.17,43879,1911,203,362,2576,27,5079,4.951.607.143
14/12/2019 06:00,33.58,44974,1981,219,369,2695,28,5292,4.951.607.143
14/12/2019 07:00,34.13,46817,2042,230,372,2721,28,5393,4.951.607.143
14/12/2019 08:00,34.88,48637,1916,238,378,2795,28,5355,4.951.607.143
14/12/2019 09:00,35.89,50145,1952,243,387,2692,31,5305,4.951.607.143
14/12/2019 10:00,35.98,51118,2200,246,390,2771,31,5638,4.951.607.143
14/12/2019 11:00,35.89,51230,2367,245,388,2720,31,5751,4.951.607.143
14/12/2019 12:00,36.07,51026,2479,242,382,2652,31,5786,4.951.607.143
14/12/2019 13:00,36.2,50803,2614,240,375,2619,31,5879,4.951.607.143
14/12/2019 14:00,36.11,51105,2825,237,371,2716,35,6184,4.951.607.143
14/12/2019 15:00,36.48,52188,2890,231,361,2791,36,6309,4.951.607.143
14/12/2019 16:00,36.91,53267,3035,225,358,2798,35,6451,4.951.607.143
14/12/2019 17:00,37.27,53687,3261,216,343,2751,31,6602,4.951.607.143
14/12/2019 18:00,36.7,52971,3503,205,327,2764,31,6830,4.951.607.143
14/12/2019 19:00,36.19,51493,3703,197,310,2724,31,6965,4.951.607.143
14/12/2019 20:00,35.36,49655,3933,188,287,2740,31,7179,4.951.607.143
14/12/2019 21:00,34.14,48596,4081,186,269,2597,27,7160,4.951.607.143
14/12/2019 22:00,33.62,47174,4136,185,254,2650,24,7249,4.951.607.143
14/12/2019 23:00,32.45,45509,4174,185,237,2679,19,7294,4.951.607.143
15/12/2019 00:00,33.15,43699,4275,183,179,2668,18,7323,4.951.607.143
15/12/2019 01:00,32.78,42755,4277,190,163,2643,19,7292,4.951.607.143
15/12/2019 02:00,32.58,42338,4197,200,160,2682,20,7259,4.951.607.143
15/12/2019 03:00,32.53,42257,3932,207,170,2586,16,6911,4.951.607.143
15/12/2019 04:00,32.32,42359,3599,200,199,2636,19,6653,4.951.607.143
15/12/2019 05:00,31.71,42767,3336,186,243,2565,15,6345,4.951.607.143
15/12/2019 06:00,31.97,43660,3076,171,287,2553,19,6106,4.951.607.143
15/12/2019 07:00,32.4,45145,3150,159,310,2599,20,6238,4.951.607.143
15/12/2019 08:00,33.25,46608,3538,149,323,2551,23,6584,4.951.607.143
15/12/2019 09:00,34.67,48109,3977,138,341,2444,21,6921,4.951.607.143
15/12/2019 10:00,35.44,49449,4225,134,343,2391,22,7115,4.951.607.143
15/12/2019 11:00,35.67,50003,4252,138,341,2348,28,7107,4.951.607.143
15/12/2019 12:00,35.69,49994,4286,141,339,2365,36,7167,4.951.607.143
15/12/2019 13:00,35.68,50027,4265,142,326,2369,38,7140,4.951.607.143
15/12/2019 14:00,35.8,50499,4498,142,289,2445,40,7414,4.951.607.143
15/12/2019 15:00,36.3,51590,4504,148,259,2465,38,7414,4.951.607.143
15/12/2019 16:00,36.5,52628,4523,170,270,2490,29,7482,4.951.607.143
15/12/2019 17:00,36.82,53131,4518,198,302,2474,20,7512,4.951.607.143
15/12/2019 18:00,36.67,52638,4402,219,339,2428,27,7415,4.951.607.143
15/12/2019 19:00,36.46,51723,4182,235,367,2366,34,7184,4.951.607.143
15/12/2019 20:00,35.97,50225,3965,249,375,2297,42,6928,4.951.607.143
15/12/2019 21:00,35.42,49237,3675,256,393,2263,40,6627,4.951.607.143
15/12/2019 22:00,35.07,47637,3454,258,403,2251,44,6410,4.951.607.143
15/12/2019 23:00,34.03,45584,3244,256,409,2255,51,6215,4.951.607.143
16/12/2019 00:00,34.46,44281,3381,128,455,2117,55,6136,4.803.333.333
16/12/2019 01:00,34.21,43486,3187,137,464,2144,56,5988,4.803.333.333
16/12/2019 02:00,34.14,43266,3057,142,468,2114,56,5837,4.803.333.333
16/12/2019 03:00,34.45,43535,2932,147,467,2131,56,5733,4.803.333.333
16/12/2019 04:00,35.44,44537,2892,144,466,2137,56,5695,4.803.333.333
16/12/2019 05:00,36.9,47032,2914,134,465,2135,56,5704,4.803.333.333
16/12/2019 06:00,39.41,51587,2853,124,462,2170,56,5665,4.803.333.333
16/12/2019 07:00,41.9,55756,2955,116,453,2179,56,5759,4.803.333.333
16/12/2019 08:00,44.88,56743,3040,111,431,2189,55,5826,4.803.333.333
16/12/2019 09:00,43.17,56590,3153,107,397,2193,51,5901,4.803.333.333
16/12/2019 10:00,41.22,56646,3181,102,368,2192,49,5892,4.803.333.333
16/12/2019 11:00,40.86,56418,3255,94,338,2126,37,5850,4.803.333.333
16/12/2019 12:00,41.97,56112,3246,91,302,2061,24,5724,4.803.333.333
16/12/2019 13:00,42,56165,3088,90,268,2095,22,5563,4.803.333.333
16/12/2019 14:00,42.15,56604,2956,88,236,2130,25,5435,4.803.333.333
16/12/2019 15:00,44.08,57327,2715,91,211,2226,25,5268,4.803.333.333
16/12/2019 16:00,44.67,57888,2528,95,198,2265,28,5114,4.803.333.333
16/12/2019 17:00,44.67,57895,2318,100,201,2314,28,4961,4.803.333.333
16/12/2019 18:00,42.99,56898,2102,105,204,2233,27,4671,4.803.333.333
16/12/2019 19:00,41.08,55664,1854,108,207,2069,31,4269,4.803.333.333
16/12/2019 20:00,40.14,53916,1494,108,205,1966,31,3804,4.803.333.333
16/12/2019 21:00,39.05,52395,1218,108,204,1972,31,3533,4.803.333.333
16/12/2019 22:00,37.84,50190,1044,110,199,1890,31,3274,4.803.333.333
16/12/2019 23:00,36.75,47433,918,112,187,1816,26,3059,4.803.333.333
17/12/2019 00:00,36.21,45431,964,161,183,1671,29,3008,4.803.333.333
17/12/2019 01:00,35.75,44390,714,160,155,1648,23,2700,4.803.333.333
17/12/2019 02:00,35.65,44085,598,148,141,1573,23,2483,4.803.333.333
17/12/2019 03:00,35.78,44264,532,121,128,1460,17,2258,4.803.333.333
17/12/2019 04:00,36.16,45183,527,92,116,1402,16,2153,4.803.333.333
17/12/2019 05:00,37.13,47683,591,69,105,1353,12,2130,4.803.333.333
17/12/2019 06:00,38.14,52123,599,58,95,1249,10,2011,4.803.333.333
17/12/2019 07:00,40.86,56446,674,59,86,1244,8,2071,4.803.333.333
17/12/2019 08:00,43.76,57313,749,70,80,1192,7,2098,4.803.333.333
17/12/2019 09:00,41.63,56949,830,99,78,1159,8,2174,4.803.333.333
17/12/2019 10:00,40.14,57018,888,127,76,1134,8,2233,4.803.333.333
17/12/2019 11:00,39.27,56653,957,137,76,1084,7,2261,4.803.333.333
17/12/2019 12:00,39.42,56455,1039,150,76,1019,7,2291,4.803.333.333
17/12/2019 13:00,39.63,56460,1165,155,80,987,6,2393,4.803.333.333
17/12/2019 14:00,40.12,56828,1368,147,93,1101,6,2715,4.803.333.333
17/12/2019 15:00,41.51,57598,1598,140,107,1147,6,2998,4.803.333.333
17/12/2019 16:00,42,58078,1904,129,119,1253,7,3412,4.803.333.333
17/12/2019 17:00,41.24,58080,2195,119,123,1234,7,3678,4.803.333.333
17/12/2019 18:00,39.19,57152,2361,109,127,1396,7,4000,4.803.333.333
17/12/2019 19:00,37.95,55902,2515,108,128,1567,8,4326,4.803.333.333
17/12/2019 20:00,37.15,54003,2573,112,142,1677,9,4513,4.803.333.333
17/12/2019 21:00,37.26,52521,2795,119,157,1898,8,4977,4.803.333.333
17/12/2019 22:00,36.91,50143,2923,126,164,1931,9,5153,4.803.333.333
17/12/2019 23:00,36.1,47547,3119,132,165,1968,15,5399,4.803.333.333
18/12/2019 00:00,35.1,45758,2503,189,202,1986,22,4902,4.803.333.333
18/12/2019 01:00,34.49,44667,2776,189,197,2042,25,5229,4.803.333.333
18/12/2019 02:00,34.26,44130,3017,180,195,2120,26,5538,4.803.333.333
18/12/2019 03:00,34.29,44230,3023,173,195,2221,26,5638,4.803.333.333
18/12/2019 04:00,35.31,45110,2923,166,211,2317,26,5643,4.803.333.333
18/12/2019 05:00,36.7,47538,2916,154,244,2437,28,5779,4.803.333.333
18/12/2019 06:00,37.75,51865,2797,140,277,2531,29,5774,4.803.333.333
18/12/2019 07:00,40.33,55984,2757,123,314,2582,34,5810,4.803.333.333
18/12/2019 08:00,42.46,56910,2744,109,348,2640,45,5886,4.803.333.333
18/12/2019 09:00,42.93,56586,2855,102,391,2674,48,6070,4.803.333.333
18/12/2019 10:00,40.67,56721,2924,94,421,2759,49,6247,4.803.333.333
18/12/2019 11:00,40.24,56451,2997,84,444,2873,49,6447,4.803.333.333
18/12/2019 12:00,40.17,56186,2943,69,452,3177,50,6691,4.803.333.333
18/12/2019 13:00,40.13,56203,2695,60,453,3384,50,6642,4.803.333.333
18/12/2019 14:00,40.29,56509,2379,55,438,3573,49,6494,4.803.333.333
18/12/2019 15:00,40.49,57358,1956,50,409,3731,44,6190,4.803.333.333
18/12/2019 16:00,41.09,57959,1685,47,380,3894,39,6045,4.803.333.333
18/12/2019 17:00,40.96,58105,1484,43,365,3956,37,5885,4.803.333.333
18/12/2019 18:00,40.49,57417,1246,43,358,4143,38,5828,4.803.333.333
18/12/2019 19:00,39.82,56212,1063,46,351,4150,37,5647,4.803.333.333
18/12/2019 20:00,39.11,54371,963,46,352,4066,37,5464,4.803.333.333
18/12/2019 21:00,38.06,52909,915,44,357,4028,37,5381,4.803.333.333
18/12/2019 22:00,36.85,50629,937,41,356,4006,39,5379,4.803.333.333
18/12/2019 23:00,35.02,48092,1022,38,348,3973,37,5418,4.803.333.333
19/12/2019 00:00,35.2,46458,1340,47,402,3877,45,5711,4.803.333.333
19/12/2019 01:00,34.87,45467,1419,54,389,3707,36,5605,4.803.333.333
19/12/2019 02:00,34.58,45128,1574,67,362,3563,31,5597,4.803.333.333
19/12/2019 03:00,34.77,45365,1774,87,319,3352,29,5561,4.803.333.333
19/12/2019 04:00,35.33,46269,2044,105,288,3195,26,5658,4.803.333.333
19/12/2019 05:00,36.38,48932,2541,125,254,2987,21,5928,4.803.333.333
19/12/2019 06:00,37.31,53438,3007,144,214,2902,22,6289,4.803.333.333
19/12/2019 07:00,39.35,57577,3433,156,172,2763,19,6543,4.803.333.333
19/12/2019 08:00,40.6,58700,3705,169,138,2620,19,6651,4.803.333.333
19/12/2019 09:00,40.02,58312,3923,191,109,2771,11,7005,4.803.333.333
19/12/2019 10:00,38.11,58288,3890,214,91,2781,6,6982,4.803.333.333
19/12/2019 11:00,37.81,57799,3763,231,78,2688,5,6765,4.803.333.333
19/12/2019 12:00,37.74,57324,3566,240,65,2555,5,6431,4.803.333.333
19/12/2019 13:00,37.84,57265,3340,256,56,2761,5,6418,4.803.333.333
19/12/2019 14:00,38.37,57591,3222,270,47,2715,5,6259,4.803.333.333
19/12/2019 15:00,39.08,58412,3032,269,55,2883,5,6244,4.803.333.333
19/12/2019 16:00,39.98,58953,3038,269,64,2986,6,6363,4.803.333.333
19/12/2019 17:00,39.91,59004,3101,268,85,3152,8,6614,4.803.333.333
19/12/2019 18:00,39.2,58006,3163,266,107,3211,11,6758,4.803.333.333
19/12/2019 19:00,37.96,56659,3146,266,132,3260,12,6816,4.803.333.333
19/12/2019 20:00,36.92,54801,3059,271,162,3249,12,6753,4.803.333.333
19/12/2019 21:00,36.29,53174,2985,273,194,3128,15,6595,4.803.333.333
19/12/2019 22:00,35.3,50769,2977,269,212,3171,12,6641,4.803.333.333
19/12/2019 23:00,34.14,48193,3041,258,220,2919,14,6452,4.803.333.333
20/12/2019 00:00,34.21,46172,3216,228,256,2613,19,6332,4.803.333.333
20/12/2019 01:00,34.13,44993,3089,215,264,2414,19,6001,4.803.333.333
20/12/2019 02:00,34.07,44570,2930,206,268,2204,19,5627,4.803.333.333
20/12/2019 03:00,33.77,44625,2708,198,274,2077,20,5277,4.803.333.333
20/12/2019 04:00,34.79,45483,2584,192,277,1791,20,4864,4.803.333.333
20/12/2019 05:00,35.96,47840,2606,186,270,1512,19,4593,4.803.333.333
20/12/2019 06:00,36.7,52000,2560,182,262,1323,19,4346,4.803.333.333
20/12/2019 07:00,37.74,56100,2628,178,254,1312,18,4390,4.803.333.333
20/12/2019 08:00,38.39,56964,2739,165,247,1235,13,4399,4.803.333.333
20/12/2019 09:00,38.35,56579,2994,150,236,1178,14,4572,4.803.333.333
20/12/2019 10:00,37.92,56467,3121,140,229,1076,14,4580,4.803.333.333
20/12/2019 11:00,37.93,56009,3254,131,230,993,14,4622,4.803.333.333
20/12/2019 12:00,37.95,55439,3456,114,233,947,12,4762,4.803.333.333
20/12/2019 13:00,37.77,55044,3564,99,233,995,10,4901,4.803.333.333
20/12/2019 14:00,37.66,55165,3756,86,237,1071,11,5161,4.803.333.333
20/12/2019 15:00,37.54,55753,3754,72,247,1252,14,5339,4.803.333.333
20/12/2019 16:00,37.57,56117,3781,63,254,1440,15,5553,4.803.333.333
20/12/2019 17:00,37.56,56065,3710,58,266,1622,16,5672,4.803.333.333
20/12/2019 18:00,37.62,54998,3540,55,273,1779,19,5666,4.803.333.333
20/12/2019 19:00,36.96,53458,3388,56,274,1758,19,5495,4.803.333.333
20/12/2019 20:00,36.1,51613,3288,60,267,1897,22,5534,4.803.333.333
20/12/2019 21:00,35.9,50275,3170,64,262,1750,23,5269,4.803.333.333
20/12/2019 22:00,34.94,48482,3034,68,259,1729,21,5111,4.803.333.333
20/12/2019 23:00,33.84,46475,2899,71,253,1617,20,4860,4.803.333.333
21/12/2019 00:00,33.24,43932,2577,114,0,1682,21,4394,4.803.333.333
21/12/2019 01:00,33.29,42885,2346,115,0,1570,22,4053,4.803.333.333
21/12/2019 02:00,32.81,42273,2240,118,0,1452,20,3830,4.803.333.333
21/12/2019 03:00,33.04,42109,2207,123,0,1511,20,3861,4.803.333.333
21/12/2019 04:00,33.17,42247,2279,132,0,1455,20,3886,4.803.333.333
21/12/2019 05:00,32.93,42927,2406,142,0,1306,20,3874,4.803.333.333
21/12/2019 06:00,33.33,44152,2301,152,0,1249,20,3722,4.803.333.333
21/12/2019 07:00,34.51,46051,2288,160,0,1227,20,3695,4.803.333.333
21/12/2019 08:00,34.91,47877,2232,165,0,1279,20,3696,4.803.333.333
21/12/2019 09:00,35.88,49004,2196,167,0,1266,20,3649,4.803.333.333
21/12/2019 10:00,36.06,49917,1983,167,0,1088,18,3256,4.803.333.333
21/12/2019 11:00,36.3,50081,1710,166,0,1061,12,2949,4.803.333.333
21/12/2019 12:00,36.23,49826,1581,166,0,934,11,2692,4.803.333.333
21/12/2019 13:00,36.15,49622,1468,170,0,1001,10,2649,4.803.333.333
21/12/2019 14:00,36.77,49887,1397,176,0,986,12,2571,4.803.333.333
21/12/2019 15:00,37.42,50809,1269,181,0,914,12,2376,4.803.333.333
21/12/2019 16:00,38.2,51862,1307,188,0,883,12,2390,4.803.333.333
21/12/2019 17:00,38.35,52257,1451,195,0,799,13,2458,4.803.333.333
21/12/2019 18:00,37.78,51574,1607,196,0,764,12,2579,4.803.333.333
21/12/2019 19:00,36.94,50170,1679,195,0,740,11,2625,4.803.333.333
21/12/2019 20:00,35.9,48428,1754,193,0,790,11,2748,4.803.333.333
21/12/2019 21:00,35.68,47394,1747,191,0,789,11,2738,4.803.333.333
21/12/2019 22:00,35.13,46015,1733,186,0,735,9,2663,4.803.333.333
21/12/2019 23:00,34.47,44194,1739,177,0,723,10,2649,4.803.333.333
22/12/2019 00:00,34.98,42185,1556,161,88,665,15,2485,4.803.333.333
22/12/2019 01:00,34.91,41142,1543,150,62,655,18,2428,4.803.333.333
22/12/2019 02:00,34.58,40709,1665,137,38,650,13,2503,4.803.333.333
22/12/2019 03:00,34.57,40677,1731,123,24,660,10,2548,4.803.333.333
22/12/2019 04:00,34.41,41031,1720,110,15,654,10,2509,4.803.333.333
22/12/2019 05:00,34.24,41855,1694,103,15,658,8,2478,4.803.333.333
22/12/2019 06:00,34.27,43111,1722,100,14,716,8,2560,4.803.333.333
22/12/2019 07:00,34.97,44683,1781,96,16,722,7,2622,4.803.333.333
22/12/2019 08:00,35.53,46218,1836,91,21,690,8,2646,4.803.333.333
22/12/2019 09:00,36.28,47502,1939,84,30,728,6,2787,4.803.333.333
22/12/2019 10:00,37.11,48610,1930,77,41,708,4,2760,4.803.333.333
22/12/2019 11:00,37.57,49066,1901,70,50,802,4,2827,4.803.333.333
22/12/2019 12:00,37.56,49029,1815,67,61,760,3,2706,4.803.333.333
22/12/2019 13:00,37.09,49059,1807,68,67,843,3,2788,4.803.333.333
22/12/2019 14:00,37.4,49363,1916,75,78,808,3,2880,4.803.333.333
22/12/2019 15:00,37.66,50361,2036,83,87,841,3,3050,4.803.333.333
22/12/2019 16:00,38.46,51369,2083,93,91,852,3,3122,4.803.333.333
22/12/2019 17:00,38.83,51943,2110,105,92,829,3,3139,4.803.333.333
22/12/2019 18:00,38.29,51469,1986,117,92,847,4,3046,4.803.333.333
22/12/2019 19:00,37.37,50562,1910,130,87,862,4,2993,4.803.333.333
22/12/2019 20:00,36.3,49174,1794,145,74,812,5,2830,4.803.333.333
22/12/2019 21:00,36.09,48174,1788,154,62,797,5,2806,4.803.333.333
22/12/2019 22:00,35.82,46548,1718,158,59,777,5,2717,4.803.333.333
22/12/2019 23:00,35.09,44528,1633,163,57,750,7,2610,4.803.333.333
23/12/2019 00:00,33.67,41486,1742,77,53,794,3,2669,4.687.440.476
23/12/2019 01:00,33.89,40634,1598,85,48,737,5,2473,4.687.440.476
23/12/2019 02:00,33.69,40354,1427,90,37,721,6,2281,4.687.440.476
23/12/2019 03:00,33.77,40398,1271,98,36,716,8,2129,4.687.440.476
23/12/2019 04:00,34.91,40936,1174,110,39,688,6,2017,4.687.440.476
23/12/2019 05:00,35.58,42480,1161,117,41,651,5,1975,4.687.440.476
23/12/2019 06:00,36.14,45697,1105,119,45,660,4,1933,4.687.440.476
23/12/2019 07:00,36.87,49263,1076,122,33,592,4,1827,4.687.440.476
23/12/2019 08:00,37.5,50806,1076,121,23,529,5,1754,4.687.440.476
23/12/2019 09:00,37.69,51353,1266,114,17,522,5,1924,4.687.440.476
23/12/2019 10:00,37.43,51655,1585,104,13,479,4,2185,4.687.440.476
23/12/2019 11:00,37.29,51603,1744,95,11,436,3,2289,4.687.440.476
23/12/2019 12:00,37.25,51408,1876,83,9,403,3,2374,4.687.440.476
23/12/2019 13:00,37.17,51372,1883,77,9,393,2,2364,4.687.440.476
23/12/2019 14:00,37.23,51835,1845,74,11,402,3,2335,4.687.440.476
23/12/2019 15:00,37.68,52738,1808,68,12,398,3,2289,4.687.440.476
23/12/2019 16:00,38.07,53506,1762,62,12,444,3,2283,4.687.440.476
23/12/2019 17:00,39.09,53606,1725,60,13,439,3,2240,4.687.440.476
23/12/2019 18:00,39.55,52656,1756,63,13,456,3,2291,4.687.440.476
23/12/2019 19:00,37.95,51472,1722,67,12,450,2,2253,4.687.440.476
23/12/2019 20:00,36.87,49932,1672,72,9,491,2,2246,4.687.440.476
23/12/2019 21:00,36.31,48750,1697,75,9,514,2,2297,4.687.440.476
23/12/2019 22:00,35.76,47032,1789,75,9,518,2,2393,4.687.440.476
23/12/2019 23:00,34.87,44761,1776,70,10,588,2,2446,4.687.440.476
24/12/2019 00:00,35.04,42275,1703,8,2,652,3,2368,4.687.440.476
24/12/2019 01:00,34.67,41030,1767,11,2,701,3,2484,4.687.440.476
24/12/2019 02:00,33.74,40468,1772,15,2,730,3,2522,4.687.440.476
24/12/2019 03:00,33.41,40408,1857,19,3,698,2,2579,4.687.440.476
24/12/2019 04:00,33.5,40655,1942,22,4,662,2,2632,4.687.440.476
24/12/2019 05:00,34.61,41491,2059,21,7,569,2,2658,4.687.440.476
24/12/2019 06:00,35.4,42919,2027,21,11,509,2,2570,4.687.440.476
24/12/2019 07:00,35.7,44967,2058,20,15,493,2,2588,4.687.440.476
24/12/2019 08:00,36.38,47075,2047,20,20,470,2,2559,4.687.440.476
24/12/2019 09:00,37.04,48832,2028,19,27,440,2,2516,4.687.440.476
24/12/2019 10:00,36.61,49828,1915,16,40,412,2,2385,4.687.440.476
24/12/2019 11:00,36.99,50005,1755,16,53,403,2,2229,4.687.440.476
24/12/2019 12:00,37.13,49588,1539,17,72,400,2,2030,4.687.440.476
24/12/2019 13:00,37.2,49140,1286,21,81,368,3,1759,4.687.440.476
24/12/2019 14:00,37.2,49164,978,23,78,342,4,1425,4.687.440.476
24/12/2019 15:00,37.64,49704,740,24,85,327,3,1179,4.687.440.476
24/12/2019 16:00,38.45,49990,627,24,86,310,3,1050,4.687.440.476
24/12/2019 17:00,38.75,48850,576,22,88,309,2,997,4.687.440.476
24/12/2019 18:00,37.37,47221,552,21,88,301,2,964,4.687.440.476
24/12/2019 19:00,36,46035,551,19,87,294,3,954,4.687.440.476
24/12/2019 20:00,35.77,45165,538,17,85,272,3,915,4.687.440.476
24/12/2019 21:00,35.72,44978,563,15,83,260,4,925,4.687.440.476
24/12/2019 22:00,35.74,44469,605,15,80,253,4,957,4.687.440.476
24/12/2019 23:00,35.17,43614,598,14,77,255,4,948,4.687.440.476
25/12/2019 00:00,34.37,41090,343,6,58,208,5,620,4.687.440.476
25/12/2019 01:00,34.19,40508,304,6,53,209,4,576,4.687.440.476
25/12/2019 02:00,33.98,40160,297,6,50,204,5,562,4.687.440.476
25/12/2019 03:00,33.92,40093,336,6,51,206,6,605,4.687.440.476
25/12/2019 04:00,34.14,40313,395,6,45,205,5,656,4.687.440.476
25/12/2019 05:00,35.12,40862,485,6,39,213,5,748,4.687.440.476
25/12/2019 06:00,35.21,41577,572,6,34,228,5,845,4.687.440.476
25/12/2019 07:00,35.22,42677,716,5,34,254,3,1012,4.687.440.476
25/12/2019 08:00,35.67,43817,818,4,35,273,4,1134,4.687.440.476
25/12/2019 09:00,35.99,45027,774,4,34,291,4,1107,4.687.440.476
25/12/2019 10:00,35.62,46282,723,4,34,294,4,1059,4.687.440.476
25/12/2019 11:00,35.8,46694,751,4,36,323,4,1118,4.687.440.476
25/12/2019 12:00,36.29,46620,910,5,37,357,4,1313,4.687.440.476
25/12/2019 13:00,36.19,46670,1147,6,39,456,4,1652,4.687.440.476
25/12/2019 14:00,36.14,47025,1325,6,45,489,3,1868,4.687.440.476
25/12/2019 15:00,36.44,47896,1492,8,60,534,3,2097,4.687.440.476
25/12/2019 16:00,37.25,48659,1589,8,66,608,3,2274,4.687.440.476
25/12/2019 17:00,37.4,48719,1666,9,68,658,2,2403,4.687.440.476
25/12/2019 18:00,37.33,48172,1746,9,69,709,2,2535,4.687.440.476
25/12/2019 19:00,36.33,47537,1868,9,69,686,2,2634,4.687.440.476
25/12/2019 20:00,35.51,46699,1888,9,64,748,2,2711,4.687.440.476
25/12/2019 21:00,35.15,46038,1933,9,61,808,2,2813,4.687.440.476
25/12/2019 22:00,35.18,44862,1902,8,59,803,2,2774,4.687.440.476
25/12/2019 23:00,33.99,43265,1819,8,56,909,2,2794,4.687.440.476
26/12/2019 00:00,34.35,41845,1855,7,48,952,1,2863,4.687.440.476
26/12/2019 01:00,34.12,40888,1783,8,41,1045,1,2878,4.687.440.476
26/12/2019 02:00,33.6,40441,1692,10,38,1032,2,2774,4.687.440.476
26/12/2019 03:00,33.5,40413,1547,10,37,1182,2,2778,4.687.440.476
26/12/2019 04:00,33.9,40696,1326,11,33,1176,2,2548,4.687.440.476
26/12/2019 05:00,34.71,41634,1121,12,28,1111,2,2274,4.687.440.476
26/12/2019 06:00,35.02,43581,886,12,24,1130,2,2054,4.687.440.476
26/12/2019 07:00,35.51,45959,677,12,22,1148,2,1861,4.687.440.476
26/12/2019 08:00,35.82,47280,527,14,21,1130,2,1694,4.687.440.476
26/12/2019 09:00,36.3,47884,434,16,21,1195,2,1668,4.687.440.476
26/12/2019 10:00,36.15,48543,359,19,23,1156,2,1559,4.687.440.476
26/12/2019 11:00,36.56,48734,311,20,26,1121,2,1480,4.687.440.476
26/12/2019 12:00,36.63,48612,277,22,29,1109,2,1439,4.687.440.476
26/12/2019 13:00,36.62,48509,238,24,33,1000,3,1298,4.687.440.476
26/12/2019 14:00,37.19,48867,207,26,35,1099,3,1370,4.687.440.476
26/12/2019 15:00,38.54,49793,210,28,40,1167,4,1449,4.687.440.476
26/12/2019 16:00,39.84,50591,212,29,44,1218,4,1507,4.687.440.476
26/12/2019 17:00,40.48,50598,192,27,49,1207,4,1479,4.687.440.476
26/12/2019 18:00,40.12,50011,179,26,61,1202,4,1472,4.687.440.476
26/12/2019 19:00,38.84,49258,176,27,65,1148,6,1422,4.687.440.476
26/12/2019 20:00,37.2,48253,185,28,67,1182,6,1468,4.687.440.476
26/12/2019 21:00,36.74,47372,214,28,68,1252,9,1571,4.687.440.476
26/12/2019 22:00,36.42,45997,223,28,74,1295,8,1628,4.687.440.476
26/12/2019 23:00,35.11,44542,225,28,78,1344,9,1684,4.687.440.476
27/12/2019 00:00,34.13,43326,415,18,74,1436,5,1948,4.687.440.476
27/12/2019 01:00,33.98,42578,455,17,79,1504,7,2062,4.687.440.476
27/12/2019 02:00,33.76,42274,482,16,81,1476,6,2061,4.687.440.476
27/12/2019 03:00,33.77,42413,485,15,90,1532,7,2129,4.687.440.476
27/12/2019 04:00,34.11,42953,543,16,97,1568,16,2240,4.687.440.476
27/12/2019 05:00,35.51,44397,645,17,103,1617,11,2393,4.687.440.476
27/12/2019 06:00,36.1,48159,696,18,107,1559,10,2390,4.687.440.476
27/12/2019 07:00,37.77,51414,716,19,115,1541,9,2400,4.687.440.476
27/12/2019 08:00,38.81,53087,739,19,122,1571,8,2459,4.687.440.476
27/12/2019 09:00,39.53,53781,773,19,133,1521,9,2455,4.687.440.476
27/12/2019 10:00,38.98,54234,696,19,150,1429,9,2303,4.687.440.476
27/12/2019 11:00,39.54,54315,573,18,161,1319,11,2082,4.687.440.476
27/12/2019 12:00,40,54171,520,17,169,1201,12,1919,4.687.440.476
27/12/2019 13:00,39.96,54090,462,18,175,1088,13,1756,4.687.440.476
27/12/2019 14:00,40.99,54510,467,19,184,1041,11,1722,4.687.440.476
27/12/2019 15:00,42.44,55432,537,20,196,975,10,1738,4.687.440.476
27/12/2019 16:00,43.13,56203,500,24,206,1001,12,1743,4.687.440.476
27/12/2019 17:00,45.48,56559,403,25,214,986,12,1640,4.687.440.476
27/12/2019 18:00,42.09,55881,352,27,219,1007,11,1616,4.687.440.476
27/12/2019 19:00,39.98,54697,350,30,222,1105,14,1721,4.687.440.476
27/12/2019 20:00,38.16,53144,420,34,224,1160,15,1853,4.687.440.476
27/12/2019 21:00,36.63,52017,514,37,235,1310,18,2114,4.687.440.476
27/12/2019 22:00,35.73,50276,478,40,240,1449,15,2222,4.687.440.476
27/12/2019 23:00,34.69,48742,362,41,241,1685,13,2342,4.687.440.476
28/12/2019 00:00,33.92,48645,308,83,304,1969,15,2679,4.687.440.476
28/12/2019 01:00,33.42,47683,294,80,301,2187,14,2876,4.687.440.476
28/12/2019 02:00,33.09,47260,295,80,283,2538,15,3211,4.687.440.476
28/12/2019 03:00,33.01,47232,308,79,269,2916,14,3586,4.687.440.476
28/12/2019 04:00,32.9,47525,337,79,265,3146,14,3841,4.687.440.476
28/12/2019 05:00,32.66,48243,389,78,259,3333,11,4070,4.687.440.476
28/12/2019 06:00,33,49370,443,78,252,3282,11,4066,4.687.440.476
28/12/2019 07:00,33.37,51161,569,81,246,3293,10,4199,4.687.440.476
28/12/2019 08:00,34.6,53287,722,82,239,3502,8,4553,4.687.440.476
28/12/2019 09:00,35.51,54982,859,83,227,3434,9,4612,4.687.440.476
28/12/2019 10:00,35.6,56068,987,82,224,3433,9,4735,4.687.440.476
28/12/2019 11:00,35.05,56198,1121,82,224,3319,7,4753,4.687.440.476
28/12/2019 12:00,34.69,55872,1266,79,218,3134,6,4703,4.687.440.476
28/12/2019 13:00,34.61,55581,1363,74,205,3033,4,4679,4.687.440.476
28/12/2019 14:00,34.94,55853,1448,69,180,3118,4,4819,4.687.440.476
28/12/2019 15:00,35.82,56815,1539,68,160,3083,4,4854,4.687.440.476
28/12/2019 16:00,36.89,57973,1588,65,150,3078,5,4886,4.687.440.476
28/12/2019 17:00,36.81,58351,1721,61,145,3455,5,5387,4.687.440.476
28/12/2019 18:00,36.23,57543,1919,57,138,3643,5,5762,4.687.440.476
28/12/2019 19:00,35.53,55905,2116,55,121,3915,4,6211,4.687.440.476
28/12/2019 20:00,34.97,53979,2282,54,103,4181,3,6623,4.687.440.476
28/12/2019 21:00,34.53,52647,2474,54,88,4290,2,6908,4.687.440.476
28/12/2019 22:00,33.91,51057,2648,56,75,4501,2,7282,4.687.440.476
28/12/2019 23:00,32.41,49163,2805,58,60,4779,2,7704,4.687.440.476
29/12/2019 00:00,32,46462,2800,51,44,4864,1,7760,4.687.440.476
29/12/2019 01:00,31.34,45486,2809,53,33,5102,1,7998,4.687.440.476
29/12/2019 02:00,30.85,44947,2813,54,22,5288,1,8178,4.687.440.476
29/12/2019 03:00,30.1,44712,2759,56,15,5461,2,8293,4.687.440.476
29/12/2019 04:00,29.98,44674,2744,60,12,5547,3,8366,4.687.440.476
29/12/2019 05:00,30.01,44887,2939,66,11,5592,4,8612,4.687.440.476
29/12/2019 06:00,30.33,45673,3001,73,12,5510,6,8602,4.687.440.476
29/12/2019 07:00,30.09,46950,3131,79,17,5518,5,8750,4.687.440.476
29/12/2019 08:00,30.08,48322,3216,78,28,5581,5,8908,4.687.440.476
29/12/2019 09:00,30.99,49752,3343,75,40,5708,6,9172,4.687.440.476
29/12/2019 10:00,31.91,50949,3421,70,59,5589,9,9148,4.687.440.476
29/12/2019 11:00,32.2,51417,3442,62,72,5708,11,9295,4.687.440.476
29/12/2019 12:00,32.62,51325,3504,50,92,5723,13,9382,4.687.440.476
29/12/2019 13:00,31.66,51190,3555,41,114,5774,16,9500,4.687.440.476
29/12/2019 14:00,31.81,51447,3685,33,148,5909,23,9798,4.687.440.476
29/12/2019 15:00,33.11,52275,3887,25,184,6000,30,10126,4.687.440.476
29/12/2019 16:00,33.72,53203,4016,20,216,6077,36,10365,4.687.440.476
29/12/2019 17:00,33.98,53605,4079,14,245,6371,38,10747,4.687.440.476
29/12/2019 18:00,33.45,53027,4080,10,270,6524,42,10926,4.687.440.476
29/12/2019 19:00,32.98,51807,4095,8,293,6729,43,11168,4.687.440.476
29/12/2019 20:00,32.06,50393,4125,6,304,6838,43,11316,4.687.440.476
29/12/2019 21:00,31.46,49343,4185,6,311,6893,43,11438,4.687.440.476
29/12/2019 22:00,30.7,47789,4211,7,325,6901,43,11487,4.687.440.476
29/12/2019 23:00,29.05,45003,4296,8,334,6861,43,11542,4.687.440.476
30/12/2019 00:00,28.03,41631,4341,48,317,6868,45,11619,4.745.952.381
30/12/2019 01:00,28,40855,4325,55,334,6833,47,11594,4.745.952.381
30/12/2019 02:00,26.65,40505,4303,63,336,6868,47,11617,4.745.952.381
30/12/2019 03:00,23.96,40504,4210,77,343,6921,45,11596,4.745.952.381
30/12/2019 04:00,26.59,41029,4128,91,349,6882,43,11493,4.745.952.381
30/12/2019 05:00,28.36,42487,4235,103,350,6824,42,11554,4.745.952.381
30/12/2019 06:00,30.45,45384,4191,114,352,6878,43,11578,4.745.952.381
30/12/2019 07:00,31.63,48312,4246,123,353,6923,43,11688,4.745.952.381
30/12/2019 08:00,32.85,49886,4194,128,353,6842,42,11559,4.745.952.381
30/12/2019 09:00,32.86,50388,4163,130,352,6908,42,11595,4.745.952.381
30/12/2019 10:00,31.49,50569,4059,131,355,6880,43,11468,4.745.952.381
30/12/2019 11:00,31.63,50480,3942,134,357,6852,44,11329,4.745.952.381
30/12/2019 12:00,31.86,50315,3844,138,357,6756,45,11140,4.745.952.381
30/12/2019 13:00,32.01,50279,3753,145,358,6813,45,11114,4.745.952.381
30/12/2019 14:00,32.62,50691,3660,154,360,6845,43,11062,4.745.952.381
30/12/2019 15:00,33.92,51507,3591,157,361,6766,43,10918,4.745.952.381
30/12/2019 16:00,34.3,52307,3476,159,364,6763,43,10805,4.745.952.381
30/12/2019 17:00,34.51,52487,3386,161,364,6697,43,10651,4.745.952.381
30/12/2019 18:00,34.37,51622,3305,161,366,6601,43,10476,4.745.952.381
30/12/2019 19:00,32.18,50568,3277,160,365,6601,43,10446,4.745.952.381
30/12/2019 20:00,31.77,49141,3264,158,362,6517,45,10346,4.745.952.381
30/12/2019 21:00,31.24,47874,3325,158,362,6485,45,10375,4.745.952.381
30/12/2019 22:00,31.34,46215,3562,157,363,6336,45,10463,4.745.952.381
30/12/2019 23:00,30.07,44176,3857,152,360,6251,47,10667,4.745.952.381
31/12/2019 00:00,27.82,41131,4315,251,468,6121,43,11198,4.745.952.381
31/12/2019 01:00,27.79,40197,4395,244,467,6079,42,11227,4.745.952.381
31/12/2019 02:00,26.27,39817,4536,236,462,6170,40,11444,4.745.952.381
31/12/2019 03:00,25.8,39874,4580,227,447,6123,39,11416,4.745.952.381
31/12/2019 04:00,26.79,40381,4532,220,439,6136,39,11366,4.745.952.381
31/12/2019 05:00,27.34,41472,4708,212,434,6150,40,11544,4.745.952.381
31/12/2019 06:00,28.53,42569,4714,206,428,6071,39,11458,4.745.952.381
31/12/2019 07:00,29.18,44418,4705,203,420,6240,42,11610,4.745.952.381
31/12/2019 08:00,31.09,45848,4579,203,409,6033,37,11261,4.745.952.381
31/12/2019 09:00,32.37,47321,4529,205,399,5872,38,11043,4.745.952.381
31/12/2019 10:00,31.95,48798,4304,208,406,5947,40,10905,4.745.952.381
31/12/2019 11:00,32.3,49611,4059,218,422,5871,39,10609,4.745.952.381
31/12/2019 12:00,33.1,49491,3720,224,434,5801,43,10222,4.745.952.381
31/12/2019 13:00,33.33,49338,3267,222,445,5743,45,9722,4.745.952.381
31/12/2019 14:00,33.69,49881,2886,213,452,5665,46,9262,4.745.952.381
31/12/2019 15:00,34.27,51048,2554,203,446,5423,46,8672,4.745.952.381
31/12/2019 16:00,34.83,51916,2289,197,445,5206,46,8183,4.745.952.381
31/12/2019 17:00,35.09,51990,2114,196,439,4999,46,7794,4.745.952.381
31/12/2019 18:00,34.78,50812,1850,198,433,4825,46,7352,4.745.952.381
31/12/2019 19:00,33.3,48972,1615,200,421,4889,46,7171,4.745.952.381
31/12/2019 20:00,32.3,47399,1409,204,397,4906,44,6960,4.745.952.381
31/12/2019 21:00,32.17,46687,1324,205,362,4904,40,6835,4.745.952.381
31/12/2019 22:00,32.08,45839,1304,204,319,4881,30,6738,4.745.952.381
31/12/2019 23:00,31.52,44680,1368,198,274,4887,19,6746,4.745.952.381
01/01/2020 00:00,30.84,43577,1602,208,0,4914,15,6739,4.745.952.381
01/01/2020 01:00,30.63,42736,1896,200,0,4918,14,7028,4.745.952.381
01/01/2020 02:00,30.38,41957,2108,188,0,5146,19,7461,4.745.952.381
01/01/2020 03:00,30.04,41629,2241,174,0,5287,20,7722,4.745.952.381
01/01/2020 04:00,29.56,41620,2359,162,0,5553,17,8091,4.745.952.381
01/01/2020 05:00,28.1,41956,2605,162,0,5837,17,8621,4.745.952.381
01/01/2020 06:00,27.57,42437,2671,167,0,6010,18,8866,4.745.952.381
01/01/2020 07:00,27.35,43264,2702,173,0,6266,16,9157,4.745.952.381
01/01/2020 08:00,27.99,44025,2760,185,0,6467,27,9439,4.745.952.381
01/01/2020 09:00,28.36,44949,2939,203,0,6558,23,9723,4.745.952.381
01/01/2020 10:00,28.45,46079,3054,223,0,6645,23,9945,4.745.952.381
01/01/2020 11:00,29.02,46681,3192,234,0,6650,24,10100,4.745.952.381
01/01/2020 12:00,29.4,46777,3370,236,0,6575,23,10204,4.745.952.381
01/01/2020 13:00,29.41,46824,3420,239,0,6566,23,10248,4.745.952.381
01/01/2020 14:00,29.92,47344,3390,242,0,6501,23,10156,4.745.952.381
01/01/2020 15:00,30.36,48263,3300,242,0,6518,23,10083,4.745.952.381
01/01/2020 16:00,30.83,49432,3154,244,0,6472,23,9893,4.745.952.381
01/01/2020 17:00,30.91,49896,3073,239,0,6465,26,9803,4.745.952.381
01/01/2020 18:00,30.79,49460,2957,227,0,6532,29,9745,4.745.952.381
01/01/2020 19:00,30.47,48582,2863,201,0,6691,30,9785,4.745.952.381
01/01/2020 20:00,30.02,47453,2854,167,0,6749,32,9802,4.745.952.381
01/01/2020 21:00,29.52,46701,2889,140,0,6828,33,9890,4.745.952.381
01/01/2020 22:00,28.28,45482,2908,135,0,6810,39,9892,4.745.952.381
01/01/2020 23:00,27.79,44172,2938,136,0,6767,39,9880,4.745.952.381
02/01/2020 00:00,26.96,43005,2853,149,379,6733,41,10155,4.745.952.381
02/01/2020 01:00,27.04,42244,2856,148,376,6625,34,10039,4.745.952.381
02/01/2020 02:00,27.03,41911,2851,142,378,6485,26,9882,4.745.952.381
02/01/2020 03:00,26.54,42000,2846,126,383,6431,25,9811,4.745.952.381
02/01/2020 04:00,27.14,42645,2868,111,384,6325,25,9713,4.745.952.381
02/01/2020 05:00,28.2,44314,3127,110,379,6239,23,9878,4.745.952.381
02/01/2020 06:00,30.24,47490,3234,126,377,6235,24,9996,4.745.952.381
02/01/2020 07:00,30.63,50434,3425,144,377,6233,24,10203,4.745.952.381
02/01/2020 08:00,30.92,51790,3563,153,377,6234,26,10353,4.745.952.381
02/01/2020 09:00,30.99,52008,3717,149,375,6429,29,10699,4.745.952.381
02/01/2020 10:00,30.87,52380,3705,144,369,6483,26,10727,4.745.952.381
02/01/2020 11:00,30.75,52318,3738,152,361,6539,29,10819,4.745.952.381
02/01/2020 12:00,30.67,52060,3787,162,349,6589,30,10917,4.745.952.381
02/01/2020 13:00,30.65,52000,3765,168,338,6484,34,10789,4.745.952.381
02/01/2020 14:00,30.76,52273,3757,177,327,6467,31,10759,4.745.952.381
02/01/2020 15:00,31.08,53042,3904,182,318,6525,31,10960,4.745.952.381
02/01/2020 16:00,31.25,53760,3992,182,316,6520,31,11041,4.745.952.381
02/01/2020 17:00,31.18,53891,4128,183,317,6554,32,11214,4.745.952.381
02/01/2020 18:00,30.78,53095,4182,182,315,6636,34,11349,4.745.952.381
02/01/2020 19:00,30.21,51927,4183,183,304,6690,34,11394,4.745.952.381
02/01/2020 20:00,29.47,50511,4229,184,292,6734,38,11477,4.745.952.381
02/01/2020 21:00,28.91,49325,4369,181,289,6781,36,11656,4.745.952.381
02/01/2020 22:00,28.39,47661,4508,180,289,6866,38,11881,4.745.952.381
02/01/2020 23:00,25.9,45624,4644,180,292,6955,41,12112,4.745.952.381
03/01/2020 00:00,24.26,43580,4658,182,291,7043,46,12220,4.745.952.381
03/01/2020 01:00,23,42745,4670,191,293,7157,46,12357,4.745.952.381
03/01/2020 02:00,20.04,42399,4698,190,296,7265,46,12495,4.745.952.381
03/01/2020 03:00,14.34,42478,4651,188,299,7202,46,12386,4.745.952.381
03/01/2020 04:00,17.06,43065,4594,183,305,7261,49,12392,4.745.952.381
03/01/2020 05:00,20.96,44787,4710,173,316,7249,49,12497,4.745.952.381
03/01/2020 06:00,26.69,47922,4662,162,320,7082,49,12275,4.745.952.381
03/01/2020 07:00,27.65,51423,4634,154,321,7081,50,12240,4.745.952.381
03/01/2020 08:00,28.81,52862,4319,148,325,6946,50,11788,4.745.952.381
03/01/2020 09:00,29.22,53022,3869,145,333,6840,51,11238,4.745.952.381
03/01/2020 10:00,29.34,53354,3371,147,340,6838,51,10747,4.745.952.381
03/01/2020 11:00,29.81,53185,3097,154,340,6824,51,10466,4.745.952.381
03/01/2020 12:00,29.72,52919,3094,163,346,6792,51,10446,4.745.952.381
03/01/2020 13:00,29.67,52915,2996,169,351,6836,51,10403,4.745.952.381
03/01/2020 14:00,29.8,53129,2848,173,364,6716,50,10151,4.745.952.381
03/01/2020 15:00,30.14,53975,2864,176,371,6601,51,10063,4.745.952.381
03/01/2020 16:00,30.32,54760,3059,181,380,6523,50,10193,4.745.952.381
03/01/2020 17:00,30.26,55034,3311,187,389,6464,50,10401,4.745.952.381
03/01/2020 18:00,29.89,54459,3465,197,394,6542,49,10647,4.745.952.381
03/01/2020 19:00,29.4,53334,3651,204,390,6711,49,11005,4.745.952.381
03/01/2020 20:00,28.41,51753,3905,210,375,6906,40,11436,4.745.952.381
03/01/2020 21:00,27.41,50426,4155,213,359,7033,26,11786,4.745.952.381
03/01/2020 22:00,26.3,48802,4350,215,342,7151,14,12072,4.745.952.381
03/01/2020 23:00,24.94,46812,4521,218,321,7297,13,12370,4.745.952.381
04/01/2020 00:00,25.58,45586,4508,165,323,7361,36,12393,4.745.952.381
04/01/2020 01:00,25.29,44553,4551,159,341,7348,38,12437,4.745.952.381
04/01/2020 02:00,25.12,44077,4682,151,361,7231,45,12470,4.745.952.381
04/01/2020 03:00,23.33,43902,4681,145,381,7027,48,12282,4.745.952.381
04/01/2020 04:00,22.37,44058,4621,141,400,7001,48,12211,4.745.952.381
04/01/2020 05:00,21.91,44690,4783,134,418,6960,50,12345,4.745.952.381
04/01/2020 06:00,21.95,45618,4752,126,434,7110,51,12473,4.745.952.381
04/01/2020 07:00,24.99,47241,4845,116,449,7155,51,12616,4.745.952.381
04/01/2020 08:00,25.29,49102,4800,104,456,7224,51,12635,4.745.952.381
04/01/2020 09:00,26.56,50640,4812,92,454,7208,51,12617,4.745.952.381
04/01/2020 10:00,26.69,51753,4705,76,450,7176,49,12456,4.745.952.381
04/01/2020 11:00,27.01,51729,4682,62,439,7170,46,12399,4.745.952.381
04/01/2020 12:00,26.67,51398,4733,49,419,7170,46,12417,4.745.952.381
04/01/2020 13:00,26.58,51145,4683,38,392,7121,44,12278,4.745.952.381
04/01/2020 14:00,26.8,51488,4627,30,356,7102,41,12156,4.745.952.381
04/01/2020 15:00,27.4,52392,4597,24,319,7097,36,12073,4.745.952.381
04/01/2020 16:00,28.36,53593,4399,18,295,7047,36,11795,4.745.952.381
04/01/2020 17:00,28.91,54341,4114,12,286,6913,41,11366,4.745.952.381
04/01/2020 18:00,29.47,53793,3640,8,285,6750,41,10724,4.745.952.381
04/01/2020 19:00,29.51,52511,3148,5,288,6553,42,10036,4.745.952.381
04/01/2020 20:00,29.24,51037,2620,3,294,6301,35,9253,4.745.952.381
04/01/2020 21:00,29.21,50021,2185,3,301,5931,40,8460,4.745.952.381
04/01/2020 22:00,29.07,48749,1671,6,304,5584,43,7608,4.745.952.381
04/01/2020 23:00,28.74,47324,1207,12,307,5304,47,6877,4.745.952.381
05/01/2020 00:00,29.43,46067,1217,8,308,5015,46,6594,4.745.952.381
05/01/2020 01:00,29.39,45220,792,12,327,4635,48,5814,4.745.952.381
05/01/2020 02:00,29.28,44871,548,19,341,4238,46,5192,4.745.952.381
05/01/2020 03:00,29.21,44799,484,28,343,3862,48,4765,4.745.952.381
05/01/2020 04:00,29.31,44982,554,39,338,3529,48,4508,4.745.952.381
05/01/2020 05:00,29.41,45484,739,53,320,3153,48,4313,4.745.952.381
05/01/2020 06:00,29.83,46419,940,72,302,2820,43,4177,4.745.952.381
05/01/2020 07:00,30.2,47768,1235,96,282,2545,44,4202,4.745.952.381
05/01/2020 08:00,30.95,49199,1589,119,261,2336,46,4351,4.745.952.381
05/01/2020 09:00,31.1,50640,1951,141,241,2468,41,4842,4.745.952.381
05/01/2020 10:00,31.4,51692,2265,162,225,2749,35,5436,4.745.952.381
05/01/2020 11:00,31.37,51985,2566,179,204,3201,30,6180,4.745.952.381
05/01/2020 12:00,31.17,51763,2829,192,182,3799,23,7025,4.745.952.381
05/01/2020 13:00,30.86,51750,3022,202,156,4392,18,7790,4.745.952.381
05/01/2020 14:00,30.61,52034,3175,208,126,4899,12,8420,4.745.952.381
05/01/2020 15:00,30.74,52980,3336,218,102,5402,6,9064,4.745.952.381
05/01/2020 16:00,31.15,54068,3426,228,89,5649,5,9397,4.745.952.381
05/01/2020 17:00,31.48,54600,3519,236,84,5865,4,9708,4.745.952.381
05/01/2020 18:00,30.99,53886,3506,243,85,6016,5,9855,4.745.952.381
05/01/2020 19:00,30.33,52650,3494,246,103,6080,9,9932,4.745.952.381
05/01/2020 20:00,29.85,51097,3469,251,143,5912,9,9784,4.745.952.381
05/01/2020 21:00,29.47,49860,3492,257,188,5942,12,9891,4.745.952.381
05/01/2020 22:00,28.81,48307,3542,260,229,5806,21,9858,4.745.952.381
05/01/2020 23:00,28,46686,3535,262,268,5794,35,9894,4.745.952.381
06/01/2020 00:00,27.89,45559,3086,210,284,5685,41,9306,4.728.154.762
06/01/2020 01:00,27.82,44474,2923,212,304,5369,44,8852,4.728.154.762
06/01/2020 02:00,28.02,43880,2769,216,327,5204,44,8560,4.728.154.762
06/01/2020 03:00,27.81,43684,2600,222,341,5124,44,8331,4.728.154.762
06/01/2020 04:00,28.01,43967,2492,228,342,4948,41,8051,4.728.154.762
06/01/2020 05:00,28.89,44792,2524,232,342,4719,34,7851,4.728.154.762
06/01/2020 06:00,29.62,46997,2467,241,339,4677,28,7752,4.728.154.762
06/01/2020 07:00,30.04,49591,2506,251,325,4452,18,7552,4.728.154.762
06/01/2020 08:00,30.44,50855,2539,257,311,4289,12,7408,4.728.154.762
06/01/2020 09:00,30.73,51603,2609,263,293,4255,12,7432,4.728.154.762
06/01/2020 10:00,31,52246,2607,262,279,3948,12,7108,4.728.154.762
06/01/2020 11:00,31.13,52339,2628,259,264,4000,9,7160,4.728.154.762
06/01/2020 12:00,31.15,51923,2777,257,239,3860,8,7141,4.728.154.762
06/01/2020 13:00,31.08,51830,2831,256,215,3835,8,7145,4.728.154.762
06/01/2020 14:00,31.2,52083,2855,257,198,3944,7,7261,4.728.154.762
06/01/2020 15:00,31.29,53005,2897,258,179,4124,6,7464,4.728.154.762
06/01/2020 16:00,31.75,53914,2908,252,172,4029,7,7368,4.728.154.762
06/01/2020 17:00,31.77,54164,3164,241,175,4002,6,7588,4.728.154.762
06/01/2020 18:00,31.31,53179,3310,227,179,3746,6,7468,4.728.154.762
06/01/2020 19:00,30.97,51964,3364,210,181,3717,5,7477,4.728.154.762
06/01/2020 20:00,30.59,50420,3360,190,176,3896,6,7628,4.728.154.762
06/01/2020 21:00,30.3,49271,3307,169,174,4162,5,7817,4.728.154.762
06/01/2020 22:00,29.48,47750,3204,157,172,4222,7,7762,4.728.154.762
06/01/2020 23:00,28.78,45782,3043,148,168,4424,7,7790,4.728.154.762
07/01/2020 00:00,27.82,44417,2548,188,159,4429,7,7331,4.728.154.762
07/01/2020 01:00,27.82,43362,2431,197,150,4287,7,7072,4.728.154.762
07/01/2020 02:00,27.83,42984,2246,195,146,4375,7,6969,4.728.154.762
07/01/2020 03:00,27.67,43114,1964,173,142,4339,7,6625,4.728.154.762
07/01/2020 04:00,27.99,43839,1767,139,136,4270,7,6319,4.728.154.762
07/01/2020 05:00,29.03,45909,1711,111,129,4279,7,6237,4.728.154.762
07/01/2020 06:00,29.79,49488,1649,92,124,4249,7,6121,4.728.154.762
07/01/2020 07:00,30.74,53104,1665,78,116,4202,9,6070,4.728.154.762
07/01/2020 08:00,31.12,54145,1644,68,111,3991,8,5822,4.728.154.762
07/01/2020 09:00,31.05,54226,1540,60,109,3964,9,5682,4.728.154.762
07/01/2020 10:00,30.93,54417,1332,51,106,3899,8,5396,4.728.154.762
07/01/2020 11:00,30.75,54181,1268,45,107,3793,9,5222,4.728.154.762
07/01/2020 12:00,30.57,53953,1393,44,107,3757,13,5314,4.728.154.762
07/01/2020 13:00,30.59,53877,1574,44,107,3769,14,5508,4.728.154.762
07/01/2020 14:00,30.5,54138,1877,42,109,3676,12,5716,4.728.154.762
07/01/2020 15:00,30.63,54858,2318,42,111,3839,10,6320,4.728.154.762
07/01/2020 16:00,30.54,55598,2774,42,118,4381,14,7329,4.728.154.762
07/01/2020 17:00,30.33,55889,3316,46,132,4818,19,8331,4.728.154.762
07/01/2020 18:00,30.01,54787,3735,50,141,5283,25,9234,4.728.154.762
07/01/2020 19:00,29.45,53447,4009,56,152,5842,24,10083,4.728.154.762
07/01/2020 20:00,28.62,51600,4189,64,160,6264,28,10705,4.728.154.762
07/01/2020 21:00,27.96,50269,4353,70,168,6573,26,11190,4.728.154.762
07/01/2020 22:00,27.05,48209,4477,73,175,6823,24,11572,4.728.154.762
07/01/2020 23:00,25.88,46048,4591,74,180,7007,28,11880,4.728.154.762
08/01/2020 00:00,20.47,44505,4695,90,225,7215,36,12261,4.728.154.762
08/01/2020 01:00,19.37,43456,4651,89,225,7263,36,12264,4.728.154.762
08/01/2020 02:00,5.08,42930,4675,93,227,7302,35,12332,4.728.154.762
08/01/2020 03:00,4.9,42808,4634,98,228,7230,38,12228,4.728.154.762
08/01/2020 04:00,6.74,43398,4591,97,241,7147,41,12117,4.728.154.762
08/01/2020 05:00,21.06,45461,4615,91,267,7107,43,12123,4.728.154.762
08/01/2020 06:00,25.87,49091,4556,86,291,7054,45,12032,4.728.154.762
08/01/2020 07:00,26.96,52553,4471,85,322,7057,46,11981,4.728.154.762
08/01/2020 08:00,27.27,53205,4221,87,341,6973,46,11668,4.728.154.762
08/01/2020 09:00,27.46,52941,3948,96,361,6891,47,11343,4.728.154.762
08/01/2020 10:00,27.59,53121,3553,108,375,6782,47,10865,4.728.154.762
08/01/2020 11:00,27.6,53127,3213,114,382,6680,47,10436,4.728.154.762
08/01/2020 12:00,27.6,52878,3052,118,392,6425,47,10034,4.728.154.762
08/01/2020 13:00,27.63,52834,2964,121,393,6305,46,9829,4.728.154.762
08/01/2020 14:00,27.88,53032,2842,126,385,6172,47,9572,4.728.154.762
08/01/2020 15:00,28.13,53967,2558,136,376,6219,46,9335,4.728.154.762
08/01/2020 16:00,28.55,54901,2320,140,374,6299,46,9179,4.728.154.762
08/01/2020 17:00,28.71,55341,2147,147,371,6316,46,9027,4.728.154.762
08/01/2020 18:00,28.68,54606,2022,153,365,6439,44,9023,4.728.154.762
08/01/2020 19:00,28.45,53582,1879,161,358,6424,44,8866,4.728.154.762
08/01/2020 20:00,28.06,51937,1691,172,350,6542,44,8799,4.728.154.762
08/01/2020 21:00,27.76,50525,1523,182,340,6576,42,8663,4.728.154.762
08/01/2020 22:00,27.1,48581,1388,188,331,6619,38,8564,4.728.154.762
08/01/2020 23:00,26.46,46347,1321,194,310,6649,35,8509,4.728.154.762
09/01/2020 00:00,23.65,44974,1495,203,314,6711,34,8757,4.728.154.762
09/01/2020 01:00,23.53,44029,1193,215,287,6747,33,8475,4.728.154.762
09/01/2020 02:00,23.61,43701,946,218,268,6701,32,8165,4.728.154.762
09/01/2020 03:00,23.95,43844,784,232,256,6595,30,7897,4.728.154.762
09/01/2020 04:00,24.89,44686,724,237,241,6463,30,7695,4.728.154.762
09/01/2020 05:00,26.16,47018,672,243,226,6243,30,7414,4.728.154.762
09/01/2020 06:00,26.48,51091,594,252,216,6058,29,7149,4.728.154.762
09/01/2020 07:00,27.35,54980,607,256,205,5824,26,6918,4.728.154.762
09/01/2020 08:00,27.86,55994,654,254,197,5498,21,6624,4.728.154.762
09/01/2020 09:00,27.83,55890,782,254,188,5150,20,6394,4.728.154.762
09/01/2020 10:00,27.92,55911,1041,253,176,4816,18,6304,4.728.154.762
09/01/2020 11:00,27.92,55496,1433,253,162,4337,17,6202,4.728.154.762
09/01/2020 12:00,27.93,54990,1847,252,144,4000,17,6260,4.728.154.762
09/01/2020 13:00,27.92,54953,2263,252,126,3782,15,6438,4.728.154.762
09/01/2020 14:00,28.08,55219,2741,250,107,3499,14,6611,4.728.154.762
09/01/2020 15:00,28.28,56180,3060,248,91,3400,14,6813,4.728.154.762
09/01/2020 16:00,28.44,57250,3089,243,87,3304,13,6736,4.728.154.762
09/01/2020 17:00,28.69,57470,2899,237,87,3286,11,6520,4.728.154.762
09/01/2020 18:00,28.58,56532,2677,233,86,3388,10,6394,4.728.154.762
09/01/2020 19:00,27.95,55397,2419,227,84,3359,8,6097,4.728.154.762
09/01/2020 20:00,27.54,53762,2043,218,84,3313,7,5665,4.728.154.762
09/01/2020 21:00,27.5,52426,1811,209,90,3222,7,5339,4.728.154.762
09/01/2020 22:00,26.86,50437,1797,199,103,3212,7,5318,4.728.154.762
09/01/2020 23:00,26.4,48195,1605,186,117,3104,6,5018,4.728.154.762
10/01/2020 00:00,26.07,46523,1671,204,163,3161,10,5209,4.728.154.762
10/01/2020 01:00,25.98,45559,1416,204,148,3133,10,4911,4.728.154.762
10/01/2020 02:00,25.81,45132,1102,204,130,3007,10,4453,4.728.154.762
10/01/2020 03:00,25.89,45190,843,204,115,3069,10,4241,4.728.154.762
10/01/2020 04:00,26.2,46194,783,202,107,2956,12,4060,4.728.154.762
10/01/2020 05:00,26.95,48540,935,198,103,2879,11,4126,4.728.154.762
10/01/2020 06:00,27.94,52614,1191,192,99,2808,10,4300,4.728.154.762
10/01/2020 07:00,28.71,56594,1778,190,95,2866,10,4939,4.728.154.762
10/01/2020 08:00,29.66,57739,2148,185,86,2927,10,5356,4.728.154.762
10/01/2020 09:00,28.98,57648,2323,176,80,2995,8,5582,4.728.154.762
10/01/2020 10:00,28.72,57816,2398,164,74,3050,8,5694,4.728.154.762
10/01/2020 11:00,28.37,57378,2606,150,61,2997,8,5822,4.728.154.762
10/01/2020 12:00,28,56721,2968,135,53,2982,7,6145,4.728.154.762
10/01/2020 13:00,27.94,56266,3158,120,55,2966,6,6305,4.728.154.762
10/01/2020 14:00,27.9,56329,3332,109,72,2965,6,6484,4.728.154.762
10/01/2020 15:00,28.16,56967,3361,100,90,3211,6,6768,4.728.154.762
10/01/2020 16:00,28.7,57967,3035,89,122,3323,7,6576,4.728.154.762
10/01/2020 17:00,28.81,58320,2576,78,177,3315,7,6153,4.728.154.762
10/01/2020 18:00,28.8,57413,2229,69,225,3366,7,5896,4.728.154.762
10/01/2020 19:00,27.91,55928,1907,61,248,3389,7,5612,4.728.154.762
10/01/2020 20:00,27.12,53858,1570,55,252,3315,6,5198,4.728.154.762
10/01/2020 21:00,26.98,52456,1251,51,240,3185,7,4734,4.728.154.762
10/01/2020 22:00,26.46,50765,1023,47,230,3149,8,4457,4.728.154.762
10/01/2020 23:00,26,48887,914,42,212,2881,8,4057,4.728.154.762
11/01/2020 00:00,26.53,47466,546,165,216,2525,18,3470,4.728.154.762
11/01/2020 01:00,26.23,46573,619,171,226,2704,20,3740,4.728.154.762
11/01/2020 02:00,26.01,46106,815,187,238,2852,19,4111,4.728.154.762
11/01/2020 03:00,25.65,45990,1138,198,269,3236,21,4862,4.728.154.762
11/01/2020 04:00,25.4,46230,1571,200,293,3742,15,5821,4.728.154.762
11/01/2020 05:00,25.32,46953,2045,202,288,4207,11,6753,4.728.154.762
11/01/2020 06:00,25.32,48033,2453,199,261,4640,8,7561,4.728.154.762
11/01/2020 07:00,25.41,49892,2948,195,222,4859,6,8230,4.728.154.762
11/01/2020 08:00,25.68,51702,3413,202,174,5305,5,9099,4.728.154.762
11/01/2020 09:00,25.89,53130,3859,208,135,5588,5,9795,4.728.154.762
11/01/2020 10:00,25.85,53956,4092,211,97,5825,5,10230,4.728.154.762
11/01/2020 11:00,25.54,53737,4260,216,71,6153,5,10705,4.728.154.762
11/01/2020 12:00,25.19,53145,4470,219,46,6262,5,11002,4.728.154.762
11/01/2020 13:00,25.01,52697,4518,216,35,6460,6,11235,4.728.154.762
11/01/2020 14:00,24.87,52675,4640,214,35,6521,9,11419,4.728.154.762
11/01/2020 15:00,25.17,53391,4748,209,36,6781,14,11788,4.728.154.762
11/01/2020 16:00,25.55,54575,4780,204,56,6720,18,11778,4.728.154.762
11/01/2020 17:00,25.66,55208,4759,200,84,6873,24,11940,4.728.154.762
11/01/2020 18:00,25.42,54295,4727,200,117,6950,31,12025,4.728.154.762
11/01/2020 19:00,24.78,52565,4626,205,160,6967,42,12000,4.728.154.762
11/01/2020 20:00,24.13,50595,4579,211,213,6897,48,11948,4.728.154.762
11/01/2020 21:00,23.5,49276,4595,217,265,6905,48,12030,4.728.154.762
11/01/2020 22:00,22.53,47815,4627,221,303,6897,49,12097,4.728.154.762
11/01/2020 23:00,20.71,46114,4684,226,326,6956,49,12241,4.728.154.762
12/01/2020 00:00,21.75,43743,4783,230,374,6854,50,12291,4.728.154.762
12/01/2020 01:00,20.79,42704,4735,234,395,6942,50,12356,4.728.154.762
12/01/2020 02:00,20.48,42167,4710,237,399,6906,50,12302,4.728.154.762
12/01/2020 03:00,20.32,41926,4541,238,405,6783,50,12017,4.728.154.762
12/01/2020 04:00,19.99,42003,4292,235,413,6678,50,11668,4.728.154.762
12/01/2020 05:00,20.33,42349,3967,229,421,6573,50,11240,4.728.154.762
12/01/2020 06:00,20.33,43055,3409,217,429,6489,50,10594,4.728.154.762
12/01/2020 07:00,21.09,44368,2932,203,437,6185,50,9807,4.728.154.762
12/01/2020 08:00,23.52,45668,2521,184,441,6039,50,9235,4.728.154.762
12/01/2020 09:00,24.3,47255,2221,163,444,5646,50,8524,4.728.154.762
12/01/2020 10:00,24.67,48432,1907,133,447,5613,50,8150,4.728.154.762
12/01/2020 11:00,24.97,48967,1643,101,444,5588,50,7826,4.728.154.762
12/01/2020 12:00,24.84,48946,1560,70,437,5431,50,7548,4.728.154.762
12/01/2020 13:00,24.79,49003,1519,44,434,5147,50,7194,4.728.154.762
12/01/2020 14:00,24.99,49242,1544,26,431,4938,50,6989,4.728.154.762
12/01/2020 15:00,25.3,50203,1658,15,422,4818,49,6962,4.728.154.762
12/01/2020 16:00,25.71,51606,1773,13,415,4561,48,6810,4.728.154.762
12/01/2020 17:00,26.52,52537,1864,19,407,4518,48,6856,4.728.154.762
12/01/2020 18:00,26.71,52148,2000,33,395,4518,46,6992,4.728.154.762
12/01/2020 19:00,26.19,51278,2104,54,378,4510,39,7085,4.728.154.762
12/01/2020 20:00,25.64,49982,2171,83,355,4495,30,7134,4.728.154.762
12/01/2020 21:00,25.55,49164,2279,116,337,4442,23,7197,4.728.154.762
12/01/2020 22:00,25.5,47787,2307,147,313,4288,16,7071,4.728.154.762
12/01/2020 23:00,24.71,46243,2275,176,287,4378,14,7130,4.728.154.762
13/01/2020 00:00,23.87,45383,2154,31,259,4636,8,7088,4.642.738.095
13/01/2020 01:00,24.21,44588,2117,23,228,4507,6,6881,4.642.738.095
13/01/2020 02:00,24.32,44383,1981,16,208,4661,5,6871,4.642.738.095
13/01/2020 03:00,24.54,44581,1702,11,192,4541,4,6450,4.642.738.095
13/01/2020 04:00,25.1,45538,1542,6,182,4705,5,6440,4.642.738.095
13/01/2020 05:00,26.09,47903,1623,4,177,4641,5,6450,4.642.738.095
13/01/2020 06:00,26.93,52234,1596,3,167,4814,6,6586,4.642.738.095
13/01/2020 07:00,27.44,56112,1536,4,160,4891,7,6598,4.642.738.095
13/01/2020 08:00,27.77,57184,1467,5,164,4868,8,6512,4.642.738.095
13/01/2020 09:00,27.79,57102,1483,7,175,4926,11,6602,4.642.738.095
13/01/2020 10:00,27.73,57046,1429,8,185,4860,12,6494,4.642.738.095
13/01/2020 11:00,27.5,56719,1436,9,195,4835,10,6485,4.642.738.095
13/01/2020 12:00,27.39,56145,1536,10,196,4803,9,6554,4.642.738.095
13/01/2020 13:00,27.31,55926,1505,11,185,4891,12,6604,4.642.738.095
13/01/2020 14:00,27.23,56065,1539,14,165,4922,8,6648,4.642.738.095
13/01/2020 15:00,27.29,56716,1677,19,160,4916,8,6780,4.642.738.095
13/01/2020 16:00,27.47,57744,1922,23,156,4887,10,6998,4.642.738.095
13/01/2020 17:00,27.46,58289,2284,29,161,4944,8,7426,4.642.738.095
13/01/2020 18:00,27.09,57231,2619,32,163,4832,10,7656,4.642.738.095
13/01/2020 19:00,26.71,56012,2863,34,156,4674,9,7736,4.642.738.095
13/01/2020 20:00,26.3,54314,3167,35,143,4764,9,8118,4.642.738.095
13/01/2020 21:00,26.03,52942,3496,36,132,4716,7,8387,4.642.738.095
13/01/2020 22:00,25.33,50952,3782,36,125,4673,6,8622,4.642.738.095
13/01/2020 23:00,23.38,48519,4099,35,111,4944,6,9195,4.642.738.095
14/01/2020 00:00,22.81,46739,4465,116,120,5065,9,9775,4.642.738.095
14/01/2020 01:00,18.63,45659,4576,94,106,5296,10,10082,4.642.738.095
14/01/2020 02:00,16.83,45263,4636,79,90,5478,11,10294,4.642.738.095
14/01/2020 03:00,16.02,45408,4575,70,85,5546,11,10287,4.642.738.095
14/01/2020 04:00,18.26,46161,4550,68,93,5774,9,10494,4.642.738.095
14/01/2020 05:00,20.52,48369,4664,73,116,6029,10,10892,4.642.738.095
14/01/2020 06:00,24.64,52302,4717,77,143,6039,11,10987,4.642.738.095
14/01/2020 07:00,25.61,56136,4710,81,174,6184,12,11161,4.642.738.095
14/01/2020 08:00,25.83,57063,4525,88,209,6332,15,11169,4.642.738.095
14/01/2020 09:00,25.79,57045,4409,92,244,6517,21,11283,4.642.738.095
14/01/2020 10:00,25.74,57136,4203,94,279,6673,30,11279,4.642.738.095
14/01/2020 11:00,25.63,56700,4004,98,308,6686,32,11128,4.642.738.095
14/01/2020 12:00,25.5,56286,3937,99,337,6666,40,11079,4.642.738.095
14/01/2020 13:00,25.59,56057,3673,97,368,6451,43,10632,4.642.738.095
14/01/2020 14:00,25.75,56019,3340,93,395,6152,44,10024,4.642.738.095
14/01/2020 15:00,26.08,56508,3085,87,412,6035,45,9664,4.642.738.095
14/01/2020 16:00,26.35,57224,3068,83,425,5787,46,9409,4.642.738.095
14/01/2020 17:00,26.48,57522,3353,80,429,5725,50,9637,4.642.738.095
14/01/2020 18:00,26.28,56354,3658,80,430,5457,50,9675,4.642.738.095
14/01/2020 19:00,25.82,54947,3845,80,425,5322,50,9722,4.642.738.095
14/01/2020 20:00,25.06,53173,4027,80,406,5467,47,10027,4.642.738.095
14/01/2020 21:00,23.96,51839,4238,78,384,5447,46,10193,4.642.738.095
14/01/2020 22:00,23.08,49683,4271,77,359,5377,41,10125,4.642.738.095
14/01/2020 23:00,19.16,47422,4258,76,329,5736,38,10437,4.642.738.095
15/01/2020 00:00,20.51,45199,3855,78,342,5833,47,10155,4.642.738.095
15/01/2020 01:00,19.45,44138,3875,80,331,5775,42,10103,4.642.738.095
15/01/2020 02:00,17.89,43645,4285,81,342,5844,38,10590,4.642.738.095
15/01/2020 03:00,17.77,43631,4567,80,353,5779,40,10819,4.642.738.095
15/01/2020 04:00,18.89,44214,4629,77,360,5815,42,10923,4.642.738.095
15/01/2020 05:00,20.45,46320,4641,73,375,5837,49,10975,4.642.738.095
15/01/2020 06:00,24.43,50059,4472,78,389,5641,50,10630,4.642.738.095
15/01/2020 07:00,25.2,53559,4293,96,393,5281,51,10114,4.642.738.095
15/01/2020 08:00,25.58,54262,4083,115,395,5130,52,9775,4.642.738.095
15/01/2020 09:00,25.62,54046,3945,133,399,4956,52,9485,4.642.738.095
15/01/2020 10:00,25.42,54140,3691,154,397,4927,52,9221,4.642.738.095
15/01/2020 11:00,25.03,53990,3476,178,392,4732,52,8830,4.642.738.095
15/01/2020 12:00,25.12,53748,3402,192,381,4924,52,8951,4.642.738.095
15/01/2020 13:00,25.18,53694,3227,203,372,4945,51,8798,4.642.738.095
15/01/2020 14:00,25.3,53800,3111,219,366,4980,51,8727,4.642.738.095
15/01/2020 15:00,25.94,54570,3031,235,359,4997,51,8673,4.642.738.095
15/01/2020 16:00,26.32,55719,3021,247,357,4920,51,8596,4.642.738.095
15/01/2020 17:00,26.41,56150,3093,254,363,4883,50,8643,4.642.738.095
15/01/2020 18:00,26.08,55229,3147,255,368,4824,49,8643,4.642.738.095
15/01/2020 19:00,25.69,54038,3279,253,370,4682,48,8632,4.642.738.095
15/01/2020 20:00,25.12,52386,3521,250,370,4720,48,8909,4.642.738.095
15/01/2020 21:00,24.84,50977,3824,242,371,4780,47,9264,4.642.738.095
15/01/2020 22:00,23.97,48927,3995,230,369,4731,47,9372,4.642.738.095
15/01/2020 23:00,23.01,46673,4057,217,364,4569,42,9249,4.642.738.095
16/01/2020 00:00,22.62,44815,4230,212,388,4586,50,9466,4.642.738.095
16/01/2020 01:00,22.28,43808,4266,205,394,4558,51,9474,4.642.738.095
16/01/2020 02:00,22.24,43519,4310,199,383,4504,51,9447,4.642.738.095
16/01/2020 03:00,22.37,43732,4215,198,383,4507,51,9354,4.642.738.095
16/01/2020 04:00,22.97,44545,4122,203,381,4453,51,9210,4.642.738.095
16/01/2020 05:00,23.68,46920,4149,213,373,4573,33,9341,4.642.738.095
16/01/2020 06:00,24.53,51125,4044,225,360,4578,32,9239,4.642.738.095
16/01/2020 07:00,25.16,54998,3948,238,348,4725,38,9297,4.642.738.095
16/01/2020 08:00,25.54,55762,3723,248,344,4670,35,9020,4.642.738.095
16/01/2020 09:00,25.51,55401,3491,253,347,4704,41,8836,4.642.738.095
16/01/2020 10:00,25.48,55481,3183,256,356,4755,43,8593,4.642.738.095
16/01/2020 11:00,25.41,55164,2901,259,363,4694,43,8260,4.642.738.095
16/01/2020 12:00,25.28,54706,2769,259,370,4767,42,8207,4.642.738.095
16/01/2020 13:00,25.31,54541,2589,258,368,4763,43,8021,4.642.738.095
16/01/2020 14:00,25.45,54541,2356,255,363,4847,39,7860,4.642.738.095
16/01/2020 15:00,25.6,55157,2108,251,352,4930,35,7676,4.642.738.095
16/01/2020 16:00,25.92,56152,2013,247,343,5018,33,7654,4.642.738.095
16/01/2020 17:00,25.92,56574,2235,243,333,5095,32,7938,4.642.738.095
16/01/2020 18:00,25.64,55667,2509,237,327,5292,32,8397,4.642.738.095
16/01/2020 19:00,25.14,54540,2743,233,306,5322,37,8641,4.642.738.095
16/01/2020 20:00,24.74,52889,2957,229,275,5323,34,8818,4.642.738.095
16/01/2020 21:00,24.51,51663,3290,225,239,5257,31,9042,4.642.738.095
16/01/2020 22:00,24.04,49650,3487,220,208,5289,26,9230,4.642.738.095
16/01/2020 23:00,23.13,47399,3658,214,182,5144,27,9225,4.642.738.095
17/01/2020 00:00,22.92,45078,3760,181,167,5040,24,9172,4.642.738.095
17/01/2020 01:00,22.61,44159,3736,167,139,4951,20,9013,4.642.738.095
17/01/2020 02:00,22.19,43771,3726,156,125,4908,14,8929,4.642.738.095
17/01/2020 03:00,22.39,43994,3679,153,112,4774,14,8732,4.642.738.095
17/01/2020 04:00,23.26,44900,3644,149,102,4760,12,8667,4.642.738.095
17/01/2020 05:00,23.61,47211,3618,143,104,4762,11,8638,4.642.738.095
17/01/2020 06:00,24.35,51186,3518,144,111,4898,13,8684,4.642.738.095
17/01/2020 07:00,24.86,55049,3501,156,123,4811,16,8607,4.642.738.095
17/01/2020 08:00,25.1,56100,3476,166,132,4589,16,8379,4.642.738.095
17/01/2020 09:00,25.12,55998,3478,174,143,4308,20,8123,4.642.738.095
17/01/2020 10:00,25.19,55881,3358,180,143,4200,18,7899,4.642.738.095
17/01/2020 11:00,25.23,55270,3192,184,132,3970,20,7498,4.642.738.095
17/01/2020 12:00,25.19,54477,3104,182,128,3668,22,7104,4.642.738.095
17/01/2020 13:00,25.2,53804,2935,180,141,3525,20,6801,4.642.738.095
17/01/2020 14:00,25.25,53527,2764,179,171,3440,19,6573,4.642.738.095
17/01/2020 15:00,25.39,53911,2458,172,204,3315,19,6168,4.642.738.095
17/01/2020 16:00,25.86,55012,2090,163,237,3114,22,5626,4.642.738.095
17/01/2020 17:00,26.12,55682,1829,154,260,3063,26,5332,4.642.738.095
17/01/2020 18:00,25.94,54835,1623,147,284,3038,26,5118,4.642.738.095
17/01/2020 19:00,25.25,53365,1406,141,303,2973,26,4849,4.642.738.095
17/01/2020 20:00,24.87,51289,1223,136,317,2835,26,4537,4.642.738.095
17/01/2020 21:00,24.71,49823,1130,136,329,2618,25,4238,4.642.738.095
17/01/2020 22:00,24.5,48031,1200,134,327,2531,26,4218,4.642.738.095
17/01/2020 23:00,24.07,45976,1292,126,316,2374,26,4134,4.642.738.095
18/01/2020 00:00,22.44,43894,2407,14,0,2242,26,4689,4.642.738.095
18/01/2020 01:00,22.97,42964,2573,12,0,1996,23,4604,4.642.738.095
18/01/2020 02:00,22.13,42381,2661,11,0,1969,27,4668,4.642.738.095
18/01/2020 03:00,22.53,42102,2731,11,0,1933,21,4696,4.642.738.095
18/01/2020 04:00,22.49,42338,2722,9,0,2061,23,4815,4.642.738.095
18/01/2020 05:00,22.45,42988,2800,9,0,2055,20,4884,4.642.738.095
18/01/2020 06:00,22.31,44003,2930,11,0,2210,24,5175,4.642.738.095
18/01/2020 07:00,22.74,45757,3013,15,0,2293,25,5346,4.642.738.095
18/01/2020 08:00,23.18,47477,3154,23,0,2474,25,5676,4.642.738.095
18/01/2020 09:00,23.58,49018,3288,32,0,2573,24,5917,4.642.738.095
18/01/2020 10:00,23.85,50052,3303,42,0,2649,28,6022,4.642.738.095
18/01/2020 11:00,23.76,50209,3375,51,0,2720,28,6174,4.642.738.095
18/01/2020 12:00,23.62,50070,3465,64,0,2836,31,6396,4.642.738.095
18/01/2020 13:00,23.47,49810,3425,83,0,2852,34,6394,4.642.738.095
18/01/2020 14:00,23.52,49852,3450,112,0,2854,35,6451,4.642.738.095
18/01/2020 15:00,23.84,50672,3433,147,0,2860,36,6476,4.642.738.095
18/01/2020 16:00,24.07,52185,3414,182,0,2924,27,6547,4.642.738.095
18/01/2020 17:00,24.34,53248,3381,209,0,2991,27,6608,4.642.738.095
18/01/2020 18:00,24.13,52633,3313,227,0,2984,25,6549,4.642.738.095
18/01/2020 19:00,23.82,51084,3198,241,0,2985,29,6453,4.642.738.095
18/01/2020 20:00,23.39,49297,3121,251,0,3013,27,6412,4.642.738.095
18/01/2020 21:00,23.14,48275,3078,258,0,3096,24,6456,4.642.738.095
18/01/2020 22:00,23.13,46913,3004,262,0,3060,22,6348,4.642.738.095
18/01/2020 23:00,22.66,45278,3028,263,0,3155,21,6467,4.642.738.095
19/01/2020 00:00,22.32,43786,2822,264,193,3233,47,6559,4.642.738.095
19/01/2020 01:00,21.92,42887,2912,264,191,3262,47,6676,4.642.738.095
19/01/2020 02:00,21.73,42517,3015,265,190,3394,45,6909,4.642.738.095
19/01/2020 03:00,21.57,42496,3082,266,189,3502,45,7084,4.642.738.095
19/01/2020 04:00,21.64,42723,3106,263,184,3743,44,7340,4.642.738.095
19/01/2020 05:00,21.92,43271,3087,261,174,3796,41,7359,4.642.738.095
19/01/2020 06:00,22.18,44265,3058,258,168,3911,33,7428,4.642.738.095
19/01/2020 07:00,22.13,45642,3098,255,160,3950,26,7489,4.642.738.095
19/01/2020 08:00,22.42,47058,3116,252,153,3997,21,7539,4.642.738.095
19/01/2020 09:00,22.7,48591,3132,248,144,4031,17,7572,4.642.738.095
19/01/2020 10:00,23.03,49654,3026,243,136,3893,13,7311,4.642.738.095
19/01/2020 11:00,23.09,49967,2904,237,127,3755,12,7035,4.642.738.095
19/01/2020 12:00,23.07,49752,2817,230,116,3637,12,6812,4.642.738.095
19/01/2020 13:00,23.07,49634,2602,220,106,3527,12,6467,4.642.738.095
19/01/2020 14:00,22.94,49850,2406,210,99,3570,11,6296,4.642.738.095
19/01/2020 15:00,23.31,50827,2236,198,94,3716,11,6255,4.642.738.095
19/01/2020 16:00,23.9,52468,2105,185,96,3705,12,6103,4.642.738.095
19/01/2020 17:00,24.36,53715,1930,173,99,3581,12,5795,4.642.738.095
19/01/2020 18:00,24.35,53351,1735,163,101,3532,13,5544,4.642.738.095
19/01/2020 19:00,24.01,52337,1569,153,102,3402,14,5240,4.642.738.095
19/01/2020 20:00,23.77,50997,1437,140,104,3265,14,4960,4.642.738.095
19/01/2020 21:00,23.8,50117,1383,124,108,3525,15,5155,4.642.738.095
19/01/2020 22:00,23.51,48638,1370,107,108,3598,15,5198,4.642.738.095
19/01/2020 23:00,23.14,46893,1380,88,105,3682,14,5269,4.642.738.095
20/01/2020 00:00,22.79,46011,1280,135,0,3995,16,5426,459.922.619
20/01/2020 01:00,22.45,45198,1333,128,0,4256,17,5734,459.922.619
20/01/2020 02:00,22.14,44877,1349,125,0,4822,19,6315,459.922.619
20/01/2020 03:00,22.05,45012,1401,121,0,5254,20,6796,459.922.619
20/01/2020 04:00,22.45,45933,1639,121,0,5514,19,7293,459.922.619
20/01/2020 05:00,23.06,48348,1939,116,0,5774,19,7848,459.922.619
20/01/2020 06:00,22.88,52652,2175,113,0,5974,20,8282,459.922.619
20/01/2020 07:00,23.59,56515,2407,117,0,6119,21,8664,459.922.619
20/01/2020 08:00,23.73,57423,2563,121,0,6177,26,8887,459.922.619
20/01/2020 09:00,23.64,57227,2717,131,0,6151,27,9026,459.922.619
20/01/2020 10:00,23.57,57105,2804,139,0,6139,30,9112,459.922.619
20/01/2020 11:00,23.64,56587,2893,140,0,6038,39,9110,459.922.619
20/01/2020 12:00,23.44,55936,3017,138,0,6052,44,9251,459.922.619
20/01/2020 13:00,23.41,55629,3023,140,0,6137,44,9344,459.922.619
20/01/2020 14:00,23.36,55527,3065,143,0,6272,43,9523,459.922.619
20/01/2020 15:00,23.4,55929,3114,150,0,6416,41,9721,459.922.619
20/01/2020 16:00,23.59,56772,3181,156,0,6607,42,9986,459.922.619
20/01/2020 17:00,23.6,57275,3182,162,0,6788,41,10173,459.922.619
20/01/2020 18:00,23.41,56036,3261,165,0,6852,43,10321,459.922.619
20/01/2020 19:00,22.91,54555,3272,167,0,6954,44,10437,459.922.619
20/01/2020 20:00,21.96,52713,3291,167,0,7013,43,10514,459.922.619
20/01/2020 21:00,21.45,51222,3302,165,0,7017,43,10527,459.922.619
20/01/2020 22:00,20.44,49045,3313,161,0,7061,44,10579,459.922.619
20/01/2020 23:00,19.07,46494,3405,154,0,7120,44,10723,459.922.619
21/01/2020 00:00,18.23,43961,3771,124,444,7130,48,11517,459.922.619
21/01/2020 01:00,18.53,42922,3880,122,448,7170,50,11670,459.922.619
21/01/2020 02:00,18.1,42542,3977,118,454,7158,50,11757,459.922.619
21/01/2020 03:00,18.19,42655,4002,112,457,7112,52,11735,459.922.619
21/01/2020 04:00,19.4,43494,3972,107,458,7109,52,11698,459.922.619
21/01/2020 05:00,19.66,45824,3959,107,462,7094,52,11674,459.922.619
21/01/2020 06:00,20.79,49799,3890,112,464,7085,51,11602,459.922.619
21/01/2020 07:00,21.77,53594,3938,125,463,7039,47,11612,459.922.619
21/01/2020 08:00,22.07,54492,3884,136,468,6886,45,11419,459.922.619
21/01/2020 09:00,21.98,54391,3878,145,472,6816,45,11356,459.922.619
21/01/2020 10:00,21.95,54497,3776,152,474,6664,45,11111,459.922.619
21/01/2020 11:00,21.9,54229,3750,160,475,6549,47,10981,459.922.619
21/01/2020 12:00,22,53912,3733,167,475,6385,51,10811,459.922.619
21/01/2020 13:00,21.98,53757,3736,175,472,6253,52,10688,459.922.619
21/01/2020 14:00,22.01,53821,3803,180,465,6180,50,10678,459.922.619
21/01/2020 15:00,22.13,54571,3761,183,454,6182,48,10628,459.922.619
21/01/2020 16:00,22.53,55692,3726,184,439,6235,47,10631,459.922.619
21/01/2020 17:00,22.72,56393,3587,185,417,6203,39,10431,459.922.619
21/01/2020 18:00,22.57,55515,3389,183,395,6205,40,10212,459.922.619
21/01/2020 19:00,22.01,54287,3279,183,366,6225,34,10087,459.922.619
21/01/2020 20:00,21.14,52580,3205,185,339,6256,30,10015,459.922.619
21/01/2020 21:00,20.89,51086,3105,188,317,6437,26,10073,459.922.619
21/01/2020 22:00,20.1,49003,3131,193,313,6591,24,10252,459.922.619
21/01/2020 23:00,18.96,46754,3206,196,314,6710,33,10459,459.922.619
22/01/2020 00:00,17.5,45227,3418,214,385,6832,28,10877,459.922.619
22/01/2020 01:00,17.18,44299,3609,215,398,6920,37,11179,459.922.619
22/01/2020 02:00,16.97,44075,3703,218,388,6902,36,11247,459.922.619
22/01/2020 03:00,17.15,44304,3692,219,376,6845,42,11174,459.922.619
22/01/2020 04:00,18.2,45209,3722,220,366,6758,41,11107,459.922.619
22/01/2020 05:00,20.01,47575,3826,219,358,6615,43,11061,459.922.619
22/01/2020 06:00,20.76,51711,3828,216,357,6435,47,10883,459.922.619
22/01/2020 07:00,21.55,55554,3915,213,357,6289,52,10826,459.922.619
22/01/2020 08:00,21.89,56422,3823,205,364,6059,53,10504,459.922.619
22/01/2020 09:00,21.87,56233,3718,200,375,5930,54,10277,459.922.619
22/01/2020 10:00,21.88,56209,3500,204,391,5835,54,9984,459.922.619
22/01/2020 11:00,21.79,55859,3281,208,406,5696,54,9645,459.922.619
22/01/2020 12:00,21.75,55437,2992,212,416,5402,54,9076,459.922.619
22/01/2020 13:00,21.84,55167,2529,220,422,5233,56,8460,459.922.619
22/01/2020 14:00,22.01,55273,1967,225,423,5120,56,7791,459.922.619
22/01/2020 15:00,22.52,56059,1456,228,418,4939,56,7097,459.922.619
22/01/2020 16:00,23.25,57333,1092,231,408,4799,56,6586,459.922.619
22/01/2020 17:00,23.82,58168,796,233,398,4634,56,6117,459.922.619
22/01/2020 18:00,23.81,57419,601,232,387,4446,55,5721,459.922.619
22/01/2020 19:00,23.49,56362,499,229,369,4195,55,5347,459.922.619
22/01/2020 20:00,22.8,54800,425,227,349,4069,56,5126,459.922.619
22/01/2020 21:00,22.69,53427,408,224,332,3720,56,4740,459.922.619
22/01/2020 22:00,21.77,51359,409,223,318,3658,54,4662,459.922.619
22/01/2020 23:00,21.42,49008,433,220,302,3513,52,4520,459.922.619
23/01/2020 00:00,20.75,46912,671,229,273,3280,34,4487,459.922.619
23/01/2020 01:00,20.57,45979,811,233,257,3090,32,4423,459.922.619
23/01/2020 02:00,20.45,45758,952,237,254,2915,31,4389,459.922.619
23/01/2020 03:00,20.46,46003,1097,241,252,2923,34,4547,459.922.619
23/01/2020 04:00,20.88,46935,1320,246,245,3074,33,4918,459.922.619
23/01/2020 05:00,21.12,49312,1507,250,232,3437,29,5455,459.922.619
23/01/2020 06:00,21.46,53548,1633,247,218,3791,24,5913,459.922.619
23/01/2020 07:00,22.57,57425,1870,240,198,4195,17,6520,459.922.619
23/01/2020 08:00,22.84,58327,1952,234,175,4653,11,7025,459.922.619
23/01/2020 09:00,22.28,57997,2035,227,152,4960,9,7383,459.922.619
23/01/2020 10:00,21.72,57881,2135,222,144,5320,10,7831,459.922.619
23/01/2020 11:00,21.12,57278,2329,217,161,5610,13,8330,459.922.619
23/01/2020 12:00,20.9,56447,2522,213,186,5961,13,8895,459.922.619
23/01/2020 13:00,20.77,56017,2662,211,223,6122,17,9235,459.922.619
23/01/2020 14:00,20.76,55853,2766,215,269,6329,23,9602,459.922.619
23/01/2020 15:00,20.78,56166,2789,220,304,6439,26,9778,459.922.619
23/01/2020 16:00,20.96,57039,2840,222,343,6517,37,9959,459.922.619
23/01/2020 17:00,20.95,57551,2799,219,370,6596,50,10034,459.922.619
23/01/2020 18:00,20.78,56556,2796,214,396,6583,45,10034,459.922.619
23/01/2020 19:00,20.46,55187,2827,210,413,6585,50,10085,459.922.619
23/01/2020 20:00,20.03,53319,2820,210,425,6633,50,10138,459.922.619
23/01/2020 21:00,19.78,51824,2698,210,436,6427,50,9821,459.922.619
23/01/2020 22:00,18.46,49668,2566,206,444,6334,51,9601,459.922.619
23/01/2020 23:00,16.91,47177,2399,194,444,6348,53,9438,459.922.619
24/01/2020 00:00,16.97,44916,2761,194,0,6286,53,9294,459.922.619
24/01/2020 01:00,17.04,43990,2754,167,0,6235,54,9210,459.922.619
24/01/2020 02:00,16.88,43548,2819,140,0,6106,54,9119,459.922.619
24/01/2020 03:00,16.97,43733,2908,115,0,5994,54,9071,459.922.619
24/01/2020 04:00,17.95,44686,2939,93,0,5791,54,8877,459.922.619
24/01/2020 05:00,19.03,47068,2980,78,0,5702,52,8812,459.922.619
24/01/2020 06:00,20.04,51233,2960,70,0,5498,52,8580,459.922.619
24/01/2020 07:00,20.84,55076,2947,74,0,5530,50,8601,459.922.619
24/01/2020 08:00,21.15,56099,2767,77,0,5383,49,8276,459.922.619
24/01/2020 09:00,20.99,56032,2557,80,0,5466,46,8149,459.922.619
24/01/2020 10:00,21.05,56099,2376,82,0,5465,47,7970,459.922.619
24/01/2020 11:00,20.9,55664,2331,81,0,5432,47,7891,459.922.619
24/01/2020 12:00,20.73,55085,2269,78,0,5437,48,7832,459.922.619
24/01/2020 13:00,20.77,54450,2200,82,0,5509,51,7842,459.922.619
24/01/2020 14:00,20.61,54225,2029,94,0,5710,48,7881,459.922.619
24/01/2020 15:00,20.55,54581,1883,113,0,5845,45,7886,459.922.619
24/01/2020 16:00,20.87,55646,1925,133,0,5933,42,8033,459.922.619
24/01/2020 17:00,21.16,56425,1952,145,0,6120,43,8260,459.922.619
24/01/2020 18:00,20.97,55736,1957,153,0,6129,37,8276,459.922.619
24/01/2020 19:00,20.61,54218,1939,155,0,6127,39,8260,459.922.619
24/01/2020 20:00,20.05,52173,1926,151,0,6163,39,8279,459.922.619
24/01/2020 21:00,19.61,50760,1883,142,0,6031,40,8096,459.922.619
24/01/2020 22:00,19,49134,1819,133,0,6111,42,8105,459.922.619
24/01/2020 23:00,18.09,47162,1736,121,0,6038,44,7939,459.922.619
25/01/2020 00:00,18.98,45132,1747,161,402,6037,40,8387,459.922.619
25/01/2020 01:00,18.96,44215,1663,160,403,5841,43,8110,459.922.619
25/01/2020 02:00,19,43782,1608,162,382,5712,37,7901,459.922.619
25/01/2020 03:00,19.05,43723,1552,162,368,5626,39,7747,459.922.619
25/01/2020 04:00,19.21,44019,1464,164,339,5473,39,7479,459.922.619
25/01/2020 05:00,19.31,44853,1319,162,311,5234,39,7065,459.922.619
25/01/2020 06:00,19.82,46083,1243,155,282,5055,38,6773,459.922.619
25/01/2020 07:00,20.27,47949,1218,155,262,4828,36,6499,459.922.619
25/01/2020 08:00,20.74,49725,1121,160,253,4504,33,6071,459.922.619
25/01/2020 09:00,21.06,51358,997,167,252,4292,31,5739,459.922.619
25/01/2020 10:00,21.36,52218,918,171,259,3967,24,5339,459.922.619
25/01/2020 11:00,21.32,52183,970,169,259,3719,27,5144,459.922.619
25/01/2020 12:00,21.27,51747,1019,166,254,3338,24,4801,459.922.619
25/01/2020 13:00,21.05,51270,1061,158,240,3025,20,4504,459.922.619
25/01/2020 14:00,21.03,51228,1126,152,203,2787,13,4281,459.922.619
25/01/2020 15:00,21.35,52021,1182,151,170,2703,10,4216,459.922.619
25/01/2020 16:00,21.86,53730,1275,152,153,2668,9,4257,459.922.619
25/01/2020 17:00,22.09,55047,1364,152,145,2819,8,4488,459.922.619
25/01/2020 18:00,21.83,54371,1477,152,135,3000,8,4772,459.922.619
25/01/2020 19:00,21.16,52732,1587,150,131,3154,8,5030,459.922.619
25/01/2020 20:00,20.81,50818,1712,150,131,3355,9,5357,459.922.619
25/01/2020 21:00,20.58,49703,1773,154,130,3586,10,5653,459.922.619
25/01/2020 22:00,20.39,48274,1834,158,137,3763,12,5904,459.922.619
25/01/2020 23:00,19.98,46529,1896,154,142,4043,15,6250,459.922.619
26/01/2020 00:00,19.22,44553,2345,188,147,4438,15,7133,459.922.619
26/01/2020 01:00,18.94,43550,2305,194,156,4738,20,7413,459.922.619
26/01/2020 02:00,18.6,43040,2221,196,173,5045,22,7657,459.922.619
26/01/2020 03:00,18.35,42880,2115,193,196,5232,28,7764,459.922.619
26/01/2020 04:00,18.8,43023,2019,184,218,5217,34,7672,459.922.619
26/01/2020 05:00,18.72,43399,1970,172,234,5163,40,7579,459.922.619
26/01/2020 06:00,18.84,44262,1951,160,247,5042,37,7437,459.922.619
26/01/2020 07:00,19.22,45578,1931,151,264,4848,34,7228,459.922.619
26/01/2020 08:00,19.54,46994,1948,146,276,4450,37,6857,459.922.619
26/01/2020 09:00,19.95,48595,1994,139,287,4152,39,6611,459.922.619
26/01/2020 10:00,20.28,49747,2034,126,286,3683,36,6165,459.922.619
26/01/2020 11:00,20.38,50176,2122,112,285,3297,32,5848,459.922.619
26/01/2020 12:00,20.4,50062,2241,107,274,2960,37,5619,459.922.619
26/01/2020 13:00,20.44,49948,2366,103,257,2643,39,5408,459.922.619
26/01/2020 14:00,20.52,50041,2435,105,236,2417,41,5234,459.922.619
26/01/2020 15:00,20.84,50841,2429,108,208,2268,36,5049,459.922.619
26/01/2020 16:00,21.23,52387,2488,107,192,2143,30,4960,459.922.619
26/01/2020 17:00,21.42,53510,2599,104,187,2119,28,5037,459.922.619
26/01/2020 18:00,21.35,53207,2701,106,183,2109,25,5124,459.922.619
26/01/2020 19:00,21.05,52131,2732,106,178,2075,24,5115,459.922.619
26/01/2020 20:00,20.66,50714,2719,103,163,2046,20,5051,459.922.619
26/01/2020 21:00,20.29,49760,2615,100,157,2103,18,4993,459.922.619
26/01/2020 22:00,20.07,48121,2506,100,146,2147,16,4915,459.922.619
26/01/2020 23:00,19.84,46210,2435,101,129,2147,14,4826,459.922.619
27/01/2020 00:00,19.54,44474,2446,120,118,2225,17,4926,4.477.916.667
27/01/2020 01:00,19.37,43709,2517,117,100,2206,17,4957,4.477.916.667
27/01/2020 02:00,19.26,43465,2686,120,86,2169,14,5075,4.477.916.667
27/01/2020 03:00,19.36,43651,2895,126,74,2403,14,5512,4.477.916.667
27/01/2020 04:00,19.77,44620,3064,124,64,2451,10,5713,4.477.916.667
27/01/2020 05:00,20.13,47162,3242,109,56,2549,10,5966,4.477.916.667
27/01/2020 06:00,20.97,51667,3372,96,47,2771,9,6295,4.477.916.667
27/01/2020 07:00,21.31,55674,3492,90,42,2859,9,6492,4.477.916.667
27/01/2020 08:00,21.42,56759,3394,84,40,2757,9,6284,4.477.916.667
27/01/2020 09:00,21.37,56653,3192,82,41,2873,8,6196,4.477.916.667
27/01/2020 10:00,21.4,56711,2946,84,41,2926,9,6006,4.477.916.667
27/01/2020 11:00,21.39,56410,2854,85,40,2972,9,5960,4.477.916.667
27/01/2020 12:00,21.38,55862,2752,87,39,2916,10,5804,4.477.916.667
27/01/2020 13:00,21.38,55596,2568,86,39,2823,10,5526,4.477.916.667
27/01/2020 14:00,21.45,55600,2371,86,42,2819,11,5329,4.477.916.667
27/01/2020 15:00,21.63,56040,2172,90,42,2877,11,5192,4.477.916.667
27/01/2020 16:00,21.96,56905,2114,94,57,2760,10,5035,4.477.916.667
27/01/2020 17:00,22.41,57603,2057,97,73,2551,11,4789,4.477.916.667
27/01/2020 18:00,21.96,56619,2071,102,89,2570,12,4844,4.477.916.667
27/01/2020 19:00,21.46,55264,2090,111,103,2561,13,4878,4.477.916.667
27/01/2020 20:00,21.16,53470,2022,129,111,2455,15,4732,4.477.916.667
27/01/2020 21:00,21.05,52063,1916,149,117,2420,17,4619,4.477.916.667
27/01/2020 22:00,20.64,49836,1817,164,123,2320,14,4438,4.477.916.667
27/01/2020 23:00,20.3,47177,1542,174,123,2224,15,4078,4.477.916.667
28/01/2020 00:00,20.13,45052,1004,31,0,1986,17,3038,4.477.916.667
28/01/2020 01:00,20.1,44078,1055,31,0,1860,18,2964,4.477.916.667
28/01/2020 02:00,20.1,43779,1262,30,0,1770,13,3075,4.477.916.667
28/01/2020 03:00,20.15,43905,1502,31,0,1664,13,3210,4.477.916.667
28/01/2020 04:00,20.36,44814,1647,32,0,1608,13,3300,4.477.916.667
28/01/2020 05:00,20.79,47287,1797,33,0,1631,12,3473,4.477.916.667
28/01/2020 06:00,21.47,51666,2123,34,0,1790,11,3958,4.477.916.667
28/01/2020 07:00,22.96,55603,2225,36,0,1846,11,4118,4.477.916.667
28/01/2020 08:00,23.3,56342,2314,37,0,1751,11,4113,4.477.916.667
28/01/2020 09:00,22.89,56181,2211,35,0,1834,12,4092,4.477.916.667
28/01/2020 10:00,22.73,56225,2118,34,0,1776,12,3940,4.477.916.667
28/01/2020 11:00,22.54,55961,2173,33,0,1777,15,3998,4.477.916.667
28/01/2020 12:00,22.48,55682,1953,32,0,1746,15,3746,4.477.916.667
28/01/2020 13:00,22.48,55569,1823,32,0,1751,17,3623,4.477.916.667
28/01/2020 14:00,22.58,55644,1763,32,0,1713,20,3528,4.477.916.667
28/01/2020 15:00,22.82,56155,1685,31,0,1718,24,3458,4.477.916.667
28/01/2020 16:00,23.16,57079,1676,31,0,1746,25,3478,4.477.916.667
28/01/2020 17:00,23.68,57798,1624,31,0,1775,27,3457,4.477.916.667
28/01/2020 18:00,23.35,56797,1695,32,0,1789,29,3545,4.477.916.667
28/01/2020 19:00,22.38,55378,1781,34,0,1792,30,3637,4.477.916.667
28/01/2020 20:00,21.45,53463,1890,36,0,1737,28,3691,4.477.916.667
28/01/2020 21:00,21.1,51946,2028,38,0,1772,28,3866,4.477.916.667
28/01/2020 22:00,20.49,49758,2192,40,0,1730,28,3990,4.477.916.667
28/01/2020 23:00,20.08,47311,2368,45,0,1836,25,4274,4.477.916.667
29/01/2020 00:00,19.95,45676,2924,56,0,1868,15,4863,4.477.916.667
29/01/2020 01:00,19.58,44666,3022,62,0,1980,15,5079,4.477.916.667
29/01/2020 02:00,19.16,44375,3031,67,0,2038,11,5147,4.477.916.667
29/01/2020 03:00,19.61,44465,2956,73,0,2136,11,5176,4.477.916.667
29/01/2020 04:00,19.97,45254,2866,82,0,2069,11,5028,4.477.916.667
29/01/2020 05:00,20.43,47634,2670,87,0,2143,9,4909,4.477.916.667
29/01/2020 06:00,21.12,51887,2539,93,0,2127,9,4768,4.477.916.667
29/01/2020 07:00,21.79,55876,2621,100,0,2197,10,4928,4.477.916.667
29/01/2020 08:00,22.11,56709,2586,105,0,2185,10,4886,4.477.916.667
29/01/2020 09:00,21.96,56412,2611,107,0,2262,8,4988,4.477.916.667
29/01/2020 10:00,21.92,56396,2669,106,0,2238,8,5021,4.477.916.667
29/01/2020 11:00,21.84,56059,2788,103,0,2093,8,4992,4.477.916.667
29/01/2020 12:00,21.64,55741,3024,98,0,2036,7,5165,4.477.916.667
29/01/2020 13:00,21.56,55581,3208,94,0,1919,7,5228,4.477.916.667
29/01/2020 14:00,21.53,55701,3407,89,0,1853,7,5356,4.477.916.667
29/01/2020 15:00,21.75,56250,3454,88,0,1805,6,5353,4.477.916.667
29/01/2020 16:00,22.13,57366,3590,90,0,1869,6,5555,4.477.916.667
29/01/2020 17:00,22.42,58288,3624,96,0,1896,7,5623,4.477.916.667
29/01/2020 18:00,22.2,57437,3622,106,0,1852,8,5588,4.477.916.667
29/01/2020 19:00,21.73,56185,3665,113,0,1888,8,5674,4.477.916.667
29/01/2020 20:00,21.3,54376,3632,116,0,1909,8,5665,4.477.916.667
29/01/2020 21:00,21.11,52795,3520,118,0,1919,7,5564,4.477.916.667
29/01/2020 22:00,20.61,50472,3465,120,0,1958,7,5550,4.477.916.667
29/01/2020 23:00,20.03,47900,3370,120,0,1904,7,5401,4.477.916.667
30/01/2020 00:00,19.77,44968,3064,125,115,1935,5,5244,4.477.916.667
30/01/2020 01:00,19.66,44106,2924,123,117,1809,5,4978,4.477.916.667
30/01/2020 02:00,19.68,43913,2892,120,122,1683,4,4821,4.477.916.667
30/01/2020 03:00,19.76,44091,2903,114,124,1593,5,4739,4.477.916.667
30/01/2020 04:00,19.91,44897,2882,106,121,1571,5,4685,4.477.916.667
30/01/2020 05:00,20.69,47087,2720,98,119,1523,5,4465,4.477.916.667
30/01/2020 06:00,21.32,51427,2722,91,118,1370,5,4306,4.477.916.667
30/01/2020 07:00,22.21,55475,2677,85,120,1313,5,4200,4.477.916.667
30/01/2020 08:00,22.57,56441,2556,79,120,1150,5,3910,4.477.916.667
30/01/2020 09:00,22.43,56280,2280,72,125,1059,6,3542,4.477.916.667
30/01/2020 10:00,22.59,56353,2019,64,137,932,5,3157,4.477.916.667
30/01/2020 11:00,22.44,55997,2013,58,161,884,5,3121,4.477.916.667
30/01/2020 12:00,22.43,55483,1898,53,187,806,5,2949,4.477.916.667
30/01/2020 13:00,22.22,55310,1878,47,189,764,6,2884,4.477.916.667
30/01/2020 14:00,22.13,55294,1985,40,161,745,7,2938,4.477.916.667
30/01/2020 15:00,22.07,55626,2116,39,129,714,5,3003,4.477.916.667
30/01/2020 16:00,22.26,56478,2258,39,112,718,5,3132,4.477.916.667
30/01/2020 17:00,22.36,57247,2435,39,106,742,7,3329,4.477.916.667
30/01/2020 18:00,21.94,56279,2669,38,107,778,7,3599,4.477.916.667
30/01/2020 19:00,21.36,55043,2929,38,107,931,5,4010,4.477.916.667
30/01/2020 20:00,21.02,53541,3108,39,96,1098,5,4346,4.477.916.667
30/01/2020 21:00,20.74,51795,3210,41,87,1304,5,4647,4.477.916.667
30/01/2020 22:00,20.27,49452,3397,41,81,1514,5,5038,4.477.916.667
30/01/2020 23:00,19.56,47185,3676,40,72,1684,6,5478,4.477.916.667
31/01/2020 00:00,16.9,46110,4436,42,121,2034,4,6637,4.477.916.667
31/01/2020 01:00,15.66,45272,4416,42,117,2136,4,6715,4.477.916.667
31/01/2020 02:00,15,44859,4521,42,110,2095,5,6773,4.477.916.667
31/01/2020 03:00,14.98,45005,4540,41,106,2106,5,6798,4.477.916.667
31/01/2020 04:00,15.98,45795,4598,41,99,2099,5,6842,4.477.916.667
31/01/2020 05:00,17.89,47874,4601,40,92,2026,5,6764,4.477.916.667
31/01/2020 06:00,19.41,51838,4589,39,89,2036,5,6758,4.477.916.667
31/01/2020 07:00,19.94,55733,4649,40,84,2112,6,6891,4.477.916.667
31/01/2020 08:00,20.06,56704,4495,40,69,2093,6,6703,4.477.916.667
31/01/2020 09:00,19.99,56497,4301,38,60,2117,6,6522,4.477.916.667
31/01/2020 10:00,19.98,56466,4050,35,42,2146,6,6279,4.477.916.667
31/01/2020 11:00,19.92,55970,3863,30,32,2277,6,6208,4.477.916.667
31/01/2020 12:00,19.81,55377,3695,27,22,2394,5,6143,4.477.916.667
31/01/2020 13:00,19.73,54833,3364,25,16,2599,5,6009,4.477.916.667
31/01/2020 14:00,19.62,54478,3047,23,17,2882,4,5973,4.477.916.667
31/01/2020 15:00,19.62,54536,2868,23,23,3131,4,6049,4.477.916.667
31/01/2020 16:00,19.91,55352,2906,24,34,3329,4,6297,4.477.916.667
31/01/2020 17:00,20.03,56247,2935,25,44,3341,4,6349,4.477.916.667
31/01/2020 18:00,19.93,55443,3022,25,51,3526,5,6629,4.477.916.667
31/01/2020 19:00,19.62,53821,3176,25,63,3620,6,6890,4.477.916.667
31/01/2020 20:00,19.09,51818,3321,25,82,3595,6,7029,4.477.916.667
31/01/2020 21:00,18.71,50192,3416,23,101,3472,6,7018,4.477.916.667
31/01/2020 22:00,18.3,48459,3428,23,124,3307,7,6889,4.477.916.667
31/01/2020 23:00,17.09,47607,3531,22,146,3402,7,7108,4.477.916.667
01/02/2020 00:00,15.07,45961,3918,191,97,3440,6,7652,4.477.916.667
01/02/2020 01:00,14.5,45145,3969,192,98,3484,8,7751,4.477.916.667
01/02/2020 02:00,14.12,44570,4133,190,93,3671,8,8095,4.477.916.667
01/02/2020 03:00,13.76,44311,4179,193,93,3839,7,8311,4.477.916.667
01/02/2020 04:00,13.01,44423,4276,199,91,4126,8,8700,4.477.916.667
01/02/2020 05:00,13.16,44965,4379,204,94,4236,8,8921,4.477.916.667
01/02/2020 06:00,14.26,45954,4397,206,102,4583,9,9297,4.477.916.667
01/02/2020 07:00,14.65,47597,4462,207,127,4766,12,9574,4.477.916.667
01/02/2020 08:00,15.31,49220,4373,209,161,4753,14,9510,4.477.916.667
01/02/2020 09:00,15.79,50737,4381,212,203,4798,19,9613,4.477.916.667
01/02/2020 10:00,15.92,51547,4377,209,244,4938,23,9791,4.477.916.667
01/02/2020 11:00,15.73,51584,4455,202,290,4916,29,9892,4.477.916.667
01/02/2020 12:00,15.43,51208,4474,190,334,4952,33,9983,4.477.916.667
01/02/2020 13:00,15.43,50744,4443,177,359,4703,34,9716,4.477.916.667
01/02/2020 14:00,15.11,50450,4459,161,359,4502,44,9525,4.477.916.667
01/02/2020 15:00,15.57,50763,4431,146,351,4390,48,9366,4.477.916.667
01/02/2020 16:00,16.25,52249,4580,135,348,4317,49,9429,4.477.916.667
01/02/2020 17:00,16.79,53553,4653,121,343,4514,49,9680,4.477.916.667
01/02/2020 18:00,16.98,53043,4670,105,339,4359,48,9521,4.477.916.667
01/02/2020 19:00,16.1,51436,4747,92,331,4164,50,9384,4.477.916.667
01/02/2020 20:00,15.01,49673,4804,87,311,4040,50,9292,4.477.916.667
01/02/2020 21:00,13.83,48543,4739,82,290,3919,50,9080,4.477.916.667
01/02/2020 22:00,13.81,47196,4721,76,277,3739,44,8857,4.477.916.667
01/02/2020 23:00,11.21,45663,4763,75,264,3723,40,8865,4.477.916.667
02/02/2020 00:00,13.23,43176,4633,88,325,3893,41,8980,4.477.916.667
02/02/2020 01:00,11.84,42398,4479,105,360,4069,39,9052,4.477.916.667
02/02/2020 02:00,11.03,42064,4533,121,375,4158,41,9228,4.477.916.667
02/02/2020 03:00,12.22,41939,4447,135,391,4190,47,9210,4.477.916.667
02/02/2020 04:00,12.9,42248,4613,149,398,4332,49,9541,4.477.916.667
02/02/2020 05:00,13.43,42652,4539,164,405,4540,51,9699,4.477.916.667
02/02/2020 06:00,13.78,43625,4345,179,410,4698,52,9684,4.477.916.667
02/02/2020 07:00,14.49,45082,4214,194,414,4737,52,9611,4.477.916.667
02/02/2020 08:00,15.63,46590,3864,203,419,4848,51,9385,4.477.916.667
02/02/2020 09:00,16.81,48197,3549,204,424,4864,52,9093,4.477.916.667
02/02/2020 10:00,17.01,49081,3217,199,424,4920,52,8812,4.477.916.667
02/02/2020 11:00,17.01,49181,2919,197,420,4964,48,8548,4.477.916.667
02/02/2020 12:00,16.96,48768,2756,193,414,5032,40,8435,4.477.916.667
02/02/2020 13:00,16.94,48412,2461,187,406,5078,38,8170,4.477.916.667
02/02/2020 14:00,16.99,48280,2061,175,408,5099,47,7790,4.477.916.667
02/02/2020 15:00,17.42,49129,1707,159,413,5156,46,7481,4.477.916.667
02/02/2020 16:00,18.13,50709,1509,137,407,5049,29,7131,4.477.916.667
02/02/2020 17:00,19.15,52459,1325,111,394,5065,31,6926,4.477.916.667
02/02/2020 18:00,19.17,52524,1210,85,383,5073,35,6786,4.477.916.667
02/02/2020 19:00,18.9,51382,1121,62,373,5170,35,6761,4.477.916.667
02/02/2020 20:00,17.91,50128,1007,48,364,5140,40,6599,4.477.916.667
02/02/2020 21:00,17.74,49213,921,39,358,5096,41,6455,4.477.916.667
02/02/2020 22:00,17.59,47701,818,35,352,5047,40,6292,4.477.916.667
02/02/2020 23:00,16.96,46065,721,33,342,5053,38,6187,4.477.916.667
03/02/2020 00:00,16.37,44621,814,25,345,4871,39,6094,4.314.345.238
03/02/2020 01:00,15.87,43902,727,26,334,4882,41,6010,4.314.345.238
03/02/2020 02:00,15.34,43770,626,25,329,4732,41,5753,4.314.345.238
03/02/2020 03:00,15.27,44199,534,26,313,4523,38,5434,4.314.345.238
03/02/2020 04:00,16.29,45284,435,26,305,4356,35,5157,4.314.345.238
03/02/2020 05:00,17.56,47928,374,28,297,3982,34,4715,4.314.345.238
03/02/2020 06:00,19.65,52618,368,27,288,3633,36,4352,4.314.345.238
03/02/2020 07:00,20.9,56897,401,27,283,3610,35,4356,4.314.345.238
03/02/2020 08:00,21.15,57848,467,27,283,3217,30,4024,4.314.345.238
03/02/2020 09:00,21.19,57596,575,27,284,2986,29,3901,4.314.345.238
03/02/2020 10:00,21.08,57350,764,26,283,2654,30,3757,4.314.345.238
03/02/2020 11:00,20.81,56532,1011,25,274,2337,27,3674,4.314.345.238
03/02/2020 12:00,20.55,55644,1365,24,264,2030,23,3706,4.314.345.238
03/02/2020 13:00,20.48,55235,1797,25,243,1814,19,3898,4.314.345.238
03/02/2020 14:00,20.49,55173,2422,23,216,1751,16,4428,4.314.345.238
03/02/2020 15:00,20.66,55765,3013,22,181,1739,15,4970,4.314.345.238
03/02/2020 16:00,20.97,57139,3500,25,160,1786,12,5483,4.314.345.238
03/02/2020 17:00,21.33,58483,3742,27,144,1876,9,5798,4.314.345.238
03/02/2020 18:00,21.12,57884,3791,28,127,1892,7,5845,4.314.345.238
03/02/2020 19:00,20.64,56671,3891,30,107,1888,5,5921,4.314.345.238
03/02/2020 20:00,19.75,55060,3919,32,90,1874,5,5920,4.314.345.238
03/02/2020 21:00,19.27,53691,3851,35,73,1918,5,5882,4.314.345.238
03/02/2020 22:00,18.72,51500,3810,39,59,1900,4,5812,4.314.345.238
03/02/2020 23:00,17.98,49041,3817,43,40,1860,4,5764,4.314.345.238
04/02/2020 00:00,17.69,47363,3757,164,0,1784,4,5709,4.314.345.238
04/02/2020 01:00,17.1,46437,3698,169,0,1763,4,5634,4.314.345.238
04/02/2020 02:00,16.49,46230,3742,178,0,1704,4,5628,4.314.345.238
04/02/2020 03:00,16.04,46491,3584,187,0,1644,4,5419,4.314.345.238
04/02/2020 04:00,16.74,47506,3438,192,0,1638,5,5273,4.314.345.238
04/02/2020 05:00,18.04,50131,3182,196,0,1551,6,4935,4.314.345.238
04/02/2020 06:00,20.59,54758,3195,194,0,1468,7,4864,4.314.345.238
04/02/2020 07:00,23.84,59028,3226,187,0,1484,8,4905,4.314.345.238
04/02/2020 08:00,27.66,59774,3159,181,0,1399,8,4747,4.314.345.238
04/02/2020 09:00,25.39,59760,3150,178,0,1335,8,4671,4.314.345.238
04/02/2020 10:00,24.45,59650,3072,180,0,1386,8,4646,4.314.345.238
04/02/2020 11:00,22.43,58804,2918,180,0,1280,10,4388,4.314.345.238
04/02/2020 12:00,21.76,58157,2635,181,0,1276,9,4101,4.314.345.238
04/02/2020 13:00,21.48,57853,2437,180,0,1423,9,4049,4.314.345.238
04/02/2020 14:00,21.2,58008,2487,180,0,1691,9,4367,4.314.345.238
04/02/2020 15:00,20.84,58630,2461,179,0,2157,10,4807,4.314.345.238
04/02/2020 16:00,20.86,59718,2541,177,0,2626,9,5353,4.314.345.238
04/02/2020 17:00,20.95,60913,2715,174,0,3329,9,6227,4.314.345.238
04/02/2020 18:00,20.64,60116,2881,164,0,3788,9,6842,4.314.345.238
04/02/2020 19:00,20.39,58797,2804,154,0,4238,9,7205,4.314.345.238
04/02/2020 20:00,19.76,57046,2588,141,0,4489,8,7226,4.314.345.238
04/02/2020 21:00,19.22,55603,2439,132,0,4577,9,7157,4.314.345.238
04/02/2020 22:00,18.72,53447,2290,122,0,4700,8,7120,4.314.345.238
04/02/2020 23:00,17.91,52679,2102,112,0,4710,8,6932,4.314.345.238
05/02/2020 00:00,16.27,48861,2211,125,133,4775,8,7252,4.314.345.238
05/02/2020 01:00,16.07,48010,1832,122,119,4727,6,6806,4.314.345.238
05/02/2020 02:00,16.01,47775,1509,120,107,4676,5,6417,4.314.345.238
05/02/2020 03:00,16.09,47946,1230,119,90,4598,5,6042,4.314.345.238
05/02/2020 04:00,16.54,48734,1136,118,73,4887,6,6220,4.314.345.238
05/02/2020 05:00,17.25,51243,1127,116,60,5034,8,6345,4.314.345.238
05/02/2020 06:00,18.27,55696,1189,116,46,4972,14,6337,4.314.345.238
05/02/2020 07:00,19.94,59604,1219,115,43,4950,16,6343,4.314.345.238
05/02/2020 08:00,20.52,60220,1243,112,47,5037,21,6460,4.314.345.238
05/02/2020 09:00,19.97,59811,1366,111,68,5136,25,6706,4.314.345.238
05/02/2020 10:00,19.22,59290,1541,109,89,5365,25,7129,4.314.345.238
05/02/2020 11:00,18.07,58288,1809,105,119,5424,27,7484,4.314.345.238
05/02/2020 12:00,17.77,57301,2306,101,159,5403,23,7992,4.314.345.238
05/02/2020 13:00,17.54,56798,2792,97,184,5410,18,8501,4.314.345.238
05/02/2020 14:00,17.57,56694,3221,93,192,5550,18,9074,4.314.345.238
05/02/2020 15:00,17.57,57223,3475,92,199,5763,16,9545,4.314.345.238
05/02/2020 16:00,17.65,58460,3670,92,219,5946,19,9946,4.314.345.238
05/02/2020 17:00,17.75,59605,3752,91,241,6119,21,10224,4.314.345.238
05/02/2020 18:00,17.64,58905,3836,87,266,6242,29,10460,4.314.345.238
05/02/2020 19:00,17.2,57547,3939,79,290,6344,31,10683,4.314.345.238
05/02/2020 20:00,16.51,55578,3992,71,308,6298,35,10704,4.314.345.238
05/02/2020 21:00,16.27,53910,3983,61,328,6130,36,10538,4.314.345.238
05/02/2020 22:00,15.74,51556,3998,51,348,5947,39,10383,4.314.345.238
05/02/2020 23:00,14.96,48891,3972,42,367,5680,43,10104,4.314.345.238
06/02/2020 00:00,14.71,46271,3829,21,0,5288,50,9188,4.314.345.238
06/02/2020 01:00,14.6,45333,3730,21,0,4890,52,8693,4.314.345.238
06/02/2020 02:00,14.52,45048,3879,24,0,4739,52,8694,4.314.345.238
06/02/2020 03:00,14.7,45276,3918,27,0,4474,51,8470,4.314.345.238
06/02/2020 04:00,15.13,46259,3887,33,0,4142,46,8108,4.314.345.238
06/02/2020 05:00,15.93,48714,3725,45,0,3886,43,7699,4.314.345.238
06/02/2020 06:00,16.6,53277,3564,60,0,3702,39,7365,4.314.345.238
06/02/2020 07:00,17.48,57225,3496,75,0,3488,23,7082,4.314.345.238
06/02/2020 08:00,17.85,57984,3388,88,0,3286,24,6786,4.314.345.238
06/02/2020 09:00,17.81,57583,3346,94,0,3171,17,6628,4.314.345.238
06/02/2020 10:00,17.8,57185,3355,102,0,3003,15,6475,4.314.345.238
06/02/2020 11:00,17.34,56405,3386,116,0,2660,14,6176,4.314.345.238
06/02/2020 12:00,17.16,55484,3385,118,0,2451,14,5968,4.314.345.238
06/02/2020 13:00,16.99,55067,3344,112,0,2270,11,5737,4.314.345.238
06/02/2020 14:00,17.17,55003,3232,109,0,2120,9,5470,4.314.345.238
06/02/2020 15:00,17.51,55279,2950,107,0,2078,7,5142,4.314.345.238
06/02/2020 16:00,17.98,56321,2756,110,0,2050,8,4924,4.314.345.238
06/02/2020 17:00,18.88,57428,2442,126,0,1972,10,4550,4.314.345.238
06/02/2020 18:00,18.92,56775,2099,161,0,1781,12,4053,4.314.345.238
06/02/2020 19:00,18.27,55514,1782,193,0,1497,13,3485,4.314.345.238
06/02/2020 20:00,17.93,53870,1396,209,0,1182,11,2798,4.314.345.238
06/02/2020 21:00,17.91,52557,1105,213,0,892,13,2223,4.314.345.238
06/02/2020 22:00,17.47,50538,902,204,0,700,17,1823,4.314.345.238
06/02/2020 23:00,16.84,48158,706,186,0,687,22,1601,4.314.345.238
07/02/2020 00:00,16.25,46669,504,193,116,720,21,1554,4.314.345.238
07/02/2020 01:00,16.12,45911,392,191,127,977,18,1705,4.314.345.238
07/02/2020 02:00,16.03,45543,323,195,136,1461,14,2129,4.314.345.238
07/02/2020 03:00,16,45788,264,201,146,2125,17,2753,4.314.345.238
07/02/2020 04:00,16.08,46772,224,207,150,2689,15,3285,4.314.345.238
07/02/2020 05:00,16.46,49167,161,201,142,3140,9,3653,4.314.345.238
07/02/2020 06:00,16.86,53403,110,183,135,3348,7,3783,4.314.345.238
07/02/2020 07:00,17.41,57296,100,159,118,3558,5,3940,4.314.345.238
07/02/2020 08:00,17.48,58024,134,139,95,3705,3,4076,4.314.345.238
07/02/2020 09:00,17.27,57671,203,121,77,3862,2,4265,4.314.345.238
07/02/2020 10:00,16.93,57270,296,101,64,3829,2,4292,4.314.345.238
07/02/2020 11:00,16.76,56412,413,88,45,3865,2,4413,4.314.345.238
07/02/2020 12:00,16.5,55457,495,86,35,3912,2,4530,4.314.345.238
07/02/2020 13:00,16.34,54546,550,96,30,3934,3,4613,4.314.345.238
07/02/2020 14:00,16.35,54031,590,110,28,3962,3,4693,4.314.345.238
07/02/2020 15:00,16.38,54047,622,129,32,3975,3,4761,4.314.345.238
07/02/2020 16:00,16.67,55043,702,153,40,4135,4,5034,4.314.345.238
07/02/2020 17:00,16.86,56237,845,177,55,4063,8,5148,4.314.345.238
07/02/2020 18:00,16.55,55824,1064,194,64,3757,11,5090,4.314.345.238
07/02/2020 19:00,16.17,53976,1389,201,79,3527,17,5213,4.314.345.238
07/02/2020 20:00,15.68,51734,1711,198,97,3323,24,5353,4.314.345.238
07/02/2020 21:00,15.51,50119,1994,188,118,3113,24,5437,4.314.345.238
07/02/2020 22:00,14.97,48260,2224,177,149,2914,29,5493,4.314.345.238
07/02/2020 23:00,14.67,46601,2392,162,178,2500,24,5256,4.314.345.238
08/02/2020 00:00,13.85,45405,2835,28,251,2402,27,5543,4.314.345.238
08/02/2020 01:00,13.66,44577,2881,32,264,2414,30,5621,4.314.345.238
08/02/2020 02:00,13.39,43994,3012,35,275,2414,28,5764,4.314.345.238
08/02/2020 03:00,13.2,43816,3071,40,279,2763,29,6182,4.314.345.238
08/02/2020 04:00,13.11,44012,3115,46,273,2940,26,6400,4.314.345.238
08/02/2020 05:00,13.06,44647,3119,55,257,3228,19,6678,4.314.345.238
08/02/2020 06:00,13.14,45784,3124,62,238,3483,14,6921,4.314.345.238
08/02/2020 07:00,13.31,47412,3150,71,219,3722,12,7174,4.314.345.238
08/02/2020 08:00,13.68,48973,3103,82,189,3955,9,7338,4.314.345.238
08/02/2020 09:00,13.93,50493,3138,90,162,4093,9,7492,4.314.345.238
08/02/2020 10:00,14.02,51120,3079,97,142,4109,9,7436,4.314.345.238
08/02/2020 11:00,14.06,50935,3003,111,128,4090,5,7337,4.314.345.238
08/02/2020 12:00,13.98,50329,2902,124,126,4035,9,7196,4.314.345.238
08/02/2020 13:00,13.92,49861,2871,135,113,3990,8,7117,4.314.345.238
08/02/2020 14:00,13.96,49573,2888,148,97,4002,7,7142,4.314.345.238
08/02/2020 15:00,14.06,49984,2775,160,85,4080,6,7106,4.314.345.238
08/02/2020 16:00,14.39,51353,2651,161,84,4182,8,7086,4.314.345.238
08/02/2020 17:00,14.64,52868,2491,156,95,4322,10,7074,4.314.345.238
08/02/2020 18:00,14.56,52665,2452,154,113,4453,12,7184,4.314.345.238
08/02/2020 19:00,14.16,51118,2453,153,130,4496,17,7249,4.314.345.238
08/02/2020 20:00,13.6,49445,2569,152,146,4478,19,7364,4.314.345.238
08/02/2020 21:00,13.36,48229,2789,146,164,4435,21,7555,4.314.345.238
08/02/2020 22:00,12.98,46824,2920,137,177,4383,24,7641,4.314.345.238
08/02/2020 23:00,12.15,45542,2898,131,185,4376,26,7616,4.314.345.238
09/02/2020 00:00,12.84,43961,3120,135,184,4385,23,7847,4.314.345.238
09/02/2020 01:00,12.47,43116,3206,128,185,4416,23,7958,4.314.345.238
09/02/2020 02:00,12.03,42716,3485,120,188,4307,24,8124,4.314.345.238
09/02/2020 03:00,9.79,42670,3724,116,192,4304,25,8361,4.314.345.238
09/02/2020 04:00,8.19,42881,4010,113,196,4577,26,8922,4.314.345.238
09/02/2020 05:00,7.04,43360,4194,109,201,4833,25,9362,4.314.345.238
09/02/2020 06:00,7.06,44360,4391,105,209,5166,24,9895,4.314.345.238
09/02/2020 07:00,9.34,45550,4584,105,211,5624,24,10548,4.314.345.238
09/02/2020 08:00,9.99,46934,4686,103,205,6131,28,11153,4.314.345.238
09/02/2020 09:00,10.42,48395,4762,96,191,6505,31,11585,4.314.345.238
09/02/2020 10:00,11.23,49240,4749,89,189,6712,35,11774,4.314.345.238
09/02/2020 11:00,11.62,49594,4867,84,196,6837,36,12020,4.314.345.238
09/02/2020 12:00,11.28,49347,4741,92,195,6994,39,12061,4.314.345.238
09/02/2020 13:00,10.98,49230,4639,105,218,7067,39,12068,4.314.345.238
09/02/2020 14:00,10.73,49173,4644,107,266,7243,43,12303,4.314.345.238
09/02/2020 15:00,10.78,49887,4445,116,321,7368,43,12293,4.314.345.238
09/02/2020 16:00,11.34,51088,4345,128,370,7419,43,12305,4.314.345.238
09/02/2020 17:00,12.02,52580,4035,140,411,7474,43,12103,4.314.345.238
09/02/2020 18:00,12.06,52266,3880,154,435,7535,51,12055,4.314.345.238
09/02/2020 19:00,10.98,51050,4038,162,451,7569,54,12274,4.314.345.238
09/02/2020 20:00,9.95,49690,4396,165,459,7592,55,12667,4.314.345.238
09/02/2020 21:00,9.63,48646,4701,165,464,7536,56,12922,4.314.345.238
09/02/2020 22:00,6.84,47028,4902,164,469,7492,56,13083,4.314.345.238
09/02/2020 23:00,3.6,45142,5001,161,469,7420,56,13107,4.314.345.238
10/02/2020 00:00,2.92,42558,4863,172,480,7289,56,12860,418.25
10/02/2020 01:00,2.01,41702,4690,160,483,7187,56,12576,418.25
10/02/2020 02:00,1.63,41429,4895,145,485,7066,56,12647,418.25
10/02/2020 03:00,1.83,41670,4858,130,485,6932,56,12461,418.25
10/02/2020 04:00,3.28,42679,4955,110,484,6804,56,12409,418.25
10/02/2020 05:00,7.81,45154,4845,90,484,6798,56,12273,418.25
10/02/2020 06:00,10.94,49617,4807,72,484,6748,56,12167,418.25
10/02/2020 07:00,13.06,53524,4851,53,485,6664,56,12109,418.25
10/02/2020 08:00,14.08,54585,4888,37,484,6458,56,11923,418.25
10/02/2020 09:00,13.16,54702,5059,23,482,6390,56,12010,418.25
10/02/2020 10:00,12.47,54648,5124,13,479,6326,55,11997,418.25
10/02/2020 11:00,12.5,54323,5199,9,477,6211,55,11951,418.25
10/02/2020 12:00,11.98,53937,5138,8,470,6204,55,11875,418.25
10/02/2020 13:00,11.96,53774,5112,12,466,6242,54,11886,418.25
10/02/2020 14:00,11.95,53743,5192,17,457,6353,53,12072,418.25
10/02/2020 15:00,12.14,54052,5098,26,447,6416,53,12040,418.25
10/02/2020 16:00,12.7,54810,5181,38,446,6600,54,12319,418.25
10/02/2020 17:00,13.95,55806,5156,54,453,6725,54,12442,418.25
10/02/2020 18:00,13.86,55386,5059,71,459,6804,53,12446,418.25
10/02/2020 19:00,13.3,54084,4949,82,465,6694,54,12244,418.25
10/02/2020 20:00,13.07,52345,4802,96,467,6580,55,12000,418.25
10/02/2020 21:00,12.46,50930,4642,110,469,6686,55,11962,418.25
10/02/2020 22:00,11.71,48841,4528,119,467,6600,55,11769,418.25
10/02/2020 23:00,8.75,46450,4481,124,461,6467,55,11588,418.25
11/02/2020 00:00,10.85,44316,3924,271,464,6397,53,11109,418.25
11/02/2020 01:00,9.83,43531,3876,271,459,6420,51,11077,418.25
11/02/2020 02:00,9.22,43317,4163,271,445,6299,53,11231,418.25
11/02/2020 03:00,9.91,43567,4282,271,426,6121,51,11151,418.25
11/02/2020 04:00,10.42,44616,4325,272,410,5922,51,10980,418.25
11/02/2020 05:00,11.54,47117,4428,272,393,5806,53,10952,418.25
11/02/2020 06:00,12.67,51377,4419,273,366,5690,51,10799,418.25
11/02/2020 07:00,13.98,55320,4687,273,342,5539,43,10884,418.25
11/02/2020 08:00,14.1,56107,4750,269,332,5435,35,10821,418.25
11/02/2020 09:00,13.41,55887,4861,263,320,5108,41,10593,418.25
11/02/2020 10:00,13.22,55775,4937,259,323,5058,31,10608,418.25
11/02/2020 11:00,13,55303,5025,256,335,4652,34,10302,418.25
11/02/2020 12:00,12.85,54826,5063,253,342,4303,38,9999,418.25
11/02/2020 13:00,12.77,54572,5031,250,359,4180,47,9867,418.25
11/02/2020 14:00,13.06,54532,5097,247,368,4164,42,9918,418.25
11/02/2020 15:00,13.01,54841,4966,247,368,4056,44,9681,418.25
11/02/2020 16:00,13.79,55836,5152,248,378,4200,45,10023,418.25
11/02/2020 17:00,14.16,56920,5119,248,396,4412,47,10222,418.25
11/02/2020 18:00,14.09,56527,5034,247,413,4589,46,10329,418.25
11/02/2020 19:00,13.73,55289,5018,244,425,4662,55,10404,418.25
11/02/2020 20:00,12.94,53528,4941,241,433,4645,53,10313,418.25
11/02/2020 21:00,12.22,52013,4897,238,440,4640,53,10268,418.25
11/02/2020 22:00,11.95,49891,4634,233,445,4705,51,10068,418.25
11/02/2020 23:00,10.11,47481,4789,226,452,4464,50,9981,418.25
12/02/2020 00:00,11.19,46825,4728,221,402,4504,35,9890,418.25
12/02/2020 01:00,11.06,46065,4632,210,411,4302,37,9592,418.25
12/02/2020 02:00,10.79,45972,4828,204,419,4349,31,9831,418.25
12/02/2020 03:00,10.95,46223,4862,199,424,4232,33,9750,418.25
12/02/2020 04:00,11.54,47174,4864,193,428,4238,37,9760,418.25
12/02/2020 05:00,12.83,49543,4904,185,430,4120,40,9679,418.25
12/02/2020 06:00,13.75,53592,4750,180,432,4018,47,9427,418.25
12/02/2020 07:00,14.33,57135,4847,175,432,3780,50,9284,418.25
12/02/2020 08:00,14.47,57910,4716,172,430,3571,51,8940,418.25
12/02/2020 09:00,14.43,57599,4763,170,432,3535,48,8948,418.25
12/02/2020 10:00,14.41,57504,4900,172,435,3365,43,8915,418.25
12/02/2020 11:00,14.27,57053,5006,171,437,3235,38,8887,418.25
12/02/2020 12:00,13.94,56356,5017,163,435,3070,43,8728,418.25
12/02/2020 13:00,13.9,55965,4998,150,434,3055,48,8685,418.25
12/02/2020 14:00,13.75,55815,5071,137,428,3111,41,8788,418.25
12/02/2020 15:00,13.75,55980,4912,128,422,3176,44,8682,418.25
12/02/2020 16:00,13.9,56931,5003,123,420,3356,46,8948,418.25
12/02/2020 17:00,14.34,58391,4828,125,424,3522,44,8943,418.25
12/02/2020 18:00,14.22,58142,4580,126,427,3789,43,8965,418.25
12/02/2020 19:00,13.98,57069,4411,127,427,4069,40,9074,418.25
12/02/2020 20:00,13.78,55402,4234,124,433,4043,35,8869,418.25
12/02/2020 21:00,13.66,54035,4131,119,436,4214,32,8932,418.25
12/02/2020 22:00,13.2,52019,3979,114,434,4224,38,8789,418.25
12/02/2020 23:00,12.83,49643,4041,104,433,4220,41,8839,418.25
13/02/2020 00:00,12.86,47119,3442,97,398,4098,42,8077,418.25
13/02/2020 01:00,12.86,46179,3305,91,406,4054,42,7898,418.25
13/02/2020 02:00,12.85,45951,3348,87,398,3946,41,7820,418.25
13/02/2020 03:00,12.91,46283,3254,83,402,3843,41,7623,418.25
13/02/2020 04:00,13.03,47179,3082,76,400,3856,42,7456,418.25
13/02/2020 05:00,13.44,49174,2769,70,398,3659,42,6938,418.25
13/02/2020 06:00,14.27,53133,2209,68,395,3657,44,6373,418.25
13/02/2020 07:00,18.11,56713,1866,67,387,3554,42,5916,418.25
13/02/2020 08:00,18.88,57507,1626,70,385,3245,40,5366,418.25
13/02/2020 09:00,18.62,57177,1427,69,390,3092,40,5018,418.25
13/02/2020 10:00,17.42,56833,1221,70,397,2659,34,4381,418.25
13/02/2020 11:00,15.97,56086,1098,75,398,2314,34,3919,418.25
13/02/2020 12:00,15.41,55288,1026,85,396,2036,34,3577,418.25
13/02/2020 13:00,15.41,54941,956,91,385,1709,37,3178,418.25
13/02/2020 14:00,15.36,54775,883,94,354,1682,33,3046,418.25
13/02/2020 15:00,15.68,54913,803,96,318,1612,31,2860,418.25
13/02/2020 16:00,15.88,55795,876,98,288,1622,30,2914,418.25
13/02/2020 17:00,16.64,57263,1101,103,271,1821,26,3322,418.25
13/02/2020 18:00,18.09,57110,1248,107,250,1956,23,3584,418.25
13/02/2020 19:00,16.77,56173,1301,108,228,2131,23,3791,418.25
13/02/2020 20:00,15.71,54939,1224,107,207,2265,23,3826,418.25
13/02/2020 21:00,15.33,53529,1105,102,197,2301,21,3726,418.25
13/02/2020 22:00,14.53,51626,957,95,180,2352,16,3600,418.25
13/02/2020 23:00,13.92,49570,818,87,147,2343,14,3409,418.25
14/02/2020 00:00,13.98,47914,672,126,103,2351,10,3262,418.25
14/02/2020 01:00,13.94,47135,481,117,81,2327,8,3014,418.25
14/02/2020 02:00,13.95,46744,373,102,66,2136,7,2684,418.25
14/02/2020 03:00,14.09,46985,306,99,58,2071,7,2541,418.25
14/02/2020 04:00,14.48,47904,250,91,55,2061,5,2462,418.25
14/02/2020 05:00,15.14,50115,221,83,52,1927,5,2288,418.25
14/02/2020 06:00,15.56,53923,178,82,51,1728,5,2044,418.25
14/02/2020 07:00,18.59,57538,143,80,42,1705,4,1974,418.25
14/02/2020 08:00,19.09,58444,110,75,32,1647,5,1869,418.25
14/02/2020 09:00,18.77,58221,98,71,26,1528,4,1727,418.25
14/02/2020 10:00,17.97,57786,88,70,19,1561,3,1741,418.25
14/02/2020 11:00,16.58,56900,81,70,17,1422,3,1593,418.25
14/02/2020 12:00,15.75,55764,108,68,16,1323,3,1518,418.25
14/02/2020 13:00,15.24,54825,226,65,16,1397,4,1708,418.25
14/02/2020 14:00,15.22,54263,430,59,18,1433,3,1943,418.25
14/02/2020 15:00,15.09,54157,646,55,15,1473,3,2192,418.25
14/02/2020 16:00,15.02,55153,907,53,17,1825,3,2805,418.25
14/02/2020 17:00,15.34,56812,1237,54,17,2249,3,3560,418.25
14/02/2020 18:00,15.22,56868,1607,56,17,2514,4,4198,418.25
14/02/2020 19:00,13.97,55403,2139,55,16,2911,4,5125,418.25
14/02/2020 20:00,13.28,53606,2721,52,17,3217,4,6011,418.25
14/02/2020 21:00,13.12,52216,3230,47,20,3686,4,6987,418.25
14/02/2020 22:00,12.74,50575,3470,44,24,3963,5,7506,418.25
14/02/2020 23:00,12.67,48724,3791,41,27,4122,5,7986,418.25
15/02/2020 00:00,11.74,47333,3925,114,13,4500,3,8555,418.25
15/02/2020 01:00,11.47,46440,3827,96,18,4665,3,8609,418.25
15/02/2020 02:00,11.25,45807,3863,80,26,5177,4,9150,418.25
15/02/2020 03:00,11.11,45569,3704,62,35,5421,4,9226,418.25
15/02/2020 04:00,11.19,45634,3420,47,53,5477,5,9002,418.25
15/02/2020 05:00,11.45,46219,3084,35,72,5458,5,8654,418.25
15/02/2020 06:00,11.46,47175,2714,26,97,5445,7,8289,418.25
15/02/2020 07:00,11.75,48603,2632,20,120,5260,10,8042,418.25
15/02/2020 08:00,12.02,50148,2553,16,138,5046,17,7770,418.25
15/02/2020 09:00,12.34,51701,2514,15,158,4760,21,7468,418.25
15/02/2020 10:00,12.52,52350,2564,15,188,4346,27,7140,418.25
15/02/2020 11:00,12.53,52161,2710,17,216,4030,29,7002,418.25
15/02/2020 12:00,12.46,51667,2817,19,242,3669,34,6781,418.25
15/02/2020 13:00,12.39,51135,3014,20,266,3337,36,6673,418.25
15/02/2020 14:00,12.36,50673,3402,24,275,3205,34,6940,418.25
15/02/2020 15:00,12.4,50796,3728,29,296,3005,36,7094,418.25
15/02/2020 16:00,12.56,51944,4228,37,315,3219,33,7832,418.25
15/02/2020 17:00,12.77,53641,4564,47,329,3358,36,8334,418.25
15/02/2020 18:00,12.58,53409,4692,60,336,3653,36,8777,418.25
15/02/2020 19:00,12.18,51880,4754,70,333,4049,36,9242,418.25
15/02/2020 20:00,11.12,50106,4737,79,318,4433,33,9600,418.25
15/02/2020 21:00,10,48965,4736,89,306,4694,32,9857,418.25
15/02/2020 22:00,9.43,47610,4594,101,293,4973,28,9989,418.25
15/02/2020 23:00,7.71,45976,4759,110,285,5365,26,10545,418.25
16/02/2020 00:00,9.25,43710,4249,139,342,5908,31,10669,418.25
16/02/2020 01:00,9.17,42672,4226,152,360,6379,30,11147,418.25
16/02/2020 02:00,8.36,42103,4509,159,383,6737,34,11822,418.25
16/02/2020 03:00,7.44,41951,4552,161,389,6906,35,12043,418.25
16/02/2020 04:00,5.67,41977,4574,166,401,7074,39,12254,418.25
16/02/2020 05:00,5.35,42386,4706,174,408,7242,44,12574,418.25
16/02/2020 06:00,6.93,42962,4588,182,412,7491,43,12716,418.25
16/02/2020 07:00,7.69,43949,4729,187,413,7537,47,12913,418.25
16/02/2020 08:00,8.57,45321,4427,192,411,7525,49,12604,418.25
16/02/2020 09:00,8.84,46939,4243,199,413,7446,49,12350,418.25
16/02/2020 10:00,9.34,48024,4343,204,418,7487,51,12503,418.25
16/02/2020 11:00,9.5,48496,4684,207,423,7343,51,12708,418.25
16/02/2020 12:00,9.56,48441,4854,210,427,7090,52,12633,418.25
16/02/2020 13:00,9.39,48216,4825,213,438,6880,52,12408,418.25
16/02/2020 14:00,9.05,47973,4870,216,451,6829,53,12419,418.25
16/02/2020 15:00,9.06,48218,4712,218,461,6623,53,12067,418.25
16/02/2020 16:00,9.68,49381,4930,223,468,6510,53,12184,418.25
16/02/2020 17:00,10.39,51044,5009,232,473,6359,53,12126,418.25
16/02/2020 18:00,10.4,51170,4908,242,477,6379,53,12059,418.25
16/02/2020 19:00,10.09,50035,4796,249,479,6279,53,11856,418.25
16/02/2020 20:00,9.46,48531,4651,255,479,6198,53,11636,418.25
16/02/2020 21:00,9.19,47772,4626,260,480,6057,53,11476,418.25
16/02/2020 22:00,8.92,46340,4538,263,479,6034,53,11367,418.25
16/02/2020 23:00,8.45,44465,4822,265,475,6066,52,11680,418.25
17/02/2020 00:00,6.95,43584,4826,45,0,6094,52,11017,4.086.488.095
17/02/2020 01:00,6.76,42835,4708,43,0,6328,53,11132,4.086.488.095
17/02/2020 02:00,6.34,42554,4857,41,0,6632,53,11583,4.086.488.095
17/02/2020 03:00,5.1,42898,4839,39,0,6826,53,11757,4.086.488.095
17/02/2020 04:00,5.31,43875,4852,37,0,6924,53,11866,4.086.488.095
17/02/2020 05:00,9.14,46449,4811,35,0,6932,53,11831,4.086.488.095
17/02/2020 06:00,11.25,50749,4581,31,0,6837,53,11502,4.086.488.095
17/02/2020 07:00,11.64,54541,4713,26,0,6956,53,11748,4.086.488.095
17/02/2020 08:00,11.87,55343,4608,20,0,6779,53,11460,4.086.488.095
17/02/2020 09:00,11.85,55284,4623,15,0,6782,53,11473,4.086.488.095
17/02/2020 10:00,11.82,55245,4710,12,0,6729,53,11504,4.086.488.095
17/02/2020 11:00,11.61,54732,4885,13,0,6469,53,11420,4.086.488.095
17/02/2020 12:00,11.5,54288,4915,13,0,6386,53,11367,4.086.488.095
17/02/2020 13:00,11.46,53949,4916,13,0,6340,53,11322,4.086.488.095
17/02/2020 14:00,11.48,53969,5033,14,0,6384,53,11484,4.086.488.095
17/02/2020 15:00,11.45,54053,4937,12,0,6435,53,11437,4.086.488.095
17/02/2020 16:00,11.64,54815,5136,12,0,6695,52,11895,4.086.488.095
17/02/2020 17:00,11.94,56017,5106,13,0,6818,52,11989,4.086.488.095
17/02/2020 18:00,11.94,55703,4979,13,0,6863,52,11907,4.086.488.095
17/02/2020 19:00,11.56,54429,4903,13,0,6720,53,11689,4.086.488.095
17/02/2020 20:00,11.27,52575,4764,12,0,6567,53,11396,4.086.488.095
17/02/2020 21:00,11.12,51165,4692,12,0,6411,53,11168,4.086.488.095
17/02/2020 22:00,10.84,49021,4481,14,0,6361,52,10908,4.086.488.095
17/02/2020 23:00,9.78,46373,4577,16,0,6332,52,10977,4.086.488.095
18/02/2020 00:00,9.77,44725,4322,249,394,6307,51,11323,4.086.488.095
18/02/2020 01:00,9.69,43906,4165,243,386,6291,51,11136,4.086.488.095
18/02/2020 02:00,9.04,43728,4295,237,376,6521,51,11480,4.086.488.095
18/02/2020 03:00,8.61,43811,4340,233,370,6428,50,11421,4.086.488.095
18/02/2020 04:00,8.96,44790,4400,233,368,6497,50,11548,4.086.488.095
18/02/2020 05:00,10.32,47286,4484,236,371,6454,50,11595,4.086.488.095
18/02/2020 06:00,11.06,51371,4369,243,372,6478,49,11511,4.086.488.095
18/02/2020 07:00,11.69,54967,4490,243,373,6661,49,11816,4.086.488.095
18/02/2020 08:00,11.79,55766,4442,242,374,6480,47,11585,4.086.488.095
18/02/2020 09:00,11.67,55444,4534,243,380,6370,49,11576,4.086.488.095
18/02/2020 10:00,11.55,55447,4727,246,393,6272,48,11686,4.086.488.095
18/02/2020 11:00,11.18,54918,4928,249,403,6175,48,11803,4.086.488.095
18/02/2020 12:00,10.89,54354,4986,251,413,6069,48,11767,4.086.488.095
18/02/2020 13:00,10.85,54030,4976,252,421,6071,48,11768,4.086.488.095
18/02/2020 14:00,11.38,53753,5047,253,423,6068,48,11839,4.086.488.095
18/02/2020 15:00,11.44,53846,4914,252,420,6247,48,11881,4.086.488.095
18/02/2020 16:00,11.63,54730,5073,251,420,6260,50,12054,4.086.488.095
18/02/2020 17:00,11.92,56318,4923,252,420,6207,50,11852,4.086.488.095
18/02/2020 18:00,11.94,56238,4694,254,423,6271,50,11692,4.086.488.095
18/02/2020 19:00,11.91,55133,4574,255,434,6344,49,11656,4.086.488.095
18/02/2020 20:00,11.73,53444,4388,257,450,6162,47,11304,4.086.488.095
18/02/2020 21:00,11.56,51987,4207,259,458,6037,48,11009,4.086.488.095
18/02/2020 22:00,11.29,49936,3858,261,460,5835,50,10464,4.086.488.095
18/02/2020 23:00,10.96,47586,3555,261,450,5526,50,9842,4.086.488.095
19/02/2020 00:00,10.26,45749,3164,263,446,5161,48,9082,4.086.488.095
19/02/2020 01:00,10.22,44870,2768,264,434,4913,49,8428,4.086.488.095
19/02/2020 02:00,10.34,44734,2566,265,425,4540,48,7844,4.086.488.095
19/02/2020 03:00,10.73,44979,2410,265,413,4182,46,7316,4.086.488.095
19/02/2020 04:00,11.01,46029,2350,264,398,3819,46,6877,4.086.488.095
19/02/2020 05:00,11.44,48519,2410,262,385,3433,42,6532,4.086.488.095
19/02/2020 06:00,11.92,52602,2324,260,369,3298,41,6292,4.086.488.095
19/02/2020 07:00,12.79,56235,2315,257,349,3054,40,6015,4.086.488.095
19/02/2020 08:00,13.96,56938,2431,252,335,2695,37,5750,4.086.488.095
19/02/2020 09:00,13.99,56690,2478,244,320,2344,43,5429,4.086.488.095
19/02/2020 10:00,13.85,56632,2533,236,315,2021,44,5149,4.086.488.095
19/02/2020 11:00,13.15,55996,2683,230,314,1754,43,5024,4.086.488.095
19/02/2020 12:00,12.42,55100,2807,223,313,1483,46,4872,4.086.488.095
19/02/2020 13:00,12.38,54577,2862,216,305,1311,42,4736,4.086.488.095
19/02/2020 14:00,12.41,54232,2955,209,290,1325,40,4819,4.086.488.095
19/02/2020 15:00,12.47,54225,2992,205,274,1201,41,4713,4.086.488.095
19/02/2020 16:00,13.03,54981,3196,203,262,1199,39,4899,4.086.488.095
19/02/2020 17:00,13.8,56713,3196,203,252,1209,34,4894,4.086.488.095
19/02/2020 18:00,14.35,56963,3128,201,242,1177,30,4778,4.086.488.095
19/02/2020 19:00,13.73,56058,3036,200,229,1171,21,4657,4.086.488.095
19/02/2020 20:00,13.12,54503,2915,200,209,1057,15,4396,4.086.488.095
19/02/2020 21:00,12.47,53062,2811,198,192,963,11,4175,4.086.488.095
19/02/2020 22:00,11.97,51130,2584,199,179,921,15,3898,4.086.488.095
19/02/2020 23:00,11.75,48833,2493,199,164,904,13,3773,4.086.488.095
20/02/2020 00:00,10.86,47135,2227,183,114,973,18,3515,4.086.488.095
20/02/2020 01:00,10.65,46343,2139,184,103,1203,18,3647,4.086.488.095
20/02/2020 02:00,10.49,46286,2233,183,93,1502,18,4029,4.086.488.095
20/02/2020 03:00,10.42,46560,2422,178,85,1979,17,4681,4.086.488.095
20/02/2020 04:00,10.38,47665,2613,172,74,2610,17,5486,4.086.488.095
20/02/2020 05:00,10.65,50117,2934,166,65,3271,17,6453,4.086.488.095
20/02/2020 06:00,11.01,54276,3424,162,54,3812,17,7469,4.086.488.095
20/02/2020 07:00,11.5,57901,3756,160,42,4234,17,8209,4.086.488.095
20/02/2020 08:00,11.56,58676,3978,161,34,4652,17,8842,4.086.488.095
20/02/2020 09:00,11.42,58304,4314,162,32,4976,17,9501,4.086.488.095
20/02/2020 10:00,11.2,57802,4483,161,35,5306,17,10002,4.086.488.095
20/02/2020 11:00,10.94,57055,4648,157,40,5670,17,10532,4.086.488.095
20/02/2020 12:00,10.66,56238,4783,144,59,6023,18,11027,4.086.488.095
20/02/2020 13:00,10.47,55850,4793,129,70,6387,21,11400,4.086.488.095
20/02/2020 14:00,10.4,55812,4874,109,66,6814,20,11883,4.086.488.095
20/02/2020 15:00,10.31,55881,4848,93,49,7050,22,12062,4.086.488.095
20/02/2020 16:00,10.3,56575,5152,79,61,7168,21,12481,4.086.488.095
20/02/2020 17:00,10.55,58142,5158,63,85,7296,23,12625,4.086.488.095
20/02/2020 18:00,10.45,58129,5054,54,115,7516,27,12766,4.086.488.095
20/02/2020 19:00,10.14,56856,5034,45,158,7646,30,12913,4.086.488.095
20/02/2020 20:00,9.8,55095,4864,39,211,7605,41,12760,4.086.488.095
20/02/2020 21:00,9.3,53552,4739,33,256,7661,43,12732,4.086.488.095
20/02/2020 22:00,8.8,51382,4617,27,296,7655,44,12639,4.086.488.095
20/02/2020 23:00,8.07,49142,4714,23,322,7564,42,12665,4.086.488.095
21/02/2020 00:00,8.3,46478,4702,17,357,7418,47,12541,4.086.488.095
21/02/2020 01:00,7.63,45595,4549,14,388,7267,46,12264,4.086.488.095
21/02/2020 02:00,7.39,45178,4498,13,406,6882,45,11844,4.086.488.095
21/02/2020 03:00,7.96,45369,4475,13,425,6522,47,11482,4.086.488.095
21/02/2020 04:00,8.49,46340,4380,13,435,6120,49,10997,4.086.488.095
21/02/2020 05:00,8.9,48717,4457,11,440,5789,49,10746,4.086.488.095
21/02/2020 06:00,9.46,52537,4479,7,443,5374,47,10350,4.086.488.095
21/02/2020 07:00,10.66,56122,4490,5,440,5101,47,10083,4.086.488.095
21/02/2020 08:00,10.88,56964,4402,3,424,4945,46,9820,4.086.488.095
21/02/2020 09:00,10.73,56588,4523,2,405,4850,44,9824,4.086.488.095
21/02/2020 10:00,10.5,56213,4595,2,376,4898,41,9912,4.086.488.095
21/02/2020 11:00,9.96,55596,4827,3,346,4904,36,10116,4.086.488.095
21/02/2020 12:00,9.57,54759,4984,5,321,5122,28,10460,4.086.488.095
21/02/2020 13:00,9.43,54053,5032,8,309,5335,16,10700,4.086.488.095
21/02/2020 14:00,9.28,53597,5130,12,303,5780,23,11248,4.086.488.095
21/02/2020 15:00,9.08,53488,5086,19,287,6208,28,11628,4.086.488.095
21/02/2020 16:00,9.18,54142,5415,35,274,6622,28,12374,4.086.488.095
21/02/2020 17:00,9.42,55635,5378,54,280,7120,27,12859,4.086.488.095
21/02/2020 18:00,9.43,55700,5301,77,294,7442,28,13142,4.086.488.095
21/02/2020 19:00,9.14,54034,5356,103,309,7627,30,13425,4.086.488.095
21/02/2020 20:00,8.84,51812,5205,126,319,7742,38,13430,4.086.488.095
21/02/2020 21:00,8.57,50225,5138,147,323,7689,38,13335,4.086.488.095
21/02/2020 22:00,8.19,48387,4864,165,333,7612,39,13013,4.086.488.095
21/02/2020 23:00,7.22,46303,5158,179,342,7639,45,13363,4.086.488.095
22/02/2020 00:00,7.9,44392,4901,39,315,7472,43,12770,4.086.488.095
22/02/2020 01:00,6.32,43517,4844,48,331,7370,45,12638,4.086.488.095
22/02/2020 02:00,5.97,42965,4866,55,346,7352,48,12667,4.086.488.095
22/02/2020 03:00,4.65,42780,4887,62,366,7355,50,12720,4.086.488.095
22/02/2020 04:00,5.06,42917,4765,72,380,7494,52,12763,4.086.488.095
22/02/2020 05:00,6.08,43584,4848,87,397,7448,52,12832,4.086.488.095
22/02/2020 06:00,6.4,44585,4949,110,415,7397,52,12923,4.086.488.095
22/02/2020 07:00,6.79,46060,4922,133,434,7159,53,12701,4.086.488.095
22/02/2020 08:00,7.19,47875,4904,152,449,7095,53,12653,4.086.488.095
22/02/2020 09:00,7.71,49460,5171,169,462,6779,53,12634,4.086.488.095
22/02/2020 10:00,7.91,50172,5220,185,470,6425,53,12353,4.086.488.095
22/02/2020 11:00,7.91,50106,5353,200,479,6144,53,12229,4.086.488.095
22/02/2020 12:00,7.9,49800,5407,213,487,5795,53,11955,4.086.488.095
22/02/2020 13:00,7.72,49386,5383,224,489,5633,53,11782,4.086.488.095
22/02/2020 14:00,7.48,49112,5449,230,488,5662,53,11882,4.086.488.095
22/02/2020 15:00,7.6,49342,5355,233,489,6052,53,12182,4.086.488.095
22/02/2020 16:00,8.37,50594,5655,233,490,6153,53,12584,4.086.488.095
22/02/2020 17:00,8.9,52362,5611,228,489,6335,53,12716,4.086.488.095
22/02/2020 18:00,9.06,52519,5522,218,489,6713,53,12995,4.086.488.095
22/02/2020 19:00,8.71,51125,5515,202,491,6635,53,12896,4.086.488.095
22/02/2020 20:00,7.67,49321,5369,182,488,6813,53,12905,4.086.488.095
22/02/2020 21:00,6.94,48321,5468,164,489,6949,53,13123,4.086.488.095
22/02/2020 22:00,6.65,47257,5038,149,489,6980,53,12709,4.086.488.095
22/02/2020 23:00,6.51,45799,5360,137,485,7025,53,13060,4.086.488.095
23/02/2020 00:00,6.13,44548,4919,160,467,7100,52,12698,4.086.488.095
23/02/2020 01:00,6.11,43766,4777,162,466,7053,52,12510,4.086.488.095
23/02/2020 02:00,5.91,43384,4769,173,465,7137,51,12595,4.086.488.095
23/02/2020 03:00,5.69,43236,4745,187,462,7193,52,12639,4.086.488.095
23/02/2020 04:00,5.95,43381,4751,204,463,7118,51,12587,4.086.488.095
23/02/2020 05:00,6.49,43852,4800,218,460,7132,51,12661,4.086.488.095
23/02/2020 06:00,6.12,44601,4839,230,460,7183,50,12762,4.086.488.095
23/02/2020 07:00,6.49,45700,4762,240,459,7198,50,12709,4.086.488.095
23/02/2020 08:00,7.22,47142,4695,246,462,7155,50,12608,4.086.488.095
23/02/2020 09:00,8.57,48611,4872,251,462,7152,50,12787,4.086.488.095
23/02/2020 10:00,8.93,49428,4851,252,461,6998,50,12612,4.086.488.095
23/02/2020 11:00,8.95,49565,4912,253,462,6896,49,12572,4.086.488.095
23/02/2020 12:00,8.89,49150,4899,252,461,6863,49,12524,4.086.488.095
23/02/2020 13:00,8.93,48776,4781,252,461,6744,49,12287,4.086.488.095
23/02/2020 14:00,8.85,48759,4748,254,457,6468,49,11976,4.086.488.095
23/02/2020 15:00,8.71,49005,4601,258,445,6221,49,11574,4.086.488.095
23/02/2020 16:00,8.81,50333,4833,261,429,5972,49,11544,4.086.488.095
23/02/2020 17:00,9.5,52478,4831,265,413,5934,49,11492,4.086.488.095
23/02/2020 18:00,10.06,53223,4798,267,397,6099,49,11610,4.086.488.095
23/02/2020 19:00,9.49,52434,4787,267,384,6281,47,11766,4.086.488.095
23/02/2020 20:00,8.79,51140,4650,267,365,6495,44,11821,4.086.488.095
23/02/2020 21:00,8.56,50313,4676,267,351,6554,44,11892,4.086.488.095
23/02/2020 22:00,8.74,49006,4211,265,342,6488,47,11353,4.086.488.095
23/02/2020 23:00,8.21,47357,4300,263,333,6515,46,11457,4.086.488.095
24/02/2020 00:00,7.44,45888,4266,192,264,6362,32,11116,387.202.381
24/02/2020 01:00,7.55,45275,4142,207,264,6252,34,10899,387.202.381
24/02/2020 02:00,7.72,45132,3990,219,277,6080,37,10603,387.202.381
24/02/2020 03:00,8.82,45484,3788,227,300,5797,34,10146,387.202.381
24/02/2020 04:00,9.41,46562,3481,234,302,5685,42,9744,387.202.381
24/02/2020 05:00,10.19,49151,2965,240,304,5592,41,9142,387.202.381
24/02/2020 06:00,10.98,53442,2647,243,301,5526,41,8758,387.202.381
24/02/2020 07:00,11.49,57055,2143,245,293,5410,37,8128,387.202.381
24/02/2020 08:00,12.67,57875,1624,247,287,5067,35,7260,387.202.381
24/02/2020 09:00,11.84,57500,1222,247,285,4682,37,6473,387.202.381
24/02/2020 10:00,11.73,57096,956,247,284,4360,35,5882,387.202.381
24/02/2020 11:00,11.6,56108,821,246,276,3976,35,5354,387.202.381
24/02/2020 12:00,11.36,55124,808,241,267,3800,32,5148,387.202.381
24/02/2020 13:00,11.31,54791,914,232,254,3566,28,4994,387.202.381
24/02/2020 14:00,11.38,54605,1046,220,232,3333,27,4858,387.202.381
24/02/2020 15:00,11.44,54600,1246,209,190,3117,25,4787,387.202.381
24/02/2020 16:00,11.42,55455,1574,202,168,2965,20,4929,387.202.381
24/02/2020 17:00,11.82,57223,1998,201,157,2751,18,5125,387.202.381
24/02/2020 18:00,12.65,57619,2550,206,148,2691,18,5613,387.202.381
24/02/2020 19:00,12.31,56551,3223,210,135,2596,17,6181,387.202.381
24/02/2020 20:00,11.57,54883,3740,214,128,2417,15,6514,387.202.381
24/02/2020 21:00,11.46,53673,4101,217,126,2264,13,6721,387.202.381
24/02/2020 22:00,11.01,51594,4153,221,122,2062,9,6567,387.202.381
24/02/2020 23:00,9.83,49095,4317,225,114,2097,7,6760,387.202.381
25/02/2020 00:00,9.82,47522,3886,131,87,2189,9,6302,387.202.381
25/02/2020 01:00,9.53,46786,3949,138,80,2324,9,6500,387.202.381
25/02/2020 02:00,9.39,46719,4161,150,84,2569,11,6975,387.202.381
25/02/2020 03:00,9.53,46990,4186,162,95,3006,12,7461,387.202.381
25/02/2020 04:00,9.81,47985,4114,176,109,3090,13,7502,387.202.381
25/02/2020 05:00,10.61,50294,3904,189,128,3227,13,7461,387.202.381
25/02/2020 06:00,12.06,54305,4105,199,147,3389,14,7854,387.202.381
25/02/2020 07:00,13.57,57882,4075,206,171,3479,14,7945,387.202.381
25/02/2020 08:00,13.83,58675,4123,215,201,3377,14,7930,387.202.381
25/02/2020 09:00,13.57,58257,4273,225,222,3339,15,8074,387.202.381
25/02/2020 10:00,13,58075,4249,232,241,3205,16,7943,387.202.381
25/02/2020 11:00,12.66,57538,4305,234,241,3147,17,7944,387.202.381
25/02/2020 12:00,12.22,56881,4235,233,232,3187,21,7908,387.202.381
25/02/2020 13:00,11.93,56604,4095,232,220,3198,24,7769,387.202.381
25/02/2020 14:00,11.93,56347,4135,224,202,3177,27,7765,387.202.381
25/02/2020 15:00,11.86,56510,4201,212,181,3374,26,7994,387.202.381
25/02/2020 16:00,11.94,57378,4438,198,174,3595,24,8429,387.202.381
25/02/2020 17:00,13.12,59044,4404,184,177,3706,20,8491,387.202.381
25/02/2020 18:00,12.99,59359,4429,170,185,3866,21,8671,387.202.381
25/02/2020 19:00,12.27,58341,4435,155,198,3891,19,8698,387.202.381
25/02/2020 20:00,11.72,56672,4183,135,222,3925,21,8486,387.202.381
25/02/2020 21:00,11.65,55286,3930,113,253,3959,22,8277,387.202.381
25/02/2020 22:00,11.18,53157,3576,92,283,3987,29,7967,387.202.381
25/02/2020 23:00,10.7,50864,3351,74,306,3964,33,7728,387.202.381
26/02/2020 00:00,11.22,48577,3036,50,0,3962,19,7067,387.202.381
26/02/2020 01:00,10.92,47785,2895,42,0,3824,20,6781,387.202.381
26/02/2020 02:00,10.81,47711,2719,37,0,3749,22,6527,387.202.381
26/02/2020 03:00,10.89,48015,2673,31,0,3599,22,6325,387.202.381
26/02/2020 04:00,11.2,48988,2658,25,0,3486,24,6193,387.202.381
26/02/2020 05:00,11.94,51301,2588,21,0,3415,25,6049,387.202.381
26/02/2020 06:00,13.43,55365,2689,19,0,3303,35,6046,387.202.381
26/02/2020 07:00,14.89,58825,2542,17,0,3205,27,5791,387.202.381
26/02/2020 08:00,18.87,59648,2432,16,0,3122,27,5597,387.202.381
26/02/2020 09:00,17.38,59522,2487,16,0,3055,32,5590,387.202.381
26/02/2020 10:00,15.94,59186,2426,18,0,3005,29,5478,387.202.381
26/02/2020 11:00,13.9,58652,2322,19,0,3039,24,5404,387.202.381
26/02/2020 12:00,13.63,57841,2162,22,0,2973,23,5180,387.202.381
26/02/2020 13:00,13.28,57306,1993,25,0,2907,27,4952,387.202.381
26/02/2020 14:00,13.34,57040,1894,31,0,2833,23,4781,387.202.381
26/02/2020 15:00,13.47,57073,1768,40,0,2683,27,4518,387.202.381
26/02/2020 16:00,13.54,57876,1615,53,0,2663,28,4359,387.202.381
26/02/2020 17:00,13.87,59522,1309,68,0,2710,25,4112,387.202.381
26/02/2020 18:00,14.2,60032,1107,81,0,2721,25,3934,387.202.381
26/02/2020 19:00,13.8,59206,998,89,0,2634,26,3747,387.202.381
26/02/2020 20:00,13.68,57688,838,95,0,2494,23,3450,387.202.381
26/02/2020 21:00,13.56,56333,687,103,0,2301,19,3110,387.202.381
26/02/2020 22:00,13.3,54334,573,107,0,2137,21,2838,387.202.381
26/02/2020 23:00,12.74,52065,503,108,0,1980,18,2609,387.202.381
27/02/2020 00:00,12.63,50188,227,123,182,1734,21,2287,387.202.381
27/02/2020 01:00,12.22,49383,268,127,186,1811,20,2412,387.202.381
27/02/2020 02:00,12.18,49258,330,130,195,1774,16,2445,387.202.381
27/02/2020 03:00,12.12,49561,393,134,208,1740,12,2487,387.202.381
27/02/2020 04:00,12.19,50604,461,133,215,1755,13,2577,387.202.381
27/02/2020 05:00,13.39,52926,511,130,217,1679,13,2550,387.202.381
27/02/2020 06:00,16.26,57004,574,130,223,1666,10,2603,387.202.381
27/02/2020 07:00,22.55,60562,551,128,231,1537,10,2457,387.202.381
27/02/2020 08:00,32.11,61382,533,124,248,1497,8,2410,387.202.381
27/02/2020 09:00,25.01,61026,608,119,269,1388,10,2394,387.202.381
27/02/2020 10:00,22.03,60566,664,117,302,1279,7,2369,387.202.381
27/02/2020 11:00,19.06,59893,797,115,323,1098,6,2339,387.202.381
27/02/2020 12:00,18.43,59016,877,114,344,1105,6,2446,387.202.381
27/02/2020 13:00,17.18,58564,850,119,362,1086,7,2424,387.202.381
27/02/2020 14:00,18.81,58279,830,123,366,1105,7,2431,387.202.381
27/02/2020 15:00,18.66,58290,713,126,362,1103,9,2313,387.202.381
27/02/2020 16:00,19.14,58828,634,132,356,1178,7,2307,387.202.381
27/02/2020 17:00,21.73,60243,588,141,345,1307,7,2388,387.202.381
27/02/2020 18:00,22.1,60604,548,146,331,1457,8,2490,387.202.381
27/02/2020 19:00,19.98,59607,496,150,322,1532,8,2508,387.202.381
27/02/2020 20:00,17.68,58010,524,149,312,1653,8,2646,387.202.381
27/02/2020 21:00,15.86,56633,612,146,307,1696,9,2770,387.202.381
27/02/2020 22:00,14.47,54619,699,144,304,1695,8,2850,387.202.381
27/02/2020 23:00,13.64,52367,860,136,300,1742,8,3046,387.202.381
28/02/2020 00:00,13.3,50561,1272,163,269,1756,9,3469,387.202.381
28/02/2020 01:00,12.6,49850,1451,157,249,1776,7,3640,387.202.381
28/02/2020 02:00,12.51,49630,1651,154,239,1863,7,3914,387.202.381
28/02/2020 03:00,12.59,49948,1874,151,226,1980,7,4238,387.202.381
28/02/2020 04:00,12.77,50983,2000,148,209,2008,7,4372,387.202.381
28/02/2020 05:00,13.96,53469,2117,146,187,1952,8,4410,387.202.381
28/02/2020 06:00,15.59,57446,2361,146,168,1888,8,4571,387.202.381
28/02/2020 07:00,18.75,61119,2453,146,157,1996,8,4760,387.202.381
28/02/2020 08:00,19.59,61973,2487,146,158,1903,7,4701,387.202.381
28/02/2020 09:00,19.4,61447,2603,146,176,1820,11,4756,387.202.381
28/02/2020 10:00,18.71,60711,2748,146,191,1778,14,4877,387.202.381
28/02/2020 11:00,15.98,59793,3003,149,210,1582,14,4958,387.202.381
28/02/2020 12:00,14.6,58805,3193,150,229,1519,13,5104,387.202.381
28/02/2020 13:00,14.33,57825,3203,149,241,1488,10,5091,387.202.381
28/02/2020 14:00,14.99,57018,3049,149,231,1600,9,5038,387.202.381
28/02/2020 15:00,13.92,56625,2815,149,205,1672,7,4848,387.202.381
28/02/2020 16:00,13.98,57174,2649,149,178,1826,6,4808,387.202.381
28/02/2020 17:00,15.24,58842,2256,148,159,2048,6,4617,387.202.381
28/02/2020 18:00,15.46,59341,1916,143,140,2379,6,4584,387.202.381
28/02/2020 19:00,14.34,57978,1803,135,125,2540,6,4609,387.202.381
28/02/2020 20:00,13.51,55866,1755,123,113,2661,7,4659,387.202.381
28/02/2020 21:00,13.3,54362,1836,110,111,2634,7,4698,387.202.381
28/02/2020 22:00,13.9,52686,1914,99,114,2466,6,4599,387.202.381
28/02/2020 23:00,12.93,50696,2196,89,112,2318,6,4721,387.202.381
29/02/2020 00:00,10.65,48857,3250,234,79,2547,6,6116,387.202.381
29/02/2020 01:00,10.29,48062,3503,245,76,2351,6,6181,387.202.381
29/02/2020 02:00,10.08,47692,3660,250,80,2147,7,6144,387.202.381
29/02/2020 03:00,10.03,47515,3826,252,86,2139,7,6310,387.202.381
29/02/2020 04:00,9.99,47727,3734,253,89,2132,6,6214,387.202.381
29/02/2020 05:00,9.81,48500,3601,255,87,2168,6,6117,387.202.381
29/02/2020 06:00,10.03,49588,3534,257,90,2319,7,6207,387.202.381
29/02/2020 07:00,10.63,51044,3383,259,94,2389,9,6134,387.202.381
29/02/2020 08:00,10.9,52764,3404,262,105,2302,9,6082,387.202.381
29/02/2020 09:00,11.48,54122,3515,264,124,2226,8,6137,387.202.381
29/02/2020 10:00,11.22,54489,3608,266,146,1995,8,6023,387.202.381
29/02/2020 11:00,10.84,54240,3818,267,161,1790,10,6046,387.202.381
29/02/2020 12:00,10.48,53509,3869,267,171,1726,12,6045,387.202.381
29/02/2020 13:00,10.15,52956,3660,266,181,1750,12,5869,387.202.381
29/02/2020 14:00,10.09,52545,3468,265,195,1849,13,5790,387.202.381
29/02/2020 15:00,10.08,52568,3385,264,203,1953,11,5816,387.202.381
29/02/2020 16:00,10.38,53505,3658,265,236,2182,8,6349,387.202.381
29/02/2020 17:00,11.14,55275,3825,265,286,2488,10,6874,387.202.381
29/02/2020 18:00,11.46,55797,4080,264,326,2726,16,7412,387.202.381
29/02/2020 19:00,10.79,54486,4350,263,346,2840,21,7820,387.202.381
29/02/2020 20:00,9.91,52610,4519,262,345,2919,22,8067,387.202.381
29/02/2020 21:00,9.81,51391,4820,258,341,3114,23,8556,387.202.381
29/02/2020 22:00,10,50122,4645,254,331,3153,18,8401,387.202.381
29/02/2020 23:00,9.59,48589,4973,251,320,3424,18,8986,387.202.381
01/03/2020 00:00,9.38,47498,4276,267,325,3560,17,8445,387.202.381
01/03/2020 01:00,9.34,46627,4248,266,329,3643,19,8505,387.202.381
01/03/2020 02:00,9.22,46134,4251,262,349,3813,20,8695,387.202.381
01/03/2020 03:00,8.93,46044,4341,256,360,4020,21,8998,387.202.381
01/03/2020 04:00,8.46,46255,4299,249,367,4240,28,9183,387.202.381
01/03/2020 05:00,8.39,46638,4467,240,369,4309,34,9419,387.202.381
01/03/2020 06:00,8.59,47362,4726,228,365,4386,34,9739,387.202.381
01/03/2020 07:00,8.9,48389,4724,218,352,4354,43,9691,387.202.381
01/03/2020 08:00,9.23,49831,4823,208,339,4032,45,9447,387.202.381
01/03/2020 09:00,9.45,51255,4999,205,342,3791,44,9381,387.202.381
01/03/2020 10:00,9.66,52059,4989,206,348,3714,44,9301,387.202.381
01/03/2020 11:00,9.63,52169,5081,201,349,3786,45,9462,387.202.381
01/03/2020 12:00,9.53,52058,5086,198,339,3892,45,9560,387.202.381
01/03/2020 13:00,9.47,51717,4956,190,312,3804,45,9307,387.202.381
01/03/2020 14:00,9.44,51563,4905,176,272,3790,45,9188,387.202.381
01/03/2020 15:00,9.49,51738,4794,163,221,3777,45,9000,387.202.381
01/03/2020 16:00,10.72,52514,4907,149,209,3740,44,9049,387.202.381
01/03/2020 17:00,11.65,54201,4649,137,215,3719,43,8763,387.202.381
01/03/2020 18:00,11.85,54957,4439,130,224,3609,41,8443,387.202.381
01/03/2020 19:00,11.67,54127,4244,125,234,3707,35,8345,387.202.381
01/03/2020 20:00,11.21,52705,3912,124,238,3526,30,7830,387.202.381
01/03/2020 21:00,10.95,51698,3710,126,242,3481,28,7587,387.202.381
01/03/2020 22:00,10.77,50271,3348,128,239,3491,26,7232,387.202.381
01/03/2020 23:00,10.4,48507,3255,131,225,3496,24,7131,387.202.381
02/03/2020 00:00,9.94,47025,2871,68,227,3502,20,6688,3.649.702.381
02/03/2020 01:00,9.97,46276,2570,59,200,3382,18,6229,3.649.702.381
02/03/2020 02:00,10,45965,2236,55,181,3362,21,5855,3.649.702.381
02/03/2020 03:00,10.08,46209,2060,56,163,3508,22,5809,3.649.702.381
02/03/2020 04:00,10.34,47017,1958,64,141,3460,18,5641,3.649.702.381
02/03/2020 05:00,11.17,49289,1802,72,125,3356,15,5370,3.649.702.381
02/03/2020 06:00,11.85,53310,1794,72,117,3226,15,5224,3.649.702.381
02/03/2020 07:00,13.76,56722,1595,60,106,3010,15,4786,3.649.702.381
02/03/2020 08:00,14.8,57553,1449,41,85,2841,14,4430,3.649.702.381
02/03/2020 09:00,14.43,57273,1309,26,72,2615,9,4031,3.649.702.381
02/03/2020 10:00,13.85,56863,1246,19,68,2335,8,3676,3.649.702.381
02/03/2020 11:00,13.78,56121,1179,16,75,2199,6,3475,3.649.702.381
02/03/2020 12:00,13.81,55344,1024,19,78,2042,5,3168,3.649.702.381
02/03/2020 13:00,13.82,55010,838,25,80,1925,4,2872,3.649.702.381
02/03/2020 14:00,13.75,54769,663,31,80,1853,4,2631,3.649.702.381
02/03/2020 15:00,13.63,54614,508,34,88,1764,3,2397,3.649.702.381
02/03/2020 16:00,13.76,55058,404,36,104,1879,3,2426,3.649.702.381
02/03/2020 17:00,13.94,56429,337,37,127,1961,3,2465,3.649.702.381
02/03/2020 18:00,14.74,56911,373,38,142,2135,7,2695,3.649.702.381
02/03/2020 19:00,14.07,56064,501,40,134,2141,10,2826,3.649.702.381
02/03/2020 20:00,13.68,54512,685,41,115,2081,14,2936,3.649.702.381
02/03/2020 21:00,12.78,53188,829,41,99,2185,12,3166,3.649.702.381
02/03/2020 22:00,11.9,51130,881,41,82,2014,10,3028,3.649.702.381
02/03/2020 23:00,11.57,48772,946,40,64,2036,7,3093,3.649.702.381
03/03/2020 00:00,11.28,46801,735,191,80,1972,7,2985,3.649.702.381
03/03/2020 01:00,11.23,45991,868,179,63,1978,5,3093,3.649.702.381
03/03/2020 02:00,11.27,45907,909,166,53,2178,5,3311,3.649.702.381
03/03/2020 03:00,11.34,46070,887,155,49,2268,3,3362,3.649.702.381
03/03/2020 04:00,11.46,46917,886,143,44,2459,3,3535,3.649.702.381
03/03/2020 05:00,11.53,49054,992,134,40,2505,3,3674,3.649.702.381
03/03/2020 06:00,11.75,53028,1109,130,44,2480,3,3766,3.649.702.381
03/03/2020 07:00,13.62,56394,1127,123,47,2541,5,3843,3.649.702.381
03/03/2020 08:00,13.99,57143,1132,112,41,2234,5,3524,3.649.702.381
03/03/2020 09:00,13.67,56898,1137,106,35,2199,3,3480,3.649.702.381
03/03/2020 10:00,13.44,56805,998,103,32,1937,3,3073,3.649.702.381
03/03/2020 11:00,13.07,56206,766,94,27,1942,2,2831,3.649.702.381
03/03/2020 12:00,12.59,55713,595,80,29,1925,2,2631,3.649.702.381
03/03/2020 13:00,12.3,55425,517,64,46,1925,3,2555,3.649.702.381
03/03/2020 14:00,12.15,55071,525,49,86,2111,3,2774,3.649.702.381
03/03/2020 15:00,12.14,55065,522,40,129,2353,4,3048,3.649.702.381
03/03/2020 16:00,12.16,55528,451,38,184,2563,3,3239,3.649.702.381
03/03/2020 17:00,13.08,56865,368,37,243,2713,6,3367,3.649.702.381
03/03/2020 18:00,13.6,57326,344,34,290,2995,8,3671,3.649.702.381
03/03/2020 19:00,13.92,56391,396,32,309,2875,9,3621,3.649.702.381
03/03/2020 20:00,12.59,54647,530,30,296,2807,7,3670,3.649.702.381
03/03/2020 21:00,11.95,53222,639,33,280,2652,9,3613,3.649.702.381
03/03/2020 22:00,11.4,51114,678,37,258,2569,9,3551,3.649.702.381
03/03/2020 23:00,10.78,48869,753,42,232,2464,11,3502,3.649.702.381
04/03/2020 00:00,10.9,47098,592,56,271,2723,35,3677,3.649.702.381
04/03/2020 01:00,10.73,46302,644,60,252,2651,34,3641,3.649.702.381
04/03/2020 02:00,10.73,46195,619,63,245,2632,29,3588,3.649.702.381
04/03/2020 03:00,10.77,46406,637,65,246,2674,30,3652,3.649.702.381
04/03/2020 04:00,10.93,47249,695,66,252,2676,22,3711,3.649.702.381
04/03/2020 05:00,11.59,49319,702,68,261,2673,23,3727,3.649.702.381
04/03/2020 06:00,12.51,53226,716,66,270,2658,21,3731,3.649.702.381
04/03/2020 07:00,13.47,56574,744,58,283,2728,28,3841,3.649.702.381
04/03/2020 08:00,13.7,57304,828,49,292,2687,35,3891,3.649.702.381
04/03/2020 09:00,13.55,57108,925,44,305,2799,37,4110,3.649.702.381
04/03/2020 10:00,13.27,56812,965,42,309,2826,39,4181,3.649.702.381
04/03/2020 11:00,13.04,56339,1038,41,298,2828,43,4248,3.649.702.381
04/03/2020 12:00,12.82,55624,1101,42,284,2773,44,4244,3.649.702.381
04/03/2020 13:00,12.53,55295,1147,45,271,2873,43,4379,3.649.702.381
04/03/2020 14:00,12.45,55056,1162,52,257,2962,44,4477,3.649.702.381
04/03/2020 15:00,12.41,54939,1145,63,219,3098,42,4567,3.649.702.381
04/03/2020 16:00,12.53,55322,1062,77,197,3142,42,4520,3.649.702.381
04/03/2020 17:00,13.09,56630,896,90,181,3064,40,4271,3.649.702.381
04/03/2020 18:00,13.28,57147,847,99,164,3257,35,4402,3.649.702.381
04/03/2020 19:00,13.75,56260,866,103,149,3075,32,4225,3.649.702.381
04/03/2020 20:00,13.35,54683,852,105,143,3071,28,4199,3.649.702.381
04/03/2020 21:00,13.09,53265,853,108,137,2966,32,4096,3.649.702.381
04/03/2020 22:00,12.17,51197,905,112,132,2860,34,4043,3.649.702.381
04/03/2020 23:00,11.22,48911,927,117,127,2817,33,4021,3.649.702.381
05/03/2020 00:00,11.07,46834,516,89,90,2563,13,3271,3.649.702.381
05/03/2020 01:00,10.99,45993,445,103,79,2547,11,3185,3.649.702.381
05/03/2020 02:00,10.98,45836,353,120,71,2341,11,2896,3.649.702.381
05/03/2020 03:00,11.24,46037,276,143,66,2169,10,2664,3.649.702.381
05/03/2020 04:00,11.93,47008,212,167,64,1949,9,2401,3.649.702.381
05/03/2020 05:00,12.15,49240,168,189,67,1862,15,2301,3.649.702.381
05/03/2020 06:00,12.42,53278,148,204,71,1714,9,2146,3.649.702.381
05/03/2020 07:00,16.23,56737,131,211,71,1565,10,1988,3.649.702.381
05/03/2020 08:00,19.6,57531,127,212,71,1459,10,1879,3.649.702.381
05/03/2020 09:00,18.19,57224,127,208,79,1321,13,1748,3.649.702.381
05/03/2020 10:00,14.82,56947,131,202,90,1268,16,1707,3.649.702.381
05/03/2020 11:00,14.23,56405,152,193,102,1223,17,1687,3.649.702.381
05/03/2020 12:00,14.17,55687,167,186,109,1238,20,1720,3.649.702.381
05/03/2020 13:00,13.87,55219,183,184,105,1254,16,1742,3.649.702.381
05/03/2020 14:00,13.59,54808,217,179,90,1239,15,1740,3.649.702.381
05/03/2020 15:00,13.66,54667,280,178,67,1188,15,1728,3.649.702.381
05/03/2020 16:00,13.78,54979,351,182,48,1175,19,1775,3.649.702.381
05/03/2020 17:00,14.03,56197,475,179,42,1228,13,1937,3.649.702.381
05/03/2020 18:00,14.53,56847,641,172,40,1381,10,2244,3.649.702.381
05/03/2020 19:00,17.72,56043,803,165,45,1527,8,2548,3.649.702.381
05/03/2020 20:00,15.97,54530,903,152,63,1706,8,2832,3.649.702.381
05/03/2020 21:00,14.51,53208,995,138,78,1832,8,3051,3.649.702.381
05/03/2020 22:00,13.68,51387,1063,123,83,1916,8,3193,3.649.702.381
05/03/2020 23:00,12.78,49379,1204,107,80,1954,7,3352,3.649.702.381
06/03/2020 00:00,13.83,48316,1568,63,0,1987,5,3623,3.649.702.381
06/03/2020 01:00,13.59,47586,1729,59,0,2058,4,3850,3.649.702.381
06/03/2020 02:00,13.57,47301,1892,59,0,2257,4,4212,3.649.702.381
06/03/2020 03:00,13.55,47672,2105,59,0,2201,5,4370,3.649.702.381
06/03/2020 04:00,13.88,48586,2284,58,0,2275,5,4622,3.649.702.381
06/03/2020 05:00,13.7,50912,2443,54,0,2230,5,4732,3.649.702.381
06/03/2020 06:00,14.46,54735,2549,51,0,2377,5,4982,3.649.702.381
06/03/2020 07:00,19.45,58210,2611,52,0,2317,4,4984,3.649.702.381
06/03/2020 08:00,25.86,59031,2757,52,0,2209,5,5023,3.649.702.381
06/03/2020 09:00,22.09,58424,2986,51,0,2045,4,5086,3.649.702.381
06/03/2020 10:00,19.9,57820,3038,55,0,1851,3,4947,3.649.702.381
06/03/2020 11:00,17.19,56831,3109,62,0,1756,4,4931,3.649.702.381
06/03/2020 12:00,16.91,55805,3140,66,0,1687,4,4897,3.649.702.381
06/03/2020 13:00,14.45,54895,3079,67,0,1780,5,4931,3.649.702.381
06/03/2020 14:00,13.79,54146,3013,68,0,1799,6,4886,3.649.702.381
06/03/2020 15:00,13.44,53696,2875,75,0,1909,6,4865,3.649.702.381
06/03/2020 16:00,13.6,54023,2768,77,0,2047,7,4899,3.649.702.381
06/03/2020 17:00,14.24,55429,2638,82,0,2242,8,4970,3.649.702.381
06/03/2020 18:00,15.2,56117,2521,85,0,2572,12,5190,3.649.702.381
06/03/2020 19:00,14.78,55082,2399,83,0,2855,14,5351,3.649.702.381
06/03/2020 20:00,13.92,53139,2211,83,0,2932,14,5240,3.649.702.381
06/03/2020 21:00,13.41,51609,2065,83,0,3012,14,5174,3.649.702.381
06/03/2020 22:00,12.98,50075,1848,83,0,2997,18,4946,3.649.702.381
06/03/2020 23:00,11.93,48223,1687,75,0,2959,18,4739,3.649.702.381
07/03/2020 00:00,12.75,47539,936,36,266,2997,13,4248,3.649.702.381
07/03/2020 01:00,12.37,46603,917,34,260,2875,14,4100,3.649.702.381
07/03/2020 02:00,12.3,46254,874,34,251,2751,17,3927,3.649.702.381
07/03/2020 03:00,12.35,46115,833,35,243,2673,16,3800,3.649.702.381
07/03/2020 04:00,12.67,46259,765,37,229,2490,16,3537,3.649.702.381
07/03/2020 05:00,12.07,46882,719,44,215,2327,13,3318,3.649.702.381
07/03/2020 06:00,12.45,48002,717,55,199,2169,15,3155,3.649.702.381
07/03/2020 07:00,13.3,49395,648,61,181,1955,17,2862,3.649.702.381
07/03/2020 08:00,14.39,51109,580,62,162,1660,13,2477,3.649.702.381
07/03/2020 09:00,15.43,52415,540,64,141,1350,11,2106,3.649.702.381
07/03/2020 10:00,15.15,52747,520,70,120,1126,11,1847,3.649.702.381
07/03/2020 11:00,14.61,52314,530,73,97,929,12,1641,3.649.702.381
07/03/2020 12:00,14,51518,555,75,73,676,9,1388,3.649.702.381
07/03/2020 13:00,13.72,50824,579,72,54,591,8,1304,3.649.702.381
07/03/2020 14:00,13.5,50439,642,69,39,689,8,1447,3.649.702.381
07/03/2020 15:00,13.41,50670,607,70,26,746,7,1456,3.649.702.381
07/03/2020 16:00,13.57,51380,571,72,24,989,5,1661,3.649.702.381
07/03/2020 17:00,14.7,53061,568,75,26,1436,5,2110,3.649.702.381
07/03/2020 18:00,15.86,54085,696,81,26,1854,6,2663,3.649.702.381
07/03/2020 19:00,14.34,53221,843,88,26,2368,6,3331,3.649.702.381
07/03/2020 20:00,13.54,51605,1068,95,27,2814,5,4009,3.649.702.381
07/03/2020 21:00,13.43,50677,1337,101,26,3158,4,4626,3.649.702.381
07/03/2020 22:00,12.3,49642,1469,105,27,3445,4,5050,3.649.702.381
07/03/2020 23:00,11.32,48383,1711,107,29,3739,4,5590,3.649.702.381
08/03/2020 00:00,9.91,47403,3244,104,27,4394,2,7771,3.649.702.381
08/03/2020 01:00,9.63,46611,3479,103,27,4544,3,8156,3.649.702.381
08/03/2020 02:00,9.47,46096,3628,106,28,4860,3,8625,3.649.702.381
08/03/2020 03:00,9.02,45939,3766,108,33,5169,2,9078,3.649.702.381
08/03/2020 04:00,8.66,46091,3879,114,36,5481,2,9512,3.649.702.381
08/03/2020 05:00,8.72,46531,3972,120,36,5813,2,9943,3.649.702.381
08/03/2020 06:00,8.67,47177,4165,129,35,6052,2,10383,3.649.702.381
08/03/2020 07:00,9.21,48126,4193,142,30,6136,2,10503,3.649.702.381
08/03/2020 08:00,9.43,49524,4354,159,28,6281,2,10824,3.649.702.381
08/03/2020 09:00,9.38,50631,4576,177,26,6447,2,11228,3.649.702.381
08/03/2020 10:00,9.58,51200,4583,192,28,6618,2,11423,3.649.702.381
08/03/2020 11:00,9.4,51290,4711,202,33,6596,2,11544,3.649.702.381
08/03/2020 12:00,8.93,50825,4700,211,37,6583,2,11533,3.649.702.381
08/03/2020 13:00,8.5,49924,4573,217,42,6617,2,11451,3.649.702.381
08/03/2020 14:00,8.81,49837,4451,218,42,6691,2,11404,3.649.702.381
08/03/2020 15:00,9.56,50025,4187,219,37,6757,2,11202,3.649.702.381
08/03/2020 16:00,9.73,51007,3907,223,33,6737,3,10903,3.649.702.381
08/03/2020 17:00,10.04,52779,3534,225,33,6809,3,10604,3.649.702.381
08/03/2020 18:00,10.46,53766,3157,228,33,6894,4,10316,3.649.702.381
08/03/2020 19:00,10.44,52972,2821,229,39,6849,6,9944,3.649.702.381
08/03/2020 20:00,10.12,51490,2503,227,63,6643,7,9443,3.649.702.381
08/03/2020 21:00,9.95,50378,2281,219,88,6526,11,9125,3.649.702.381
08/03/2020 22:00,9.66,48800,2061,206,111,6382,14,8774,3.649.702.381
08/03/2020 23:00,9.31,46966,1888,190,124,6129,14,8345,3.649.702.381
09/03/2020 00:00,8.78,44082,1602,85,136,5971,25,7819,347.452.381
09/03/2020 01:00,8.83,43308,1314,82,136,5723,24,7279,347.452.381
09/03/2020 02:00,8.86,43088,1065,78,141,5391,21,6696,347.452.381
09/03/2020 03:00,8.98,43347,912,76,147,5008,22,6165,347.452.381
09/03/2020 04:00,9.29,44328,867,72,153,4880,20,5992,347.452.381
09/03/2020 05:00,9.87,46646,761,70,157,4597,18,5603,347.452.381
09/03/2020 06:00,10.48,50518,822,64,164,4353,18,5421,347.452.381
09/03/2020 07:00,11.66,53941,845,57,157,4281,18,5358,347.452.381
09/03/2020 08:00,12.18,54805,893,53,139,3910,15,5010,347.452.381
09/03/2020 09:00,11.96,54602,910,52,126,3823,14,4925,347.452.381
09/03/2020 10:00,11.37,54373,891,50,124,3433,14,4512,347.452.381
09/03/2020 11:00,10.94,53730,881,43,126,3329,13,4392,347.452.381
09/03/2020 12:00,10.77,53120,937,35,117,3247,13,4349,347.452.381
09/03/2020 13:00,10.69,52777,1025,25,103,3130,14,4297,347.452.381
09/03/2020 14:00,10.7,52538,1159,16,91,3134,11,4411,347.452.381
09/03/2020 15:00,10.75,52315,1232,9,70,3202,7,4520,347.452.381
09/03/2020 16:00,10.93,52566,1240,7,69,3445,5,4766,347.452.381
09/03/2020 17:00,11.8,53773,1164,7,92,3629,7,4899,347.452.381
09/03/2020 18:00,12.77,54418,1161,9,122,3873,10,5175,347.452.381
09/03/2020 19:00,12.47,53685,1274,12,145,3948,11,5390,347.452.381
09/03/2020 20:00,10.94,52048,1394,16,153,3848,11,5422,347.452.381
09/03/2020 21:00,10.64,50727,1470,21,162,3870,13,5536,347.452.381
09/03/2020 22:00,10.24,48659,1507,27,165,3662,17,5378,347.452.381
09/03/2020 23:00,9.81,46325,1519,33,163,3585,17,5317,347.452.381
10/03/2020 00:00,9.2,44412,1622,134,203,3318,16,5293,347.452.381
10/03/2020 01:00,9,43700,1878,137,187,3062,16,5280,347.452.381
10/03/2020 02:00,8.94,43577,2078,135,175,2883,16,5287,347.452.381
10/03/2020 03:00,8.98,43761,2306,134,166,2616,16,5238,347.452.381
10/03/2020 04:00,9.26,44722,2562,135,157,2504,14,5372,347.452.381
10/03/2020 05:00,9.57,46894,2813,137,146,2519,12,5627,347.452.381
10/03/2020 06:00,10.99,50722,3279,140,140,2474,11,6044,347.452.381
10/03/2020 07:00,12.82,54214,3554,138,134,2552,10,6388,347.452.381
10/03/2020 08:00,13.03,54957,3910,129,131,2390,13,6573,347.452.381
10/03/2020 09:00,13.04,54634,4224,123,132,2178,16,6673,347.452.381
10/03/2020 10:00,13.02,54536,4232,120,137,2075,11,6575,347.452.381
10/03/2020 11:00,12.23,54198,4119,114,138,2153,9,6533,347.452.381
10/03/2020 12:00,11.84,53504,3932,109,137,2196,17,6391,347.452.381
10/03/2020 13:00,11.46,53289,3760,106,145,2194,17,6222,347.452.381
10/03/2020 14:00,11.03,53121,3743,102,143,2260,14,6262,347.452.381
10/03/2020 15:00,11.3,53218,3735,99,128,2344,15,6321,347.452.381
10/03/2020 16:00,11.25,53714,3892,98,135,2541,13,6679,347.452.381
10/03/2020 17:00,11.83,54987,3993,98,175,2734,11,7011,347.452.381
10/03/2020 18:00,11.51,55711,4026,100,224,3019,12,7381,347.452.381
10/03/2020 19:00,11.04,54928,4083,98,272,3070,16,7539,347.452.381
10/03/2020 20:00,10.54,53126,4027,96,321,3047,24,7515,347.452.381
10/03/2020 21:00,9.49,51620,4026,93,359,2915,26,7419,347.452.381
10/03/2020 22:00,8.81,49403,4044,93,383,2897,29,7446,347.452.381
10/03/2020 23:00,8.09,47080,4105,91,402,2850,30,7478,347.452.381
11/03/2020 00:00,7.65,44900,4072,90,414,2874,39,7489,347.452.381
11/03/2020 01:00,7.46,44020,4162,90,422,2885,37,7596,347.452.381
11/03/2020 02:00,7.42,43857,4226,94,417,2904,40,7681,347.452.381
11/03/2020 03:00,7.78,44007,4272,101,427,2964,42,7806,347.452.381
11/03/2020 04:00,8.39,44873,4294,105,430,3132,41,8002,347.452.381
11/03/2020 05:00,8.95,47202,4203,110,423,3249,41,8026,347.452.381
11/03/2020 06:00,9.58,51185,4351,114,416,3403,37,8321,347.452.381
11/03/2020 07:00,10.31,54613,4291,115,417,3428,39,8290,347.452.381
11/03/2020 08:00,10.62,55338,4438,116,423,3373,33,8383,347.452.381
11/03/2020 09:00,10.36,54996,4605,120,436,3516,33,8710,347.452.381
11/03/2020 10:00,10.01,54656,4599,126,450,3528,40,8743,347.452.381
11/03/2020 11:00,9.82,54041,4570,129,464,3580,44,8787,347.452.381
11/03/2020 12:00,9.63,53170,4525,130,474,3647,45,8821,347.452.381
11/03/2020 13:00,9.56,52672,4434,129,481,3644,46,8734,347.452.381
11/03/2020 14:00,9.48,52360,4397,123,483,3628,46,8677,347.452.381
11/03/2020 15:00,9.55,52160,4306,115,483,3584,47,8535,347.452.381
11/03/2020 16:00,9.69,52522,4345,108,483,3618,47,8601,347.452.381
11/03/2020 17:00,9.98,53866,4169,102,483,3762,47,8563,347.452.381
11/03/2020 18:00,10.41,54808,3944,98,483,3978,47,8550,347.452.381
11/03/2020 19:00,10.2,54316,3926,95,482,4118,46,8667,347.452.381
11/03/2020 20:00,9.78,52796,3906,94,479,4281,46,8806,347.452.381
11/03/2020 21:00,9.54,51392,3907,100,471,4445,47,8970,347.452.381
11/03/2020 22:00,8.99,49327,3808,107,460,4464,47,8886,347.452.381
11/03/2020 23:00,8.84,47019,3566,116,442,4322,46,8492,347.452.381
12/03/2020 00:00,8.32,44715,3431,130,404,4255,45,8265,347.452.381
12/03/2020 01:00,8.07,43887,3562,137,394,4117,40,8250,347.452.381
12/03/2020 02:00,7.64,43739,3824,143,386,3998,37,8388,347.452.381
12/03/2020 03:00,6.86,43986,4105,151,387,3785,37,8465,347.452.381
12/03/2020 04:00,6.64,44993,4341,158,392,3652,40,8583,347.452.381
12/03/2020 05:00,8.16,47402,4431,163,393,3502,38,8527,347.452.381
12/03/2020 06:00,9.02,51293,4735,164,396,3391,45,8731,347.452.381
12/03/2020 07:00,10.38,54758,4747,160,394,3147,45,8493,347.452.381
12/03/2020 08:00,10.58,55554,4904,156,395,2960,42,8457,347.452.381
12/03/2020 09:00,9.39,55159,5058,149,416,2854,41,8518,347.452.381
12/03/2020 10:00,8.67,54946,4973,131,439,2725,43,8311,347.452.381
12/03/2020 11:00,8.58,54371,5018,116,450,2724,47,8355,347.452.381
12/03/2020 12:00,8.41,53545,5012,109,457,2740,48,8366,347.452.381
12/03/2020 13:00,8.51,53120,4921,113,469,2937,46,8486,347.452.381
12/03/2020 14:00,8.52,52926,5011,127,482,3202,42,8864,347.452.381
12/03/2020 15:00,8.93,52890,5076,147,484,3633,48,9388,347.452.381
12/03/2020 16:00,9,53203,5158,164,474,4021,48,9865,347.452.381
12/03/2020 17:00,9.38,54468,5000,174,454,4459,48,10135,347.452.381
12/03/2020 18:00,9.82,55434,4778,186,445,5072,48,10529,347.452.381
12/03/2020 19:00,9.53,54898,4687,196,456,5604,48,10991,347.452.381
12/03/2020 20:00,8.98,53303,4518,202,481,5898,48,11147,347.452.381
12/03/2020 21:00,8.7,51934,4440,208,489,6230,48,11415,347.452.381
12/03/2020 22:00,8.33,50000,4402,212,491,6512,48,11665,347.452.381
12/03/2020 23:00,7.51,47823,4372,214,488,6707,48,11829,347.452.381
13/03/2020 00:00,7.67,45832,3963,210,487,6774,50,11484,347.452.381
13/03/2020 01:00,6.97,45089,3776,206,485,6855,50,11372,347.452.381
13/03/2020 02:00,6.43,44886,3529,202,483,6728,50,10992,347.452.381
13/03/2020 03:00,6.97,45198,3276,191,477,6467,49,10460,347.452.381
13/03/2020 04:00,7.43,46277,3012,182,474,6242,49,9959,347.452.381
13/03/2020 05:00,8.02,48697,2665,182,471,5960,49,9327,347.452.381
13/03/2020 06:00,9.06,52491,2507,186,466,5685,49,8893,347.452.381
13/03/2020 07:00,9.71,55983,2507,187,463,5486,48,8691,347.452.381
13/03/2020 08:00,9.67,56971,2821,189,464,5363,48,8885,347.452.381
13/03/2020 09:00,8.98,56592,3316,190,468,5447,47,9468,347.452.381
13/03/2020 10:00,8.5,56343,3719,186,469,5299,46,9719,347.452.381
13/03/2020 11:00,8.69,55531,4090,177,467,5101,47,9882,347.452.381
13/03/2020 12:00,8.14,54626,4338,161,460,4996,47,10002,347.452.381
13/03/2020 13:00,7.94,54053,4287,142,445,4954,40,9868,347.452.381
13/03/2020 14:00,7.76,53376,4181,122,418,5057,29,9807,347.452.381
13/03/2020 15:00,8.1,53035,3920,121,353,5213,23,9630,347.452.381
13/03/2020 16:00,8.57,53410,3769,124,289,5377,18,9577,347.452.381
13/03/2020 17:00,9.21,55021,3479,141,240,5502,13,9375,347.452.381
13/03/2020 18:00,9.7,56416,3116,147,206,5669,15,9153,347.452.381
13/03/2020 19:00,9.83,55838,2860,140,195,5729,18,8942,347.452.381
13/03/2020 20:00,9.42,53903,2563,155,206,5694,21,8639,347.452.381
13/03/2020 21:00,9.24,52432,2288,170,229,5680,18,8385,347.452.381
13/03/2020 22:00,9.06,50839,1851,173,258,5608,15,7905,347.452.381
13/03/2020 23:00,8.89,49004,1408,182,287,5497,14,7388,347.452.381
14/03/2020 00:00,8.75,47836,691,22,227,5436,18,6394,347.452.381
14/03/2020 01:00,8.55,47105,457,25,267,5258,24,6031,347.452.381
14/03/2020 02:00,8.52,46876,291,29,291,5229,26,5866,347.452.381
14/03/2020 03:00,8.53,46829,195,36,294,4989,35,5549,347.452.381
14/03/2020 04:00,8.68,47255,140,40,297,4861,32,5370,347.452.381
14/03/2020 05:00,8.77,47996,119,41,293,4707,24,5184,347.452.381
14/03/2020 06:00,8.72,49027,146,41,290,4404,39,4920,347.452.381
14/03/2020 07:00,8.97,50407,204,36,295,3932,43,4510,347.452.381
14/03/2020 08:00,9.93,52000,307,27,312,2990,46,3682,347.452.381
14/03/2020 09:00,11.15,52833,455,21,335,2226,46,3083,347.452.381
14/03/2020 10:00,11.16,52716,679,17,338,1423,33,2490,347.452.381
14/03/2020 11:00,10.72,52024,1053,17,335,1131,43,2579,347.452.381
14/03/2020 12:00,10.06,51061,1432,20,332,1010,43,2837,347.452.381
14/03/2020 13:00,9.54,50362,1757,22,325,1079,44,3227,347.452.381
14/03/2020 14:00,9.35,50070,2074,26,309,1182,43,3634,347.452.381
14/03/2020 15:00,9.5,50292,2333,32,277,1438,36,4116,347.452.381
14/03/2020 16:00,9.62,51350,2549,36,238,1840,32,4695,347.452.381
14/03/2020 17:00,9.84,53540,2649,36,193,2728,26,5632,347.452.381
14/03/2020 18:00,9.8,55120,2888,30,152,3706,21,6797,347.452.381
14/03/2020 19:00,9.09,54647,3244,25,124,4505,18,7916,347.452.381
14/03/2020 20:00,8.53,52947,3493,21,106,5250,16,8886,347.452.381
14/03/2020 21:00,8.29,51868,3833,16,89,5772,15,9725,347.452.381
14/03/2020 22:00,8,50662,4114,13,77,6108,13,10325,347.452.381
14/03/2020 23:00,7.59,49236,4278,10,66,6232,11,10597,347.452.381
15/03/2020 00:00,7.65,47495,4246,5,53,6335,8,10647,347.452.381
15/03/2020 01:00,7.24,46654,4302,3,52,6495,8,10860,347.452.381
15/03/2020 02:00,6.69,46145,4304,3,57,6569,8,10941,347.452.381
15/03/2020 03:00,5.98,46044,4299,2,66,6713,8,11088,347.452.381
15/03/2020 04:00,5.97,46232,4303,2,77,6783,8,11173,347.452.381
15/03/2020 05:00,5.28,46607,4254,2,97,6956,11,11320,347.452.381
15/03/2020 06:00,5.46,47096,4441,2,125,6939,13,11520,347.452.381
15/03/2020 07:00,5.16,47923,4386,2,140,7059,16,11603,347.452.381
15/03/2020 08:00,6.15,49075,4503,2,151,6982,22,11660,347.452.381
15/03/2020 09:00,6.55,50044,4641,3,173,6931,31,11779,347.452.381
15/03/2020 10:00,6.76,50501,4644,6,187,6915,38,11790,347.452.381
15/03/2020 11:00,6.7,50542,4686,9,194,6839,44,11772,347.452.381
15/03/2020 12:00,6.56,50026,4667,13,202,6749,45,11676,347.452.381
15/03/2020 13:00,6.59,49728,4579,17,214,6743,44,11597,347.452.381
15/03/2020 14:00,6.58,49689,4548,22,229,6763,43,11605,347.452.381
15/03/2020 15:00,6.56,49852,4545,25,232,6768,41,11611,347.452.381
15/03/2020 16:00,7.07,50634,4646,31,254,6681,37,11649,347.452.381
15/03/2020 17:00,7.98,52335,4596,42,286,6604,39,11567,347.452.381
15/03/2020 18:00,8.34,53575,4544,58,325,6528,34,11489,347.452.381
15/03/2020 19:00,8.22,52964,4562,72,347,6538,37,11556,347.452.381
15/03/2020 20:00,7.93,51240,4446,82,356,6665,40,11589,347.452.381
15/03/2020 21:00,7.69,50033,4430,93,365,6626,42,11556,347.452.381
15/03/2020 22:00,7.33,48324,4266,102,369,6753,42,11532,347.452.381
15/03/2020 23:00,6.65,46463,3984,110,373,6754,44,11265,347.452.381
16/03/2020 00:00,6.76,44555,3242,199,380,6581,44,10446,3.271.309.524
16/03/2020 01:00,6.66,43788,3000,203,386,6386,43,10018,3.271.309.524
16/03/2020 02:00,6.78,43640,2802,212,383,6101,42,9540,3.271.309.524
16/03/2020 03:00,6.97,43892,2625,223,383,5869,42,9142,3.271.309.524
16/03/2020 04:00,7.4,44862,2515,226,392,5760,42,8935,3.271.309.524
16/03/2020 05:00,7.93,47355,2328,216,400,5497,42,8483,3.271.309.524
16/03/2020 06:00,8.83,51228,2130,195,404,5241,42,8012,3.271.309.524
16/03/2020 07:00,9.89,54706,1809,181,404,4836,42,7272,3.271.309.524
16/03/2020 08:00,11.17,55495,1665,179,399,4074,43,6360,3.271.309.524
16/03/2020 09:00,10.92,55244,1560,175,396,3444,43,5618,3.271.309.524
16/03/2020 10:00,10.16,55052,1482,171,385,2804,43,4885,3.271.309.524
16/03/2020 11:00,9.91,54488,1415,167,366,2476,37,4461,3.271.309.524
16/03/2020 12:00,10.92,53839,1312,163,337,2148,23,3983,3.271.309.524
16/03/2020 13:00,10.81,53430,1197,166,307,2087,18,3775,3.271.309.524
16/03/2020 14:00,10.82,52898,1011,170,283,1932,13,3409,3.271.309.524
16/03/2020 15:00,9.9,52584,773,176,261,1908,11,3129,3.271.309.524
16/03/2020 16:00,9.92,52788,640,175,238,1853,7,2913,3.271.309.524
16/03/2020 17:00,10.39,54195,494,172,214,2023,10,2913,3.271.309.524
16/03/2020 18:00,11.72,55499,485,170,187,2461,11,3314,3.271.309.524
16/03/2020 19:00,12.23,55143,529,174,160,2934,11,3808,3.271.309.524
16/03/2020 20:00,10.59,53493,594,178,136,3456,11,4375,3.271.309.524
16/03/2020 21:00,9.03,52225,659,176,119,3970,9,4933,3.271.309.524
16/03/2020 22:00,8.68,50251,693,166,102,4394,9,5364,3.271.309.524
16/03/2020 23:00,8.31,48006,823,156,79,4469,7,5534,3.271.309.524
17/03/2020 00:00,7.77,45435,1102,268,50,4754,4,6178,3.271.309.524
17/03/2020 01:00,7.44,44807,1402,267,35,4857,4,6565,3.271.309.524
17/03/2020 02:00,7.21,44767,1720,265,22,4963,4,6974,3.271.309.524
17/03/2020 03:00,7.12,45001,2013,265,15,5074,4,7371,3.271.309.524
17/03/2020 04:00,7.15,45987,2262,264,12,5304,4,7846,3.271.309.524
17/03/2020 05:00,7.42,48217,2494,263,13,5350,4,8124,3.271.309.524
17/03/2020 06:00,8.11,51899,2793,262,18,5554,5,8632,3.271.309.524
17/03/2020 07:00,8.8,55095,2942,260,25,5585,8,8820,3.271.309.524
17/03/2020 08:00,8.96,55650,3130,254,30,5524,7,8945,3.271.309.524
17/03/2020 09:00,8.87,55050,3318,244,38,5660,6,9266,3.271.309.524
17/03/2020 10:00,8.61,54914,3307,222,49,5791,7,9376,3.271.309.524
17/03/2020 11:00,8.46,54345,3332,197,69,5846,9,9453,3.271.309.524
17/03/2020 12:00,8.2,53752,3381,177,88,5729,14,9389,3.271.309.524
17/03/2020 13:00,8.02,53323,3329,157,101,5739,17,9343,3.271.309.524
17/03/2020 14:00,7.94,52894,3261,139,114,5902,21,9437,3.271.309.524
17/03/2020 15:00,7.86,52774,3269,127,122,5868,16,9402,3.271.309.524
17/03/2020 16:00,7.96,52854,3324,117,131,6085,19,9676,3.271.309.524
17/03/2020 17:00,8.29,53903,3065,111,149,6217,21,9563,3.271.309.524
17/03/2020 18:00,8.48,54690,2891,109,166,6159,25,9350,3.271.309.524
17/03/2020 19:00,8.47,53887,2756,102,181,6129,27,9195,3.271.309.524
17/03/2020 20:00,7.97,52047,2648,88,200,6172,28,9136,3.271.309.524
17/03/2020 21:00,7.64,50660,2717,73,218,6231,23,9262,3.271.309.524
17/03/2020 22:00,7.15,48579,2696,57,235,6107,24,9119,3.271.309.524
17/03/2020 23:00,6.57,46372,2700,39,240,6114,27,9120,3.271.309.524
18/03/2020 00:00,6.05,44041,2920,32,201,6090,26,9269,3.271.309.524
18/03/2020 01:00,5.78,43171,3267,20,207,5867,26,9387,3.271.309.524
18/03/2020 02:00,5.47,43030,3733,14,215,5831,27,9820,3.271.309.524
18/03/2020 03:00,5.49,43298,4089,13,228,5821,29,10180,3.271.309.524
18/03/2020 04:00,5.89,44142,4317,18,228,5629,30,10222,3.271.309.524
18/03/2020 05:00,6.51,46279,4429,29,227,5461,28,10174,3.271.309.524
18/03/2020 06:00,7.18,49976,4625,42,228,5456,29,10380,3.271.309.524
18/03/2020 07:00,7.62,53165,4401,47,232,5306,30,10016,3.271.309.524
18/03/2020 08:00,7.95,53948,4185,49,243,4963,32,9472,3.271.309.524
18/03/2020 09:00,8.11,53758,3943,61,249,4686,40,8979,3.271.309.524
18/03/2020 10:00,8.11,53563,3516,82,279,4432,47,8356,3.271.309.524
18/03/2020 11:00,7.97,53023,3264,106,309,4401,48,8128,3.271.309.524
18/03/2020 12:00,7.88,52364,3092,131,334,4327,48,7932,3.271.309.524
18/03/2020 13:00,7.83,51907,2871,152,353,4386,48,7810,3.271.309.524
18/03/2020 14:00,7.76,51587,2602,168,360,4333,48,7511,3.271.309.524
18/03/2020 15:00,7.74,51439,2362,181,362,4399,48,7352,3.271.309.524
18/03/2020 16:00,7.79,51512,2214,194,365,4611,48,7432,3.271.309.524
18/03/2020 17:00,8.08,52666,1895,201,368,4751,47,7262,3.271.309.524
18/03/2020 18:00,8.28,53825,1721,200,367,4847,46,7181,3.271.309.524
18/03/2020 19:00,8.2,53597,1633,195,364,5124,44,7360,3.271.309.524
18/03/2020 20:00,7.84,52075,1619,191,357,5408,43,7618,3.271.309.524
18/03/2020 21:00,7.58,50689,1665,185,342,5513,40,7745,3.271.309.524
18/03/2020 22:00,7.33,48717,1554,177,328,5465,31,7555,3.271.309.524
18/03/2020 23:00,7.1,46616,1508,169,305,5358,27,7367,3.271.309.524
19/03/2020 00:00,6.6,44447,1316,174,309,5428,41,7268,3.271.309.524
19/03/2020 01:00,6.41,43764,1235,174,271,5271,38,6989,3.271.309.524
19/03/2020 02:00,6.37,43598,1121,172,241,5382,36,6952,3.271.309.524
19/03/2020 03:00,6.49,43870,1044,169,215,5285,35,6748,3.271.309.524
19/03/2020 04:00,6.73,44708,1058,168,197,5244,29,6696,3.271.309.524
19/03/2020 05:00,7.05,46913,1063,164,192,5198,24,6641,3.271.309.524
19/03/2020 06:00,7.53,50645,1062,161,193,5165,23,6604,3.271.309.524
19/03/2020 07:00,7.97,53638,1015,155,203,4872,24,6269,3.271.309.524
19/03/2020 08:00,8.08,54288,1025,157,217,4703,29,6131,3.271.309.524
19/03/2020 09:00,7.96,53441,1164,162,230,4573,33,6162,3.271.309.524
19/03/2020 10:00,7.78,52865,1337,159,238,4365,33,6132,3.271.309.524
19/03/2020 11:00,7.59,52068,1577,151,240,4457,31,6456,3.271.309.524
19/03/2020 12:00,7.41,51117,1750,143,240,4514,26,6673,3.271.309.524
19/03/2020 13:00,7.25,50478,1791,133,243,4484,25,6676,3.271.309.524
19/03/2020 14:00,7.23,49992,1832,128,227,4437,23,6647,3.271.309.524
19/03/2020 15:00,7.27,50066,1819,132,221,4197,19,6388,3.271.309.524
19/03/2020 16:00,7.45,50405,1853,146,203,4015,18,6235,3.271.309.524
19/03/2020 17:00,7.88,51745,1622,161,184,3674,16,5657,3.271.309.524
19/03/2020 18:00,8.19,53147,1552,172,174,3765,20,5683,3.271.309.524
19/03/2020 19:00,8.17,53085,1550,179,169,3644,22,5564,3.271.309.524
19/03/2020 20:00,7.93,51664,1604,186,172,3592,25,5579,3.271.309.524
19/03/2020 21:00,7.69,50422,1690,193,174,3482,26,5565,3.271.309.524
19/03/2020 22:00,7.37,48581,1666,189,171,3319,27,5372,3.271.309.524
19/03/2020 23:00,7.06,46677,1669,171,163,3165,26,5194,3.271.309.524
20/03/2020 00:00,7.31,45129,1211,194,149,2747,24,4325,3.271.309.524
20/03/2020 01:00,7.25,44502,1209,170,134,2547,22,4082,3.271.309.524
20/03/2020 02:00,7.28,44530,1159,152,123,2405,22,3861,3.271.309.524
20/03/2020 03:00,7.53,44879,1147,136,112,2327,19,3741,3.271.309.524
20/03/2020 04:00,7.85,45899,1191,123,107,2364,19,3804,3.271.309.524
20/03/2020 05:00,8.3,48189,1234,111,105,2343,15,3808,3.271.309.524
20/03/2020 06:00,11.21,51746,1264,103,100,2314,14,3795,3.271.309.524
20/03/2020 07:00,15.17,54980,1218,101,88,2247,11,3665,3.271.309.524
20/03/2020 08:00,17.64,55900,1216,112,84,1990,9,3411,3.271.309.524
20/03/2020 09:00,15.11,55312,1353,122,97,1833,9,3414,3.271.309.524
20/03/2020 10:00,13.07,54722,1461,128,111,1730,10,3440,3.271.309.524
20/03/2020 11:00,11.75,53837,1600,132,125,1862,9,3728,3.271.309.524
20/03/2020 12:00,9.64,52930,1751,135,134,2149,12,4181,3.271.309.524
20/03/2020 13:00,8.45,52146,1947,136,138,2482,14,4717,3.271.309.524
20/03/2020 14:00,8.16,51431,2156,136,140,2695,20,5147,3.271.309.524
20/03/2020 15:00,7.96,51174,2421,133,141,2971,22,5688,3.271.309.524
20/03/2020 16:00,7.97,51476,2634,126,148,3015,22,5945,3.271.309.524
20/03/2020 17:00,8.35,52912,2496,123,158,3080,24,5881,3.271.309.524
20/03/2020 18:00,8.62,54410,2373,121,166,3304,24,5988,3.271.309.524
20/03/2020 19:00,8.56,54102,2403,119,179,3562,28,6291,3.271.309.524
20/03/2020 20:00,8.44,52413,2412,115,196,3689,31,6443,3.271.309.524
20/03/2020 21:00,8.1,51050,2474,109,212,4018,23,6836,3.271.309.524
20/03/2020 22:00,7.67,49480,2296,104,215,4127,19,6761,3.271.309.524
20/03/2020 23:00,7.39,47750,2095,96,206,4222,19,6638,3.271.309.524
21/03/2020 00:00,7.86,46430,1212,107,227,4333,17,5896,3.271.309.524
21/03/2020 01:00,7.72,45741,1105,100,226,4339,17,5787,3.271.309.524
21/03/2020 02:00,7.64,45520,1019,91,229,4238,14,5591,3.271.309.524
21/03/2020 03:00,7.64,45504,915,87,239,4400,14,5655,3.271.309.524
21/03/2020 04:00,7.71,45857,869,89,243,4058,14,5273,3.271.309.524
21/03/2020 05:00,7.76,46458,867,99,241,3908,13,5128,3.271.309.524
21/03/2020 06:00,7.75,47299,833,121,241,3634,11,4840,3.271.309.524
21/03/2020 07:00,7.98,48593,783,139,246,3192,8,4368,3.271.309.524
21/03/2020 08:00,8.5,49924,744,154,256,2658,7,3819,3.271.309.524
21/03/2020 09:00,9.1,50722,798,164,249,2058,6,3275,3.271.309.524
21/03/2020 10:00,7.87,50535,855,175,228,1740,6,3004,3.271.309.524
21/03/2020 11:00,7.54,49762,956,183,210,1541,9,2899,3.271.309.524
21/03/2020 12:00,7.43,48875,984,189,196,1387,10,2766,3.271.309.524
21/03/2020 13:00,6.92,48054,958,199,194,1471,24,2846,3.271.309.524
21/03/2020 14:00,6.77,47533,963,206,196,1404,28,2797,3.271.309.524
21/03/2020 15:00,6.95,47745,989,210,175,1276,31,2681,3.271.309.524
21/03/2020 16:00,7.78,48546,988,211,169,1196,24,2588,3.271.309.524
21/03/2020 17:00,8.56,50623,818,208,155,1268,21,2470,3.271.309.524
21/03/2020 18:00,9.39,52093,781,201,147,1339,23,2491,3.271.309.524
21/03/2020 19:00,10.57,51845,924,192,153,1482,13,2764,3.271.309.524
21/03/2020 20:00,9.58,50254,1080,174,167,1589,11,3021,3.271.309.524
21/03/2020 21:00,8.47,49361,1263,150,190,1802,13,3418,3.271.309.524
21/03/2020 22:00,8.34,48354,1281,123,206,1841,12,3463,3.271.309.524
21/03/2020 23:00,7.95,47116,1378,95,201,1987,15,3676,3.271.309.524
22/03/2020 00:00,7.6,46157,1096,68,222,2137,14,3537,3.271.309.524
22/03/2020 01:00,7.59,45444,1067,52,216,2463,15,3813,3.271.309.524
22/03/2020 02:00,7.18,44987,929,40,215,2610,13,3807,3.271.309.524
22/03/2020 03:00,6.47,45015,946,33,225,2923,10,4137,3.271.309.524
22/03/2020 04:00,6.24,45349,951,37,226,3186,9,4409,3.271.309.524
22/03/2020 05:00,6.35,45863,897,49,220,3586,9,4761,3.271.309.524
22/03/2020 06:00,6.19,46236,898,63,212,3722,9,4904,3.271.309.524
22/03/2020 07:00,5.94,47007,972,73,207,3708,7,4967,3.271.309.524
22/03/2020 08:00,6.38,47942,1043,89,217,3413,8,4770,3.271.309.524
22/03/2020 09:00,6.38,48527,1172,116,235,3204,10,4737,3.271.309.524
22/03/2020 10:00,6.09,48850,1280,146,242,3029,10,4707,3.271.309.524
22/03/2020 11:00,5.94,48567,1173,167,229,3019,10,4598,3.271.309.524
22/03/2020 12:00,5.85,47903,1017,184,213,2963,9,4386,3.271.309.524
22/03/2020 13:00,5.7,47441,970,195,203,2981,10,4359,3.271.309.524
22/03/2020 14:00,5.66,47322,889,202,196,2982,10,4279,3.271.309.524
22/03/2020 15:00,5.72,47619,865,207,175,3116,8,4371,3.271.309.524
22/03/2020 16:00,6.21,48455,879,219,163,3167,8,4436,3.271.309.524
22/03/2020 17:00,7.26,50404,936,230,153,3482,7,4808,3.271.309.524
22/03/2020 18:00,7.84,52212,1034,241,146,3804,7,5232,3.271.309.524
22/03/2020 19:00,8.25,52322,1204,250,147,4054,8,5663,3.271.309.524
22/03/2020 20:00,7.96,51197,1360,256,155,4088,7,5866,3.271.309.524
22/03/2020 21:00,7.84,50254,1565,259,153,4150,6,6133,3.271.309.524
22/03/2020 22:00,7.66,48879,1779,260,142,3977,6,6164,3.271.309.524
22/03/2020 23:00,7.33,47303,1940,261,122,3885,5,6213,3.271.309.524
23/03/2020 00:00,6.98,45991,2255,80,95,3835,6,6271,3.076.071.429
23/03/2020 01:00,6.76,45390,2264,69,76,3769,6,6184,3.076.071.429
23/03/2020 02:00,6.76,45303,2124,60,64,3802,6,6056,3.076.071.429
23/03/2020 03:00,6.95,45733,2025,51,49,3766,6,5897,3.076.071.429
23/03/2020 04:00,7.16,46703,1946,43,44,3586,6,5625,3.076.071.429
23/03/2020 05:00,7.56,48862,1848,39,42,3721,6,5656,3.076.071.429
23/03/2020 06:00,8.06,52182,1849,37,36,3708,6,5636,3.076.071.429
23/03/2020 07:00,8.9,55103,1817,39,28,3664,6,5554,3.076.071.429
23/03/2020 08:00,9.38,55629,1762,44,23,3400,6,5235,3.076.071.429
23/03/2020 09:00,9.1,54996,1797,51,24,3396,6,5274,3.076.071.429
23/03/2020 10:00,8.48,54333,1928,57,24,3269,6,5284,3.076.071.429
23/03/2020 11:00,8.31,53569,2064,63,20,3430,6,5583,3.076.071.429
23/03/2020 12:00,8.12,52867,2040,70,14,3760,6,5890,3.076.071.429
23/03/2020 13:00,7.96,52453,2063,74,13,4106,7,6263,3.076.071.429
23/03/2020 14:00,7.9,51967,2009,75,13,4335,7,6439,3.076.071.429
23/03/2020 15:00,7.8,51842,1917,73,14,4550,7,6561,3.076.071.429
23/03/2020 16:00,7.82,52048,1794,74,14,4838,8,6728,3.076.071.429
23/03/2020 17:00,8.01,53360,1664,84,14,5126,7,6895,3.076.071.429
23/03/2020 18:00,8.14,54572,1693,97,15,5355,7,7167,3.076.071.429
23/03/2020 19:00,8.14,54399,1923,104,14,5588,8,7637,3.076.071.429
23/03/2020 20:00,7.86,52781,2187,106,16,5710,8,8027,3.076.071.429
23/03/2020 21:00,7.53,51464,2573,101,18,5717,8,8417,3.076.071.429
23/03/2020 22:00,7.19,49731,2778,94,19,5657,7,8555,3.076.071.429
23/03/2020 23:00,6.8,47578,2886,86,18,5693,8,8691,3.076.071.429
24/03/2020 00:00,6.2,45607,2965,12,0,5978,11,8966,3.076.071.429
24/03/2020 01:00,5.99,44872,2912,16,0,5969,11,8908,3.076.071.429
24/03/2020 02:00,5.85,44716,2704,16,0,6015,14,8749,3.076.071.429
24/03/2020 03:00,5.91,44914,2577,17,0,6005,13,8612,3.076.071.429
24/03/2020 04:00,6.2,45690,2554,20,0,6067,11,8652,3.076.071.429
24/03/2020 05:00,6.77,47596,2563,23,0,6020,11,8617,3.076.071.429
24/03/2020 06:00,7.2,50794,2705,23,0,6099,10,8837,3.076.071.429
24/03/2020 07:00,7.62,53688,2784,22,0,5962,10,8778,3.076.071.429
24/03/2020 08:00,7.65,54279,2900,21,0,5860,10,8791,3.076.071.429
24/03/2020 09:00,7.49,53690,2982,23,0,5821,17,8843,3.076.071.429
24/03/2020 10:00,7.31,53188,3032,27,0,5615,19,8693,3.076.071.429
24/03/2020 11:00,7.14,52593,3059,32,0,5700,19,8810,3.076.071.429
24/03/2020 12:00,7.05,51851,2992,38,0,5603,20,8653,3.076.071.429
24/03/2020 13:00,6.94,51393,2982,43,0,5581,23,8629,3.076.071.429
24/03/2020 14:00,6.95,51010,2881,46,0,5713,25,8665,3.076.071.429
24/03/2020 15:00,6.97,51054,2806,46,0,5746,24,8622,3.076.071.429
24/03/2020 16:00,7.07,51377,2655,44,0,5880,22,8601,3.076.071.429
24/03/2020 17:00,7.33,52598,2416,45,0,6043,20,8524,3.076.071.429
24/03/2020 18:00,7.7,53683,2375,50,0,6258,18,8701,3.076.071.429
24/03/2020 19:00,7.65,53706,2497,58,0,6218,18,8791,3.076.071.429
24/03/2020 20:00,7.27,52250,2631,67,0,6371,19,9088,3.076.071.429
24/03/2020 21:00,7.02,50875,2854,75,0,6564,19,9512,3.076.071.429
24/03/2020 22:00,6.65,48885,3010,82,0,6571,20,9683,3.076.071.429
24/03/2020 23:00,6.03,46863,3142,90,0,6650,21,9903,3.076.071.429
25/03/2020 00:00,5.81,45245,3105,129,0,6679,23,9936,3.076.071.429
25/03/2020 01:00,5.55,44352,3099,138,0,6561,24,9822,3.076.071.429
25/03/2020 02:00,5.39,44123,2979,146,0,6694,24,9843,3.076.071.429
25/03/2020 03:00,5.52,44439,2887,151,0,6708,25,9771,3.076.071.429
25/03/2020 04:00,5.79,45090,2778,151,0,6674,27,9630,3.076.071.429
25/03/2020 05:00,6.15,46785,2644,152,0,6617,26,9439,3.076.071.429
25/03/2020 06:00,6.43,49903,2577,152,0,6603,26,9358,3.076.071.429
25/03/2020 07:00,6.98,52531,2488,150,0,6529,25,9192,3.076.071.429
25/03/2020 08:00,7.06,53003,2410,158,0,6405,25,8998,3.076.071.429
25/03/2020 09:00,6.99,52273,2346,169,0,6379,28,8922,3.076.071.429
25/03/2020 10:00,6.87,51614,2317,173,0,6267,29,8786,3.076.071.429
25/03/2020 11:00,6.75,50923,2279,178,0,6297,32,8786,3.076.071.429
25/03/2020 12:00,6.6,50193,2131,180,0,6282,32,8625,3.076.071.429
25/03/2020 13:00,6.57,49632,1992,182,0,6226,32,8432,3.076.071.429
25/03/2020 14:00,6.58,49353,1747,184,0,6168,32,8131,3.076.071.429
25/03/2020 15:00,6.58,49377,1482,183,0,6010,31,7706,3.076.071.429
25/03/2020 16:00,6.69,49662,1242,184,0,5942,27,7395,3.076.071.429
25/03/2020 17:00,7,50818,998,192,0,5703,23,6916,3.076.071.429
25/03/2020 18:00,7.33,51960,935,198,0,5446,20,6599,3.076.071.429
25/03/2020 19:00,7.3,52046,982,202,0,5190,19,6393,3.076.071.429
25/03/2020 20:00,7.12,50806,1032,203,0,4888,20,6143,3.076.071.429
25/03/2020 21:00,7.01,49596,1144,202,0,4424,20,5790,3.076.071.429
25/03/2020 22:00,6.88,47823,1189,196,0,4296,17,5698,3.076.071.429
25/03/2020 23:00,6.54,45948,1175,186,0,4138,18,5517,3.076.071.429
26/03/2020 00:00,6.23,44015,1105,182,108,3867,22,5284,3.076.071.429
26/03/2020 01:00,6.26,43425,1047,183,108,3673,21,5032,3.076.071.429
26/03/2020 02:00,6.33,43372,938,186,99,3538,21,4782,3.076.071.429
26/03/2020 03:00,6.42,43619,814,191,92,3335,18,4450,3.076.071.429
26/03/2020 04:00,6.52,44257,687,199,77,3064,16,4043,3.076.071.429
26/03/2020 05:00,6.68,46133,559,206,64,2881,16,3726,3.076.071.429
26/03/2020 06:00,7.18,49233,547,210,54,2789,15,3615,3.076.071.429
26/03/2020 07:00,8.16,51901,578,209,37,2482,11,3317,3.076.071.429
26/03/2020 08:00,8.28,52432,611,207,27,1995,8,2848,3.076.071.429
26/03/2020 09:00,8.1,51620,672,209,19,1542,12,2454,3.076.071.429
26/03/2020 10:00,7.89,50983,698,212,18,1315,12,2255,3.076.071.429
26/03/2020 11:00,7.37,50242,716,217,23,1525,12,2493,3.076.071.429
26/03/2020 12:00,7.05,49542,740,220,30,1695,10,2695,3.076.071.429
26/03/2020 13:00,6.9,49080,787,224,40,1831,8,2890,3.076.071.429
26/03/2020 14:00,6.74,48601,714,229,43,1930,7,2923,3.076.071.429
26/03/2020 15:00,6.76,48612,664,234,41,2004,6,2949,3.076.071.429
26/03/2020 16:00,6.79,48867,624,240,44,2038,5,2951,3.076.071.429
26/03/2020 17:00,6.94,50081,574,242,62,2252,5,3135,3.076.071.429
26/03/2020 18:00,7.5,51252,565,241,86,2448,4,3344,3.076.071.429
26/03/2020 19:00,7.46,51300,621,233,107,2755,4,3720,3.076.071.429
26/03/2020 20:00,7.19,50189,658,220,118,2942,4,3942,3.076.071.429
26/03/2020 21:00,6.9,48989,663,206,125,2970,4,3968,3.076.071.429
26/03/2020 22:00,6.52,47268,617,192,126,2969,4,3908,3.076.071.429
26/03/2020 23:00,6.27,45562,561,176,116,2900,3,3756,3.076.071.429
27/03/2020 00:00,5.97,43930,502,176,107,2893,5,3683,3.076.071.429
27/03/2020 01:00,5.85,43360,504,170,101,2699,5,3479,3.076.071.429
27/03/2020 02:00,5.83,43327,509,166,99,2663,5,3442,3.076.071.429
27/03/2020 03:00,5.91,43635,509,161,105,2551,6,3332,3.076.071.429
27/03/2020 04:00,6.04,44353,489,151,116,2484,6,3246,3.076.071.429
27/03/2020 05:00,6.2,46153,483,139,132,2434,7,3195,3.076.071.429
27/03/2020 06:00,6.64,49249,472,123,138,2288,10,3031,3.076.071.429
27/03/2020 07:00,7.04,52039,457,101,118,2074,10,2760,3.076.071.429
27/03/2020 08:00,7.43,52725,413,83,87,1768,6,2357,3.076.071.429
27/03/2020 09:00,7.32,52031,396,71,77,1554,5,2103,3.076.071.429
27/03/2020 10:00,6.99,51339,395,69,87,1563,5,2119,3.076.071.429
27/03/2020 11:00,6.87,50304,422,74,99,1689,5,2289,3.076.071.429
27/03/2020 12:00,6.55,49288,450,83,97,1797,6,2433,3.076.071.429
27/03/2020 13:00,6.36,48562,450,91,92,2020,7,2660,3.076.071.429
27/03/2020 14:00,6.25,47976,438,93,86,2144,6,2767,3.076.071.429
27/03/2020 15:00,6.18,47570,504,89,74,2280,5,2952,3.076.071.429
27/03/2020 16:00,6.19,47799,637,86,76,2416,3,3218,3.076.071.429
27/03/2020 17:00,6.33,48943,788,86,94,2652,4,3624,3.076.071.429
27/03/2020 18:00,6.5,50161,890,88,112,2779,4,3873,3.076.071.429
27/03/2020 19:00,6.51,50097,907,87,122,3090,4,4210,3.076.071.429
27/03/2020 20:00,6.25,48658,813,85,122,3207,5,4232,3.076.071.429
27/03/2020 21:00,6.18,47437,733,80,121,3396,6,4336,3.076.071.429
27/03/2020 22:00,6.08,46069,629,72,116,3728,7,4552,3.076.071.429
27/03/2020 23:00,5.84,44640,532,62,106,3930,8,4638,3.076.071.429
28/03/2020 00:00,5.6,43123,471,57,74,4131,3,4736,3.076.071.429
28/03/2020 01:00,5.44,42475,574,45,60,4289,3,4971,3.076.071.429
28/03/2020 02:00,5.38,42383,748,33,44,4383,3,5211,3.076.071.429
28/03/2020 03:00,5.38,42456,969,25,36,4518,3,5551,3.076.071.429
28/03/2020 04:00,5.43,42820,1177,18,27,4498,3,5723,3.076.071.429
28/03/2020 05:00,5.44,43277,1373,12,22,4446,3,5856,3.076.071.429
28/03/2020 06:00,5.53,43936,1514,8,18,4277,3,5820,3.076.071.429
28/03/2020 07:00,5.62,45113,1561,7,12,4256,3,5839,3.076.071.429
28/03/2020 08:00,5.75,46408,1647,17,8,4061,3,5736,3.076.071.429
28/03/2020 09:00,5.73,47187,1756,25,6,4057,3,5847,3.076.071.429
28/03/2020 10:00,5.59,47224,1859,37,5,4343,3,6247,3.076.071.429
28/03/2020 11:00,5.28,46762,1941,53,6,4222,3,6225,3.076.071.429
28/03/2020 12:00,4.98,46226,2043,66,9,4284,3,6405,3.076.071.429
28/03/2020 13:00,4.08,45741,2264,72,11,4493,3,6843,3.076.071.429
28/03/2020 14:00,3.73,45372,2529,70,14,4682,4,7299,3.076.071.429
28/03/2020 15:00,4.03,45756,2826,67,16,4834,5,7748,3.076.071.429
28/03/2020 16:00,5.05,46613,3020,65,24,4892,5,8006,3.076.071.429
28/03/2020 17:00,5.64,48495,3055,64,38,5115,6,8278,3.076.071.429
28/03/2020 18:00,5.93,49963,3179,68,65,5269,11,8592,3.076.071.429
28/03/2020 19:00,5.79,49999,3338,74,85,5515,17,9029,3.076.071.429
28/03/2020 20:00,5.45,48554,3544,80,102,5699,22,9447,3.076.071.429
28/03/2020 21:00,5.2,47659,3962,84,120,6003,29,10198,3.076.071.429
28/03/2020 22:00,5.08,46715,4278,82,151,6223,25,10759,3.076.071.429
28/03/2020 23:00,4.9,45402,4435,73,176,6322,26,11032,3.076.071.429
29/03/2020 00:00,4.59,43920,4341,48,0,6353,24,10766,3.076.071.429
29/03/2020 01:00,4.4,43332,4530,42,0,6191,30,10793,3.076.071.429
29/03/2020 02:00,4.08,43162,4510,36,0,6018,36,10600,3.076.071.429
29/03/2020 03:00,3.7,43521,4515,32,0,5987,39,10573,3.076.071.429
29/03/2020 04:00,3.52,43994,4458,30,0,5948,38,10474,3.076.071.429
29/03/2020 05:00,3.73,44395,4368,27,0,5451,36,9882,3.076.071.429
29/03/2020 06:00,4,45357,4327,22,0,5060,33,9442,3.076.071.429
29/03/2020 07:00,4.37,46623,4175,17,0,4720,36,8948,3.076.071.429
29/03/2020 08:00,4.89,47709,4078,12,0,4081,39,8210,3.076.071.429
29/03/2020 09:00,4.81,48055,3887,10,0,3584,37,7518,3.076.071.429
29/03/2020 10:00,4.84,47802,3608,9,0,3192,36,6845,3.076.071.429
29/03/2020 11:00,4.67,47334,3310,10,0,3085,34,6439,3.076.071.429
29/03/2020 12:00,4.51,47054,2992,10,0,3068,37,6107,3.076.071.429
29/03/2020 13:00,4.44,46828,2917,11,0,2877,39,5844,3.076.071.429
29/03/2020 14:00,4.53,46861,2864,13,0,2856,44,5777,3.076.071.429
29/03/2020 15:00,4.83,47285,2829,13,0,2954,42,5838,3.076.071.429
29/03/2020 16:00,5.17,48333,2697,12,0,3118,37,5864,3.076.071.429
29/03/2020 17:00,5.92,49371,2511,11,0,3066,28,5616,3.076.071.429
29/03/2020 18:00,6.75,50059,2342,11,0,3139,19,5511,3.076.071.429
29/03/2020 19:00,7.42,50124,2161,9,0,3359,13,5542,3.076.071.429
29/03/2020 20:00,7.23,49270,2003,8,0,3568,10,5589,3.076.071.429
29/03/2020 21:00,6.82,47872,1966,6,0,3766,8,5746,3.076.071.429
29/03/2020 22:00,6.18,46306,1910,6,0,3793,6,5715,3.076.071.429
29/03/2020 23:00,5.65,44790,2256,7,0,3801,4,6068,3.076.071.429
30/03/2020 00:00,5.62,44309,2258,70,0,3689,3,6020,2.874.583.333
30/03/2020 01:00,5.61,44225,2192,66,0,3441,3,5702,2.874.583.333
30/03/2020 02:00,5.63,44527,2041,63,0,3507,2,5613,2.874.583.333
30/03/2020 03:00,5.77,45421,1954,61,0,3333,2,5350,2.874.583.333
30/03/2020 04:00,6.4,47611,2015,58,0,3373,2,5448,2.874.583.333
30/03/2020 05:00,7.75,51124,1946,55,0,3248,3,5252,2.874.583.333
30/03/2020 06:00,8.89,54523,1894,48,0,2897,3,4842,2.874.583.333
30/03/2020 07:00,12.73,55548,1879,38,0,2601,3,4521,2.874.583.333
30/03/2020 08:00,12.68,55184,1800,29,0,2443,3,4275,2.874.583.333
30/03/2020 09:00,11.3,54618,1772,25,0,2153,3,3953,2.874.583.333
30/03/2020 10:00,9.75,53885,1759,25,0,2134,3,3921,2.874.583.333
30/03/2020 11:00,8.95,53114,1874,25,0,2110,4,4013,2.874.583.333
30/03/2020 12:00,8.48,52784,1925,24,0,2270,5,4224,2.874.583.333
30/03/2020 13:00,8.36,52209,2115,22,0,2291,5,4433,2.874.583.333
30/03/2020 14:00,8.25,51801,2265,19,0,2256,5,4545,2.874.583.333
30/03/2020 15:00,8.18,51736,2366,16,0,2136,6,4524,2.874.583.333
30/03/2020 16:00,8.28,52214,2329,18,0,1974,6,4327,2.874.583.333
30/03/2020 17:00,8.91,52454,2195,23,0,1792,6,4016,2.874.583.333
30/03/2020 18:00,12.62,52807,1965,28,0,1603,5,3601,2.874.583.333
30/03/2020 19:00,11.48,52671,1696,31,0,1492,4,3223,2.874.583.333
30/03/2020 20:00,8.27,51534,1364,31,0,1536,4,2935,2.874.583.333
30/03/2020 21:00,7.57,49653,1051,31,0,1771,3,2856,2.874.583.333
30/03/2020 22:00,6.51,47572,763,33,0,2158,4,2958,2.874.583.333
30/03/2020 23:00,5.73,45931,516,17,54,2894,8,3489,2.874.583.333
31/03/2020 00:00,5.51,45197,364,10,40,3475,6,3895,2.874.583.333
31/03/2020 01:00,5.39,45101,249,7,37,3991,9,4293,2.874.583.333
31/03/2020 02:00,5.3,45369,159,6,42,4416,9,4632,2.874.583.333
31/03/2020 03:00,5.3,46087,125,5,53,4764,7,4954,2.874.583.333
31/03/2020 04:00,5.58,47866,134,5,56,4933,7,5135,2.874.583.333
31/03/2020 05:00,5.75,51144,214,6,45,5038,6,5309,2.874.583.333
31/03/2020 06:00,6.45,53987,390,9,36,5129,5,5569,2.874.583.333
31/03/2020 07:00,6.36,54884,599,14,27,5160,3,5803,2.874.583.333
31/03/2020 08:00,6.03,54505,880,21,17,5249,2,6169,2.874.583.333
31/03/2020 09:00,5.89,53992,1175,31,13,5321,2,6542,2.874.583.333
31/03/2020 10:00,5.77,53305,1479,43,12,5457,2,6993,2.874.583.333
31/03/2020 11:00,5.68,52461,1782,50,11,5538,2,7383,2.874.583.333
31/03/2020 12:00,5.49,51920,1968,53,16,5851,3,7891,2.874.583.333
31/03/2020 13:00,5.29,51387,2226,56,31,6123,4,8440,2.874.583.333
31/03/2020 14:00,5.12,50982,2518,55,48,6337,4,8962,2.874.583.333
31/03/2020 15:00,5.08,50671,2797,55,69,6517,5,9443,2.874.583.333
31/03/2020 16:00,5.15,50831,2940,59,86,6522,8,9615,2.874.583.333
31/03/2020 17:00,5.29,50955,2964,57,97,6623,11,9752,2.874.583.333
31/03/2020 18:00,5.42,50946,3140,54,113,6600,16,9923,2.874.583.333
31/03/2020 19:00,5.42,50614,3263,51,134,6525,22,9995,2.874.583.333
31/03/2020 20:00,5.31,49466,3323,48,168,6455,30,10024,2.874.583.333
31/03/2020 21:00,4.99,47566,3473,42,206,6474,37,10232,2.874.583.333
31/03/2020 22:00,4.71,45542,3518,34,247,6440,42,10281,2.874.583.333
31/03/2020 23:00,4.41,44082,3164,24,314,6245,43,9790,2.874.583.333
01/04/2020 00:00,4.36,43085,3045,17,352,6131,43,9588,2.874.583.333
01/04/2020 01:00,4.39,42814,3005,12,363,5968,43,9391,2.874.583.333
01/04/2020 02:00,4.5,42959,2927,7,378,5796,43,9151,2.874.583.333
01/04/2020 03:00,4.58,43522,2881,4,389,5656,45,8975,2.874.583.333
01/04/2020 04:00,4.83,45179,2906,5,393,5514,42,8860,2.874.583.333
01/04/2020 05:00,5.03,48348,2891,7,393,5221,39,8551,2.874.583.333
01/04/2020 06:00,6.15,51482,2978,9,389,4676,38,8090,2.874.583.333
01/04/2020 07:00,7.92,52431,2991,15,382,4154,33,7575,2.874.583.333
01/04/2020 08:00,7.92,52139,3198,26,375,3557,27,7183,2.874.583.333
01/04/2020 09:00,7.21,51785,3383,43,366,3166,24,6982,2.874.583.333
01/04/2020 10:00,6.34,51310,3465,63,363,2894,20,6805,2.874.583.333
01/04/2020 11:00,6.17,50645,3661,85,365,2716,21,6848,2.874.583.333
01/04/2020 12:00,5.82,50206,3727,109,366,2652,21,6875,2.874.583.333
01/04/2020 13:00,5.58,49433,3822,130,366,2747,20,7085,2.874.583.333
01/04/2020 14:00,5.35,48996,3856,150,368,2895,20,7289,2.874.583.333
01/04/2020 15:00,5.2,48895,3926,164,367,3050,15,7522,2.874.583.333
01/04/2020 16:00,5.26,49292,3875,177,359,3173,13,7597,2.874.583.333
01/04/2020 17:00,5.42,49481,3649,192,348,3307,11,7507,2.874.583.333
01/04/2020 18:00,5.48,49520,3627,208,342,3562,12,7751,2.874.583.333
01/04/2020 19:00,5.38,49349,3622,221,337,3779,14,7973,2.874.583.333
01/04/2020 20:00,5.06,48319,3587,229,344,3988,14,8162,2.874.583.333
01/04/2020 21:00,4.85,46553,3718,232,355,4287,14,8606,2.874.583.333
01/04/2020 22:00,4.56,44545,3822,227,363,4400,14,8826,2.874.583.333
01/04/2020 23:00,4.38,43324,4142,195,394,4517,22,9270,2.874.583.333
02/04/2020 00:00,4.28,42621,3957,181,418,4535,27,9118,2.874.583.333
02/04/2020 01:00,4.26,42530,3852,168,419,4399,27,8865,2.874.583.333
02/04/2020 02:00,4.35,42803,3546,154,425,4233,29,8387,2.874.583.333
02/04/2020 03:00,4.47,43563,3372,139,428,4238,37,8214,2.874.583.333
02/04/2020 04:00,4.68,45539,3433,125,428,4218,39,8243,2.874.583.333
02/04/2020 05:00,4.94,48897,3562,116,437,4079,45,8239,2.874.583.333
02/04/2020 06:00,5.68,51652,3757,115,443,3987,45,8347,2.874.583.333
02/04/2020 07:00,5.65,52675,3980,122,448,4052,50,8652,2.874.583.333
02/04/2020 08:00,5.26,52375,4348,135,455,4173,51,9162,2.874.583.333
02/04/2020 09:00,5,52135,4612,147,465,4406,50,9680,2.874.583.333
02/04/2020 10:00,4.91,51744,4737,155,468,4866,52,10278,2.874.583.333
02/04/2020 11:00,4.85,51088,4871,160,471,5324,53,10879,2.874.583.333
02/04/2020 12:00,4.8,50860,4862,159,469,5547,54,11091,2.874.583.333
02/04/2020 13:00,4.69,50511,4952,157,471,5552,55,11187,2.874.583.333
02/04/2020 14:00,4.64,50451,4939,154,469,5484,55,11101,2.874.583.333
02/04/2020 15:00,4.67,50518,4957,144,465,5332,55,10953,2.874.583.333
02/04/2020 16:00,4.74,51089,4935,128,455,5298,55,10871,2.874.583.333
02/04/2020 17:00,4.77,51237,4771,110,449,5428,55,10813,2.874.583.333
02/04/2020 18:00,4.81,51340,4828,92,445,5602,55,11022,2.874.583.333
02/04/2020 19:00,4.8,51137,4813,79,448,5785,55,11180,2.874.583.333
02/04/2020 20:00,4.69,50067,4730,70,455,5940,55,11250,2.874.583.333
02/04/2020 21:00,4.54,48236,4823,63,464,5950,55,11355,2.874.583.333
02/04/2020 22:00,4.22,46227,4818,61,468,5973,55,11375,2.874.583.333
02/04/2020 23:00,3.46,44320,4825,77,479,6216,53,11650,2.874.583.333
03/04/2020 00:00,3.38,43647,4663,85,481,6210,53,11492,2.874.583.333
03/04/2020 01:00,3.35,43591,4659,93,481,6287,53,11573,2.874.583.333
03/04/2020 02:00,3.41,43881,4475,100,481,6328,53,11437,2.874.583.333
03/04/2020 03:00,3.49,44630,4371,105,480,6273,52,11281,2.874.583.333
03/04/2020 04:00,3.84,46583,4352,106,479,6273,52,11262,2.874.583.333
03/04/2020 05:00,4.1,49900,4347,106,477,6186,52,11168,2.874.583.333
03/04/2020 06:00,4.47,52892,4418,107,476,6068,52,11121,2.874.583.333
03/04/2020 07:00,4.67,54002,4471,114,479,5887,52,11003,2.874.583.333
03/04/2020 08:00,4.58,53786,4627,125,479,5791,52,11074,2.874.583.333
03/04/2020 09:00,4.46,53389,4660,137,478,5702,51,11028,2.874.583.333
03/04/2020 10:00,4.35,52748,4600,148,479,5672,50,10949,2.874.583.333
03/04/2020 11:00,4.27,52180,4557,159,481,5644,50,10891,2.874.583.333
03/04/2020 12:00,4.2,51351,4449,173,482,5608,50,10762,2.874.583.333
03/04/2020 13:00,4.09,50619,4450,188,478,5704,49,10869,2.874.583.333
03/04/2020 14:00,4.02,50061,4389,200,476,5746,47,10858,2.874.583.333
03/04/2020 15:00,4.05,49832,4343,209,469,5878,44,10943,2.874.583.333
03/04/2020 16:00,4.25,50134,4179,218,461,5683,41,10582,2.874.583.333
03/04/2020 17:00,4.48,50470,3796,223,443,5428,32,9922,2.874.583.333
03/04/2020 18:00,4.7,50490,3511,229,419,5123,29,9311,2.874.583.333
03/04/2020 19:00,4.77,50098,3205,235,390,4883,28,8741,2.874.583.333
03/04/2020 20:00,4.7,49155,2799,240,366,4870,29,8304,2.874.583.333
03/04/2020 21:00,4.58,47759,2524,244,349,4877,31,8025,2.874.583.333
03/04/2020 22:00,4.45,46110,2293,244,332,4816,24,7709,2.874.583.333
03/04/2020 23:00,4.54,44651,1553,81,0,4715,23,6372,2.874.583.333
04/04/2020 00:00,4.52,43939,1356,48,0,4546,22,5972,2.874.583.333
04/04/2020 01:00,4.49,43741,1203,46,0,4496,19,5764,2.874.583.333
04/04/2020 02:00,4.49,43792,1066,45,0,4589,22,5722,2.874.583.333
04/04/2020 03:00,4.53,44019,971,43,0,4433,15,5462,2.874.583.333
04/04/2020 04:00,4.6,44474,881,41,0,4305,11,5238,2.874.583.333
04/04/2020 05:00,4.69,45296,781,40,0,4087,9,4917,2.874.583.333
04/04/2020 06:00,4.92,46419,714,35,0,3963,7,4719,2.874.583.333
04/04/2020 07:00,5.33,47849,683,27,0,3669,6,4385,2.874.583.333
04/04/2020 08:00,5.26,48665,699,21,0,3576,9,4305,2.874.583.333
04/04/2020 09:00,4.97,48652,789,20,0,3539,17,4365,2.874.583.333
04/04/2020 10:00,4.8,48176,988,23,0,3672,21,4704,2.874.583.333
04/04/2020 11:00,4.6,47465,1172,27,0,3909,27,5135,2.874.583.333
04/04/2020 12:00,4.49,46867,1303,27,0,4154,30,5514,2.874.583.333
04/04/2020 13:00,4.44,46407,1368,26,0,4215,28,5637,2.874.583.333
04/04/2020 14:00,4.4,46367,1369,24,0,4403,25,5821,2.874.583.333
04/04/2020 15:00,4.46,46820,1312,26,0,4317,24,5679,2.874.583.333
04/04/2020 16:00,4.67,47797,1268,34,0,4052,20,5374,2.874.583.333
04/04/2020 17:00,4.96,48420,1088,50,0,3703,13,4854,2.874.583.333
04/04/2020 18:00,5.4,48432,931,71,0,3295,9,4306,2.874.583.333
04/04/2020 19:00,5.26,48216,882,95,0,3188,8,4173,2.874.583.333
04/04/2020 20:00,4.99,47409,1016,120,0,2954,11,4101,2.874.583.333
04/04/2020 21:00,4.91,46250,1146,137,0,2974,14,4271,2.874.583.333
04/04/2020 22:00,4.66,45011,1261,153,0,2998,19,4431,2.874.583.333
04/04/2020 23:00,4.67,43527,1276,164,184,2846,21,4491,2.874.583.333
05/04/2020 00:00,4.64,42845,1251,175,174,2751,16,4367,2.874.583.333
05/04/2020 01:00,4.63,42493,1420,175,159,2654,15,4423,2.874.583.333
05/04/2020 02:00,4.6,42427,1674,171,145,2535,12,4537,2.874.583.333
05/04/2020 03:00,4.63,42559,1862,167,135,2459,9,4632,2.874.583.333
05/04/2020 04:00,4.64,42944,1832,165,124,2347,8,4476,2.874.583.333
05/04/2020 05:00,4.58,43244,1947,163,115,2199,8,4432,2.874.583.333
05/04/2020 06:00,4.61,44058,1993,159,101,1968,8,4229,2.874.583.333
05/04/2020 07:00,4.76,45224,1984,149,93,1704,7,3937,2.874.583.333
05/04/2020 08:00,4.66,46136,1918,131,92,1416,7,3564,2.874.583.333
05/04/2020 09:00,4.36,46469,1962,112,102,1257,11,3444,2.874.583.333
05/04/2020 10:00,3.92,46209,2052,100,110,1205,13,3480,2.874.583.333
05/04/2020 11:00,3.66,45790,2166,94,120,1465,13,3858,2.874.583.333
05/04/2020 12:00,3.53,45293,2162,91,121,1726,12,4112,2.874.583.333
05/04/2020 13:00,3.43,44789,2124,89,114,1865,10,4202,2.874.583.333
05/04/2020 14:00,3.43,44582,2026,87,99,1871,7,4090,2.874.583.333
05/04/2020 15:00,3.74,44921,2003,86,88,1912,7,4096,2.874.583.333
05/04/2020 16:00,4.46,45636,1988,81,76,1862,8,4015,2.874.583.333
05/04/2020 17:00,4.91,46319,1880,74,65,2015,9,4043,2.874.583.333
05/04/2020 18:00,5.17,46756,1914,69,57,2097,10,4147,2.874.583.333
05/04/2020 19:00,5.43,46945,2138,65,52,2204,14,4473,2.874.583.333
05/04/2020 20:00,5.12,46219,2527,65,63,2398,16,5069,2.874.583.333
05/04/2020 21:00,4.82,44806,2777,56,72,2746,16,5667,2.874.583.333
05/04/2020 22:00,4.45,43252,2850,44,89,2882,15,5880,2.874.583.333
05/04/2020 23:00,4.19,41929,3503,244,50,3240,13,7050,2.874.583.333
06/04/2020 00:00,4.07,41472,3291,237,65,3197,13,6803,2.723.333.333
06/04/2020 01:00,4.11,41254,3275,235,79,3285,14,6888,2.723.333.333
06/04/2020 02:00,3.78,41528,3221,235,94,3247,15,6812,2.723.333.333
06/04/2020 03:00,3.8,42263,3122,235,107,3171,13,6648,2.723.333.333
06/04/2020 04:00,4.56,44258,3118,234,113,3237,13,6715,2.723.333.333
06/04/2020 05:00,4.94,47490,3235,231,110,3134,15,6725,2.723.333.333
06/04/2020 06:00,5.38,50498,3201,231,106,3145,17,6700,2.723.333.333
06/04/2020 07:00,5.62,51686,3072,236,88,2823,13,6232,2.723.333.333
06/04/2020 08:00,5.6,51525,2874,242,66,2506,9,5697,2.723.333.333
06/04/2020 09:00,5.47,51036,2673,243,64,2374,9,5363,2.723.333.333
06/04/2020 10:00,5.2,50169,2523,244,76,2312,10,5165,2.723.333.333
06/04/2020 11:00,4.93,49205,2503,245,92,2548,12,5400,2.723.333.333
06/04/2020 12:00,4.74,48505,2419,244,91,2916,14,5684,2.723.333.333
06/04/2020 13:00,4.57,47547,2420,240,99,3134,14,5907,2.723.333.333
06/04/2020 14:00,4.47,46958,2358,233,108,3249,13,5961,2.723.333.333
06/04/2020 15:00,4.45,46635,2255,220,116,3306,13,5910,2.723.333.333
06/04/2020 16:00,4.52,46831,2112,200,129,3384,10,5835,2.723.333.333
06/04/2020 17:00,4.52,46876,1726,175,158,3603,8,5670,2.723.333.333
06/04/2020 18:00,4.61,47193,1508,149,197,4039,10,5903,2.723.333.333
06/04/2020 19:00,4.63,47071,1480,129,234,4327,12,6182,2.723.333.333
06/04/2020 20:00,4.54,46276,1552,113,263,4469,22,6419,2.723.333.333
06/04/2020 21:00,4.33,44550,1581,104,285,4575,27,6572,2.723.333.333
06/04/2020 22:00,4.08,42510,1599,98,286,4611,28,6622,2.723.333.333
06/04/2020 23:00,3.98,40561,1762,37,276,4467,31,6573,2.723.333.333
07/04/2020 00:00,3.93,39822,1698,33,270,4333,32,6366,2.723.333.333
07/04/2020 01:00,3.91,39681,1736,33,266,4144,33,6212,2.723.333.333
07/04/2020 02:00,3.99,39899,1828,36,267,3982,31,6144,2.723.333.333
07/04/2020 03:00,4.11,40599,1942,39,272,3887,32,6172,2.723.333.333
07/04/2020 04:00,4.36,42403,1997,41,276,3825,33,6172,2.723.333.333
07/04/2020 05:00,4.86,45552,2150,41,271,3744,35,6241,2.723.333.333
07/04/2020 06:00,5.19,48261,1978,40,259,3589,34,5900,2.723.333.333
07/04/2020 07:00,5.36,49125,1707,37,243,3511,29,5527,2.723.333.333
07/04/2020 08:00,5.11,48897,1406,36,223,3722,28,5415,2.723.333.333
07/04/2020 09:00,4.97,48503,1224,36,216,4049,35,5560,2.723.333.333
07/04/2020 10:00,4.85,47830,1167,39,228,4592,38,6064,2.723.333.333
07/04/2020 11:00,4.81,46964,1073,41,248,5183,39,6584,2.723.333.333
07/04/2020 12:00,4.59,46424,973,41,258,5427,36,6735,2.723.333.333
07/04/2020 13:00,4.48,46013,897,43,276,5465,40,6721,2.723.333.333
07/04/2020 14:00,4.51,45687,786,42,277,5413,33,6551,2.723.333.333
07/04/2020 15:00,4.55,45532,613,39,273,5087,18,6030,2.723.333.333
07/04/2020 16:00,4.69,45801,431,39,258,4577,9,5314,2.723.333.333
07/04/2020 17:00,4.86,45891,267,45,237,4082,10,4641,2.723.333.333
07/04/2020 18:00,5,46147,160,56,222,3751,22,4211,2.723.333.333
07/04/2020 19:00,4.99,46136,126,70,204,3672,33,4105,2.723.333.333
07/04/2020 20:00,4.89,45448,124,86,187,3616,35,4048,2.723.333.333
07/04/2020 21:00,4.68,43826,151,104,169,3667,24,4115,2.723.333.333
07/04/2020 22:00,4.31,41952,208,123,147,3833,13,4324,2.723.333.333
07/04/2020 23:00,4.18,40431,218,145,166,4203,20,4752,2.723.333.333
08/04/2020 00:00,4.09,39726,279,157,139,4425,18,5018,2.723.333.333
08/04/2020 01:00,4.04,39656,377,165,109,4629,14,5294,2.723.333.333
08/04/2020 02:00,4.04,39974,571,170,80,4775,10,5606,2.723.333.333
08/04/2020 03:00,4.1,40684,844,172,59,4843,6,5924,2.723.333.333
08/04/2020 04:00,4.27,42508,1110,172,37,4948,4,6271,2.723.333.333
08/04/2020 05:00,4.54,45621,1421,169,27,4992,3,6612,2.723.333.333
08/04/2020 06:00,4.85,48196,1623,162,22,4908,3,6718,2.723.333.333
08/04/2020 07:00,4.96,48956,1605,155,19,4685,3,6467,2.723.333.333
08/04/2020 08:00,4.93,48532,1418,153,17,4429,3,6020,2.723.333.333
08/04/2020 09:00,4.89,48081,1254,155,22,4486,3,5920,2.723.333.333
08/04/2020 10:00,4.71,47454,1223,163,28,4777,5,6196,2.723.333.333
08/04/2020 11:00,4.53,46766,1188,168,37,5155,9,6557,2.723.333.333
08/04/2020 12:00,4.38,46250,1151,170,40,5369,13,6743,2.723.333.333
08/04/2020 13:00,4.28,45933,1144,168,46,5621,16,6995,2.723.333.333
08/04/2020 14:00,4.21,45727,1123,162,46,5544,20,6895,2.723.333.333
08/04/2020 15:00,4.21,45551,1065,160,44,5453,22,6744,2.723.333.333
08/04/2020 16:00,4.27,45806,1029,170,40,5251,24,6514,2.723.333.333
08/04/2020 17:00,4.44,45906,953,180,41,5170,18,6362,2.723.333.333
08/04/2020 18:00,4.58,46059,839,185,54,5176,19,6273,2.723.333.333
08/04/2020 19:00,4.59,46048,774,190,72,5210,20,6266,2.723.333.333
08/04/2020 20:00,4.49,45319,906,198,104,5012,25,6245,2.723.333.333
08/04/2020 21:00,4.3,43612,1142,203,144,5051,28,6568,2.723.333.333
08/04/2020 22:00,4.04,42012,1438,202,182,5178,28,7028,2.723.333.333
08/04/2020 23:00,4.12,39355,1973,211,192,5189,26,7591,2.723.333.333
09/04/2020 00:00,4.03,38687,2037,205,203,5255,26,7726,2.723.333.333
09/04/2020 01:00,3.98,38530,2089,195,199,5208,26,7717,2.723.333.333
09/04/2020 02:00,3.99,38739,2179,176,177,5242,23,7797,2.723.333.333
09/04/2020 03:00,4.07,39485,2258,146,154,5362,23,7943,2.723.333.333
09/04/2020 04:00,4.33,40780,2197,108,150,5402,18,7875,2.723.333.333
09/04/2020 05:00,4.42,42715,2156,72,163,5323,20,7734,2.723.333.333
09/04/2020 06:00,4.69,44651,2206,43,175,5212,16,7652,2.723.333.333
09/04/2020 07:00,4.84,45572,2318,29,190,4998,12,7547,2.723.333.333
09/04/2020 08:00,4.82,45757,2445,27,210,4959,12,7653,2.723.333.333
09/04/2020 09:00,4.76,45628,2652,38,235,4935,19,7879,2.723.333.333
09/04/2020 10:00,4.65,45065,2718,63,256,4763,18,7818,2.723.333.333
09/04/2020 11:00,4.6,44253,2692,94,273,4639,18,7716,2.723.333.333
09/04/2020 12:00,4.55,43735,2602,121,274,4357,23,7377,2.723.333.333
09/04/2020 13:00,4.45,43177,2574,137,275,4221,26,7233,2.723.333.333
09/04/2020 14:00,4.37,42901,2630,148,264,4062,27,7131,2.723.333.333
09/04/2020 15:00,4.38,42917,2645,156,252,3964,24,7041,2.723.333.333
09/04/2020 16:00,4.55,43327,2500,166,238,3831,20,6755,2.723.333.333
09/04/2020 17:00,4.77,43810,2180,178,212,3702,14,6286,2.723.333.333
09/04/2020 18:00,4.96,44079,1737,190,191,3494,6,5618,2.723.333.333
09/04/2020 19:00,5,44376,1511,198,174,3410,6,5299,2.723.333.333
09/04/2020 20:00,5.04,44065,1377,202,157,3236,6,4978,2.723.333.333
09/04/2020 21:00,4.97,42808,1194,204,136,3152,8,4694,2.723.333.333
09/04/2020 22:00,4.78,41286,982,202,124,2980,9,4297,2.723.333.333
09/04/2020 23:00,4.79,39233,1155,201,109,2919,7,4391,2.723.333.333
10/04/2020 00:00,4.72,38767,964,197,108,2837,7,4113,2.723.333.333
10/04/2020 01:00,4.71,38613,814,191,102,2877,9,3993,2.723.333.333
10/04/2020 02:00,4.75,38752,710,182,97,3002,9,4000,2.723.333.333
10/04/2020 03:00,4.83,39173,637,173,94,3034,7,3945,2.723.333.333
10/04/2020 04:00,4.88,39681,618,158,86,3065,7,3934,2.723.333.333
10/04/2020 05:00,4.93,40369,587,130,76,2821,9,3623,2.723.333.333
10/04/2020 06:00,4.99,41490,604,99,58,2647,8,3416,2.723.333.333
10/04/2020 07:00,5.03,42520,575,76,45,2380,7,3083,2.723.333.333
10/04/2020 08:00,5.04,43087,600,67,51,2278,7,3003,2.723.333.333
10/04/2020 09:00,4.98,43328,676,71,84,2426,8,3265,2.723.333.333
10/04/2020 10:00,4.93,42932,708,88,117,2487,9,3409,2.723.333.333
10/04/2020 11:00,4.87,42242,722,110,149,2687,12,3680,2.723.333.333
10/04/2020 12:00,4.8,41774,737,134,170,2808,11,3860,2.723.333.333
10/04/2020 13:00,4.75,41370,747,155,183,2892,11,3988,2.723.333.333
10/04/2020 14:00,4.75,41270,797,174,179,2987,11,4148,2.723.333.333
10/04/2020 15:00,4.8,41451,758,185,177,3071,10,4201,2.723.333.333
10/04/2020 16:00,4.9,41970,639,181,169,3029,8,4026,2.723.333.333
10/04/2020 17:00,4.97,42293,497,169,151,2868,6,3691,2.723.333.333
10/04/2020 18:00,5.05,42596,347,155,133,2664,5,3304,2.723.333.333
10/04/2020 19:00,5.11,43031,271,142,122,2687,4,3226,2.723.333.333
10/04/2020 20:00,5.04,43095,236,132,114,2879,4,3365,2.723.333.333
10/04/2020 21:00,5.04,42255,206,123,105,2849,5,3288,2.723.333.333
10/04/2020 22:00,4.92,40862,156,112,89,3007,5,3369,2.723.333.333
10/04/2020 23:00,4.98,39325,231,107,86,2924,6,3354,2.723.333.333
11/04/2020 00:00,4.93,38863,178,103,84,2956,7,3328,2.723.333.333
11/04/2020 01:00,4.93,38704,128,100,76,2916,6,3226,2.723.333.333
11/04/2020 02:00,4.97,38781,91,95,67,2761,7,3021,2.723.333.333
11/04/2020 03:00,5.03,39099,78,89,57,2545,7,2776,2.723.333.333
11/04/2020 04:00,5.18,39522,79,83,41,2238,6,2447,2.723.333.333
11/04/2020 05:00,5.29,39887,86,74,30,1779,6,1975,2.723.333.333
11/04/2020 06:00,5.41,40842,154,65,19,1377,5,1620,2.723.333.333
11/04/2020 07:00,5.4,41909,230,64,12,896,4,1206,2.723.333.333
11/04/2020 08:00,5.42,42490,322,73,11,637,4,1047,2.723.333.333
11/04/2020 09:00,5.39,42655,412,88,16,497,4,1017,2.723.333.333
11/04/2020 10:00,5.33,42197,504,103,24,538,5,1174,2.723.333.333
11/04/2020 11:00,5.28,41659,739,112,37,664,7,1559,2.723.333.333
11/04/2020 12:00,5.13,41230,931,117,53,872,9,1982,2.723.333.333
11/04/2020 13:00,5.04,40934,1078,118,61,1158,10,2425,2.723.333.333
11/04/2020 14:00,5.07,40834,1200,116,64,1506,10,2896,2.723.333.333
11/04/2020 15:00,5.16,40901,1288,113,65,1719,9,3194,2.723.333.333
11/04/2020 16:00,5.32,41383,1475,107,57,1995,7,3641,2.723.333.333
11/04/2020 17:00,5.41,41664,1657,101,44,2366,5,4173,2.723.333.333
11/04/2020 18:00,5.37,41756,1717,96,36,2803,4,4656,2.723.333.333
11/04/2020 19:00,5.32,42090,1899,93,32,3262,5,5291,2.723.333.333
11/04/2020 20:00,5.1,42061,2163,90,35,3704,6,5998,2.723.333.333
11/04/2020 21:00,4.89,41023,2370,87,58,4062,7,6584,2.723.333.333
11/04/2020 22:00,4.66,39737,2491,86,91,4295,12,6975,2.723.333.333
11/04/2020 23:00,4.43,38652,2886,83,188,4614,21,7792,2.723.333.333
12/04/2020 00:00,4.23,38122,2576,74,246,4796,24,7716,2.723.333.333
12/04/2020 01:00,4.1,37873,2230,65,283,4812,24,7414,2.723.333.333
12/04/2020 02:00,4.08,37850,1978,58,308,4906,28,7278,2.723.333.333
12/04/2020 03:00,4.13,37951,1683,51,325,4932,32,7023,2.723.333.333
12/04/2020 04:00,4.16,38252,1365,46,340,4963,35,6749,2.723.333.333
12/04/2020 05:00,4.11,38516,1202,40,340,5048,38,6668,2.723.333.333
12/04/2020 06:00,4.18,39237,1087,37,337,5181,35,6677,2.723.333.333
12/04/2020 07:00,4.3,40431,1021,39,328,5271,37,6696,2.723.333.333
12/04/2020 08:00,4.4,41523,1030,42,315,5256,41,6684,2.723.333.333
12/04/2020 09:00,4.29,42655,1150,45,305,5394,43,6937,2.723.333.333
12/04/2020 10:00,4.09,42678,1390,47,297,5617,45,7396,2.723.333.333
12/04/2020 11:00,3.85,42466,1535,48,296,5814,45,7738,2.723.333.333
12/04/2020 12:00,3.02,42153,1736,47,294,6164,46,8287,2.723.333.333
12/04/2020 13:00,2.05,41690,1995,43,296,6256,45,8635,2.723.333.333
12/04/2020 14:00,2.31,41195,2283,37,296,6385,46,9047,2.723.333.333
12/04/2020 15:00,3.01,41401,2522,29,282,6440,46,9319,2.723.333.333
12/04/2020 16:00,3.7,42049,2744,24,276,6480,46,9570,2.723.333.333
12/04/2020 17:00,3.93,42546,2725,22,289,6573,44,9653,2.723.333.333
12/04/2020 18:00,3.96,42822,2577,23,304,6551,44,9499,2.723.333.333
12/04/2020 19:00,4,43015,2695,26,316,6619,46,9702,2.723.333.333
12/04/2020 20:00,4.06,42856,3161,29,323,6630,47,10190,2.723.333.333
12/04/2020 21:00,3.79,41553,3621,33,325,6604,47,10630,2.723.333.333
12/04/2020 22:00,3.4,40311,3878,35,318,6626,47,10904,2.723.333.333
12/04/2020 23:00,2.89,39220,4725,107,0,6919,45,11796,2.723.333.333
13/04/2020 00:00,1.49,38609,4616,93,0,7031,37,11777,2.595.178.571
13/04/2020 01:00,1.72,38606,4383,82,0,7059,31,11555,2.595.178.571
13/04/2020 02:00,1.23,38856,4358,71,0,6986,28,11443,2.595.178.571
13/04/2020 03:00,1.19,39299,4359,63,0,6928,28,11378,2.595.178.571
13/04/2020 04:00,1.23,39694,4160,56,0,6916,32,11164,2.595.178.571
13/04/2020 05:00,1.33,40272,4005,54,0,6907,35,11001,2.595.178.571
13/04/2020 06:00,1.41,41491,3949,53,0,6926,38,10966,2.595.178.571
13/04/2020 07:00,1.47,42693,3956,58,0,7094,29,11137,2.595.178.571
13/04/2020 08:00,1.85,43656,3852,68,0,7267,19,11206,2.595.178.571
13/04/2020 09:00,1.84,44038,3816,81,0,7358,15,11270,2.595.178.571
13/04/2020 10:00,1.47,43870,3793,88,0,7438,22,11341,2.595.178.571
13/04/2020 11:00,1.32,43388,3798,92,0,7440,23,11353,2.595.178.571
13/04/2020 12:00,1.14,43114,3849,96,0,7413,21,11379,2.595.178.571
13/04/2020 13:00,0.95,42824,4070,103,0,7448,27,11648,2.595.178.571
13/04/2020 14:00,0.84,42829,4245,112,0,7427,27,11811,2.595.178.571
13/04/2020 15:00,1.05,43055,4288,117,0,7470,26,11901,2.595.178.571
13/04/2020 16:00,1.74,43622,4359,118,0,7431,20,11928,2.595.178.571
13/04/2020 17:00,2.75,44043,4098,117,0,7312,17,11544,2.595.178.571
13/04/2020 18:00,3.88,44404,3608,116,0,7081,12,10817,2.595.178.571
13/04/2020 19:00,4.16,44718,3434,118,0,6917,14,10483,2.595.178.571
13/04/2020 20:00,4.35,44708,3352,117,0,6859,20,10348,2.595.178.571
13/04/2020 21:00,4.12,43724,3240,113,0,6780,20,10153,2.595.178.571
13/04/2020 22:00,3.96,42338,3108,103,0,6751,35,9997,2.595.178.571
13/04/2020 23:00,3.91,41215,2970,205,253,6713,31,10172,2.595.178.571
14/04/2020 00:00,4.1,40651,2774,189,254,6672,36,9925,2.595.178.571
14/04/2020 01:00,3.95,40700,2474,179,257,6623,38,9571,2.595.178.571
14/04/2020 02:00,3.98,41070,2303,165,253,6587,38,9346,2.595.178.571
14/04/2020 03:00,4.41,41713,2193,144,245,6440,39,9061,2.595.178.571
14/04/2020 04:00,4.65,43550,2078,124,250,6287,39,8778,2.595.178.571
14/04/2020 05:00,4.79,46464,1919,118,257,6097,40,8431,2.595.178.571
14/04/2020 06:00,4.99,49198,1816,117,282,5752,41,8008,2.595.178.571
14/04/2020 07:00,5.24,49885,1864,112,308,5382,41,7707,2.595.178.571
14/04/2020 08:00,5.17,49718,1981,104,327,5216,44,7672,2.595.178.571
14/04/2020 09:00,5.24,49562,2087,105,340,4845,44,7421,2.595.178.571
14/04/2020 10:00,5.19,49199,2165,113,357,4702,44,7381,2.595.178.571
14/04/2020 11:00,5.25,48589,2333,128,381,4366,43,7251,2.595.178.571
14/04/2020 12:00,5.11,48138,2392,145,399,4169,43,7148,2.595.178.571
14/04/2020 13:00,4.96,47734,2520,156,410,3777,43,6906,2.595.178.571
14/04/2020 14:00,4.94,47415,2744,160,414,3467,41,6826,2.595.178.571
14/04/2020 15:00,4.96,47250,3069,161,413,3324,40,7007,2.595.178.571
14/04/2020 16:00,5.1,47551,3373,156,397,3262,40,7228,2.595.178.571
14/04/2020 17:00,5.3,47640,3495,149,357,3432,32,7465,2.595.178.571
14/04/2020 18:00,5.37,47679,3282,141,306,3742,23,7494,2.595.178.571
14/04/2020 19:00,5.31,47429,3251,142,267,3933,18,7611,2.595.178.571
14/04/2020 20:00,4.98,46816,3463,146,258,4159,13,8039,2.595.178.571
14/04/2020 21:00,4.76,44856,3645,150,255,4511,13,8574,2.595.178.571
14/04/2020 22:00,4.52,42749,3761,145,261,4930,12,9109,2.595.178.571
14/04/2020 23:00,4.17,41853,4427,142,278,5284,36,10167,2.595.178.571
15/04/2020 00:00,3.96,40915,4443,137,284,5631,28,10523,2.595.178.571
15/04/2020 01:00,3.85,40724,4272,135,288,5891,14,10600,2.595.178.571
15/04/2020 02:00,3.81,41001,4301,133,293,6042,14,10783,2.595.178.571
15/04/2020 03:00,3.93,41567,4288,133,296,6098,31,10846,2.595.178.571
15/04/2020 04:00,4.28,43297,4143,127,300,5975,33,10578,2.595.178.571
15/04/2020 05:00,4.65,46496,3997,115,307,5856,37,10312,2.595.178.571
15/04/2020 06:00,4.98,49365,3891,107,316,5576,38,9928,2.595.178.571
15/04/2020 07:00,5.22,50271,3875,110,330,5431,36,9782,2.595.178.571
15/04/2020 08:00,5.02,49974,3466,114,352,5307,35,9274,2.595.178.571
15/04/2020 09:00,4.93,49642,3230,121,375,5327,36,9089,2.595.178.571
15/04/2020 10:00,4.84,49089,3333,128,385,5114,37,8997,2.595.178.571
15/04/2020 11:00,4.84,48298,3383,134,387,4794,40,8738,2.595.178.571
15/04/2020 12:00,4.79,47622,3424,138,376,4402,44,8384,2.595.178.571
15/04/2020 13:00,4.63,47024,3605,141,365,4126,40,8277,2.595.178.571
15/04/2020 14:00,4.72,46559,3711,147,361,3822,34,8075,2.595.178.571
15/04/2020 15:00,4.74,46154,3774,151,353,3735,27,8040,2.595.178.571
15/04/2020 16:00,4.85,46346,3822,151,333,3880,13,8199,2.595.178.571
15/04/2020 17:00,4.94,46358,3573,147,312,4076,9,8117,2.595.178.571
15/04/2020 18:00,4.98,46388,3276,138,302,4357,14,8087,2.595.178.571
15/04/2020 19:00,4.96,46256,3117,127,310,4634,22,8210,2.595.178.571
15/04/2020 20:00,4.86,45576,3225,111,329,4962,27,8654,2.595.178.571
15/04/2020 21:00,4.59,43631,3316,93,354,5277,35,9075,2.595.178.571
15/04/2020 22:00,4.29,41540,3294,73,388,5567,44,9366,2.595.178.571
15/04/2020 23:00,3.66,39574,3989,77,423,5886,41,10416,2.595.178.571
16/04/2020 00:00,3.5,38985,3991,63,445,5935,44,10478,2.595.178.571
16/04/2020 01:00,3.43,38814,3850,51,462,5965,44,10372,2.595.178.571
16/04/2020 02:00,3.46,39005,3848,40,472,6005,46,10411,2.595.178.571
16/04/2020 03:00,3.63,39658,3789,38,476,5963,46,10312,2.595.178.571
16/04/2020 04:00,4.07,41440,3494,39,479,5930,47,9989,2.595.178.571
16/04/2020 05:00,4.55,44330,3276,50,481,5660,47,9514,2.595.178.571
16/04/2020 06:00,4.98,46886,3045,76,480,5488,47,9136,2.595.178.571
16/04/2020 07:00,5.33,47905,2950,101,482,5250,47,8830,2.595.178.571
16/04/2020 08:00,5.21,47695,2738,113,483,5181,47,8562,2.595.178.571
16/04/2020 09:00,5.03,47494,2657,124,480,5141,47,8449,2.595.178.571
16/04/2020 10:00,4.92,47065,2714,134,477,5138,46,8509,2.595.178.571
16/04/2020 11:00,4.85,46415,2614,142,474,5074,46,8350,2.595.178.571
16/04/2020 12:00,4.84,45958,2518,152,467,5097,45,8279,2.595.178.571
16/04/2020 13:00,4.72,45545,2552,161,455,5049,45,8262,2.595.178.571
16/04/2020 14:00,4.61,45265,2524,167,432,5179,45,8347,2.595.178.571
16/04/2020 15:00,4.7,45026,2476,168,408,5240,40,8332,2.595.178.571
16/04/2020 16:00,4.75,45352,2348,156,361,5166,27,8058,2.595.178.571
16/04/2020 17:00,4.79,45470,2020,132,276,4976,16,7420,2.595.178.571
16/04/2020 18:00,4.93,45553,1624,105,200,4982,10,6921,2.595.178.571
16/04/2020 19:00,4.94,45434,1330,84,164,5048,10,6636,2.595.178.571
16/04/2020 20:00,4.86,45068,1210,73,166,5020,12,6481,2.595.178.571
16/04/2020 21:00,4.77,43637,1144,71,174,5134,13,6536,2.595.178.571
16/04/2020 22:00,4.58,41839,1066,76,184,5288,13,6627,2.595.178.571
16/04/2020 23:00,4.52,40812,1259,118,148,5315,11,6851,2.595.178.571
17/04/2020 00:00,4.45,40216,1022,136,147,5326,14,6645,2.595.178.571
17/04/2020 01:00,4.43,40116,860,129,144,5408,12,6553,2.595.178.571
17/04/2020 02:00,4.47,40330,726,143,150,5414,12,6445,2.595.178.571
17/04/2020 03:00,4.55,41025,631,178,159,5457,14,6439,2.595.178.571
17/04/2020 04:00,4.69,42780,577,195,162,5401,16,6351,2.595.178.571
17/04/2020 05:00,4.9,45534,508,197,152,5339,20,6216,2.595.178.571
17/04/2020 06:00,5.17,48142,468,198,145,5153,19,5983,2.595.178.571
17/04/2020 07:00,5.13,49082,441,201,176,5161,29,6008,2.595.178.571
17/04/2020 08:00,4.99,48946,373,198,248,5198,33,6050,2.595.178.571
17/04/2020 09:00,4.92,48485,328,192,315,5237,36,6108,2.595.178.571
17/04/2020 10:00,4.86,47890,262,197,356,5197,35,6047,2.595.178.571
17/04/2020 11:00,4.83,47219,215,208,376,5277,37,6113,2.595.178.571
17/04/2020 12:00,4.76,46492,204,209,384,5339,42,6178,2.595.178.571
17/04/2020 13:00,4.78,45627,223,203,386,5436,42,6290,2.595.178.571
17/04/2020 14:00,4.75,45076,280,198,386,5493,42,6399,2.595.178.571
17/04/2020 15:00,4.76,44841,371,198,385,5470,39,6463,2.595.178.571
17/04/2020 16:00,4.82,45068,477,199,365,5429,37,6507,2.595.178.571
17/04/2020 17:00,4.96,45062,655,198,321,5233,36,6443,2.595.178.571
17/04/2020 18:00,5.07,44919,718,196,261,4991,32,6198,2.595.178.571
17/04/2020 19:00,5.16,44605,693,196,223,4852,27,5991,2.595.178.571
17/04/2020 20:00,4.98,44320,722,195,209,4700,26,5852,2.595.178.571
17/04/2020 21:00,4.98,43185,710,193,209,4558,26,5696,2.595.178.571
17/04/2020 22:00,4.85,41738,666,190,209,4518,30,5613,2.595.178.571
17/04/2020 23:00,4.8,40420,834,92,206,4505,22,5659,2.595.178.571
18/04/2020 00:00,4.73,39680,775,85,201,4375,20,5456,2.595.178.571
18/04/2020 01:00,4.73,39477,691,74,191,4327,22,5305,2.595.178.571
18/04/2020 02:00,4.75,39498,611,64,179,4288,22,5164,2.595.178.571
18/04/2020 03:00,4.8,39671,575,57,165,4270,21,5088,2.595.178.571
18/04/2020 04:00,4.9,40046,582,54,146,4038,16,4836,2.595.178.571
18/04/2020 05:00,5.02,40582,622,54,118,3703,16,4513,2.595.178.571
18/04/2020 06:00,5.23,41671,647,57,91,3359,14,4168,2.595.178.571
18/04/2020 07:00,5.25,42988,588,63,79,3142,12,3884,2.595.178.571
18/04/2020 08:00,5.32,43936,501,74,89,3302,14,3980,2.595.178.571
18/04/2020 09:00,5.2,44171,432,91,108,3271,14,3916,2.595.178.571
18/04/2020 10:00,4.99,43905,413,108,128,3314,14,3977,2.595.178.571
18/04/2020 11:00,4.97,43298,484,119,150,3559,16,4328,2.595.178.571
18/04/2020 12:00,4.96,42837,565,121,157,3617,16,4476,2.595.178.571
18/04/2020 13:00,4.92,42277,653,115,171,3707,19,4665,2.595.178.571
18/04/2020 14:00,4.92,42192,838,101,178,3672,20,4809,2.595.178.571
18/04/2020 15:00,4.95,42513,1075,83,176,3562,21,4917,2.595.178.571
18/04/2020 16:00,5.26,43211,1132,63,171,3441,20,4827,2.595.178.571
18/04/2020 17:00,5.65,43536,1132,46,161,3109,18,4466,2.595.178.571
18/04/2020 18:00,5.83,43367,1005,35,149,2986,14,4189,2.595.178.571
18/04/2020 19:00,5.79,43007,898,27,141,2913,10,3989,2.595.178.571
18/04/2020 20:00,5.62,42696,1010,23,136,2742,10,3921,2.595.178.571
18/04/2020 21:00,5.37,41701,1140,21,132,2896,11,4200,2.595.178.571
18/04/2020 22:00,5.09,40449,1145,25,126,2903,16,4215,2.595.178.571
18/04/2020 23:00,4.86,39494,865,35,143,2939,23,4005,2.595.178.571
19/04/2020 00:00,4.79,38819,770,58,146,2763,25,3762,2.595.178.571
19/04/2020 01:00,4.79,38432,674,83,154,2692,25,3628,2.595.178.571
19/04/2020 02:00,4.83,38427,681,107,165,2755,22,3730,2.595.178.571
19/04/2020 03:00,4.91,38558,717,131,174,2707,22,3751,2.595.178.571
19/04/2020 04:00,4.96,38783,785,151,174,2567,21,3698,2.595.178.571
19/04/2020 05:00,4.92,38958,816,171,169,2107,18,3281,2.595.178.571
19/04/2020 06:00,5.13,39744,797,188,166,1774,16,2941,2.595.178.571
19/04/2020 07:00,5.38,40850,712,200,171,1456,18,2557,2.595.178.571
19/04/2020 08:00,5.56,41749,599,207,199,1236,18,2259,2.595.178.571
19/04/2020 09:00,5.48,42117,555,214,229,1117,16,2131,2.595.178.571
19/04/2020 10:00,5.18,42020,533,221,235,1248,14,2251,2.595.178.571
19/04/2020 11:00,4.84,41672,511,226,216,1416,15,2384,2.595.178.571
19/04/2020 12:00,4.45,41225,486,229,189,1705,18,2627,2.595.178.571
19/04/2020 13:00,4.19,40742,470,232,180,1742,18,2642,2.595.178.571
19/04/2020 14:00,4.2,40586,468,233,179,1861,19,2760,2.595.178.571
19/04/2020 15:00,4.3,40743,477,232,179,1777,19,2684,2.595.178.571
19/04/2020 16:00,4.66,41329,478,231,172,1898,18,2797,2.595.178.571
19/04/2020 17:00,4.96,41713,469,230,156,1978,16,2849,2.595.178.571
19/04/2020 18:00,5.16,41702,456,229,140,2150,13,2988,2.595.178.571
19/04/2020 19:00,5.19,41792,497,227,132,2183,10,3049,2.595.178.571
19/04/2020 20:00,5.13,41828,484,223,125,2470,10,3312,2.595.178.571
19/04/2020 21:00,4.94,40745,444,215,117,2631,10,3417,2.595.178.571
19/04/2020 22:00,4.71,39361,401,203,105,2995,10,3714,2.595.178.571
19/04/2020 23:00,4.44,38394,210,189,90,2956,10,3455,2.595.178.571
20/04/2020 00:00,4.33,37898,180,186,81,3022,7,3476,2.522.261.905
20/04/2020 01:00,3.88,37774,152,186,71,2987,6,3402,2.522.261.905
20/04/2020 02:00,3.66,37976,141,185,68,3218,6,3618,2.522.261.905
20/04/2020 03:00,4.01,38645,156,183,69,3062,6,3476,2.522.261.905
20/04/2020 04:00,4.84,40316,182,182,69,2997,7,3437,2.522.261.905
20/04/2020 05:00,5.65,42950,203,184,57,2671,8,3123,2.522.261.905
20/04/2020 06:00,6.85,45553,210,188,42,2521,8,2969,2.522.261.905
20/04/2020 07:00,8.05,46365,224,195,30,2171,7,2627,2.522.261.905
20/04/2020 08:00,7.93,46344,242,201,30,1875,9,2357,2.522.261.905
20/04/2020 09:00,7.1,46090,273,209,35,1821,10,2348,2.522.261.905
20/04/2020 10:00,5.86,45535,299,218,49,1615,11,2192,2.522.261.905
20/04/2020 11:00,5.04,44770,357,227,59,1669,11,2323,2.522.261.905
20/04/2020 12:00,4.8,44241,414,232,68,1619,13,2346,2.522.261.905
20/04/2020 13:00,4.71,43553,477,232,78,1625,13,2425,2.522.261.905
20/04/2020 14:00,4.63,43047,626,227,79,1544,13,2489,2.522.261.905
20/04/2020 15:00,4.68,42880,853,218,81,1466,13,2631,2.522.261.905
20/04/2020 16:00,4.98,43055,945,212,78,1382,11,2628,2.522.261.905
20/04/2020 17:00,5.38,43094,971,208,71,1440,11,2701,2.522.261.905
20/04/2020 18:00,5.48,43077,979,204,71,1568,9,2831,2.522.261.905
20/04/2020 19:00,5.39,42775,933,199,78,1639,10,2859,2.522.261.905
20/04/2020 20:00,5.35,42465,1034,196,85,1731,8,3054,2.522.261.905
20/04/2020 21:00,5.27,41187,1159,195,96,1815,6,3271,2.522.261.905
20/04/2020 22:00,4.89,39540,1172,192,100,1819,5,3288,2.522.261.905
20/04/2020 23:00,4.71,37939,969,35,119,1855,8,2986,2.522.261.905
21/04/2020 00:00,4.37,37303,881,37,110,1810,8,2846,2.522.261.905
21/04/2020 01:00,4.13,37114,829,37,95,1764,8,2733,2.522.261.905
21/04/2020 02:00,4.15,37365,743,35,85,1712,8,2583,2.522.261.905
21/04/2020 03:00,4.17,38022,748,33,74,1617,7,2479,2.522.261.905
21/04/2020 04:00,4.81,39653,776,31,64,1562,7,2440,2.522.261.905
21/04/2020 05:00,5.46,42411,856,28,44,1257,7,2192,2.522.261.905
21/04/2020 06:00,7.04,45056,876,25,31,923,6,1861,2.522.261.905
21/04/2020 07:00,9.2,45810,843,25,25,740,6,1639,2.522.261.905
21/04/2020 08:00,7.41,45519,751,28,29,677,6,1491,2.522.261.905
21/04/2020 09:00,5.24,45106,795,32,42,695,7,1571,2.522.261.905
21/04/2020 10:00,4.8,44481,925,36,48,816,9,1834,2.522.261.905
21/04/2020 11:00,4.65,43779,1131,38,52,958,11,2190,2.522.261.905
21/04/2020 12:00,4.55,43287,1287,38,48,1015,13,2401,2.522.261.905
21/04/2020 13:00,4.47,42819,1406,38,37,1142,10,2633,2.522.261.905
21/04/2020 14:00,4.36,42406,1477,38,37,1247,9,2808,2.522.261.905
21/04/2020 15:00,4.39,42210,1391,37,45,1136,11,2620,2.522.261.905
21/04/2020 16:00,4.67,42268,1359,36,61,1184,13,2653,2.522.261.905
21/04/2020 17:00,5.18,42216,1253,36,71,1143,14,2517,2.522.261.905
21/04/2020 18:00,5.3,42185,1063,35,91,1254,13,2456,2.522.261.905
21/04/2020 19:00,5.37,42057,1000,36,113,1323,13,2485,2.522.261.905
21/04/2020 20:00,5.4,41746,1163,38,128,1299,14,2642,2.522.261.905
21/04/2020 21:00,5.29,40283,1328,41,138,1351,13,2871,2.522.261.905
21/04/2020 22:00,5.24,38555,1272,40,134,1193,9,2648,2.522.261.905
21/04/2020 23:00,4.76,36948,1211,39,121,960,10,2341,2.522.261.905
22/04/2020 00:00,4.52,36239,1133,39,103,800,7,2082,2.522.261.905
22/04/2020 01:00,4.35,36090,1044,39,97,704,5,1889,2.522.261.905
22/04/2020 02:00,4.46,36385,945,38,97,701,5,1786,2.522.261.905
22/04/2020 03:00,4.66,37035,893,40,102,752,5,1792,2.522.261.905
22/04/2020 04:00,5.73,38640,837,40,95,822,4,1798,2.522.261.905
22/04/2020 05:00,7.48,41450,872,37,79,805,4,1797,2.522.261.905
22/04/2020 06:00,9.93,43993,809,33,51,770,4,1667,2.522.261.905
22/04/2020 07:00,10.19,44747,768,30,28,684,3,1513,2.522.261.905
22/04/2020 08:00,9.89,44457,711,31,22,547,3,1314,2.522.261.905
22/04/2020 09:00,8.12,44069,717,32,25,538,3,1315,2.522.261.905
22/04/2020 10:00,7.13,43576,755,33,29,532,3,1352,2.522.261.905
22/04/2020 11:00,5.44,42957,922,32,34,540,3,1531,2.522.261.905
22/04/2020 12:00,4.98,42523,1032,29,36,743,4,1844,2.522.261.905
22/04/2020 13:00,4.72,42042,1069,29,55,1005,6,2164,2.522.261.905
22/04/2020 14:00,4.56,41656,1052,31,76,1179,7,2345,2.522.261.905
22/04/2020 15:00,4.72,41356,931,40,99,1498,6,2574,2.522.261.905
22/04/2020 16:00,5.41,41529,850,47,115,1440,5,2457,2.522.261.905
22/04/2020 17:00,5.85,41456,698,50,118,1436,5,2307,2.522.261.905
22/04/2020 18:00,5.92,41409,509,51,120,1689,5,2374,2.522.261.905
22/04/2020 19:00,5.71,41349,439,51,113,1886,4,2493,2.522.261.905
22/04/2020 20:00,5.58,41103,416,50,102,2166,4,2738,2.522.261.905
22/04/2020 21:00,5.25,39711,403,51,91,2349,4,2898,2.522.261.905
22/04/2020 22:00,4.93,37948,391,50,75,2374,4,2894,2.522.261.905
22/04/2020 23:00,4.96,36776,346,56,99,2320,7,2828,2.522.261.905
23/04/2020 00:00,4.92,36276,298,52,95,2199,8,2652,2.522.261.905
23/04/2020 01:00,4.89,36144,267,50,89,2128,8,2542,2.522.261.905
23/04/2020 02:00,4.9,36351,248,52,88,1970,6,2364,2.522.261.905
23/04/2020 03:00,5.05,36932,250,57,90,1859,6,2262,2.522.261.905
23/04/2020 04:00,5.42,38478,239,57,82,1668,6,2052,2.522.261.905
23/04/2020 05:00,6.26,41064,233,50,65,1355,8,1711,2.522.261.905
23/04/2020 06:00,9.94,43362,198,41,45,1143,6,1433,2.522.261.905
23/04/2020 07:00,9.8,44352,177,34,37,906,4,1158,2.522.261.905
23/04/2020 08:00,8.27,44150,149,30,39,844,3,1065,2.522.261.905
23/04/2020 09:00,7.23,43949,170,27,55,894,3,1149,2.522.261.905
23/04/2020 10:00,6.47,43510,199,25,74,1017,3,1318,2.522.261.905
23/04/2020 11:00,6.03,42997,241,24,107,1160,3,1535,2.522.261.905
23/04/2020 12:00,5.77,42558,277,25,139,1407,3,1851,2.522.261.905
23/04/2020 13:00,5.37,42149,333,24,163,1639,7,2166,2.522.261.905
23/04/2020 14:00,5.22,41812,390,23,160,1850,10,2433,2.522.261.905
23/04/2020 15:00,5.29,41654,432,22,156,2036,11,2657,2.522.261.905
23/04/2020 16:00,5.28,41867,487,21,146,2045,6,2705,2.522.261.905
23/04/2020 17:00,5.39,41772,496,24,135,2063,4,2722,2.522.261.905
23/04/2020 18:00,5.6,41656,458,33,131,2315,3,2940,2.522.261.905
23/04/2020 19:00,5.69,41511,495,43,132,2410,3,3083,2.522.261.905
23/04/2020 20:00,5.51,41310,626,49,125,2654,3,3457,2.522.261.905
23/04/2020 21:00,5.08,40000,769,49,120,3051,3,3992,2.522.261.905
23/04/2020 22:00,4.73,38317,861,48,100,3124,3,4136,2.522.261.905
23/04/2020 23:00,4.82,37171,904,59,86,3001,4,4054,2.522.261.905
24/04/2020 00:00,4.74,36574,1078,63,74,2947,4,4166,2.522.261.905
24/04/2020 01:00,4.68,36495,1259,61,56,2930,4,4310,2.522.261.905
24/04/2020 02:00,4.71,36727,1445,55,48,2889,4,4441,2.522.261.905
24/04/2020 03:00,4.78,37374,1558,47,45,2965,4,4619,2.522.261.905
24/04/2020 04:00,4.96,38878,1586,37,42,2887,4,4556,2.522.261.905
24/04/2020 05:00,5.15,41552,1683,26,37,2849,4,4599,2.522.261.905
24/04/2020 06:00,6.47,44198,1754,17,33,2532,4,4340,2.522.261.905
24/04/2020 07:00,6.95,45254,1796,13,35,2310,4,4158,2.522.261.905
24/04/2020 08:00,6.61,45232,1739,13,46,2174,4,3976,2.522.261.905
24/04/2020 09:00,6.39,45046,1811,14,71,2060,4,3960,2.522.261.905
24/04/2020 10:00,6,44591,1880,17,93,2043,5,4038,2.522.261.905
24/04/2020 11:00,5.44,44005,2034,19,117,2091,4,4265,2.522.261.905
24/04/2020 12:00,5.19,43478,2140,21,133,2181,5,4480,2.522.261.905
24/04/2020 13:00,5,42736,2414,24,134,2304,6,4882,2.522.261.905
24/04/2020 14:00,4.86,42211,2614,26,124,2505,7,5276,2.522.261.905
24/04/2020 15:00,4.8,42022,2846,29,108,2643,8,5634,2.522.261.905
24/04/2020 16:00,4.84,42276,2987,31,88,2730,10,5846,2.522.261.905
24/04/2020 17:00,4.95,42275,2884,32,74,2882,14,5886,2.522.261.905
24/04/2020 18:00,5.02,42082,2599,33,69,2924,15,5640,2.522.261.905
24/04/2020 19:00,5.06,41817,2484,32,72,2784,15,5387,2.522.261.905
24/04/2020 20:00,5.07,41647,2413,32,88,2887,13,5433,2.522.261.905
24/04/2020 21:00,5.05,40632,2204,33,101,2930,12,5280,2.522.261.905
24/04/2020 22:00,4.92,39251,2009,34,108,2963,12,5126,2.522.261.905
24/04/2020 23:00,4.77,37638,2174,185,106,3057,12,5534,2.522.261.905
25/04/2020 00:00,4.73,37000,1954,181,129,3133,12,5409,2.522.261.905
25/04/2020 01:00,4.71,36742,1618,177,136,2968,12,4911,2.522.261.905
25/04/2020 02:00,4.79,36745,1290,170,131,2894,12,4497,2.522.261.905
25/04/2020 03:00,4.81,36892,1123,160,127,2934,11,4355,2.522.261.905
25/04/2020 04:00,4.89,37092,913,148,122,3014,10,4207,2.522.261.905
25/04/2020 05:00,4.92,37664,675,139,122,2757,11,3704,2.522.261.905
25/04/2020 06:00,5.09,38844,496,135,122,2735,14,3502,2.522.261.905
25/04/2020 07:00,5.16,40192,410,134,128,2743,19,3434,2.522.261.905
25/04/2020 08:00,5.31,41299,343,136,144,2922,17,3562,2.522.261.905
25/04/2020 09:00,5.18,41684,330,143,160,3306,17,3956,2.522.261.905
25/04/2020 10:00,4.99,41425,382,157,170,3493,17,4219,2.522.261.905
25/04/2020 11:00,4.86,40865,474,171,174,3663,19,4501,2.522.261.905
25/04/2020 12:00,4.74,40476,537,182,185,3849,19,4772,2.522.261.905
25/04/2020 13:00,4.66,40158,688,190,199,3854,22,4953,2.522.261.905
25/04/2020 14:00,4.65,40101,703,191,203,4057,29,5183,2.522.261.905
25/04/2020 15:00,4.69,40427,734,185,206,4299,25,5449,2.522.261.905
25/04/2020 16:00,4.82,41163,854,173,200,4278,21,5526,2.522.261.905
25/04/2020 17:00,4.99,41529,768,161,175,4082,11,5197,2.522.261.905
25/04/2020 18:00,5.11,41313,620,153,152,3915,6,4846,2.522.261.905
25/04/2020 19:00,5.19,40933,528,146,130,3619,4,4427,2.522.261.905
25/04/2020 20:00,5.2,40871,406,142,109,3552,5,4214,2.522.261.905
25/04/2020 21:00,5.14,40017,323,140,89,3614,7,4173,2.522.261.905
25/04/2020 22:00,4.92,38900,261,131,69,3440,9,3910,2.522.261.905
25/04/2020 23:00,4.98,37512,447,143,54,3273,8,3925,2.522.261.905
26/04/2020 00:00,4.95,36836,431,129,35,3083,7,3685,2.522.261.905
26/04/2020 01:00,4.94,36597,432,120,25,2955,7,3539,2.522.261.905
26/04/2020 02:00,4.99,36623,425,115,22,2799,8,3369,2.522.261.905
26/04/2020 03:00,5.05,36791,480,110,20,2652,6,3268,2.522.261.905
26/04/2020 04:00,5.12,36964,507,103,21,2378,5,3014,2.522.261.905
26/04/2020 05:00,5.15,37213,546,93,21,2140,5,2805,2.522.261.905
26/04/2020 06:00,5.28,38005,573,84,21,1792,6,2476,2.522.261.905
26/04/2020 07:00,5.41,39226,600,75,27,1569,6,2277,2.522.261.905
26/04/2020 08:00,5.45,40262,569,66,44,1375,6,2060,2.522.261.905
26/04/2020 09:00,5.59,40801,555,61,73,1360,9,2058,2.522.261.905
26/04/2020 10:00,5.65,40950,551,60,96,1340,10,2057,2.522.261.905
26/04/2020 11:00,5.45,40670,604,60,116,1394,8,2182,2.522.261.905
26/04/2020 12:00,5.28,40288,639,58,122,1312,8,2139,2.522.261.905
26/04/2020 13:00,5.11,39909,726,56,140,1272,9,2203,2.522.261.905
26/04/2020 14:00,5.07,39826,829,54,148,1163,8,2202,2.522.261.905
26/04/2020 15:00,5.21,40100,858,52,150,1160,11,2231,2.522.261.905
26/04/2020 16:00,5.42,40766,854,48,140,1105,8,2155,2.522.261.905
26/04/2020 17:00,5.91,41225,767,42,119,1026,8,1962,2.522.261.905
26/04/2020 18:00,6.01,41227,672,38,98,871,6,1685,2.522.261.905
26/04/2020 19:00,6.46,41215,655,33,85,877,5,1655,2.522.261.905
26/04/2020 20:00,6.81,41403,672,31,82,875,6,1666,2.522.261.905
26/04/2020 21:00,6.53,40377,727,31,79,1018,5,1860,2.522.261.905
26/04/2020 22:00,5.78,39010,795,29,76,1015,4,1919,2.522.261.905
26/04/2020 23:00,6.36,37836,956,31,0,920,3,1910,2.522.261.905
27/04/2020 00:00,5.93,37287,1008,36,0,821,3,1868,2.418.809.524
27/04/2020 01:00,5.92,37066,1022,40,0,745,3,1810,2.418.809.524
27/04/2020 02:00,5.99,37264,1031,42,0,721,3,1797,2.418.809.524
27/04/2020 03:00,6.41,37869,1060,40,0,714,3,1817,2.418.809.524
27/04/2020 04:00,7.4,39443,959,31,0,717,3,1710,2.418.809.524
27/04/2020 05:00,8.34,42346,969,22,0,630,2,1623,2.418.809.524
27/04/2020 06:00,9.94,45269,1019,17,0,561,3,1600,2.418.809.524
27/04/2020 07:00,11.92,46431,1074,17,0,597,2,1690,2.418.809.524
27/04/2020 08:00,11.25,46573,949,21,0,656,2,1628,2.418.809.524
27/04/2020 09:00,9.99,46579,893,27,0,801,2,1723,2.418.809.524
27/04/2020 10:00,9.26,46289,839,37,0,949,2,1827,2.418.809.524
27/04/2020 11:00,8.34,45697,726,46,0,1060,3,1835,2.418.809.524
27/04/2020 12:00,7.79,45428,623,52,0,1156,3,1834,2.418.809.524
27/04/2020 13:00,7.51,45134,605,55,0,1274,4,1938,2.418.809.524
27/04/2020 14:00,7.12,44755,538,55,0,1339,4,1936,2.418.809.524
27/04/2020 15:00,6.97,44625,473,56,0,1430,3,1962,2.418.809.524
27/04/2020 16:00,6.97,44934,410,55,0,1416,2,1883,2.418.809.524
27/04/2020 17:00,7.86,44891,354,55,0,1391,3,1803,2.418.809.524
27/04/2020 18:00,8.1,44650,292,57,0,1437,3,1789,2.418.809.524
27/04/2020 19:00,8.71,44291,280,57,0,1296,7,1640,2.418.809.524
27/04/2020 20:00,8.06,44076,271,57,0,1316,9,1653,2.418.809.524
27/04/2020 21:00,6.62,42680,264,62,0,1408,12,1746,2.418.809.524
27/04/2020 22:00,5.97,40665,252,71,0,1359,14,1696,2.418.809.524
27/04/2020 23:00,6.16,38881,307,52,112,1191,14,1676,2.418.809.524
28/04/2020 00:00,5.68,38137,347,50,106,1135,14,1652,2.418.809.524
28/04/2020 01:00,5.62,37938,368,48,96,1166,12,1690,2.418.809.524
28/04/2020 02:00,5.72,38067,410,45,81,1190,12,1738,2.418.809.524
28/04/2020 03:00,6.06,38636,500,40,71,1254,12,1877,2.418.809.524
28/04/2020 04:00,6.91,40158,513,34,62,1265,10,1884,2.418.809.524
28/04/2020 05:00,8.06,43308,509,27,53,1272,9,1870,2.418.809.524
28/04/2020 06:00,12.27,46249,506,22,42,1374,7,1951,2.418.809.524
28/04/2020 07:00,13.94,47287,471,20,39,1436,5,1971,2.418.809.524
28/04/2020 08:00,13.95,47284,456,20,42,1540,4,2062,2.418.809.524
28/04/2020 09:00,13.68,47170,439,20,45,1608,3,2115,2.418.809.524
28/04/2020 10:00,12.99,46982,389,22,51,1630,4,2096,2.418.809.524
28/04/2020 11:00,12.06,46539,366,22,63,1577,3,2031,2.418.809.524
28/04/2020 12:00,10.32,46265,339,21,80,1493,3,1936,2.418.809.524
28/04/2020 13:00,10.15,45933,353,19,99,1460,3,1934,2.418.809.524
28/04/2020 14:00,8.78,45791,358,17,111,1358,4,1848,2.418.809.524
28/04/2020 15:00,8.31,45624,347,15,119,1311,4,1796,2.418.809.524
28/04/2020 16:00,8.82,45660,367,13,123,1178,4,1685,2.418.809.524
28/04/2020 17:00,8.99,45527,360,14,125,1058,4,1561,2.418.809.524
28/04/2020 18:00,9.47,45220,357,16,131,976,4,1484,2.418.809.524
28/04/2020 19:00,9.97,44977,402,17,134,958,4,1515,2.418.809.524
28/04/2020 20:00,8.98,44813,453,19,132,1086,5,1695,2.418.809.524
28/04/2020 21:00,8.31,43308,507,20,129,1112,4,1772,2.418.809.524
28/04/2020 22:00,6.95,41343,537,20,114,1222,6,1899,2.418.809.524
28/04/2020 23:00,6.73,39631,538,20,142,1184,25,1909,2.418.809.524
29/04/2020 00:00,6.46,38845,571,22,119,1234,20,1966,2.418.809.524
29/04/2020 01:00,6.21,38624,538,22,90,1284,15,1949,2.418.809.524
29/04/2020 02:00,6.39,38883,558,22,69,1309,10,1968,2.418.809.524
29/04/2020 03:00,6.72,39415,609,21,51,1279,8,1968,2.418.809.524
29/04/2020 04:00,8.08,40924,591,19,36,1157,6,1809,2.418.809.524
29/04/2020 05:00,9.73,43978,668,17,31,1027,4,1747,2.418.809.524
29/04/2020 06:00,13.32,46897,686,15,29,963,4,1697,2.418.809.524
29/04/2020 07:00,13.65,47945,803,14,27,948,4,1796,2.418.809.524
29/04/2020 08:00,12.33,47850,858,14,18,957,4,1851,2.418.809.524
29/04/2020 09:00,11.82,47655,1029,18,14,992,4,2057,2.418.809.524
29/04/2020 10:00,11.04,47304,1183,23,12,977,4,2199,2.418.809.524
29/04/2020 11:00,10.65,46780,1366,30,11,934,6,2347,2.418.809.524
29/04/2020 12:00,9.82,46379,1529,38,14,881,7,2469,2.418.809.524
29/04/2020 13:00,8.95,45960,1645,43,18,858,8,2572,2.418.809.524
29/04/2020 14:00,8.55,45829,1802,47,23,903,9,2784,2.418.809.524
29/04/2020 15:00,8.89,45494,1850,52,31,930,11,2874,2.418.809.524
29/04/2020 16:00,8.49,45599,1922,58,36,998,9,3023,2.418.809.524
29/04/2020 17:00,8.07,45372,1974,68,39,1107,9,3197,2.418.809.524
29/04/2020 18:00,8.03,45165,1976,80,48,1227,9,3340,2.418.809.524
29/04/2020 19:00,8.4,44885,2142,91,66,1362,6,3667,2.418.809.524
29/04/2020 20:00,8.61,44622,2394,96,77,1606,7,4180,2.418.809.524
29/04/2020 21:00,7.56,43097,2642,99,92,1762,9,4604,2.418.809.524
29/04/2020 22:00,5.93,41263,2791,102,97,1873,10,4873,2.418.809.524
29/04/2020 23:00,5.86,39848,3013,121,115,1885,10,5144,2.418.809.524
30/04/2020 00:00,5.66,39158,3251,114,116,1852,9,5342,2.418.809.524
30/04/2020 01:00,5.55,38865,3311,101,112,1769,9,5302,2.418.809.524
30/04/2020 02:00,5.56,38972,3297,91,106,1751,10,5255,2.418.809.524
30/04/2020 03:00,5.66,39401,3431,81,104,1813,10,5439,2.418.809.524
30/04/2020 04:00,6.24,40757,3425,74,97,1809,12,5417,2.418.809.524
30/04/2020 05:00,7.49,43644,3542,67,85,1844,12,5550,2.418.809.524
30/04/2020 06:00,8.93,46426,3618,60,69,1869,10,5626,2.418.809.524
30/04/2020 07:00,10.46,47577,3526,52,60,1942,9,5589,2.418.809.524
30/04/2020 08:00,9.99,47584,3280,45,60,2096,11,5492,2.418.809.524
30/04/2020 09:00,8.94,47569,3164,39,60,2273,12,5548,2.418.809.524
30/04/2020 10:00,8.32,47376,2821,35,53,2502,9,5420,2.418.809.524
30/04/2020 11:00,7.76,46877,2459,32,45,2658,7,5201,2.418.809.524
30/04/2020 12:00,7.28,46539,2084,30,30,2781,7,4932,2.418.809.524
30/04/2020 13:00,6.23,46151,1834,29,27,3019,6,4915,2.418.809.524
30/04/2020 14:00,6.05,45860,1773,28,29,3051,6,4887,2.418.809.524
30/04/2020 15:00,6.28,45530,1709,26,34,3105,6,4880,2.418.809.524
30/04/2020 16:00,6.49,45591,1619,24,49,3183,8,4883,2.418.809.524
30/04/2020 17:00,6.48,45047,1535,21,67,3252,11,4886,2.418.809.524
30/04/2020 18:00,6.46,44262,1274,19,96,3182,7,4578,2.418.809.524
30/04/2020 19:00,5.95,43651,1022,19,136,3182,9,4368,2.418.809.524
30/04/2020 20:00,5.99,43932,838,22,172,3167,12,4211,2.418.809.524
30/04/2020 21:00,5.8,42786,723,25,201,3089,17,4055,2.418.809.524
30/04/2020 22:00,5.36,40866,720,27,217,3100,18,4082,2.418.809.524
30/04/2020 23:00,5.3,39115,1005,25,222,2915,20,4187,2.418.809.524
01/05/2020 00:00,5.22,38285,1166,24,214,2539,21,3964,2.418.809.524
01/05/2020 01:00,4.77,37950,1331,22,209,2434,23,4019,2.418.809.524
01/05/2020 02:00,4.58,37908,1450,20,211,2265,25,3971,2.418.809.524
01/05/2020 03:00,4.6,37864,1568,17,223,2149,23,3980,2.418.809.524
01/05/2020 04:00,4.75,37992,1485,15,227,1998,24,3749,2.418.809.524
01/05/2020 05:00,4.58,38596,1467,11,234,1907,18,3637,2.418.809.524
01/05/2020 06:00,4.83,39703,1475,8,248,1858,18,3607,2.418.809.524
01/05/2020 07:00,5.17,40752,1518,6,268,1807,17,3616,2.418.809.524
01/05/2020 08:00,5.45,41732,1551,6,286,1768,23,3634,2.418.809.524
01/05/2020 09:00,5.71,42289,1826,7,308,1835,29,4005,2.418.809.524
01/05/2020 10:00,5.69,42247,1868,7,315,1987,37,4214,2.418.809.524
01/05/2020 11:00,5.55,42011,1810,10,307,2067,39,4233,2.418.809.524
01/05/2020 12:00,5.42,41646,1776,13,286,2177,39,4291,2.418.809.524
01/05/2020 13:00,5.38,41251,1618,16,270,2246,38,4188,2.418.809.524
01/05/2020 14:00,5.3,41096,1394,20,245,2330,35,4024,2.418.809.524
01/05/2020 15:00,5.27,41134,1180,20,225,2204,33,3662,2.418.809.524
01/05/2020 16:00,6.45,41664,1018,21,215,2026,31,3311,2.418.809.524
01/05/2020 17:00,7.13,41916,752,25,213,1991,23,3004,2.418.809.524
01/05/2020 18:00,7.11,41788,585,33,219,1973,20,2830,2.418.809.524
01/05/2020 19:00,7.17,41628,558,45,236,1899,17,2755,2.418.809.524
01/05/2020 20:00,7.37,41959,526,61,251,1922,20,2780,2.418.809.524
01/05/2020 21:00,7.09,41190,561,77,255,1949,24,2866,2.418.809.524
01/05/2020 22:00,6.54,39741,564,84,236,1934,23,2841,2.418.809.524
01/05/2020 23:00,6.73,38813,266,78,91,1913,4,2352,2.418.809.524
02/05/2020 00:00,6.14,38133,250,93,72,1858,5,2278,2.418.809.524
02/05/2020 01:00,6.14,37857,244,96,52,1664,4,2060,2.418.809.524
02/05/2020 02:00,6.14,37816,212,90,45,1640,4,1991,2.418.809.524
02/05/2020 03:00,6.25,37810,206,81,40,1598,3,1928,2.418.809.524
02/05/2020 04:00,6.34,37942,198,71,34,1495,3,1801,2.418.809.524
02/05/2020 05:00,6.31,37931,214,60,28,1378,3,1683,2.418.809.524
02/05/2020 06:00,6.97,38886,230,49,23,1282,3,1587,2.418.809.524
02/05/2020 07:00,7.1,40077,237,41,21,1108,3,1410,2.418.809.524
02/05/2020 08:00,7.37,41205,260,36,19,1033,3,1351,2.418.809.524
02/05/2020 09:00,7.45,41639,299,35,20,1006,3,1363,2.418.809.524
02/05/2020 10:00,7.4,41541,331,38,24,974,3,1370,2.418.809.524
02/05/2020 11:00,7.36,41202,440,43,25,971,3,1482,2.418.809.524
02/05/2020 12:00,6.69,40771,573,50,24,982,3,1632,2.418.809.524
02/05/2020 13:00,5.66,40367,710,60,23,983,3,1779,2.418.809.524
02/05/2020 14:00,5.52,40160,860,72,23,861,3,1819,2.418.809.524
02/05/2020 15:00,5.79,40478,998,82,23,825,3,1931,2.418.809.524
02/05/2020 16:00,7.14,41182,1148,88,21,688,3,1948,2.418.809.524
02/05/2020 17:00,7.43,41481,1151,87,19,604,3,1864,2.418.809.524
02/05/2020 18:00,7.48,41111,1052,81,17,572,3,1725,2.418.809.524
02/05/2020 19:00,7.49,40582,1051,78,17,586,3,1735,2.418.809.524
02/05/2020 20:00,7.44,40619,1088,77,17,592,3,1777,2.418.809.524
02/05/2020 21:00,7.49,40018,1191,76,18,655,3,1943,2.418.809.524
02/05/2020 22:00,7.12,38800,1245,69,18,699,3,2034,2.418.809.524
02/05/2020 23:00,7.27,36980,1298,66,19,735,5,2123,2.418.809.524
03/05/2020 00:00,6.71,36283,1447,55,19,773,5,2299,2.418.809.524
03/05/2020 01:00,6.41,36009,1489,44,18,898,5,2454,2.418.809.524
03/05/2020 02:00,6.48,35984,1528,35,18,1017,5,2603,2.418.809.524
03/05/2020 03:00,6.39,35952,1692,26,21,1031,5,2775,2.418.809.524
03/05/2020 04:00,6.42,35977,1791,19,22,934,5,2771,2.418.809.524
03/05/2020 05:00,6.6,36263,1911,13,18,797,5,2744,2.418.809.524
03/05/2020 06:00,6.75,37032,2017,12,14,766,5,2814,2.418.809.524
03/05/2020 07:00,7.08,38271,2137,14,15,753,5,2924,2.418.809.524
03/05/2020 08:00,7.2,39350,2093,18,19,854,5,2989,2.418.809.524
03/05/2020 09:00,7.27,39888,2204,23,26,874,6,3133,2.418.809.524
03/05/2020 10:00,7.29,39944,2143,27,38,985,7,3200,2.418.809.524
03/05/2020 11:00,7.03,39686,2076,33,59,1194,8,3370,2.418.809.524
03/05/2020 12:00,6.23,39365,2083,38,63,1359,8,3551,2.418.809.524
03/05/2020 13:00,5.71,38962,2075,46,70,1741,7,3939,2.418.809.524
03/05/2020 14:00,5.58,38796,2240,58,70,1927,7,4302,2.418.809.524
03/05/2020 15:00,6.22,39201,2331,65,71,2107,8,4582,2.418.809.524
03/05/2020 16:00,6.62,39881,2399,63,70,2151,8,4691,2.418.809.524
03/05/2020 17:00,7.1,40386,2334,58,68,2133,8,4601,2.418.809.524
03/05/2020 18:00,7.45,40323,2115,54,67,2174,7,4417,2.418.809.524
03/05/2020 19:00,7.48,40296,2010,52,71,2188,7,4328,2.418.809.524
03/05/2020 20:00,7.64,40627,1919,52,75,2434,6,4486,2.418.809.524
03/05/2020 21:00,7.22,39798,1905,51,78,2707,6,4747,2.418.809.524
03/05/2020 22:00,6.43,38381,1901,48,77,2999,6,5031,2.418.809.524
03/05/2020 23:00,6.66,36778,1849,87,56,3113,5,5110,2.418.809.524
04/05/2020 00:00,6.41,36251,1889,91,60,3232,6,5278,2.354.345.238
04/05/2020 01:00,6.32,36054,1835,95,61,3314,7,5312,2.354.345.238
04/05/2020 02:00,6.39,36235,1754,96,62,3279,8,5199,2.354.345.238
04/05/2020 03:00,6.62,36855,1781,94,65,3254,8,5202,2.354.345.238
04/05/2020 04:00,7.24,38602,1796,91,61,3085,8,5041,2.354.345.238
04/05/2020 05:00,7.86,41872,1908,84,53,2731,8,4784,2.354.345.238
04/05/2020 06:00,12.11,45060,2029,78,42,2321,4,4474,2.354.345.238
04/05/2020 07:00,13.3,46348,2216,79,49,2118,3,4465,2.354.345.238
04/05/2020 08:00,12.92,46526,2195,87,60,1893,3,4238,2.354.345.238
04/05/2020 09:00,11.48,46502,2279,98,78,1851,3,4309,2.354.345.238
04/05/2020 10:00,10.89,46182,2382,103,90,1802,4,4381,2.354.345.238
04/05/2020 11:00,10.81,45735,2382,100,96,1772,4,4354,2.354.345.238
04/05/2020 12:00,9.86,45420,2378,95,93,1815,4,4385,2.354.345.238
04/05/2020 13:00,9.52,45102,2512,92,89,1807,5,4505,2.354.345.238
04/05/2020 14:00,9.48,44723,2611,91,69,1867,5,4643,2.354.345.238
04/05/2020 15:00,8.98,44429,2642,93,57,1904,5,4701,2.354.345.238
04/05/2020 16:00,9.63,44527,2834,94,41,1827,5,4801,2.354.345.238
04/05/2020 17:00,9.47,44280,2752,96,32,1870,3,4753,2.354.345.238
04/05/2020 18:00,10.53,43898,2463,104,27,1775,3,4372,2.354.345.238
04/05/2020 19:00,10.7,43452,2286,114,22,1748,2,4172,2.354.345.238
04/05/2020 20:00,10.71,43379,2052,124,21,2107,2,4306,2.354.345.238
04/05/2020 21:00,10.07,42133,1961,131,21,2254,3,4370,2.354.345.238
04/05/2020 22:00,7.57,40034,1982,133,20,2395,2,4532,2.354.345.238
04/05/2020 23:00,7.18,37968,1653,12,16,2556,3,4240,2.354.345.238
05/05/2020 00:00,6.95,37141,1641,14,22,2759,3,4439,2.354.345.238
05/05/2020 01:00,6.88,36940,1571,15,31,2886,2,4505,2.354.345.238
05/05/2020 02:00,6.93,37166,1476,14,37,2908,2,4437,2.354.345.238
05/05/2020 03:00,7.04,37761,1348,14,53,2816,2,4233,2.354.345.238
05/05/2020 04:00,7.47,39445,1333,13,57,2544,2,3949,2.354.345.238
05/05/2020 05:00,7.99,43028,1248,13,47,2130,4,3442,2.354.345.238
05/05/2020 06:00,13.13,46288,1165,13,36,1700,4,2918,2.354.345.238
05/05/2020 07:00,14.14,47395,1207,15,27,1482,4,2735,2.354.345.238
05/05/2020 08:00,12.03,47205,1187,19,27,1385,3,2621,2.354.345.238
05/05/2020 09:00,9.99,46990,1259,22,27,1572,3,2883,2.354.345.238
05/05/2020 10:00,8.42,46553,1367,23,30,1667,3,3090,2.354.345.238
05/05/2020 11:00,7.73,45890,1368,23,31,1932,4,3358,2.354.345.238
05/05/2020 12:00,7.47,45378,1404,20,20,2175,5,3624,2.354.345.238
05/05/2020 13:00,7.32,44999,1423,18,20,2431,7,3899,2.354.345.238
05/05/2020 14:00,7.16,44630,1388,15,26,2510,8,3947,2.354.345.238
05/05/2020 15:00,7.1,44189,1386,13,36,2681,10,4126,2.354.345.238
05/05/2020 16:00,7.03,44121,1448,13,58,2623,11,4153,2.354.345.238
05/05/2020 17:00,7.16,43674,1345,12,73,2559,10,3999,2.354.345.238
05/05/2020 18:00,7.3,43261,1114,11,99,2528,7,3759,2.354.345.238
05/05/2020 19:00,7.26,42810,982,11,130,2648,8,3779,2.354.345.238
05/05/2020 20:00,7.22,42727,860,12,155,3049,9,4085,2.354.345.238
05/05/2020 21:00,6.99,41329,785,12,175,3432,8,4412,2.354.345.238
05/05/2020 22:00,6.52,39100,714,12,179,3723,7,4635,2.354.345.238
05/05/2020 23:00,6.76,37301,1104,14,170,3886,17,5191,2.354.345.238
06/05/2020 00:00,6.52,36468,1172,13,180,3963,16,5344,2.354.345.238
06/05/2020 01:00,6.45,36297,1257,12,186,4016,15,5486,2.354.345.238
06/05/2020 02:00,6.55,36615,1394,12,190,3991,16,5603,2.354.345.238
06/05/2020 03:00,6.74,37217,1572,12,194,3892,16,5686,2.354.345.238
06/05/2020 04:00,7.12,38750,1866,12,198,3744,16,5836,2.354.345.238
06/05/2020 05:00,7.72,41900,2036,9,197,3389,13,5644,2.354.345.238
06/05/2020 06:00,8.54,44830,2179,6,194,3030,6,5415,2.354.345.238
06/05/2020 07:00,8.58,45812,2471,5,197,2945,7,5625,2.354.345.238
06/05/2020 08:00,7.79,45562,2549,5,204,3094,8,5860,2.354.345.238
06/05/2020 09:00,7.63,45226,2920,8,220,3134,11,6293,2.354.345.238
06/05/2020 10:00,7.51,44860,3232,11,232,3419,13,6907,2.354.345.238
06/05/2020 11:00,7.36,44364,3362,16,242,3688,15,7323,2.354.345.238
06/05/2020 12:00,7.09,43913,3568,21,239,3920,12,7760,2.354.345.238
06/05/2020 13:00,6.89,43400,3758,25,253,4257,13,8306,2.354.345.238
06/05/2020 14:00,6.65,43063,3949,28,265,4505,11,8758,2.354.345.238
06/05/2020 15:00,6.5,42772,4071,29,273,4587,9,8969,2.354.345.238
06/05/2020 16:00,6.65,42827,4416,27,256,4521,8,9228,2.354.345.238
06/05/2020 17:00,6.65,42478,4343,25,229,4258,5,8860,2.354.345.238
06/05/2020 18:00,6.84,42143,4002,24,201,4071,4,8302,2.354.345.238
06/05/2020 19:00,6.87,41730,3735,25,174,4086,4,8024,2.354.345.238
06/05/2020 20:00,7.07,41631,3487,25,152,4094,4,7762,2.354.345.238
06/05/2020 21:00,6.78,40462,3243,25,132,4182,3,7585,2.354.345.238
06/05/2020 22:00,6.19,38465,3093,24,112,4430,3,7662,2.354.345.238
06/05/2020 23:00,6.33,36494,3036,42,89,4637,3,7807,2.354.345.238
07/05/2020 00:00,6.14,35815,2838,41,81,4669,3,7632,2.354.345.238
07/05/2020 01:00,6.18,35650,2489,40,77,4668,8,7282,2.354.345.238
07/05/2020 02:00,6.47,35855,2150,36,81,4575,9,6851,2.354.345.238
07/05/2020 03:00,6.75,36426,1936,33,85,4429,11,6494,2.354.345.238
07/05/2020 04:00,7.22,37914,1708,27,83,4159,9,5986,2.354.345.238
07/05/2020 05:00,7.86,41028,1547,20,74,3814,7,5462,2.354.345.238
07/05/2020 06:00,8.37,44027,1313,18,70,3403,5,4809,2.354.345.238
07/05/2020 07:00,9,45283,1244,21,78,2932,7,4282,2.354.345.238
07/05/2020 08:00,8.52,45227,1039,26,88,2835,9,3997,2.354.345.238
07/05/2020 09:00,8.49,45188,996,31,105,2778,10,3920,2.354.345.238
07/05/2020 10:00,8.75,44956,1002,33,129,2641,14,3819,2.354.345.238
07/05/2020 11:00,8.44,44467,942,33,154,2558,15,3702,2.354.345.238
07/05/2020 12:00,8.32,44012,877,36,169,2490,17,3589,2.354.345.238
07/05/2020 13:00,8.22,43334,836,41,194,2562,18,3651,2.354.345.238
07/05/2020 14:00,8.11,42929,869,49,215,2422,21,3576,2.354.345.238
07/05/2020 15:00,8.12,42603,945,59,228,2330,18,3580,2.354.345.238
07/05/2020 16:00,8.16,42591,1085,62,222,2030,14,3413,2.354.345.238
07/05/2020 17:00,8.37,42242,1118,65,186,1658,10,3037,2.354.345.238
07/05/2020 18:00,8.74,41975,1065,69,153,1365,6,2658,2.354.345.238
07/05/2020 19:00,9.17,41601,1000,73,129,1229,4,2435,2.354.345.238
07/05/2020 20:00,9.99,41415,984,81,117,1248,4,2434,2.354.345.238
07/05/2020 21:00,8.46,40259,982,90,101,1288,4,2465,2.354.345.238
07/05/2020 22:00,8.01,38422,1008,97,83,1381,3,2572,2.354.345.238
07/05/2020 23:00,7.8,37337,1361,106,48,1338,3,2856,2.354.345.238
08/05/2020 00:00,7.54,36587,1359,106,35,1345,4,2849,2.354.345.238
08/05/2020 01:00,7.49,36375,1293,104,23,1360,5,2785,2.354.345.238
08/05/2020 02:00,7.51,36399,1224,102,18,1406,4,2754,2.354.345.238
08/05/2020 03:00,7.61,36799,1261,98,18,1583,6,2966,2.354.345.238
08/05/2020 04:00,7.99,38000,1364,91,21,1626,9,3111,2.354.345.238
08/05/2020 05:00,8.64,40454,1367,80,26,1580,12,3065,2.354.345.238
08/05/2020 06:00,13.13,43018,1375,71,33,1520,7,3006,2.354.345.238
08/05/2020 07:00,13.66,44208,1375,71,52,1586,9,3093,2.354.345.238
08/05/2020 08:00,13.16,44334,1327,78,69,1553,17,3044,2.354.345.238
08/05/2020 09:00,11.74,44231,1486,86,90,1745,24,3431,2.354.345.238
08/05/2020 10:00,9.46,43862,1577,95,107,1874,26,3679,2.354.345.238
08/05/2020 11:00,8.44,43210,1650,104,119,2092,25,3990,2.354.345.238
08/05/2020 12:00,8.03,42556,1747,112,123,2363,32,4377,2.354.345.238
08/05/2020 13:00,7.74,41944,1760,119,131,2582,30,4622,2.354.345.238
08/05/2020 14:00,7.47,41447,1791,126,134,2750,28,4829,2.354.345.238
08/05/2020 15:00,7.48,41169,1711,132,129,2871,28,4871,2.354.345.238
08/05/2020 16:00,7.8,41353,1649,134,123,3006,24,4936,2.354.345.238
08/05/2020 17:00,7.98,41267,1490,130,112,2846,24,4602,2.354.345.238
08/05/2020 18:00,8.1,40904,1296,121,102,2755,17,4291,2.354.345.238
08/05/2020 19:00,8.12,40230,1190,109,97,2766,13,4175,2.354.345.238
08/05/2020 20:00,8.21,40080,1072,98,100,2911,13,4194,2.354.345.238
08/05/2020 21:00,7.96,39176,994,90,105,3055,15,4259,2.354.345.238
08/05/2020 22:00,7.46,37733,969,81,112,3091,17,4270,2.354.345.238
08/05/2020 23:00,7.89,36421,891,151,94,3280,15,4431,2.354.345.238
09/05/2020 00:00,7.76,35709,768,148,101,3139,12,4168,2.354.345.238
09/05/2020 01:00,7.66,35437,626,145,101,3103,11,3986,2.354.345.238
09/05/2020 02:00,7.65,35346,515,138,98,2967,7,3725,2.354.345.238
09/05/2020 03:00,7.68,35425,456,130,90,2764,6,3446,2.354.345.238
09/05/2020 04:00,7.74,35551,422,118,79,2377,5,3001,2.354.345.238
09/05/2020 05:00,8,36100,308,106,60,1914,4,2392,2.354.345.238
09/05/2020 06:00,7.9,37200,253,98,50,1422,3,1826,2.354.345.238
09/05/2020 07:00,8.11,38585,205,91,49,1028,3,1376,2.354.345.238
09/05/2020 08:00,8.56,39736,160,86,55,864,3,1168,2.354.345.238
09/05/2020 09:00,8.64,40280,129,82,76,658,3,948,2.354.345.238
09/05/2020 10:00,8.62,40167,112,79,93,586,4,874,2.354.345.238
09/05/2020 11:00,8.44,39649,123,74,101,631,4,933,2.354.345.238
09/05/2020 12:00,8.25,39174,155,69,102,776,5,1107,2.354.345.238
09/05/2020 13:00,8.07,38836,181,61,105,981,5,1333,2.354.345.238
09/05/2020 14:00,7.97,38645,204,55,101,1109,5,1474,2.354.345.238
09/05/2020 15:00,7.97,39046,214,50,95,1226,5,1590,2.354.345.238
09/05/2020 16:00,8.29,39742,200,48,87,1330,4,1669,2.354.345.238
09/05/2020 17:00,8.56,40063,175,45,76,1400,4,1700,2.354.345.238
09/05/2020 18:00,8.77,39721,145,44,66,1491,3,1749,2.354.345.238
09/05/2020 19:00,8.62,39292,141,44,60,1736,4,1985,2.354.345.238
09/05/2020 20:00,8.69,39442,175,43,53,2051,5,2327,2.354.345.238
09/05/2020 21:00,8.48,38949,219,39,42,2229,4,2533,2.354.345.238
09/05/2020 22:00,7.95,37799,300,34,35,2362,4,2735,2.354.345.238
09/05/2020 23:00,8.11,36446,292,43,20,2336,4,2695,2.354.345.238
10/05/2020 00:00,7.92,35825,427,40,13,2410,4,2894,2.354.345.238
10/05/2020 01:00,7.8,35491,539,34,9,2335,3,2920,2.354.345.238
10/05/2020 02:00,7.7,35452,686,26,9,2275,4,3000,2.354.345.238
10/05/2020 03:00,7.56,35389,852,18,7,2151,4,3032,2.354.345.238
10/05/2020 04:00,7.44,35357,1009,11,7,1952,4,2983,2.354.345.238
10/05/2020 05:00,7.42,35711,1042,7,7,1852,4,2912,2.354.345.238
10/05/2020 06:00,7.55,36555,1059,6,7,1781,4,2857,2.354.345.238
10/05/2020 07:00,7.73,37852,1133,6,8,1898,3,3048,2.354.345.238
10/05/2020 08:00,7.88,39007,1227,7,12,2007,4,3257,2.354.345.238
10/05/2020 09:00,7.87,39762,1572,10,17,2038,5,3642,2.354.345.238
10/05/2020 10:00,7.75,40125,1874,13,26,2301,6,4220,2.354.345.238
10/05/2020 11:00,7.54,39967,2093,14,33,2447,9,4596,2.354.345.238
10/05/2020 12:00,6.54,39762,2402,14,34,2629,11,5090,2.354.345.238
10/05/2020 13:00,5.94,39584,2653,12,34,2698,14,5411,2.354.345.238
10/05/2020 14:00,5.68,39601,2962,11,34,2991,14,6012,2.354.345.238
10/05/2020 15:00,6.2,39974,3220,9,36,3100,9,6374,2.354.345.238
10/05/2020 16:00,7.24,40667,3742,8,37,3211,8,7006,2.354.345.238
10/05/2020 17:00,7.97,41221,3829,6,40,3120,9,7004,2.354.345.238
10/05/2020 18:00,8.26,41208,3615,6,60,3148,7,6836,2.354.345.238
10/05/2020 19:00,8.27,41076,3448,6,100,3282,6,6842,2.354.345.238
10/05/2020 20:00,8.49,41275,3217,7,162,3621,9,7016,2.354.345.238
10/05/2020 21:00,8.38,40634,3042,7,227,3752,16,7044,2.354.345.238
10/05/2020 22:00,7.94,39335,2991,8,268,3964,25,7256,2.354.345.238
10/05/2020 23:00,7.01,37605,3023,66,267,4135,25,7516,2.354.345.238
11/05/2020 00:00,6.03,36975,3048,55,282,4237,23,7645,2.266.071.429
11/05/2020 01:00,5.64,36815,2980,45,271,4316,21,7633,2.266.071.429
11/05/2020 02:00,4.91,36927,2705,37,250,4461,12,7465,2.266.071.429
11/05/2020 03:00,5.29,37390,2833,29,227,4498,4,7591,2.266.071.429
11/05/2020 04:00,7.01,38890,2893,19,204,4298,4,7418,2.266.071.429
11/05/2020 05:00,8.31,41915,2940,10,180,4140,7,7277,2.266.071.429
11/05/2020 06:00,9.91,45003,3044,8,153,4000,11,7216,2.266.071.429
11/05/2020 07:00,10.93,46312,3092,11,141,3774,21,7039,2.266.071.429
11/05/2020 08:00,10.68,46543,3035,16,145,3589,26,6811,2.266.071.429
11/05/2020 09:00,10.49,46538,3084,25,154,3404,37,6704,2.266.071.429
11/05/2020 10:00,10.01,46419,3114,36,168,3194,42,6554,2.266.071.429
11/05/2020 11:00,9.31,46028,2983,52,182,3300,41,6558,2.266.071.429
11/05/2020 12:00,8.97,45683,2921,69,193,3236,42,6461,2.266.071.429
11/05/2020 13:00,8.5,45364,2986,83,213,3396,30,6708,2.266.071.429
11/05/2020 14:00,8.1,44999,3009,95,243,3656,25,7028,2.266.071.429
11/05/2020 15:00,8.17,44695,2962,102,278,3550,17,6909,2.266.071.429
11/05/2020 16:00,8.46,44816,3084,100,291,3346,17,6838,2.266.071.429
11/05/2020 17:00,8.54,44601,3066,95,300,3389,18,6868,2.266.071.429
11/05/2020 18:00,8.68,44218,2837,93,312,3219,16,6477,2.266.071.429
11/05/2020 19:00,9.1,43629,2685,94,312,3063,18,6172,2.266.071.429
11/05/2020 20:00,9.13,43592,2482,97,309,2982,15,5885,2.266.071.429
11/05/2020 21:00,8.59,42711,2352,97,315,3142,17,5923,2.266.071.429
11/05/2020 22:00,8.27,40926,2335,92,313,3110,13,5863,2.266.071.429
11/05/2020 23:00,8.86,39308,2460,133,229,3114,2,5938,2.266.071.429
12/05/2020 00:00,8.81,38517,2678,123,203,3087,3,6094,2.266.071.429
12/05/2020 01:00,8.85,38305,2713,97,187,2954,5,5956,2.266.071.429
12/05/2020 02:00,8.95,38545,2517,76,163,2712,6,5474,2.266.071.429
12/05/2020 03:00,9.2,38967,2447,62,144,2685,4,5342,2.266.071.429
12/05/2020 04:00,11.92,40334,2435,56,130,2462,3,5086,2.266.071.429
12/05/2020 05:00,13.74,43292,2530,54,121,1956,2,4663,2.266.071.429
12/05/2020 06:00,13.9,46072,2616,59,119,1629,2,4425,2.266.071.429
12/05/2020 07:00,14.63,47119,2889,69,143,1517,3,4621,2.266.071.429
12/05/2020 08:00,14.12,46963,2908,81,187,1584,3,4763,2.266.071.429
12/05/2020 09:00,13.86,46840,3202,95,221,1794,5,5317,2.266.071.429
12/05/2020 10:00,13.51,46524,3430,116,257,1937,6,5746,2.266.071.429
12/05/2020 11:00,13.51,46158,3501,131,280,2092,7,6011,2.266.071.429
12/05/2020 12:00,12.44,45975,3678,137,292,2229,7,6343,2.266.071.429
12/05/2020 13:00,11.91,45658,3850,137,291,2332,7,6617,2.266.071.429
12/05/2020 14:00,10.3,45502,3941,137,265,2470,6,6819,2.266.071.429
12/05/2020 15:00,9.71,45360,3980,139,233,2578,6,6936,2.266.071.429
12/05/2020 16:00,10.52,45412,4318,144,194,2594,6,7256,2.266.071.429
12/05/2020 17:00,11.93,45149,4370,145,155,2528,6,7204,2.266.071.429
12/05/2020 18:00,12.06,44835,4166,137,124,2301,5,6733,2.266.071.429
12/05/2020 19:00,12.81,44384,3994,124,113,2462,4,6697,2.266.071.429
12/05/2020 20:00,12.63,44357,3775,112,128,2634,4,6653,2.266.071.429
12/05/2020 21:00,10.62,43305,3440,105,153,2941,4,6643,2.266.071.429
12/05/2020 22:00,8.92,41423,3257,97,175,3256,5,6790,2.266.071.429
12/05/2020 23:00,12.35,39397,1712,95,228,3369,31,5435,2.266.071.429
13/05/2020 00:00,11.83,38672,1568,86,272,3697,27,5650,2.266.071.429
13/05/2020 01:00,11.6,38400,1379,76,302,3634,31,5422,2.266.071.429
13/05/2020 02:00,11.6,38558,1085,64,316,3776,35,5276,2.266.071.429
13/05/2020 03:00,11.84,38940,1012,49,317,3750,23,5151,2.266.071.429
13/05/2020 04:00,12.81,40237,782,36,320,3386,28,4552,2.266.071.429
13/05/2020 05:00,14.91,43180,620,27,332,3024,32,4035,2.266.071.429
13/05/2020 06:00,16.14,45881,603,23,356,2711,40,3733,2.266.071.429
13/05/2020 07:00,18.06,46924,589,23,374,2409,45,3440,2.266.071.429
13/05/2020 08:00,17.03,46913,588,28,395,2247,44,3302,2.266.071.429
13/05/2020 09:00,15.96,46812,526,37,419,2168,43,3193,2.266.071.429
13/05/2020 10:00,15.84,46562,477,47,433,2046,46,3049,2.266.071.429
13/05/2020 11:00,15.76,46100,526,54,434,2011,42,3067,2.266.071.429
13/05/2020 12:00,15.68,45767,559,56,431,1914,46,3006,2.266.071.429
13/05/2020 13:00,15.31,45390,698,54,429,1786,46,3013,2.266.071.429
13/05/2020 14:00,14.91,45048,815,48,419,1809,46,3137,2.266.071.429
13/05/2020 15:00,14.84,44785,942,42,401,1748,37,3170,2.266.071.429
13/05/2020 16:00,14.88,44793,1046,41,375,1710,45,3217,2.266.071.429
13/05/2020 17:00,15.17,44443,1082,36,330,1486,47,2981,2.266.071.429
13/05/2020 18:00,15.25,44062,1025,32,271,1388,44,2760,2.266.071.429
13/05/2020 19:00,15.47,43695,1017,30,229,1334,32,2642,2.266.071.429
13/05/2020 20:00,15.28,43523,977,31,206,1327,20,2561,2.266.071.429
13/05/2020 21:00,15.07,42539,971,35,187,1321,25,2539,2.266.071.429
13/05/2020 22:00,14.59,40643,954,37,162,1470,24,2647,2.266.071.429
13/05/2020 23:00,15.24,39154,1303,65,91,1493,22,2974,2.266.071.429
14/05/2020 00:00,14.71,38550,1500,73,73,1670,15,3331,2.266.071.429
14/05/2020 01:00,14.49,38374,1637,80,56,1512,10,3295,2.266.071.429
14/05/2020 02:00,14.69,38499,1766,87,41,1367,11,3272,2.266.071.429
14/05/2020 03:00,14.97,38879,1995,88,35,1298,10,3426,2.266.071.429
14/05/2020 04:00,14.81,40196,2163,83,29,1139,8,3422,2.266.071.429
14/05/2020 05:00,14.99,42979,2285,68,20,901,6,3280,2.266.071.429
14/05/2020 06:00,16.24,45587,2348,60,15,742,4,3169,2.266.071.429
14/05/2020 07:00,17.17,46710,2440,56,17,779,4,3296,2.266.071.429
14/05/2020 08:00,15.94,46525,2223,55,24,905,4,3211,2.266.071.429
14/05/2020 09:00,15.74,46384,2203,59,35,1147,7,3451,2.266.071.429
14/05/2020 10:00,15.28,46078,2223,64,52,1380,9,3728,2.266.071.429
14/05/2020 11:00,15.96,45603,2223,65,76,1653,13,4030,2.266.071.429
14/05/2020 12:00,15.73,45263,2239,56,94,1871,15,4275,2.266.071.429
14/05/2020 13:00,14.99,44895,2357,44,113,2176,14,4704,2.266.071.429
14/05/2020 14:00,13.84,44509,2508,36,113,2466,13,5136,2.266.071.429
14/05/2020 15:00,13.22,44260,2716,33,118,2780,11,5658,2.266.071.429
14/05/2020 16:00,13.11,44340,2942,33,115,2870,11,5971,2.266.071.429
14/05/2020 17:00,13.54,44072,2956,34,104,2834,7,5935,2.266.071.429
14/05/2020 18:00,13.54,43762,2839,38,95,2579,7,5558,2.266.071.429
14/05/2020 19:00,13.58,43309,2708,47,91,2488,6,5340,2.266.071.429
14/05/2020 20:00,13.57,43092,2608,54,95,2542,6,5305,2.266.071.429
14/05/2020 21:00,13.62,42163,2434,60,106,2565,7,5172,2.266.071.429
14/05/2020 22:00,12.22,40376,2356,68,114,2717,9,5264,2.266.071.429
14/05/2020 23:00,12.29,38737,2603,47,158,2724,13,5545,2.266.071.429
15/05/2020 00:00,11.89,38046,2513,53,171,2797,12,5546,2.266.071.429
15/05/2020 01:00,11.61,37783,2366,60,182,2736,11,5355,2.266.071.429
15/05/2020 02:00,11.95,37802,2216,66,187,2545,10,5024,2.266.071.429
15/05/2020 03:00,11.84,38154,2268,68,189,2312,10,4847,2.266.071.429
15/05/2020 04:00,12.85,39312,2275,63,183,2178,10,4709,2.266.071.429
15/05/2020 05:00,14.46,41893,2317,52,172,1947,8,4496,2.266.071.429
15/05/2020 06:00,15.91,44592,2388,40,178,1860,11,4477,2.266.071.429
15/05/2020 07:00,16.12,45693,2539,33,208,1854,19,4653,2.266.071.429
15/05/2020 08:00,15.02,45792,2522,29,251,2085,19,4906,2.266.071.429
15/05/2020 09:00,14.43,45843,2781,30,286,2271,18,5386,2.266.071.429
15/05/2020 10:00,13.95,45575,3105,33,313,2425,22,5898,2.266.071.429
15/05/2020 11:00,13.49,44978,3308,39,325,2573,29,6274,2.266.071.429
15/05/2020 12:00,12.59,44386,3503,45,328,2772,32,6680,2.266.071.429
15/05/2020 13:00,11.77,43570,3778,51,326,3037,37,7229,2.266.071.429
15/05/2020 14:00,11.41,43005,4029,53,319,3138,36,7575,2.266.071.429
15/05/2020 15:00,11.25,42807,4124,53,304,3323,37,7841,2.266.071.429
15/05/2020 16:00,11.65,42945,4453,51,289,3433,37,8263,2.266.071.429
15/05/2020 17:00,13.48,42781,4420,47,265,3331,31,8094,2.266.071.429
15/05/2020 18:00,13.56,42334,4164,41,242,3073,30,7550,2.266.071.429
15/05/2020 19:00,13.3,41604,4076,38,234,2965,22,7335,2.266.071.429
15/05/2020 20:00,13.92,41371,4076,40,243,2887,19,7265,2.266.071.429
15/05/2020 21:00,13.03,40721,4006,44,262,3076,19,7407,2.266.071.429
15/05/2020 22:00,11.79,39422,3983,46,275,3098,19,7421,2.266.071.429
15/05/2020 23:00,10.53,38135,3995,67,322,3219,22,7625,2.266.071.429
16/05/2020 00:00,9.76,37333,3878,55,360,3222,24,7539,2.266.071.429
16/05/2020 01:00,9.12,36344,4009,43,382,3216,21,7671,2.266.071.429
16/05/2020 02:00,9.04,36815,4035,32,388,2941,22,7418,2.266.071.429
16/05/2020 03:00,8.73,37038,4087,23,381,2812,28,7331,2.266.071.429
16/05/2020 04:00,8.76,37217,4200,15,383,2884,29,7511,2.266.071.429
16/05/2020 05:00,8.67,37996,4290,10,403,2714,33,7450,2.266.071.429
16/05/2020 06:00,8.55,38856,4234,6,428,2741,44,7453,2.266.071.429
16/05/2020 07:00,9.85,39962,4120,6,448,2638,47,7259,2.266.071.429
16/05/2020 08:00,10.49,40982,4129,9,457,2698,49,7342,2.266.071.429
16/05/2020 09:00,10.33,41630,4191,14,462,2775,52,7494,2.266.071.429
16/05/2020 10:00,10.05,41648,4288,20,465,2936,52,7761,2.266.071.429
16/05/2020 11:00,9.55,41359,4276,27,468,3140,52,7963,2.266.071.429
16/05/2020 12:00,8.83,41101,4264,33,466,3334,53,8150,2.266.071.429
16/05/2020 13:00,8.47,40822,4193,38,469,3414,52,8166,2.266.071.429
16/05/2020 14:00,8.36,40576,4119,40,469,3440,47,8115,2.266.071.429
16/05/2020 15:00,8.67,40647,4066,40,469,3462,47,8084,2.266.071.429
16/05/2020 16:00,9.12,41156,4278,35,469,3464,45,8291,2.266.071.429
16/05/2020 17:00,10.07,41738,4219,31,464,3294,37,8045,2.266.071.429
16/05/2020 18:00,10.5,41262,3876,28,451,3245,30,7630,2.266.071.429
16/05/2020 19:00,10.49,40489,3572,25,442,3232,36,7307,2.266.071.429
16/05/2020 20:00,10.62,40532,3345,23,429,3210,38,7045,2.266.071.429
16/05/2020 21:00,10.61,40126,3261,20,413,3104,41,6839,2.266.071.429
16/05/2020 22:00,9.77,39092,3208,15,410,3086,43,6762,2.266.071.429
16/05/2020 23:00,9.77,37555,3478,12,431,3066,42,7029,2.266.071.429
17/05/2020 00:00,9.02,36862,3455,14,421,3016,42,6948,2.266.071.429
17/05/2020 01:00,8.47,36529,3557,20,393,2969,41,6980,2.266.071.429
17/05/2020 02:00,8.36,36440,3472,27,379,2975,41,6894,2.266.071.429
17/05/2020 03:00,8.07,36374,3367,36,346,2912,32,6693,2.266.071.429
17/05/2020 04:00,8.06,36372,3380,43,326,2878,29,6656,2.266.071.429
17/05/2020 05:00,8.55,36692,3397,40,335,2696,27,6495,2.266.071.429
17/05/2020 06:00,9.8,37517,3447,32,350,2676,30,6535,2.266.071.429
17/05/2020 07:00,10.23,38643,3492,31,373,2683,37,6616,2.266.071.429
17/05/2020 08:00,9.47,39734,3651,36,389,2733,40,6849,2.266.071.429
17/05/2020 09:00,9.08,40486,3800,47,408,2794,40,7089,2.266.071.429
17/05/2020 10:00,8.67,40718,3981,63,422,2824,39,7329,2.266.071.429
17/05/2020 11:00,9.11,40620,4095,80,441,2870,44,7530,2.266.071.429
17/05/2020 12:00,6.52,40368,4197,94,450,2926,47,7714,2.266.071.429
17/05/2020 13:00,5.3,40080,4217,101,458,2906,49,7731,2.266.071.429
17/05/2020 14:00,5.41,39913,4194,103,458,2951,49,7755,2.266.071.429
17/05/2020 15:00,6.91,40095,4089,100,453,2887,47,7576,2.266.071.429
17/05/2020 16:00,9.68,40775,4241,96,450,2863,43,7693,2.266.071.429
17/05/2020 17:00,12.02,40980,4136,97,444,2719,40,7436,2.266.071.429
17/05/2020 18:00,12.57,40756,3839,101,445,2489,39,6913,2.266.071.429
17/05/2020 19:00,12.93,40473,3625,111,447,2439,44,6666,2.266.071.429
17/05/2020 20:00,13.23,40541,3459,123,449,2404,37,6472,2.266.071.429
17/05/2020 21:00,12.86,39977,3330,133,449,2341,36,6289,2.266.071.429
17/05/2020 22:00,12.17,38619,3070,139,435,2366,21,6031,2.266.071.429
17/05/2020 23:00,12.83,36301,2571,44,424,2506,29,5574,2.266.071.429
18/05/2020 00:00,12.8,35637,2295,46,413,2529,32,5315,2.331.369.048
18/05/2020 01:00,12.72,35432,2152,50,380,2498,26,5106,2.331.369.048
18/05/2020 02:00,12.54,35509,1910,53,340,2442,23,4768,2.331.369.048
18/05/2020 03:00,12.94,35974,1607,53,306,2265,16,4247,2.331.369.048
18/05/2020 04:00,13.67,37351,1380,47,268,2075,11,3781,2.331.369.048
18/05/2020 05:00,14.59,40230,1138,40,244,1709,11,3142,2.331.369.048
18/05/2020 06:00,28.3,43194,898,37,239,1412,17,2603,2.331.369.048
18/05/2020 07:00,19.22,44418,742,38,242,1154,14,2190,2.331.369.048
18/05/2020 08:00,17.58,44491,601,42,250,1083,12,1988,2.331.369.048
18/05/2020 09:00,16.1,44444,537,47,253,1002,11,1850,2.331.369.048
18/05/2020 10:00,15,44187,542,52,258,1066,13,1931,2.331.369.048
18/05/2020 11:00,14.9,43747,583,56,264,1176,12,2091,2.331.369.048
18/05/2020 12:00,14.03,43347,746,56,245,1333,12,2392,2.331.369.048
18/05/2020 13:00,13.48,43052,928,54,235,1410,11,2638,2.331.369.048
18/05/2020 14:00,13.02,42655,1102,48,211,1673,10,3044,2.331.369.048
18/05/2020 15:00,13.46,42315,1293,42,185,1640,8,3168,2.331.369.048
18/05/2020 16:00,14.12,42287,1593,35,156,1608,6,3398,2.331.369.048
18/05/2020 17:00,14.3,41930,1899,28,121,1582,5,3635,2.331.369.048
18/05/2020 18:00,14.55,41497,2068,24,89,1487,6,3674,2.331.369.048
18/05/2020 19:00,14.49,40891,2113,23,73,1518,5,3732,2.331.369.048
18/05/2020 20:00,14.49,40784,2239,27,69,1570,6,3911,2.331.369.048
18/05/2020 21:00,13.93,39980,2408,35,69,1736,7,4255,2.331.369.048
18/05/2020 22:00,13.03,38202,2494,42,69,1821,9,4435,2.331.369.048
18/05/2020 23:00,12.79,36740,1956,43,57,1719,11,3786,2.331.369.048
19/05/2020 00:00,12.64,36003,1946,43,47,1740,13,3789,2.331.369.048
19/05/2020 01:00,12.5,35801,1877,43,40,1749,14,3723,2.331.369.048
19/05/2020 02:00,12.5,35911,1727,46,38,1709,14,3534,2.331.369.048
19/05/2020 03:00,12.63,36176,1658,47,37,1762,14,3518,2.331.369.048
19/05/2020 04:00,13.02,37382,1761,46,34,1668,10,3519,2.331.369.048
19/05/2020 05:00,13.84,40224,1926,48,30,1423,11,3438,2.331.369.048
19/05/2020 06:00,17.49,43077,1895,53,31,1241,9,3229,2.331.369.048
19/05/2020 07:00,17.96,44144,1900,65,33,1123,8,3129,2.331.369.048
19/05/2020 08:00,16.42,44135,1884,81,38,1213,8,3224,2.331.369.048
19/05/2020 09:00,15.65,44040,1968,97,52,1245,10,3372,2.331.369.048
19/05/2020 10:00,14.44,43838,2045,111,70,1445,9,3680,2.331.369.048
19/05/2020 11:00,14.77,43366,2065,119,97,1592,11,3884,2.331.369.048
19/05/2020 12:00,14.54,43118,2050,122,127,1761,11,4071,2.331.369.048
19/05/2020 13:00,14.62,42815,2049,121,146,1783,11,4110,2.331.369.048
19/05/2020 14:00,13.62,42458,1896,115,156,1923,12,4102,2.331.369.048
19/05/2020 15:00,13.18,42177,1758,102,164,1915,12,3951,2.331.369.048
19/05/2020 16:00,13.68,42060,1681,84,162,1905,11,3843,2.331.369.048
19/05/2020 17:00,13.92,41629,1521,68,153,1667,9,3418,2.331.369.048
19/05/2020 18:00,14.88,41295,1288,58,142,1562,7,3057,2.331.369.048
19/05/2020 19:00,14.91,40752,1114,53,133,1612,6,2918,2.331.369.048
19/05/2020 20:00,14.81,40584,1005,51,129,1616,5,2806,2.331.369.048
19/05/2020 21:00,13.57,39770,948,48,126,1613,5,2740,2.331.369.048
19/05/2020 22:00,12.53,37984,917,44,114,1752,6,2833,2.331.369.048
19/05/2020 23:00,12.17,36257,712,32,92,1958,8,2802,2.331.369.048
20/05/2020 00:00,11.64,35487,640,28,84,1987,9,2748,2.331.369.048
20/05/2020 01:00,11.42,35302,585,25,74,2123,10,2817,2.331.369.048
20/05/2020 02:00,11.55,35494,551,22,70,2024,10,2677,2.331.369.048
20/05/2020 03:00,11.76,35750,492,17,70,1955,10,2544,2.331.369.048
20/05/2020 04:00,12.97,36974,458,10,68,1612,12,2160,2.331.369.048
20/05/2020 05:00,15.08,39785,409,6,59,1077,13,1564,2.331.369.048
20/05/2020 06:00,20.99,42515,352,4,54,666,18,1094,2.331.369.048
20/05/2020 07:00,27.75,43466,311,4,63,444,27,849,2.331.369.048
20/05/2020 08:00,17.98,43380,285,3,88,372,35,783,2.331.369.048
20/05/2020 09:00,17.13,43332,267,4,119,386,33,809,2.331.369.048
20/05/2020 10:00,16.06,43103,274,7,155,337,30,803,2.331.369.048
20/05/2020 11:00,15.94,42668,304,11,190,355,33,893,2.331.369.048
20/05/2020 12:00,15.06,42393,327,17,213,356,33,946,2.331.369.048
20/05/2020 13:00,14.29,41966,357,26,238,380,34,1035,2.331.369.048
20/05/2020 14:00,14.1,41554,367,39,250,412,35,1103,2.331.369.048
20/05/2020 15:00,13.62,41266,352,50,261,378,34,1075,2.331.369.048
20/05/2020 16:00,14.09,41266,297,58,259,444,34,1092,2.331.369.048
20/05/2020 17:00,14.93,40931,245,61,239,418,34,997,2.331.369.048
20/05/2020 18:00,15.9,40539,193,61,218,461,28,961,2.331.369.048
20/05/2020 19:00,14.69,40063,158,62,200,443,19,882,2.331.369.048
20/05/2020 20:00,14.93,39837,128,69,190,510,16,913,2.331.369.048
20/05/2020 21:00,13.48,39062,113,78,181,587,16,975,2.331.369.048
20/05/2020 22:00,11.77,37489,95,84,170,578,15,942,2.331.369.048
20/05/2020 23:00,10.67,36058,48,84,171,553,14,870,2.331.369.048
21/05/2020 00:00,9.74,35102,51,83,175,599,16,924,2.331.369.048
21/05/2020 01:00,9.44,34851,60,81,181,564,20,906,2.331.369.048
21/05/2020 02:00,9.4,34520,64,80,195,453,21,813,2.331.369.048
21/05/2020 03:00,9.39,34430,69,79,209,383,21,761,2.331.369.048
21/05/2020 04:00,9.44,34659,74,81,213,279,21,668,2.331.369.048
21/05/2020 05:00,9.44,35415,72,86,216,191,21,586,2.331.369.048
21/05/2020 06:00,10.34,36519,72,88,233,117,24,534,2.331.369.048
21/05/2020 07:00,11.8,37642,82,86,256,92,27,543,2.331.369.048
21/05/2020 08:00,12.03,38611,90,83,277,100,29,579,2.331.369.048
21/05/2020 09:00,12,39193,113,83,304,115,34,649,2.331.369.048
21/05/2020 10:00,11.58,39352,136,87,327,141,34,725,2.331.369.048
21/05/2020 11:00,12.02,39184,158,92,349,167,35,801,2.331.369.048
21/05/2020 12:00,11.01,38837,181,101,361,200,39,882,2.331.369.048
21/05/2020 13:00,9.79,38472,185,105,370,243,41,944,2.331.369.048
21/05/2020 14:00,11.02,38290,208,111,368,316,41,1044,2.331.369.048
21/05/2020 15:00,11.4,38562,213,117,358,465,39,1192,2.331.369.048
21/05/2020 16:00,11.61,38849,213,119,343,556,37,1268,2.331.369.048
21/05/2020 17:00,12.06,39053,251,118,317,639,30,1355,2.331.369.048
21/05/2020 18:00,11.91,38790,319,114,277,867,28,1605,2.331.369.048
21/05/2020 19:00,11.17,38318,386,111,251,1113,18,1879,2.331.369.048
21/05/2020 20:00,10.16,38317,544,105,234,1386,16,2285,2.331.369.048
21/05/2020 21:00,9.69,37894,692,101,224,1601,15,2633,2.331.369.048
21/05/2020 22:00,9.09,36623,804,100,208,1937,12,3061,2.331.369.048
21/05/2020 23:00,8.76,35003,864,131,0,1905,13,2913,2.331.369.048
22/05/2020 00:00,8.47,34260,981,141,0,1963,14,3099,2.331.369.048
22/05/2020 01:00,8.26,34044,1104,152,0,2054,13,3323,2.331.369.048
22/05/2020 02:00,8.03,34064,1267,164,0,2108,14,3553,2.331.369.048
22/05/2020 03:00,7.93,34114,1402,170,0,2128,11,3711,2.331.369.048
22/05/2020 04:00,8.34,35116,1515,172,0,1999,13,3699,2.331.369.048
22/05/2020 05:00,9.97,37077,1711,173,0,1755,10,3649,2.331.369.048
22/05/2020 06:00,12.28,39240,1751,172,0,1496,8,3427,2.331.369.048
22/05/2020 07:00,13.55,40559,1811,173,0,1316,8,3308,2.331.369.048
22/05/2020 08:00,12.92,40914,2043,177,0,1440,6,3666,2.331.369.048
22/05/2020 09:00,12.03,40927,2392,178,0,1593,5,4168,2.331.369.048
22/05/2020 10:00,10.82,40679,2804,175,0,1790,6,4775,2.331.369.048
22/05/2020 11:00,9.02,40249,3119,166,0,2117,5,5407,2.331.369.048
22/05/2020 12:00,8.41,39908,3313,151,0,2352,6,5822,2.331.369.048
22/05/2020 13:00,7.83,39497,3382,135,0,2645,10,6172,2.331.369.048
22/05/2020 14:00,7.57,39086,3484,120,0,2920,8,6532,2.331.369.048
22/05/2020 15:00,7.27,38879,3484,105,0,3284,10,6883,2.331.369.048
22/05/2020 16:00,7.35,38939,3709,90,0,3498,9,7306,2.331.369.048
22/05/2020 17:00,7.54,38961,3709,78,0,3738,8,7533,2.331.369.048
22/05/2020 18:00,7.42,38534,3678,71,0,4063,6,7818,2.331.369.048
22/05/2020 19:00,7.14,37750,3406,68,0,4386,5,7865,2.331.369.048
22/05/2020 20:00,7.19,37352,3059,63,0,4744,4,7870,2.331.369.048
22/05/2020 21:00,7.06,36990,2602,59,0,5076,4,7741,2.331.369.048
22/05/2020 22:00,5.82,35908,2316,54,0,5387,4,7761,2.331.369.048
22/05/2020 23:00,4.26,33979,1930,58,42,5560,4,7594,2.331.369.048
23/05/2020 00:00,4.1,33149,1679,66,32,5618,4,7399,2.331.369.048
23/05/2020 01:00,3.91,32791,1447,71,26,5421,4,6969,2.331.369.048
23/05/2020 02:00,3.84,32642,1286,71,29,5331,5,6722,2.331.369.048
23/05/2020 03:00,3.85,32503,1201,68,34,5122,6,6431,2.331.369.048
23/05/2020 04:00,4,32581,1124,65,38,4955,10,6192,2.331.369.048
23/05/2020 05:00,4.13,33204,1120,66,33,4305,13,5537,2.331.369.048
23/05/2020 06:00,4.03,34322,1127,73,27,3771,9,5007,2.331.369.048
23/05/2020 07:00,5.06,35838,1248,79,24,3492,7,4850,2.331.369.048
23/05/2020 08:00,5.34,37047,1525,88,25,3415,7,5060,2.331.369.048
23/05/2020 09:00,5.33,37736,1857,105,28,3402,9,5401,2.331.369.048
23/05/2020 10:00,4.74,37746,2190,131,32,3660,11,6024,2.331.369.048
23/05/2020 11:00,3.93,37489,2446,152,36,3772,14,6420,2.331.369.048
23/05/2020 12:00,3.62,37231,2763,167,39,3797,16,6782,2.331.369.048
23/05/2020 13:00,1.91,36984,2984,172,49,3944,19,7168,2.331.369.048
23/05/2020 14:00,1.65,36804,3308,170,56,3986,17,7537,2.331.369.048
23/05/2020 15:00,1.74,37007,3487,160,63,4044,17,7771,2.331.369.048
23/05/2020 16:00,2.91,37672,3674,145,70,4184,15,8088,2.331.369.048
23/05/2020 17:00,4.48,37853,3569,124,73,3810,9,7585,2.331.369.048
23/05/2020 18:00,5.06,37441,3255,105,78,3690,9,7137,2.331.369.048
23/05/2020 19:00,5.06,36825,2919,92,85,3575,7,6678,2.331.369.048
23/05/2020 20:00,5.08,36610,2492,87,86,3318,7,5990,2.331.369.048
23/05/2020 21:00,5.03,36274,2228,83,96,3184,8,5599,2.331.369.048
23/05/2020 22:00,4.22,35167,2277,76,93,2957,10,5413,2.331.369.048
23/05/2020 23:00,1.67,33141,3145,54,97,3020,8,6324,2.331.369.048
24/05/2020 00:00,1.46,32364,3185,54,91,2971,7,6308,2.331.369.048
24/05/2020 01:00,0.94,31948,3075,53,83,3013,8,6232,2.331.369.048
24/05/2020 02:00,0.45,31801,3382,53,69,2940,9,6453,2.331.369.048
24/05/2020 03:00,0.21,31554,3304,52,64,2924,8,6352,2.331.369.048
24/05/2020 04:00,0.31,31632,3475,49,54,2693,7,6278,2.331.369.048
24/05/2020 05:00,0.51,32044,3502,44,38,2372,6,5962,2.331.369.048
24/05/2020 06:00,0.59,32958,3334,39,33,2193,5,5604,2.331.369.048
24/05/2020 07:00,1.01,34408,3255,40,32,2186,5,5518,2.331.369.048
24/05/2020 08:00,1.43,35529,3444,47,38,2295,5,5829,2.331.369.048
24/05/2020 09:00,1.49,36273,3545,55,49,2374,5,6028,2.331.369.048
24/05/2020 10:00,1.5,36560,3667,65,69,2381,6,6188,2.331.369.048
24/05/2020 11:00,1.51,36512,3622,76,92,2471,7,6268,2.331.369.048
24/05/2020 12:00,1.49,36315,3647,86,106,2376,7,6222,2.331.369.048
24/05/2020 13:00,1.46,36079,3721,94,104,2258,8,6185,2.331.369.048
24/05/2020 14:00,1.46,35962,3855,97,98,2165,10,6225,2.331.369.048
24/05/2020 15:00,1.55,36251,3949,91,92,2147,10,6289,2.331.369.048
24/05/2020 16:00,2.26,36953,4202,82,85,1824,9,6202,2.331.369.048
24/05/2020 17:00,5.43,37237,4263,72,77,1498,7,5917,2.331.369.048
24/05/2020 18:00,6.22,37122,4074,60,73,1348,6,5561,2.331.369.048
24/05/2020 19:00,7.39,36725,3925,53,70,1146,5,5199,2.331.369.048
24/05/2020 20:00,8.2,36826,3684,46,70,1017,5,4822,2.331.369.048
24/05/2020 21:00,7.98,36341,3594,46,68,931,5,4644,2.331.369.048
24/05/2020 22:00,6.4,35022,3680,45,62,824,6,4617,2.331.369.048
24/05/2020 23:00,5.41,33653,4027,44,41,665,3,4780,2.331.369.048
25/05/2020 00:00,5.26,32970,3776,44,30,524,4,4378,2.739.047.619
25/05/2020 01:00,5.31,32728,3511,43,23,495,3,4075,2.739.047.619
25/05/2020 02:00,5.24,32675,3371,43,18,490,3,3925,2.739.047.619
25/05/2020 03:00,5.32,32959,3117,43,14,450,3,3627,2.739.047.619
25/05/2020 04:00,5.59,34305,3152,40,12,476,2,3682,2.739.047.619
25/05/2020 05:00,8.59,37341,3065,35,10,388,2,3500,2.739.047.619
25/05/2020 06:00,10.43,40270,2768,33,8,322,3,3134,2.739.047.619
25/05/2020 07:00,11.48,41413,2404,34,7,298,2,2745,2.739.047.619
25/05/2020 08:00,11.12,41485,2152,37,7,327,2,2525,2.739.047.619
25/05/2020 09:00,11.05,41452,1891,40,8,332,3,2274,2.739.047.619
25/05/2020 10:00,10.93,41238,1686,41,11,334,4,2076,2.739.047.619
25/05/2020 11:00,10.44,40822,1461,40,15,379,5,1900,2.739.047.619
25/05/2020 12:00,10,40517,1316,37,23,416,7,1799,2.739.047.619
25/05/2020 13:00,9.57,40169,1176,32,33,504,9,1754,2.739.047.619
25/05/2020 14:00,8.86,39834,1029,27,44,536,11,1647,2.739.047.619
25/05/2020 15:00,9.09,39493,898,24,59,497,11,1489,2.739.047.619
25/05/2020 16:00,10.02,39510,856,21,62,427,11,1377,2.739.047.619
25/05/2020 17:00,10.06,39163,837,20,61,408,12,1338,2.739.047.619
25/05/2020 18:00,10.05,38631,716,21,66,385,10,1198,2.739.047.619
25/05/2020 19:00,10.05,37920,609,23,69,316,6,1023,2.739.047.619
25/05/2020 20:00,10.32,37607,452,24,78,317,4,875,2.739.047.619
25/05/2020 21:00,9.9,36922,310,21,87,329,7,754,2.739.047.619
25/05/2020 22:00,8,35249,261,18,84,352,9,724,2.739.047.619
25/05/2020 23:00,4.33,33375,250,11,108,347,7,723,2.739.047.619
26/05/2020 00:00,4.17,32595,184,12,112,358,6,672,2.739.047.619
26/05/2020 01:00,4.11,32364,142,11,104,416,5,678,2.739.047.619
26/05/2020 02:00,4.06,32368,134,10,93,426,5,668,2.739.047.619
26/05/2020 03:00,4.04,32535,121,9,85,514,5,734,2.739.047.619
26/05/2020 04:00,4.39,33811,116,7,67,604,6,800,2.739.047.619
26/05/2020 05:00,5.35,36733,83,6,37,554,4,684,2.739.047.619
26/05/2020 06:00,7.97,39608,61,6,20,508,2,597,2.739.047.619
26/05/2020 07:00,8.22,40623,57,7,16,531,2,613,2.739.047.619
26/05/2020 08:00,7.33,40501,60,10,23,613,2,708,2.739.047.619
26/05/2020 09:00,6.65,40432,67,14,32,820,2,935,2.739.047.619
26/05/2020 10:00,5.96,40212,82,19,38,1125,3,1267,2.739.047.619
26/05/2020 11:00,5.85,39823,134,25,45,1403,5,1612,2.739.047.619
26/05/2020 12:00,5.41,39665,202,30,55,1701,5,1993,2.739.047.619
26/05/2020 13:00,5.25,39286,298,34,59,1911,6,2308,2.739.047.619
26/05/2020 14:00,4.56,38985,404,33,61,2036,5,2539,2.739.047.619
26/05/2020 15:00,4.32,38724,486,30,70,2093,7,2686,2.739.047.619
26/05/2020 16:00,4.23,38636,543,26,80,2129,8,2786,2.739.047.619
26/05/2020 17:00,4.33,38278,514,24,83,2135,7,2763,2.739.047.619
26/05/2020 18:00,4.14,37883,465,24,86,2178,6,2759,2.739.047.619
26/05/2020 19:00,4.05,37303,436,26,93,2280,4,2839,2.739.047.619
26/05/2020 20:00,4,37003,387,26,106,2381,4,2904,2.739.047.619
26/05/2020 21:00,3.57,36184,340,26,105,2421,4,2896,2.739.047.619
26/05/2020 22:00,2.16,34459,373,24,90,2559,3,3049,2.739.047.619
26/05/2020 23:00,2.17,32844,370,28,81,2610,2,3091,2.739.047.619
27/05/2020 00:00,1.97,32045,385,25,69,2592,2,3073,2.739.047.619
27/05/2020 01:00,1.92,31747,383,22,59,2783,2,3249,2.739.047.619
27/05/2020 02:00,1.88,31735,418,18,45,2582,2,3065,2.739.047.619
27/05/2020 03:00,1.94,31920,464,13,38,2472,2,2989,2.739.047.619
27/05/2020 04:00,2.96,33224,601,9,34,2347,2,2993,2.739.047.619
27/05/2020 05:00,4.07,36160,810,5,27,2301,2,3145,2.739.047.619
27/05/2020 06:00,6.06,38957,1028,3,19,2160,2,3212,2.739.047.619
27/05/2020 07:00,6.99,40080,1173,3,19,1978,2,3175,2.739.047.619
27/05/2020 08:00,6.47,40084,1439,4,32,1946,2,3423,2.739.047.619
27/05/2020 09:00,6.06,40198,1630,6,57,1982,3,3678,2.739.047.619
27/05/2020 10:00,6.23,40068,1830,8,80,2020,3,3941,2.739.047.619
27/05/2020 11:00,5.81,39831,2025,12,100,2095,3,4235,2.739.047.619
27/05/2020 12:00,5.16,39609,2231,13,101,2179,6,4530,2.739.047.619
27/05/2020 13:00,4.92,39339,2392,15,113,2322,5,4847,2.739.047.619
27/05/2020 14:00,4.22,39056,2535,15,127,2478,7,5162,2.739.047.619
27/05/2020 15:00,3.44,38825,2611,15,140,2768,10,5544,2.739.047.619
27/05/2020 16:00,3.42,38890,2807,15,136,2991,10,5959,2.739.047.619
27/05/2020 17:00,4.63,38571,2886,16,110,3054,10,6076,2.739.047.619
27/05/2020 18:00,4.72,38228,2833,17,88,3040,6,5984,2.739.047.619
27/05/2020 19:00,4.58,37628,2759,19,76,3031,4,5889,2.739.047.619
27/05/2020 20:00,4.54,37228,2590,19,69,3272,3,5953,2.739.047.619
27/05/2020 21:00,3.56,36444,2398,18,61,3544,3,6024,2.739.047.619
27/05/2020 22:00,2.87,34834,2472,15,64,3547,2,6100,2.739.047.619
27/05/2020 23:00,1.98,33046,2466,26,55,3576,2,6125,2.739.047.619
28/05/2020 00:00,1.85,32309,2283,26,48,3555,2,5914,2.739.047.619
28/05/2020 01:00,1.81,32022,2084,25,42,3505,4,5660,2.739.047.619
28/05/2020 02:00,1.86,31981,1995,23,38,3332,4,5392,2.739.047.619
28/05/2020 03:00,1.95,32172,1863,19,34,3172,5,5093,2.739.047.619
28/05/2020 04:00,2.75,33438,1864,12,28,2953,9,4866,2.739.047.619
28/05/2020 05:00,4.18,36167,1774,7,19,2496,10,4306,2.739.047.619
28/05/2020 06:00,5.07,38925,1607,4,19,2187,12,3829,2.739.047.619
28/05/2020 07:00,5.01,40091,1426,3,21,2010,12,3472,2.739.047.619
28/05/2020 08:00,4.95,40211,1354,5,25,1988,12,3384,2.739.047.619
28/05/2020 09:00,4.7,40365,1253,8,32,2186,14,3493,2.739.047.619
28/05/2020 10:00,4.38,40210,1161,13,39,2311,14,3538,2.739.047.619
28/05/2020 11:00,4.32,39908,1120,17,56,2513,21,3727,2.739.047.619
28/05/2020 12:00,4.21,39681,1108,22,62,2621,29,3842,2.739.047.619
28/05/2020 13:00,4.11,39345,1052,24,82,2731,34,3923,2.739.047.619
28/05/2020 14:00,3.94,39043,991,25,105,2782,37,3940,2.739.047.619
28/05/2020 15:00,3.19,38865,902,25,132,2793,43,3895,2.739.047.619
28/05/2020 16:00,4.09,38870,873,22,156,2753,42,3846,2.739.047.619
28/05/2020 17:00,4.87,38585,799,19,174,2696,38,3726,2.739.047.619
28/05/2020 18:00,4.93,38254,729,15,189,2601,30,3564,2.739.047.619
28/05/2020 19:00,4.65,37698,689,13,206,2392,21,3321,2.739.047.619
28/05/2020 20:00,4.61,37279,571,13,228,2304,18,3134,2.739.047.619
28/05/2020 21:00,4.32,36501,443,13,246,2370,14,3086,2.739.047.619
28/05/2020 22:00,3.27,34965,395,13,244,2366,15,3033,2.739.047.619
28/05/2020 23:00,2.72,33486,331,25,213,2361,16,2946,2.739.047.619
29/05/2020 00:00,2.41,32525,275,32,215,2429,18,2969,2.739.047.619
29/05/2020 01:00,2.26,32093,234,40,219,2459,20,2972,2.739.047.619
29/05/2020 02:00,2.31,32118,219,49,225,2446,22,2961,2.739.047.619
29/05/2020 03:00,2.42,32418,209,53,231,2350,22,2865,2.739.047.619
29/05/2020 04:00,3.4,33736,212,50,233,2237,22,2754,2.739.047.619
29/05/2020 05:00,4.58,36562,183,43,222,2066,22,2536,2.739.047.619
29/05/2020 06:00,6.81,39454,145,36,221,2054,35,2491,2.739.047.619
29/05/2020 07:00,6.96,40806,142,33,228,2053,32,2488,2.739.047.619
29/05/2020 08:00,5.96,40999,145,34,236,2005,27,2447,2.739.047.619
29/05/2020 09:00,5.27,41117,179,41,250,2079,26,2575,2.739.047.619
29/05/2020 10:00,4.77,40874,217,55,260,2160,27,2719,2.739.047.619
29/05/2020 11:00,4.56,40342,256,74,264,2277,31,2902,2.739.047.619
29/05/2020 12:00,4.33,39763,320,93,271,2341,38,3063,2.739.047.619
29/05/2020 13:00,4.1,39129,380,109,280,2392,42,3203,2.739.047.619
29/05/2020 14:00,3.93,38597,432,121,281,2427,45,3306,2.739.047.619
29/05/2020 15:00,3.96,38297,480,129,286,2334,44,3273,2.739.047.619
29/05/2020 16:00,4.16,38241,509,126,288,2295,39,3257,2.739.047.619
29/05/2020 17:00,4.28,38064,592,119,289,2204,35,3239,2.739.047.619
29/05/2020 18:00,4.32,37486,611,108,286,1996,25,3026,2.739.047.619
29/05/2020 19:00,4.01,36571,623,102,296,1983,18,3022,2.739.047.619
29/05/2020 20:00,3.88,35988,667,100,306,2057,17,3147,2.739.047.619
29/05/2020 21:00,3.42,35346,723,99,321,1999,18,3160,2.739.047.619
29/05/2020 22:00,2.74,34089,614,95,316,2068,19,3112,2.739.047.619
29/05/2020 23:00,3.4,32626,455,15,263,2035,14,2782,2.739.047.619
30/05/2020 00:00,3.03,31765,427,18,258,2174,13,2890,2.739.047.619
30/05/2020 01:00,2.36,31334,382,18,251,2242,13,2906,2.739.047.619
30/05/2020 02:00,2.29,31010,335,17,243,2257,14,2866,2.739.047.619
30/05/2020 03:00,2.24,30749,300,18,237,2333,15,2903,2.739.047.619
30/05/2020 04:00,2.46,31009,305,20,223,1980,13,2541,2.739.047.619
30/05/2020 05:00,3.07,31797,280,17,210,1533,9,2049,2.739.047.619
30/05/2020 06:00,3.3,33013,256,13,203,1016,5,1493,2.739.047.619
30/05/2020 07:00,4.04,34554,251,12,225,883,6,1377,2.739.047.619
30/05/2020 08:00,4.27,35756,294,12,271,943,9,1529,2.739.047.619
30/05/2020 09:00,4.46,36372,342,13,315,1064,20,1754,2.739.047.619
30/05/2020 10:00,4.27,36268,421,15,344,1190,30,2000,2.739.047.619
30/05/2020 11:00,4.13,35923,542,16,361,1252,35,2206,2.739.047.619
30/05/2020 12:00,3.4,35566,704,19,374,1442,40,2579,2.739.047.619
30/05/2020 13:00,2.28,35125,827,22,385,1428,40,2702,2.739.047.619
30/05/2020 14:00,2.11,34956,953,22,399,1520,43,2937,2.739.047.619
30/05/2020 15:00,2.99,35162,1082,20,405,1524,44,3075,2.739.047.619
30/05/2020 16:00,3.25,35739,1180,19,406,1535,43,3183,2.739.047.619
30/05/2020 17:00,3.9,35834,1176,19,406,1479,44,3124,2.739.047.619
30/05/2020 18:00,3.96,35353,1000,23,409,1394,42,2868,2.739.047.619
30/05/2020 19:00,3.56,34652,862,31,411,1358,42,2704,2.739.047.619
30/05/2020 20:00,3.39,34396,717,48,415,1436,38,2654,2.739.047.619
30/05/2020 21:00,2.58,34164,655,68,419,1509,35,2686,2.739.047.619
30/05/2020 22:00,1.94,33076,668,78,425,1639,38,2848,2.739.047.619
30/05/2020 23:00,2.22,31135,879,85,433,1756,33,3186,2.739.047.619
31/05/2020 00:00,2.1,30340,736,84,436,2113,33,3402,2.739.047.619
31/05/2020 01:00,1.98,29815,663,77,429,2031,33,3233,2.739.047.619
31/05/2020 02:00,1.92,29568,677,66,424,2046,33,3246,2.739.047.619
31/05/2020 03:00,1.77,29220,700,54,419,2057,29,3259,2.739.047.619
31/05/2020 04:00,1.91,29261,829,42,419,2045,29,3364,2.739.047.619
31/05/2020 05:00,1.96,29720,941,30,419,1724,31,3145,2.739.047.619
31/05/2020 06:00,2.21,30669,976,20,419,1482,37,2934,2.739.047.619
31/05/2020 07:00,2.24,32036,1002,16,424,1336,41,2819,2.739.047.619
31/05/2020 08:00,1.77,33201,1095,15,433,1340,44,2927,2.739.047.619
31/05/2020 09:00,1.41,33906,1102,16,442,1448,46,3054,2.739.047.619
31/05/2020 10:00,1.31,34188,1157,16,444,1495,47,3159,2.739.047.619
31/05/2020 11:00,0.92,34127,1310,17,442,1471,47,3287,2.739.047.619
31/05/2020 12:00,0.81,33826,1445,17,436,1453,46,3397,2.739.047.619
31/05/2020 13:00,0.75,33562,1492,18,428,1394,46,3378,2.739.047.619
31/05/2020 14:00,0.72,33458,1546,20,422,1310,46,3344,2.739.047.619
31/05/2020 15:00,0.85,33752,1510,22,418,1214,46,3210,2.739.047.619
31/05/2020 16:00,1.46,34284,1364,20,408,1144,45,2981,2.739.047.619
31/05/2020 17:00,2.24,34517,1097,17,395,1066,45,2620,2.739.047.619
31/05/2020 18:00,2.74,34397,863,17,383,957,44,2264,2.739.047.619
31/05/2020 19:00,3.46,34032,744,17,367,989,33,2150,2.739.047.619
31/05/2020 20:00,3.8,34006,713,17,352,899,23,2004,2.739.047.619
31/05/2020 21:00,3.42,33749,731,18,339,935,18,2041,2.739.047.619
31/05/2020 22:00,2.39,32395,810,19,314,956,16,2115,2.739.047.619
31/05/2020 23:00,2.63,30919,744,92,285,891,15,2027,2.739.047.619
01/06/2020 00:00,2.47,30313,691,88,260,881,15,1935,3.474.107.143
01/06/2020 01:00,2.51,30116,572,83,242,824,13,1734,3.474.107.143
01/06/2020 02:00,2.5,30024,525,78,223,611,11,1448,3.474.107.143
01/06/2020 03:00,2.4,30065,404,68,204,555,13,1244,3.474.107.143
01/06/2020 04:00,3,31119,352,54,187,525,10,1128,3.474.107.143
01/06/2020 05:00,3.8,33153,293,40,171,367,7,878,3.474.107.143
01/06/2020 06:00,4.19,35075,239,30,166,280,4,719,3.474.107.143
01/06/2020 07:00,4.27,36272,219,27,176,225,7,654,3.474.107.143
01/06/2020 08:00,4.29,36961,236,28,190,199,12,665,3.474.107.143
01/06/2020 09:00,3.72,37362,250,32,210,237,15,744,3.474.107.143
01/06/2020 10:00,2.82,37482,275,39,226,290,17,847,3.474.107.143
01/06/2020 11:00,3.49,37238,337,47,244,329,23,980,3.474.107.143
01/06/2020 12:00,2.35,36852,369,55,256,342,26,1048,3.474.107.143
01/06/2020 13:00,2.05,36556,369,62,264,382,29,1106,3.474.107.143
01/06/2020 14:00,1.93,36353,403,66,262,402,33,1166,3.474.107.143
01/06/2020 15:00,2.27,36233,413,67,266,494,33,1273,3.474.107.143
01/06/2020 16:00,3.96,36326,360,63,260,500,34,1217,3.474.107.143
01/06/2020 17:00,4.18,36221,286,57,236,492,31,1102,3.474.107.143
01/06/2020 18:00,4.46,35767,251,50,214,551,21,1087,3.474.107.143
01/06/2020 19:00,4.19,35156,229,46,201,734,20,1230,3.474.107.143
01/06/2020 20:00,4.4,34844,231,46,194,1018,15,1504,3.474.107.143
01/06/2020 21:00,4.18,34216,215,49,187,1196,10,1657,3.474.107.143
01/06/2020 22:00,3.16,32795,181,54,175,1283,8,1701,3.474.107.143
01/06/2020 23:00,3.08,30939,178,38,199,1277,9,1701,3.474.107.143
02/06/2020 00:00,2.38,30102,194,36,177,1322,9,1738,3.474.107.143
02/06/2020 01:00,2.26,29841,162,32,165,1403,9,1771,3.474.107.143
02/06/2020 02:00,2.26,29724,143,28,163,1383,9,1726,3.474.107.143
02/06/2020 03:00,2.28,29834,144,29,159,1228,9,1569,3.474.107.143
02/06/2020 04:00,3.32,31203,162,30,145,1048,8,1393,3.474.107.143
02/06/2020 05:00,3.34,33965,149,29,118,626,5,927,3.474.107.143
02/06/2020 06:00,4.56,36797,139,28,102,430,4,703,3.474.107.143
02/06/2020 07:00,6.05,37972,163,28,106,505,4,806,3.474.107.143
02/06/2020 08:00,4.68,38084,196,31,127,334,5,693,3.474.107.143
02/06/2020 09:00,4.5,38221,241,36,144,388,7,816,3.474.107.143
02/06/2020 10:00,4.09,38244,278,44,146,517,7,992,3.474.107.143
02/06/2020 11:00,4.06,38043,299,50,151,622,9,1131,3.474.107.143
02/06/2020 12:00,3.61,37826,318,55,144,772,16,1305,3.474.107.143
02/06/2020 13:00,3.41,37577,343,55,150,907,22,1477,3.474.107.143
02/06/2020 14:00,3.12,37300,350,53,155,921,20,1499,3.474.107.143
02/06/2020 15:00,2.85,37136,358,50,159,1069,17,1653,3.474.107.143
02/06/2020 16:00,2.89,37027,359,46,162,1061,15,1643,3.474.107.143
02/06/2020 17:00,3.2,36572,350,41,157,1145,13,1706,3.474.107.143
02/06/2020 18:00,3.86,36204,328,37,159,1109,12,1645,3.474.107.143
02/06/2020 19:00,3.8,35650,305,35,167,1414,9,1930,3.474.107.143
02/06/2020 20:00,3.71,35264,333,34,176,1467,6,2016,3.474.107.143
02/06/2020 21:00,3.34,34464,402,35,184,1726,7,2354,3.474.107.143
02/06/2020 22:00,2.43,32857,470,35,184,1506,11,2206,3.474.107.143
02/06/2020 23:00,2.56,31366,473,51,192,1369,10,2095,3.474.107.143
03/06/2020 00:00,2.32,30372,501,53,174,1256,9,1993,3.474.107.143
03/06/2020 01:00,2.28,29976,471,54,162,1096,8,1791,3.474.107.143
03/06/2020 02:00,2.29,29870,492,56,152,1064,8,1772,3.474.107.143
03/06/2020 03:00,2.32,30002,528,53,141,975,8,1705,3.474.107.143
03/06/2020 04:00,3.07,31377,534,47,118,830,10,1539,3.474.107.143
03/06/2020 05:00,3.59,34619,490,41,91,685,6,1313,3.474.107.143
03/06/2020 06:00,5.1,37894,458,42,76,627,3,1206,3.474.107.143
03/06/2020 07:00,5.14,39307,441,47,77,588,2,1155,3.474.107.143
03/06/2020 08:00,4.9,39472,452,52,89,553,3,1149,3.474.107.143
03/06/2020 09:00,4.76,39654,511,57,95,552,5,1220,3.474.107.143
03/06/2020 10:00,4.55,39527,578,62,96,589,8,1333,3.474.107.143
03/06/2020 11:00,4.41,39309,673,69,87,673,7,1509,3.474.107.143
03/06/2020 12:00,4.19,39086,833,74,71,757,8,1743,3.474.107.143
03/06/2020 13:00,4.02,38748,1024,75,65,751,9,1924,3.474.107.143
03/06/2020 14:00,3.76,38405,1165,75,60,879,12,2191,3.474.107.143
03/06/2020 15:00,3.43,38063,1263,72,61,928,13,2337,3.474.107.143
03/06/2020 16:00,3.81,38095,1383,67,63,1070,12,2595,3.474.107.143
03/06/2020 17:00,3.84,37655,1489,62,64,1046,12,2673,3.474.107.143
03/06/2020 18:00,4.29,37220,1487,60,67,1211,11,2836,3.474.107.143
03/06/2020 19:00,4.09,36576,1459,62,74,1364,6,2965,3.474.107.143
03/06/2020 20:00,4.21,36134,1485,65,84,1622,4,3260,3.474.107.143
03/06/2020 21:00,3.66,35310,1636,67,98,1949,3,3753,3.474.107.143
03/06/2020 22:00,3.03,33574,1769,68,106,2093,3,4039,3.474.107.143
03/06/2020 23:00,4.01,31832,1473,72,93,2158,4,3800,3.474.107.143
04/06/2020 00:00,3.36,30978,1451,69,90,2021,4,3635,3.474.107.143
04/06/2020 01:00,3.26,30566,1329,64,77,1816,4,3290,3.474.107.143
04/06/2020 02:00,3.28,30415,1361,59,69,1750,5,3244,3.474.107.143
04/06/2020 03:00,3.29,30515,1414,52,67,1715,5,3253,3.474.107.143
04/06/2020 04:00,4.45,31888,1539,41,56,1636,4,3276,3.474.107.143
04/06/2020 05:00,4.79,35060,1646,32,32,1387,3,3100,3.474.107.143
04/06/2020 06:00,7,38232,1804,30,20,1305,3,3162,3.474.107.143
04/06/2020 07:00,8.1,39559,2015,34,16,1180,3,3248,3.474.107.143
04/06/2020 08:00,7.82,39758,2291,45,16,1477,3,3832,3.474.107.143
04/06/2020 09:00,7.03,39925,2499,58,20,1897,3,4477,3.474.107.143
04/06/2020 10:00,6.37,39815,2640,71,18,2376,3,5108,3.474.107.143
04/06/2020 11:00,5.91,39404,2710,80,14,2591,3,5398,3.474.107.143
04/06/2020 12:00,5.08,39250,2727,87,12,2829,3,5658,3.474.107.143
04/06/2020 13:00,4.79,39061,2888,90,14,2805,5,5802,3.474.107.143
04/06/2020 14:00,4.45,38785,2934,90,17,2725,5,5771,3.474.107.143
04/06/2020 15:00,4.33,38480,2845,88,22,2763,5,5723,3.474.107.143
04/06/2020 16:00,4.42,38504,2889,81,24,2742,6,5742,3.474.107.143
04/06/2020 17:00,4.22,38127,3064,71,22,2735,5,5897,3.474.107.143
04/06/2020 18:00,4.37,37632,2815,61,21,2651,4,5552,3.474.107.143
04/06/2020 19:00,3.53,36923,2399,54,22,2635,3,5113,3.474.107.143
04/06/2020 20:00,3.49,36467,2452,50,24,2784,3,5313,3.474.107.143
04/06/2020 21:00,2.67,35596,2715,49,25,2989,6,5784,3.474.107.143
04/06/2020 22:00,2,33899,2803,47,26,2987,5,5868,3.474.107.143
04/06/2020 23:00,1.97,32800,3121,52,33,2978,5,6189,3.474.107.143
05/06/2020 00:00,1.67,31809,3247,48,43,3043,4,6385,3.474.107.143
05/06/2020 01:00,1.52,31315,3073,43,48,3051,4,6219,3.474.107.143
05/06/2020 02:00,1.49,31054,3005,40,56,3002,4,6107,3.474.107.143
05/06/2020 03:00,1.51,31097,2861,37,72,2987,4,5961,3.474.107.143
05/06/2020 04:00,1.99,32289,2891,34,76,2918,4,5923,3.474.107.143
05/06/2020 05:00,2.97,35226,2745,32,66,2626,3,5472,3.474.107.143
05/06/2020 06:00,4.46,38226,2435,32,58,2446,3,4974,3.474.107.143
05/06/2020 07:00,5.01,39746,2324,35,90,2391,3,4843,3.474.107.143
05/06/2020 08:00,4.85,40164,2272,42,149,2511,4,4978,3.474.107.143
05/06/2020 09:00,4.38,40368,2202,49,199,2625,5,5080,3.474.107.143
05/06/2020 10:00,4.24,40236,2078,53,238,2968,10,5347,3.474.107.143
05/06/2020 11:00,3.44,39842,2025,55,268,3026,11,5385,3.474.107.143
05/06/2020 12:00,3.27,39307,1856,57,282,3159,15,5369,3.474.107.143
05/06/2020 13:00,3.08,38793,1715,60,295,3114,17,5201,3.474.107.143
05/06/2020 14:00,2.42,38282,1414,60,295,2832,18,4619,3.474.107.143
05/06/2020 15:00,2.49,38017,1131,58,292,2887,22,4390,3.474.107.143
05/06/2020 16:00,2.57,38117,844,54,292,2452,25,3667,3.474.107.143
05/06/2020 17:00,2.81,37974,566,47,294,2188,24,3119,3.474.107.143
05/06/2020 18:00,2.81,37315,409,42,299,1879,21,2650,3.474.107.143
05/06/2020 19:00,2.79,36382,424,39,293,1645,24,2425,3.474.107.143
05/06/2020 20:00,2.78,35641,483,36,276,1450,20,2265,3.474.107.143
05/06/2020 21:00,2.61,35135,620,33,248,1272,21,2194,3.474.107.143
05/06/2020 22:00,2.35,33861,762,30,213,1240,23,2268,3.474.107.143
05/06/2020 23:00,2.1,32571,1522,70,125,1295,16,3028,3.474.107.143
06/06/2020 00:00,1.48,31598,1899,80,99,1525,12,3615,3.474.107.143
06/06/2020 01:00,1.41,31028,1951,85,81,1573,3,3693,3.474.107.143
06/06/2020 02:00,1.35,30670,2255,85,78,1641,3,4062,3.474.107.143
06/06/2020 03:00,1.42,30402,2479,80,89,1784,3,4435,3.474.107.143
06/06/2020 04:00,1.39,30661,2627,73,115,1905,4,4724,3.474.107.143
06/06/2020 05:00,1.41,31440,2545,66,166,2025,6,4808,3.474.107.143
06/06/2020 06:00,1.61,32617,2223,64,228,2154,8,4677,3.474.107.143
06/06/2020 07:00,2.01,34238,2182,70,301,2330,12,4895,3.474.107.143
06/06/2020 08:00,2.25,35665,2315,83,363,2468,16,5245,3.474.107.143
06/06/2020 09:00,2.08,36411,2539,97,406,2917,25,5984,3.474.107.143
06/06/2020 10:00,1.69,36450,2790,110,421,3076,32,6429,3.474.107.143
06/06/2020 11:00,1.44,36295,3062,119,405,3270,45,6901,3.474.107.143
06/06/2020 12:00,1.03,36004,3242,126,375,3575,45,7363,3.474.107.143
06/06/2020 13:00,0.78,35644,3469,131,340,3829,46,7815,3.474.107.143
06/06/2020 14:00,1.38,35575,3484,136,293,4030,44,7987,3.474.107.143
06/06/2020 15:00,1.45,35795,3361,139,231,4158,38,7927,3.474.107.143
06/06/2020 16:00,2.11,36451,3192,138,178,4129,35,7672,3.474.107.143
06/06/2020 17:00,2.49,36535,2955,133,138,3872,28,7126,3.474.107.143
06/06/2020 18:00,2.54,36004,2438,129,104,3715,17,6403,3.474.107.143
06/06/2020 19:00,2.39,35195,1989,131,94,3574,11,5799,3.474.107.143
06/06/2020 20:00,2.29,34796,1643,136,96,3629,11,5515,3.474.107.143
06/06/2020 21:00,2.1,34455,1490,141,119,3589,12,5351,3.474.107.143
06/06/2020 22:00,1.82,33401,1547,145,133,3673,13,5511,3.474.107.143
06/06/2020 23:00,2.04,32176,1739,150,75,3891,8,5863,3.474.107.143
07/06/2020 00:00,1.89,31278,1779,152,79,3999,6,6015,3.474.107.143
07/06/2020 01:00,1.52,30664,1708,152,76,4067,5,6008,3.474.107.143
07/06/2020 02:00,1.49,30292,1692,151,76,4096,4,6019,3.474.107.143
07/06/2020 03:00,1.47,29877,1599,146,79,4143,4,5971,3.474.107.143
07/06/2020 04:00,1.48,29916,1540,138,78,4221,6,5983,3.474.107.143
07/06/2020 05:00,1.49,30458,1392,133,70,4340,7,5942,3.474.107.143
07/06/2020 06:00,1.51,31549,1231,132,59,4443,4,5869,3.474.107.143
07/06/2020 07:00,1.83,33012,1263,137,56,4448,4,5908,3.474.107.143
07/06/2020 08:00,1.98,34325,1235,142,50,4618,4,6049,3.474.107.143
07/06/2020 09:00,2.13,35198,1179,146,51,4630,6,6012,3.474.107.143
07/06/2020 10:00,2.12,35511,1065,147,54,4754,7,6027,3.474.107.143
07/06/2020 11:00,2.12,35431,951,139,54,4690,9,5843,3.474.107.143
07/06/2020 12:00,2.03,35233,850,126,59,4884,4,5923,3.474.107.143
07/06/2020 13:00,2,35022,830,110,64,4722,3,5729,3.474.107.143
07/06/2020 14:00,2.13,34931,712,96,55,4490,3,5356,3.474.107.143
07/06/2020 15:00,2.19,35268,578,84,51,4180,2,4895,3.474.107.143
07/06/2020 16:00,2.4,35934,501,71,50,3780,2,4404,3.474.107.143
07/06/2020 17:00,2.65,36311,419,55,47,3491,2,4014,3.474.107.143
07/06/2020 18:00,2.81,36186,326,47,42,3086,2,3503,3.474.107.143
07/06/2020 19:00,2.88,35621,336,41,43,2665,2,3087,3.474.107.143
07/06/2020 20:00,2.91,35399,370,38,41,2477,2,2928,3.474.107.143
07/06/2020 21:00,2.87,34958,386,34,50,2360,2,2832,3.474.107.143
07/06/2020 22:00,2.51,33683,359,31,54,2169,2,2615,3.474.107.143
07/06/2020 23:00,1.66,32731,321,29,58,2106,2,2516,3.474.107.143
08/06/2020 00:00,1.51,31825,314,33,52,2007,2,2408,4.178.333.333
08/06/2020 01:00,1.51,31487,346,35,57,1856,4,2298,4.178.333.333
08/06/2020 02:00,1.55,31316,354,35,61,1772,5,2227,4.178.333.333
08/06/2020 03:00,1.74,31467,301,34,51,1600,4,1990,4.178.333.333
08/06/2020 04:00,2.21,32964,259,31,43,1142,4,1479,4.178.333.333
08/06/2020 05:00,3.74,36185,184,26,37,846,4,1097,4.178.333.333
08/06/2020 06:00,5.54,39265,132,23,34,742,5,936,4.178.333.333
08/06/2020 07:00,6.8,40540,136,24,32,753,3,948,4.178.333.333
08/06/2020 08:00,6.28,40885,177,29,29,799,3,1037,4.178.333.333
08/06/2020 09:00,6.37,41122,246,35,29,820,3,1133,4.178.333.333
08/06/2020 10:00,6.09,41108,308,38,30,893,3,1272,4.178.333.333
08/06/2020 11:00,5.52,40878,390,38,33,975,2,1438,4.178.333.333
08/06/2020 12:00,5.49,40645,455,34,34,878,3,1404,4.178.333.333
08/06/2020 13:00,5.04,40328,558,28,37,889,3,1515,4.178.333.333
08/06/2020 14:00,4.85,39968,612,20,38,878,3,1551,4.178.333.333
08/06/2020 15:00,4.65,39697,643,15,44,908,3,1613,4.178.333.333
08/06/2020 16:00,4.75,39653,589,14,49,903,2,1557,4.178.333.333
08/06/2020 17:00,5.02,39328,566,18,50,863,3,1500,4.178.333.333
08/06/2020 18:00,5.06,38784,496,30,51,875,4,1456,4.178.333.333
08/06/2020 19:00,4.94,37896,433,49,56,897,3,1438,4.178.333.333
08/06/2020 20:00,4.84,37320,367,73,57,937,3,1437,4.178.333.333
08/06/2020 21:00,4.57,36493,327,94,61,1121,4,1607,4.178.333.333
08/06/2020 22:00,2.88,34815,307,106,63,1237,4,1717,4.178.333.333
08/06/2020 23:00,2.45,33060,338,15,68,1263,7,1691,4.178.333.333
09/06/2020 00:00,2.02,32099,334,16,57,1444,6,1857,4.178.333.333
09/06/2020 01:00,1.89,31725,314,16,50,1503,8,1891,4.178.333.333
09/06/2020 02:00,1.91,31532,318,16,45,1363,8,1750,4.178.333.333
09/06/2020 03:00,1.97,31612,340,14,42,1201,7,1604,4.178.333.333
09/06/2020 04:00,2.65,33139,371,11,35,904,7,1328,4.178.333.333
09/06/2020 05:00,4.08,36354,326,9,28,724,5,1092,4.178.333.333
09/06/2020 06:00,5.15,39597,280,6,21,464,5,776,4.178.333.333
09/06/2020 07:00,6.27,40946,268,6,19,326,5,624,4.178.333.333
09/06/2020 08:00,6.07,41037,269,8,18,269,6,570,4.178.333.333
09/06/2020 09:00,6.14,41190,264,12,18,217,5,516,4.178.333.333
09/06/2020 10:00,5.95,41093,276,17,19,218,5,535,4.178.333.333
09/06/2020 11:00,5.79,40688,303,23,18,228,5,577,4.178.333.333
09/06/2020 12:00,5.16,40589,328,27,16,259,5,635,4.178.333.333
09/06/2020 13:00,5.04,40347,347,31,19,307,5,709,4.178.333.333
09/06/2020 14:00,4.83,39967,329,35,25,329,5,723,4.178.333.333
09/06/2020 15:00,4.65,39659,325,37,31,380,5,778,4.178.333.333
09/06/2020 16:00,4.59,39532,287,39,33,393,6,758,4.178.333.333
09/06/2020 17:00,4.9,38962,274,37,35,422,5,773,4.178.333.333
09/06/2020 18:00,4.67,38471,250,39,36,439,5,769,4.178.333.333
09/06/2020 19:00,4.8,37689,212,42,41,438,4,737,4.178.333.333
09/06/2020 20:00,4.56,37100,174,45,51,533,4,807,4.178.333.333
09/06/2020 21:00,3.68,36146,145,45,61,601,4,856,4.178.333.333
09/06/2020 22:00,2.78,34358,125,43,63,721,5,957,4.178.333.333
09/06/2020 23:00,2.63,32732,136,49,68,749,7,1009,4.178.333.333
10/06/2020 00:00,2.23,31749,156,48,76,704,9,993,4.178.333.333
10/06/2020 01:00,2.06,31244,148,45,77,702,7,979,4.178.333.333
10/06/2020 02:00,2.02,31094,144,43,77,624,7,895,4.178.333.333
10/06/2020 03:00,2.14,31218,139,39,76,638,6,898,4.178.333.333
10/06/2020 04:00,2.85,32649,150,33,72,531,6,792,4.178.333.333
10/06/2020 05:00,4.18,35800,150,26,66,445,8,695,4.178.333.333
10/06/2020 06:00,5.11,38952,145,21,64,322,8,560,4.178.333.333
10/06/2020 07:00,6.01,40106,144,17,62,280,8,511,4.178.333.333
10/06/2020 08:00,5.57,40147,160,16,64,327,7,574,4.178.333.333
10/06/2020 09:00,5.31,40278,164,16,69,394,7,650,4.178.333.333
10/06/2020 10:00,5.2,40149,185,17,72,522,6,802,4.178.333.333
10/06/2020 11:00,5.09,39826,226,19,77,635,7,964,4.178.333.333
10/06/2020 12:00,5.08,39664,271,21,75,705,9,1081,4.178.333.333
10/06/2020 13:00,5,39427,352,25,76,820,11,1284,4.178.333.333
10/06/2020 14:00,5.08,39063,442,26,82,920,14,1484,4.178.333.333
10/06/2020 15:00,4.45,38783,618,27,90,985,15,1735,4.178.333.333
10/06/2020 16:00,4.56,38789,738,26,101,1028,16,1909,4.178.333.333
10/06/2020 17:00,4.84,38304,916,25,110,1050,16,2117,4.178.333.333
10/06/2020 18:00,4.65,37775,995,26,124,1136,14,2295,4.178.333.333
10/06/2020 19:00,3.79,37000,1047,25,132,1179,13,2396,4.178.333.333
10/06/2020 20:00,3.35,36373,1207,27,133,1405,11,2783,4.178.333.333
10/06/2020 21:00,2.91,35583,1397,28,139,1673,9,3246,4.178.333.333
10/06/2020 22:00,2.1,33856,1448,30,140,1944,10,3572,4.178.333.333
10/06/2020 23:00,1.77,32160,1686,29,90,2051,12,3868,4.178.333.333
11/06/2020 00:00,1.49,31284,1740,34,83,2199,12,4068,4.178.333.333
11/06/2020 01:00,1.46,30868,1733,39,77,2285,12,4146,4.178.333.333
11/06/2020 02:00,1.45,30665,1819,43,71,2399,11,4343,4.178.333.333
11/06/2020 03:00,1.45,30769,1916,42,69,2541,13,4581,4.178.333.333
11/06/2020 04:00,1.67,32238,2042,38,66,2399,14,4559,4.178.333.333
11/06/2020 05:00,2.88,35262,2185,35,53,2074,11,4358,4.178.333.333
11/06/2020 06:00,3.39,38286,2182,34,45,1879,13,4153,4.178.333.333
11/06/2020 07:00,4.22,39524,2341,34,44,1788,12,4219,4.178.333.333
11/06/2020 08:00,4.09,39677,2578,37,46,1894,10,4565,4.178.333.333
11/06/2020 09:00,4.01,39868,2737,40,56,2064,16,4913,4.178.333.333
11/06/2020 10:00,3.85,39790,2900,43,58,2276,22,5299,4.178.333.333
11/06/2020 11:00,3.57,39530,3064,46,65,2466,21,5662,4.178.333.333
11/06/2020 12:00,3.35,39312,3130,50,64,2610,21,5875,4.178.333.333
11/06/2020 13:00,3.05,39073,3231,52,68,2733,24,6108,4.178.333.333
11/06/2020 14:00,2.95,38796,3141,53,71,2789,28,6082,4.178.333.333
11/06/2020 15:00,2.92,38565,2947,55,76,2864,30,5972,4.178.333.333
11/06/2020 16:00,2.99,38545,2869,52,82,2859,32,5894,4.178.333.333
11/06/2020 17:00,2.97,38122,2857,51,94,2815,37,5854,4.178.333.333
11/06/2020 18:00,2.92,37627,2661,54,119,2777,38,5649,4.178.333.333
11/06/2020 19:00,2.78,36738,2391,63,151,2790,34,5429,4.178.333.333
11/06/2020 20:00,2.52,36170,2404,74,168,2771,27,5444,4.178.333.333
11/06/2020 21:00,2.01,35328,2346,88,180,2855,25,5494,4.178.333.333
11/06/2020 22:00,1.48,33750,2191,102,180,2886,22,5381,4.178.333.333
11/06/2020 23:00,1.15,32128,2482,115,146,2977,16,5736,4.178.333.333
12/06/2020 00:00,0.95,31179,2651,123,143,2951,18,5886,4.178.333.333
12/06/2020 01:00,0.9,30634,2583,123,139,2967,13,5825,4.178.333.333
12/06/2020 02:00,0.86,30380,2660,123,128,2944,9,5864,4.178.333.333
12/06/2020 03:00,0.9,30510,2798,122,115,2944,12,5991,4.178.333.333
12/06/2020 04:00,1.44,31942,2862,118,103,2710,16,5809,4.178.333.333
12/06/2020 05:00,1.9,35024,2716,111,96,2409,15,5347,4.178.333.333
12/06/2020 06:00,2.44,38145,2434,106,96,2197,16,4849,4.178.333.333
12/06/2020 07:00,3.04,39626,2448,105,102,2100,16,4771,4.178.333.333
12/06/2020 08:00,3.01,39853,2506,108,111,2200,13,4938,4.178.333.333
12/06/2020 09:00,2.7,40006,2499,111,116,2477,14,5217,4.178.333.333
12/06/2020 10:00,2.38,39838,2456,116,124,2683,16,5395,4.178.333.333
12/06/2020 11:00,2.3,39304,2358,118,133,2797,18,5424,4.178.333.333
12/06/2020 12:00,2.09,38755,2254,117,128,2898,15,5412,4.178.333.333
12/06/2020 13:00,1.99,38163,2227,113,133,2938,17,5428,4.178.333.333
12/06/2020 14:00,1.95,37624,2204,109,145,2965,17,5440,4.178.333.333
12/06/2020 15:00,1.91,37318,2127,105,154,2976,16,5378,4.178.333.333
12/06/2020 16:00,1.89,37303,2106,102,166,2925,16,5315,4.178.333.333
12/06/2020 17:00,1.89,37021,2157,102,180,2811,16,5266,4.178.333.333
12/06/2020 18:00,1.88,36283,2056,102,191,2722,17,5088,4.178.333.333
12/06/2020 19:00,1.82,35154,1970,104,203,2676,15,4968,4.178.333.333
12/06/2020 20:00,1.8,34316,1994,107,212,2817,15,5145,4.178.333.333
12/06/2020 21:00,1.55,33652,2102,114,222,2957,14,5409,4.178.333.333
12/06/2020 22:00,1.45,32424,2273,120,226,2935,14,5568,4.178.333.333
12/06/2020 23:00,1.44,31334,2254,131,228,2866,8,5487,4.178.333.333
13/06/2020 00:00,1.41,30378,2275,135,232,2733,9,5384,4.178.333.333
13/06/2020 01:00,1.33,29738,2117,138,229,2631,9,5124,4.178.333.333
13/06/2020 02:00,1.23,29313,2066,142,230,2544,8,4990,4.178.333.333
13/06/2020 03:00,1.22,28983,2061,141,231,2470,8,4911,4.178.333.333
13/06/2020 04:00,1.37,29153,2076,130,228,2251,8,4693,4.178.333.333
13/06/2020 05:00,1.45,29976,2039,116,239,2027,9,4430,4.178.333.333
13/06/2020 06:00,1.45,31218,1955,105,248,1906,12,4226,4.178.333.333
13/06/2020 07:00,1.49,32820,2043,98,257,1859,12,4269,4.178.333.333
13/06/2020 08:00,1.68,34155,2180,91,266,2021,14,4572,4.178.333.333
13/06/2020 09:00,1.72,34983,2303,84,280,2248,15,4930,4.178.333.333
13/06/2020 10:00,1.66,34897,2412,88,288,2499,16,5303,4.178.333.333
13/06/2020 11:00,1.55,34544,2512,103,290,2655,15,5575,4.178.333.333
13/06/2020 12:00,1.49,34233,2632,127,296,2791,15,5861,4.178.333.333
13/06/2020 13:00,1.48,33922,2598,145,308,2882,15,5948,4.178.333.333
13/06/2020 14:00,1.48,33778,2599,155,315,2942,16,6027,4.178.333.333
13/06/2020 15:00,1.49,34019,2667,166,325,2948,14,6120,4.178.333.333
13/06/2020 16:00,1.65,34495,2707,170,329,2969,14,6189,4.178.333.333
13/06/2020 17:00,1.75,34434,2718,167,328,2992,12,6217,4.178.333.333
13/06/2020 18:00,1.53,33861,2520,152,313,2927,12,5924,4.178.333.333
13/06/2020 19:00,1.47,33095,2392,142,297,2948,10,5789,4.178.333.333
13/06/2020 20:00,1.44,32697,2455,135,291,3108,10,5999,4.178.333.333
13/06/2020 21:00,1.41,32421,2547,142,284,3282,9,6264,4.178.333.333
13/06/2020 22:00,1.39,31492,2511,148,280,3508,10,6457,4.178.333.333
13/06/2020 23:00,1.29,30202,2944,172,246,3598,9,6969,4.178.333.333
14/06/2020 00:00,1.02,29290,3068,165,242,3606,8,7089,4.178.333.333
14/06/2020 01:00,0.87,28578,2927,155,245,3473,7,6807,4.178.333.333
14/06/2020 02:00,0.54,28137,2907,137,246,3395,8,6693,4.178.333.333
14/06/2020 03:00,0.48,27656,2952,113,243,3221,10,6539,4.178.333.333
14/06/2020 04:00,0.87,27780,3031,86,233,2911,10,6271,4.178.333.333
14/06/2020 05:00,1.25,28340,2953,60,214,2184,6,5417,4.178.333.333
14/06/2020 06:00,1.44,29409,2719,43,203,1650,4,4619,4.178.333.333
14/06/2020 07:00,1.5,30800,2837,36,215,1359,6,4453,4.178.333.333
14/06/2020 08:00,1.68,32127,2992,36,238,1304,10,4580,4.178.333.333
14/06/2020 09:00,1.86,33057,3106,40,265,1428,17,4856,4.178.333.333
14/06/2020 10:00,1.83,33387,3176,45,279,1713,19,5232,4.178.333.333
14/06/2020 11:00,1.78,33372,3087,52,280,1885,20,5324,4.178.333.333
14/06/2020 12:00,1.7,33149,2903,55,268,1932,21,5179,4.178.333.333
14/06/2020 13:00,1.7,32948,2890,52,256,1911,20,5129,4.178.333.333
14/06/2020 14:00,1.78,32854,2703,44,236,1802,16,4801,4.178.333.333
14/06/2020 15:00,1.78,33104,2538,33,207,1717,16,4511,4.178.333.333
14/06/2020 16:00,2,33646,2295,20,177,1608,15,4115,4.178.333.333
14/06/2020 17:00,2.3,33973,2054,12,157,1539,9,3771,4.178.333.333
14/06/2020 18:00,2.51,33835,1770,10,137,1492,7,3416,4.178.333.333
14/06/2020 19:00,2.26,33364,1449,13,122,1563,5,3152,4.178.333.333
14/06/2020 20:00,2.19,33196,1159,20,99,1796,4,3078,4.178.333.333
14/06/2020 21:00,2.03,32750,976,28,81,1841,2,2928,4.178.333.333
14/06/2020 22:00,1.71,31636,863,31,69,1946,3,2912,4.178.333.333
14/06/2020 23:00,1.49,30929,878,103,72,1753,1,2807,4.178.333.333
15/06/2020 00:00,1.47,30000,839,108,58,1608,7,2620,4.931.488.095
15/06/2020 01:00,1.46,29560,803,113,42,1577,4,2539,4.931.488.095
15/06/2020 02:00,1.46,29423,774,118,34,1670,5,2601,4.931.488.095
15/06/2020 03:00,1.48,29588,715,119,29,1428,5,2296,4.931.488.095
15/06/2020 04:00,1.98,31114,657,114,21,1170,5,1967,4.931.488.095
15/06/2020 05:00,3.9,34360,568,110,17,760,4,1459,4.931.488.095
15/06/2020 06:00,7.21,37496,442,105,14,532,0,1093,4.931.488.095
15/06/2020 07:00,8.07,38923,399,107,13,408,0,927,4.931.488.095
15/06/2020 08:00,7.95,39302,357,114,13,360,2,846,4.931.488.095
15/06/2020 09:00,7.42,39450,314,121,15,340,1,791,4.931.488.095
15/06/2020 10:00,7.12,39453,288,127,19,329,1,764,4.931.488.095
15/06/2020 11:00,5.54,39210,276,132,24,421,1,854,4.931.488.095
15/06/2020 12:00,5.92,39025,235,135,29,480,0,879,4.931.488.095
15/06/2020 13:00,5.72,38729,233,136,31,567,0,967,4.931.488.095
15/06/2020 14:00,6.15,38416,241,134,31,746,0,1152,4.931.488.095
15/06/2020 15:00,5.55,38123,303,132,30,877,0,1342,4.931.488.095
15/06/2020 16:00,5.76,38013,306,128,29,1006,0,1469,4.931.488.095
15/06/2020 17:00,5.45,37500,301,124,27,1078,0,1530,4.931.488.095
15/06/2020 18:00,4.92,36987,291,122,26,1052,0,1491,4.931.488.095
15/06/2020 19:00,4.8,36135,292,121,25,1084,0,1522,4.931.488.095
15/06/2020 20:00,4.59,35576,303,121,24,1071,0,1519,4.931.488.095
15/06/2020 21:00,3.98,34744,366,118,25,1173,0,1682,4.931.488.095
15/06/2020 22:00,2.62,33126,384,110,25,1215,0,1734,4.931.488.095
15/06/2020 23:00,1.95,31948,246,84,24,1352,1,1707,4.931.488.095
16/06/2020 00:00,1.59,30937,250,84,26,1495,2,1857,4.931.488.095
16/06/2020 01:00,1.5,30413,232,80,25,1523,1,1861,4.931.488.095
16/06/2020 02:00,1.49,30175,250,75,24,1557,1,1907,4.931.488.095
16/06/2020 03:00,1.49,30195,317,70,25,1614,1,2027,4.931.488.095
16/06/2020 04:00,2,31630,321,62,27,1498,1,1909,4.931.488.095
16/06/2020 05:00,4.08,34776,297,51,27,1276,0,1651,4.931.488.095
16/06/2020 06:00,7.27,37933,233,43,27,1093,0,1396,4.931.488.095
16/06/2020 07:00,7.88,39357,250,42,33,1019,0,1344,4.931.488.095
16/06/2020 08:00,7.91,39601,290,49,50,1027,1,1417,4.931.488.095
16/06/2020 09:00,7.89,39903,357,60,64,1092,1,1574,4.931.488.095
16/06/2020 10:00,7.58,39962,437,70,70,1176,0,1753,4.931.488.095
16/06/2020 11:00,7.29,39754,454,73,59,1230,0,1816,4.931.488.095
16/06/2020 12:00,6.9,39609,465,72,42,1346,0,1925,4.931.488.095
16/06/2020 13:00,6.89,39398,484,68,34,1340,0,1926,4.931.488.095
16/06/2020 14:00,5.03,39050,511,60,25,1348,0,1944,4.931.488.095
16/06/2020 15:00,4.78,38725,506,52,17,1351,0,1926,4.931.488.095
16/06/2020 16:00,4.37,38469,533,43,13,1346,0,1935,4.931.488.095
16/06/2020 17:00,4.82,37808,520,38,13,1339,0,1910,4.931.488.095
16/06/2020 18:00,4.62,37247,462,34,13,1333,0,1842,4.931.488.095
16/06/2020 19:00,3.98,36521,435,33,16,1413,0,1897,4.931.488.095
16/06/2020 20:00,3.76,35962,419,34,20,1540,0,2013,4.931.488.095
16/06/2020 21:00,2.91,35004,365,35,25,1721,0,2146,4.931.488.095
16/06/2020 22:00,2.03,33324,311,36,29,1737,0,2113,4.931.488.095
16/06/2020 23:00,2.14,31781,289,26,29,1903,0,2247,4.931.488.095
17/06/2020 00:00,1.93,30761,279,27,29,1883,3,2221,4.931.488.095
17/06/2020 01:00,1.93,30205,286,26,24,1625,5,1966,4.931.488.095
17/06/2020 02:00,1.93,29991,305,25,20,1497,5,1852,4.931.488.095
17/06/2020 03:00,2.05,30050,309,21,18,1325,4,1677,4.931.488.095
17/06/2020 04:00,2.57,31513,308,15,15,1259,2,1599,4.931.488.095
17/06/2020 05:00,4.63,34667,279,9,12,1063,0,1363,4.931.488.095
17/06/2020 06:00,8.78,37851,211,5,10,862,1,1089,4.931.488.095
17/06/2020 07:00,8.97,39226,204,4,8,693,1,910,4.931.488.095
17/06/2020 08:00,8.92,39452,210,4,8,642,1,865,4.931.488.095
17/06/2020 09:00,8.88,39763,248,4,9,615,2,878,4.931.488.095
17/06/2020 10:00,8.93,39746,287,5,11,596,1,900,4.931.488.095
17/06/2020 11:00,8.97,39494,286,6,12,625,1,930,4.931.488.095
17/06/2020 12:00,8.75,39365,301,7,12,642,1,963,4.931.488.095
17/06/2020 13:00,8.46,39113,356,7,16,613,0,992,4.931.488.095
17/06/2020 14:00,7.73,38720,397,7,22,568,1,995,4.931.488.095
17/06/2020 15:00,7.36,38324,432,6,30,525,1,994,4.931.488.095
17/06/2020 16:00,6.41,38264,507,6,39,481,1,1034,4.931.488.095
17/06/2020 17:00,4.74,37795,569,6,53,425,0,1053,4.931.488.095
17/06/2020 18:00,4.68,37322,527,8,77,409,0,1021,4.931.488.095
17/06/2020 19:00,4.55,36538,527,9,105,385,0,1026,4.931.488.095
17/06/2020 20:00,4.3,35795,593,11,133,419,0,1156,4.931.488.095
17/06/2020 21:00,4.08,34850,678,12,158,535,0,1383,4.931.488.095
17/06/2020 22:00,2.96,33239,662,13,165,524,0,1364,4.931.488.095
17/06/2020 23:00,3.3,31812,362,13,159,418,7,959,4.931.488.095
18/06/2020 00:00,2.71,30705,298,15,160,350,4,827,4.931.488.095
18/06/2020 01:00,2.45,29995,256,15,151,338,2,762,4.931.488.095
18/06/2020 02:00,2.38,29623,260,14,148,360,8,790,4.931.488.095
18/06/2020 03:00,2.36,29624,283,13,147,414,5,862,4.931.488.095
18/06/2020 04:00,3.19,31048,300,10,137,335,6,788,4.931.488.095
18/06/2020 05:00,4.75,34129,282,7,113,300,6,708,4.931.488.095
18/06/2020 06:00,5.94,37414,256,5,84,234,2,581,4.931.488.095
18/06/2020 07:00,7.45,39000,283,4,72,303,3,665,4.931.488.095
18/06/2020 08:00,7.11,39286,339,4,73,354,3,773,4.931.488.095
18/06/2020 09:00,6.94,39536,378,4,84,451,4,921,4.931.488.095
18/06/2020 10:00,6.54,39446,404,5,98,300,6,813,4.931.488.095
18/06/2020 11:00,6.48,39078,455,6,109,388,5,963,4.931.488.095
18/06/2020 12:00,5.88,38682,482,7,108,624,6,1227,4.931.488.095
18/06/2020 13:00,5.45,38280,539,8,98,475,9,1129,4.931.488.095
18/06/2020 14:00,4.45,37848,547,9,86,553,10,1205,4.931.488.095
18/06/2020 15:00,4.33,37643,559,10,79,644,11,1303,4.931.488.095
18/06/2020 16:00,4,37451,519,11,78,697,9,1314,4.931.488.095
18/06/2020 17:00,4.15,36858,479,11,76,713,24,1303,4.931.488.095
18/06/2020 18:00,4.13,36210,390,11,76,797,4,1278,4.931.488.095
18/06/2020 19:00,4.18,35428,326,12,79,1010,6,1433,4.931.488.095
18/06/2020 20:00,3.68,34788,316,13,94,1220,23,1666,4.931.488.095
18/06/2020 21:00,2.98,33956,320,13,118,1495,4,1950,4.931.488.095
18/06/2020 22:00,2.33,32580,300,14,121,1806,3,2244,4.931.488.095
18/06/2020 23:00,1.75,31055,215,15,97,1988,5,2320,4.931.488.095
19/06/2020 00:00,1.55,29912,225,15,98,2085,4,2427,4.931.488.095
19/06/2020 01:00,1.48,29228,226,15,99,2229,3,2572,4.931.488.095
19/06/2020 02:00,1.46,28861,275,16,94,2380,2,2767,4.931.488.095
19/06/2020 03:00,1.45,28684,353,14,87,2325,3,2782,4.931.488.095
19/06/2020 04:00,1.59,29226,346,12,71,2054,5,2488,4.931.488.095
19/06/2020 05:00,2,31164,309,10,52,1716,3,2090,4.931.488.095
19/06/2020 06:00,2.72,33843,283,7,31,1392,2,1715,4.931.488.095
19/06/2020 07:00,2.97,35570,275,7,26,1106,2,1416,4.931.488.095
19/06/2020 08:00,3.23,36405,291,6,29,1015,2,1343,4.931.488.095
19/06/2020 09:00,3.32,36827,331,7,40,993,1,1372,4.931.488.095
19/06/2020 10:00,3.2,36721,401,9,45,1019,1,1475,4.931.488.095
19/06/2020 11:00,2.91,36320,451,12,41,1064,3,1571,4.931.488.095
19/06/2020 12:00,2.75,35821,468,15,34,1090,5,1612,4.931.488.095
19/06/2020 13:00,2.57,35329,508,18,36,1211,5,1778,4.931.488.095
19/06/2020 14:00,2.15,34893,541,19,36,1277,7,1880,4.931.488.095
19/06/2020 15:00,2.13,34738,526,20,35,1275,3,1859,4.931.488.095
19/06/2020 16:00,2.16,34666,592,21,35,1384,3,2035,4.931.488.095
19/06/2020 17:00,2.06,34315,620,22,36,1378,2,2058,4.931.488.095
19/06/2020 18:00,1.99,33653,677,21,40,1370,2,2110,4.931.488.095
19/06/2020 19:00,1.86,32867,701,21,54,1469,2,2247,4.931.488.095
19/06/2020 20:00,1.77,32413,683,21,70,1673,3,2450,4.931.488.095
19/06/2020 21:00,1.67,32008,533,22,89,1885,3,2532,4.931.488.095
19/06/2020 22:00,1.49,31176,470,21,100,2131,4,2726,4.931.488.095
19/06/2020 23:00,1.46,30231,673,114,96,2109,9,3001,4.931.488.095
20/06/2020 00:00,1.42,29251,735,103,94,2209,3,3144,4.931.488.095
20/06/2020 01:00,1.39,28605,821,95,95,2161,1,3173,4.931.488.095
20/06/2020 02:00,1.3,28109,955,87,94,2135,1,3272,4.931.488.095
20/06/2020 03:00,1.22,27624,1066,77,85,2083,2,3313,4.931.488.095
20/06/2020 04:00,1.35,27633,1159,65,73,1728,2,3027,4.931.488.095
20/06/2020 05:00,1.47,28146,1096,55,50,1402,2,2605,4.931.488.095
20/06/2020 06:00,1.5,29239,963,51,35,1160,3,2212,4.931.488.095
20/06/2020 07:00,1.68,30788,1032,58,31,1000,5,2126,4.931.488.095
20/06/2020 08:00,1.93,32156,1104,74,31,974,2,2185,4.931.488.095
20/06/2020 09:00,2.04,33007,1171,89,37,1028,2,2327,4.931.488.095
20/06/2020 10:00,2.07,33270,1214,98,35,1144,3,2494,4.931.488.095
20/06/2020 11:00,2.06,33038,1253,105,34,1251,3,2646,4.931.488.095
20/06/2020 12:00,2.01,32867,1276,107,32,1360,2,2777,4.931.488.095
20/06/2020 13:00,1.97,32597,1384,104,32,1453,3,2976,4.931.488.095
20/06/2020 14:00,1.95,32478,1419,97,40,1437,3,2996,4.931.488.095
20/06/2020 15:00,2.02,32629,1497,91,49,1404,6,3047,4.931.488.095
20/06/2020 16:00,2.18,33159,1467,85,62,1401,7,3022,4.931.488.095
20/06/2020 17:00,2.39,33218,1452,80,67,1356,9,2964,4.931.488.095
20/06/2020 18:00,2.22,32759,1371,76,79,1380,6,2912,4.931.488.095
20/06/2020 19:00,2.06,32047,1223,78,100,1463,10,2874,4.931.488.095
20/06/2020 20:00,2.03,31639,1075,79,117,1644,7,2922,4.931.488.095
20/06/2020 21:00,1.81,31321,1008,80,133,1795,5,3021,4.931.488.095
20/06/2020 22:00,1.63,30609,943,77,144,1994,2,3160,4.931.488.095
20/06/2020 23:00,1.49,29780,919,75,112,2031,3,3140,4.931.488.095
21/06/2020 00:00,1.45,28685,913,70,110,2008,4,3105,4.931.488.095
21/06/2020 01:00,1.43,27996,918,65,109,1968,5,3065,4.931.488.095
21/06/2020 02:00,1.41,27536,903,59,104,1833,4,2903,4.931.488.095
21/06/2020 03:00,1.38,27021,810,53,96,1695,6,2660,4.931.488.095
21/06/2020 04:00,1.41,27014,768,40,85,1452,4,2349,4.931.488.095
21/06/2020 05:00,1.47,27624,679,28,70,1128,5,1910,4.931.488.095
21/06/2020 06:00,1.55,28745,590,22,66,929,4,1611,4.931.488.095
21/06/2020 07:00,1.64,30289,548,27,59,842,5,1481,4.931.488.095
21/06/2020 08:00,1.79,31733,533,42,56,835,5,1471,4.931.488.095
21/06/2020 09:00,2,32634,496,61,57,887,5,1506,4.931.488.095
21/06/2020 10:00,2.06,33016,470,81,59,1001,6,1617,4.931.488.095
21/06/2020 11:00,1.96,33014,465,97,60,1108,5,1735,4.931.488.095
21/06/2020 12:00,1.77,32950,443,112,58,1146,4,1763,4.931.488.095
21/06/2020 13:00,1.55,32835,462,117,59,1244,4,1886,4.931.488.095
21/06/2020 14:00,1.55,32920,436,117,53,1310,3,1919,4.931.488.095
21/06/2020 15:00,1.7,33166,379,112,47,1322,4,1864,4.931.488.095
21/06/2020 16:00,1.99,33757,361,102,47,1321,5,1836,4.931.488.095
21/06/2020 17:00,2.18,34072,316,92,56,1340,5,1809,4.931.488.095
21/06/2020 18:00,2.37,33998,248,84,62,1368,6,1768,4.931.488.095
21/06/2020 19:00,2.25,33469,204,80,62,1488,5,1839,4.931.488.095
21/06/2020 20:00,2.1,33277,211,80,66,1731,5,2093,4.931.488.095
21/06/2020 21:00,1.99,32832,282,80,71,1901,4,2338,4.931.488.095
21/06/2020 22:00,1.74,31670,313,81,71,2002,6,2473,4.931.488.095
21/06/2020 23:00,1.53,30141,281,25,98,2109,8,2521,4.931.488.095
22/06/2020 00:00,1.45,29188,375,28,93,2180,6,2682,552.327.381
22/06/2020 01:00,1.43,28773,468,29,82,2087,7,2673,552.327.381
22/06/2020 02:00,1.44,28656,536,31,69,1862,7,2505,552.327.381
22/06/2020 03:00,1.47,28834,622,32,60,1612,6,2332,552.327.381
22/06/2020 04:00,1.72,30485,736,32,43,1243,6,2060,552.327.381
22/06/2020 05:00,2.38,33839,735,27,26,903,5,1696,552.327.381
22/06/2020 06:00,4.21,37210,699,21,15,594,4,1333,552.327.381
22/06/2020 07:00,5.72,38770,868,18,11,415,3,1315,552.327.381
22/06/2020 08:00,5.89,39329,1087,19,12,389,3,1510,552.327.381
22/06/2020 09:00,5.79,39653,1367,20,12,407,3,1809,552.327.381
22/06/2020 10:00,6,39636,1569,22,11,449,3,2054,552.327.381
22/06/2020 11:00,5.97,39456,1624,24,13,532,3,2196,552.327.381
22/06/2020 12:00,5.85,39306,1698,25,17,621,3,2364,552.327.381
22/06/2020 13:00,4.95,38980,1774,27,22,713,3,2539,552.327.381
22/06/2020 14:00,4.09,38680,1923,29,27,794,4,2777,552.327.381
22/06/2020 15:00,3.56,38435,2182,30,34,924,4,3174,552.327.381
22/06/2020 16:00,3.79,38234,2240,37,40,920,4,3241,552.327.381
22/06/2020 17:00,3.85,37752,2163,30,46,916,6,3161,552.327.381
22/06/2020 18:00,3.81,37195,2021,30,52,894,6,3003,552.327.381
22/06/2020 19:00,3.64,36231,1744,33,65,981,5,2828,552.327.381
22/06/2020 20:00,3.47,35634,1549,42,71,1119,4,2785,552.327.381
22/06/2020 21:00,2.93,34772,1469,58,79,1333,6,2945,552.327.381
22/06/2020 22:00,2.03,33222,1410,68,84,1482,5,3049,552.327.381
22/06/2020 23:00,2.25,31444,1234,122,66,1558,4,2984,552.327.381
23/06/2020 00:00,1.93,30431,1179,120,63,1663,3,3028,552.327.381
23/06/2020 01:00,1.71,29869,1126,118,57,1616,3,2920,552.327.381
23/06/2020 02:00,1.69,29594,1066,114,48,1481,3,2712,552.327.381
23/06/2020 03:00,1.68,29581,1042,110,40,1349,3,2544,552.327.381
23/06/2020 04:00,2.14,31238,1032,100,37,1147,3,2319,552.327.381
23/06/2020 05:00,4.16,34672,903,88,33,782,3,1809,552.327.381
23/06/2020 06:00,6.01,38006,810,79,29,606,3,1527,552.327.381
23/06/2020 07:00,7.87,39567,880,76,25,458,3,1442,552.327.381
23/06/2020 08:00,8.28,39936,870,84,24,399,3,1380,552.327.381
23/06/2020 09:00,8.29,40271,799,93,23,374,3,1292,552.327.381
23/06/2020 10:00,8.47,40337,703,101,21,373,3,1201,552.327.381
23/06/2020 11:00,8.27,40024,635,105,22,393,4,1159,552.327.381
23/06/2020 12:00,7.81,39837,574,105,24,460,4,1167,552.327.381
23/06/2020 13:00,7.32,39613,514,103,27,485,4,1133,552.327.381
23/06/2020 14:00,6.01,39367,499,101,32,525,5,1162,552.327.381
23/06/2020 15:00,5.51,38935,491,98,41,570,9,1209,552.327.381
23/06/2020 16:00,5.94,38656,444,92,54,536,9,1135,552.327.381
23/06/2020 17:00,4.97,38195,355,84,61,593,9,1102,552.327.381
23/06/2020 18:00,5.28,37585,256,80,70,588,8,1002,552.327.381
23/06/2020 19:00,4.96,36652,184,81,84,634,7,990,552.327.381
23/06/2020 20:00,4.14,36024,145,80,99,780,8,1112,552.327.381
23/06/2020 21:00,3.88,35057,139,79,121,1032,8,1379,552.327.381
23/06/2020 22:00,2.93,33455,131,74,138,1321,8,1672,552.327.381
23/06/2020 23:00,2.63,31511,89,32,106,1505,5,1737,552.327.381
24/06/2020 00:00,1.99,30482,96,26,123,1745,5,1995,552.327.381
24/06/2020 01:00,1.87,29851,103,21,131,1776,6,2037,552.327.381
24/06/2020 02:00,1.77,29532,105,18,128,1740,6,1997,552.327.381
24/06/2020 03:00,1.77,29563,101,16,124,1798,6,2045,552.327.381
24/06/2020 04:00,1.94,31121,102,13,109,1441,8,1673,552.327.381
24/06/2020 05:00,2.77,34482,76,8,80,964,5,1133,552.327.381
24/06/2020 06:00,5.2,37748,59,4,44,630,3,740,552.327.381
24/06/2020 07:00,7.32,39129,57,4,29,419,4,513,552.327.381
24/06/2020 08:00,7.56,39519,48,4,29,303,4,388,552.327.381
24/06/2020 09:00,7.75,39824,45,4,38,247,4,338,552.327.381
24/06/2020 10:00,7.65,39728,46,6,46,220,3,321,552.327.381
24/06/2020 11:00,7.49,39573,52,9,54,222,3,340,552.327.381
24/06/2020 12:00,7.5,39487,66,12,53,343,5,479,552.327.381
24/06/2020 13:00,7.02,39314,68,16,50,382,8,524,552.327.381
24/06/2020 14:00,6.28,39000,104,19,38,403,10,574,552.327.381
24/06/2020 15:00,5.87,38654,156,21,39,422,11,649,552.327.381
24/06/2020 16:00,5.41,38555,187,22,40,451,10,710,552.327.381
24/06/2020 17:00,5.01,38113,206,21,41,481,7,756,552.327.381
24/06/2020 18:00,4.97,37502,238,23,49,493,5,808,552.327.381
24/06/2020 19:00,4.4,36588,244,24,64,534,5,871,552.327.381
24/06/2020 20:00,3.56,35828,249,24,75,625,4,977,552.327.381
24/06/2020 21:00,2.96,34833,285,23,85,854,4,1251,552.327.381
24/06/2020 22:00,2.52,33273,328,21,89,982,4,1424,552.327.381
24/06/2020 23:00,2.12,31707,270,12,0,963,3,1248,552.327.381
25/06/2020 00:00,1.93,30651,299,10,0,970,3,1282,552.327.381
25/06/2020 01:00,1.81,30093,332,8,0,998,3,1341,552.327.381
25/06/2020 02:00,1.79,29783,341,6,0,919,3,1269,552.327.381
25/06/2020 03:00,1.78,29724,364,5,0,842,3,1214,552.327.381
25/06/2020 04:00,1.83,31157,374,4,0,702,3,1083,552.327.381
25/06/2020 05:00,2.44,34302,365,3,0,527,3,898,552.327.381
25/06/2020 06:00,3.92,37615,331,3,0,469,2,805,552.327.381
25/06/2020 07:00,6.48,39183,332,3,0,444,1,780,552.327.381
25/06/2020 08:00,6.55,39591,379,4,0,409,1,793,552.327.381
25/06/2020 09:00,6.04,39972,455,6,0,412,1,874,552.327.381
25/06/2020 10:00,6.07,39992,549,7,0,434,1,991,552.327.381
25/06/2020 11:00,6.06,39789,630,8,0,473,2,1113,552.327.381
25/06/2020 12:00,5.65,39690,682,9,0,584,3,1278,552.327.381
25/06/2020 13:00,5.12,39496,727,10,0,677,3,1417,552.327.381
25/06/2020 14:00,3.52,39178,816,11,0,819,3,1649,552.327.381
25/06/2020 15:00,2.97,38899,940,12,0,908,3,1863,552.327.381
25/06/2020 16:00,2.94,38699,988,12,0,930,3,1933,552.327.381
25/06/2020 17:00,3.53,38246,1001,11,0,974,3,1989,552.327.381
25/06/2020 18:00,3.09,37705,935,11,0,981,3,1930,552.327.381
25/06/2020 19:00,2.67,36812,875,11,0,1035,4,1925,552.327.381
25/06/2020 20:00,2.54,36118,903,12,0,1196,3,2114,552.327.381
25/06/2020 21:00,2.47,35158,1059,13,0,1362,3,2437,552.327.381
25/06/2020 22:00,1.99,33647,1224,13,0,1508,3,2748,552.327.381
25/06/2020 23:00,1.95,32411,1376,18,44,1515,2,2955,552.327.381
26/06/2020 00:00,1.74,31266,1401,22,54,1611,3,3091,552.327.381
26/06/2020 01:00,1.67,30670,1435,25,58,1623,3,3144,552.327.381
26/06/2020 02:00,1.62,30388,1367,26,59,1614,3,3069,552.327.381
26/06/2020 03:00,1.6,30391,1337,25,61,1578,2,3003,552.327.381
26/06/2020 04:00,1.66,31741,1363,21,58,1500,2,2944,552.327.381
26/06/2020 05:00,2.47,34822,1258,16,41,1158,2,2475,552.327.381
26/06/2020 06:00,4.49,38013,1040,11,26,813,2,1892,552.327.381
26/06/2020 07:00,5.6,39543,950,11,20,513,1,1495,552.327.381
26/06/2020 08:00,5.7,40029,915,13,28,496,1,1453,552.327.381
26/06/2020 09:00,5.68,40374,969,15,44,559,1,1588,552.327.381
26/06/2020 10:00,5.11,40201,1060,16,68,675,2,1821,552.327.381
26/06/2020 11:00,4.97,39865,1074,18,85,758,5,1940,552.327.381
26/06/2020 12:00,4.69,39407,1034,18,82,861,5,2000,552.327.381
26/06/2020 13:00,3.22,38879,1045,17,83,962,4,2111,552.327.381
26/06/2020 14:00,2.28,38297,1030,15,89,929,3,2066,552.327.381
26/06/2020 15:00,2,37910,1013,14,89,923,3,2042,552.327.381
26/06/2020 16:00,2.08,37765,1008,12,86,871,3,1980,552.327.381
26/06/2020 17:00,2.33,37290,936,12,91,845,2,1886,552.327.381
26/06/2020 18:00,2.36,36629,806,13,90,835,2,1746,552.327.381
26/06/2020 19:00,1.99,35516,738,14,96,873,3,1724,552.327.381
26/06/2020 20:00,1.78,34796,804,14,111,1109,3,2041,552.327.381
26/06/2020 21:00,1.77,34128,1009,14,138,1365,4,2530,552.327.381
26/06/2020 22:00,1.58,32967,1133,13,152,1515,7,2820,552.327.381
26/06/2020 23:00,1.72,31708,1082,69,123,1550,3,2827,552.327.381
27/06/2020 00:00,1.57,30564,993,78,127,1621,3,2822,552.327.381
27/06/2020 01:00,1.53,29898,1066,82,127,1612,3,2890,552.327.381
27/06/2020 02:00,1.5,29374,1079,79,129,1570,3,2860,552.327.381
27/06/2020 03:00,1.46,28914,1066,75,135,1699,4,2979,552.327.381
27/06/2020 04:00,1.51,29089,1097,73,127,1564,3,2864,552.327.381
27/06/2020 05:00,1.56,30005,1003,77,97,1321,3,2501,552.327.381
27/06/2020 06:00,1.54,31382,830,81,65,1190,2,2168,552.327.381
27/06/2020 07:00,1.57,33092,834,90,59,1113,2,2098,552.327.381
27/06/2020 08:00,1.67,34611,843,101,80,1119,1,2144,552.327.381
27/06/2020 09:00,1.72,35468,894,110,112,1078,2,2196,552.327.381
27/06/2020 10:00,1.68,35472,973,119,131,1068,4,2295,552.327.381
27/06/2020 11:00,1.62,35231,1027,125,133,1058,4,2347,552.327.381
27/06/2020 12:00,1.6,34960,1025,129,125,1084,4,2367,552.327.381
27/06/2020 13:00,1.6,34578,1027,131,108,1160,4,2430,552.327.381
27/06/2020 14:00,1.6,34393,1060,133,78,1203,6,2480,552.327.381
27/06/2020 15:00,1.59,34688,1007,133,52,1328,10,2530,552.327.381
27/06/2020 16:00,1.66,35131,926,134,46,1394,13,2513,552.327.381
27/06/2020 17:00,1.67,35084,856,133,42,1402,11,2444,552.327.381
27/06/2020 18:00,1.61,34582,808,129,43,1417,8,2405,552.327.381
27/06/2020 19:00,1.55,33741,850,128,40,1526,21,2565,552.327.381
27/06/2020 20:00,1.52,33320,938,127,31,1650,21,2767,552.327.381
27/06/2020 21:00,1.53,32969,868,126,23,1792,5,2814,552.327.381
27/06/2020 22:00,1.47,32063,900,122,22,1895,3,2942,552.327.381
27/06/2020 23:00,1.49,30665,804,122,20,1946,2,2894,552.327.381
28/06/2020 00:00,1.47,29569,892,120,16,1923,2,2953,552.327.381
28/06/2020 01:00,1.44,28844,1042,118,12,1893,2,3067,552.327.381
28/06/2020 02:00,1.42,28371,1129,114,10,1855,2,3110,552.327.381
28/06/2020 03:00,1.42,27880,1233,110,9,1726,2,3080,552.327.381
28/06/2020 04:00,1.42,27942,1404,100,7,1520,1,3032,552.327.381
28/06/2020 05:00,1.42,28520,1420,88,8,1248,1,2765,552.327.381
28/06/2020 06:00,1.42,29716,1364,79,9,1090,1,2543,552.327.381
28/06/2020 07:00,1.46,31330,1518,76,9,991,1,2595,552.327.381
28/06/2020 08:00,1.5,32711,1708,84,13,1005,2,2812,552.327.381
28/06/2020 09:00,1.71,33686,1860,93,16,1129,2,3100,552.327.381
28/06/2020 10:00,1.7,34138,2001,101,23,1343,3,3471,552.327.381
28/06/2020 11:00,1.65,34213,2089,105,31,1579,4,3808,552.327.381
28/06/2020 12:00,1.56,34115,2110,105,39,1766,6,4026,552.327.381
28/06/2020 13:00,1.4,34053,2178,103,53,1876,6,4216,552.327.381
28/06/2020 14:00,1.45,34120,2328,101,66,1819,3,4317,552.327.381
28/06/2020 15:00,1.56,34439,2457,98,70,1781,4,4410,552.327.381
28/06/2020 16:00,1.76,34914,2518,92,70,1735,3,4418,552.327.381
28/06/2020 17:00,1.82,35129,2330,84,61,1705,4,4184,552.327.381
28/06/2020 18:00,1.86,35089,1960,80,55,1642,3,3740,552.327.381
28/06/2020 19:00,1.8,34419,1688,81,56,1647,2,3474,552.327.381
28/06/2020 20:00,1.77,34160,1480,80,54,1745,2,3361,552.327.381
28/06/2020 21:00,1.77,33631,1353,79,43,1877,2,3354,552.327.381
28/06/2020 22:00,1.71,32473,1319,74,33,1888,2,3316,552.327.381
28/06/2020 23:00,1.48,31052,1272,14,14,1875,2,3177,552.327.381
29/06/2020 00:00,1.42,30125,1384,12,11,1856,2,3265,5.840.595.238
29/06/2020 01:00,1.42,29692,1490,9,13,1776,2,3290,5.840.595.238
29/06/2020 02:00,1.42,29509,1552,8,15,1664,2,3241,5.840.595.238
29/06/2020 03:00,1.43,29590,1728,7,16,1575,2,3328,5.840.595.238
29/06/2020 04:00,1.55,31100,1898,6,13,1462,2,3381,5.840.595.238
29/06/2020 05:00,1.93,34227,1841,4,9,1282,2,3138,5.840.595.238
29/06/2020 06:00,2.46,37597,1808,3,9,1225,2,3047,5.840.595.238
29/06/2020 07:00,3.63,39154,2058,3,15,1204,3,3283,5.840.595.238
29/06/2020 08:00,4.16,39699,2310,4,30,1279,3,3626,5.840.595.238
29/06/2020 09:00,4,40079,2525,6,37,1378,3,3949,5.840.595.238
29/06/2020 10:00,3.32,40209,2582,8,44,1728,3,4365,5.840.595.238
29/06/2020 11:00,3.05,40037,2615,10,64,1770,3,4462,5.840.595.238
29/06/2020 12:00,3.03,39954,2690,11,81,2093,4,4879,5.840.595.238
29/06/2020 13:00,2.83,39592,2724,11,87,2219,6,5047,5.840.595.238
29/06/2020 14:00,2.23,39220,2761,10,86,2189,3,5049,5.840.595.238
29/06/2020 15:00,2.17,38905,2801,9,87,2267,3,5167,5.840.595.238
29/06/2020 16:00,2.09,38713,2737,8,85,2240,3,5073,5.840.595.238
29/06/2020 17:00,2.45,38323,2579,7,76,2022,3,4687,5.840.595.238
29/06/2020 18:00,2.23,37752,2420,7,65,1954,3,4449,5.840.595.238
29/06/2020 19:00,2.09,36799,2315,7,59,1955,2,4338,5.840.595.238
29/06/2020 20:00,1.97,36169,2270,7,57,2084,2,4420,5.840.595.238
29/06/2020 21:00,1.96,35325,2456,11,63,2168,2,4700,5.840.595.238
29/06/2020 22:00,1.74,33945,2707,14,68,2334,3,5126,5.840.595.238
29/06/2020 23:00,1.53,32620,2521,68,110,2338,3,5040,5.840.595.238
30/06/2020 00:00,1.46,31572,2711,63,129,2533,2,5438,5.840.595.238
30/06/2020 01:00,1.38,30926,2994,58,139,2543,2,5736,5.840.595.238
30/06/2020 02:00,1.36,30664,3146,55,149,2675,3,6028,5.840.595.238
30/06/2020 03:00,1.41,30743,3249,49,156,2629,9,6092,5.840.595.238
30/06/2020 04:00,1.53,32241,3342,39,155,2269,6,5811,5.840.595.238
30/06/2020 05:00,1.99,35264,3342,28,150,2221,16,5757,5.840.595.238
30/06/2020 06:00,4.05,38388,3192,21,157,2155,16,5541,5.840.595.238
30/06/2020 07:00,3.97,39956,3469,17,186,2165,18,5855,5.840.595.238
30/06/2020 08:00,2.74,40524,3679,15,222,2257,7,6180,5.840.595.238
30/06/2020 09:00,1.97,40980,3894,15,241,2453,3,6606,5.840.595.238
30/06/2020 10:00,1.63,41081,4059,17,271,2604,8,6959,5.840.595.238
30/06/2020 11:00,1.57,40872,4145,20,307,2818,21,7311,5.840.595.238
30/06/2020 12:00,1.49,40806,4120,22,334,2886,31,7393,5.840.595.238
30/06/2020 13:00,1.51,40664,4171,25,350,3132,35,7713,5.840.595.238
30/06/2020 14:00,1.51,40376,4294,25,340,3070,35,7764,5.840.595.238
30/06/2020 15:00,1.55,40033,4413,29,313,3088,36,7879,5.840.595.238
30/06/2020 16:00,2.12,39921,4459,24,292,3228,36,8039,5.840.595.238
30/06/2020 17:00,2.14,39370,4498,24,266,3159,36,7983,5.840.595.238
30/06/2020 18:00,1.98,38803,4308,27,244,3216,36,7831,5.840.595.238
30/06/2020 19:00,1.6,37860,4140,34,231,3406,36,7847,5.840.595.238
30/06/2020 20:00,1.7,37211,3980,43,231,3766,36,8056,5.840.595.238
30/06/2020 21:00,1.58,36323,3948,46,238,3956,36,8224,5.840.595.238
30/06/2020 22:00,1.45,34668,3915,43,251,4106,37,8352,5.840.595.238
30/06/2020 23:00,0.95,32617,3604,124,318,4200,37,8283,5.840.595.238
01/07/2020 00:00,0.59,31536,3469,124,325,4256,37,8211,5.840.595.238
01/07/2020 01:00,0.45,30937,3280,128,333,4322,37,8100,5.840.595.238
01/07/2020 02:00,0.46,30688,2998,137,343,4435,37,7950,5.840.595.238
01/07/2020 03:00,0.61,30717,2732,148,362,4580,37,7859,5.840.595.238
01/07/2020 04:00,1.13,32141,2509,155,377,4526,36,7603,5.840.595.238
01/07/2020 05:00,1.59,35208,2167,154,387,4337,33,7078,5.840.595.238
01/07/2020 06:00,2.31,38396,1866,157,390,4167,36,6616,5.840.595.238
01/07/2020 07:00,3.13,39917,1916,163,406,3818,37,6340,5.840.595.238
01/07/2020 08:00,3.48,40497,1800,168,414,3651,35,6068,5.840.595.238
01/07/2020 09:00,3.84,40908,1771,172,416,3630,37,6026,5.840.595.238
01/07/2020 10:00,3.74,40961,1675,177,415,3423,37,5727,5.840.595.238
01/07/2020 11:00,3.28,40600,1471,181,418,3147,37,5254,5.840.595.238
01/07/2020 12:00,3.29,40549,1406,184,404,3054,37,5085,5.840.595.238
01/07/2020 13:00,2.84,40424,1412,186,388,2988,36,5010,5.840.595.238
01/07/2020 14:00,2.45,40092,1417,184,363,3006,36,5006,5.840.595.238
01/07/2020 15:00,2.39,39784,1377,179,333,3003,35,4927,5.840.595.238
01/07/2020 16:00,2.31,39501,1335,171,286,2819,34,4645,5.840.595.238
01/07/2020 17:00,2.39,39114,1300,158,232,2581,30,4301,5.840.595.238
01/07/2020 18:00,2.41,38469,1143,143,179,2253,29,3747,5.840.595.238
01/07/2020 19:00,2.41,37542,1072,127,146,2081,28,3454,5.840.595.238
01/07/2020 20:00,2.3,36809,1076,115,135,2019,24,3369,5.840.595.238
01/07/2020 21:00,1.96,36021,1156,105,133,1909,22,3325,5.840.595.238
01/07/2020 22:00,1.65,34410,1287,95,129,1854,20,3385,5.840.595.238
01/07/2020 23:00,1.58,32519,930,167,100,1937,11,3145,5.840.595.238
02/07/2020 00:00,1.49,31474,1236,170,92,2015,10,3523,5.840.595.238
02/07/2020 01:00,1.47,30871,1372,172,88,2133,8,3773,5.840.595.238
02/07/2020 02:00,1.46,30560,1399,173,92,2015,8,3687,5.840.595.238
02/07/2020 03:00,1.48,30553,1453,173,96,2002,7,3731,5.840.595.238
02/07/2020 04:00,1.58,31948,1455,172,98,1855,6,3586,5.840.595.238
02/07/2020 05:00,2.11,34993,1379,170,102,1683,5,3339,5.840.595.238
02/07/2020 06:00,2.87,38116,1306,167,108,1571,4,3156,5.840.595.238
02/07/2020 07:00,3.54,39805,1428,168,123,1529,4,3252,5.840.595.238
02/07/2020 08:00,3.57,40433,1476,172,151,1694,6,3499,5.840.595.238
02/07/2020 09:00,3.72,40964,1564,177,184,1793,6,3724,5.840.595.238
02/07/2020 10:00,3.33,40959,1618,179,212,1955,6,3970,5.840.595.238
02/07/2020 11:00,3.2,40814,1638,179,240,2152,8,4217,5.840.595.238
02/07/2020 12:00,3.1,40628,1645,180,269,2271,15,4380,5.840.595.238
02/07/2020 13:00,2.84,40458,1700,184,276,2309,13,4482,5.840.595.238
02/07/2020 14:00,2.71,39924,1741,183,272,2390,11,4597,5.840.595.238
02/07/2020 15:00,2.44,39650,1746,177,263,2443,15,4644,5.840.595.238
02/07/2020 16:00,2.29,39556,1735,164,235,2404,19,4557,5.840.595.238
02/07/2020 17:00,2.43,39077,1805,144,194,2292,20,4455,5.840.595.238
02/07/2020 18:00,2.57,38533,1755,126,152,2139,16,4188,5.840.595.238
02/07/2020 19:00,2.29,37584,1633,116,124,1979,11,3863,5.840.595.238
02/07/2020 20:00,2.11,36938,1445,111,106,1875,10,3547,5.840.595.238
02/07/2020 21:00,2,36004,1330,108,98,1846,9,3391,5.840.595.238
02/07/2020 22:00,1.66,34454,1298,99,93,1877,10,3377,5.840.595.238
02/07/2020 23:00,1.62,32815,876,64,72,1833,13,2858,5.840.595.238
03/07/2020 00:00,1.51,31741,918,60,69,1832,13,2892,5.840.595.238
03/07/2020 01:00,1.45,31204,905,55,62,1863,11,2896,5.840.595.238
03/07/2020 02:00,1.43,30925,846,48,55,1789,9,2747,5.840.595.238
03/07/2020 03:00,1.45,31002,775,41,43,1750,8,2617,5.840.595.238
03/07/2020 04:00,1.56,32469,737,34,33,1744,8,2556,5.840.595.238
03/07/2020 05:00,1.77,35587,668,27,22,1740,5,2462,5.840.595.238
03/07/2020 06:00,2.39,38803,638,24,17,1775,4,2458,5.840.595.238
03/07/2020 07:00,2.75,40480,718,25,15,1885,8,2651,5.840.595.238
03/07/2020 08:00,2.91,41116,753,28,18,2032,9,2840,5.840.595.238
03/07/2020 09:00,2.71,41491,786,31,20,2169,11,3017,5.840.595.238
03/07/2020 10:00,2.46,41323,884,32,21,2283,11,3231,5.840.595.238
03/07/2020 11:00,2.36,41012,1066,29,17,2302,12,3426,5.840.595.238
03/07/2020 12:00,1.93,40555,1279,24,17,2267,11,3598,5.840.595.238
03/07/2020 13:00,1.82,39982,1511,21,20,2447,10,4009,5.840.595.238
03/07/2020 14:00,1.72,39360,1802,21,26,2543,11,4403,5.840.595.238
03/07/2020 15:00,1.71,38987,1994,21,34,2617,8,4674,5.840.595.238
03/07/2020 16:00,1.75,38955,2111,21,38,2772,7,4949,5.840.595.238
03/07/2020 17:00,1.76,38459,2233,23,45,2685,8,4994,5.840.595.238
03/07/2020 18:00,1.71,37700,2256,27,55,2448,8,4794,5.840.595.238
03/07/2020 19:00,1.68,36603,2283,32,61,2359,6,4741,5.840.595.238
03/07/2020 20:00,1.67,35864,2338,39,71,2317,4,4769,5.840.595.238
03/07/2020 21:00,1.65,35223,2444,49,80,2403,7,4983,5.840.595.238
03/07/2020 22:00,1.52,33978,2594,61,83,2538,9,5285,5.840.595.238
03/07/2020 23:00,1.5,32357,3358,10,68,2607,13,6056,5.840.595.238
04/07/2020 00:00,1.31,31355,3567,11,73,2636,18,6305,5.840.595.238
04/07/2020 01:00,1.21,30691,3732,12,74,2636,19,6473,5.840.595.238
04/07/2020 02:00,1.08,30179,3846,12,72,2586,16,6532,5.840.595.238
04/07/2020 03:00,0.95,29780,3878,11,65,2418,15,6387,5.840.595.238
04/07/2020 04:00,1.11,29931,3879,9,63,2325,11,6287,5.840.595.238
04/07/2020 05:00,1.29,30753,3568,6,68,2256,7,5905,5.840.595.238
04/07/2020 06:00,1.41,32096,3218,4,86,2255,9,5572,5.840.595.238
04/07/2020 07:00,1.54,33848,3278,3,120,2215,16,5632,5.840.595.238
04/07/2020 08:00,1.53,35370,3178,4,154,2260,31,5627,5.840.595.238
04/07/2020 09:00,1.45,36262,3061,4,196,2357,47,5665,5.840.595.238
04/07/2020 10:00,1.37,36384,2882,5,227,2467,43,5624,5.840.595.238
04/07/2020 11:00,1.32,36114,2639,7,247,2386,45,5324,5.840.595.238
04/07/2020 12:00,1.29,35780,2384,8,254,2366,42,5054,5.840.595.238
04/07/2020 13:00,1.38,35465,2293,7,246,2293,48,4887,5.840.595.238
04/07/2020 14:00,1.51,35316,2172,7,208,2092,48,4527,5.840.595.238
04/07/2020 15:00,1.82,35563,2006,6,167,1977,45,4201,5.840.595.238
04/07/2020 16:00,1.99,36002,1871,6,139,1988,41,4045,5.840.595.238
04/07/2020 17:00,2,35954,1738,6,120,1913,41,3818,5.840.595.238
04/07/2020 18:00,2,35356,1522,8,111,1797,34,3472,5.840.595.238
04/07/2020 19:00,1.9,34381,1460,11,111,1715,26,3323,5.840.595.238
04/07/2020 20:00,1.84,33945,1472,15,110,1671,16,3284,5.840.595.238
04/07/2020 21:00,1.76,33575,1474,19,111,1633,13,3250,5.840.595.238
04/07/2020 22:00,1.66,32601,1460,20,108,1696,13,3297,5.840.595.238
04/07/2020 23:00,1.74,31001,1885,17,121,1837,21,3881,5.840.595.238
05/07/2020 00:00,1.4,30017,1828,18,142,1913,21,3922,5.840.595.238
05/07/2020 01:00,0.9,29475,1892,18,173,1907,26,4016,5.840.595.238
05/07/2020 02:00,0.33,29028,1907,18,208,1903,29,4065,5.840.595.238
05/07/2020 03:00,0.11,28541,1990,17,245,1877,37,4166,5.840.595.238
05/07/2020 04:00,0.09,28544,2232,13,270,1683,43,4241,5.840.595.238
05/07/2020 05:00,0.21,29115,2437,9,270,1667,45,4428,5.840.595.238
05/07/2020 06:00,0.49,30257,2652,5,268,1713,44,4682,5.840.595.238
05/07/2020 07:00,0.59,31825,3156,3,271,1938,45,5413,5.840.595.238
05/07/2020 08:00,0.91,33233,3616,4,269,2206,44,6139,5.840.595.238
05/07/2020 09:00,0.92,34203,4067,8,262,2486,37,6860,5.840.595.238
05/07/2020 10:00,0.87,34677,4310,15,254,2888,35,7502,5.840.595.238
05/07/2020 11:00,0.53,34757,4411,22,237,3254,32,7956,5.840.595.238
05/07/2020 12:00,0.16,34663,4352,28,220,3697,30,8327,5.840.595.238
05/07/2020 13:00,0.08,34457,4345,33,212,4185,25,8800,5.840.595.238
05/07/2020 14:00,0.06,34392,4395,38,210,4445,27,9115,5.840.595.238
05/07/2020 15:00,0.06,34558,4483,43,207,4858,27,9618,5.840.595.238
05/07/2020 16:00,0.09,35049,4521,45,206,4929,31,9732,5.840.595.238
05/07/2020 17:00,0.93,35308,4599,46,210,4695,26,9576,5.840.595.238
05/07/2020 18:00,1.36,35235,4405,49,214,4636,33,9337,5.840.595.238
05/07/2020 19:00,1.41,34653,4169,53,220,4831,37,9310,5.840.595.238
05/07/2020 20:00,1.4,34360,4019,56,244,4944,35,9298,5.840.595.238
05/07/2020 21:00,1.37,33840,3980,58,268,5069,37,9412,5.840.595.238
05/07/2020 22:00,1.24,32594,3993,58,277,5065,40,9433,5.840.595.238
05/07/2020 23:00,0.18,30638,3843,83,267,5328,50,9571,5.840.595.238
06/07/2020 00:00,0.05,29814,3910,88,254,5443,51,9746,5.994.345.238
06/07/2020 01:00,0.01,29350,3891,89,241,5504,52,9777,5.994.345.238
06/07/2020 02:00,0.02,29182,3769,87,233,5366,51,9506,5.994.345.238
06/07/2020 03:00,0.01,29367,3727,81,230,5270,49,9357,5.994.345.238
06/07/2020 04:00,0.08,30689,3763,73,218,5572,48,9674,5.994.345.238
06/07/2020 05:00,1,33615,3554,67,204,5662,49,9536,5.994.345.238
06/07/2020 06:00,1.4,36800,3386,62,201,5747,52,9448,5.994.345.238
06/07/2020 07:00,1.52,38490,3508,62,202,5479,52,9303,5.994.345.238
06/07/2020 08:00,1.52,39190,3675,65,210,5367,50,9367,5.994.345.238
06/07/2020 09:00,1.47,39628,3832,69,223,5170,49,9343,5.994.345.238
06/07/2020 10:00,1.35,39844,4049,75,230,5158,49,9561,5.994.345.238
06/07/2020 11:00,1.38,39683,4217,79,234,5178,49,9757,5.994.345.238
06/07/2020 12:00,1.24,39658,4238,80,226,5014,50,9608,5.994.345.238
06/07/2020 13:00,1.08,39351,4236,80,221,4830,49,9416,5.994.345.238
06/07/2020 14:00,1.07,38991,4265,77,222,4804,47,9415,5.994.345.238
06/07/2020 15:00,1.14,38600,4318,69,231,4441,43,9102,5.994.345.238
06/07/2020 16:00,1.37,38478,4409,60,236,4293,45,9043,5.994.345.238
06/07/2020 17:00,1.52,38102,4468,49,219,4105,49,8890,5.994.345.238
06/07/2020 18:00,1.52,37546,4386,41,205,4059,45,8736,5.994.345.238
06/07/2020 19:00,1.5,36553,4263,36,194,3941,45,8479,5.994.345.238
06/07/2020 20:00,1.47,35869,4202,38,200,4077,44,8561,5.994.345.238
06/07/2020 21:00,1.4,35125,4256,43,208,4136,44,8687,5.994.345.238
06/07/2020 22:00,1.26,33826,4213,46,217,4073,42,8591,5.994.345.238
06/07/2020 23:00,0.57,32039,4274,220,280,4114,51,8939,5.994.345.238
07/07/2020 00:00,0.26,30995,4124,214,291,4148,55,8832,5.994.345.238
07/07/2020 01:00,0.11,30482,3975,208,297,4174,55,8709,5.994.345.238
07/07/2020 02:00,0.09,30246,3853,204,305,4173,55,8590,5.994.345.238
07/07/2020 03:00,0.21,30255,3707,25,310,4130,53,8225,5.994.345.238
07/07/2020 04:00,1.01,31503,3685,195,307,4067,49,8303,5.994.345.238
07/07/2020 05:00,1.47,34241,3461,196,307,3897,47,7908,5.994.345.238
07/07/2020 06:00,1.69,37209,3280,199,323,3637,41,7480,5.994.345.238
07/07/2020 07:00,1.92,38853,3311,201,330,3418,32,7292,5.994.345.238
07/07/2020 08:00,2.12,39607,3292,204,325,3278,22,7121,5.994.345.238
07/07/2020 09:00,2.42,40058,3265,206,329,3225,21,7046,5.994.345.238
07/07/2020 10:00,2.46,40185,3317,208,326,3111,25,6987,5.994.345.238
07/07/2020 11:00,2.39,40154,3343,210,326,3005,28,6912,5.994.345.238
07/07/2020 12:00,2.39,39986,3309,211,321,2898,27,6766,5.994.345.238
07/07/2020 13:00,2.34,39867,3290,209,315,2762,20,6596,5.994.345.238
07/07/2020 14:00,2.19,39510,3401,206,310,2662,20,6599,5.994.345.238
07/07/2020 15:00,2.15,39096,3471,200,300,2626,27,6624,5.994.345.238
07/07/2020 16:00,2.42,39116,3438,189,284,2587,27,6525,5.994.345.238
07/07/2020 17:00,2.57,38777,3390,179,254,2340,28,6191,5.994.345.238
07/07/2020 18:00,2.49,38176,3188,172,223,2177,25,5785,5.994.345.238
07/07/2020 19:00,2.31,37279,2959,169,197,2068,20,5413,5.994.345.238
07/07/2020 20:00,2.1,36653,2774,169,191,2065,17,5216,5.994.345.238
07/07/2020 21:00,1.85,35766,2624,168,190,2059,16,5057,5.994.345.238
07/07/2020 22:00,1.7,34210,2460,167,177,2225,15,5044,5.994.345.238
07/07/2020 23:00,1.53,32473,2555,163,0,2257,15,4990,5.994.345.238
08/07/2020 00:00,1.48,31385,2517,165,0,2349,16,5047,5.994.345.238
08/07/2020 01:00,1.43,30824,2487,169,0,2456,19,5131,5.994.345.238
08/07/2020 02:00,1.42,30543,2378,171,0,2458,17,5024,5.994.345.238
08/07/2020 03:00,1.43,30548,2233,172,0,2356,18,4779,5.994.345.238
08/07/2020 04:00,1.55,31790,2205,170,0,2194,16,4585,5.994.345.238
08/07/2020 05:00,1.92,34612,1974,163,0,1987,16,4140,5.994.345.238
08/07/2020 06:00,2.86,37508,1856,150,0,1911,21,3938,5.994.345.238
08/07/2020 07:00,3.31,38994,1934,136,0,1805,15,3890,5.994.345.238
08/07/2020 08:00,3.66,39637,1977,125,0,1727,10,3839,5.994.345.238
08/07/2020 09:00,3.93,40100,1974,121,0,1688,12,3795,5.994.345.238
08/07/2020 10:00,3.87,40104,2019,120,0,1689,15,3843,5.994.345.238
08/07/2020 11:00,3.7,39862,2029,122,0,1659,23,3833,5.994.345.238
08/07/2020 12:00,3.46,39730,2093,124,0,1702,31,3950,5.994.345.238
08/07/2020 13:00,3.31,39581,2162,122,0,1720,39,4043,5.994.345.238
08/07/2020 14:00,3.06,39227,2299,111,0,1773,46,4229,5.994.345.238
08/07/2020 15:00,2.98,38862,2415,91,0,1637,49,4192,5.994.345.238
08/07/2020 16:00,3.03,38741,2406,70,0,1539,46,4061,5.994.345.238
08/07/2020 17:00,2.99,38430,2392,54,0,1498,44,3988,5.994.345.238
08/07/2020 18:00,2.78,37791,2264,43,0,1416,31,3754,5.994.345.238
08/07/2020 19:00,2.38,36944,2044,36,0,1476,22,3578,5.994.345.238
08/07/2020 20:00,2.15,36294,1820,36,0,1552,17,3425,5.994.345.238
08/07/2020 21:00,2.09,35519,1605,37,0,1831,21,3494,5.994.345.238
08/07/2020 22:00,1.8,33951,1532,41,0,2036,22,3631,5.994.345.238
08/07/2020 23:00,2.29,32096,1487,39,146,2053,21,3746,5.994.345.238
09/07/2020 00:00,1.94,31134,1371,41,143,2343,21,3919,5.994.345.238
09/07/2020 01:00,1.84,30625,1285,45,137,2411,18,3896,5.994.345.238
09/07/2020 02:00,1.8,30413,1180,45,129,2380,18,3752,5.994.345.238
09/07/2020 03:00,1.78,30451,1067,42,124,2353,17,3603,5.994.345.238
09/07/2020 04:00,2.06,31606,993,41,111,2176,16,3337,5.994.345.238
09/07/2020 05:00,3.02,34218,829,41,102,1996,16,2984,5.994.345.238
09/07/2020 06:00,3.73,37065,734,46,103,1763,16,2662,5.994.345.238
09/07/2020 07:00,5.2,38679,723,48,106,1475,17,2369,5.994.345.238
09/07/2020 08:00,5.42,39301,684,45,114,1218,16,2077,5.994.345.238
09/07/2020 09:00,5.64,39815,608,48,124,1083,20,1883,5.994.345.238
09/07/2020 10:00,5.48,39850,525,48,129,1038,20,1760,5.994.345.238
09/07/2020 11:00,5.45,39609,478,47,134,999,22,1680,5.994.345.238
09/07/2020 12:00,5.48,39336,455,49,130,955,28,1617,5.994.345.238
09/07/2020 13:00,5.13,38981,414,53,123,937,27,1554,5.994.345.238
09/07/2020 14:00,4.89,38602,388,52,108,906,24,1478,5.994.345.238
09/07/2020 15:00,4.7,38295,382,61,94,920,23,1480,5.994.345.238
09/07/2020 16:00,4.35,38225,391,61,73,869,21,1415,5.994.345.238
09/07/2020 17:00,4.37,37822,385,54,46,825,18,1328,5.994.345.238
09/07/2020 18:00,4.53,37291,379,49,33,789,17,1267,5.994.345.238
09/07/2020 19:00,3.83,36445,369,48,22,888,12,1339,5.994.345.238
09/07/2020 20:00,3.5,35898,375,50,22,1034,9,1490,5.994.345.238
09/07/2020 21:00,3.09,35093,398,54,28,1202,8,1690,5.994.345.238
09/07/2020 22:00,2.58,33688,428,57,34,1271,9,1799,5.994.345.238
09/07/2020 23:00,2.41,32054,428,54,92,1338,5,1917,5.994.345.238
10/07/2020 00:00,2.13,31039,407,55,97,1470,6,2035,5.994.345.238
10/07/2020 01:00,1.97,30577,410,52,104,1618,6,2190,5.994.345.238
10/07/2020 02:00,1.87,30360,396,49,113,1638,5,2201,5.994.345.238
10/07/2020 03:00,1.9,30366,383,43,124,1548,5,2103,5.994.345.238
10/07/2020 04:00,2.29,31557,367,35,121,1306,5,1834,5.994.345.238
10/07/2020 05:00,3.13,34092,334,31,111,1099,5,1580,5.994.345.238
10/07/2020 06:00,3.93,36708,342,37,103,1072,5,1559,5.994.345.238
10/07/2020 07:00,5.19,38235,392,41,98,847,4,1382,5.994.345.238
10/07/2020 08:00,5.21,38956,428,48,102,718,4,1300,5.994.345.238
10/07/2020 09:00,5.28,39429,472,57,106,685,4,1324,5.994.345.238
10/07/2020 10:00,5.12,39352,553,71,114,677,4,1419,5.994.345.238
10/07/2020 11:00,5.09,38938,669,77,136,683,4,1569,5.994.345.238
10/07/2020 12:00,5,38532,819,77,147,656,4,1703,5.994.345.238
10/07/2020 13:00,4.57,38222,994,70,142,601,4,1811,5.994.345.238
10/07/2020 14:00,4.2,37749,1283,67,114,517,4,1985,5.994.345.238
10/07/2020 15:00,3.84,37493,1616,59,89,478,4,2246,5.994.345.238
10/07/2020 16:00,3.86,37325,1829,48,65,452,4,2398,5.994.345.238
10/07/2020 17:00,3.81,36874,2034,37,43,440,3,2557,5.994.345.238
10/07/2020 18:00,3.61,36255,2223,28,32,536,3,2822,5.994.345.238
10/07/2020 19:00,3,35256,2270,24,32,492,3,2821,5.994.345.238
10/07/2020 20:00,2.83,34584,2329,24,58,572,4,2987,5.994.345.238
10/07/2020 21:00,2.32,33973,2607,26,90,715,4,3442,5.994.345.238
10/07/2020 22:00,1.92,32849,2754,29,113,804,6,3706,5.994.345.238
10/07/2020 23:00,1.81,30821,3238,36,234,859,2,4369,5.994.345.238
11/07/2020 00:00,1.75,29923,3302,38,289,901,3,4533,5.994.345.238
11/07/2020 01:00,1.69,29399,3385,43,360,983,5,4776,5.994.345.238
11/07/2020 02:00,1.62,29015,3405,49,406,1059,11,4930,5.994.345.238
11/07/2020 03:00,1.58,28680,3363,55,430,1105,20,4973,5.994.345.238
11/07/2020 04:00,1.59,28812,3268,54,428,1123,32,4905,5.994.345.238
11/07/2020 05:00,1.67,29546,3111,52,419,1130,40,4752,5.994.345.238
11/07/2020 06:00,1.92,30750,2953,60,418,1143,49,4623,5.994.345.238
11/07/2020 07:00,1.98,32403,2983,69,410,1150,44,4656,5.994.345.238
11/07/2020 08:00,2.29,33928,2938,85,400,1151,47,4621,5.994.345.238
11/07/2020 09:00,2.63,34791,2895,104,390,1191,50,4630,5.994.345.238
11/07/2020 10:00,2.51,35002,2932,131,377,1245,44,4729,5.994.345.238
11/07/2020 11:00,2.16,34844,3022,154,360,1316,43,4895,5.994.345.238
11/07/2020 12:00,1.96,34583,3146,158,330,1451,32,5117,5.994.345.238
11/07/2020 13:00,1.86,34291,3202,157,308,1650,27,5344,5.994.345.238
11/07/2020 14:00,1.78,34126,3338,162,291,1660,20,5471,5.994.345.238
11/07/2020 15:00,1.86,34327,3494,169,262,1768,15,5708,5.994.345.238
11/07/2020 16:00,2.01,34697,3473,170,233,1771,10,5657,5.994.345.238
11/07/2020 17:00,2.8,34758,3401,165,206,1737,10,5519,5.994.345.238
11/07/2020 18:00,2.68,34218,3182,161,176,1583,9,5111,5.994.345.238
11/07/2020 19:00,2.49,33287,2863,155,148,1540,7,4713,5.994.345.238
11/07/2020 20:00,2.53,32943,2601,148,129,1788,6,4672,5.994.345.238
11/07/2020 21:00,2.28,32617,2503,140,122,2010,6,4781,5.994.345.238
11/07/2020 22:00,2.01,31680,2452,128,118,2384,6,5088,5.994.345.238
11/07/2020 23:00,1.9,30722,2339,123,142,2323,7,4934,5.994.345.238
12/07/2020 00:00,1.73,29742,2259,118,136,2367,7,4887,5.994.345.238
12/07/2020 01:00,1.65,29207,2269,115,133,2395,8,4920,5.994.345.238
12/07/2020 02:00,1.6,28847,2230,110,126,2396,7,4869,5.994.345.238
12/07/2020 03:00,1.59,28452,2187,107,117,2281,6,4698,5.994.345.238
12/07/2020 04:00,1.61,28411,2158,100,108,2068,7,4441,5.994.345.238
12/07/2020 05:00,1.64,28955,2120,91,98,1812,6,4127,5.994.345.238
12/07/2020 06:00,1.7,30021,2128,83,101,1621,8,3941,5.994.345.238
12/07/2020 07:00,1.79,31415,2283,73,120,1605,7,4088,5.994.345.238
12/07/2020 08:00,1.98,32663,2357,67,142,1507,7,4080,5.994.345.238
12/07/2020 09:00,2.13,33570,2443,61,162,1485,9,4160,5.994.345.238
12/07/2020 10:00,2.22,33956,2526,61,185,1596,9,4377,5.994.345.238
12/07/2020 11:00,2.18,34005,2527,62,209,1655,13,4466,5.994.345.238
12/07/2020 12:00,2.01,33886,2550,66,220,1770,13,4619,5.994.345.238
12/07/2020 13:00,1.96,33720,2524,71,235,1840,15,4685,5.994.345.238
12/07/2020 14:00,1.91,33787,2595,78,239,1870,14,4796,5.994.345.238
12/07/2020 15:00,1.94,33911,2690,93,236,1901,14,4934,5.994.345.238
12/07/2020 16:00,2.15,34374,2635,108,225,1848,14,4830,5.994.345.238
12/07/2020 17:00,3.05,34654,2522,129,199,1745,14,4609,5.994.345.238
12/07/2020 18:00,3.42,34484,2306,153,167,1598,13,4237,5.994.345.238
12/07/2020 19:00,3.47,33852,2046,178,135,1453,8,3820,5.994.345.238
12/07/2020 20:00,3.39,33521,1826,198,115,1633,5,3777,5.994.345.238
12/07/2020 21:00,3.21,33144,1787,210,108,1753,4,3862,5.994.345.238
12/07/2020 22:00,2.54,31993,1757,217,104,1876,3,3957,5.994.345.238
12/07/2020 23:00,1.92,30578,1678,40,91,2051,5,3865,5.994.345.238
13/07/2020 00:00,1.76,29739,1647,39,87,2146,5,3924,6.191.369.048
13/07/2020 01:00,1.7,29319,1579,38,80,2035,5,3737,6.191.369.048
13/07/2020 02:00,1.69,29131,1450,36,79,2052,4,3621,6.191.369.048
13/07/2020 03:00,1.75,29213,1328,31,76,2127,4,3566,6.191.369.048
13/07/2020 04:00,2.17,30307,1194,23,67,2105,7,3396,6.191.369.048
13/07/2020 05:00,3.27,32851,1058,15,49,1802,5,2929,6.191.369.048
13/07/2020 06:00,3.47,35779,1033,10,40,1764,4,2851,6.191.369.048
13/07/2020 07:00,4.37,37477,1032,10,57,1565,4,2668,6.191.369.048
13/07/2020 08:00,5.08,38277,966,13,74,1412,4,2469,6.191.369.048
13/07/2020 09:00,5.17,38689,922,15,90,1385,5,2417,6.191.369.048
13/07/2020 10:00,5.13,38733,922,16,107,1368,5,2418,6.191.369.048
13/07/2020 11:00,4.93,38573,864,16,128,1394,7,2409,6.191.369.048
13/07/2020 12:00,4.44,38376,859,14,136,1448,9,2466,6.191.369.048
13/07/2020 13:00,4.25,38242,818,11,145,1426,10,2410,6.191.369.048
13/07/2020 14:00,4.02,37871,819,9,150,1365,9,2352,6.191.369.048
13/07/2020 15:00,3.82,37519,827,6,149,1355,9,2346,6.191.369.048
13/07/2020 16:00,3.78,37419,766,5,141,1338,9,2259,6.191.369.048
13/07/2020 17:00,4,37071,697,4,124,1181,6,2012,6.191.369.048
13/07/2020 18:00,3.8,36638,646,5,107,1082,5,1845,6.191.369.048
13/07/2020 19:00,3.45,35712,604,6,92,1079,4,1785,6.191.369.048
13/07/2020 20:00,3.33,35111,600,8,79,1095,3,1785,6.191.369.048
13/07/2020 21:00,3.15,34447,658,12,69,1160,4,1903,6.191.369.048
13/07/2020 22:00,2.44,33064,728,15,49,1197,4,1993,6.191.369.048
13/07/2020 23:00,2.21,31277,982,17,34,1073,4,2110,6.191.369.048
14/07/2020 00:00,2.13,30265,992,18,29,1047,4,2090,6.191.369.048
14/07/2020 01:00,1.96,29811,1115,18,24,939,3,2099,6.191.369.048
14/07/2020 02:00,1.94,29652,1249,17,21,842,3,2132,6.191.369.048
14/07/2020 03:00,1.95,29681,1393,15,20,741,3,2172,6.191.369.048
14/07/2020 04:00,2.23,30748,1481,12,20,604,3,2120,6.191.369.048
14/07/2020 05:00,3.19,33096,1412,8,18,510,3,1951,6.191.369.048
14/07/2020 06:00,3.82,35673,1341,6,18,478,2,1845,6.191.369.048
14/07/2020 07:00,4.42,37228,1231,5,23,471,3,1733,6.191.369.048
14/07/2020 08:00,4.99,37962,1097,6,28,497,3,1631,6.191.369.048
14/07/2020 09:00,5.08,38436,1002,8,34,550,3,1597,6.191.369.048
14/07/2020 10:00,5.07,38490,965,11,38,629,3,1646,6.191.369.048
14/07/2020 11:00,4.83,38386,791,17,43,713,3,1567,6.191.369.048
14/07/2020 12:00,4.43,38371,666,17,46,771,5,1505,6.191.369.048
14/07/2020 13:00,4.29,38164,606,20,47,796,6,1475,6.191.369.048
14/07/2020 14:00,4.04,37919,582,22,41,836,6,1487,6.191.369.048
14/07/2020 15:00,3.96,37643,528,24,40,836,5,1433,6.191.369.048
14/07/2020 16:00,3.94,37595,491,24,36,790,3,1344,6.191.369.048
14/07/2020 17:00,3.99,37223,431,24,28,864,3,1350,6.191.369.048
14/07/2020 18:00,3.96,36793,407,22,22,825,3,1279,6.191.369.048
14/07/2020 19:00,3.75,35964,386,22,20,833,3,1264,6.191.369.048
14/07/2020 20:00,3.7,35436,394,24,17,917,2,1354,6.191.369.048
14/07/2020 21:00,3.47,34641,398,27,14,955,2,1396,6.191.369.048
14/07/2020 22:00,2.67,33101,414,29,12,960,3,1418,6.191.369.048
14/07/2020 23:00,2.7,31102,363,23,5,955,2,1348,6.191.369.048
15/07/2020 00:00,2.24,30142,376,25,5,905,2,1313,6.191.369.048
15/07/2020 01:00,1.96,29686,359,25,5,832,2,1223,6.191.369.048
15/07/2020 02:00,1.87,29466,316,23,6,782,2,1129,6.191.369.048
15/07/2020 03:00,1.86,29486,303,18,6,668,2,997,6.191.369.048
15/07/2020 04:00,2.61,30449,305,12,7,551,3,878,6.191.369.048
15/07/2020 05:00,3.25,32659,307,8,6,481,3,805,6.191.369.048
15/07/2020 06:00,3.87,35106,296,7,5,436,2,746,6.191.369.048
15/07/2020 07:00,4.76,36467,289,7,5,411,2,714,6.191.369.048
15/07/2020 08:00,5.22,37221,299,8,5,419,2,733,6.191.369.048
15/07/2020 09:00,5.51,37754,308,9,5,455,2,779,6.191.369.048
15/07/2020 10:00,5.69,37802,328,10,6,497,2,843,6.191.369.048
15/07/2020 11:00,5.38,37626,349,10,9,539,3,910,6.191.369.048
15/07/2020 12:00,5.24,37541,381,10,10,603,3,1007,6.191.369.048
15/07/2020 13:00,5.03,37344,421,10,12,620,3,1066,6.191.369.048
15/07/2020 14:00,4.77,36990,502,9,11,640,4,1166,6.191.369.048
15/07/2020 15:00,4.44,36740,592,8,11,673,5,1289,6.191.369.048
15/07/2020 16:00,4.41,36656,625,8,10,625,7,1275,6.191.369.048
15/07/2020 17:00,4.34,36355,625,7,10,596,10,1248,6.191.369.048
15/07/2020 18:00,4,35852,621,7,13,541,8,1190,6.191.369.048
15/07/2020 19:00,3.72,35087,523,9,17,519,5,1073,6.191.369.048
15/07/2020 20:00,3.66,34622,436,13,21,582,5,1057,6.191.369.048
15/07/2020 21:00,3.45,33967,418,16,27,728,7,1196,6.191.369.048
15/07/2020 22:00,2.8,32564,433,19,35,798,7,1292,6.191.369.048
15/07/2020 23:00,2.91,30838,303,7,37,733,6,1086,6.191.369.048
16/07/2020 00:00,2.45,29897,325,6,47,700,7,1085,6.191.369.048
16/07/2020 01:00,2.02,29475,372,6,57,599,8,1042,6.191.369.048
16/07/2020 02:00,2,29239,397,5,56,499,8,965,6.191.369.048
16/07/2020 03:00,1.96,29230,394,5,52,419,8,878,6.191.369.048
16/07/2020 04:00,2.92,30183,359,5,43,359,8,774,6.191.369.048
16/07/2020 05:00,3.39,32345,318,3,34,297,7,659,6.191.369.048
16/07/2020 06:00,3.94,34737,308,2,26,247,3,586,6.191.369.048
16/07/2020 07:00,5.07,36220,324,2,23,233,2,584,6.191.369.048
16/07/2020 08:00,5.78,36902,334,2,28,251,3,618,6.191.369.048
16/07/2020 09:00,5.83,37412,360,4,32,287,3,686,6.191.369.048
16/07/2020 10:00,5.76,37445,372,6,34,331,4,747,6.191.369.048
16/07/2020 11:00,5.42,37256,380,9,35,372,4,800,6.191.369.048
16/07/2020 12:00,5.19,37068,391,12,29,429,6,867,6.191.369.048
16/07/2020 13:00,5.12,36814,385,13,27,471,7,903,6.191.369.048
16/07/2020 14:00,5.05,36543,406,13,24,500,7,950,6.191.369.048
16/07/2020 15:00,4.94,36310,424,13,24,530,9,1000,6.191.369.048
16/07/2020 16:00,4.99,36202,429,14,28,549,9,1029,6.191.369.048
16/07/2020 17:00,4.58,35913,394,14,33,562,7,1010,6.191.369.048
16/07/2020 18:00,4.28,35354,351,15,42,564,5,977,6.191.369.048
16/07/2020 19:00,3.73,34658,288,18,64,702,4,1076,6.191.369.048
16/07/2020 20:00,3.67,34272,274,22,89,927,7,1319,6.191.369.048
16/07/2020 21:00,3.35,33637,287,24,116,1253,7,1687,6.191.369.048
16/07/2020 22:00,2.94,32372,305,24,128,1485,5,1947,6.191.369.048
16/07/2020 23:00,2.91,30727,257,24,140,1611,7,2039,6.191.369.048
17/07/2020 00:00,2.48,29750,253,25,134,1612,7,2031,6.191.369.048
17/07/2020 01:00,2.17,29291,256,27,125,1580,4,1992,6.191.369.048
17/07/2020 02:00,2.07,29084,258,27,116,1360,4,1765,6.191.369.048
17/07/2020 03:00,1.98,29082,267,26,109,1377,4,1783,6.191.369.048
17/07/2020 04:00,2.63,30111,261,23,99,1204,4,1591,6.191.369.048
17/07/2020 05:00,3.11,32321,236,19,73,1036,3,1367,6.191.369.048
17/07/2020 06:00,3.72,34687,228,16,40,831,2,1117,6.191.369.048
17/07/2020 07:00,4.35,36234,244,17,25,757,1,1044,6.191.369.048
17/07/2020 08:00,5.35,36938,276,21,26,864,1,1188,6.191.369.048
17/07/2020 09:00,5.22,37429,318,25,31,1142,1,1517,6.191.369.048
17/07/2020 10:00,4.96,37364,364,27,32,1389,3,1815,6.191.369.048
17/07/2020 11:00,4.37,37007,374,28,30,1700,4,2136,6.191.369.048
17/07/2020 12:00,3.72,36612,405,29,29,2010,6,2479,6.191.369.048
17/07/2020 13:00,3.55,36169,422,31,29,2277,7,2766,6.191.369.048
17/07/2020 14:00,3.36,35785,449,33,27,2499,9,3017,6.191.369.048
17/07/2020 15:00,3.2,35529,459,36,25,2713,8,3241,6.191.369.048
17/07/2020 16:00,3.24,35460,440,40,26,2817,7,3330,6.191.369.048
17/07/2020 17:00,3.26,35153,383,41,32,2561,6,3023,6.191.369.048
17/07/2020 18:00,3.24,34541,342,43,37,2325,5,2752,6.191.369.048
17/07/2020 19:00,2.97,33592,268,45,54,2348,6,2721,6.191.369.048
17/07/2020 20:00,2.78,33021,207,46,61,2421,7,2742,6.191.369.048
17/07/2020 21:00,2.39,32541,185,44,63,2354,6,2652,6.191.369.048
17/07/2020 22:00,1.9,31429,194,41,66,2286,5,2592,6.191.369.048
17/07/2020 23:00,1.8,30471,492,27,31,2356,3,2909,6.191.369.048
18/07/2020 00:00,1.76,29474,533,30,30,2027,3,2623,6.191.369.048
18/07/2020 01:00,1.72,28928,582,34,27,1861,2,2506,6.191.369.048
18/07/2020 02:00,1.71,28552,628,36,26,1762,3,2455,6.191.369.048
18/07/2020 03:00,1.71,28172,635,37,26,1467,3,2168,6.191.369.048
18/07/2020 04:00,1.73,28145,653,39,23,1422,3,2140,6.191.369.048
18/07/2020 05:00,1.82,28757,697,44,18,1329,3,2091,6.191.369.048
18/07/2020 06:00,2.06,29864,732,60,11,1216,1,2020,6.191.369.048
18/07/2020 07:00,2.45,31388,781,74,6,1340,1,2202,6.191.369.048
18/07/2020 08:00,2.88,32786,828,99,5,1341,1,2274,6.191.369.048
18/07/2020 09:00,2.94,33675,882,141,5,1456,1,2485,6.191.369.048
18/07/2020 10:00,2.88,33873,939,178,6,1599,1,2723,6.191.369.048
18/07/2020 11:00,2.7,33684,1020,203,7,1674,1,2905,6.191.369.048
18/07/2020 12:00,2.45,33434,1024,210,10,1807,2,3053,6.191.369.048
18/07/2020 13:00,2.24,33207,1039,206,11,1939,3,3198,6.191.369.048
18/07/2020 14:00,2.42,33062,1063,199,12,1961,4,3239,6.191.369.048
18/07/2020 15:00,2.48,33222,1022,186,15,1992,3,3218,6.191.369.048
18/07/2020 16:00,2.75,33701,959,170,17,1978,4,3128,6.191.369.048
18/07/2020 17:00,2.98,33880,847,151,19,2024,3,3044,6.191.369.048
18/07/2020 18:00,2.98,33462,780,125,23,1989,2,2919,6.191.369.048
18/07/2020 19:00,2.87,32624,806,102,30,2095,2,3035,6.191.369.048
18/07/2020 20:00,2.88,32411,861,83,38,2151,3,3136,6.191.369.048
18/07/2020 21:00,2.49,32163,911,71,43,2504,3,3532,6.191.369.048
18/07/2020 22:00,2.01,31135,938,62,44,2622,3,3669,6.191.369.048
18/07/2020 23:00,1.74,29756,867,58,30,2833,3,3791,6.191.369.048
19/07/2020 00:00,1.67,28826,763,49,31,3049,2,3894,6.191.369.048
19/07/2020 01:00,1.62,28342,737,43,29,3004,3,3816,6.191.369.048
19/07/2020 02:00,1.6,28009,685,38,29,2830,2,3584,6.191.369.048
19/07/2020 03:00,1.58,27667,560,31,31,2657,2,3281,6.191.369.048
19/07/2020 04:00,1.63,27545,431,23,26,2433,2,2915,6.191.369.048
19/07/2020 05:00,1.72,28010,341,16,18,2116,2,2493,6.191.369.048
19/07/2020 06:00,1.85,29093,299,13,11,1942,2,2267,6.191.369.048
19/07/2020 07:00,2.09,30534,254,13,6,1870,1,2144,6.191.369.048
19/07/2020 08:00,2.5,31837,232,12,4,1985,1,2234,6.191.369.048
19/07/2020 09:00,2.8,32743,252,15,5,2109,1,2382,6.191.369.048
19/07/2020 10:00,2.83,33089,288,18,6,2115,1,2428,6.191.369.048
19/07/2020 11:00,2.94,33139,322,19,8,2219,2,2570,6.191.369.048
19/07/2020 12:00,2.92,32981,344,23,8,2154,3,2532,6.191.369.048
19/07/2020 13:00,2.71,32841,384,26,10,2125,4,2549,6.191.369.048
19/07/2020 14:00,2.91,32755,456,26,10,1977,5,2474,6.191.369.048
19/07/2020 15:00,2.96,32854,500,24,11,1974,4,2513,6.191.369.048
19/07/2020 16:00,2.99,33382,562,22,11,1865,4,2464,6.191.369.048
19/07/2020 17:00,3.23,33583,563,20,15,1604,3,2205,6.191.369.048
19/07/2020 18:00,3.29,33384,563,18,21,1521,3,2126,6.191.369.048
19/07/2020 19:00,3.23,32845,500,18,30,1512,3,2063,6.191.369.048
19/07/2020 20:00,3.2,32665,450,17,37,1577,3,2084,6.191.369.048
19/07/2020 21:00,2.99,32385,497,18,38,1618,3,2174,6.191.369.048
19/07/2020 22:00,2.46,31177,531,20,34,1604,2,2191,6.191.369.048
19/07/2020 23:00,2.09,29824,902,26,35,1516,3,2482,6.191.369.048
20/07/2020 00:00,1.82,28930,855,23,41,1619,4,2542,6.388.690.476
20/07/2020 01:00,1.77,28500,886,20,39,1595,6,2546,6.388.690.476
20/07/2020 02:00,1.76,28342,1060,17,36,1625,9,2747,6.388.690.476
20/07/2020 03:00,1.77,28461,1151,15,33,1456,9,2664,6.388.690.476
20/07/2020 04:00,2.22,29480,1129,12,30,1160,8,2339,6.388.690.476
20/07/2020 05:00,3.07,31768,1177,9,23,888,6,2103,6.388.690.476
20/07/2020 06:00,3.58,34402,1251,6,18,723,4,2002,6.388.690.476
20/07/2020 07:00,4.21,36110,1379,5,14,661,3,2062,6.388.690.476
20/07/2020 08:00,4.51,37000,1569,6,14,659,3,2251,6.388.690.476
20/07/2020 09:00,4.63,37562,1803,8,15,746,3,2575,6.388.690.476
20/07/2020 10:00,4.51,37686,1977,11,16,911,3,2918,6.388.690.476
20/07/2020 11:00,3.94,37528,2064,14,18,1039,4,3139,6.388.690.476
20/07/2020 12:00,3.86,37409,2143,15,24,1261,4,3447,6.388.690.476
20/07/2020 13:00,3.67,37180,2257,16,26,1439,4,3742,6.388.690.476
20/07/2020 14:00,3.45,36917,2534,17,25,1621,3,4200,6.388.690.476
20/07/2020 15:00,3.32,36584,2699,18,28,1818,3,4566,6.388.690.476
20/07/2020 16:00,3.36,36540,2845,19,42,1899,8,4813,6.388.690.476
20/07/2020 17:00,3.4,36213,2913,19,53,1872,5,4862,6.388.690.476
20/07/2020 18:00,3.36,35744,2843,20,48,1947,3,4861,6.388.690.476
20/07/2020 19:00,3.12,34927,2610,20,42,2106,2,4780,6.388.690.476
20/07/2020 20:00,2.97,34431,2361,21,38,2307,2,4729,6.388.690.476
20/07/2020 21:00,2.66,33693,2272,20,41,2508,2,4843,6.388.690.476
20/07/2020 22:00,1.96,32327,2276,17,53,2753,5,5104,6.388.690.476
20/07/2020 23:00,1.75,30400,2069,4,73,3174,8,5328,6.388.690.476
21/07/2020 00:00,1.64,29491,2004,4,81,3477,3,5569,6.388.690.476
21/07/2020 01:00,1.59,29100,1996,4,90,3588,2,5680,6.388.690.476
21/07/2020 02:00,1.58,28978,2007,4,101,3514,2,5628,6.388.690.476
21/07/2020 03:00,1.57,29016,1988,4,120,3586,4,5702,6.388.690.476
21/07/2020 04:00,1.7,29979,1935,4,142,3583,6,5670,6.388.690.476
21/07/2020 05:00,2.02,32132,1948,4,162,3491,9,5614,6.388.690.476
21/07/2020 06:00,2.94,34524,1962,3,190,3399,15,5569,6.388.690.476
21/07/2020 07:00,3.2,36187,2092,3,219,3259,14,5587,6.388.690.476
21/07/2020 08:00,3.37,37021,2196,4,248,3206,18,5672,6.388.690.476
21/07/2020 09:00,3.44,37670,2329,5,274,3213,18,5839,6.388.690.476
21/07/2020 10:00,3.36,37848,2406,6,293,3244,21,5970,6.388.690.476
21/07/2020 11:00,3.25,37726,2568,8,310,3287,22,6195,6.388.690.476
21/07/2020 12:00,3.2,37638,2655,10,322,3312,23,6322,6.388.690.476
21/07/2020 13:00,3.07,37365,2709,10,335,3269,23,6346,6.388.690.476
21/07/2020 14:00,2.89,37032,2908,9,341,3347,26,6631,6.388.690.476
21/07/2020 15:00,2.85,36737,2915,9,341,3305,30,6600,6.388.690.476
21/07/2020 16:00,2.98,36641,2918,8,334,3312,29,6601,6.388.690.476
21/07/2020 17:00,3.02,36292,2893,9,313,3182,27,6424,6.388.690.476
21/07/2020 18:00,3.05,35876,2759,9,274,3124,20,6186,6.388.690.476
21/07/2020 19:00,2.83,35045,2528,11,244,3081,17,5881,6.388.690.476
21/07/2020 20:00,2.75,34535,2305,15,233,3280,20,5853,6.388.690.476
21/07/2020 21:00,2.46,33799,2176,19,239,3525,14,5973,6.388.690.476
21/07/2020 22:00,1.86,32339,2150,21,250,3793,7,6221,6.388.690.476
21/07/2020 23:00,1.59,30888,2008,26,270,4026,15,6345,6.388.690.476
22/07/2020 00:00,1.51,29909,1926,24,291,4269,9,6519,6.388.690.476
22/07/2020 01:00,1.49,29494,1819,19,301,4448,19,6606,6.388.690.476
22/07/2020 02:00,1.48,29261,1784,13,300,4322,25,6444,6.388.690.476
22/07/2020 03:00,1.49,29284,1678,12,307,4270,18,6285,6.388.690.476
22/07/2020 04:00,1.54,30228,1578,12,308,4118,16,6032,6.388.690.476
22/07/2020 05:00,1.68,32396,1564,12,317,3755,21,5669,6.388.690.476
22/07/2020 06:00,2.01,34806,1622,14,349,3786,30,5801,6.388.690.476
22/07/2020 07:00,2.46,36317,1729,14,377,3711,43,5874,6.388.690.476
22/07/2020 08:00,2.68,37212,1809,18,382,3721,27,5957,6.388.690.476
22/07/2020 09:00,2.71,37842,1845,27,382,3859,19,6132,6.388.690.476
22/07/2020 10:00,2.65,37917,1832,37,379,3948,18,6214,6.388.690.476
22/07/2020 11:00,2.27,37629,1783,48,376,4044,33,6284,6.388.690.476
22/07/2020 12:00,2.21,37456,1747,59,369,4188,36,6399,6.388.690.476
22/07/2020 13:00,2.09,37221,1759,63,364,4278,36,6500,6.388.690.476
22/07/2020 14:00,2.07,36771,1911,71,344,4408,31,6765,6.388.690.476
22/07/2020 15:00,2.02,36474,1991,68,313,4511,27,6910,6.388.690.476
22/07/2020 16:00,2.03,36369,1994,66,280,4366,26,6732,6.388.690.476
22/07/2020 17:00,1.99,36174,2006,63,235,4376,20,6700,6.388.690.476
22/07/2020 18:00,1.96,35689,2000,57,196,4329,15,6597,6.388.690.476
22/07/2020 19:00,1.8,34927,1838,54,169,4415,16,6492,6.388.690.476
22/07/2020 20:00,1.77,34508,1595,54,152,4622,14,6437,6.388.690.476
22/07/2020 21:00,1.69,33899,1470,55,138,4806,14,6483,6.388.690.476
22/07/2020 22:00,1.56,32426,1410,54,138,4917,24,6543,6.388.690.476
22/07/2020 23:00,1.65,30740,1165,64,153,5064,14,6460,6.388.690.476
23/07/2020 00:00,1.57,29842,1086,63,148,5083,13,6393,6.388.690.476
23/07/2020 01:00,1.53,29465,1006,58,150,5046,12,6272,6.388.690.476
23/07/2020 02:00,1.51,29168,985,56,154,5107,9,6311,6.388.690.476
23/07/2020 03:00,1.5,29152,971,50,160,5057,9,6247,6.388.690.476
23/07/2020 04:00,1.62,30043,930,47,161,4909,8,6055,6.388.690.476
23/07/2020 05:00,1.82,32050,887,48,146,4821,14,5916,6.388.690.476
23/07/2020 06:00,2.12,34357,834,52,139,4775,19,5819,6.388.690.476
23/07/2020 07:00,2.31,35908,865,62,154,4696,23,5800,6.388.690.476
23/07/2020 08:00,2.29,36678,941,73,181,4700,19,5914,6.388.690.476
23/07/2020 09:00,2.29,37266,1038,92,203,4765,20,6118,6.388.690.476
23/07/2020 10:00,2.28,37358,1083,117,229,4962,27,6418,6.388.690.476
23/07/2020 11:00,2.15,37170,1139,143,261,5017,27,6587,6.388.690.476
23/07/2020 12:00,2.1,36867,1214,174,266,5060,28,6742,6.388.690.476
23/07/2020 13:00,2.03,36598,1258,191,269,5134,30,6882,6.388.690.476
23/07/2020 14:00,2.04,36344,1223,198,261,5084,31,6797,6.388.690.476
23/07/2020 15:00,1.98,36085,1137,201,245,4995,26,6604,6.388.690.476
23/07/2020 16:00,1.98,36011,1011,195,219,4819,24,6268,6.388.690.476
23/07/2020 17:00,2.02,35774,854,185,179,4687,21,5926,6.388.690.476
23/07/2020 18:00,2.04,35251,738,171,140,4450,14,5513,6.388.690.476
23/07/2020 19:00,1.94,34454,741,157,120,4349,7,5374,6.388.690.476
23/07/2020 20:00,1.95,34123,817,146,113,4337,6,5419,6.388.690.476
23/07/2020 21:00,1.89,33464,917,137,116,4265,7,5442,6.388.690.476
23/07/2020 22:00,1.75,32041,955,130,124,4195,11,5415,6.388.690.476
23/07/2020 23:00,1.6,30563,1888,129,144,4136,11,6308,6.388.690.476
24/07/2020 00:00,1.57,29490,2101,120,158,3986,17,6382,6.388.690.476
24/07/2020 01:00,1.53,29051,2194,112,173,3874,21,6374,6.388.690.476
24/07/2020 02:00,1.51,28853,2212,113,175,3735,16,6251,6.388.690.476
24/07/2020 03:00,1.52,28800,2250,117,172,3607,10,6156,6.388.690.476
24/07/2020 04:00,1.58,29755,2192,101,166,3476,13,5948,6.388.690.476
24/07/2020 05:00,1.94,31749,2096,103,157,3137,12,5505,6.388.690.476
24/07/2020 06:00,2.28,34015,1975,111,153,2966,11,5216,6.388.690.476
24/07/2020 07:00,2.53,35634,1883,116,160,2936,15,5110,6.388.690.476
24/07/2020 08:00,2.73,36431,1845,123,174,2825,21,4988,6.388.690.476
24/07/2020 09:00,2.92,37031,1825,127,189,2746,27,4914,6.388.690.476
24/07/2020 10:00,2.91,36937,1822,129,192,2736,33,4912,6.388.690.476
24/07/2020 11:00,2.67,36620,1788,135,187,2504,35,4649,6.388.690.476
24/07/2020 12:00,2.65,36268,1752,140,191,2344,29,4456,6.388.690.476
24/07/2020 13:00,2.64,35904,1757,138,187,2281,30,4393,6.388.690.476
24/07/2020 14:00,2.57,35464,1714,132,181,2103,22,4152,6.388.690.476
24/07/2020 15:00,2.5,35171,1610,121,174,1958,31,3894,6.388.690.476
24/07/2020 16:00,2.58,35072,1602,103,163,1844,25,3737,6.388.690.476
24/07/2020 17:00,2.53,34695,1479,84,155,1807,20,3545,6.388.690.476
24/07/2020 18:00,2.46,34033,1269,68,155,1705,29,3226,6.388.690.476
24/07/2020 19:00,2.36,33086,1026,58,159,1673,45,2961,6.388.690.476
24/07/2020 20:00,2.36,32653,905,53,160,1740,34,2892,6.388.690.476
24/07/2020 21:00,2.3,32097,814,51,163,1822,35,2885,6.388.690.476
24/07/2020 22:00,1.98,30754,744,48,167,1948,21,2928,6.388.690.476
24/07/2020 23:00,1.97,29815,754,19,166,1909,29,2877,6.388.690.476
25/07/2020 00:00,1.99,28786,625,20,168,1934,21,2768,6.388.690.476
25/07/2020 01:00,1.91,28294,579,20,165,1862,15,2641,6.388.690.476
25/07/2020 02:00,1.85,27974,538,19,161,1774,17,2509,6.388.690.476
25/07/2020 03:00,1.77,27606,508,18,156,1703,6,2391,6.388.690.476
25/07/2020 04:00,1.76,27558,473,15,143,1538,5,2174,6.388.690.476
25/07/2020 05:00,1.78,28219,441,10,126,1316,6,1899,6.388.690.476
25/07/2020 06:00,1.85,29363,401,6,113,1146,3,1669,6.388.690.476
25/07/2020 07:00,2.08,30917,394,5,109,1049,3,1560,6.388.690.476
25/07/2020 08:00,2.3,32267,474,5,111,1038,2,1630,6.388.690.476
25/07/2020 09:00,2.41,33155,618,7,114,1093,1,1833,6.388.690.476
25/07/2020 10:00,2.42,33265,745,10,114,1175,2,2046,6.388.690.476
25/07/2020 11:00,2.42,33113,932,13,113,1387,3,2448,6.388.690.476
25/07/2020 12:00,2.3,32888,1135,17,106,1545,4,2807,6.388.690.476
25/07/2020 13:00,2.23,32617,1253,19,96,1710,5,3083,6.388.690.476
25/07/2020 14:00,2.22,32469,1365,17,86,1716,5,3189,6.388.690.476
25/07/2020 15:00,2.26,32733,1313,13,74,1674,4,3078,6.388.690.476
25/07/2020 16:00,2.38,33105,1228,9,62,1477,3,2779,6.388.690.476
25/07/2020 17:00,2.44,33168,1208,7,45,1286,2,2548,6.388.690.476
25/07/2020 18:00,2.41,32829,1217,6,38,1071,1,2333,6.388.690.476
25/07/2020 19:00,2.29,31923,1254,6,32,1018,1,2311,6.388.690.476
25/07/2020 20:00,2.29,31772,1314,6,25,1023,1,2369,6.388.690.476
25/07/2020 21:00,2.28,31346,1273,6,19,1129,1,2428,6.388.690.476
25/07/2020 22:00,2,30111,1269,8,15,1243,1,2536,6.388.690.476
25/07/2020 23:00,1.84,29642,1659,7,11,1318,2,2997,6.388.690.476
26/07/2020 00:00,1.79,28699,1606,7,11,1361,2,2987,6.388.690.476
26/07/2020 01:00,1.83,28223,1571,6,12,1453,3,3045,6.388.690.476
26/07/2020 02:00,1.81,27944,1593,6,13,1486,3,3101,6.388.690.476
26/07/2020 03:00,1.75,27594,1535,5,19,1571,4,3134,6.388.690.476
26/07/2020 04:00,1.69,27424,1457,4,22,1656,5,3144,6.388.690.476
26/07/2020 05:00,1.72,27986,1522,3,20,1538,8,3091,6.388.690.476
26/07/2020 06:00,1.8,29131,1585,1,17,1440,6,3049,6.388.690.476
26/07/2020 07:00,1.94,30433,1738,1,16,1456,5,3216,6.388.690.476
26/07/2020 08:00,2.02,31757,1866,2,18,1560,6,3452,6.388.690.476
26/07/2020 09:00,1.95,32676,2180,2,20,1918,8,4128,6.388.690.476
26/07/2020 10:00,1.66,33137,2360,4,20,2240,7,4631,6.388.690.476
26/07/2020 11:00,1.45,33235,2531,4,20,2622,7,5184,6.388.690.476
26/07/2020 12:00,1.33,33265,2575,5,20,2639,6,5245,6.388.690.476
26/07/2020 13:00,1.16,33220,2584,6,23,2656,4,5273,6.388.690.476
26/07/2020 14:00,1.21,33153,2483,5,25,2719,3,5235,6.388.690.476
26/07/2020 15:00,1.42,33299,2291,4,30,2962,3,5290,6.388.690.476
26/07/2020 16:00,1.78,33758,2390,3,38,2891,3,5325,6.388.690.476
26/07/2020 17:00,1.91,33641,2435,3,58,2779,4,5279,6.388.690.476
26/07/2020 18:00,1.97,33405,2333,3,88,2712,5,5141,6.388.690.476
26/07/2020 19:00,1.89,32722,2134,3,130,2893,7,5167,6.388.690.476
26/07/2020 20:00,1.85,32577,1954,4,167,2947,14,5086,6.388.690.476
26/07/2020 21:00,1.8,32162,1789,5,194,3066,21,5075,6.388.690.476
26/07/2020 22:00,1.65,30698,1720,7,188,3105,23,5043,6.388.690.476
26/07/2020 23:00,1.52,29378,1221,67,154,3104,24,4570,6.388.690.476
27/07/2020 00:00,1.49,28578,1190,61,134,3059,24,4468,664.75
27/07/2020 01:00,1.48,28227,1194,57,99,2938,19,4307,664.75
27/07/2020 02:00,1.47,28118,1111,57,64,2956,7,4195,664.75
27/07/2020 03:00,1.49,28233,1082,62,46,2703,9,3902,664.75
27/07/2020 04:00,1.59,29163,1048,63,32,2526,7,3676,664.75
27/07/2020 05:00,1.76,31327,1107,63,17,2502,4,3693,664.75
27/07/2020 06:00,1.98,33837,1120,67,12,2307,2,3508,664.75
27/07/2020 07:00,2.14,35529,1171,69,11,2290,2,3543,664.75
27/07/2020 08:00,2.31,36401,1341,77,14,2145,1,3578,664.75
27/07/2020 09:00,2.35,36911,1539,85,18,2099,2,3743,664.75
27/07/2020 10:00,2.32,36989,1642,93,24,2132,2,3893,664.75
27/07/2020 11:00,2.3,36876,1656,101,29,2123,2,3911,664.75
27/07/2020 12:00,2.26,36614,1610,104,32,2140,2,3888,664.75
27/07/2020 13:00,2.24,36237,1660,98,40,2031,2,3831,664.75
27/07/2020 14:00,2.3,35890,1604,97,47,1995,1,3744,664.75
27/07/2020 15:00,2.35,35590,1408,93,44,1829,2,3376,664.75
27/07/2020 16:00,2.39,35577,1386,80,37,1531,2,3036,664.75
27/07/2020 17:00,2.36,35218,1328,73,33,1366,2,2802,664.75
27/07/2020 18:00,2.33,34726,1246,76,30,1231,1,2584,664.75
27/07/2020 19:00,2.2,33984,1291,77,32,1355,1,2756,664.75
27/07/2020 20:00,2.1,33629,1498,78,31,1502,1,3110,664.75
27/07/2020 21:00,2,33019,1866,80,29,1674,1,3650,664.75
27/07/2020 22:00,1.79,31681,2113,75,23,1729,1,3941,664.75
27/07/2020 23:00,1.53,30403,2750,86,7,1752,0,4595,664.75
28/07/2020 00:00,1.48,29417,3036,88,5,1718,0,4847,664.75
28/07/2020 01:00,1.46,29019,3269,86,3,1666,0,5024,664.75
28/07/2020 02:00,1.45,28914,3364,83,3,1630,0,5080,664.75
28/07/2020 03:00,1.45,28842,3262,78,3,1640,0,4983,664.75
28/07/2020 04:00,1.48,29742,2966,68,5,1687,0,4726,664.75
28/07/2020 05:00,1.6,31873,2808,52,8,1700,0,4568,664.75
28/07/2020 06:00,1.81,34205,2607,35,9,1798,0,4449,664.75
28/07/2020 07:00,1.98,35787,2513,25,12,1936,0,4486,664.75
28/07/2020 08:00,2.05,36692,2648,20,19,2077,1,4765,664.75
28/07/2020 09:00,2.02,37259,2839,19,25,2291,2,5176,664.75
28/07/2020 10:00,1.98,37336,2951,17,33,2430,3,5434,664.75
28/07/2020 11:00,1.9,37189,3069,16,43,2676,3,5807,664.75
28/07/2020 12:00,1.59,37042,3090,13,59,2773,3,5938,664.75
28/07/2020 13:00,1.58,36901,3131,10,71,2756,3,5971,664.75
28/07/2020 14:00,1.71,36646,3224,7,83,2994,5,6313,664.75
28/07/2020 15:00,1.71,36395,3197,6,86,3078,4,6371,664.75
28/07/2020 16:00,1.82,36327,3285,6,88,2972,3,6354,664.75
28/07/2020 17:00,1.83,36102,3318,6,93,2911,5,6333,664.75
28/07/2020 18:00,1.78,35577,3279,8,97,2684,7,6075,664.75
28/07/2020 19:00,1.73,34796,3193,11,100,2746,9,6059,664.75
28/07/2020 20:00,1.74,34332,3031,15,98,2787,22,5953,664.75
28/07/2020 21:00,1.71,33597,3021,18,99,2848,14,6000,664.75
28/07/2020 22:00,1.6,32030,3040,19,97,2764,17,5937,664.75
28/07/2020 23:00,1.46,30381,2992,19,105,2737,11,5864,664.75
29/07/2020 00:00,1.4,29466,3200,21,117,2672,12,6022,664.75
29/07/2020 01:00,1.31,29042,3313,23,128,2740,12,6216,664.75
29/07/2020 02:00,1.22,28772,3385,23,137,2781,17,6343,664.75
29/07/2020 03:00,1.2,28837,3302,23,136,2875,16,6352,664.75
29/07/2020 04:00,1.39,29754,3099,20,126,2827,22,6094,664.75
29/07/2020 05:00,1.53,32010,3011,14,116,2845,26,6012,664.75
29/07/2020 06:00,1.64,34535,2866,9,119,2983,26,6003,664.75
29/07/2020 07:00,1.68,36080,2819,5,142,2971,23,5960,664.75
29/07/2020 08:00,1.69,36998,2937,4,164,2909,33,6047,664.75
29/07/2020 09:00,1.67,37673,3149,4,191,2824,31,6199,664.75
29/07/2020 10:00,1.6,37890,3280,5,211,3016,34,6546,664.75
29/07/2020 11:00,1.39,37739,3409,7,218,3148,37,6819,664.75
29/07/2020 12:00,1.13,37464,3423,9,210,3247,36,6925,664.75
29/07/2020 13:00,1.12,37199,3440,8,218,3363,36,7065,664.75
29/07/2020 14:00,1.37,36973,3528,7,223,3330,40,7128,664.75
29/07/2020 15:00,1.56,36754,3479,6,222,3087,44,6838,664.75
29/07/2020 16:00,1.59,36652,3574,5,218,3040,44,6881,664.75
29/07/2020 17:00,1.61,36401,3533,4,204,3005,49,6795,664.75
29/07/2020 18:00,1.6,35754,3485,6,191,2992,48,6722,664.75
29/07/2020 19:00,1.57,34886,3404,9,189,2986,42,6630,664.75
29/07/2020 20:00,1.6,34500,3235,14,201,3015,41,6506,664.75
29/07/2020 21:00,1.61,33734,3232,21,212,3020,43,6528,664.75
29/07/2020 22:00,1.5,32114,3270,27,228,3050,45,6620,664.75
29/07/2020 23:00,1.41,30852,3909,53,275,3129,57,7423,664.75
30/07/2020 00:00,1.11,29858,3815,56,284,3160,61,7376,664.75
30/07/2020 01:00,0.97,29408,3640,56,296,3254,58,7304,664.75
30/07/2020 02:00,0.87,29194,3645,54,308,3379,56,7442,664.75
30/07/2020 03:00,0.8,29238,3617,52,326,3548,58,7601,664.75
30/07/2020 04:00,1.06,30173,3510,47,340,3677,62,7636,664.75
30/07/2020 05:00,1.4,32404,3434,37,352,3775,64,7662,664.75
30/07/2020 06:00,1.53,34865,3353,39,365,3942,67,7766,664.75
30/07/2020 07:00,1.58,36521,3444,43,387,4105,67,8046,664.75
30/07/2020 08:00,1.58,37403,3613,44,402,4392,67,8518,664.75
30/07/2020 09:00,1.59,38008,3664,55,418,4699,67,8903,664.75
30/07/2020 10:00,1.58,38166,3593,68,438,4984,67,9150,664.75
30/07/2020 11:00,1.54,37932,3605,76,453,5203,62,9399,664.75
30/07/2020 12:00,1.54,37666,3450,86,460,5488,57,9541,664.75
30/07/2020 13:00,1.52,37392,3305,96,458,5716,54,9629,664.75
30/07/2020 14:00,1.51,37054,3338,99,455,5801,65,9758,664.75
30/07/2020 15:00,1.52,36843,3242,99,451,5684,65,9541,664.75
30/07/2020 16:00,1.57,36884,3093,91,444,5508,64,9200,664.75
30/07/2020 17:00,1.67,36524,2937,79,433,5150,61,8660,664.75
30/07/2020 18:00,1.67,35978,2668,71,413,4766,61,7979,664.75
30/07/2020 19:00,1.64,35124,2381,67,395,4458,57,7358,664.75
30/07/2020 20:00,1.65,34844,2096,68,383,4290,61,6898,664.75
30/07/2020 21:00,1.62,34027,2022,76,369,3957,56,6480,664.75
30/07/2020 22:00,1.53,32515,1931,76,359,3878,39,6283,664.75
30/07/2020 23:00,1.39,30806,1608,84,322,3718,38,5770,664.75
31/07/2020 00:00,1.34,29713,1530,87,311,3612,42,5582,664.75
31/07/2020 01:00,1.26,29258,1442,89,295,3520,39,5385,664.75
31/07/2020 02:00,1.2,29127,1414,89,279,3493,39,5314,664.75
31/07/2020 03:00,1.27,29118,1378,85,261,3235,30,4989,664.75
31/07/2020 04:00,1.42,30000,1286,81,248,2970,29,4614,664.75
31/07/2020 05:00,1.54,32220,1217,81,247,2499,24,4068,664.75
31/07/2020 06:00,1.66,34790,1040,81,259,2034,16,3430,664.75
31/07/2020 07:00,1.86,36534,914,84,268,1791,12,3069,664.75
31/07/2020 08:00,1.99,37363,756,87,270,1486,10,2609,664.75
31/07/2020 09:00,2.04,37945,556,91,272,1142,9,2070,664.75
31/07/2020 10:00,2.02,37893,414,88,255,954,7,1718,664.75
31/07/2020 11:00,2.02,37493,312,83,239,857,9,1500,664.75
31/07/2020 12:00,1.99,37161,254,72,230,767,12,1335,664.75
31/07/2020 13:00,1.96,36767,241,70,226,667,12,1216,664.75
31/07/2020 14:00,1.94,36307,201,68,216,610,12,1107,664.75
31/07/2020 15:00,1.93,36014,153,73,209,577,15,1027,664.75
31/07/2020 16:00,1.94,35939,137,73,195,552,18,975,664.75
31/07/2020 17:00,2.01,35571,106,72,171,520,18,887,664.75
31/07/2020 18:00,1.98,34896,81,66,157,366,15,685,664.75
31/07/2020 19:00,1.86,34037,77,58,160,417,13,725,664.75
31/07/2020 20:00,1.78,33626,93,51,166,445,13,768,664.75
31/07/2020 21:00,1.74,33012,132,44,166,480,14,836,664.75
31/07/2020 22:00,1.62,31577,179,37,158,480,14,868,664.75
31/07/2020 23:00,1.55,30282,362,90,114,465,7,1038,664.75
01/08/2020 00:00,1.52,29335,528,91,105,479,8,1211,664.75
01/08/2020 01:00,1.5,28885,700,89,102,456,9,1356,664.75
01/08/2020 02:00,1.48,28609,839,84,99,404,10,1436,664.75
01/08/2020 03:00,1.47,28297,924,68,100,330,10,1432,664.75
01/08/2020 04:00,1.48,28227,955,57,85,258,10,1365,664.75
01/08/2020 05:00,1.49,28799,1046,51,62,168,9,1336,664.75
01/08/2020 06:00,1.59,29941,1093,46,52,123,5,1319,664.75
01/08/2020 07:00,1.63,31458,1072,43,58,106,4,1283,664.75
01/08/2020 08:00,1.7,32843,1157,40,70,118,3,1388,664.75
01/08/2020 09:00,1.74,33585,1281,38,86,143,4,1552,664.75
01/08/2020 10:00,1.73,33638,1436,38,93,206,6,1779,664.75
01/08/2020 11:00,1.66,33414,1692,36,97,282,9,2116,664.75
01/08/2020 12:00,1.65,33178,1864,39,88,370,9,2370,664.75
01/08/2020 13:00,1.65,32997,1934,43,92,453,9,2531,664.75
01/08/2020 14:00,1.65,32959,1953,46,82,518,10,2609,664.75
01/08/2020 15:00,1.7,33150,1892,47,86,569,12,2606,664.75
01/08/2020 16:00,1.75,33597,1833,44,79,614,11,2581,664.75
01/08/2020 17:00,1.74,33604,1730,38,69,663,9,2509,664.75
01/08/2020 18:00,1.71,33266,1437,31,71,747,7,2293,664.75
01/08/2020 19:00,1.68,32516,1334,28,76,977,4,2419,664.75
01/08/2020 20:00,1.68,32458,1449,27,71,1196,4,2747,664.75
01/08/2020 21:00,1.63,31987,1544,27,60,1457,3,3091,664.75
01/08/2020 22:00,1.55,30758,1558,28,39,1637,2,3264,664.75
01/08/2020 23:00,1.59,29694,1357,20,31,1681,3,3092,664.75
02/08/2020 00:00,1.53,28796,1284,26,24,1735,3,3072,664.75
02/08/2020 01:00,1.5,28449,1218,28,17,1767,2,3032,664.75
02/08/2020 02:00,1.51,28141,1085,28,11,1734,1,2859,664.75
02/08/2020 03:00,1.49,27833,935,26,10,1669,1,2641,664.75
02/08/2020 04:00,1.5,27671,802,23,10,1539,2,2376,664.75
02/08/2020 05:00,1.52,28141,709,19,10,1289,2,2029,664.75
02/08/2020 06:00,1.55,29155,622,15,10,1053,2,1702,664.75
02/08/2020 07:00,1.58,30336,595,15,9,924,2,1545,664.75
02/08/2020 08:00,1.61,31417,603,15,7,907,2,1534,664.75
02/08/2020 09:00,1.64,32158,653,16,9,903,2,1583,664.75
02/08/2020 10:00,1.65,32530,705,17,10,1011,2,1745,664.75
02/08/2020 11:00,1.61,32545,657,16,13,1193,2,1881,664.75
02/08/2020 12:00,1.59,32954,665,15,17,1404,4,2105,664.75
02/08/2020 13:00,1.59,33187,689,14,19,1461,5,2188,664.75
02/08/2020 14:00,1.58,33217,764,13,20,1503,4,2304,664.75
02/08/2020 15:00,1.57,33444,781,13,20,1553,4,2371,664.75
02/08/2020 16:00,1.64,33885,802,15,18,1613,3,2451,664.75
02/08/2020 17:00,1.71,34043,990,17,18,1765,2,2792,664.75
02/08/2020 18:00,1.72,33839,1072,23,17,1837,1,2950,664.75
02/08/2020 19:00,1.69,33317,1020,36,19,1942,1,3018,664.75
02/08/2020 20:00,1.69,33280,956,52,28,2008,1,3045,664.75
02/08/2020 21:00,1.69,32769,1023,67,47,2067,2,3206,664.75
02/08/2020 22:00,1.63,31336,1098,73,74,2062,4,3311,664.75
02/08/2020 23:00,1.51,30519,1099,33,59,2030,7,3228,664.75
03/08/2020 00:00,1.48,29623,1044,27,68,2030,6,3175,6.726.071.429
03/08/2020 01:00,1.47,29322,1049,20,72,2012,5,3158,6.726.071.429
03/08/2020 02:00,1.46,29234,1089,14,70,2037,5,3215,6.726.071.429
03/08/2020 03:00,1.47,29305,1087,11,68,2023,4,3193,6.726.071.429
03/08/2020 04:00,1.49,30329,965,10,62,2002,4,3043,6.726.071.429
03/08/2020 05:00,1.53,32677,835,10,43,1930,4,2822,6.726.071.429
03/08/2020 06:00,1.66,35287,825,11,28,1924,3,2791,6.726.071.429
03/08/2020 07:00,1.82,36921,848,16,18,1931,4,2817,6.726.071.429
03/08/2020 08:00,1.89,37743,829,21,16,1920,3,2789,6.726.071.429
03/08/2020 09:00,1.93,38278,800,28,16,1883,4,2731,6.726.071.429
03/08/2020 10:00,1.92,38376,816,36,17,1882,2,2753,6.726.071.429
03/08/2020 11:00,1.93,38208,880,46,18,1845,2,2791,6.726.071.429
03/08/2020 12:00,1.92,37978,919,54,18,1875,3,2869,6.726.071.429
03/08/2020 13:00,1.89,37773,945,57,19,1913,4,2938,6.726.071.429
03/08/2020 14:00,1.86,37407,994,58,21,1921,2,2996,6.726.071.429
03/08/2020 15:00,1.84,37129,989,54,24,1974,1,3042,6.726.071.429
03/08/2020 16:00,1.77,37082,977,48,26,1949,1,3001,6.726.071.429
03/08/2020 17:00,1.77,36715,945,41,27,1919,1,2933,6.726.071.429
03/08/2020 18:00,1.77,36255,908,38,30,1845,1,2822,6.726.071.429
03/08/2020 19:00,1.75,35529,843,38,36,1831,1,2749,6.726.071.429
03/08/2020 20:00,1.73,35159,786,41,36,2032,0,2895,6.726.071.429
03/08/2020 21:00,1.67,34386,820,45,31,2195,0,3091,6.726.071.429
03/08/2020 22:00,1.58,32752,812,44,30,2128,0,3014,6.726.071.429
03/08/2020 23:00,1.57,31713,762,55,43,1992,1,2853,6.726.071.429
04/08/2020 00:00,1.55,30715,671,57,50,1938,0,2716,6.726.071.429
04/08/2020 01:00,1.53,30298,658,59,42,1806,0,2565,6.726.071.429
04/08/2020 02:00,1.54,30208,681,60,37,1702,0,2480,6.726.071.429
04/08/2020 03:00,1.55,30234,716,63,33,1703,0,2515,6.726.071.429
04/08/2020 04:00,1.62,31109,712,66,30,1567,1,2376,6.726.071.429
04/08/2020 05:00,1.81,33320,718,66,24,1331,0,2139,6.726.071.429
04/08/2020 06:00,2.09,35889,647,65,20,1108,0,1840,6.726.071.429
04/08/2020 07:00,2.32,37503,680,62,17,1039,0,1798,6.726.071.429
04/08/2020 08:00,2.39,38240,768,59,16,998,0,1841,6.726.071.429
04/08/2020 09:00,2.36,38777,795,55,19,984,0,1853,6.726.071.429
04/08/2020 10:00,2.42,38872,777,54,20,988,0,1839,6.726.071.429
04/08/2020 11:00,2.32,38605,782,56,20,1042,0,1900,6.726.071.429
04/08/2020 12:00,2.31,38413,796,56,20,1084,1,1957,6.726.071.429
04/08/2020 13:00,2.3,38202,819,52,23,1067,1,1962,6.726.071.429
04/08/2020 14:00,2.32,37841,871,46,25,1055,1,1998,6.726.071.429
04/08/2020 15:00,2.26,37517,857,38,27,1036,1,1959,6.726.071.429
04/08/2020 16:00,2.16,37556,807,33,29,1088,1,1958,6.726.071.429
04/08/2020 17:00,2.12,37202,719,30,32,1032,1,1814,6.726.071.429
04/08/2020 18:00,2.03,36702,604,28,39,1064,1,1736,6.726.071.429
04/08/2020 19:00,1.97,36046,528,28,48,1138,1,1743,6.726.071.429
04/08/2020 20:00,1.96,35739,597,27,65,1254,1,1944,6.726.071.429
04/08/2020 21:00,1.89,34867,800,26,77,1417,1,2321,6.726.071.429
04/08/2020 22:00,1.68,33210,1018,23,83,1606,0,2730,6.726.071.429
04/08/2020 23:00,1.71,31965,1377,15,66,1584,1,3043,6.726.071.429
05/08/2020 00:00,1.62,31039,1484,15,73,1627,1,3200,6.726.071.429
05/08/2020 01:00,1.58,30637,1649,15,63,1604,2,3333,6.726.071.429
05/08/2020 02:00,1.57,30398,1794,16,47,1519,2,3378,6.726.071.429
05/08/2020 03:00,1.56,30511,1956,15,37,1509,2,3519,6.726.071.429
05/08/2020 04:00,1.61,31443,2054,15,31,1398,2,3500,6.726.071.429
05/08/2020 05:00,1.85,33752,2296,14,26,1240,2,3578,6.726.071.429
05/08/2020 06:00,2.14,36432,2552,11,24,1104,1,3692,6.726.071.429
05/08/2020 07:00,2.34,38025,2721,9,25,1148,2,3905,6.726.071.429
05/08/2020 08:00,2.46,38916,3039,9,33,1339,4,4424,6.726.071.429
05/08/2020 09:00,2.51,39534,3186,8,44,1783,7,5028,6.726.071.429
05/08/2020 10:00,2.45,39689,3204,9,58,2212,7,5490,6.726.071.429
05/08/2020 11:00,2.24,39441,3301,9,62,2570,8,5950,6.726.071.429
05/08/2020 12:00,2.3,39280,3246,10,64,2925,8,6253,6.726.071.429
05/08/2020 13:00,2.17,38994,3193,10,67,3042,9,6321,6.726.071.429
05/08/2020 14:00,2.17,38681,3097,10,62,3221,8,6398,6.726.071.429
05/08/2020 15:00,2.12,38393,2818,10,59,3160,6,6053,6.726.071.429
05/08/2020 16:00,2.19,38307,2557,12,51,3048,5,5673,6.726.071.429
05/08/2020 17:00,2.23,37935,2175,12,37,2934,3,5161,6.726.071.429
05/08/2020 18:00,2.15,37312,1690,13,32,2860,6,4601,6.726.071.429
05/08/2020 19:00,1.97,36561,1357,15,31,2871,5,4279,6.726.071.429
05/08/2020 20:00,1.97,36205,1193,17,31,2966,3,4210,6.726.071.429
05/08/2020 21:00,1.92,35264,1035,19,32,2881,3,3970,6.726.071.429
05/08/2020 22:00,1.69,33510,953,20,31,2763,4,3771,6.726.071.429
05/08/2020 23:00,1.69,32162,1152,10,41,2426,7,3636,6.726.071.429
06/08/2020 00:00,1.64,31132,1178,13,52,2170,8,3421,6.726.071.429
06/08/2020 01:00,1.63,30663,1381,17,55,1901,9,3363,6.726.071.429
06/08/2020 02:00,1.64,30440,1403,20,56,1724,9,3212,6.726.071.429
06/08/2020 03:00,1.68,30499,1457,21,57,1634,8,3177,6.726.071.429
06/08/2020 04:00,1.75,31478,1355,18,53,1403,8,2837,6.726.071.429
06/08/2020 05:00,2.15,33767,1409,14,40,1139,12,2614,6.726.071.429
06/08/2020 06:00,2.5,36462,1239,11,33,1020,12,2315,6.726.071.429
06/08/2020 07:00,2.91,38133,972,11,27,930,13,1953,6.726.071.429
06/08/2020 08:00,3.14,38909,920,12,28,845,13,1818,6.726.071.429
06/08/2020 09:00,3.05,39502,890,14,32,850,16,1802,6.726.071.429
06/08/2020 10:00,3.03,39622,915,19,31,866,19,1850,6.726.071.429
06/08/2020 11:00,2.98,39378,931,23,30,910,16,1910,6.726.071.429
06/08/2020 12:00,2.97,39185,894,28,27,913,16,1878,6.726.071.429
06/08/2020 13:00,2.93,38882,873,30,27,960,16,1906,6.726.071.429
06/08/2020 14:00,2.96,38524,807,31,24,955,14,1831,6.726.071.429
06/08/2020 15:00,3.06,38260,684,27,21,885,11,1628,6.726.071.429
06/08/2020 16:00,2.93,38241,603,25,19,847,9,1503,6.726.071.429
06/08/2020 17:00,3,37866,504,26,18,826,6,1380,6.726.071.429
06/08/2020 18:00,2.9,37334,406,26,22,892,5,1351,6.726.071.429
06/08/2020 19:00,2.7,36590,384,27,27,1105,2,1545,6.726.071.429
06/08/2020 20:00,2.53,36237,387,28,29,1390,3,1837,6.726.071.429
06/08/2020 21:00,2.3,35242,406,29,34,1547,2,2018,6.726.071.429
06/08/2020 22:00,1.87,33503,402,31,37,1723,2,2195,6.726.071.429
06/08/2020 23:00,1.92,31862,578,41,29,1747,2,2397,6.726.071.429
07/08/2020 00:00,1.82,30791,527,43,29,1762,2,2363,6.726.071.429
07/08/2020 01:00,1.74,30321,539,44,31,1679,2,2295,6.726.071.429
07/08/2020 02:00,1.74,30192,500,46,34,1537,2,2119,6.726.071.429
07/08/2020 03:00,1.74,30247,440,50,39,1374,3,1906,6.726.071.429
07/08/2020 04:00,1.81,31200,367,51,38,1180,3,1639,6.726.071.429
07/08/2020 05:00,2.37,33489,387,51,35,963,3,1439,6.726.071.429
07/08/2020 06:00,2.75,36166,309,48,26,761,2,1146,6.726.071.429
07/08/2020 07:00,2.97,37914,256,49,18,564,1,888,6.726.071.429
07/08/2020 08:00,3.25,38701,299,51,15,517,1,883,6.726.071.429
07/08/2020 09:00,3.42,39178,375,54,19,556,1,1005,6.726.071.429
07/08/2020 10:00,3.27,39116,414,54,19,676,2,1165,6.726.071.429
07/08/2020 11:00,2.99,38653,490,50,19,848,2,1409,6.726.071.429
07/08/2020 12:00,2.95,38282,531,47,14,1075,2,1669,6.726.071.429
07/08/2020 13:00,2.78,37798,505,43,14,1223,3,1788,6.726.071.429
07/08/2020 14:00,2.8,37219,503,38,15,1282,4,1842,6.726.071.429
07/08/2020 15:00,2.81,36889,440,32,17,1231,4,1724,6.726.071.429
07/08/2020 16:00,3.18,36846,451,26,18,1160,4,1659,6.726.071.429
07/08/2020 17:00,3.36,36450,476,20,20,1068,4,1588,6.726.071.429
07/08/2020 18:00,3.48,35724,497,16,27,1066,4,1610,6.726.071.429
07/08/2020 19:00,3.04,34916,567,14,37,1190,3,1811,6.726.071.429
07/08/2020 20:00,2.92,34545,682,14,49,1381,5,2131,6.726.071.429
07/08/2020 21:00,2.68,33744,760,15,69,1526,6,2376,6.726.071.429
07/08/2020 22:00,2.02,32268,829,14,78,1575,7,2503,6.726.071.429
07/08/2020 23:00,2.35,31098,952,33,86,1566,8,2645,6.726.071.429
08/08/2020 00:00,2.02,30137,959,37,96,1533,8,2633,6.726.071.429
08/08/2020 01:00,1.94,29609,918,41,96,1496,6,2557,6.726.071.429
08/08/2020 02:00,1.91,29298,725,47,94,1366,5,2237,6.726.071.429
08/08/2020 03:00,1.85,28992,594,50,90,1397,5,2136,6.726.071.429
08/08/2020 04:00,1.92,28848,449,46,79,1270,5,1849,6.726.071.429
08/08/2020 05:00,2.08,29434,396,39,61,1091,5,1592,6.726.071.429
08/08/2020 06:00,2.5,30710,298,36,34,863,5,1236,6.726.071.429
08/08/2020 07:00,2.86,32400,207,36,15,642,3,903,6.726.071.429
08/08/2020 08:00,2.97,33890,143,36,9,654,2,844,6.726.071.429
08/08/2020 09:00,2.99,34647,93,37,8,723,1,862,6.726.071.429
08/08/2020 10:00,2.93,34768,77,38,6,927,1,1049,6.726.071.429
08/08/2020 11:00,2.75,34595,69,37,5,1204,1,1316,6.726.071.429
08/08/2020 12:00,2.71,34364,71,33,4,1428,1,1537,6.726.071.429
08/08/2020 13:00,2.57,34218,81,29,5,1477,1,1593,6.726.071.429
08/08/2020 14:00,2.44,34175,124,25,5,1493,3,1650,6.726.071.429
08/08/2020 15:00,2.5,34242,175,21,6,1401,3,1606,6.726.071.429
08/08/2020 16:00,2.62,34674,212,17,8,1357,2,1596,6.726.071.429
08/08/2020 17:00,2.74,34648,273,16,10,1379,2,1680,6.726.071.429
08/08/2020 18:00,2.71,34197,343,18,14,1575,3,1953,6.726.071.429
08/08/2020 19:00,2.42,33580,386,20,17,1889,3,2315,6.726.071.429
08/08/2020 20:00,2.25,33503,419,23,20,2292,4,2758,6.726.071.429
08/08/2020 21:00,2.11,32929,553,24,26,2750,4,3357,6.726.071.429
08/08/2020 22:00,1.75,31665,587,24,29,3012,3,3655,6.726.071.429
08/08/2020 23:00,1.78,30646,462,22,51,3122,5,3662,6.726.071.429
09/08/2020 00:00,1.69,29684,557,24,40,3180,4,3805,6.726.071.429
09/08/2020 01:00,1.67,29185,613,25,31,3211,3,3883,6.726.071.429
09/08/2020 02:00,1.65,28918,502,26,26,3235,2,3791,6.726.071.429
09/08/2020 03:00,1.62,28597,467,25,22,3261,2,3777,6.726.071.429
09/08/2020 04:00,1.63,28335,412,21,18,3203,2,3656,6.726.071.429
09/08/2020 05:00,1.65,28674,391,16,15,3076,2,3500,6.726.071.429
09/08/2020 06:00,1.77,29853,327,12,14,2889,1,3243,6.726.071.429
09/08/2020 07:00,2,31422,299,12,10,2704,1,3026,6.726.071.429
09/08/2020 08:00,2.48,32886,308,14,8,2361,1,2692,6.726.071.429
09/08/2020 09:00,2.76,33805,279,17,7,2069,1,2373,6.726.071.429
09/08/2020 10:00,2.78,34234,269,22,9,1820,1,2121,6.726.071.429
09/08/2020 11:00,2.71,34431,271,28,10,1683,2,1994,6.726.071.429
09/08/2020 12:00,2.73,34302,311,33,10,1599,3,1956,6.726.071.429
09/08/2020 13:00,2.73,34125,407,35,10,1649,3,2104,6.726.071.429
09/08/2020 14:00,2.72,34113,433,36,15,1635,4,2123,6.726.071.429
09/08/2020 15:00,2.87,34345,499,32,22,1655,5,2213,6.726.071.429
09/08/2020 16:00,3.09,34823,559,28,28,1646,6,2267,6.726.071.429
09/08/2020 17:00,3.35,34986,594,24,32,1556,5,2211,6.726.071.429
09/08/2020 18:00,3.38,34800,574,24,36,1495,5,2134,6.726.071.429
09/08/2020 19:00,3.19,34384,595,29,42,1579,4,2249,6.726.071.429
09/08/2020 20:00,3.29,34384,593,36,50,1746,4,2429,6.726.071.429
09/08/2020 21:00,2.94,33654,586,42,62,2033,4,2727,6.726.071.429
09/08/2020 22:00,2.63,32149,484,45,63,2195,4,2791,6.726.071.429
09/08/2020 23:00,2.39,31315,465,14,31,2129,4,2643,6.726.071.429
10/08/2020 00:00,2.19,30404,433,13,28,2121,4,2599,6.690.238.095
10/08/2020 01:00,2.07,30097,419,13,23,2117,4,2576,6.690.238.095
10/08/2020 02:00,2.04,30026,433,12,19,2004,5,2473,6.690.238.095
10/08/2020 03:00,2.11,30201,425,11,15,1934,5,2390,6.690.238.095
10/08/2020 04:00,2.61,31360,420,9,13,1857,3,2302,6.690.238.095
10/08/2020 05:00,3.45,34102,426,7,11,1597,4,2045,6.690.238.095
10/08/2020 06:00,4.94,37149,333,5,8,1243,3,1592,6.690.238.095
10/08/2020 07:00,5.78,38945,302,3,7,1010,3,1325,6.690.238.095
10/08/2020 08:00,5.85,39722,265,3,8,887,3,1166,6.690.238.095
10/08/2020 09:00,6.22,40273,251,4,8,820,3,1086,6.690.238.095
10/08/2020 10:00,6.66,40273,250,6,9,793,4,1062,6.690.238.095
10/08/2020 11:00,6.31,40059,275,7,14,733,5,1034,6.690.238.095
10/08/2020 12:00,6.2,39773,302,7,17,691,7,1024,6.690.238.095
10/08/2020 13:00,6,39519,380,7,19,649,8,1063,6.690.238.095
10/08/2020 14:00,5.87,39112,496,7,28,610,10,1151,6.690.238.095
10/08/2020 15:00,5.85,38689,612,7,40,575,9,1243,6.690.238.095
10/08/2020 16:00,5.68,38655,735,6,56,567,11,1375,6.690.238.095
10/08/2020 17:00,5.6,38153,933,5,64,591,13,1606,6.690.238.095
10/08/2020 18:00,5.69,37561,1016,5,70,660,11,1762,6.690.238.095
10/08/2020 19:00,5.58,36859,881,5,77,749,10,1722,6.690.238.095
10/08/2020 20:00,5.23,36564,822,5,102,908,12,1849,6.690.238.095
10/08/2020 21:00,4.96,35526,839,5,126,1032,15,2017,6.690.238.095
10/08/2020 22:00,4.08,33616,844,5,132,1153,10,2144,6.690.238.095
10/08/2020 23:00,4.61,32482,828,45,130,1211,7,2221,6.690.238.095
11/08/2020 00:00,4.22,31430,789,47,116,1208,6,2166,6.690.238.095
11/08/2020 01:00,4.1,30980,842,43,107,1169,4,2165,6.690.238.095
11/08/2020 02:00,4.1,30894,808,38,107,1122,4,2079,6.690.238.095
11/08/2020 03:00,4.2,31045,762,36,109,1069,3,1979,6.690.238.095
11/08/2020 04:00,4.45,32072,738,39,103,1000,4,1884,6.690.238.095
11/08/2020 05:00,4.65,34623,750,42,88,851,4,1735,6.690.238.095
11/08/2020 06:00,5.93,37510,648,42,66,715,3,1474,6.690.238.095
11/08/2020 07:00,7.52,39133,613,39,59,601,1,1313,6.690.238.095
11/08/2020 08:00,7.49,39748,605,38,62,516,1,1222,6.690.238.095
11/08/2020 09:00,7.48,40160,596,38,71,466,3,1174,6.690.238.095
11/08/2020 10:00,7.42,40231,598,39,66,464,5,1172,6.690.238.095
11/08/2020 11:00,7.2,40013,680,43,57,473,5,1258,6.690.238.095
11/08/2020 12:00,7.38,39916,742,45,54,480,5,1326,6.690.238.095
11/08/2020 13:00,7.36,39717,810,45,54,469,9,1387,6.690.238.095
11/08/2020 14:00,6.99,39382,899,44,68,456,18,1485,6.690.238.095
11/08/2020 15:00,6.94,39092,969,42,87,462,17,1577,6.690.238.095
11/08/2020 16:00,6.52,39123,1063,39,95,490,17,1704,6.690.238.095
11/08/2020 17:00,6.37,38770,1123,36,98,571,16,1844,6.690.238.095
11/08/2020 18:00,6.32,38302,1067,37,104,776,11,1995,6.690.238.095
11/08/2020 19:00,6.02,37623,1091,38,114,1012,9,2264,6.690.238.095
11/08/2020 20:00,5.8,37338,1278,38,124,1261,11,2712,6.690.238.095
11/08/2020 21:00,5.15,36178,1520,35,120,1451,9,3135,6.690.238.095
11/08/2020 22:00,4.37,34217,1574,34,102,1601,10,3321,6.690.238.095
11/08/2020 23:00,4.65,32788,1479,53,73,1617,7,3229,6.690.238.095
12/08/2020 00:00,4.08,31829,1476,53,61,1521,6,3117,6.690.238.095
12/08/2020 01:00,3.99,31377,1469,54,55,1327,3,2908,6.690.238.095
12/08/2020 02:00,4.05,31195,1447,51,55,1315,4,2872,6.690.238.095
12/08/2020 03:00,4.17,31395,1441,50,57,1212,3,2763,6.690.238.095
12/08/2020 04:00,4.87,32478,1437,52,58,1084,3,2634,6.690.238.095
12/08/2020 05:00,5.74,35071,1494,54,50,842,2,2442,6.690.238.095
12/08/2020 06:00,8.92,38051,1448,54,32,710,1,2245,6.690.238.095
12/08/2020 07:00,10.96,39643,1483,52,25,597,1,2158,6.690.238.095
12/08/2020 08:00,10.54,40287,1486,49,29,500,1,2065,6.690.238.095
12/08/2020 09:00,11.24,40835,1429,51,30,406,1,1917,6.690.238.095
12/08/2020 10:00,11.19,40929,1320,49,27,385,2,1783,6.690.238.095
12/08/2020 11:00,10.52,40730,1330,47,21,458,2,1858,6.690.238.095
12/08/2020 12:00,10.63,40611,1328,45,12,507,3,1895,6.690.238.095
12/08/2020 13:00,10.58,40339,1242,43,12,558,4,1859,6.690.238.095
12/08/2020 14:00,9.55,40044,1172,39,14,633,7,1865,6.690.238.095
12/08/2020 15:00,9.24,39763,1163,38,18,673,9,1901,6.690.238.095
12/08/2020 16:00,9.31,39732,1134,37,20,684,7,1882,6.690.238.095
12/08/2020 17:00,10.24,39320,1170,33,22,655,5,1885,6.690.238.095
12/08/2020 18:00,10.49,38749,1237,30,22,634,3,1926,6.690.238.095
12/08/2020 19:00,9.3,38047,1275,30,23,724,2,2054,6.690.238.095
12/08/2020 20:00,7.24,37780,1373,29,27,793,3,2225,6.690.238.095
12/08/2020 21:00,5.75,36479,1451,29,30,838,2,2350,6.690.238.095
12/08/2020 22:00,4.75,34387,1423,26,32,869,1,2351,6.690.238.095
12/08/2020 23:00,5.31,32812,1421,24,17,850,1,2313,6.690.238.095
13/08/2020 00:00,4.78,31826,1334,21,13,809,2,2179,6.690.238.095
13/08/2020 01:00,4.46,31399,1288,19,15,790,2,2114,6.690.238.095
13/08/2020 02:00,4.51,31255,1240,19,15,743,2,2019,6.690.238.095
13/08/2020 03:00,4.51,31402,1163,19,17,656,3,1858,6.690.238.095
13/08/2020 04:00,5.28,32449,1160,17,17,587,3,1784,6.690.238.095
13/08/2020 05:00,6.33,35059,1249,13,15,497,4,1778,6.690.238.095
13/08/2020 06:00,9.6,38150,1134,11,13,380,3,1541,6.690.238.095
13/08/2020 07:00,10.93,39757,1098,10,10,281,3,1402,6.690.238.095
13/08/2020 08:00,10.76,40432,1017,11,9,232,5,1274,6.690.238.095
13/08/2020 09:00,11.07,40960,881,12,12,210,4,1119,6.690.238.095
13/08/2020 10:00,10.66,40984,826,12,14,214,8,1074,6.690.238.095
13/08/2020 11:00,10.81,40786,788,12,18,260,12,1090,6.690.238.095
13/08/2020 12:00,11.27,40611,740,12,24,298,16,1090,6.690.238.095
13/08/2020 13:00,11.29,40353,771,11,27,344,11,1164,6.690.238.095
13/08/2020 14:00,11.28,39964,737,10,29,382,10,1168,6.690.238.095
13/08/2020 15:00,11.47,39660,697,9,30,420,8,1164,6.690.238.095
13/08/2020 16:00,11.37,39700,617,7,30,479,6,1139,6.690.238.095
13/08/2020 17:00,11.16,39200,581,6,30,561,4,1182,6.690.238.095
13/08/2020 18:00,11.17,38735,544,5,31,703,3,1286,6.690.238.095
13/08/2020 19:00,10.57,38045,538,6,29,980,3,1556,6.690.238.095
13/08/2020 20:00,9.15,37691,618,6,25,1282,3,1934,6.690.238.095
13/08/2020 21:00,6.73,36339,680,7,24,1481,2,2194,6.690.238.095
13/08/2020 22:00,5.01,34377,673,8,22,1532,2,2237,6.690.238.095
13/08/2020 23:00,5.07,32953,519,11,23,1540,1,2094,6.690.238.095
14/08/2020 00:00,4.5,31995,496,13,25,1464,1,1999,6.690.238.095
14/08/2020 01:00,4.31,31564,480,17,22,1330,2,1851,6.690.238.095
14/08/2020 02:00,4.27,31454,402,21,20,1365,1,1809,6.690.238.095
14/08/2020 03:00,4.22,31605,358,24,20,1306,2,1710,6.690.238.095
14/08/2020 04:00,5.16,32727,326,26,18,1204,1,1575,6.690.238.095
14/08/2020 05:00,6.31,35238,339,27,17,1005,1,1389,6.690.238.095
14/08/2020 06:00,8.61,38155,297,25,15,808,1,1146,6.690.238.095
14/08/2020 07:00,10.73,39868,279,22,13,613,1,928,6.690.238.095
14/08/2020 08:00,11.4,40607,283,17,11,525,1,837,6.690.238.095
14/08/2020 09:00,11.88,41114,269,17,11,438,1,736,6.690.238.095
14/08/2020 10:00,10.91,40936,255,15,12,488,1,771,6.690.238.095
14/08/2020 11:00,10.72,40494,255,15,13,567,1,851,6.690.238.095
14/08/2020 12:00,10.23,40094,247,12,12,622,2,895,6.690.238.095
14/08/2020 13:00,9.8,39596,270,10,12,730,2,1024,6.690.238.095
14/08/2020 14:00,8.21,39061,339,9,13,793,2,1156,6.690.238.095
14/08/2020 15:00,7.83,38752,494,10,11,812,2,1329,6.690.238.095
14/08/2020 16:00,7.58,38782,626,10,10,855,2,1503,6.690.238.095
14/08/2020 17:00,7.55,38356,686,10,10,835,2,1543,6.690.238.095
14/08/2020 18:00,7.49,37587,747,10,12,849,1,1619,6.690.238.095
14/08/2020 19:00,6.57,36812,709,11,15,1023,2,1760,6.690.238.095
14/08/2020 20:00,6.21,36422,602,12,21,1201,2,1838,6.690.238.095
14/08/2020 21:00,5.45,35322,547,13,29,1374,3,1966,6.690.238.095
14/08/2020 22:00,4.42,33604,486,14,37,1540,3,2080,6.690.238.095
14/08/2020 23:00,4.67,32109,382,2,0,1585,2,1971,6.690.238.095
15/08/2020 00:00,4.4,31155,378,2,0,1650,2,2032,6.690.238.095
15/08/2020 01:00,4.24,30662,371,3,0,1786,2,2162,6.690.238.095
15/08/2020 02:00,4.12,30402,379,3,0,1765,3,2150,6.690.238.095
15/08/2020 03:00,3.97,30154,355,3,0,1772,3,2133,6.690.238.095
15/08/2020 04:00,4.09,30072,299,3,0,1644,3,1949,6.690.238.095
15/08/2020 05:00,4.27,30734,238,2,0,1483,3,1726,6.690.238.095
15/08/2020 06:00,4.63,32176,195,1,0,1081,3,1280,6.690.238.095
15/08/2020 07:00,5.11,33988,175,1,0,932,2,1110,6.690.238.095
15/08/2020 08:00,5.9,35488,154,1,0,941,2,1098,6.690.238.095
15/08/2020 09:00,5.97,36287,140,1,0,1066,2,1209,6.690.238.095
15/08/2020 10:00,5.96,36419,144,2,0,1080,2,1228,6.690.238.095
15/08/2020 11:00,5.92,36228,159,3,0,1397,2,1561,6.690.238.095
15/08/2020 12:00,5.59,35961,187,4,0,1741,2,1934,6.690.238.095
15/08/2020 13:00,5.39,35598,244,5,0,2019,3,2271,6.690.238.095
15/08/2020 14:00,5.07,35507,304,4,0,2215,3,2526,6.690.238.095
15/08/2020 15:00,5.42,35675,349,4,0,2251,3,2607,6.690.238.095
15/08/2020 16:00,5.63,36030,371,3,0,2353,3,2730,6.690.238.095
15/08/2020 17:00,5.6,36053,417,3,0,2349,2,2771,6.690.238.095
15/08/2020 18:00,5.43,35600,424,3,0,2454,2,2883,6.690.238.095
15/08/2020 19:00,4.97,35034,387,4,0,2546,2,2939,6.690.238.095
15/08/2020 20:00,5.1,35093,350,5,0,2639,2,2996,6.690.238.095
15/08/2020 21:00,4.83,34243,338,6,0,2871,2,3217,6.690.238.095
15/08/2020 22:00,4.27,32865,303,9,0,2833,1,3146,6.690.238.095
15/08/2020 23:00,4.65,31598,363,13,9,2851,4,3240,6.690.238.095
16/08/2020 00:00,4.26,30714,305,15,8,2985,4,3317,6.690.238.095
16/08/2020 01:00,4.12,30294,269,17,8,2973,4,3271,6.690.238.095
16/08/2020 02:00,4.1,30049,279,17,9,2907,3,3215,6.690.238.095
16/08/2020 03:00,4.09,29794,274,17,8,2685,3,2987,6.690.238.095
16/08/2020 04:00,4.16,29599,253,18,8,2406,3,2688,6.690.238.095
16/08/2020 05:00,4.53,29897,256,17,8,2066,2,2349,6.690.238.095
16/08/2020 06:00,5.07,31080,253,13,8,1860,3,2137,6.690.238.095
16/08/2020 07:00,5.91,32651,249,9,7,1672,3,1940,6.690.238.095
16/08/2020 08:00,6.11,34097,239,10,7,1381,3,1640,6.690.238.095
16/08/2020 09:00,6.21,35086,235,13,9,1287,5,1549,6.690.238.095
16/08/2020 10:00,6.05,35478,256,19,12,1357,7,1651,6.690.238.095
16/08/2020 11:00,6.16,35503,303,23,18,1468,7,1819,6.690.238.095
16/08/2020 12:00,5.96,35303,352,24,24,1557,6,1963,6.690.238.095
16/08/2020 13:00,5.8,35250,387,24,28,1797,7,2243,6.690.238.095
16/08/2020 14:00,5.83,35241,356,24,31,1821,6,2238,6.690.238.095
16/08/2020 15:00,5.95,35415,330,24,31,1812,4,2201,6.690.238.095
16/08/2020 16:00,6.34,35997,367,24,28,1885,3,2307,6.690.238.095
16/08/2020 17:00,7.16,36280,432,25,28,1768,2,2255,6.690.238.095
16/08/2020 18:00,7.71,36226,484,29,26,1602,2,2143,6.690.238.095
16/08/2020 19:00,8.01,36031,606,33,24,1604,2,2269,6.690.238.095
16/08/2020 20:00,8.18,36024,818,34,23,1586,2,2463,6.690.238.095
16/08/2020 21:00,7.51,35116,1017,36,19,1659,2,2733,6.690.238.095
16/08/2020 22:00,6.2,33507,1153,42,14,1613,2,2824,6.690.238.095
16/08/2020 23:00,5.67,32100,1056,20,10,1614,2,2702,6.690.238.095
17/08/2020 00:00,5,31172,1063,17,9,1611,2,2702,670.047.619
17/08/2020 01:00,4.92,30854,1089,16,7,1591,1,2704,670.047.619
17/08/2020 02:00,4.92,30844,1044,16,6,1526,2,2594,670.047.619
17/08/2020 03:00,5.2,31131,1000,15,6,1505,2,2528,670.047.619
17/08/2020 04:00,6.77,32441,998,13,6,1432,2,2451,670.047.619
17/08/2020 05:00,7.8,35498,1026,9,6,1299,4,2344,670.047.619
17/08/2020 06:00,9.9,38783,1011,5,7,978,3,2004,670.047.619
17/08/2020 07:00,13.4,40422,984,4,8,836,1,1833,670.047.619
17/08/2020 08:00,13.54,41028,936,5,6,674,1,1622,670.047.619
17/08/2020 09:00,13.79,41527,899,5,6,594,1,1505,670.047.619
17/08/2020 10:00,13.81,41564,891,6,5,488,1,1391,670.047.619
17/08/2020 11:00,13.42,41384,1049,7,6,499,1,1562,670.047.619
17/08/2020 12:00,13.53,41019,1163,7,7,514,1,1692,670.047.619
17/08/2020 13:00,13.28,40767,1215,6,8,525,2,1756,670.047.619
17/08/2020 14:00,13.2,40426,1221,6,9,532,3,1771,670.047.619
17/08/2020 15:00,13.12,40061,1245,6,10,558,4,1823,670.047.619
17/08/2020 16:00,13.23,40039,1137,6,12,549,4,1708,670.047.619
17/08/2020 17:00,13.41,39519,1044,5,22,573,4,1648,670.047.619
17/08/2020 18:00,12.72,38996,977,4,37,657,5,1680,670.047.619
17/08/2020 19:00,12,38465,968,6,63,774,6,1817,670.047.619
17/08/2020 20:00,10.05,38136,1030,7,89,923,12,2061,670.047.619
17/08/2020 21:00,8.89,36672,1205,9,121,1012,12,2359,670.047.619
17/08/2020 22:00,7.4,34529,1214,10,134,1073,11,2442,670.047.619
17/08/2020 23:00,7.99,32528,1016,39,175,1056,10,2296,670.047.619
18/08/2020 00:00,7.71,31440,972,34,160,944,12,2122,670.047.619
18/08/2020 01:00,7.58,31069,972,33,148,817,12,1982,670.047.619
18/08/2020 02:00,7.61,31065,782,35,138,762,11,1728,670.047.619
18/08/2020 03:00,7.87,31296,723,33,129,670,10,1565,670.047.619
18/08/2020 04:00,9.1,32495,687,26,115,578,9,1415,670.047.619
18/08/2020 05:00,10.81,35308,699,19,103,454,6,1281,670.047.619
18/08/2020 06:00,13.27,38410,532,13,86,385,4,1020,670.047.619
18/08/2020 07:00,15.35,40038,547,10,65,260,2,884,670.047.619
18/08/2020 08:00,16.17,40562,563,9,55,218,3,848,670.047.619
18/08/2020 09:00,16.1,40998,558,9,57,212,3,839,670.047.619
18/08/2020 10:00,15.09,41093,479,9,60,213,2,763,670.047.619
18/08/2020 11:00,15.56,40915,471,10,57,249,1,788,670.047.619
18/08/2020 12:00,15.78,40819,406,12,41,307,1,767,670.047.619
18/08/2020 13:00,14.73,40660,351,16,39,334,2,742,670.047.619
18/08/2020 14:00,13.87,40379,355,19,40,388,3,805,670.047.619
18/08/2020 15:00,13.76,39946,370,19,41,402,3,835,670.047.619
18/08/2020 16:00,13.33,39955,391,18,43,403,3,858,670.047.619
18/08/2020 17:00,13.9,39533,362,17,48,472,4,903,670.047.619
18/08/2020 18:00,13.18,39074,297,17,62,731,4,1111,670.047.619
18/08/2020 19:00,13.01,38563,256,17,73,909,5,1260,670.047.619
18/08/2020 20:00,12.26,38249,226,16,82,1081,6,1411,670.047.619
18/08/2020 21:00,10.83,36714,235,14,86,1133,7,1475,670.047.619
18/08/2020 22:00,8.37,34294,278,14,83,1288,6,1669,670.047.619
18/08/2020 23:00,8.98,32189,168,8,119,1205,7,1507,670.047.619
19/08/2020 00:00,7.88,31219,161,6,115,1143,5,1430,670.047.619
19/08/2020 01:00,7.41,30770,153,5,107,1062,4,1331,670.047.619
19/08/2020 02:00,7.45,30644,162,4,100,954,4,1224,670.047.619
19/08/2020 03:00,8.29,30987,160,3,100,811,5,1079,670.047.619
19/08/2020 04:00,10.43,32235,173,3,90,762,4,1032,670.047.619
19/08/2020 05:00,13.09,35112,144,3,73,620,6,846,670.047.619
19/08/2020 06:00,15.73,38335,109,2,48,456,6,621,670.047.619
19/08/2020 07:00,17.51,39915,102,2,34,391,3,532,670.047.619
19/08/2020 08:00,20.43,40541,111,3,38,351,4,507,670.047.619
19/08/2020 09:00,20.78,41023,129,3,51,311,5,499,670.047.619
19/08/2020 10:00,19.7,41073,172,3,56,374,7,612,670.047.619
19/08/2020 11:00,19.62,40882,220,4,57,459,5,745,670.047.619
19/08/2020 12:00,19.65,40725,241,4,38,534,6,823,670.047.619
19/08/2020 13:00,16.19,40398,250,5,34,606,5,900,670.047.619
19/08/2020 14:00,15.74,40047,247,5,29,718,7,1006,670.047.619
19/08/2020 15:00,15.06,39741,237,4,29,721,5,996,670.047.619
19/08/2020 16:00,15.14,39715,218,4,32,715,4,973,670.047.619
19/08/2020 17:00,15.39,39324,196,5,38,682,5,926,670.047.619
19/08/2020 18:00,15.07,38834,163,6,49,741,7,966,670.047.619
19/08/2020 19:00,13.21,38215,151,9,71,848,6,1085,670.047.619
19/08/2020 20:00,12.2,37814,155,11,86,955,14,1221,670.047.619
19/08/2020 21:00,9.92,36171,200,13,87,1069,11,1380,670.047.619
19/08/2020 22:00,7.8,33880,254,13,83,1055,13,1418,670.047.619
19/08/2020 23:00,7.4,32242,446,8,56,929,7,1446,670.047.619
20/08/2020 00:00,7.01,31259,586,8,46,859,5,1504,670.047.619
20/08/2020 01:00,6.71,30810,799,7,40,757,3,1606,670.047.619
20/08/2020 02:00,6.7,30791,912,5,41,659,3,1620,670.047.619
20/08/2020 03:00,6.77,31106,995,5,41,668,3,1712,670.047.619
20/08/2020 04:00,7.66,32349,1056,4,40,721,3,1824,670.047.619
20/08/2020 05:00,11.2,35257,1173,4,34,622,3,1836,670.047.619
20/08/2020 06:00,13.69,38436,1240,3,25,503,2,1773,670.047.619
20/08/2020 07:00,14.88,40031,1307,2,22,415,2,1748,670.047.619
20/08/2020 08:00,14.83,40633,1451,1,18,393,1,1864,670.047.619
20/08/2020 09:00,14.78,40979,1568,1,15,450,1,2035,670.047.619
20/08/2020 10:00,14.58,41069,1604,1,13,553,1,2172,670.047.619
20/08/2020 11:00,15.13,40895,1793,2,12,680,1,2488,670.047.619
20/08/2020 12:00,14.99,40700,1840,2,11,848,1,2702,670.047.619
20/08/2020 13:00,14.78,40418,1823,3,11,1021,1,2859,670.047.619
20/08/2020 14:00,13.89,40085,1757,5,15,1081,2,2860,670.047.619
20/08/2020 15:00,14.08,39799,1784,7,18,1192,2,3003,670.047.619
20/08/2020 16:00,14.07,39766,1585,8,20,1239,2,2854,670.047.619
20/08/2020 17:00,14.58,39334,1437,10,25,1118,2,2592,670.047.619
20/08/2020 18:00,14.51,38864,1304,14,28,1234,2,2582,670.047.619
20/08/2020 19:00,14.06,38245,1207,19,27,1418,3,2674,670.047.619
20/08/2020 20:00,12.88,37779,1003,24,24,1615,3,2669,670.047.619
20/08/2020 21:00,10.28,36109,854,27,21,1783,3,2688,670.047.619
20/08/2020 22:00,7.9,33985,815,28,18,1893,2,2756,670.047.619
20/08/2020 23:00,7.56,32575,524,29,10,1844,2,2409,670.047.619
21/08/2020 00:00,6.89,31567,665,27,9,1736,2,2439,670.047.619
21/08/2020 01:00,6.73,31144,762,26,7,1730,2,2527,670.047.619
21/08/2020 02:00,6.61,31182,1079,26,7,1658,2,2772,670.047.619
21/08/2020 03:00,6.7,31407,1336,25,8,1727,2,3098,670.047.619
21/08/2020 04:00,7.59,32609,1574,23,8,1608,1,3214,670.047.619
21/08/2020 05:00,10.49,35467,1943,20,8,1423,1,3395,670.047.619
21/08/2020 06:00,13.9,38627,2217,13,8,1187,1,3426,670.047.619
21/08/2020 07:00,14.92,40244,2478,6,7,1098,1,3590,670.047.619
21/08/2020 08:00,15.04,40872,2818,4,6,1240,1,4069,670.047.619
21/08/2020 09:00,15.22,41338,2858,5,6,1512,1,4382,670.047.619
21/08/2020 10:00,14.61,41241,2816,6,7,1841,1,4671,670.047.619
21/08/2020 11:00,14.31,40762,3161,7,8,2166,2,5344,670.047.619
21/08/2020 12:00,13.91,40318,3178,7,10,2578,2,5775,670.047.619
21/08/2020 13:00,12.56,39759,3219,8,11,2821,2,6061,670.047.619
21/08/2020 14:00,10.98,39224,3208,10,11,3088,3,6320,670.047.619
21/08/2020 15:00,9.85,38847,3253,10,11,3362,3,6639,670.047.619
21/08/2020 16:00,9.98,38768,3080,11,10,3615,3,6719,670.047.619
21/08/2020 17:00,9.19,38370,2823,12,14,3803,1,6653,670.047.619
21/08/2020 18:00,7.54,37596,2472,14,22,4064,1,6573,670.047.619
21/08/2020 19:00,6.72,36917,2304,17,39,4205,1,6566,670.047.619
21/08/2020 20:00,6.47,36384,2091,24,73,4287,1,6476,670.047.619
21/08/2020 21:00,5.66,35034,2047,31,113,4288,2,6481,670.047.619
21/08/2020 22:00,5.07,33231,1970,37,143,4463,4,6617,670.047.619
21/08/2020 23:00,4.94,31573,2036,24,125,4373,24,6582,670.047.619
22/08/2020 00:00,4.72,30560,2123,29,136,4179,27,6494,670.047.619
22/08/2020 01:00,4.42,30057,2188,33,131,4214,23,6589,670.047.619
22/08/2020 02:00,4.3,29868,2238,37,126,4151,20,6572,670.047.619
22/08/2020 03:00,4.08,29738,2212,38,126,4172,21,6569,670.047.619
22/08/2020 04:00,4.07,29762,2192,37,125,4169,26,6549,670.047.619
22/08/2020 05:00,4.31,30325,2298,33,125,4111,26,6593,670.047.619
22/08/2020 06:00,5.17,31742,2308,25,129,4110,28,6600,670.047.619
22/08/2020 07:00,6.01,33549,2512,20,133,4194,29,6888,670.047.619
22/08/2020 08:00,6.51,35046,2846,20,136,4381,29,7412,670.047.619
22/08/2020 09:00,6.47,35849,3051,22,143,4574,36,7826,670.047.619
22/08/2020 10:00,6.25,35954,3135,22,141,4767,39,8104,670.047.619
22/08/2020 11:00,5.91,35804,3503,26,131,4994,32,8686,670.047.619
22/08/2020 12:00,5.09,35480,3586,30,106,5274,42,9038,670.047.619
22/08/2020 13:00,4.42,35201,3536,33,94,5309,31,9003,670.047.619
22/08/2020 14:00,4.92,35132,3483,31,81,5185,16,8796,670.047.619
22/08/2020 15:00,5.95,35216,3562,28,68,5125,9,8792,670.047.619
22/08/2020 16:00,6.83,35645,3364,24,63,4814,4,8269,670.047.619
22/08/2020 17:00,7,35761,3311,21,53,4730,6,8121,670.047.619
22/08/2020 18:00,6.85,35398,3143,23,46,4616,8,7836,670.047.619
22/08/2020 19:00,6.8,34956,3032,28,46,4507,10,7623,670.047.619
22/08/2020 20:00,6.8,34815,2772,33,45,4602,11,7463,670.047.619
22/08/2020 21:00,6.56,33829,2611,37,41,4552,10,7251,670.047.619
22/08/2020 22:00,5.8,32348,2562,38,38,4431,14,7083,670.047.619
22/08/2020 23:00,4.94,30678,2370,39,70,4438,22,6939,670.047.619
23/08/2020 00:00,4.91,29768,2331,41,67,4285,29,6753,670.047.619
23/08/2020 01:00,4.65,29391,2331,40,67,4116,22,6576,670.047.619
23/08/2020 02:00,4.52,29205,2363,37,64,3986,20,6470,670.047.619
23/08/2020 03:00,4.16,28992,2215,31,60,3939,19,6264,670.047.619
23/08/2020 04:00,3.9,28885,2090,28,51,3845,15,6029,670.047.619
23/08/2020 05:00,4.28,29153,1999,23,51,3803,13,5889,670.047.619
23/08/2020 06:00,5.19,30363,2006,17,49,3568,11,5651,670.047.619
23/08/2020 07:00,5.56,32044,2090,13,52,3549,21,5725,670.047.619
23/08/2020 08:00,5.79,33605,2193,14,69,3646,23,5945,670.047.619
23/08/2020 09:00,5.54,34576,2221,16,84,3642,29,5992,670.047.619
23/08/2020 10:00,5.22,35064,2233,19,99,3652,36,6039,670.047.619
23/08/2020 11:00,4.87,35097,2432,25,123,3466,36,6082,670.047.619
23/08/2020 12:00,4.32,35006,2566,32,150,3569,39,6356,670.047.619
23/08/2020 13:00,4.33,35057,2688,42,157,3580,44,6511,670.047.619
23/08/2020 14:00,4.89,34882,2760,51,158,3468,43,6480,670.047.619
23/08/2020 15:00,5.52,35175,2905,55,156,3431,44,6591,670.047.619
23/08/2020 16:00,7.11,35822,2906,59,144,3212,43,6364,670.047.619
23/08/2020 17:00,7.83,36159,2865,63,124,3093,32,6177,670.047.619
23/08/2020 18:00,7.92,36130,2736,67,111,2974,32,5920,670.047.619
23/08/2020 19:00,7.77,35938,2604,68,109,3056,31,5868,670.047.619
23/08/2020 20:00,7.81,35763,2468,63,111,3135,32,5809,670.047.619
23/08/2020 21:00,7.68,34592,2540,53,117,3250,34,5994,670.047.619
23/08/2020 22:00,6.83,32935,2610,43,122,3364,38,6177,670.047.619
23/08/2020 23:00,5.5,30945,2348,19,176,3579,20,6142,670.047.619
24/08/2020 00:00,5.42,30152,2193,20,190,3457,22,5882,6.628.571.429
24/08/2020 01:00,5.38,29897,2055,20,197,3490,16,5778,6.628.571.429
24/08/2020 02:00,5.39,29969,1855,19,195,3433,21,5523,6.628.571.429
24/08/2020 03:00,5.81,30434,1579,18,189,3336,16,5138,6.628.571.429
24/08/2020 04:00,6.32,32005,1296,17,178,3173,15,4679,6.628.571.429
24/08/2020 05:00,8.19,35368,1061,16,167,2779,12,4035,6.628.571.429
24/08/2020 06:00,11.56,38778,948,12,150,2377,9,3496,6.628.571.429
24/08/2020 07:00,15.43,40346,911,7,150,2174,7,3249,6.628.571.429
24/08/2020 08:00,17.72,40938,904,5,175,1972,11,3067,6.628.571.429
24/08/2020 09:00,18.43,41286,849,8,207,1848,12,2924,6.628.571.429
24/08/2020 10:00,17.9,41223,775,11,240,1907,12,2945,6.628.571.429
24/08/2020 11:00,17.5,40927,788,13,265,2020,10,3096,6.628.571.429
24/08/2020 12:00,17.32,40652,773,14,280,2104,20,3191,6.628.571.429
24/08/2020 13:00,16.83,40490,772,15,276,2146,25,3234,6.628.571.429
24/08/2020 14:00,15.86,40112,821,16,279,2114,30,3260,6.628.571.429
24/08/2020 15:00,15.65,39685,853,16,263,2113,30,3275,6.628.571.429
24/08/2020 16:00,14.54,39640,875,15,229,1988,33,3140,6.628.571.429
24/08/2020 17:00,16.84,39238,900,16,179,1730,32,2857,6.628.571.429
24/08/2020 18:00,16.99,38829,892,24,138,1516,28,2598,6.628.571.429
24/08/2020 19:00,17.06,38255,784,37,113,1574,24,2532,6.628.571.429
24/08/2020 20:00,14.88,37734,723,55,102,1700,19,2599,6.628.571.429
24/08/2020 21:00,11.79,36077,760,73,96,1883,14,2826,6.628.571.429
24/08/2020 22:00,7.93,33886,777,86,98,1964,12,2937,6.628.571.429
24/08/2020 23:00,7.45,32483,945,85,78,1899,11,3018,6.628.571.429
25/08/2020 00:00,7.37,31515,999,84,78,1935,7,3103,6.628.571.429
25/08/2020 01:00,7.21,31126,1084,81,82,1953,7,3207,6.628.571.429
25/08/2020 02:00,7.28,31181,1108,82,87,1859,7,3143,6.628.571.429
25/08/2020 03:00,7.65,31533,1096,83,85,1778,11,3053,6.628.571.429
25/08/2020 04:00,7.91,32959,952,82,82,1791,5,2912,6.628.571.429
25/08/2020 05:00,12.2,36069,737,76,75,1602,5,2495,6.628.571.429
25/08/2020 06:00,17.29,39420,589,84,65,1448,6,2192,6.628.571.429
25/08/2020 07:00,20.62,40943,535,87,60,1329,7,2018,6.628.571.429
25/08/2020 08:00,20.29,41285,531,95,61,1387,9,2083,6.628.571.429
25/08/2020 09:00,20.27,41538,494,107,68,1590,13,2272,6.628.571.429
25/08/2020 10:00,19.41,41519,417,115,82,1794,13,2421,6.628.571.429
25/08/2020 11:00,18.91,41263,375,121,88,2000,13,2597,6.628.571.429
25/08/2020 12:00,19.85,41126,381,123,79,2199,15,2797,6.628.571.429
25/08/2020 13:00,19.26,40812,481,119,84,2266,18,2968,6.628.571.429
25/08/2020 14:00,18.25,40542,622,112,82,2297,22,3135,6.628.571.429
25/08/2020 15:00,16.9,40183,746,101,86,2227,23,3183,6.628.571.429
25/08/2020 16:00,16.98,40246,932,86,84,2014,22,3138,6.628.571.429
25/08/2020 17:00,18.72,39821,1157,74,77,1788,20,3116,6.628.571.429
25/08/2020 18:00,19.19,39500,1452,65,69,1669,16,3271,6.628.571.429
25/08/2020 19:00,19.06,39007,1826,57,67,1679,10,3639,6.628.571.429
25/08/2020 20:00,17.28,38519,2260,50,68,1758,10,4146,6.628.571.429
25/08/2020 21:00,10.83,36658,2733,46,77,1855,8,4719,6.628.571.429
25/08/2020 22:00,7.45,34290,3025,39,86,1924,9,5083,6.628.571.429
25/08/2020 23:00,6.98,32652,3566,49,76,1876,9,5576,6.628.571.429
26/08/2020 00:00,6.24,31820,3587,45,83,1801,10,5526,6.628.571.429
26/08/2020 01:00,5.72,31462,3451,44,80,1784,9,5368,6.628.571.429
26/08/2020 02:00,5.4,31393,3122,47,77,1722,7,4975,6.628.571.429
26/08/2020 03:00,5.97,31763,2722,47,80,1816,8,4673,6.628.571.429
26/08/2020 04:00,7.62,33255,2328,43,82,1977,7,4437,6.628.571.429
26/08/2020 05:00,13.79,36268,1884,41,85,1814,6,3830,6.628.571.429
26/08/2020 06:00,18.81,39563,1555,36,80,1689,6,3366,6.628.571.429
26/08/2020 07:00,21.58,40967,1319,30,71,1560,6,2986,6.628.571.429
26/08/2020 08:00,21.58,41447,1174,29,76,1398,6,2683,6.628.571.429
26/08/2020 09:00,21.75,41852,1016,27,94,1278,6,2421,6.628.571.429
26/08/2020 10:00,21.44,41870,864,31,118,1232,7,2252,6.628.571.429
26/08/2020 11:00,21.42,41619,879,36,142,1172,10,2239,6.628.571.429
26/08/2020 12:00,21.5,41388,922,41,151,1163,11,2288,6.628.571.429
26/08/2020 13:00,20.54,41073,1052,41,150,1121,9,2373,6.628.571.429
26/08/2020 14:00,20.31,40734,1243,44,146,1150,8,2591,6.628.571.429
26/08/2020 15:00,20.09,40438,1429,48,139,1160,7,2783,6.628.571.429
26/08/2020 16:00,21.35,40431,1619,48,122,1145,8,2942,6.628.571.429
26/08/2020 17:00,21.15,40044,1836,47,113,1100,5,3101,6.628.571.429
26/08/2020 18:00,21.28,39673,1965,44,109,1134,7,3259,6.628.571.429
26/08/2020 19:00,19.74,39143,2078,40,108,1267,8,3501,6.628.571.429
26/08/2020 20:00,18.76,38532,2202,41,105,1450,7,3805,6.628.571.429
26/08/2020 21:00,12.04,36729,2374,42,97,1625,7,4145,6.628.571.429
26/08/2020 22:00,7.98,34438,2433,43,94,1941,5,4516,6.628.571.429
26/08/2020 23:00,8.56,32868,2246,41,0,2210,3,4500,6.628.571.429
27/08/2020 00:00,7.65,32023,2303,40,0,2351,3,4697,6.628.571.429
27/08/2020 01:00,7.69,31667,2468,40,0,2517,3,5028,6.628.571.429
27/08/2020 02:00,8.34,31716,2602,41,0,2618,4,5265,6.628.571.429
27/08/2020 03:00,9.32,32017,2539,39,0,2487,8,5073,6.628.571.429
27/08/2020 04:00,11.24,33436,2425,33,0,2384,12,4854,6.628.571.429
27/08/2020 05:00,14.72,36337,2301,29,0,2156,11,4497,6.628.571.429
27/08/2020 06:00,20.93,39614,2144,22,0,1861,11,4038,6.628.571.429
27/08/2020 07:00,23.89,41008,2125,16,0,1433,10,3584,6.628.571.429
27/08/2020 08:00,23.78,41281,2212,15,0,1212,7,3446,6.628.571.429
27/08/2020 09:00,23.94,41681,2078,16,0,1016,8,3118,6.628.571.429
27/08/2020 10:00,23.55,41706,1881,16,0,844,9,2750,6.628.571.429
27/08/2020 11:00,23.73,41439,1798,15,0,762,8,2583,6.628.571.429
27/08/2020 12:00,23.9,41317,1713,17,0,690,8,2428,6.628.571.429
27/08/2020 13:00,23.85,41031,1633,16,0,646,9,2304,6.628.571.429
27/08/2020 14:00,23.9,40709,1511,14,0,629,14,2168,6.628.571.429
27/08/2020 15:00,23.72,40442,1343,12,0,605,16,1976,6.628.571.429
27/08/2020 16:00,23.67,40398,1140,10,0,560,15,1725,6.628.571.429
27/08/2020 17:00,24.11,39960,878,10,0,489,11,1388,6.628.571.429
27/08/2020 18:00,24.64,39600,652,11,0,454,9,1126,6.628.571.429
27/08/2020 19:00,24.56,39192,533,10,0,447,9,999,6.628.571.429
27/08/2020 20:00,23.84,38586,459,10,0,448,8,925,6.628.571.429
27/08/2020 21:00,20.29,36816,416,11,0,488,7,922,6.628.571.429
27/08/2020 22:00,13.43,34683,362,12,0,477,7,858,6.628.571.429
27/08/2020 23:00,13.86,33317,53,13,91,457,3,617,6.628.571.429
28/08/2020 00:00,12.02,32324,50,15,83,410,3,561,6.628.571.429
28/08/2020 01:00,11.83,31920,59,16,70,351,2,498,6.628.571.429
28/08/2020 02:00,11.49,32000,138,17,63,320,2,540,6.628.571.429
28/08/2020 03:00,12.3,32392,272,19,58,334,2,685,6.628.571.429
28/08/2020 04:00,15.13,33766,434,23,41,379,2,879,6.628.571.429
28/08/2020 05:00,16.82,36618,626,27,28,405,2,1088,6.628.571.429
28/08/2020 06:00,24.04,39724,757,25,19,432,2,1235,6.628.571.429
28/08/2020 07:00,25.04,41222,906,23,12,428,2,1371,6.628.571.429
28/08/2020 08:00,25.17,41653,1073,29,6,432,2,1542,6.628.571.429
28/08/2020 09:00,25.05,41942,1252,30,6,487,2,1777,6.628.571.429
28/08/2020 10:00,25,41757,1353,30,5,530,2,1920,6.628.571.429
28/08/2020 11:00,25.26,41274,1597,32,5,593,2,2229,6.628.571.429
28/08/2020 12:00,25,40761,1825,35,5,649,2,2516,6.628.571.429
28/08/2020 13:00,24.34,40169,1946,37,6,722,2,2713,6.628.571.429
28/08/2020 14:00,18.91,39608,2024,37,7,815,2,2885,6.628.571.429
28/08/2020 15:00,16.86,39298,2049,38,7,877,2,2973,6.628.571.429
28/08/2020 16:00,16.92,39343,1904,34,8,943,2,2891,6.628.571.429
28/08/2020 17:00,22.03,38975,1699,31,10,945,2,2687,6.628.571.429
28/08/2020 18:00,21.89,38358,1565,31,12,1022,2,2632,6.628.571.429
28/08/2020 19:00,19.9,37721,1395,32,22,1191,2,2642,6.628.571.429
28/08/2020 20:00,15.86,37027,1244,33,39,1377,2,2695,6.628.571.429
28/08/2020 21:00,12.55,35572,1250,34,69,1574,3,2930,6.628.571.429
28/08/2020 22:00,10.65,33827,1168,34,90,1664,7,2963,6.628.571.429
28/08/2020 23:00,12.59,32754,1128,101,141,1566,8,2944,6.628.571.429
29/08/2020 00:00,12.01,31838,973,108,158,1545,10,2794,6.628.571.429
29/08/2020 01:00,11.79,31348,920,110,175,1518,11,2734,6.628.571.429
29/08/2020 02:00,11.73,31142,902,113,192,1438,13,2658,6.628.571.429
29/08/2020 03:00,11.7,31075,842,115,209,1436,11,2613,6.628.571.429
29/08/2020 04:00,11.84,31216,713,116,224,1424,13,2490,6.628.571.429
29/08/2020 05:00,12.05,31808,631,116,233,1429,13,2422,6.628.571.429
29/08/2020 06:00,12.48,33279,534,116,240,1359,14,2263,6.628.571.429
29/08/2020 07:00,14.37,35121,412,123,251,1263,10,2059,6.628.571.429
29/08/2020 08:00,16.18,36585,392,134,261,1307,10,2104,6.628.571.429
29/08/2020 09:00,16.48,37349,391,140,278,1197,12,2018,6.628.571.429
29/08/2020 10:00,16.85,37374,375,146,283,1196,13,2013,6.628.571.429
29/08/2020 11:00,16.66,37132,378,149,267,1250,13,2057,6.628.571.429
29/08/2020 12:00,16.03,36808,392,153,230,1213,16,2004,6.628.571.429
29/08/2020 13:00,16.02,36542,397,156,195,1301,16,2065,6.628.571.429
29/08/2020 14:00,15.72,36395,393,155,169,1251,14,1982,6.628.571.429
29/08/2020 15:00,16.14,36497,365,151,145,1157,14,1832,6.628.571.429
29/08/2020 16:00,16.82,36948,370,145,132,1132,15,1794,6.628.571.429
29/08/2020 17:00,19.04,36983,357,136,131,1179,10,1813,6.628.571.429
29/08/2020 18:00,18.32,36646,360,128,134,1221,7,1850,6.628.571.429
29/08/2020 19:00,16.59,36173,337,120,140,1316,7,1920,6.628.571.429
29/08/2020 20:00,16.53,35884,362,109,144,1370,5,1990,6.628.571.429
29/08/2020 21:00,14.33,34726,400,101,142,1433,3,2079,6.628.571.429
29/08/2020 22:00,12.75,33248,418,90,131,1324,3,1966,6.628.571.429
29/08/2020 23:00,15.11,32049,389,86,156,1125,20,1776,6.628.571.429
30/08/2020 00:00,14.94,31189,420,83,145,972,20,1640,6.628.571.429
30/08/2020 01:00,14.84,30805,412,81,129,924,18,1564,6.628.571.429
30/08/2020 02:00,14.83,30680,436,78,120,789,24,1447,6.628.571.429
30/08/2020 03:00,14.81,30530,445,74,110,730,22,1381,6.628.571.429
30/08/2020 04:00,14.88,30553,478,69,96,636,17,1296,6.628.571.429
30/08/2020 05:00,15,30836,415,68,82,631,11,1207,6.628.571.429
30/08/2020 06:00,15.42,32000,330,70,71,571,9,1051,6.628.571.429
30/08/2020 07:00,16.25,33605,317,74,60,542,4,997,6.628.571.429
30/08/2020 08:00,17.07,35104,347,77,52,483,4,963,6.628.571.429
30/08/2020 09:00,17.68,36050,400,82,41,465,3,991,6.628.571.429
30/08/2020 10:00,17.75,36360,500,91,36,564,3,1194,6.628.571.429
30/08/2020 11:00,17.11,36266,651,104,34,511,2,1302,6.628.571.429
30/08/2020 12:00,16.85,36062,887,108,31,511,2,1539,6.628.571.429
30/08/2020 13:00,16.65,35984,1070,110,27,581,2,1790,6.628.571.429
30/08/2020 14:00,16.4,35981,1192,109,24,648,2,1975,6.628.571.429
30/08/2020 15:00,16.82,36284,1221,107,23,722,2,2075,6.628.571.429
30/08/2020 16:00,18.07,36959,1162,101,22,783,2,2070,6.628.571.429
30/08/2020 17:00,18.57,37187,1039,97,24,1101,2,2263,6.628.571.429
30/08/2020 18:00,19.86,37199,904,98,25,1267,2,2296,6.628.571.429
30/08/2020 19:00,19.73,37064,884,104,29,1528,3,2548,6.628.571.429
30/08/2020 20:00,19.01,36666,848,110,32,1924,3,2917,6.628.571.429
30/08/2020 21:00,16.39,35323,877,112,35,2208,3,3235,6.628.571.429
30/08/2020 22:00,15.39,33718,805,107,36,2550,3,3501,6.628.571.429
30/08/2020 23:00,16.67,32829,576,22,48,2739,6,3391,6.628.571.429
31/08/2020 00:00,15.97,32112,478,22,39,2888,6,3433,6.570.714.286
31/08/2020 01:00,15.73,31850,438,22,48,3207,7,3722,6.570.714.286
31/08/2020 02:00,15.56,31976,402,25,62,3200,6,3695,6.570.714.286
31/08/2020 03:00,15.95,32540,400,28,75,3401,7,3911,6.570.714.286
31/08/2020 04:00,17.8,34068,445,28,88,3514,6,4081,6.570.714.286
31/08/2020 05:00,21.52,37177,468,25,94,3303,6,3896,6.570.714.286
31/08/2020 06:00,25.08,40376,439,18,90,2928,5,3480,6.570.714.286
31/08/2020 07:00,29.64,41778,434,13,95,2550,4,3096,6.570.714.286
31/08/2020 08:00,29.82,42106,432,12,95,2345,3,2887,6.570.714.286
31/08/2020 09:00,30.07,42318,437,11,95,2260,3,2806,6.570.714.286
31/08/2020 10:00,30.31,42181,443,11,94,2104,5,2657,6.570.714.286
31/08/2020 11:00,29.13,41784,458,11,94,2016,4,2583,6.570.714.286
31/08/2020 12:00,29.49,41598,447,11,106,1869,8,2441,6.570.714.286
31/08/2020 13:00,29.23,41354,419,11,110,1719,16,2275,6.570.714.286
31/08/2020 14:00,29.14,41034,431,10,111,1563,20,2135,6.570.714.286
31/08/2020 15:00,29.21,40731,391,9,115,1481,27,2023,6.570.714.286
31/08/2020 16:00,29.38,40689,356,8,121,1280,26,1791,6.570.714.286
31/08/2020 17:00,32.58,40295,366,8,125,1265,24,1788,6.570.714.286
31/08/2020 18:00,32.02,40039,379,9,128,1349,20,1885,6.570.714.286
31/08/2020 19:00,30.45,39634,387,12,130,1586,19,2134,6.570.714.286
31/08/2020 20:00,28.54,39060,404,14,126,1866,15,2425,6.570.714.286
31/08/2020 21:00,25.33,37387,406,15,121,2048,11,2601,6.570.714.286
31/08/2020 22:00,19.43,35302,378,15,108,2066,8,2575,6.570.714.286
31/08/2020 23:00,20.04,33889,344,24,77,2191,9,2645,6.570.714.286
01/09/2020 00:00,19.2,33032,291,22,68,2178,9,2568,6.570.714.286
01/09/2020 01:00,19.01,32708,253,21,53,1901,7,2235,6.570.714.286
01/09/2020 02:00,19.32,32810,250,20,37,1738,6,2051,6.570.714.286
01/09/2020 03:00,20.09,33197,250,19,28,1585,7,1889,6.570.714.286
01/09/2020 04:00,23.66,34582,250,17,21,1384,9,1681,6.570.714.286
01/09/2020 05:00,26.52,37516,249,12,17,1170,8,1456,6.570.714.286
01/09/2020 06:00,30.3,40631,246,9,15,873,8,1151,6.570.714.286
01/09/2020 07:00,36.49,41921,241,7,15,666,9,938,6.570.714.286
01/09/2020 08:00,35.55,42020,243,8,22,522,13,808,6.570.714.286
01/09/2020 09:00,34.94,42075,260,9,30,473,14,786,6.570.714.286
01/09/2020 10:00,33.66,41979,280,13,37,489,16,835,6.570.714.286
01/09/2020 11:00,32.42,41689,301,17,47,500,17,882,6.570.714.286
01/09/2020 12:00,33.46,41499,345,21,55,533,15,969,6.570.714.286
01/09/2020 13:00,30.2,41179,413,26,67,581,18,1105,6.570.714.286
01/09/2020 14:00,28.87,40941,432,32,82,635,18,1199,6.570.714.286
01/09/2020 15:00,29.8,40631,404,39,92,603,21,1159,6.570.714.286
01/09/2020 16:00,30.05,40686,386,45,102,601,26,1160,6.570.714.286
01/09/2020 17:00,30.43,40341,391,47,121,702,25,1286,6.570.714.286
01/09/2020 18:00,29.68,40112,381,50,151,931,20,1533,6.570.714.286
01/09/2020 19:00,30.07,39716,380,53,179,1265,18,1895,6.570.714.286
01/09/2020 20:00,27.62,38957,382,58,199,1571,15,2225,6.570.714.286
01/09/2020 21:00,23.59,37257,404,64,223,2010,17,2718,6.570.714.286
01/09/2020 22:00,20.1,35122,387,71,239,2264,15,2976,6.570.714.286
01/09/2020 23:00,20.51,33402,367,59,187,2342,22,2977,6.570.714.286
02/09/2020 00:00,19.62,32571,354,67,203,2302,22,2948,6.570.714.286
02/09/2020 01:00,19.19,32239,367,72,211,2223,19,2892,6.570.714.286
02/09/2020 02:00,19.2,32290,364,74,220,2177,19,2854,6.570.714.286
02/09/2020 03:00,20.05,32761,378,74,228,2176,19,2875,6.570.714.286
02/09/2020 04:00,22.97,34281,409,75,236,2212,20,2952,6.570.714.286
02/09/2020 05:00,25.47,37316,408,75,244,2085,24,2836,6.570.714.286
02/09/2020 06:00,29.29,40545,403,72,251,2085,20,2831,6.570.714.286
02/09/2020 07:00,32.8,41724,406,69,251,1749,15,2490,6.570.714.286
02/09/2020 08:00,32.45,41952,398,66,243,1579,18,2304,6.570.714.286
02/09/2020 09:00,30.81,42179,393,61,219,1665,23,2361,6.570.714.286
02/09/2020 10:00,29.62,42159,379,58,200,1925,23,2585,6.570.714.286
02/09/2020 11:00,29.07,41862,337,58,185,2174,34,2788,6.570.714.286
02/09/2020 12:00,28.47,41572,299,58,172,2369,26,2924,6.570.714.286
02/09/2020 13:00,25.53,41235,259,58,154,2339,24,2834,6.570.714.286
02/09/2020 14:00,25.76,41038,240,55,127,2267,23,2712,6.570.714.286
02/09/2020 15:00,26.97,40765,236,53,105,2102,29,2525,6.570.714.286
02/09/2020 16:00,28.14,40657,258,50,99,2003,23,2433,6.570.714.286
02/09/2020 17:00,30.09,40276,279,49,104,2033,18,2483,6.570.714.286
02/09/2020 18:00,29.74,40020,267,50,109,2219,12,2657,6.570.714.286
02/09/2020 19:00,27.63,39644,224,51,115,2424,18,2832,6.570.714.286
02/09/2020 20:00,24.77,38810,198,52,122,2567,20,2959,6.570.714.286
02/09/2020 21:00,21.92,37000,186,52,123,2725,21,3107,6.570.714.286
02/09/2020 22:00,19.63,34832,175,52,118,2752,17,3114,6.570.714.286
02/09/2020 23:00,18.06,33284,132,52,107,2696,12,2999,6.570.714.286
03/09/2020 00:00,17.74,32372,132,53,107,2531,12,2835,6.570.714.286
03/09/2020 01:00,17.59,32023,152,55,112,2407,9,2735,6.570.714.286
03/09/2020 02:00,17.62,32042,197,58,123,2259,8,2645,6.570.714.286
03/09/2020 03:00,18.26,32438,257,60,133,2003,8,2461,6.570.714.286
03/09/2020 04:00,20.93,33889,336,61,139,1861,7,2404,6.570.714.286
03/09/2020 05:00,24.92,36919,419,60,149,1513,7,2148,6.570.714.286
03/09/2020 06:00,26.96,40077,555,54,159,1223,6,1997,6.570.714.286
03/09/2020 07:00,29.15,41341,673,50,166,1032,7,1928,6.570.714.286
03/09/2020 08:00,27.73,41581,815,54,185,978,7,2039,6.570.714.286
03/09/2020 09:00,27.76,41711,1003,63,201,1056,9,2332,6.570.714.286
03/09/2020 10:00,26.95,41565,1150,75,223,1156,8,2612,6.570.714.286
03/09/2020 11:00,25.44,41174,1348,81,246,1179,8,2862,6.570.714.286
03/09/2020 12:00,25.48,41001,1524,86,257,1194,9,3070,6.570.714.286
03/09/2020 13:00,25.41,40766,1748,91,264,1280,11,3394,6.570.714.286
03/09/2020 14:00,25.34,40609,2043,94,264,1218,11,3630,6.570.714.286
03/09/2020 15:00,26.01,40456,2242,94,255,1203,12,3806,6.570.714.286
03/09/2020 16:00,27.36,40506,2467,100,242,1168,9,3986,6.570.714.286
03/09/2020 17:00,28.15,40149,2687,105,231,1141,11,4175,6.570.714.286
03/09/2020 18:00,28.26,40055,2751,109,225,1171,12,4268,6.570.714.286
03/09/2020 19:00,26.44,39714,2779,106,219,1278,14,4396,6.570.714.286
03/09/2020 20:00,25.01,38737,2752,99,221,1363,13,4448,6.570.714.286
03/09/2020 21:00,20.61,36890,2734,94,231,1530,16,4605,6.570.714.286
03/09/2020 22:00,17.97,34848,2646,88,240,1690,26,4690,6.570.714.286
03/09/2020 23:00,17.88,33425,2522,76,205,1676,25,4504,6.570.714.286
04/09/2020 00:00,17.22,32393,2376,72,193,1647,20,4308,6.570.714.286
04/09/2020 01:00,17.29,32011,2379,69,177,1774,27,4426,6.570.714.286
04/09/2020 02:00,17.2,32041,2382,66,163,1662,23,4296,6.570.714.286
04/09/2020 03:00,17.62,32476,2319,65,154,1664,24,4226,6.570.714.286
04/09/2020 04:00,19.02,34028,2154,63,146,1758,19,4140,6.570.714.286
04/09/2020 05:00,24.04,37033,2013,58,147,1896,16,4130,6.570.714.286
04/09/2020 06:00,27.62,40201,1923,49,152,1895,13,4032,6.570.714.286
04/09/2020 07:00,30.04,41480,1928,39,159,2026,13,4165,6.570.714.286
04/09/2020 08:00,29.29,41689,2132,36,174,2247,18,4607,6.570.714.286
04/09/2020 09:00,28.54,41928,2300,37,188,2460,26,5011,6.570.714.286
04/09/2020 10:00,26.76,41672,2339,39,195,2642,29,5244,6.570.714.286
04/09/2020 11:00,24.29,41235,2442,42,200,2851,33,5568,6.570.714.286
04/09/2020 12:00,23.04,40700,2483,46,195,2871,35,5630,6.570.714.286
04/09/2020 13:00,21.87,40130,2535,48,188,2842,32,5645,6.570.714.286
04/09/2020 14:00,21.79,39620,2607,52,171,2925,21,5776,6.570.714.286
04/09/2020 15:00,22.97,39379,2585,50,153,2722,14,5524,6.570.714.286
04/09/2020 16:00,23.32,39551,2522,48,139,2767,17,5493,6.570.714.286
04/09/2020 17:00,23.95,39302,2461,47,127,2741,18,5394,6.570.714.286
04/09/2020 18:00,23.23,38843,2178,47,118,2877,14,5234,6.570.714.286
04/09/2020 19:00,22.28,38224,2006,44,116,3019,14,5199,6.570.714.286
04/09/2020 20:00,21.05,37330,1908,40,115,3164,13,5240,6.570.714.286
04/09/2020 21:00,19.6,35789,1914,40,118,3195,13,5280,6.570.714.286
04/09/2020 22:00,17.58,33935,1864,45,114,3285,13,5321,6.570.714.286
04/09/2020 23:00,16.25,32334,1929,12,114,3286,12,5353,6.570.714.286
05/09/2020 00:00,15.89,31391,1888,12,113,2974,12,4999,6.570.714.286
05/09/2020 01:00,15.76,30957,1967,13,113,2897,13,5003,6.570.714.286
05/09/2020 02:00,15.57,30800,2081,14,113,2860,12,5080,6.570.714.286
05/09/2020 03:00,15.67,30796,2099,14,111,2735,12,4971,6.570.714.286
05/09/2020 04:00,15.9,30980,2079,15,109,2815,11,5029,6.570.714.286
05/09/2020 05:00,16.09,31620,2159,18,106,2836,11,5130,6.570.714.286
05/09/2020 06:00,16.56,33072,2224,16,105,2830,12,5187,6.570.714.286
05/09/2020 07:00,17.5,34920,2338,14,108,2778,13,5251,6.570.714.286
05/09/2020 08:00,19.84,36343,2584,14,124,2895,19,5636,6.570.714.286
05/09/2020 09:00,19.26,37049,2776,17,151,2849,20,5813,6.570.714.286
05/09/2020 10:00,17.47,37104,2853,20,174,3066,22,6135,6.570.714.286
05/09/2020 11:00,16.83,36841,3114,24,207,3086,28,6459,6.570.714.286
05/09/2020 12:00,15.78,36584,3178,27,243,3382,26,6856,6.570.714.286
05/09/2020 13:00,15.52,36305,3289,32,253,3350,24,6948,6.570.714.286
05/09/2020 14:00,16.16,36147,3420,37,234,3484,17,7192,6.570.714.286
05/09/2020 15:00,17.16,36347,3322,40,191,3305,8,6866,6.570.714.286
05/09/2020 16:00,19.03,36932,3116,47,163,3055,6,6387,6.570.714.286
05/09/2020 17:00,19.07,37082,2965,55,146,2898,3,6067,6.570.714.286
05/09/2020 18:00,19.84,36892,2732,68,129,2882,6,5817,6.570.714.286
05/09/2020 19:00,18.66,36468,2404,75,119,2995,9,5602,6.570.714.286
05/09/2020 20:00,17.57,35991,2199,76,116,3205,11,5607,6.570.714.286
05/09/2020 21:00,16.4,34755,2110,75,119,3326,11,5641,6.570.714.286
05/09/2020 22:00,15.61,33255,1983,82,119,3208,11,5403,6.570.714.286
05/09/2020 23:00,13.99,31732,1779,67,101,3033,13,4993,6.570.714.286
06/09/2020 00:00,13.76,30860,1767,66,90,2974,12,4909,6.570.714.286
06/09/2020 01:00,13.67,30493,1789,62,82,2853,10,4796,6.570.714.286
06/09/2020 02:00,13.63,30430,1840,54,81,2739,11,4725,6.570.714.286
06/09/2020 03:00,13.65,30404,1778,39,82,2744,8,4651,6.570.714.286
06/09/2020 04:00,13.76,30536,1639,30,82,2599,9,4359,6.570.714.286
06/09/2020 05:00,13.96,30835,1528,31,83,2374,9,4025,6.570.714.286
06/09/2020 06:00,14.75,32024,1465,26,79,2147,9,3726,6.570.714.286
06/09/2020 07:00,15.16,33720,1482,32,79,1994,9,3596,6.570.714.286
06/09/2020 08:00,16.97,35220,1639,37,92,1895,11,3674,6.570.714.286
06/09/2020 09:00,17.78,36032,1707,41,109,1810,11,3678,6.570.714.286
06/09/2020 10:00,17.93,36300,1741,41,117,1752,11,3662,6.570.714.286
06/09/2020 11:00,17.34,36178,1922,40,130,1719,15,3826,6.570.714.286
06/09/2020 12:00,15.74,35938,2016,40,137,1786,22,4001,6.570.714.286
06/09/2020 13:00,15.56,35820,2161,36,148,1795,22,4162,6.570.714.286
06/09/2020 14:00,15.8,35825,2345,30,149,1836,21,4381,6.570.714.286
06/09/2020 15:00,17.66,36165,2324,26,138,1771,17,4276,6.570.714.286
06/09/2020 16:00,20.47,36947,2279,25,120,1732,13,4169,6.570.714.286
06/09/2020 17:00,20.62,37403,2246,25,102,1616,11,4000,6.570.714.286
06/09/2020 18:00,21.23,37646,2075,24,89,1704,9,3901,6.570.714.286
06/09/2020 19:00,21.39,37493,1912,23,85,1832,8,3860,6.570.714.286
06/09/2020 20:00,20.91,36825,1938,23,87,2007,8,4063,6.570.714.286
06/09/2020 21:00,17.78,35297,2039,24,92,2138,8,4301,6.570.714.286
06/09/2020 22:00,15.09,33565,2089,23,92,2167,9,4380,6.570.714.286
06/09/2020 23:00,14.51,32570,2183,52,92,2342,16,4685,6.570.714.286
07/09/2020 00:00,13.87,31776,2165,65,94,2382,18,4724,6.636.964.286
07/09/2020 01:00,13.8,31509,2214,72,95,2360,15,4756,6.636.964.286
07/09/2020 02:00,14,31694,2224,74,90,2284,11,4683,6.636.964.286
07/09/2020 03:00,14.71,32379,2069,78,86,2128,8,4369,6.636.964.286
07/09/2020 04:00,17.44,34182,1849,82,85,1935,4,3955,6.636.964.286
07/09/2020 05:00,23.85,37673,1739,80,82,1719,6,3626,6.636.964.286
07/09/2020 06:00,28.84,41161,1700,73,77,1357,6,3213,6.636.964.286
07/09/2020 07:00,31.04,42519,1580,74,72,1034,6,2766,6.636.964.286
07/09/2020 08:00,30.28,42791,1644,89,73,831,7,2644,6.636.964.286
07/09/2020 09:00,28.86,42811,1677,98,77,715,9,2576,6.636.964.286
07/09/2020 10:00,28.14,42558,1670,99,86,693,9,2557,6.636.964.286
07/09/2020 11:00,26.5,42116,1761,96,95,784,10,2746,6.636.964.286
07/09/2020 12:00,26.03,41875,1848,97,114,962,10,3031,6.636.964.286
07/09/2020 13:00,24.76,41605,2050,99,127,1322,13,3611,6.636.964.286
07/09/2020 14:00,24.54,41320,2317,114,135,1679,9,4254,6.636.964.286
07/09/2020 15:00,24.31,41123,2459,118,140,2163,8,4888,6.636.964.286
07/09/2020 16:00,23.78,41218,2483,115,137,2623,11,5369,6.636.964.286
07/09/2020 17:00,23.44,40886,2517,110,128,3096,10,5861,6.636.964.286
07/09/2020 18:00,21.78,40777,2424,101,122,3799,6,6452,6.636.964.286
07/09/2020 19:00,20.77,40379,2430,95,126,4450,4,7105,6.636.964.286
07/09/2020 20:00,17.03,39469,2561,91,132,4971,5,7760,6.636.964.286
07/09/2020 21:00,14.28,37483,2789,88,138,5289,6,8310,6.636.964.286
07/09/2020 22:00,11.67,35168,2991,83,134,5662,5,8875,6.636.964.286
07/09/2020 23:00,10.81,33340,3331,62,166,5553,10,9122,6.636.964.286
08/09/2020 00:00,9.89,32416,3444,59,178,5623,11,9315,6.636.964.286
08/09/2020 01:00,9.51,31984,3557,60,189,5645,12,9463,6.636.964.286
08/09/2020 02:00,9.53,32092,3540,56,201,5536,13,9346,6.636.964.286
08/09/2020 03:00,10.28,32640,3447,55,209,5300,21,9032,6.636.964.286
08/09/2020 04:00,11.93,34303,3375,53,205,4888,28,8549,6.636.964.286
08/09/2020 05:00,14.4,37550,3216,51,215,4826,28,8336,6.636.964.286
08/09/2020 06:00,18.7,40893,2877,48,235,4435,29,7624,6.636.964.286
08/09/2020 07:00,21.6,42086,2671,45,260,4084,32,7092,6.636.964.286
08/09/2020 08:00,21.97,42090,2671,46,298,4055,35,7105,6.636.964.286
08/09/2020 09:00,18.53,42103,2681,45,334,3930,33,7023,6.636.964.286
08/09/2020 10:00,16.01,41916,2658,47,370,3858,50,6983,6.636.964.286
08/09/2020 11:00,15.78,41646,2741,46,403,3898,50,7138,6.636.964.286
08/09/2020 12:00,15.73,41392,2801,42,424,4144,50,7461,6.636.964.286
08/09/2020 13:00,14.91,41057,2789,37,440,4198,50,7514,6.636.964.286
08/09/2020 14:00,15.79,40929,2658,32,449,4066,50,7255,6.636.964.286
08/09/2020 15:00,16.98,40696,2734,28,456,4155,47,7420,6.636.964.286
08/09/2020 16:00,19.09,40931,2617,22,459,4048,47,7193,6.636.964.286
08/09/2020 17:00,20.8,40722,2434,19,458,3942,44,6897,6.636.964.286
08/09/2020 18:00,21.96,40555,2182,22,450,4114,43,6811,6.636.964.286
08/09/2020 19:00,21.24,40147,2028,26,433,4275,39,6801,6.636.964.286
08/09/2020 20:00,17.4,39138,1970,30,417,4342,34,6793,6.636.964.286
08/09/2020 21:00,13.97,37143,1927,34,402,4466,30,6859,6.636.964.286
08/09/2020 22:00,12.47,34727,1871,34,385,4481,30,6801,6.636.964.286
08/09/2020 23:00,11.91,33054,1902,35,358,4599,26,6920,6.636.964.286
09/09/2020 00:00,11.75,32131,1880,40,335,4248,21,6524,6.636.964.286
09/09/2020 01:00,11.82,31806,1939,42,298,4129,22,6430,6.636.964.286
09/09/2020 02:00,11.8,31841,2013,42,270,3844,22,6191,6.636.964.286
09/09/2020 03:00,12.21,32417,2138,49,236,3650,18,6091,6.636.964.286
09/09/2020 04:00,14.59,34231,2366,60,209,3407,15,6057,6.636.964.286
09/09/2020 05:00,17.82,37448,2702,71,193,3370,13,6349,6.636.964.286
09/09/2020 06:00,23.42,40703,2889,84,189,3270,13,6445,6.636.964.286
09/09/2020 07:00,25.61,41823,2997,96,198,2958,14,6263,6.636.964.286
09/09/2020 08:00,25.55,41987,3218,107,231,2950,19,6525,6.636.964.286
09/09/2020 09:00,25.17,42214,3343,118,265,3118,23,6867,6.636.964.286
09/09/2020 10:00,21.06,42237,3252,137,296,3307,27,7019,6.636.964.286
09/09/2020 11:00,20.28,41970,3199,150,315,3299,29,6992,6.636.964.286
09/09/2020 12:00,19.37,41690,3073,149,324,3286,32,6864,6.636.964.286
09/09/2020 13:00,17.67,41399,3090,148,331,3267,39,6875,6.636.964.286
09/09/2020 14:00,18.05,41176,3088,139,321,3246,41,6835,6.636.964.286
09/09/2020 15:00,19.13,41034,3290,134,286,3173,40,6923,6.636.964.286
09/09/2020 16:00,23.15,41080,3373,153,262,3276,43,7107,6.636.964.286
09/09/2020 17:00,23.48,40823,3450,169,263,3526,44,7452,6.636.964.286
09/09/2020 18:00,20.7,40765,3321,166,280,3930,44,7741,6.636.964.286
09/09/2020 19:00,19.43,40349,3238,160,313,4159,45,7915,6.636.964.286
09/09/2020 20:00,15.89,39312,3375,151,353,4370,46,8295,6.636.964.286
09/09/2020 21:00,12.37,37340,3478,144,391,5013,45,9071,6.636.964.286
09/09/2020 22:00,11.47,35038,3466,121,407,5291,47,9332,6.636.964.286
09/09/2020 23:00,10.19,33466,3637,96,422,5487,50,9692,6.636.964.286
10/09/2020 00:00,9.68,32565,3462,84,423,5586,47,9602,6.636.964.286
10/09/2020 01:00,9.47,32253,3437,74,415,5592,50,9568,6.636.964.286
10/09/2020 02:00,9.5,32357,3431,66,416,5625,51,9589,6.636.964.286
10/09/2020 03:00,10.14,32912,3401,59,418,5524,52,9454,6.636.964.286
10/09/2020 04:00,11.33,34591,3381,54,417,5520,53,9425,6.636.964.286
10/09/2020 05:00,13.73,37845,3250,55,415,5516,53,9289,6.636.964.286
10/09/2020 06:00,20.8,41135,2946,52,419,5288,53,8758,6.636.964.286
10/09/2020 07:00,25.37,42413,2681,49,429,4998,53,8210,6.636.964.286
10/09/2020 08:00,25.3,42610,2558,53,439,4973,51,8074,6.636.964.286
10/09/2020 09:00,25.33,42742,2414,67,449,4810,52,7792,6.636.964.286
10/09/2020 10:00,24.23,42598,2216,80,448,4621,50,7415,6.636.964.286
10/09/2020 11:00,23.35,42165,1975,91,437,4543,47,7093,6.636.964.286
10/09/2020 12:00,21.44,41993,1808,100,419,4589,44,6960,6.636.964.286
10/09/2020 13:00,17.6,41767,1770,103,395,4581,43,6892,6.636.964.286
10/09/2020 14:00,19.73,41520,1615,110,373,4583,43,6724,6.636.964.286
10/09/2020 15:00,22.56,41397,1614,117,339,4554,38,6662,6.636.964.286
10/09/2020 16:00,23.97,41557,1464,119,281,4260,38,6162,6.636.964.286
10/09/2020 17:00,24.9,41423,1248,120,211,4003,36,5618,6.636.964.286
10/09/2020 18:00,25.19,41454,958,133,157,3960,32,5240,6.636.964.286
10/09/2020 19:00,25.23,41147,781,147,119,3793,26,4866,6.636.964.286
10/09/2020 20:00,23.97,40012,705,162,96,3766,21,4750,6.636.964.286
10/09/2020 21:00,18.8,37983,631,169,78,3562,17,4457,6.636.964.286
10/09/2020 22:00,14.64,35801,617,171,68,3364,14,4234,6.636.964.286
10/09/2020 23:00,14.01,34425,605,197,62,3062,10,3936,6.636.964.286
11/09/2020 00:00,13.92,33523,632,186,67,2882,6,3773,6.636.964.286
11/09/2020 01:00,13.92,33200,683,177,78,2650,4,3592,6.636.964.286
11/09/2020 02:00,14.24,33286,775,177,93,2494,4,3543,6.636.964.286
11/09/2020 03:00,15.18,33817,862,172,106,2399,5,3544,6.636.964.286
11/09/2020 04:00,18,35716,938,174,115,2348,6,3581,6.636.964.286
11/09/2020 05:00,24.1,39070,982,178,123,2291,7,3581,6.636.964.286
11/09/2020 06:00,26.36,42386,1070,174,126,2109,6,3485,6.636.964.286
11/09/2020 07:00,27.96,43674,1126,167,118,1920,6,3337,6.636.964.286
11/09/2020 08:00,27.86,43744,1181,168,119,1868,8,3344,6.636.964.286
11/09/2020 09:00,27.35,43838,1305,179,149,1917,10,3560,6.636.964.286
11/09/2020 10:00,26.77,43435,1488,196,170,1958,17,3829,6.636.964.286
11/09/2020 11:00,26.77,42801,1824,211,171,2077,20,4303,6.636.964.286
11/09/2020 12:00,26.35,42166,2123,219,155,2323,18,4838,6.636.964.286
11/09/2020 13:00,22.91,41610,2379,227,140,2567,16,5329,6.636.964.286
11/09/2020 14:00,19.09,41049,2423,231,123,2905,19,5701,6.636.964.286
11/09/2020 15:00,19.91,40826,2483,230,105,3046,22,5886,6.636.964.286
11/09/2020 16:00,21.43,41064,2400,230,90,3284,20,6024,6.636.964.286
11/09/2020 17:00,19.9,40886,2327,226,77,3595,16,6241,6.636.964.286
11/09/2020 18:00,17.11,40604,2122,218,71,4146,14,6571,6.636.964.286
11/09/2020 19:00,15.75,39946,2062,209,69,4644,14,6998,6.636.964.286
11/09/2020 20:00,13.9,38732,2135,194,75,4978,14,7396,6.636.964.286
11/09/2020 21:00,12.55,37008,2200,178,84,5041,13,7516,6.636.964.286
11/09/2020 22:00,11.74,35062,2163,154,99,5034,15,7465,6.636.964.286
11/09/2020 23:00,11.88,33280,2271,83,108,5365,21,7848,6.636.964.286
12/09/2020 00:00,11.79,32265,2146,80,124,5297,21,7668,6.636.964.286
12/09/2020 01:00,11.71,31843,2150,78,133,5165,25,7551,6.636.964.286
12/09/2020 02:00,11.72,31735,2152,74,136,5066,22,7450,6.636.964.286
12/09/2020 03:00,11.76,31766,2135,72,139,4656,22,7024,6.636.964.286
12/09/2020 04:00,11.9,32071,2133,73,141,4298,20,6665,6.636.964.286
12/09/2020 05:00,12.38,32788,2102,75,143,3913,19,6252,6.636.964.286
12/09/2020 06:00,12.94,34225,2018,75,142,3690,18,5943,6.636.964.286
12/09/2020 07:00,14.86,36118,2010,81,133,3397,17,5638,6.636.964.286
12/09/2020 08:00,16.6,37530,2216,87,131,3247,22,5703,6.636.964.286
12/09/2020 09:00,16.19,38260,2417,87,150,3388,29,6071,6.636.964.286
12/09/2020 10:00,14.41,38274,2573,90,174,3429,35,6301,6.636.964.286
12/09/2020 11:00,12.21,38003,2839,92,199,3407,49,6586,6.636.964.286
12/09/2020 12:00,11.64,37693,3068,94,206,3506,48,6922,6.636.964.286
12/09/2020 13:00,11.55,37479,3405,93,215,3606,48,7367,6.636.964.286
12/09/2020 14:00,11.99,37510,3489,83,213,3797,54,7636,6.636.964.286
12/09/2020 15:00,12.86,37828,3691,74,203,3869,52,7889,6.636.964.286
12/09/2020 16:00,14.86,38547,3669,60,200,3846,43,7818,6.636.964.286
12/09/2020 17:00,16.65,38765,3589,64,214,3902,30,7799,6.636.964.286
12/09/2020 18:00,16.96,38581,3252,77,236,4052,39,7656,6.636.964.286
12/09/2020 19:00,15.97,38012,2934,91,250,4335,52,7662,6.636.964.286
12/09/2020 20:00,14.23,37189,2775,94,254,4747,53,7923,6.636.964.286
12/09/2020 21:00,12.81,35749,2554,88,262,4796,53,7753,6.636.964.286
12/09/2020 22:00,11.87,34150,2255,82,277,4861,55,7530,6.636.964.286
12/09/2020 23:00,12.02,32906,2320,67,372,4813,55,7627,6.636.964.286
13/09/2020 00:00,11.86,32047,2063,62,388,4698,54,7265,6.636.964.286
13/09/2020 01:00,11.84,31682,2005,57,389,4848,53,7352,6.636.964.286
13/09/2020 02:00,11.84,31613,2067,55,371,4640,52,7185,6.636.964.286
13/09/2020 03:00,11.75,31642,2158,56,339,4851,53,7457,6.636.964.286
13/09/2020 04:00,11.61,31802,2273,54,308,4896,52,7583,6.636.964.286
13/09/2020 05:00,11.64,32101,2424,53,287,4942,48,7754,6.636.964.286
13/09/2020 06:00,11.91,33112,2551,49,273,5013,48,7934,6.636.964.286
13/09/2020 07:00,12.33,34870,2796,45,280,5150,46,8317,6.636.964.286
13/09/2020 08:00,12.76,36463,3163,46,313,5213,46,8781,6.636.964.286
13/09/2020 09:00,12.03,37370,3396,52,338,5386,46,9218,6.636.964.286
13/09/2020 10:00,9.98,37695,3446,56,356,5503,46,9407,6.636.964.286
13/09/2020 11:00,3.43,37659,3658,62,366,5651,49,9786,6.636.964.286
13/09/2020 12:00,1.78,37457,3777,66,365,5630,50,9888,6.636.964.286
13/09/2020 13:00,1.5,37317,3856,69,369,5600,53,9947,6.636.964.286
13/09/2020 14:00,4.99,37293,3712,71,365,5512,56,9716,6.636.964.286
13/09/2020 15:00,11.66,37584,3865,64,345,5416,56,9746,6.636.964.286
13/09/2020 16:00,12.75,38329,3775,55,314,5003,55,9202,6.636.964.286
13/09/2020 17:00,13.93,38820,3466,50,317,5211,56,9100,6.636.964.286
13/09/2020 18:00,14.45,39112,2847,48,335,5113,57,8400,6.636.964.286
13/09/2020 19:00,15.07,38754,2432,50,346,5234,58,8120,6.636.964.286
13/09/2020 20:00,14.01,37877,2163,53,365,5299,59,7939,6.636.964.286
13/09/2020 21:00,12.78,36260,1967,55,394,5282,59,7757,6.636.964.286
13/09/2020 22:00,12.28,34447,1781,55,424,5179,58,7497,6.636.964.286
13/09/2020 23:00,12.05,33171,2378,143,0,5238,56,7815,6.636.964.286
14/09/2020 00:00,12.03,32417,2120,117,0,5070,56,7363,6.683.630.952
14/09/2020 01:00,12.07,32098,1946,94,0,4953,53,7046,6.683.630.952
14/09/2020 02:00,12.09,32184,1715,80,0,4902,50,6747,6.683.630.952
14/09/2020 03:00,12.31,32864,1471,72,0,4793,50,6386,6.683.630.952
14/09/2020 04:00,13.82,34805,1261,69,0,4363,49,5742,6.683.630.952
14/09/2020 05:00,17.5,38334,1106,64,0,4282,42,5494,6.683.630.952
14/09/2020 06:00,25,41659,966,53,0,3895,38,4952,6.683.630.952
14/09/2020 07:00,26.28,42935,845,48,0,3716,25,4634,6.683.630.952
14/09/2020 08:00,26.29,43136,827,46,0,3572,29,4474,6.683.630.952
14/09/2020 09:00,25.82,43058,875,47,0,3594,29,4545,6.683.630.952
14/09/2020 10:00,25.12,42781,968,46,0,3526,27,4567,6.683.630.952
14/09/2020 11:00,24.46,42393,1033,44,0,3646,20,4743,6.683.630.952
14/09/2020 12:00,23.41,42142,1039,44,0,3834,18,4935,6.683.630.952
14/09/2020 13:00,21.95,41862,986,43,0,3880,14,4923,6.683.630.952
14/09/2020 14:00,24.83,41577,850,45,0,3712,15,4622,6.683.630.952
14/09/2020 15:00,25.96,41408,734,49,0,3485,9,4277,6.683.630.952
14/09/2020 16:00,26.4,41485,622,50,0,3285,6,3963,6.683.630.952
14/09/2020 17:00,26.2,41247,489,53,0,3119,6,3667,6.683.630.952
14/09/2020 18:00,26.71,41153,387,58,0,3127,5,3577,6.683.630.952
14/09/2020 19:00,25.58,40686,367,64,0,3170,6,3607,6.683.630.952
14/09/2020 20:00,23.06,39628,344,67,0,3172,5,3588,6.683.630.952
14/09/2020 21:00,18.03,37622,311,72,0,3058,6,3447,6.683.630.952
14/09/2020 22:00,14.26,35333,266,78,0,3003,6,3353,6.683.630.952
14/09/2020 23:00,13.54,33214,204,93,90,2874,8,3269,6.683.630.952
15/09/2020 00:00,12.99,32307,149,76,88,2775,7,3095,6.683.630.952
15/09/2020 01:00,13.05,32091,117,65,86,2551,6,2825,6.683.630.952
15/09/2020 02:00,13.37,32248,91,55,90,2461,3,2700,6.683.630.952
15/09/2020 03:00,14.23,32849,81,47,89,2395,4,2616,6.683.630.952
15/09/2020 04:00,17.67,34677,75,42,87,2186,5,2395,6.683.630.952
15/09/2020 05:00,26.11,37998,75,41,83,1798,4,2001,6.683.630.952
15/09/2020 06:00,30.71,41236,70,38,79,1503,4,1694,6.683.630.952
15/09/2020 07:00,33.96,42384,68,39,72,1088,3,1270,6.683.630.952
15/09/2020 08:00,33.48,42344,70,48,62,854,2,1036,6.683.630.952
15/09/2020 09:00,33.03,42382,58,59,60,581,2,760,6.683.630.952
15/09/2020 10:00,33.26,42246,45,70,63,416,3,597,6.683.630.952
15/09/2020 11:00,32.46,42007,35,78,65,364,6,548,6.683.630.952
15/09/2020 12:00,32.45,41719,33,86,53,340,7,519,6.683.630.952
15/09/2020 13:00,31.4,41409,35,91,48,348,9,531,6.683.630.952
15/09/2020 14:00,32.03,41230,49,92,42,371,7,561,6.683.630.952
15/09/2020 15:00,31.69,40974,54,84,35,396,6,575,6.683.630.952
15/09/2020 16:00,31.95,41178,73,74,30,442,3,622,6.683.630.952
15/09/2020 17:00,33.62,41076,110,72,31,547,2,762,6.683.630.952
15/09/2020 18:00,35.4,41054,121,72,37,708,2,940,6.683.630.952
15/09/2020 19:00,34.03,40565,122,73,47,844,4,1090,6.683.630.952
15/09/2020 20:00,30.16,39364,134,74,70,963,3,1244,6.683.630.952
15/09/2020 21:00,26.6,37393,143,72,94,1121,4,1434,6.683.630.952
15/09/2020 22:00,17.75,35028,166,68,111,1323,4,1672,6.683.630.952
15/09/2020 23:00,16.54,32856,175,40,128,1540,8,1891,6.683.630.952
16/09/2020 00:00,14.58,31978,227,34,147,1636,11,2055,6.683.630.952
16/09/2020 01:00,13.63,31740,290,29,162,1976,15,2472,6.683.630.952
16/09/2020 02:00,13.34,31842,456,23,175,2082,15,2751,6.683.630.952
16/09/2020 03:00,14.37,32530,655,19,190,2134,18,3016,6.683.630.952
16/09/2020 04:00,17.18,34340,804,18,198,2298,17,3335,6.683.630.952
16/09/2020 05:00,25.57,37856,917,18,197,2505,20,3657,6.683.630.952
16/09/2020 06:00,27.3,41175,994,15,187,2864,20,4080,6.683.630.952
16/09/2020 07:00,27.81,42261,1067,12,162,3364,18,4623,6.683.630.952
16/09/2020 08:00,26.54,42494,1287,12,135,3932,13,5379,6.683.630.952
16/09/2020 09:00,25.65,42625,1669,14,130,4548,17,6378,6.683.630.952
16/09/2020 10:00,23.53,42394,1937,14,136,4945,24,7056,6.683.630.952
16/09/2020 11:00,22.17,42138,2112,15,150,5326,26,7629,6.683.630.952
16/09/2020 12:00,17.76,42013,2224,14,155,5782,36,8211,6.683.630.952
16/09/2020 13:00,14.96,41711,2354,12,155,6106,41,8668,6.683.630.952
16/09/2020 14:00,14.76,41489,2487,10,156,6247,36,8936,6.683.630.952
16/09/2020 15:00,15.49,41404,2671,7,151,6420,23,9272,6.683.630.952
16/09/2020 16:00,17,41605,2729,6,150,6483,15,9383,6.683.630.952
16/09/2020 17:00,18.44,41683,2792,5,153,6447,8,9405,6.683.630.952
16/09/2020 18:00,21.83,41924,2530,4,158,6511,3,9206,6.683.630.952
16/09/2020 19:00,17.4,41437,2451,4,164,6621,4,9244,6.683.630.952
16/09/2020 20:00,14.69,40128,2584,5,170,6697,1,9457,6.683.630.952
16/09/2020 21:00,12.16,38081,2672,8,175,6778,9,9642,6.683.630.952
16/09/2020 22:00,11.57,35750,2601,12,184,6664,39,9500,6.683.630.952
16/09/2020 23:00,9.19,34370,2421,22,0,6453,49,8945,6.683.630.952
17/09/2020 00:00,9.14,33558,2137,30,0,6359,41,8567,6.683.630.952
17/09/2020 01:00,9.2,33322,1891,39,0,6267,44,8241,6.683.630.952
17/09/2020 02:00,9.32,33472,1723,47,0,6181,46,7997,6.683.630.952
17/09/2020 03:00,10,34118,1592,51,0,6003,51,7697,6.683.630.952
17/09/2020 04:00,11.03,35993,1487,54,0,5713,54,7308,6.683.630.952
17/09/2020 05:00,18.75,39521,1291,59,0,5473,56,6879,6.683.630.952
17/09/2020 06:00,27.56,42984,1000,67,0,5021,56,6144,6.683.630.952
17/09/2020 07:00,31.31,44261,743,71,0,4505,56,5375,6.683.630.952
17/09/2020 08:00,31.34,44443,570,75,0,4149,57,4851,6.683.630.952
17/09/2020 09:00,29.7,44462,472,74,0,3663,57,4266,6.683.630.952
17/09/2020 10:00,25.98,44115,385,78,0,3172,57,3692,6.683.630.952
17/09/2020 11:00,25.84,43659,336,83,0,2907,58,3384,6.683.630.952
17/09/2020 12:00,25.64,43306,349,82,0,2607,58,3096,6.683.630.952
17/09/2020 13:00,22.6,42993,402,76,0,2270,58,2806,6.683.630.952
17/09/2020 14:00,23.1,42749,420,72,0,1935,58,2485,6.683.630.952
17/09/2020 15:00,29.14,42668,422,75,0,1758,58,2313,6.683.630.952
17/09/2020 16:00,30.2,42953,423,88,0,1523,58,2092,6.683.630.952
17/09/2020 17:00,31.42,43011,425,99,0,1426,58,2008,6.683.630.952
17/09/2020 18:00,31.84,43283,387,109,0,1518,58,2072,6.683.630.952
17/09/2020 19:00,30.54,42924,401,123,0,1733,58,2315,6.683.630.952
17/09/2020 20:00,28.15,41604,399,147,0,2081,58,2685,6.683.630.952
17/09/2020 21:00,23.1,39471,377,157,0,2190,58,2782,6.683.630.952
17/09/2020 22:00,14.79,37159,335,164,0,2308,58,2865,6.683.630.952
17/09/2020 23:00,9.42,35226,446,190,368,2962,52,4018,6.683.630.952
18/09/2020 00:00,9.03,34321,482,197,351,3302,51,4383,6.683.630.952
18/09/2020 01:00,8.62,34045,491,207,331,3915,48,4992,6.683.630.952
18/09/2020 02:00,8.34,34206,526,214,316,4374,42,5472,6.683.630.952
18/09/2020 03:00,8.65,34872,596,217,303,4524,41,5681,6.683.630.952
18/09/2020 04:00,9.52,36731,659,217,286,4645,33,5840,6.683.630.952
18/09/2020 05:00,11.53,40200,712,217,262,5013,28,6232,6.683.630.952
18/09/2020 06:00,16.4,43498,718,219,236,4864,22,6059,6.683.630.952
18/09/2020 07:00,19.54,44689,682,222,216,4976,19,6115,6.683.630.952
18/09/2020 08:00,19.42,44638,678,225,218,4654,18,5793,6.683.630.952
18/09/2020 09:00,16.1,44537,751,230,220,4553,15,5769,6.683.630.952
18/09/2020 10:00,14.19,43955,797,235,204,4583,11,5830,6.683.630.952
18/09/2020 11:00,13.95,43222,809,239,198,4665,12,5923,6.683.630.952
18/09/2020 12:00,13.97,42473,826,246,185,4635,14,5906,6.683.630.952
18/09/2020 13:00,10.76,41784,801,251,179,4761,15,6007,6.683.630.952
18/09/2020 14:00,9.93,41213,792,254,173,4726,10,5955,6.683.630.952
18/09/2020 15:00,9.99,41023,786,258,167,4752,8,5971,6.683.630.952
18/09/2020 16:00,10.96,41289,769,261,156,4614,12,5812,6.683.630.952
18/09/2020 17:00,13.26,41336,701,260,149,4732,11,5853,6.683.630.952
18/09/2020 18:00,13.13,41133,588,257,144,4850,12,5851,6.683.630.952
18/09/2020 19:00,10.41,40332,555,256,145,4948,15,5919,6.683.630.952
18/09/2020 20:00,9.51,39025,574,254,154,4900,15,5897,6.683.630.952
18/09/2020 21:00,8.91,37378,565,249,158,4740,15,5727,6.683.630.952
18/09/2020 22:00,7.94,35505,540,239,150,4641,14,5584,6.683.630.952
18/09/2020 23:00,6.45,34116,364,84,165,4512,11,5136,6.683.630.952
19/09/2020 00:00,6.3,33246,336,97,154,4456,10,5053,6.683.630.952
19/09/2020 01:00,6.1,32884,317,110,142,4327,7,4903,6.683.630.952
19/09/2020 02:00,6.16,32874,284,121,128,4183,4,4720,6.683.630.952
19/09/2020 03:00,6.34,32965,276,128,112,4039,3,4558,6.683.630.952
19/09/2020 04:00,6.75,33438,256,138,98,3888,3,4383,6.683.630.952
19/09/2020 05:00,7.35,34226,224,151,84,3800,2,4261,6.683.630.952
19/09/2020 06:00,7.87,35450,188,162,70,3566,3,3989,6.683.630.952
19/09/2020 07:00,8.34,37212,153,170,49,3296,3,3671,6.683.630.952
19/09/2020 08:00,9.81,38566,132,177,39,3186,4,3538,6.683.630.952
19/09/2020 09:00,9.9,39202,114,185,39,3056,4,3398,6.683.630.952
19/09/2020 10:00,9.83,38962,106,187,43,3021,5,3362,6.683.630.952
19/09/2020 11:00,9.28,38502,83,186,51,3079,6,3405,6.683.630.952
19/09/2020 12:00,8.8,38115,70,190,52,3089,8,3409,6.683.630.952
19/09/2020 13:00,8.88,37767,70,189,54,2935,8,3256,6.683.630.952
19/09/2020 14:00,9.86,37651,82,189,57,2789,8,3125,6.683.630.952
19/09/2020 15:00,11.59,37842,87,196,62,2427,8,2780,6.683.630.952
19/09/2020 16:00,13.88,38583,111,203,65,2200,8,2587,6.683.630.952
19/09/2020 17:00,19.22,39075,112,205,72,1915,7,2311,6.683.630.952
19/09/2020 18:00,20.04,39095,118,208,79,1483,7,1895,6.683.630.952
19/09/2020 19:00,19.25,38471,124,217,85,1337,7,1770,6.683.630.952
19/09/2020 20:00,14,37558,119,222,83,1220,6,1650,6.683.630.952
19/09/2020 21:00,13.01,36318,108,223,77,1202,6,1616,6.683.630.952
19/09/2020 22:00,9.29,34863,96,209,68,1137,5,1515,6.683.630.952
19/09/2020 23:00,7.39,33414,73,212,67,1233,6,1591,6.683.630.952
20/09/2020 00:00,6.98,32692,59,213,62,1402,5,1741,6.683.630.952
20/09/2020 01:00,6.71,32435,50,212,54,1672,3,1991,6.683.630.952
20/09/2020 02:00,6.44,32333,43,207,45,2037,3,2335,6.683.630.952
20/09/2020 03:00,6.28,32459,40,208,36,2547,3,2834,6.683.630.952
20/09/2020 04:00,6.26,32772,40,211,30,2876,3,3160,6.683.630.952
20/09/2020 05:00,6.29,33125,52,213,25,3077,3,3370,6.683.630.952
20/09/2020 06:00,6.43,34055,59,216,21,3293,3,3592,6.683.630.952
20/09/2020 07:00,6.87,35733,57,221,17,3207,4,3506,6.683.630.952
20/09/2020 08:00,7.27,37199,53,223,13,3178,4,3471,6.683.630.952
20/09/2020 09:00,7.37,37853,54,219,10,3205,3,3491,6.683.630.952
20/09/2020 10:00,7.26,37912,68,212,8,3420,4,3712,6.683.630.952
20/09/2020 11:00,6.71,37628,82,206,7,3478,5,3778,6.683.630.952
20/09/2020 12:00,6.49,37216,92,201,10,3325,6,3634,6.683.630.952
20/09/2020 13:00,6.34,36974,113,197,12,3318,6,3646,6.683.630.952
20/09/2020 14:00,6.46,36885,157,194,13,3509,7,3880,6.683.630.952
20/09/2020 15:00,6.86,37253,200,188,14,3465,6,3873,6.683.630.952
20/09/2020 16:00,7.49,38133,238,178,16,3386,8,3826,6.683.630.952
20/09/2020 17:00,8.48,38907,253,165,20,3547,7,3992,6.683.630.952
20/09/2020 18:00,8.96,39313,277,151,28,3996,9,4461,6.683.630.952
20/09/2020 19:00,8.81,38944,315,135,40,4137,13,4640,6.683.630.952
20/09/2020 20:00,7.94,38013,318,120,60,4084,17,4599,6.683.630.952
20/09/2020 21:00,7.07,36483,291,101,69,4094,19,4574,6.683.630.952
20/09/2020 22:00,6.34,34717,276,89,79,3897,22,4363,6.683.630.952
20/09/2020 23:00,5.52,33153,240,246,58,3878,16,4438,6.683.630.952
21/09/2020 00:00,5.41,32454,237,237,71,3914,15,4474,6.784.047.619
21/09/2020 01:00,5.71,32169,220,228,80,3894,15,4437,6.784.047.619
21/09/2020 02:00,6.09,32328,199,217,83,3952,13,4464,6.784.047.619
21/09/2020 03:00,6.55,33108,200,199,78,4219,14,4710,6.784.047.619
21/09/2020 04:00,7.25,35109,194,178,70,4217,11,4670,6.784.047.619
21/09/2020 05:00,9.07,38701,187,158,66,4363,11,4785,6.784.047.619
21/09/2020 06:00,12.86,41951,181,136,65,4594,11,4987,6.784.047.619
21/09/2020 07:00,16.53,43150,185,115,63,4770,11,5144,6.784.047.619
21/09/2020 08:00,14.33,43269,210,94,59,4989,9,5361,6.784.047.619
21/09/2020 09:00,12.56,43191,264,77,59,5168,9,5577,6.784.047.619
21/09/2020 10:00,10.57,42850,322,72,69,5470,8,5941,6.784.047.619
21/09/2020 11:00,8.38,42400,373,81,82,5626,10,6172,6.784.047.619
21/09/2020 12:00,8.06,41994,408,99,84,5928,12,6531,6.784.047.619
21/09/2020 13:00,7.17,41698,434,112,84,6181,13,6824,6.784.047.619
21/09/2020 14:00,7.16,41422,433,116,78,6329,14,6970,6.784.047.619
21/09/2020 15:00,7.41,41223,438,116,67,6431,19,7071,6.784.047.619
21/09/2020 16:00,8.13,41454,418,121,60,6447,22,7068,6.784.047.619
21/09/2020 17:00,8.32,41525,349,131,61,6404,23,6968,6.784.047.619
21/09/2020 18:00,9.76,41586,291,138,67,6344,25,6865,6.784.047.619
21/09/2020 19:00,8.03,40940,284,133,78,6310,26,6831,6.784.047.619
21/09/2020 20:00,7.34,39708,297,125,93,6213,28,6756,6.784.047.619
21/09/2020 21:00,6.62,37654,310,116,110,6147,32,6715,6.784.047.619
21/09/2020 22:00,6.23,35379,301,108,128,5966,37,6540,6.784.047.619
21/09/2020 23:00,5.09,33638,347,100,166,5603,33,6249,6.784.047.619
22/09/2020 00:00,4.93,32755,324,90,181,5432,29,6056,6.784.047.619
22/09/2020 01:00,4.88,32548,296,80,185,5339,31,5931,6.784.047.619
22/09/2020 02:00,5.01,32709,276,76,178,5137,33,5700,6.784.047.619
22/09/2020 03:00,5.44,33376,269,76,163,5059,26,5593,6.784.047.619
22/09/2020 04:00,6.77,35320,260,75,151,4845,24,5355,6.784.047.619
22/09/2020 05:00,9.47,38735,254,71,137,4677,23,5162,6.784.047.619
22/09/2020 06:00,18.06,41873,247,64,124,4292,18,4745,6.784.047.619
22/09/2020 07:00,22.47,42996,241,61,99,3834,13,4248,6.784.047.619
22/09/2020 08:00,23.36,42953,252,65,77,3513,12,3919,6.784.047.619
22/09/2020 09:00,22.22,42914,269,70,69,3203,14,3625,6.784.047.619
22/09/2020 10:00,21.98,42656,310,76,64,2994,18,3462,6.784.047.619
22/09/2020 11:00,21.96,42309,349,89,66,2677,22,3203,6.784.047.619
22/09/2020 12:00,23.25,42007,397,100,65,2589,21,3172,6.784.047.619
22/09/2020 13:00,20.29,41629,439,110,62,2335,18,2964,6.784.047.619
22/09/2020 14:00,22.77,41468,438,121,50,2211,15,2835,6.784.047.619
22/09/2020 15:00,24.41,41310,458,128,43,2096,13,2738,6.784.047.619
22/09/2020 16:00,25.62,41617,431,138,38,1940,10,2557,6.784.047.619
22/09/2020 17:00,26.82,41855,389,163,48,2210,8,2818,6.784.047.619
22/09/2020 18:00,26.38,42132,372,184,78,2608,10,3252,6.784.047.619
22/09/2020 19:00,23.17,41395,412,196,116,2923,12,3659,6.784.047.619
22/09/2020 20:00,14.97,39943,470,199,143,3221,12,4045,6.784.047.619
22/09/2020 21:00,9.95,37873,531,200,169,3189,13,4102,6.784.047.619
22/09/2020 22:00,6.91,35558,571,196,188,3313,12,4280,6.784.047.619
22/09/2020 23:00,6.19,33986,715,194,211,3341,10,4471,6.784.047.619
23/09/2020 00:00,5.95,33082,693,186,209,3287,12,4387,6.784.047.619
23/09/2020 01:00,5.97,32770,735,177,208,3326,13,4459,6.784.047.619
23/09/2020 02:00,5.95,32878,797,166,209,3316,16,4504,6.784.047.619
23/09/2020 03:00,6.14,33548,874,158,210,3273,17,4532,6.784.047.619
23/09/2020 04:00,7.46,35365,963,149,209,3125,18,4464,6.784.047.619
23/09/2020 05:00,10.31,38785,1105,141,209,2948,17,4420,6.784.047.619
23/09/2020 06:00,20.19,41960,1241,134,206,3043,20,4644,6.784.047.619
23/09/2020 07:00,24.43,42894,1269,133,185,2816,19,4422,6.784.047.619
23/09/2020 08:00,24.37,42973,1363,131,150,2689,18,4351,6.784.047.619
23/09/2020 09:00,22.72,42914,1406,120,128,2662,16,4332,6.784.047.619
23/09/2020 10:00,18.35,42438,1400,112,119,2820,18,4469,6.784.047.619
23/09/2020 11:00,18.58,41800,1378,103,121,3181,19,4802,6.784.047.619
23/09/2020 12:00,14.02,41351,1477,94,112,3365,19,5067,6.784.047.619
23/09/2020 13:00,10.57,40978,1521,86,105,3322,20,5054,6.784.047.619
23/09/2020 14:00,14.01,40866,1327,76,88,3126,19,4636,6.784.047.619
23/09/2020 15:00,17.48,40866,1185,66,72,3005,14,4342,6.784.047.619
23/09/2020 16:00,17.53,41325,1059,56,70,3024,8,4217,6.784.047.619
23/09/2020 17:00,21.48,41627,1044,50,87,3089,7,4277,6.784.047.619
23/09/2020 18:00,20.99,41933,1122,46,119,3254,10,4551,6.784.047.619
23/09/2020 19:00,16.31,41218,1229,49,151,3401,11,4841,6.784.047.619
23/09/2020 20:00,9.97,39892,1406,51,172,3274,11,4914,6.784.047.619
23/09/2020 21:00,7.2,37926,1662,53,176,3102,11,5004,6.784.047.619
23/09/2020 22:00,6.07,35521,1746,53,180,2877,14,4870,6.784.047.619
23/09/2020 23:00,5.43,33881,2636,49,176,2638,14,5513,6.784.047.619
24/09/2020 00:00,5.08,33042,2535,48,163,2541,17,5304,6.784.047.619
24/09/2020 01:00,5.03,32781,2543,47,152,2547,20,5309,6.784.047.619
24/09/2020 02:00,5.01,32890,2649,45,147,2551,17,5409,6.784.047.619
24/09/2020 03:00,5.07,33519,2841,46,148,2546,17,5598,6.784.047.619
24/09/2020 04:00,5.72,35427,3087,49,150,2703,17,6006,6.784.047.619
24/09/2020 05:00,6.74,38826,3363,53,157,2914,17,6504,6.784.047.619
24/09/2020 06:00,10.63,41975,3452,54,156,3028,20,6710,6.784.047.619
24/09/2020 07:00,10.23,42936,3367,48,139,3189,19,6762,6.784.047.619
24/09/2020 08:00,7.97,42926,3425,44,109,3182,11,6771,6.784.047.619
24/09/2020 09:00,6.84,42809,3516,42,92,3469,9,7128,6.784.047.619
24/09/2020 10:00,6.59,42311,3502,43,89,3645,10,7289,6.784.047.619
24/09/2020 11:00,6.32,41827,3464,47,100,3739,11,7361,6.784.047.619
24/09/2020 12:00,6.4,41536,3505,51,106,3965,11,7638,6.784.047.619
24/09/2020 13:00,6.25,41323,3488,55,112,4051,10,7716,6.784.047.619
24/09/2020 14:00,6.41,41224,3396,57,110,4349,12,7924,6.784.047.619
24/09/2020 15:00,6.5,41279,3259,61,102,4457,14,7893,6.784.047.619
24/09/2020 16:00,6.88,41664,2985,67,100,4665,12,7829,6.784.047.619
24/09/2020 17:00,9.88,41873,2625,77,101,4518,10,7331,6.784.047.619
24/09/2020 18:00,11.96,42166,2312,83,106,4632,13,7146,6.784.047.619
24/09/2020 19:00,8.03,41467,2166,85,106,4460,13,6830,6.784.047.619
24/09/2020 20:00,6.67,40139,1947,85,94,4389,13,6528,6.784.047.619
24/09/2020 21:00,6,38120,1687,86,86,4377,10,6246,6.784.047.619
24/09/2020 22:00,5.35,35849,1554,83,78,4451,10,6176,6.784.047.619
24/09/2020 23:00,4.48,34054,1208,75,78,4457,8,5826,6.784.047.619
25/09/2020 00:00,4.27,33251,1044,66,67,4314,7,5498,6.784.047.619
25/09/2020 01:00,4.14,32959,895,59,58,4213,5,5230,6.784.047.619
25/09/2020 02:00,4.26,33131,791,59,48,4245,4,5147,6.784.047.619
25/09/2020 03:00,4.55,33790,884,59,45,4315,4,5307,6.784.047.619
25/09/2020 04:00,4.99,35752,1054,60,45,4338,3,5500,6.784.047.619
25/09/2020 05:00,6.26,39301,1249,63,49,4228,3,5592,6.784.047.619
25/09/2020 06:00,17.25,42508,1357,64,54,3981,3,5459,6.784.047.619
25/09/2020 07:00,18.7,43579,1423,61,60,3781,3,5328,6.784.047.619
25/09/2020 08:00,18.92,43628,1504,55,63,3550,4,5176,6.784.047.619
25/09/2020 09:00,17.73,43663,1598,56,74,3350,4,5082,6.784.047.619
25/09/2020 10:00,16.05,43283,1606,60,98,3232,5,5001,6.784.047.619
25/09/2020 11:00,16.41,42766,1584,63,130,3354,6,5137,6.784.047.619
25/09/2020 12:00,14.89,42139,1543,66,146,3475,5,5235,6.784.047.619
25/09/2020 13:00,10.24,41553,1547,69,173,3577,6,5372,6.784.047.619
25/09/2020 14:00,7.14,41077,1702,71,193,3660,8,5634,6.784.047.619
25/09/2020 15:00,7.62,41016,1860,81,209,3540,9,5699,6.784.047.619
25/09/2020 16:00,6.54,41322,1824,94,237,3674,8,5837,6.784.047.619
25/09/2020 17:00,6.87,41639,1766,104,270,3852,13,6005,6.784.047.619
25/09/2020 18:00,6.89,41471,1578,107,305,4061,18,6069,6.784.047.619
25/09/2020 19:00,5.92,40130,1436,106,338,4203,20,6103,6.784.047.619
25/09/2020 20:00,5.4,38727,1378,105,346,4402,24,6255,6.784.047.619
25/09/2020 21:00,4.94,37080,1425,99,342,4601,27,6494,6.784.047.619
25/09/2020 22:00,4.45,35111,1470,86,325,4835,29,6745,6.784.047.619
25/09/2020 23:00,2.97,33800,1802,118,330,4829,24,7103,6.784.047.619
26/09/2020 00:00,2.71,32793,1791,108,315,4909,22,7145,6.784.047.619
26/09/2020 01:00,2.47,32343,1720,97,303,4763,22,6905,6.784.047.619
26/09/2020 02:00,2.41,32323,1472,89,302,4748,22,6633,6.784.047.619
26/09/2020 03:00,2.48,32504,1407,87,303,4677,26,6500,6.784.047.619
26/09/2020 04:00,2.61,33104,1355,84,299,4481,27,6246,6.784.047.619
26/09/2020 05:00,2.93,33920,1344,83,296,4364,26,6113,6.784.047.619
26/09/2020 06:00,2.88,35194,1322,87,299,4195,26,5929,6.784.047.619
26/09/2020 07:00,3.5,37082,1181,106,301,3986,22,5596,6.784.047.619
26/09/2020 08:00,3.85,38612,1081,123,302,3627,17,5150,6.784.047.619
26/09/2020 09:00,4.01,39336,1062,128,321,3369,19,4899,6.784.047.619
26/09/2020 10:00,4.07,39273,1114,135,334,3328,21,4932,6.784.047.619
26/09/2020 11:00,4.22,38932,1159,147,357,3329,22,5014,6.784.047.619
26/09/2020 12:00,4.1,38695,1116,156,373,3461,22,5128,6.784.047.619
26/09/2020 13:00,4.04,38437,1060,158,387,3721,26,5352,6.784.047.619
26/09/2020 14:00,4.01,38365,1171,157,393,3933,25,5679,6.784.047.619
26/09/2020 15:00,4.06,38678,1469,150,395,4251,19,6284,6.784.047.619
26/09/2020 16:00,4.18,39648,1682,140,394,4327,20,6563,6.784.047.619
26/09/2020 17:00,4.08,40245,1924,134,392,4611,22,7083,6.784.047.619
26/09/2020 18:00,4.08,40192,2190,129,395,5008,30,7752,6.784.047.619
26/09/2020 19:00,3.92,39034,2463,124,399,5236,30,8252,6.784.047.619
26/09/2020 20:00,3.63,37911,2765,113,400,5119,31,8428,6.784.047.619
26/09/2020 21:00,3.06,36549,3037,96,398,5112,31,8674,6.784.047.619
26/09/2020 22:00,2.47,34972,3007,77,388,5160,30,8662,6.784.047.619
26/09/2020 23:00,1.57,32935,3520,54,379,5164,27,9144,6.784.047.619
27/09/2020 00:00,1.5,32012,3370,39,379,4920,24,8732,6.784.047.619
27/09/2020 01:00,1.48,31622,3344,29,377,4803,24,8577,6.784.047.619
27/09/2020 02:00,1.48,31509,3168,23,379,4655,24,8249,6.784.047.619
27/09/2020 03:00,1.52,31701,2992,20,380,4579,27,7998,6.784.047.619
27/09/2020 04:00,1.69,32071,2822,20,382,4504,28,7756,6.784.047.619
27/09/2020 05:00,1.9,32497,2578,22,391,4427,28,7446,6.784.047.619
27/09/2020 06:00,1.99,33346,2263,22,394,4321,28,7028,6.784.047.619
27/09/2020 07:00,2.46,35150,2001,21,394,4199,25,6640,6.784.047.619
27/09/2020 08:00,2.98,36763,1936,26,393,3853,20,6228,6.784.047.619
27/09/2020 09:00,3.4,37468,1820,39,393,3544,24,5820,6.784.047.619
27/09/2020 10:00,3.5,37706,1637,56,396,3308,27,5424,6.784.047.619
27/09/2020 11:00,3.28,37487,1470,71,404,3145,29,5119,6.784.047.619
27/09/2020 12:00,3.16,37114,1522,81,403,3102,32,5140,6.784.047.619
27/09/2020 13:00,2.98,36922,1662,89,401,2995,32,5179,6.784.047.619
27/09/2020 14:00,3.01,36889,1795,98,394,2985,28,5300,6.784.047.619
27/09/2020 15:00,3.2,37250,2002,99,388,2834,25,5348,6.784.047.619
27/09/2020 16:00,3.95,38229,2028,97,388,2864,25,5402,6.784.047.619
27/09/2020 17:00,6.14,39090,2070,99,381,2856,25,5431,6.784.047.619
27/09/2020 18:00,6.93,39644,1991,108,366,2901,26,5392,6.784.047.619
27/09/2020 19:00,4.99,38877,1989,113,343,2843,28,5316,6.784.047.619
27/09/2020 20:00,3.89,37633,2013,115,320,2683,25,5156,6.784.047.619
27/09/2020 21:00,3.3,36024,1893,119,287,2545,20,4864,6.784.047.619
27/09/2020 22:00,2.67,34183,1638,111,241,2377,14,4381,6.784.047.619
27/09/2020 23:00,2.66,33050,1524,94,129,2293,16,4056,6.784.047.619
28/09/2020 00:00,2.72,32364,1398,85,119,2063,12,3677,681.25
28/09/2020 01:00,2.82,32125,1362,76,98,1954,12,3502,681.25
28/09/2020 02:00,2.93,32255,1311,66,81,1870,9,3337,681.25
28/09/2020 03:00,3.07,32979,1310,56,67,1780,5,3218,681.25
28/09/2020 04:00,4.47,35073,1290,48,61,1662,5,3066,681.25
28/09/2020 05:00,11.41,38869,1184,42,63,1563,4,2856,681.25
28/09/2020 06:00,15.23,42028,1037,37,68,1675,4,2821,681.25
28/09/2020 07:00,16.96,43231,959,26,71,1533,4,2593,681.25
28/09/2020 08:00,16.76,43282,968,19,72,1348,2,2409,681.25
28/09/2020 09:00,16.45,43302,909,18,71,1278,3,2279,681.25
28/09/2020 10:00,16.09,43152,853,17,69,1181,5,2125,681.25
28/09/2020 11:00,14.77,42739,689,16,64,1065,6,1840,681.25
28/09/2020 12:00,14.05,42379,606,16,57,971,5,1655,681.25
28/09/2020 13:00,14.06,41971,585,17,44,910,3,1559,681.25
28/09/2020 14:00,14.02,41615,571,21,38,872,2,1504,681.25
28/09/2020 15:00,14.38,41459,591,29,34,884,2,1540,681.25
28/09/2020 16:00,14.71,41757,583,44,29,860,2,1518,681.25
28/09/2020 17:00,17.94,41956,554,61,30,936,2,1583,681.25
28/09/2020 18:00,19.46,42181,597,74,32,1018,1,1722,681.25
28/09/2020 19:00,16.14,41131,585,82,42,1063,1,1773,681.25
28/09/2020 20:00,12.24,39668,513,87,55,1071,1,1727,681.25
28/09/2020 21:00,5.67,37637,455,91,60,1018,2,1626,681.25
28/09/2020 22:00,3.58,35444,420,91,60,1001,1,1573,681.25
28/09/2020 23:00,2.77,33460,766,82,29,990,2,1869,681.25
29/09/2020 00:00,2.71,32575,741,75,32,968,2,1818,681.25
29/09/2020 01:00,2.72,32307,710,70,35,903,2,1720,681.25
29/09/2020 02:00,2.76,32465,722,64,42,841,2,1671,681.25
29/09/2020 03:00,2.9,33179,718,60,49,821,3,1651,681.25
29/09/2020 04:00,6.15,35234,724,58,61,862,2,1707,681.25
29/09/2020 05:00,14.16,38718,719,57,68,754,2,1600,681.25
29/09/2020 06:00,18.81,41756,693,52,75,797,2,1619,681.25
29/09/2020 07:00,22.11,42839,661,41,71,747,2,1522,681.25
29/09/2020 08:00,20.41,42852,678,31,56,712,2,1479,681.25
29/09/2020 09:00,20.22,42959,840,28,49,619,1,1537,681.25
29/09/2020 10:00,19.07,42862,914,29,48,609,1,1601,681.25
29/09/2020 11:00,18.75,42616,943,30,49,628,1,1651,681.25
29/09/2020 12:00,17.95,42312,965,29,38,586,1,1619,681.25
29/09/2020 13:00,17.42,41934,913,30,37,506,1,1487,681.25
29/09/2020 14:00,17.34,41795,865,30,36,436,2,1369,681.25
29/09/2020 15:00,17.01,41686,808,31,39,399,2,1279,681.25
29/09/2020 16:00,17.79,42231,740,33,52,406,3,1234,681.25
29/09/2020 17:00,22.41,42565,718,35,80,382,3,1218,681.25
29/09/2020 18:00,25.13,42736,798,35,110,447,3,1393,681.25
29/09/2020 19:00,22.27,41589,855,33,134,531,3,1556,681.25
29/09/2020 20:00,14.83,40059,854,29,140,548,4,1575,681.25
29/09/2020 21:00,6.53,37967,861,26,138,612,5,1642,681.25
29/09/2020 22:00,2.99,35550,850,24,122,654,4,1654,681.25
29/09/2020 23:00,3.04,33909,714,15,96,694,6,1525,681.25
30/09/2020 00:00,2.72,33019,670,13,88,742,6,1519,681.25
30/09/2020 01:00,2.65,32753,667,13,80,743,5,1508,681.25
30/09/2020 02:00,2.67,32887,625,12,82,716,5,1440,681.25
30/09/2020 03:00,3,33630,613,11,84,754,6,1468,681.25
30/09/2020 04:00,5.81,35661,599,9,90,770,6,1474,681.25
30/09/2020 05:00,12.84,39357,575,7,98,742,5,1427,681.25
30/09/2020 06:00,20.74,42601,570,6,107,725,5,1413,681.25
30/09/2020 07:00,25.38,43587,616,4,104,716,6,1446,681.25
30/09/2020 08:00,25.7,43705,776,3,87,669,4,1539,681.25
30/09/2020 09:00,26.92,43811,964,3,83,617,3,1670,681.25
30/09/2020 10:00,26.51,43590,1114,3,87,599,3,1806,681.25
30/09/2020 11:00,24.67,43110,1207,4,85,640,4,1940,681.25
30/09/2020 12:00,22.38,42621,1291,3,76,667,3,2040,681.25
30/09/2020 13:00,18.88,42396,1312,3,83,654,4,2056,681.25
30/09/2020 14:00,15.09,42182,1225,4,95,726,5,2055,681.25
30/09/2020 15:00,20.31,42058,1185,4,107,742,6,2044,681.25
30/09/2020 16:00,20.35,42523,1203,5,127,815,6,2156,681.25
30/09/2020 17:00,24.35,42919,1190,5,151,1007,9,2362,681.25
30/09/2020 18:00,24.09,43315,1289,6,174,1307,12,2788,681.25
30/09/2020 19:00,16.88,42366,1408,6,185,1341,14,2954,681.25
30/09/2020 20:00,9.77,40917,1537,7,177,1389,18,3128,681.25
30/09/2020 21:00,4.25,38853,1653,7,159,1475,15,3309,681.25
30/09/2020 22:00,2.69,36184,1753,7,135,1418,13,3326,681.25
30/09/2020 23:00,2.79,34190,1939,5,129,1337,11,3421,681.25
01/10/2020 00:00,2.65,33307,1926,4,126,1271,9,3336,681.25
01/10/2020 01:00,2.65,33030,1953,4,127,1264,10,3358,681.25
01/10/2020 02:00,2.67,33157,2036,4,138,1281,10,3469,681.25
01/10/2020 03:00,2.79,33810,2084,4,145,1271,11,3515,681.25
01/10/2020 04:00,3.82,35831,2124,4,149,1277,12,3566,681.25
01/10/2020 05:00,7.12,39561,2207,4,153,1315,14,3693,681.25
01/10/2020 06:00,13.99,42797,2218,4,155,1357,13,3747,681.25
01/10/2020 07:00,18.91,43807,2156,3,145,1481,12,3797,681.25
01/10/2020 08:00,16.85,43836,2324,3,133,1589,7,4056,681.25
01/10/2020 09:00,15.31,43914,2655,2,132,1582,8,4379,681.25
01/10/2020 10:00,12.16,43524,2848,2,137,1692,9,4688,681.25
01/10/2020 11:00,12.14,43133,2850,2,141,1806,11,4810,681.25
01/10/2020 12:00,11.75,42894,2816,2,151,1885,11,4865,681.25
01/10/2020 13:00,11.54,42652,2817,3,158,2005,9,4992,681.25
01/10/2020 14:00,10.92,42389,2827,6,168,1982,12,4995,681.25
01/10/2020 15:00,11.6,42525,2814,10,170,2035,13,5042,681.25
01/10/2020 16:00,11.97,42938,2864,20,173,2201,13,5271,681.25
01/10/2020 17:00,12.14,43293,2907,28,187,2565,18,5705,681.25
01/10/2020 18:00,11.26,43448,2946,34,204,2854,22,6060,681.25
01/10/2020 19:00,4.86,42217,3004,37,216,3044,24,6325,681.25
01/10/2020 20:00,3.61,40683,3089,39,216,3066,23,6433,681.25
01/10/2020 21:00,2.88,38564,3099,38,217,2973,21,6348,681.25
01/10/2020 22:00,2.62,36240,2955,38,204,2906,20,6123,681.25
01/10/2020 23:00,3.32,34615,3138,42,256,2947,15,6398,681.25
02/10/2020 00:00,3.15,33622,2912,41,243,3007,17,6220,681.25
02/10/2020 01:00,3.09,33338,2765,42,230,3050,17,6104,681.25
02/10/2020 02:00,3.11,33474,2633,47,222,3065,17,5984,681.25
02/10/2020 03:00,3.29,34055,2467,51,227,3264,21,6030,681.25
02/10/2020 04:00,3.82,36032,2429,54,230,3219,21,5953,681.25
02/10/2020 05:00,4.98,39660,2433,55,232,3274,18,6012,681.25
02/10/2020 06:00,9.27,42707,2464,51,226,3302,18,6061,681.25
02/10/2020 07:00,11.78,43722,2474,42,217,3351,16,6100,681.25
02/10/2020 08:00,11.39,43749,2604,33,216,3410,13,6276,681.25
02/10/2020 09:00,9.73,43662,2854,30,219,3491,11,6605,681.25
02/10/2020 10:00,7.33,43207,2987,29,216,3506,12,6750,681.25
02/10/2020 11:00,5.99,42654,2969,29,222,3446,11,6677,681.25
02/10/2020 12:00,5.5,42144,3083,31,228,3269,10,6621,681.25
02/10/2020 13:00,4.89,41650,3199,34,232,3216,11,6692,681.25
02/10/2020 14:00,4.43,41252,3288,40,233,3192,14,6767,681.25
02/10/2020 15:00,4.42,41179,3291,50,217,3216,14,6788,681.25
02/10/2020 16:00,4.68,41781,3400,66,205,3315,13,6999,681.25
02/10/2020 17:00,4.93,42228,3461,76,213,3548,17,7315,681.25
02/10/2020 18:00,4.53,42019,3504,78,235,3750,21,7588,681.25
02/10/2020 19:00,3.88,40450,3582,77,249,3738,21,7667,681.25
02/10/2020 20:00,3.48,39046,3596,75,246,3664,18,7599,681.25
02/10/2020 21:00,3.14,37368,3613,72,237,3434,16,7372,681.25
02/10/2020 22:00,2.55,35517,3575,66,230,3277,16,7164,681.25
02/10/2020 23:00,3,33752,3744,92,250,3166,20,7272,681.25
03/10/2020 00:00,2.59,32871,3678,91,251,3103,18,7141,681.25
03/10/2020 01:00,1.47,32449,3560,91,245,3160,19,7075,681.25
03/10/2020 02:00,1.44,32428,3619,93,242,3243,19,7216,681.25
03/10/2020 03:00,1.48,32587,3610,94,242,3368,19,7333,681.25
03/10/2020 04:00,2.23,33111,3681,95,249,3496,20,7541,681.25
03/10/2020 05:00,2.18,33966,3681,96,255,3490,21,7543,681.25
03/10/2020 06:00,3.06,35128,3643,95,267,3793,20,7818,681.25
03/10/2020 07:00,4.34,36982,3520,88,275,3893,20,7796,681.25
03/10/2020 08:00,4.62,38539,3510,77,293,3974,18,7872,681.25
03/10/2020 09:00,4.76,39186,3638,69,316,4071,21,8115,681.25
03/10/2020 10:00,4.69,39033,3711,66,328,4180,23,8308,681.25
03/10/2020 11:00,4.56,38671,3650,65,341,4184,25,8265,681.25
03/10/2020 12:00,4.25,38416,3730,64,344,4400,31,8569,681.25
03/10/2020 13:00,3.94,38074,3823,66,350,4356,33,8628,681.25
03/10/2020 14:00,4.23,38053,3857,69,353,4424,33,8736,681.25
03/10/2020 15:00,4.34,38369,3800,75,359,4409,37,8680,681.25
03/10/2020 16:00,4.58,39443,3836,87,373,4617,33,8946,681.25
03/10/2020 17:00,4.64,40217,3829,97,381,4907,35,9249,681.25
03/10/2020 18:00,4.6,40109,3798,104,393,5094,32,9421,681.25
03/10/2020 19:00,4.46,38651,3804,105,398,5180,36,9523,681.25
03/10/2020 20:00,4.11,37290,3763,103,396,5095,38,9395,681.25
03/10/2020 21:00,3.66,35906,3795,99,392,4957,37,9280,681.25
03/10/2020 22:00,2.76,34330,3658,93,389,5000,38,9178,681.25
03/10/2020 23:00,3.17,32841,3293,87,424,4939,40,8783,681.25
04/10/2020 00:00,3.17,31940,2953,84,429,4972,40,8478,681.25
04/10/2020 01:00,2.97,31547,2651,79,419,4991,38,8178,681.25
04/10/2020 02:00,3.17,31411,2278,75,412,5052,38,7855,681.25
04/10/2020 03:00,2.27,31492,1986,73,411,5103,39,7612,681.25
04/10/2020 04:00,1.93,31895,1864,75,410,5171,41,7561,681.25
04/10/2020 05:00,1.6,32387,1788,78,416,5352,40,7674,681.25
04/10/2020 06:00,1.57,33385,1706,76,420,5473,38,7713,681.25
04/10/2020 07:00,2.61,35124,1559,67,419,5447,37,7529,681.25
04/10/2020 08:00,3.37,36730,1311,53,413,5243,35,7055,681.25
04/10/2020 09:00,4.26,37678,1131,47,400,5274,39,6891,681.25
04/10/2020 10:00,4.45,38003,1162,50,392,5215,39,6858,681.25
04/10/2020 11:00,4.4,38002,1357,53,393,5068,42,6913,681.25
04/10/2020 12:00,4.26,37829,1456,59,389,5061,41,7006,681.25
04/10/2020 13:00,4.21,37742,1614,64,388,4962,42,7070,681.25
04/10/2020 14:00,4.64,37681,1848,71,377,4856,41,7193,681.25
04/10/2020 15:00,4.95,38002,1968,81,360,4596,34,7039,681.25
04/10/2020 16:00,5.95,39087,2071,94,348,4514,27,7054,681.25
04/10/2020 17:00,6.42,40062,2198,103,340,4491,27,7159,681.25
04/10/2020 18:00,7.69,40384,2341,105,327,4694,24,7491,681.25
04/10/2020 19:00,6.27,39294,2402,102,302,4609,23,7438,681.25
04/10/2020 20:00,6.09,38123,2320,96,267,4468,22,7173,681.25
04/10/2020 21:00,5.71,36528,2159,89,236,4235,15,6734,681.25
04/10/2020 22:00,5.16,34611,2033,82,198,4181,12,6506,681.25
04/10/2020 23:00,4.69,33660,1681,61,144,4291,15,6192,681.25
05/10/2020 00:00,4.7,32889,1633,57,91,4199,10,5990,6.866.011.905
05/10/2020 01:00,4.7,32612,1593,58,61,4048,11,5771,6.866.011.905
05/10/2020 02:00,4.77,32799,1661,58,48,3678,4,5449,6.866.011.905
05/10/2020 03:00,4.82,33589,1753,57,49,3626,3,5488,6.866.011.905
05/10/2020 04:00,5.56,35711,1948,58,51,3432,3,5492,6.866.011.905
05/10/2020 05:00,7.3,39556,2154,60,58,3572,3,5847,6.866.011.905
05/10/2020 06:00,11.76,42957,2327,58,70,3411,3,5869,6.866.011.905
05/10/2020 07:00,16.66,43953,2352,47,85,3013,4,5501,6.866.011.905
05/10/2020 08:00,15.59,43987,2360,36,84,2879,3,5362,6.866.011.905
05/10/2020 09:00,16,44042,2294,31,90,2723,3,5141,6.866.011.905
05/10/2020 10:00,15.23,43766,2209,33,90,2611,3,4946,6.866.011.905
05/10/2020 11:00,12.56,43318,2156,36,99,2267,4,4562,6.866.011.905
05/10/2020 12:00,14.1,42936,2114,40,116,2013,4,4287,6.866.011.905
05/10/2020 13:00,13.21,42541,1929,44,134,1742,4,3853,6.866.011.905
05/10/2020 14:00,14.6,42320,1769,52,147,1541,4,3513,6.866.011.905
05/10/2020 15:00,17.11,42197,1661,68,156,1503,4,3392,6.866.011.905
05/10/2020 16:00,18.27,42703,1576,89,180,1587,4,3436,6.866.011.905
05/10/2020 17:00,21.17,43208,1600,100,213,1738,5,3656,6.866.011.905
05/10/2020 18:00,21.13,43313,1669,99,224,1873,12,3877,6.866.011.905
05/10/2020 19:00,16.68,42050,1695,95,214,1960,15,3979,6.866.011.905
05/10/2020 20:00,11.73,40698,1600,91,212,1882,15,3800,6.866.011.905
05/10/2020 21:00,8.53,38590,1592,86,221,1746,17,3662,6.866.011.905
05/10/2020 22:00,6.47,36299,1563,81,215,1677,16,3552,6.866.011.905
05/10/2020 23:00,6.05,34763,1411,162,233,1615,10,3431,6.866.011.905
06/10/2020 00:00,5.99,33850,1356,165,241,1656,12,3430,6.866.011.905
06/10/2020 01:00,5.91,33573,1368,162,267,1652,10,3459,6.866.011.905
06/10/2020 02:00,5.62,33690,1480,148,294,1754,14,3690,6.866.011.905
06/10/2020 03:00,5.75,34347,1574,129,309,1828,24,3864,6.866.011.905
06/10/2020 04:00,6.14,36216,1648,112,324,2051,30,4165,6.866.011.905
06/10/2020 05:00,8.76,39750,1759,93,337,2197,31,4417,6.866.011.905
06/10/2020 06:00,11.84,42844,1886,76,347,2345,29,4683,6.866.011.905
06/10/2020 07:00,18.25,43833,1946,58,355,2482,26,4867,6.866.011.905
06/10/2020 08:00,17.48,43872,2061,44,349,2746,24,5224,6.866.011.905
06/10/2020 09:00,12,43995,2187,33,332,2926,25,5503,6.866.011.905
06/10/2020 10:00,12.33,43878,2231,25,310,3001,32,5599,6.866.011.905
06/10/2020 11:00,13.11,43700,2161,17,292,3143,32,5645,6.866.011.905
06/10/2020 12:00,11.89,43466,2246,14,285,3430,43,6018,6.866.011.905
06/10/2020 13:00,11.78,43138,2225,11,271,3688,41,6236,6.866.011.905
06/10/2020 14:00,11.63,43057,2055,11,248,3610,33,5957,6.866.011.905
06/10/2020 15:00,11.56,42971,1922,15,219,3713,29,5898,6.866.011.905
06/10/2020 16:00,12.08,43431,1770,25,199,3697,26,5717,6.866.011.905
06/10/2020 17:00,13.36,43847,1645,39,197,3752,23,5656,6.866.011.905
06/10/2020 18:00,13.52,43919,1563,53,199,3705,17,5537,6.866.011.905
06/10/2020 19:00,10.72,42578,1577,63,206,3578,20,5444,6.866.011.905
06/10/2020 20:00,7.46,40986,1557,69,213,3697,19,5555,6.866.011.905
06/10/2020 21:00,6.78,38884,1473,70,214,3724,18,5499,6.866.011.905
06/10/2020 22:00,6.04,36534,1360,69,210,3754,15,5408,6.866.011.905
06/10/2020 23:00,6.12,34965,855,63,211,3859,17,5005,6.866.011.905
07/10/2020 00:00,6.02,34072,776,65,197,3823,19,4880,6.866.011.905
07/10/2020 01:00,5.97,33829,759,69,181,3823,20,4852,6.866.011.905
07/10/2020 02:00,5.99,33916,782,77,168,3662,18,4707,6.866.011.905
07/10/2020 03:00,6.17,34601,840,90,160,3560,18,4668,6.866.011.905
07/10/2020 04:00,6.75,36493,895,105,159,3510,13,4682,6.866.011.905
07/10/2020 05:00,8.67,40122,871,122,161,3545,14,4713,6.866.011.905
07/10/2020 06:00,14.04,43309,859,139,160,3530,15,4703,6.866.011.905
07/10/2020 07:00,20.43,44213,832,161,145,3413,11,4562,6.866.011.905
07/10/2020 08:00,19.31,44304,836,175,126,3467,9,4613,6.866.011.905
07/10/2020 09:00,16.89,44481,817,180,118,3449,9,4573,6.866.011.905
07/10/2020 10:00,15.75,44201,843,179,118,3326,8,4474,6.866.011.905
07/10/2020 11:00,13.64,43909,906,176,121,3317,8,4528,6.866.011.905
07/10/2020 12:00,14.07,43583,1074,175,109,3217,9,4584,6.866.011.905
07/10/2020 13:00,13.35,43394,1160,169,104,3235,11,4679,6.866.011.905
07/10/2020 14:00,12.8,43274,1291,159,92,3279,11,4832,6.866.011.905
07/10/2020 15:00,12.59,43272,1413,147,76,3236,10,4882,6.866.011.905
07/10/2020 16:00,17.93,43759,1449,132,71,3178,7,4837,6.866.011.905
07/10/2020 17:00,19.54,44319,1445,119,71,3126,6,4767,6.866.011.905
07/10/2020 18:00,17.9,44355,1486,114,68,3239,7,4914,6.866.011.905
07/10/2020 19:00,11.71,42997,1669,111,70,3101,7,4958,6.866.011.905
07/10/2020 20:00,9.26,41479,1835,99,73,3043,8,5058,6.866.011.905
07/10/2020 21:00,7.2,39414,1954,87,75,2887,6,5009,6.866.011.905
07/10/2020 22:00,6.63,37128,2068,80,78,2661,5,4892,6.866.011.905
07/10/2020 23:00,7.55,35038,1740,102,52,2500,5,4399,6.866.011.905
08/10/2020 00:00,7.39,34233,1804,98,51,2317,5,4275,6.866.011.905
08/10/2020 01:00,7.35,33935,1823,95,55,2185,5,4163,6.866.011.905
08/10/2020 02:00,7.37,33968,1847,90,59,2138,7,4141,6.866.011.905
08/10/2020 03:00,7.72,34599,1912,88,59,1997,9,4065,6.866.011.905
08/10/2020 04:00,8.2,36646,1891,85,58,1945,10,3989,6.866.011.905
08/10/2020 05:00,12.02,40373,1865,84,61,1911,11,3932,6.866.011.905
08/10/2020 06:00,22.04,43615,1862,80,68,1878,11,3899,6.866.011.905
08/10/2020 07:00,24.33,44593,1835,76,68,1957,13,3949,6.866.011.905
08/10/2020 08:00,23.84,44711,1981,73,70,2029,11,4164,6.866.011.905
08/10/2020 09:00,22.74,44831,2060,71,80,1965,13,4189,6.866.011.905
08/10/2020 10:00,22.39,44528,2113,68,92,1941,12,4226,6.866.011.905
08/10/2020 11:00,22.4,44144,2100,66,104,2010,17,4297,6.866.011.905
08/10/2020 12:00,21.8,43971,1987,62,115,2098,21,4283,6.866.011.905
08/10/2020 13:00,21.18,43721,2055,54,121,2168,24,4422,6.866.011.905
08/10/2020 14:00,17.37,43626,2269,49,112,2253,23,4706,6.866.011.905
08/10/2020 15:00,20.63,43723,2302,48,102,2266,21,4739,6.866.011.905
08/10/2020 16:00,21.41,44297,2282,55,96,2401,22,4856,6.866.011.905
08/10/2020 17:00,20.74,44875,2327,68,103,2609,22,5129,6.866.011.905
08/10/2020 18:00,20.04,44737,2336,80,116,2840,19,5391,6.866.011.905
08/10/2020 19:00,12.19,43343,2482,89,132,2891,17,5611,6.866.011.905
08/10/2020 20:00,8.83,41894,2667,86,145,2764,20,5682,6.866.011.905
08/10/2020 21:00,7.85,39770,2949,81,160,2593,22,5805,6.866.011.905
08/10/2020 22:00,6.86,37518,3221,74,171,2464,24,5954,6.866.011.905
08/10/2020 23:00,9.36,35477,2686,66,180,2152,12,5096,6.866.011.905
09/10/2020 00:00,8.58,34556,3014,61,194,2104,16,5389,6.866.011.905
09/10/2020 01:00,8.39,34262,3021,57,210,2191,18,5497,6.866.011.905
09/10/2020 02:00,8.68,34445,2778,53,231,2294,19,5375,6.866.011.905
09/10/2020 03:00,9.54,35223,2414,48,256,2457,20,5195,6.866.011.905
09/10/2020 04:00,10.02,37294,2138,45,278,2685,28,5174,6.866.011.905
09/10/2020 05:00,12.4,40966,2000,41,291,2963,30,5325,6.866.011.905
09/10/2020 06:00,17.1,44368,1849,38,297,3035,32,5251,6.866.011.905
09/10/2020 07:00,19.39,45399,1654,38,301,3075,34,5102,6.866.011.905
09/10/2020 08:00,19.95,45440,1616,40,300,3202,36,5194,6.866.011.905
09/10/2020 09:00,20.1,45404,1674,42,299,3241,35,5291,6.866.011.905
09/10/2020 10:00,20.26,44913,1694,44,293,3179,25,5235,6.866.011.905
09/10/2020 11:00,19.78,44390,1704,48,286,3044,25,5107,6.866.011.905
09/10/2020 12:00,18.99,43670,1672,50,291,3026,29,5068,6.866.011.905
09/10/2020 13:00,17.75,43148,1789,52,292,2947,31,5111,6.866.011.905
09/10/2020 14:00,15.92,42803,1895,56,269,2810,23,5053,6.866.011.905
09/10/2020 15:00,14.08,42879,1958,64,227,2727,20,4996,6.866.011.905
09/10/2020 16:00,15.2,43632,1960,75,182,2575,19,4811,6.866.011.905
09/10/2020 17:00,17.15,44254,1835,79,151,2563,16,4644,6.866.011.905
09/10/2020 18:00,14.3,43871,1864,87,125,2717,13,4806,6.866.011.905
09/10/2020 19:00,12.59,42173,1763,94,107,2833,9,4806,6.866.011.905
09/10/2020 20:00,12.03,40724,1565,97,94,2816,8,4580,6.866.011.905
09/10/2020 21:00,11.07,39057,1444,97,84,2915,7,4547,6.866.011.905
09/10/2020 22:00,10.33,37244,1389,89,71,2845,8,4402,6.866.011.905
09/10/2020 23:00,12.37,35762,1214,85,69,2904,9,4281,6.866.011.905
10/10/2020 00:00,12.16,34902,1099,81,62,2750,9,4001,6.866.011.905
10/10/2020 01:00,12.06,34507,1079,80,58,2672,10,3899,6.866.011.905
10/10/2020 02:00,12.04,34490,1006,79,63,2523,9,3680,6.866.011.905
10/10/2020 03:00,12.17,34639,847,79,71,2394,6,3397,6.866.011.905
10/10/2020 04:00,12.44,35248,793,78,89,2181,7,3148,6.866.011.905
10/10/2020 05:00,13.27,36196,839,78,114,2048,6,3085,6.866.011.905
10/10/2020 06:00,14.31,37477,941,76,133,1762,10,2922,6.866.011.905
10/10/2020 07:00,15.53,39259,968,70,140,1475,15,2668,6.866.011.905
10/10/2020 08:00,16.32,40908,1082,63,141,1260,10,2556,6.866.011.905
10/10/2020 09:00,16.93,41707,1064,61,149,1040,10,2324,6.866.011.905
10/10/2020 10:00,17.42,41617,1072,60,168,872,10,2182,6.866.011.905
10/10/2020 11:00,16.95,41413,1195,59,184,748,13,2199,6.866.011.905
10/10/2020 12:00,16.28,41117,1311,63,173,723,19,2289,6.866.011.905
10/10/2020 13:00,15.86,40646,1414,67,170,702,16,2369,6.866.011.905
10/10/2020 14:00,15.89,40556,1560,69,163,736,16,2544,6.866.011.905
10/10/2020 15:00,16.56,41022,1733,76,159,794,18,2780,6.866.011.905
10/10/2020 16:00,17.89,42270,1826,88,165,878,17,2974,6.866.011.905
10/10/2020 17:00,20.62,43229,1808,96,166,1032,18,3120,6.866.011.905
10/10/2020 18:00,19.2,42853,1927,99,154,1198,13,3391,6.866.011.905
10/10/2020 19:00,16.49,41227,1989,99,133,1336,13,3570,6.866.011.905
10/10/2020 20:00,15.69,40006,2035,95,111,1435,11,3687,6.866.011.905
10/10/2020 21:00,14.29,38758,1928,92,87,1388,12,3507,6.866.011.905
10/10/2020 22:00,12.47,37101,1788,90,77,1354,8,3317,6.866.011.905
10/10/2020 23:00,15.86,35776,1527,115,58,1350,6,3056,6.866.011.905
11/10/2020 00:00,15.11,34946,1485,121,58,1384,6,3054,6.866.011.905
11/10/2020 01:00,14.78,34603,1366,128,51,1497,6,3048,6.866.011.905
11/10/2020 02:00,14.75,34502,1351,139,42,1501,5,3038,6.866.011.905
11/10/2020 03:00,14.78,34615,1259,150,35,1635,5,3084,6.866.011.905
11/10/2020 04:00,14.56,35112,1155,158,34,1707,4,3058,6.866.011.905
11/10/2020 05:00,15.31,35800,1216,162,31,1842,4,3255,6.866.011.905
11/10/2020 06:00,16.04,36821,1296,167,25,2044,4,3536,6.866.011.905
11/10/2020 07:00,16.3,38464,1175,169,19,2162,4,3529,6.866.011.905
11/10/2020 08:00,17.52,40058,1105,167,14,2157,4,3447,6.866.011.905
11/10/2020 09:00,17.71,41010,1145,168,16,2159,4,3492,6.866.011.905
11/10/2020 10:00,17.69,41165,1098,170,18,2099,4,3389,6.866.011.905
11/10/2020 11:00,17.71,40880,967,170,18,1919,4,3078,6.866.011.905
11/10/2020 12:00,17.63,40579,922,163,18,1834,4,2941,6.866.011.905
11/10/2020 13:00,17.6,40451,959,161,18,1667,4,2809,6.866.011.905
11/10/2020 14:00,17.66,40480,930,162,19,1493,4,2608,6.866.011.905
11/10/2020 15:00,17.8,40998,882,165,19,1404,4,2474,6.866.011.905
11/10/2020 16:00,18.07,42213,804,161,20,1326,3,2314,6.866.011.905
11/10/2020 17:00,19.51,43362,713,157,24,1271,3,2168,6.866.011.905
11/10/2020 18:00,19.8,43475,684,156,25,1228,3,2096,6.866.011.905
11/10/2020 19:00,18.68,42304,652,152,24,1195,4,2027,6.866.011.905
11/10/2020 20:00,17.98,41173,528,149,22,1043,4,1746,6.866.011.905
11/10/2020 21:00,17.77,39577,470,149,22,944,4,1589,6.866.011.905
11/10/2020 22:00,17.01,37687,475,143,21,862,4,1505,6.866.011.905
11/10/2020 23:00,17.69,35985,326,95,28,857,11,1317,6.866.011.905
12/10/2020 00:00,17.39,35222,369,94,27,840,10,1340,6.788.214.286
12/10/2020 01:00,17.16,35044,426,92,26,875,10,1429,6.788.214.286
12/10/2020 02:00,17.19,35195,611,89,29,918,7,1654,6.788.214.286
12/10/2020 03:00,17.59,36012,851,86,34,978,8,1957,6.788.214.286
12/10/2020 04:00,18.56,38309,853,87,39,1078,10,2067,6.788.214.286
12/10/2020 05:00,22.3,42291,767,91,43,1164,10,2075,6.788.214.286
12/10/2020 06:00,24.46,45719,848,97,41,1253,8,2247,6.788.214.286
12/10/2020 07:00,27.5,46801,918,107,41,1272,14,2352,6.788.214.286
12/10/2020 08:00,26.96,46990,941,121,35,1287,11,2395,6.788.214.286
12/10/2020 09:00,26.6,47086,877,138,28,1206,8,2257,6.788.214.286
12/10/2020 10:00,25.68,46731,830,157,30,1205,7,2229,6.788.214.286
12/10/2020 11:00,23.93,46257,860,169,35,1169,10,2243,6.788.214.286
12/10/2020 12:00,23.85,45821,894,173,32,1200,10,2309,6.788.214.286
12/10/2020 13:00,23.88,45340,886,171,33,1270,9,2369,6.788.214.286
12/10/2020 14:00,23.39,45099,813,141,32,1121,9,2116,6.788.214.286
12/10/2020 15:00,23.23,44969,720,117,33,1118,9,1997,6.788.214.286
12/10/2020 16:00,24.02,45565,614,113,35,1163,9,1934,6.788.214.286
12/10/2020 17:00,26.94,46397,522,111,45,1270,9,1957,6.788.214.286
12/10/2020 18:00,27.83,46369,427,108,64,1690,10,2299,6.788.214.286
12/10/2020 19:00,23.75,44946,362,100,71,1702,11,2246,6.788.214.286
12/10/2020 20:00,22.49,43518,329,93,72,1761,16,2271,6.788.214.286
12/10/2020 21:00,19.45,41401,269,88,72,1810,19,2258,6.788.214.286
12/10/2020 22:00,17.96,39074,210,79,67,1811,18,2185,6.788.214.286
12/10/2020 23:00,19.37,37661,164,13,0,1797,7,1981,6.788.214.286
13/10/2020 00:00,18.67,36759,198,13,0,1793,9,2013,6.788.214.286
13/10/2020 01:00,18.41,36573,191,14,0,1800,6,2011,6.788.214.286
13/10/2020 02:00,18.26,36802,145,17,0,1840,7,2009,6.788.214.286
13/10/2020 03:00,18.44,37553,104,21,0,1896,6,2027,6.788.214.286
13/10/2020 04:00,19.53,39706,100,25,0,2028,5,2158,6.788.214.286
13/10/2020 05:00,21.64,43645,143,27,0,1802,4,1976,6.788.214.286
13/10/2020 06:00,23.23,46976,182,28,0,1719,4,1933,6.788.214.286
13/10/2020 07:00,24.3,48082,172,29,0,1588,3,1792,6.788.214.286
13/10/2020 08:00,24.02,48102,160,27,0,1415,3,1605,6.788.214.286
13/10/2020 09:00,23.93,47970,134,32,0,1336,2,1504,6.788.214.286
13/10/2020 10:00,23.36,47552,138,40,0,1086,2,1266,6.788.214.286
13/10/2020 11:00,23.12,47049,168,48,0,1083,2,1301,6.788.214.286
13/10/2020 12:00,23,46421,224,52,0,1026,3,1305,6.788.214.286
13/10/2020 13:00,22.38,45994,297,49,0,940,5,1291,6.788.214.286
13/10/2020 14:00,21.85,45691,392,47,0,923,7,1369,6.788.214.286
13/10/2020 15:00,21.82,45644,449,46,0,994,7,1496,6.788.214.286
13/10/2020 16:00,22.9,46431,515,43,0,1115,8,1681,6.788.214.286
13/10/2020 17:00,23.81,47305,708,48,0,1422,11,2189,6.788.214.286
13/10/2020 18:00,23.95,47252,1010,53,0,1570,17,2650,6.788.214.286
13/10/2020 19:00,22.09,45780,1274,60,0,1945,19,3298,6.788.214.286
13/10/2020 20:00,20.2,44232,1529,61,0,2089,23,3702,6.788.214.286
13/10/2020 21:00,18.73,42178,1756,59,0,2115,27,3957,6.788.214.286
13/10/2020 22:00,17.69,39811,1948,56,0,2321,33,4358,6.788.214.286
13/10/2020 23:00,18.35,38364,1779,38,0,2271,12,4100,6.788.214.286
14/10/2020 00:00,17.78,37566,1876,35,0,2407,15,4333,6.788.214.286
14/10/2020 01:00,17.38,37324,1935,34,0,2542,17,4528,6.788.214.286
14/10/2020 02:00,17.05,37489,2076,36,0,2668,17,4797,6.788.214.286
14/10/2020 03:00,17.46,38339,2328,30,0,2799,20,5177,6.788.214.286
14/10/2020 04:00,18.67,40528,2536,24,0,2926,23,5509,6.788.214.286
14/10/2020 05:00,20.18,44429,2712,21,0,3037,27,5797,6.788.214.286
14/10/2020 06:00,23.39,47741,2870,17,0,3153,27,6067,6.788.214.286
14/10/2020 07:00,26.69,48802,2890,15,0,3179,33,6117,6.788.214.286
14/10/2020 08:00,24.82,48930,3112,13,0,3074,35,6234,6.788.214.286
14/10/2020 09:00,22.67,48823,3349,14,0,3118,38,6519,6.788.214.286
14/10/2020 10:00,21.31,48253,3557,16,0,3318,40,6931,6.788.214.286
14/10/2020 11:00,20.04,47736,3710,17,0,3474,40,7241,6.788.214.286
14/10/2020 12:00,19.94,47186,3743,17,0,3674,40,7474,6.788.214.286
14/10/2020 13:00,19.73,46867,3729,16,0,3844,40,7629,6.788.214.286
14/10/2020 14:00,19.54,46659,3672,15,0,3973,40,7700,6.788.214.286
14/10/2020 15:00,19.53,46744,3639,16,0,4138,40,7833,6.788.214.286
14/10/2020 16:00,19.83,47501,3599,17,0,4391,39,8046,6.788.214.286
14/10/2020 17:00,20.33,48405,3429,21,0,4812,37,8299,6.788.214.286
14/10/2020 18:00,20.02,48251,3403,26,0,5104,38,8571,6.788.214.286
14/10/2020 19:00,19.1,46695,3386,34,0,5246,37,8703,6.788.214.286
14/10/2020 20:00,18.25,45312,3318,37,0,5340,36,8731,6.788.214.286
14/10/2020 21:00,17.29,43260,3242,39,0,5324,36,8641,6.788.214.286
14/10/2020 22:00,15.96,40787,3190,41,0,5350,33,8614,6.788.214.286
14/10/2020 23:00,15.49,39028,3054,43,192,5341,31,8661,6.788.214.286
15/10/2020 00:00,14.77,38177,2991,46,170,5496,33,8736,6.788.214.286
15/10/2020 01:00,14.62,37854,2925,51,148,5460,32,8616,6.788.214.286
15/10/2020 02:00,14.71,37972,2934,57,131,5260,32,8414,6.788.214.286
15/10/2020 03:00,15.48,38746,2915,65,116,5172,31,8299,6.788.214.286
15/10/2020 04:00,17.56,41022,2814,76,101,4922,29,7942,6.788.214.286
15/10/2020 05:00,20.24,44934,2724,85,94,4722,32,7657,6.788.214.286
15/10/2020 06:00,22.08,48323,2696,90,87,4393,29,7295,6.788.214.286
15/10/2020 07:00,24.53,49404,2599,90,82,3946,29,6746,6.788.214.286
15/10/2020 08:00,25.52,49428,2675,94,78,3594,29,6470,6.788.214.286
15/10/2020 09:00,23.97,49346,2698,110,76,3173,28,6085,6.788.214.286
15/10/2020 10:00,22.9,48767,2578,123,77,2787,26,5591,6.788.214.286
15/10/2020 11:00,22.22,48092,2323,130,80,2569,22,5124,6.788.214.286
15/10/2020 12:00,21.9,47495,2061,138,81,2497,21,4798,6.788.214.286
15/10/2020 13:00,22.09,47120,1853,143,84,2445,16,4541,6.788.214.286
15/10/2020 14:00,21.94,46847,1727,147,83,2407,16,4380,6.788.214.286
15/10/2020 15:00,22.52,46857,1606,155,89,2356,14,4220,6.788.214.286
15/10/2020 16:00,23.83,47590,1415,164,108,2437,11,4135,6.788.214.286
15/10/2020 17:00,24.63,48358,1294,167,124,2585,8,4178,6.788.214.286
15/10/2020 18:00,24.9,48191,1281,168,132,2842,8,4431,6.788.214.286
15/10/2020 19:00,22.29,46776,1218,169,133,2970,10,4500,6.788.214.286
15/10/2020 20:00,21.55,45304,1081,165,127,3133,10,4516,6.788.214.286
15/10/2020 21:00,20.49,43169,857,161,120,3254,8,4400,6.788.214.286
15/10/2020 22:00,19.19,40880,700,155,112,3255,9,4231,6.788.214.286
15/10/2020 23:00,19.03,38830,272,145,86,3322,8,3833,6.788.214.286
16/10/2020 00:00,18.14,37966,243,147,91,3313,7,3801,6.788.214.286
16/10/2020 01:00,17.95,37678,222,151,87,3207,6,3673,6.788.214.286
16/10/2020 02:00,17.99,37777,208,149,81,3178,8,3624,6.788.214.286
16/10/2020 03:00,18.42,38465,226,145,76,2986,8,3441,6.788.214.286
16/10/2020 04:00,20.21,40702,271,139,71,2758,7,3246,6.788.214.286
16/10/2020 05:00,21.37,44539,333,133,65,2514,5,3050,6.788.214.286
16/10/2020 06:00,24.56,47899,389,119,63,2373,7,2951,6.788.214.286
16/10/2020 07:00,28.99,48999,445,105,59,2277,7,2893,6.788.214.286
16/10/2020 08:00,29.96,49159,521,101,54,1884,5,2565,6.788.214.286
16/10/2020 09:00,29.94,48907,560,93,53,1804,5,2515,6.788.214.286
16/10/2020 10:00,28.82,48231,609,81,56,1689,7,2442,6.788.214.286
16/10/2020 11:00,27.57,47568,714,70,59,1578,6,2427,6.788.214.286
16/10/2020 12:00,25.24,46820,743,63,49,1574,6,2435,6.788.214.286
16/10/2020 13:00,22.99,46043,715,60,56,1611,6,2448,6.788.214.286
16/10/2020 14:00,22.47,45578,656,59,62,1659,5,2441,6.788.214.286
16/10/2020 15:00,22.97,45561,634,58,69,1759,5,2525,6.788.214.286
16/10/2020 16:00,25.09,46350,687,64,79,2126,4,2960,6.788.214.286
16/10/2020 17:00,26.84,47138,783,70,87,2367,4,3311,6.788.214.286
16/10/2020 18:00,25.56,46498,894,72,96,2654,5,3721,6.788.214.286
16/10/2020 19:00,22.3,44705,978,72,101,2742,5,3898,6.788.214.286
16/10/2020 20:00,21.41,43242,999,70,98,2860,4,4031,6.788.214.286
16/10/2020 21:00,20.54,41544,914,67,91,2803,4,3879,6.788.214.286
16/10/2020 22:00,19.33,39746,833,62,79,2755,4,3733,6.788.214.286
16/10/2020 23:00,18.72,38060,776,67,69,2976,4,3892,6.788.214.286
17/10/2020 00:00,18.15,37155,676,67,67,3072,4,3886,6.788.214.286
17/10/2020 01:00,17.42,36810,527,68,63,3161,3,3822,6.788.214.286
17/10/2020 02:00,17.24,36783,406,67,60,3328,3,3864,6.788.214.286
17/10/2020 03:00,17.29,36972,338,64,57,3485,3,3947,6.788.214.286
17/10/2020 04:00,17.41,37720,287,61,50,3638,3,4039,6.788.214.286
17/10/2020 05:00,17.97,38875,240,60,46,3756,3,4105,6.788.214.286
17/10/2020 06:00,18.64,40247,213,59,43,3779,3,4097,6.788.214.286
17/10/2020 07:00,19.33,41855,205,54,39,3884,4,4186,6.788.214.286
17/10/2020 08:00,19.74,43505,182,43,28,3762,6,4021,6.788.214.286
17/10/2020 09:00,19.95,44267,145,34,19,3632,4,3834,6.788.214.286
17/10/2020 10:00,19.76,44104,161,33,13,3630,3,3840,6.788.214.286
17/10/2020 11:00,19.55,43608,228,33,9,3649,3,3922,6.788.214.286
17/10/2020 12:00,19.07,43105,364,33,7,3699,3,4106,6.788.214.286
17/10/2020 13:00,18.61,42676,580,34,6,3702,4,4326,6.788.214.286
17/10/2020 14:00,18.45,42672,816,34,5,3711,4,4570,6.788.214.286
17/10/2020 15:00,18.91,43094,1148,34,5,3619,4,4810,6.788.214.286
17/10/2020 16:00,19.35,44505,1504,39,6,3784,4,5337,6.788.214.286
17/10/2020 17:00,19.62,45513,1886,47,7,3902,6,5848,6.788.214.286
17/10/2020 18:00,19.15,44862,2336,56,8,4149,7,6556,6.788.214.286
17/10/2020 19:00,17.91,43184,2717,62,11,4248,8,7046,6.788.214.286
17/10/2020 20:00,16.69,42057,2956,65,15,4328,9,7373,6.788.214.286
17/10/2020 21:00,15.52,40728,3119,65,23,4339,10,7556,6.788.214.286
17/10/2020 22:00,14.2,39163,3232,61,34,4471,14,7812,6.788.214.286
17/10/2020 23:00,14.85,38149,3045,65,31,4572,16,7729,6.788.214.286
18/10/2020 00:00,14.09,37394,3013,58,54,4975,19,8119,6.788.214.286
18/10/2020 01:00,13.18,37113,2949,50,80,5427,24,8530,6.788.214.286
18/10/2020 02:00,12.77,37173,2878,45,112,5723,33,8791,6.788.214.286
18/10/2020 03:00,12.92,37353,2720,41,149,5853,31,8794,6.788.214.286
18/10/2020 04:00,13.48,37981,2497,39,184,5950,29,8699,6.788.214.286
18/10/2020 05:00,14.01,38807,2330,34,214,6089,23,8690,6.788.214.286
18/10/2020 06:00,14.7,39898,2205,35,254,6029,35,8558,6.788.214.286
18/10/2020 07:00,16.58,41513,2007,32,294,6064,32,8429,6.788.214.286
18/10/2020 08:00,17.26,43307,1891,29,323,6119,33,8395,6.788.214.286
18/10/2020 09:00,18.09,44300,1878,25,344,6184,25,8456,6.788.214.286
18/10/2020 10:00,17.61,44369,1862,20,358,6271,18,8529,6.788.214.286
18/10/2020 11:00,17.24,43903,1926,16,339,6271,29,8581,6.788.214.286
18/10/2020 12:00,17.13,43478,1982,12,307,6316,39,8656,6.788.214.286
18/10/2020 13:00,16.98,43279,2096,8,304,6311,40,8759,6.788.214.286
18/10/2020 14:00,17.14,43227,2146,6,326,6234,37,8749,6.788.214.286
18/10/2020 15:00,17.83,43680,2164,4,333,6026,36,8563,6.788.214.286
18/10/2020 16:00,19.84,45179,2045,4,319,6066,37,8471,6.788.214.286
18/10/2020 17:00,20.42,46711,1916,5,302,6076,45,8344,6.788.214.286
18/10/2020 18:00,20.41,46826,1893,7,278,6228,43,8449,6.788.214.286
18/10/2020 19:00,20.21,45718,1888,9,243,6132,42,8314,6.788.214.286
18/10/2020 20:00,19.94,44634,1973,11,220,6143,37,8384,6.788.214.286
18/10/2020 21:00,18.76,43051,1982,12,211,6088,29,8322,6.788.214.286
18/10/2020 22:00,17.43,41233,1906,14,200,6054,34,8208,6.788.214.286
18/10/2020 23:00,17.12,40106,1652,57,238,6060,28,8035,6.788.214.286
19/10/2020 00:00,16.92,39476,1588,54,250,5980,25,7897,6.754.345.238
19/10/2020 01:00,16.63,39329,1553,52,274,5904,40,7823,6.754.345.238
19/10/2020 02:00,16.78,39479,1545,52,296,5893,46,7832,6.754.345.238
19/10/2020 03:00,17.77,40327,1495,52,303,5839,49,7738,6.754.345.238
19/10/2020 04:00,19.48,42632,1358,50,309,5758,49,7524,6.754.345.238
19/10/2020 05:00,20.63,46971,1195,47,302,5602,49,7195,6.754.345.238
19/10/2020 06:00,24.26,50732,1164,43,299,5436,51,6993,6.754.345.238
19/10/2020 07:00,26.94,51686,1033,41,303,5129,51,6557,6.754.345.238
19/10/2020 08:00,26.93,51656,964,43,311,4802,52,6172,6.754.345.238
19/10/2020 09:00,25.93,51596,926,42,338,4575,52,5933,6.754.345.238
19/10/2020 10:00,24.41,51034,948,36,371,4196,52,5603,6.754.345.238
19/10/2020 11:00,24.09,50334,904,32,397,3947,52,5332,6.754.345.238
19/10/2020 12:00,23.31,49775,807,29,403,3601,50,4890,6.754.345.238
19/10/2020 13:00,22.11,49273,798,26,390,3267,50,4531,6.754.345.238
19/10/2020 14:00,22.55,49090,812,22,358,3151,50,4393,6.754.345.238
19/10/2020 15:00,24.47,49077,790,19,319,2732,47,3907,6.754.345.238
19/10/2020 16:00,27,49853,904,20,287,2562,46,3819,6.754.345.238
19/10/2020 17:00,27.79,50839,1069,19,267,2466,45,3866,6.754.345.238
19/10/2020 18:00,28.85,50688,1310,17,248,2364,43,3982,6.754.345.238
19/10/2020 19:00,24.95,49308,1590,12,230,2123,41,3996,6.754.345.238
19/10/2020 20:00,21.92,47977,1768,9,215,1846,34,3872,6.754.345.238
19/10/2020 21:00,20.81,45953,1900,6,208,1619,33,3766,6.754.345.238
19/10/2020 22:00,19.79,43610,2101,4,195,1479,30,3809,6.754.345.238
19/10/2020 23:00,20.19,42154,1965,161,185,1371,30,3712,6.754.345.238
20/10/2020 00:00,19.87,41166,2007,163,170,1273,24,3637,6.754.345.238
20/10/2020 01:00,19.51,40892,2077,167,158,1218,22,3642,6.754.345.238
20/10/2020 02:00,19.44,41085,2154,171,146,1148,23,3642,6.754.345.238
20/10/2020 03:00,19.88,41768,2186,166,134,1189,27,3702,6.754.345.238
20/10/2020 04:00,20.77,43837,2211,163,115,1263,25,3777,6.754.345.238
20/10/2020 05:00,21.6,47882,2267,160,90,1380,24,3921,6.754.345.238
20/10/2020 06:00,27.34,51464,2462,159,68,1552,21,4262,6.754.345.238
20/10/2020 07:00,29.98,52623,2551,161,43,1664,14,4433,6.754.345.238
20/10/2020 08:00,27.38,52504,2720,161,33,1721,8,4643,6.754.345.238
20/10/2020 09:00,24.94,52317,2943,162,24,1784,5,4918,6.754.345.238
20/10/2020 10:00,22.71,51948,3048,162,22,1946,3,5181,6.754.345.238
20/10/2020 11:00,21.13,51454,3090,157,29,1979,3,5258,6.754.345.238
20/10/2020 12:00,20.83,51031,3090,157,37,2043,4,5331,6.754.345.238
20/10/2020 13:00,20.66,50722,3000,154,41,2150,3,5348,6.754.345.238
20/10/2020 14:00,20.54,50470,2940,149,43,2295,3,5430,6.754.345.238
20/10/2020 15:00,20.76,50481,2846,147,62,2528,2,5585,6.754.345.238
20/10/2020 16:00,21.75,51365,2779,149,91,2606,5,5630,6.754.345.238
20/10/2020 17:00,23.28,52170,2702,149,130,2934,12,5927,6.754.345.238
20/10/2020 18:00,21.74,51554,2694,147,166,3075,15,6097,6.754.345.238
20/10/2020 19:00,20.42,49874,2667,144,196,3186,21,6214,6.754.345.238
20/10/2020 20:00,19.57,48077,2699,140,216,3196,21,6272,6.754.345.238
20/10/2020 21:00,19.23,45700,2808,128,232,2969,22,6159,6.754.345.238
20/10/2020 22:00,17.96,43051,2818,125,235,2886,22,6086,6.754.345.238
20/10/2020 23:00,16.15,40700,2092,124,261,2822,19,5318,6.754.345.238
21/10/2020 00:00,15.61,39768,1914,118,258,2932,19,5241,6.754.345.238
21/10/2020 01:00,15.66,39356,1832,111,246,2913,16,5118,6.754.345.238
21/10/2020 02:00,15.67,39373,1784,104,224,2926,15,5053,6.754.345.238
21/10/2020 03:00,16.27,40055,1642,95,196,2978,15,4926,6.754.345.238
21/10/2020 04:00,18.14,42022,1448,85,173,2818,15,4539,6.754.345.238
21/10/2020 05:00,18.94,45893,1214,72,164,2875,13,4338,6.754.345.238
21/10/2020 06:00,23.52,49283,1121,55,148,2832,12,4168,6.754.345.238
21/10/2020 07:00,26.96,50161,1035,39,136,2725,11,3946,6.754.345.238
21/10/2020 08:00,25.94,50055,1033,26,117,2566,9,3751,6.754.345.238
21/10/2020 09:00,26.65,49945,1135,19,103,2496,8,3761,6.754.345.238
21/10/2020 10:00,24.59,49610,1207,15,96,2426,7,3751,6.754.345.238
21/10/2020 11:00,23.93,49099,1321,13,94,2385,5,3818,6.754.345.238
21/10/2020 12:00,22.31,48683,1521,13,93,2290,7,3924,6.754.345.238
21/10/2020 13:00,20.71,48344,1706,11,88,2152,10,3967,6.754.345.238
21/10/2020 14:00,19.28,48161,1954,9,83,1978,10,4034,6.754.345.238
21/10/2020 15:00,19.49,48271,2235,7,86,1942,10,4280,6.754.345.238
21/10/2020 16:00,19.95,49056,2570,9,95,1927,10,4611,6.754.345.238
21/10/2020 17:00,20.39,49708,2814,12,112,2147,10,5095,6.754.345.238
21/10/2020 18:00,20.17,48942,3067,15,126,2212,11,5431,6.754.345.238
21/10/2020 19:00,18.29,47254,3371,21,140,2149,11,5692,6.754.345.238
21/10/2020 20:00,16.18,45688,3511,32,153,2305,15,6016,6.754.345.238
21/10/2020 21:00,15.22,43519,3714,44,175,2331,17,6281,6.754.345.238
21/10/2020 22:00,12.77,40907,3916,53,196,2418,16,6599,6.754.345.238
21/10/2020 23:00,10.35,39020,3273,49,230,2583,20,6155,6.754.345.238
22/10/2020 00:00,10.03,38088,3378,55,245,2672,23,6373,6.754.345.238
22/10/2020 01:00,9.1,37708,3369,64,265,2767,24,6489,6.754.345.238
22/10/2020 02:00,10.01,37671,3518,69,284,2836,27,6734,6.754.345.238
22/10/2020 03:00,11.15,38229,3656,74,303,2869,33,6935,6.754.345.238
22/10/2020 04:00,13.72,40307,3620,82,318,2957,33,7010,6.754.345.238
22/10/2020 05:00,15.13,44267,3381,90,351,3070,37,6929,6.754.345.238
22/10/2020 06:00,16.85,47668,3138,91,388,3180,48,6845,6.754.345.238
22/10/2020 07:00,17.92,48698,2882,92,420,3241,58,6693,6.754.345.238
22/10/2020 08:00,17.88,48693,2938,88,442,3201,60,6729,6.754.345.238
22/10/2020 09:00,17,48712,3150,86,452,3151,60,6899,6.754.345.238
22/10/2020 10:00,16.41,48355,3379,85,457,3053,60,7034,6.754.345.238
22/10/2020 11:00,16.18,47949,3638,78,463,3024,60,7263,6.754.345.238
22/10/2020 12:00,15.91,47571,3758,73,463,2958,60,7312,6.754.345.238
22/10/2020 13:00,15.74,47280,3856,71,461,2908,60,7356,6.754.345.238
22/10/2020 14:00,15.58,47044,3898,71,447,2974,59,7449,6.754.345.238
22/10/2020 15:00,15.69,47210,3890,75,427,2955,59,7406,6.754.345.238
22/10/2020 16:00,16.79,47944,3899,81,407,3093,58,7538,6.754.345.238
22/10/2020 17:00,17.31,48688,3811,89,378,3258,58,7594,6.754.345.238
22/10/2020 18:00,16.84,48146,3975,94,355,3412,58,7894,6.754.345.238
22/10/2020 19:00,15.25,46579,4002,98,339,3499,58,7996,6.754.345.238
22/10/2020 20:00,13.98,45030,3950,102,326,3665,59,8102,6.754.345.238
22/10/2020 21:00,12.89,42833,4066,100,319,3664,58,8207,6.754.345.238
22/10/2020 22:00,11.31,40331,4165,97,307,3828,55,8452,6.754.345.238
22/10/2020 23:00,10.68,38511,3682,102,304,4006,57,8151,6.754.345.238
23/10/2020 00:00,10.26,37572,3605,100,282,4212,54,8253,6.754.345.238
23/10/2020 01:00,9.89,37337,3382,102,277,4242,51,8054,6.754.345.238
23/10/2020 02:00,10.67,37478,3161,108,274,4411,50,8004,6.754.345.238
23/10/2020 03:00,11.05,38181,2768,116,271,4561,47,7763,6.754.345.238
23/10/2020 04:00,13.22,40308,2386,126,281,4558,47,7398,6.754.345.238
23/10/2020 05:00,14.69,44378,2069,135,301,4451,53,7009,6.754.345.238
23/10/2020 06:00,17.37,47977,1885,143,325,4122,54,6529,6.754.345.238
23/10/2020 07:00,24.24,49094,1652,154,343,3790,55,5994,6.754.345.238
23/10/2020 08:00,28.27,49383,1469,158,362,3437,56,5482,6.754.345.238
23/10/2020 09:00,33.17,49431,1395,158,384,3085,53,5075,6.754.345.238
23/10/2020 10:00,30.97,49043,1418,161,402,2620,55,4656,6.754.345.238
23/10/2020 11:00,32.91,48595,1461,159,418,2498,51,4587,6.754.345.238
23/10/2020 12:00,29.12,47977,1375,163,417,2523,52,4530,6.754.345.238
23/10/2020 13:00,22.93,47387,1244,170,407,2492,51,4364,6.754.345.238
23/10/2020 14:00,19.01,47029,1119,181,382,2444,42,4168,6.754.345.238
23/10/2020 15:00,19.27,47095,990,198,348,2457,33,4026,6.754.345.238
23/10/2020 16:00,20.99,48157,889,209,312,2611,32,4053,6.754.345.238
23/10/2020 17:00,20.94,49036,924,213,276,2799,26,4238,6.754.345.238
23/10/2020 18:00,19.59,48093,1019,213,235,2843,11,4321,6.754.345.238
23/10/2020 19:00,16.23,46167,1137,211,196,2852,7,4403,6.754.345.238
23/10/2020 20:00,15.22,44788,1236,204,176,2871,5,4492,6.754.345.238
23/10/2020 21:00,14.79,43202,1467,192,156,2825,4,4644,6.754.345.238
23/10/2020 22:00,14.39,41408,1712,176,132,2732,2,4754,6.754.345.238
23/10/2020 23:00,13.86,40169,2337,4,95,2862,3,5301,6.754.345.238
24/10/2020 00:00,13.41,39202,2355,6,80,2869,3,5313,6.754.345.238
24/10/2020 01:00,13.04,38769,2252,8,69,2847,3,5179,6.754.345.238
24/10/2020 02:00,13.06,38641,2275,11,64,2867,4,5221,6.754.345.238
24/10/2020 03:00,13.12,38827,2225,16,58,2984,6,5289,6.754.345.238
24/10/2020 04:00,13.38,39472,2150,22,50,2896,5,5123,6.754.345.238
24/10/2020 05:00,13.67,40631,1973,28,47,2843,5,4896,6.754.345.238
24/10/2020 06:00,13.71,41916,1924,34,47,2709,6,4720,6.754.345.238
24/10/2020 07:00,14.62,43493,1778,41,57,2617,4,4497,6.754.345.238
24/10/2020 08:00,15.16,45187,1647,42,60,2584,6,4339,6.754.345.238
24/10/2020 09:00,15.73,45959,1635,42,69,2281,8,4035,6.754.345.238
24/10/2020 10:00,15.46,45933,1681,50,86,2044,8,3869,6.754.345.238
24/10/2020 11:00,15.16,45546,1711,59,118,1877,17,3782,6.754.345.238
24/10/2020 12:00,15.07,45038,1759,64,156,1685,24,3688,6.754.345.238
24/10/2020 13:00,14.91,44642,1846,65,196,1449,38,3594,6.754.345.238
24/10/2020 14:00,14.93,44609,1858,69,231,1238,54,3450,6.754.345.238
24/10/2020 15:00,15.6,45082,1799,75,264,1144,48,3330,6.754.345.238
24/10/2020 16:00,17.21,46634,1862,83,285,1094,48,3372,6.754.345.238
24/10/2020 17:00,20.03,47729,1832,90,298,1112,38,3370,6.754.345.238
24/10/2020 18:00,17.1,46856,2008,99,302,1248,40,3697,6.754.345.238
24/10/2020 19:00,15.19,45081,2258,105,299,1273,34,3969,6.754.345.238
24/10/2020 20:00,14.64,43934,2474,106,282,1339,31,4232,6.754.345.238
24/10/2020 21:00,13.97,42601,2870,112,274,1481,24,4761,6.754.345.238
24/10/2020 22:00,12.9,41153,3239,116,237,1598,21,5211,6.754.345.238
24/10/2020 23:00,11.06,39620,3440,103,197,1737,18,5495,6.754.345.238
25/10/2020 00:00,8.54,38671,3637,107,176,1963,15,5898,6.754.345.238
25/10/2020 01:00,7.15,38272,3722,110,149,2271,9,6261,6.754.345.238
25/10/2020 02:00,6.33,38008,3744,115,127,2418,9,6413,6.754.345.238
25/10/2020 03:00,5.26,37932,3691,112,113,2739,9,6664,6.754.345.238
25/10/2020 04:00,4.27,38042,3677,104,100,3139,8,7028,6.754.345.238
25/10/2020 05:00,5,38539,3614,87,88,3576,6,7371,6.754.345.238
25/10/2020 06:00,5.48,39330,3717,73,80,4083,5,7958,6.754.345.238
25/10/2020 07:00,6.33,40330,3661,68,78,4397,4,8208,6.754.345.238
25/10/2020 08:00,8.09,41784,3662,59,76,4777,4,8578,6.754.345.238
25/10/2020 09:00,8.49,43206,3749,49,81,5095,5,8979,6.754.345.238
25/10/2020 10:00,8.6,43934,3811,47,90,5357,6,9311,6.754.345.238
25/10/2020 11:00,10.01,44193,3792,56,98,5729,6,9681,6.754.345.238
25/10/2020 12:00,10.26,43944,3440,73,105,5901,8,9527,6.754.345.238
25/10/2020 13:00,10.47,43599,3026,85,118,6012,9,9250,6.754.345.238
25/10/2020 14:00,11.78,43512,2570,114,137,6037,9,8867,6.754.345.238
25/10/2020 15:00,12.93,44176,2162,128,162,6021,14,8487,6.754.345.238
25/10/2020 16:00,13.86,45543,2034,133,194,6008,15,8384,6.754.345.238
25/10/2020 17:00,14.83,46719,1893,149,226,6014,18,8300,6.754.345.238
25/10/2020 18:00,14.56,46635,1884,159,241,5814,20,8118,6.754.345.238
25/10/2020 19:00,13.5,45774,1815,167,243,5700,26,7951,6.754.345.238
25/10/2020 20:00,12.67,44363,1663,167,246,5481,28,7585,6.754.345.238
25/10/2020 21:00,11.92,43401,1615,158,252,5175,29,7229,6.754.345.238
25/10/2020 22:00,11.47,41743,1566,157,246,4763,29,6761,6.754.345.238
25/10/2020 23:00,10.32,39912,1467,139,243,4244,31,6124,6.754.345.238
26/10/2020 00:00,9.83,38211,1648,143,268,3721,32,5812,6.782.321.429
26/10/2020 01:00,9.34,37344,1636,149,274,3306,34,5399,6.782.321.429
26/10/2020 02:00,9.66,37106,1682,157,278,2930,37,5084,6.782.321.429
26/10/2020 03:00,10.16,37261,1604,165,277,2598,35,4679,6.782.321.429
26/10/2020 04:00,11.37,38136,1515,176,273,2213,34,4211,6.782.321.429
26/10/2020 05:00,12.63,40441,1598,178,275,2114,37,4202,6.782.321.429
26/10/2020 06:00,14.55,44795,1779,175,276,2110,38,4378,6.782.321.429
26/10/2020 07:00,15.59,48249,1798,164,277,2028,37,4304,6.782.321.429
26/10/2020 08:00,16.92,49171,1876,156,272,1846,37,4187,6.782.321.429
26/10/2020 09:00,15.95,49179,1939,152,267,1795,38,4191,6.782.321.429
26/10/2020 10:00,15.78,48960,2026,153,262,1768,38,4247,6.782.321.429
26/10/2020 11:00,15.66,48607,1982,137,245,1713,30,4107,6.782.321.429
26/10/2020 12:00,15.53,48142,1790,121,224,1566,26,3727,6.782.321.429
26/10/2020 13:00,15.81,47993,1740,110,205,1557,20,3632,6.782.321.429
26/10/2020 14:00,15.98,47748,1928,96,195,1634,14,3867,6.782.321.429
26/10/2020 15:00,16.36,48224,1998,91,189,1642,14,3934,6.782.321.429
26/10/2020 16:00,19.88,49081,2030,88,191,1910,14,4233,6.782.321.429
26/10/2020 17:00,22.89,49926,2017,82,209,2180,14,4502,6.782.321.429
26/10/2020 18:00,20.03,49543,2134,72,226,2295,17,4744,6.782.321.429
26/10/2020 19:00,16.3,48465,2171,59,240,2493,16,4979,6.782.321.429
26/10/2020 20:00,14.95,46706,2114,50,238,2263,16,4681,6.782.321.429
26/10/2020 21:00,14.67,45265,2135,41,233,1959,16,4384,6.782.321.429
26/10/2020 22:00,13.81,43073,2211,34,230,1714,14,4203,6.782.321.429
26/10/2020 23:00,12.15,40667,2173,34,224,1620,13,4064,6.782.321.429
27/10/2020 00:00,11,37936,2361,148,261,1668,14,4452,6.782.321.429
27/10/2020 01:00,10.12,37043,2424,145,264,1598,15,4446,6.782.321.429
27/10/2020 02:00,9.5,36855,2583,142,266,1607,20,4618,6.782.321.429
27/10/2020 03:00,9.96,37159,2588,144,266,1569,20,4587,6.782.321.429
27/10/2020 04:00,11.16,37941,2684,150,261,1561,20,4676,6.782.321.429
27/10/2020 05:00,12.56,40291,2826,157,249,1769,24,5025,6.782.321.429
27/10/2020 06:00,13.96,44377,3017,161,237,1929,22,5366,6.782.321.429
27/10/2020 07:00,15.87,47741,3020,163,223,2135,20,5561,6.782.321.429
27/10/2020 08:00,17.52,48729,3080,161,208,2231,19,5699,6.782.321.429
27/10/2020 09:00,15.37,48460,3212,162,195,2473,16,6058,6.782.321.429
27/10/2020 10:00,14.33,48308,3361,160,182,2612,10,6325,6.782.321.429
27/10/2020 11:00,14.07,47946,3475,152,159,2713,12,6511,6.782.321.429
27/10/2020 12:00,13.88,47565,3518,138,133,2704,9,6502,6.782.321.429
27/10/2020 13:00,13.86,47383,3531,124,108,2862,6,6631,6.782.321.429
27/10/2020 14:00,13.92,47441,3453,114,88,2910,5,6570,6.782.321.429
27/10/2020 15:00,13.97,48021,3377,110,80,3262,4,6833,6.782.321.429
27/10/2020 16:00,14.47,48983,3339,112,85,3619,5,7160,6.782.321.429
27/10/2020 17:00,15.47,49939,3262,111,97,4061,5,7536,6.782.321.429
27/10/2020 18:00,14.96,49533,3270,108,107,4252,5,7742,6.782.321.429
27/10/2020 19:00,13.94,48244,3224,107,117,4444,3,7895,6.782.321.429
27/10/2020 20:00,12.55,46451,3108,106,121,4528,4,7867,6.782.321.429
27/10/2020 21:00,11.78,44859,3184,105,130,4509,7,7935,6.782.321.429
27/10/2020 22:00,11.14,42665,3303,102,141,4428,14,7988,6.782.321.429
27/10/2020 23:00,7.81,40106,3213,96,141,4225,17,7692,6.782.321.429
28/10/2020 00:00,5.54,37828,3581,117,153,4190,25,8066,6.782.321.429
28/10/2020 01:00,3.47,37123,3677,123,147,4307,16,8270,6.782.321.429
28/10/2020 02:00,3.22,36975,3856,128,138,4172,17,8311,6.782.321.429
28/10/2020 03:00,4.87,37167,3809,136,131,4143,13,8232,6.782.321.429
28/10/2020 04:00,6.43,38096,3730,148,132,3959,12,7981,6.782.321.429
28/10/2020 05:00,10.2,40527,3507,157,140,3980,13,7797,6.782.321.429
28/10/2020 06:00,11.48,44513,3315,166,149,4165,17,7812,6.782.321.429
28/10/2020 07:00,12.4,47702,3052,175,153,4168,13,7561,6.782.321.429
28/10/2020 08:00,12.93,48458,2896,172,146,4253,16,7483,6.782.321.429
28/10/2020 09:00,12.45,48290,2880,165,135,4093,19,7292,6.782.321.429
28/10/2020 10:00,12.26,48258,2997,160,136,3903,23,7219,6.782.321.429
28/10/2020 11:00,12.02,47849,3135,153,150,3756,29,7223,6.782.321.429
28/10/2020 12:00,11.67,47400,3238,149,161,3656,29,7233,6.782.321.429
28/10/2020 13:00,11.67,47121,3354,142,168,3599,28,7291,6.782.321.429
28/10/2020 14:00,11.68,47049,3325,129,165,3614,30,7263,6.782.321.429
28/10/2020 15:00,11.68,47693,3323,118,176,3907,30,7554,6.782.321.429
28/10/2020 16:00,12.23,48850,3338,108,191,4196,30,7863,6.782.321.429
28/10/2020 17:00,12.47,49574,3334,100,204,4371,29,8038,6.782.321.429
28/10/2020 18:00,12.39,49143,3334,93,208,4672,22,8329,6.782.321.429
28/10/2020 19:00,11.63,48117,3207,86,200,4745,19,8257,6.782.321.429
28/10/2020 20:00,10.96,46449,2963,83,185,4783,15,8029,6.782.321.429
28/10/2020 21:00,10.68,45007,2892,80,167,4864,13,8016,6.782.321.429
28/10/2020 22:00,9.74,42896,2808,71,150,4796,11,7836,6.782.321.429
28/10/2020 23:00,8.09,40460,2601,68,137,4716,8,7530,6.782.321.429
29/10/2020 00:00,7.26,38747,1872,87,109,4696,11,6775,6.782.321.429
29/10/2020 01:00,6.74,37834,1657,99,94,4620,10,6480,6.782.321.429
29/10/2020 02:00,6.93,37601,1526,119,84,4462,8,6199,6.782.321.429
29/10/2020 03:00,6.67,37725,1370,140,79,4174,7,5770,6.782.321.429
29/10/2020 04:00,9.23,38528,1229,140,78,3877,8,5332,6.782.321.429
29/10/2020 05:00,10.73,40883,1098,135,75,3651,8,4967,6.782.321.429
29/10/2020 06:00,11.64,44787,1098,137,73,3458,10,4776,6.782.321.429
29/10/2020 07:00,12.6,48005,1196,140,73,3215,10,4634,6.782.321.429
29/10/2020 08:00,13.68,48820,1305,141,71,3050,11,4578,6.782.321.429
29/10/2020 09:00,13.31,48684,1328,146,68,2850,8,4400,6.782.321.429
29/10/2020 10:00,12.57,48612,1435,147,68,2498,7,4155,6.782.321.429
29/10/2020 11:00,12.53,48104,1590,143,70,2156,8,3967,6.782.321.429
29/10/2020 12:00,12.14,47568,1639,136,70,1823,8,3676,6.782.321.429
29/10/2020 13:00,12.27,47410,1691,130,67,1647,6,3541,6.782.321.429
29/10/2020 14:00,12.9,47440,1752,130,59,1543,6,3490,6.782.321.429
29/10/2020 15:00,12.86,47933,1828,135,54,1511,6,3534,6.782.321.429
29/10/2020 16:00,14.13,48890,1834,144,61,1577,7,3623,6.782.321.429
29/10/2020 17:00,16.35,49831,1710,158,74,1690,9,3641,6.782.321.429
29/10/2020 18:00,15.48,49473,1599,168,81,1612,12,3472,6.782.321.429
29/10/2020 19:00,12.86,48477,1535,169,81,1647,11,3443,6.782.321.429
29/10/2020 20:00,11.96,46922,1465,164,78,1603,11,3321,6.782.321.429
29/10/2020 21:00,11.62,45610,1442,155,80,1583,9,3269,6.782.321.429
29/10/2020 22:00,11.08,43487,1482,141,82,1482,8,3195,6.782.321.429
29/10/2020 23:00,10.75,41313,1656,130,78,1401,7,3272,6.782.321.429
30/10/2020 00:00,9.88,39990,1153,141,90,1478,6,2868,6.782.321.429
30/10/2020 01:00,9.59,39197,1296,122,92,1470,6,2986,6.782.321.429
30/10/2020 02:00,8.63,39079,1414,108,93,1428,6,3049,6.782.321.429
30/10/2020 03:00,6.28,39262,1365,104,91,1456,5,3021,6.782.321.429
30/10/2020 04:00,7.68,40028,1347,94,88,1234,5,2768,6.782.321.429
30/10/2020 05:00,10.56,42376,1363,83,84,1064,6,2600,6.782.321.429
30/10/2020 06:00,11.51,46115,1463,75,78,1133,5,2754,6.782.321.429
30/10/2020 07:00,13.27,49283,1503,71,69,1082,7,2732,6.782.321.429
30/10/2020 08:00,14.78,50443,1555,66,58,938,5,2622,6.782.321.429
30/10/2020 09:00,14.21,50446,1650,64,46,821,4,2585,6.782.321.429
30/10/2020 10:00,14,50401,1796,58,44,695,3,2596,6.782.321.429
30/10/2020 11:00,13.54,49999,1840,51,51,546,3,2491,6.782.321.429
30/10/2020 12:00,12.96,49368,1879,41,70,495,3,2488,6.782.321.429
30/10/2020 13:00,12.48,48830,1887,33,84,483,3,2490,6.782.321.429
30/10/2020 14:00,12.21,48397,1723,26,89,559,3,2400,6.782.321.429
30/10/2020 15:00,12.44,48494,1696,24,87,686,3,2496,6.782.321.429
30/10/2020 16:00,13.66,49569,1555,24,84,871,3,2537,6.782.321.429
30/10/2020 17:00,15.73,50258,1391,24,76,1089,3,2583,6.782.321.429
30/10/2020 18:00,14.67,49912,1349,23,69,1336,3,2780,6.782.321.429
30/10/2020 19:00,11.92,48621,1261,20,63,1596,3,2943,6.782.321.429
30/10/2020 20:00,11.02,46644,1176,18,62,1760,3,3019,6.782.321.429
30/10/2020 21:00,10.4,45292,1145,16,60,1964,3,3188,6.782.321.429
30/10/2020 22:00,10.08,43508,1089,15,57,2125,3,3289,6.782.321.429
30/10/2020 23:00,9.68,41583,829,13,51,2334,3,3230,6.782.321.429
31/10/2020 00:00,9.81,39430,462,34,50,2497,4,3047,6.782.321.429
31/10/2020 01:00,9.44,38439,370,26,40,2719,4,3159,6.782.321.429
31/10/2020 02:00,9.05,37935,283,19,35,2607,4,2948,6.782.321.429
31/10/2020 03:00,9.04,37813,210,16,30,2684,4,2944,6.782.321.429
31/10/2020 04:00,9.16,37989,156,16,29,2662,3,2866,6.782.321.429
31/10/2020 05:00,9.49,38484,110,16,28,2470,4,2628,6.782.321.429
31/10/2020 06:00,9.81,39516,92,19,24,2452,3,2590,6.782.321.429
31/10/2020 07:00,9.91,40726,117,24,18,2182,3,2344,6.782.321.429
31/10/2020 08:00,10.16,42357,202,23,12,1957,2,2196,6.782.321.429
31/10/2020 09:00,10.79,43891,277,17,9,1734,2,2039,6.782.321.429
31/10/2020 10:00,11.16,44725,402,15,10,1422,3,1852,6.782.321.429
31/10/2020 11:00,11.06,44649,638,15,10,1379,3,2045,6.782.321.429
31/10/2020 12:00,10.42,44371,900,17,8,1226,3,2154,6.782.321.429
31/10/2020 13:00,10.18,44053,1142,23,8,1122,2,2297,6.782.321.429
31/10/2020 14:00,9.99,43887,1373,36,9,984,2,2404,6.782.321.429
31/10/2020 15:00,10.01,44368,1686,45,10,991,3,2735,6.782.321.429
31/10/2020 16:00,10.25,45678,2044,57,11,1128,3,3243,6.782.321.429
31/10/2020 17:00,10.27,46818,2339,66,18,1286,6,3715,6.782.321.429
31/10/2020 18:00,9.97,46549,2702,66,24,1577,8,4377,6.782.321.429
31/10/2020 19:00,9.3,45332,3005,64,30,1899,12,5010,6.782.321.429
31/10/2020 20:00,8.25,43613,3166,63,34,2283,11,5557,6.782.321.429
31/10/2020 21:00,6.79,42612,3417,64,38,2693,9,6221,6.782.321.429
31/10/2020 22:00,5.4,41128,3691,53,42,3111,9,6906,6.782.321.429
31/10/2020 23:00,3.7,39443,3745,43,49,3467,9,7313,6.782.321.429
01/11/2020 00:00,4.57,37687,3586,41,53,3800,9,7489,6.782.321.429
01/11/2020 01:00,4.28,36698,3281,44,54,4133,10,7522,6.782.321.429
01/11/2020 02:00,3.51,36081,2654,44,56,4391,9,7154,6.782.321.429
01/11/2020 03:00,3.54,35915,1901,32,59,4633,9,6634,6.782.321.429
01/11/2020 04:00,3.95,35958,1646,21,66,4861,11,6605,6.782.321.429
01/11/2020 05:00,4.38,36391,1658,15,82,5000,12,6767,6.782.321.429
01/11/2020 06:00,4.56,37212,1842,11,97,5360,17,7327,6.782.321.429
01/11/2020 07:00,4.82,38250,1824,9,111,5580,18,7542,6.782.321.429
01/11/2020 08:00,6.24,39754,1793,7,113,5671,16,7600,6.782.321.429
01/11/2020 09:00,7.03,41321,1864,6,119,5500,21,7510,6.782.321.429
01/11/2020 10:00,7.87,42281,2040,7,138,5517,24,7726,6.782.321.429
01/11/2020 11:00,7.66,42676,2256,10,172,5545,32,8015,6.782.321.429
01/11/2020 12:00,6.97,42602,2439,13,192,5470,33,8147,6.782.321.429
01/11/2020 13:00,6.56,42436,2653,18,207,5586,32,8496,6.782.321.429
01/11/2020 14:00,6.22,42595,2818,23,201,5717,34,8793,6.782.321.429
01/11/2020 15:00,6.81,43259,2980,34,215,5874,28,9131,6.782.321.429
01/11/2020 16:00,7.85,44637,3173,52,239,6085,28,9577,6.782.321.429
01/11/2020 17:00,8.61,45895,3410,72,260,6198,36,9976,6.782.321.429
01/11/2020 18:00,8.05,45621,3641,91,285,6435,40,10492,6.782.321.429
01/11/2020 19:00,6.9,44728,3638,107,293,6710,46,10794,6.782.321.429
01/11/2020 20:00,5,43305,3435,121,287,6904,47,10794,6.782.321.429
01/11/2020 21:00,3.94,42424,3286,130,277,7122,46,10861,6.782.321.429
01/11/2020 22:00,2.63,40823,3271,133,266,7278,46,10994,6.782.321.429
01/11/2020 23:00,1.45,38927,3175,135,262,7311,45,10928,6.782.321.429
02/11/2020 00:00,0.42,36957,3588,6,234,7477,38,11343,696.202.381
02/11/2020 01:00,0.05,36173,3614,5,234,7253,30,11136,696.202.381
02/11/2020 02:00,-0.02,35986,3741,5,241,7277,27,11291,696.202.381
02/11/2020 03:00,-0.93,36166,3501,4,251,6804,34,10594,696.202.381
02/11/2020 04:00,-0.07,36973,3776,4,259,7290,34,11363,696.202.381
02/11/2020 05:00,0.33,39361,3803,4,268,7760,29,11864,696.202.381
02/11/2020 06:00,2.48,43547,3851,3,283,8095,31,12263,696.202.381
02/11/2020 07:00,4.96,46649,3781,3,294,8144,36,12258,696.202.381
02/11/2020 08:00,5.55,47328,3636,2,292,8115,42,12087,696.202.381
02/11/2020 09:00,5.39,47129,3553,2,297,8163,43,12058,696.202.381
02/11/2020 10:00,5.27,46978,3711,2,299,8156,43,12211,696.202.381
02/11/2020 11:00,5.17,46687,3755,2,304,8106,46,12213,696.202.381
02/11/2020 12:00,4.96,46326,3732,2,304,8050,46,12134,696.202.381
02/11/2020 13:00,4.95,46202,3845,2,305,7902,47,12101,696.202.381
02/11/2020 14:00,4.97,46078,3795,2,304,7704,47,11852,696.202.381
02/11/2020 15:00,5.43,46490,3999,3,303,7548,46,11899,696.202.381
02/11/2020 16:00,7.13,47290,4047,4,297,7452,48,11848,696.202.381
02/11/2020 17:00,8.6,47828,4144,4,294,7309,49,11800,696.202.381
02/11/2020 18:00,8.45,47143,4236,5,293,7210,48,11792,696.202.381
02/11/2020 19:00,7.23,45933,4137,6,285,6906,48,11382,696.202.381
02/11/2020 20:00,5.69,44254,3844,5,268,6827,45,10989,696.202.381
02/11/2020 21:00,5.04,42883,3914,5,252,6785,44,11000,696.202.381
02/11/2020 22:00,3.81,40721,3886,4,243,6685,41,10859,696.202.381
02/11/2020 23:00,1.72,38526,3750,4,223,6618,41,10636,696.202.381
03/11/2020 00:00,0.84,36453,3454,158,199,6596,39,10446,696.202.381
03/11/2020 01:00,0.62,35599,3418,24,195,6434,43,10114,696.202.381
03/11/2020 02:00,0.61,35356,3527,25,190,6170,39,9951,696.202.381
03/11/2020 03:00,0.86,35609,3477,25,191,6021,43,9757,696.202.381
03/11/2020 04:00,1.29,36533,3529,25,197,5769,49,9569,696.202.381
03/11/2020 05:00,2.57,38920,3569,189,206,5642,47,9653,696.202.381
03/11/2020 06:00,6.14,42991,3661,197,216,5509,45,9628,696.202.381
03/11/2020 07:00,8.24,46355,3667,206,220,5494,40,9627,696.202.381
03/11/2020 08:00,8.48,47317,3504,211,218,5409,31,9373,696.202.381
03/11/2020 09:00,8.13,47261,3412,215,212,5174,35,9048,696.202.381
03/11/2020 10:00,8.04,47166,3538,221,216,5052,43,9070,696.202.381
03/11/2020 11:00,7.92,46798,3579,226,230,4763,46,8844,696.202.381
03/11/2020 12:00,7.86,46503,3542,230,239,4533,46,8590,696.202.381
03/11/2020 13:00,7.95,46474,3425,235,233,4351,48,8292,696.202.381
03/11/2020 14:00,8.24,46622,2866,242,222,4405,42,7777,696.202.381
03/11/2020 15:00,8.84,47279,2543,247,214,4411,42,7457,696.202.381
03/11/2020 16:00,9.83,48436,2367,251,203,4309,35,7165,696.202.381
03/11/2020 17:00,10.04,49182,2397,254,191,4279,35,7156,696.202.381
03/11/2020 18:00,10.08,48555,2466,255,182,4409,32,7344,696.202.381
03/11/2020 19:00,9.4,47656,2537,255,172,4372,26,7362,696.202.381
03/11/2020 20:00,8.44,46254,2541,254,154,4497,24,7470,696.202.381
03/11/2020 21:00,7.71,45143,2677,251,143,4514,23,7608,696.202.381
03/11/2020 22:00,6.74,43202,2776,249,128,4645,18,7816,696.202.381
03/11/2020 23:00,4.08,40796,2733,247,114,4715,14,7823,696.202.381
04/11/2020 00:00,2.5,38563,3047,247,84,4940,9,8327,696.202.381
04/11/2020 01:00,1.49,37825,3104,244,79,5037,6,8470,696.202.381
04/11/2020 02:00,1.44,37658,3075,243,79,5273,7,8677,696.202.381
04/11/2020 03:00,1.43,37878,2935,243,82,5346,7,8613,696.202.381
04/11/2020 04:00,1.47,38853,2919,239,98,5522,7,8785,696.202.381
04/11/2020 05:00,2.5,41216,2959,228,123,5513,10,8833,696.202.381
04/11/2020 06:00,4.81,45454,3058,210,147,5495,16,8926,696.202.381
04/11/2020 07:00,7.04,49137,3151,194,165,5556,15,9081,696.202.381
04/11/2020 08:00,7.31,50071,3002,180,176,5253,18,8629,696.202.381
04/11/2020 09:00,6.84,49994,2873,167,181,5204,27,8452,696.202.381
04/11/2020 10:00,6.41,49958,3054,159,202,5225,33,8673,696.202.381
04/11/2020 11:00,5.42,49016,3304,155,233,5072,43,8807,696.202.381
04/11/2020 12:00,5.08,48291,3397,151,263,5107,48,8966,696.202.381
04/11/2020 13:00,5.09,48484,3486,147,275,5190,49,9147,696.202.381
04/11/2020 14:00,5.18,48765,3335,143,281,5296,44,9099,696.202.381
04/11/2020 15:00,5.32,49543,3152,142,288,5619,42,9243,696.202.381
04/11/2020 16:00,6.35,50677,3149,142,296,5986,47,9620,696.202.381
04/11/2020 17:00,6.92,51707,3222,141,302,6301,35,10001,696.202.381
04/11/2020 18:00,6.41,51207,3294,136,305,6483,30,10248,696.202.381
04/11/2020 19:00,5.37,50081,3240,130,302,6494,43,10209,696.202.381
04/11/2020 20:00,4.71,48308,3025,125,295,6537,47,10029,696.202.381
04/11/2020 21:00,4.36,46903,3087,120,299,6521,46,10073,696.202.381
04/11/2020 22:00,3.34,44690,3148,114,319,6529,46,10156,696.202.381
04/11/2020 23:00,1.45,42095,3135,107,325,6563,47,10177,696.202.381
05/11/2020 00:00,1.68,40272,2926,93,292,6493,41,9845,696.202.381
05/11/2020 01:00,1.36,39393,2931,84,292,6621,43,9971,696.202.381
05/11/2020 02:00,0.96,39200,3024,76,299,7021,42,10462,696.202.381
05/11/2020 03:00,0.9,39378,2967,69,313,7400,49,10798,696.202.381
05/11/2020 04:00,0.97,40176,3035,62,325,7676,47,11145,696.202.381
05/11/2020 05:00,1.5,42491,3091,61,331,7899,45,11427,696.202.381
05/11/2020 06:00,2.44,46208,3237,69,337,8060,47,11750,696.202.381
05/11/2020 07:00,3.9,49538,3366,74,349,8177,47,12013,696.202.381
05/11/2020 08:00,3.43,50190,3368,80,364,8077,53,11942,696.202.381
05/11/2020 09:00,3.2,49968,3437,93,385,8025,55,11995,696.202.381
05/11/2020 10:00,2.99,49778,3678,107,407,7975,54,12221,696.202.381
05/11/2020 11:00,2.71,49191,3815,120,427,7906,56,12324,696.202.381
05/11/2020 12:00,2.55,48693,3846,126,431,7777,57,12237,696.202.381
05/11/2020 13:00,2.4,48503,3968,141,434,7677,56,12276,696.202.381
05/11/2020 14:00,2.59,48646,3893,149,437,7573,54,12106,696.202.381
05/11/2020 15:00,3.1,49058,3957,153,439,7516,56,12121,696.202.381
05/11/2020 16:00,4,50106,3910,158,439,7508,54,12069,696.202.381
05/11/2020 17:00,4.59,50759,3853,152,434,7517,52,12008,696.202.381
05/11/2020 18:00,4.23,49997,3706,143,425,7456,47,11777,696.202.381
05/11/2020 19:00,3.46,48806,3409,143,409,7299,44,11304,696.202.381
05/11/2020 20:00,2.95,46934,2966,138,383,7163,40,10690,696.202.381
05/11/2020 21:00,2.21,45344,2898,136,363,7165,34,10596,696.202.381
05/11/2020 22:00,1.64,42978,2873,129,345,7009,32,10388,696.202.381
05/11/2020 23:00,1.02,40441,2720,128,320,6783,29,9980,696.202.381
06/11/2020 00:00,1.16,38323,2953,130,326,6464,27,9900,696.202.381
06/11/2020 01:00,0.99,37375,2743,138,315,6200,24,9420,696.202.381
06/11/2020 02:00,0.99,37119,2652,149,292,5957,23,9073,696.202.381
06/11/2020 03:00,1.41,37198,2440,151,268,5742,18,8619,696.202.381
06/11/2020 04:00,1.63,38012,2264,145,234,5652,15,8310,696.202.381
06/11/2020 05:00,2.95,40333,2021,146,202,5486,10,7865,696.202.381
06/11/2020 06:00,4.59,44495,1847,153,174,5428,10,7612,696.202.381
06/11/2020 07:00,6.65,48137,1702,163,155,5425,9,7454,696.202.381
06/11/2020 08:00,6.93,48777,1491,177,152,5389,7,7216,696.202.381
06/11/2020 09:00,6.7,48756,1310,189,160,5289,8,6956,696.202.381
06/11/2020 10:00,6.19,48612,1334,203,168,5276,10,6991,696.202.381
06/11/2020 11:00,5.49,48024,1371,213,165,5204,14,6967,696.202.381
06/11/2020 12:00,5.04,47309,1335,218,153,5191,16,6913,696.202.381
06/11/2020 13:00,4.91,46685,1385,216,147,5295,16,7059,696.202.381
06/11/2020 14:00,4.86,46479,1352,210,141,5329,12,7044,696.202.381
06/11/2020 15:00,5,46956,1217,207,146,5459,12,7041,696.202.381
06/11/2020 16:00,5.62,47873,1089,203,151,5592,15,7050,696.202.381
06/11/2020 17:00,5.85,48602,931,193,149,5533,20,6826,696.202.381
06/11/2020 18:00,5.87,48026,900,184,144,5377,16,6621,696.202.381
06/11/2020 19:00,5.48,46548,803,178,136,5265,11,6393,696.202.381
06/11/2020 20:00,4.57,44587,647,174,128,4936,9,5894,696.202.381
06/11/2020 21:00,4.38,43246,578,174,129,4707,12,5600,696.202.381
06/11/2020 22:00,4.23,41482,594,173,133,4502,19,5421,696.202.381
06/11/2020 23:00,3.55,39656,642,166,137,4318,16,5279,696.202.381
07/11/2020 00:00,2.94,38155,480,3,128,4386,7,5004,696.202.381
07/11/2020 01:00,2.7,37250,494,4,132,4537,5,5172,696.202.381
07/11/2020 02:00,2.47,36730,528,3,136,4825,3,5495,696.202.381
07/11/2020 03:00,2.3,36655,562,4,139,5029,7,5741,696.202.381
07/11/2020 04:00,2.25,36815,589,4,145,5275,7,6020,696.202.381
07/11/2020 05:00,2.47,37499,617,4,145,5357,7,6130,696.202.381
07/11/2020 06:00,2.58,38646,650,6,148,5371,8,6183,696.202.381
07/11/2020 07:00,2.66,40049,685,6,157,5440,14,6302,696.202.381
07/11/2020 08:00,3.01,41534,702,4,174,5410,17,6307,696.202.381
07/11/2020 09:00,3.29,43174,705,3,181,5466,19,6374,696.202.381
07/11/2020 10:00,3.74,43910,724,3,184,5445,21,6377,696.202.381
07/11/2020 11:00,3.84,43836,680,2,186,5381,20,6269,696.202.381
07/11/2020 12:00,3.9,43581,569,3,182,5283,17,6054,696.202.381
07/11/2020 13:00,4.15,43264,540,4,174,5135,20,5873,696.202.381
07/11/2020 14:00,4.58,43422,482,4,168,5034,20,5708,696.202.381
07/11/2020 15:00,5,44397,399,6,166,4754,24,5349,696.202.381
07/11/2020 16:00,6.17,45716,347,9,167,4504,25,5052,696.202.381
07/11/2020 17:00,7.6,46782,324,13,169,4169,26,4701,696.202.381
07/11/2020 18:00,6.51,46250,321,18,170,3978,29,4516,696.202.381
07/11/2020 19:00,5.39,44789,303,24,171,3705,29,4232,696.202.381
07/11/2020 20:00,4.97,43047,250,28,170,3696,27,4171,696.202.381
07/11/2020 21:00,4.57,42069,228,32,174,3599,34,4067,696.202.381
07/11/2020 22:00,4.67,40770,236,36,178,3543,27,4020,696.202.381
07/11/2020 23:00,4.18,39088,223,39,185,3454,32,3933,696.202.381
08/11/2020 00:00,4.25,37666,426,29,173,3340,32,4000,696.202.381
08/11/2020 01:00,4.07,36845,369,30,166,3205,26,3796,696.202.381
08/11/2020 02:00,3.95,36473,287,29,162,3046,28,3552,696.202.381
08/11/2020 03:00,4.06,36468,200,31,152,2911,31,3325,696.202.381
08/11/2020 04:00,4.44,36704,175,33,136,2652,22,3018,696.202.381
08/11/2020 05:00,4.9,37229,166,34,116,2474,23,2813,696.202.381
08/11/2020 06:00,4.89,38140,165,37,97,2303,17,2619,696.202.381
08/11/2020 07:00,5.08,39348,153,44,75,2220,7,2499,696.202.381
08/11/2020 08:00,6.19,40867,143,53,57,2003,4,2260,696.202.381
08/11/2020 09:00,7.11,42399,147,63,42,1976,4,2232,696.202.381
08/11/2020 10:00,7.71,43434,151,74,40,1763,2,2030,696.202.381
08/11/2020 11:00,7.76,43708,156,80,37,1572,2,1847,696.202.381
08/11/2020 12:00,7.6,43486,158,83,37,1508,2,1788,696.202.381
08/11/2020 13:00,7.69,43466,168,89,32,1556,2,1847,696.202.381
08/11/2020 14:00,7.67,43746,193,96,31,1618,1,1939,696.202.381
08/11/2020 15:00,8.04,44537,241,100,32,1693,1,2067,696.202.381
08/11/2020 16:00,8.75,46040,338,111,34,1872,1,2356,696.202.381
08/11/2020 17:00,9.03,47326,520,127,37,2003,1,2688,696.202.381
08/11/2020 18:00,9.13,47075,705,138,37,2312,1,3193,696.202.381
08/11/2020 19:00,8.46,46233,868,150,33,2544,1,3596,696.202.381
08/11/2020 20:00,8.14,44896,950,153,26,2733,1,3863,696.202.381
08/11/2020 21:00,7.44,43989,999,161,23,2924,1,4108,696.202.381
08/11/2020 22:00,6.5,42355,1013,166,21,3066,1,4267,696.202.381
08/11/2020 23:00,5.22,40460,1042,167,18,3264,1,4492,696.202.381
09/11/2020 00:00,5.87,39950,922,172,18,3297,2,4411,6.912.380.952
09/11/2020 01:00,5.63,39183,930,169,15,3522,2,4638,6.912.380.952
09/11/2020 02:00,5.51,38943,899,169,13,3540,2,4623,6.912.380.952
09/11/2020 03:00,5.54,39063,817,165,12,3578,3,4575,6.912.380.952
09/11/2020 04:00,5.65,39932,807,154,13,3556,3,4533,6.912.380.952
09/11/2020 05:00,6.48,42389,829,146,14,3423,4,4416,6.912.380.952
09/11/2020 06:00,7.83,46599,853,146,16,3339,6,4360,6.912.380.952
09/11/2020 07:00,8.45,49931,924,145,18,3243,7,4337,6.912.380.952
09/11/2020 08:00,8.98,50707,935,138,17,3071,6,4167,6.912.380.952
09/11/2020 09:00,8.87,50703,919,125,16,2904,8,3972,6.912.380.952
09/11/2020 10:00,8.79,50714,880,118,16,2695,8,3717,6.912.380.952
09/11/2020 11:00,8.91,50412,841,118,18,2316,9,3302,6.912.380.952
09/11/2020 12:00,8.86,49994,751,120,20,2087,9,2987,6.912.380.952
09/11/2020 13:00,9.06,49981,711,121,24,1934,10,2800,6.912.380.952
09/11/2020 14:00,9.19,49968,691,126,27,1946,12,2802,6.912.380.952
09/11/2020 15:00,9.56,50540,734,138,29,2079,9,2989,6.912.380.952
09/11/2020 16:00,9.9,51465,840,152,33,2044,7,3076,6.912.380.952
09/11/2020 17:00,10.09,52094,976,161,36,1923,5,3101,6.912.380.952
09/11/2020 18:00,9.87,51482,1038,158,37,1828,5,3066,6.912.380.952
09/11/2020 19:00,9.55,50240,1023,151,37,1697,4,2912,6.912.380.952
09/11/2020 20:00,9.08,48582,1032,146,38,1557,4,2777,6.912.380.952
09/11/2020 21:00,8.48,47246,1095,140,40,1292,4,2571,6.912.380.952
09/11/2020 22:00,8.3,45070,1069,131,42,1086,3,2331,6.912.380.952
09/11/2020 23:00,8,42771,1044,119,41,918,3,2125,6.912.380.952
10/11/2020 00:00,8.84,41153,989,41,13,826,3,1872,6.912.380.952
10/11/2020 01:00,8.79,40291,928,38,11,732,2,1711,6.912.380.952
10/11/2020 02:00,8.77,40037,917,38,11,721,2,1689,6.912.380.952
10/11/2020 03:00,8.81,40252,859,43,10,726,2,1640,6.912.380.952
10/11/2020 04:00,8.87,41066,880,52,9,720,2,1663,6.912.380.952
10/11/2020 05:00,8.77,43239,910,69,8,734,3,1724,6.912.380.952
10/11/2020 06:00,9.34,47116,926,87,7,727,3,1750,6.912.380.952
10/11/2020 07:00,11.57,50537,918,103,5,705,3,1734,6.912.380.952
10/11/2020 08:00,13.61,51562,903,117,5,638,3,1666,6.912.380.952
10/11/2020 09:00,11.98,51376,964,116,4,589,3,1676,6.912.380.952
10/11/2020 10:00,11.85,51238,977,110,4,599,2,1692,6.912.380.952
10/11/2020 11:00,11.12,50886,997,102,4,575,2,1680,6.912.380.952
10/11/2020 12:00,10.79,50506,961,94,4,575,2,1636,6.912.380.952
10/11/2020 13:00,10.71,50418,906,94,4,643,2,1649,6.912.380.952
10/11/2020 14:00,11.03,50573,817,97,5,718,2,1639,6.912.380.952
10/11/2020 15:00,12.96,51228,783,98,7,830,2,1720,6.912.380.952
10/11/2020 16:00,13.8,52242,790,98,7,979,2,1876,6.912.380.952
10/11/2020 17:00,14.09,52922,874,92,11,1000,2,1979,6.912.380.952
10/11/2020 18:00,11.95,52096,926,82,12,1036,3,2059,6.912.380.952
10/11/2020 19:00,10.06,50826,918,70,12,1065,3,2068,6.912.380.952
10/11/2020 20:00,9.49,49054,893,57,15,995,4,1964,6.912.380.952
10/11/2020 21:00,9.09,47598,850,48,18,968,4,1888,6.912.380.952
10/11/2020 22:00,9,45466,783,40,20,918,4,1765,6.912.380.952
10/11/2020 23:00,8.74,43015,760,36,19,879,5,1699,6.912.380.952
11/11/2020 00:00,8.53,41246,613,34,10,876,4,1537,6.912.380.952
11/11/2020 01:00,8.07,40360,529,33,10,887,4,1463,6.912.380.952
11/11/2020 02:00,7.9,40028,490,31,12,934,5,1472,6.912.380.952
11/11/2020 03:00,7.95,40123,438,27,16,913,5,1399,6.912.380.952
11/11/2020 04:00,8.48,40967,432,24,19,890,5,1370,6.912.380.952
11/11/2020 05:00,8.67,43134,448,21,24,849,6,1348,6.912.380.952
11/11/2020 06:00,9.06,47069,485,19,27,864,6,1401,6.912.380.952
11/11/2020 07:00,10.23,50419,557,15,28,830,6,1436,6.912.380.952
11/11/2020 08:00,12.08,51176,575,11,26,816,6,1434,6.912.380.952
11/11/2020 09:00,10.9,51040,582,8,24,769,7,1390,6.912.380.952
11/11/2020 10:00,10,51003,584,6,23,681,4,1298,6.912.380.952
11/11/2020 11:00,10.18,50679,594,6,21,653,4,1278,6.912.380.952
11/11/2020 12:00,10.25,50398,562,5,17,604,3,1191,6.912.380.952
11/11/2020 13:00,10.25,50242,596,6,18,552,4,1176,6.912.380.952
11/11/2020 14:00,10.58,50334,613,7,23,577,4,1224,6.912.380.952
11/11/2020 15:00,10.27,50983,663,10,27,661,6,1367,6.912.380.952
11/11/2020 16:00,11.12,51964,736,12,35,690,5,1478,6.912.380.952
11/11/2020 17:00,11.28,52548,831,13,49,697,4,1594,6.912.380.952
11/11/2020 18:00,9.77,51818,955,14,54,747,5,1775,6.912.380.952
11/11/2020 19:00,9.5,50611,1068,13,58,813,7,1959,6.912.380.952
11/11/2020 20:00,9.03,48843,1139,13,59,835,8,2054,6.912.380.952
11/11/2020 21:00,8.62,47502,1210,12,62,864,8,2156,6.912.380.952
11/11/2020 22:00,8.54,45416,1272,12,65,883,9,2241,6.912.380.952
11/11/2020 23:00,7.93,42935,1256,11,65,903,10,2245,6.912.380.952
12/11/2020 00:00,6.17,40809,1413,8,65,998,12,2496,6.912.380.952
12/11/2020 01:00,5.91,39921,1428,10,65,1035,11,2549,6.912.380.952
12/11/2020 02:00,5.74,39653,1497,11,68,1112,12,2700,6.912.380.952
12/11/2020 03:00,5.59,39774,1515,13,70,1173,11,2782,6.912.380.952
12/11/2020 04:00,5.68,40652,1630,15,69,1164,8,2886,6.912.380.952
12/11/2020 05:00,6.61,42959,1771,17,70,1195,7,3060,6.912.380.952
12/11/2020 06:00,7.04,46991,1887,18,70,1335,10,3320,6.912.380.952
12/11/2020 07:00,7.58,50449,1958,19,69,1408,12,3466,6.912.380.952
12/11/2020 08:00,7.77,51229,1940,20,65,1499,9,3533,6.912.380.952
12/11/2020 09:00,7.71,51211,1979,20,59,1579,9,3646,6.912.380.952
12/11/2020 10:00,7.65,51265,2089,20,53,1664,5,3831,6.912.380.952
12/11/2020 11:00,7.57,50987,2247,20,50,1608,6,3931,6.912.380.952
12/11/2020 12:00,7.63,50683,2273,20,50,1558,5,3906,6.912.380.952
12/11/2020 13:00,7.71,50714,2340,20,54,1605,5,4024,6.912.380.952
12/11/2020 14:00,7.73,50910,2245,22,59,1705,5,4036,6.912.380.952
12/11/2020 15:00,7.81,51407,2211,25,74,1842,6,4158,6.912.380.952
12/11/2020 16:00,7.88,52307,2155,28,85,2034,9,4311,6.912.380.952
12/11/2020 17:00,7.77,52874,2029,32,91,2242,10,4404,6.912.380.952
12/11/2020 18:00,7.64,52182,1772,37,94,2458,9,4370,6.912.380.952
12/11/2020 19:00,7.51,51004,1470,40,95,2527,8,4140,6.912.380.952
12/11/2020 20:00,7.01,49216,1260,43,93,2546,9,3951,6.912.380.952
12/11/2020 21:00,6.96,47767,1127,43,94,2447,9,3720,6.912.380.952
12/11/2020 22:00,6.78,45532,1076,43,96,2356,10,3581,6.912.380.952
12/11/2020 23:00,6.2,43118,1030,41,98,2273,12,3454,6.912.380.952
13/11/2020 00:00,4.75,41128,720,29,118,2233,10,3110,6.912.380.952
13/11/2020 01:00,4.53,40190,696,26,116,2006,9,2853,6.912.380.952
13/11/2020 02:00,4.36,39916,651,24,119,1944,12,2750,6.912.380.952
13/11/2020 03:00,4.36,40021,482,23,121,1888,13,2527,6.912.380.952
13/11/2020 04:00,4.58,40865,415,23,124,2019,13,2594,6.912.380.952
13/11/2020 05:00,4.99,43034,443,24,129,2077,15,2688,6.912.380.952
13/11/2020 06:00,5.12,46946,525,24,132,2069,15,2765,6.912.380.952
13/11/2020 07:00,5.58,50473,637,25,133,2050,13,2858,6.912.380.952
13/11/2020 08:00,5.76,51290,778,25,132,2030,14,2979,6.912.380.952
13/11/2020 09:00,5.67,51385,960,25,130,1971,15,3101,6.912.380.952
13/11/2020 10:00,5.53,51439,1145,24,127,1955,12,3263,6.912.380.952
13/11/2020 11:00,5.42,51149,1348,24,125,1936,12,3445,6.912.380.952
13/11/2020 12:00,5.56,50642,1482,23,124,1838,9,3476,6.912.380.952
13/11/2020 13:00,5.54,50152,1629,21,116,1755,12,3533,6.912.380.952
13/11/2020 14:00,5.36,50079,1690,21,111,1879,10,3711,6.912.380.952
13/11/2020 15:00,5.37,50470,1834,23,108,2084,10,4059,6.912.380.952
13/11/2020 16:00,5.57,51330,2075,27,106,2412,10,4630,6.912.380.952
13/11/2020 17:00,5.6,51685,2425,32,100,2532,11,5100,6.912.380.952
13/11/2020 18:00,5.4,50911,2617,36,93,2733,12,5491,6.912.380.952
13/11/2020 19:00,4.98,49464,2647,38,88,3026,10,5809,6.912.380.952
13/11/2020 20:00,4.7,47421,2486,39,85,3157,8,5775,6.912.380.952
13/11/2020 21:00,4.94,45997,2194,39,83,3357,8,5681,6.912.380.952
13/11/2020 22:00,4.54,44279,1917,40,80,3525,9,5571,6.912.380.952
13/11/2020 23:00,3.94,42378,1644,39,70,3504,8,5265,6.912.380.952
14/11/2020 00:00,3.35,40602,1328,129,50,3449,6,4962,6.912.380.952
14/11/2020 01:00,3.26,39610,1150,104,36,3478,5,4773,6.912.380.952
14/11/2020 02:00,3.17,39124,1024,85,33,3530,5,4677,6.912.380.952
14/11/2020 03:00,3.18,39022,918,68,32,3539,4,4561,6.912.380.952
14/11/2020 04:00,3.19,39218,800,58,33,3367,5,4263,6.912.380.952
14/11/2020 05:00,3.26,39837,705,57,35,3414,7,4218,6.912.380.952
14/11/2020 06:00,3.14,41015,690,62,36,3378,6,4172,6.912.380.952
14/11/2020 07:00,3.13,42484,742,67,36,3410,6,4261,6.912.380.952
14/11/2020 08:00,3.32,43981,795,66,36,3300,5,4202,6.912.380.952
14/11/2020 09:00,3.64,45606,905,61,32,3107,4,4109,6.912.380.952
14/11/2020 10:00,4.06,46520,962,62,31,2918,4,3977,6.912.380.952
14/11/2020 11:00,4.17,46587,959,74,31,2886,4,3954,6.912.380.952
14/11/2020 12:00,3.92,46393,959,94,31,2723,4,3811,6.912.380.952
14/11/2020 13:00,3.76,46177,1053,112,32,2526,6,3729,6.912.380.952
14/11/2020 14:00,3.91,46335,1136,128,37,2499,6,3806,6.912.380.952
14/11/2020 15:00,4.12,47209,1295,145,54,2453,6,3953,6.912.380.952
14/11/2020 16:00,4.81,48493,1520,155,68,2594,7,4344,6.912.380.952
14/11/2020 17:00,4.92,49411,1829,162,80,2834,7,4912,6.912.380.952
14/11/2020 18:00,4.4,48872,2079,161,90,2912,7,5249,6.912.380.952
14/11/2020 19:00,3.75,47504,2317,160,91,2870,8,5446,6.912.380.952
14/11/2020 20:00,3.37,45809,2554,155,90,2847,9,5655,6.912.380.952
14/11/2020 21:00,3.23,44801,2834,151,88,2710,9,5792,6.912.380.952
14/11/2020 22:00,3.06,43575,2985,135,89,2744,9,5962,6.912.380.952
14/11/2020 23:00,2.67,41922,3112,121,81,2871,9,6194,6.912.380.952
15/11/2020 00:00,2.58,39795,3005,113,87,3182,11,6398,6.912.380.952
15/11/2020 01:00,2.2,38892,2980,101,88,3232,11,6412,6.912.380.952
15/11/2020 02:00,1.47,38410,3069,88,88,3497,12,6754,6.912.380.952
15/11/2020 03:00,1.4,38266,3038,79,89,3732,15,6953,6.912.380.952
15/11/2020 04:00,1.37,38411,3028,73,92,3797,12,7002,6.912.380.952
15/11/2020 05:00,1.42,38758,2991,73,92,3942,9,7107,6.912.380.952
15/11/2020 06:00,1.46,39589,2948,78,91,4158,9,7284,6.912.380.952
15/11/2020 07:00,2.01,40798,2912,81,92,4419,10,7514,6.912.380.952
15/11/2020 08:00,2.07,42096,2757,71,90,4485,10,7413,6.912.380.952
15/11/2020 09:00,2.5,43645,2677,60,85,4560,10,7392,6.912.380.952
15/11/2020 10:00,2.61,44631,2729,51,85,4717,10,7592,6.912.380.952
15/11/2020 11:00,2.71,44911,2813,51,85,4824,8,7781,6.912.380.952
15/11/2020 12:00,2.64,44781,2768,50,89,4822,8,7737,6.912.380.952
15/11/2020 13:00,2.64,44723,2880,49,93,4863,9,7894,6.912.380.952
15/11/2020 14:00,2.71,44843,3001,50,111,4735,10,7907,6.912.380.952
15/11/2020 15:00,2.82,45556,3217,52,136,4819,10,8234,6.912.380.952
15/11/2020 16:00,2.96,46902,3516,54,152,4990,11,8723,6.912.380.952
15/11/2020 17:00,2.97,47830,3887,49,161,5078,11,9186,6.912.380.952
15/11/2020 18:00,2.92,47339,4063,44,169,5201,11,9488,6.912.380.952
15/11/2020 19:00,2.62,46274,4077,39,175,5315,15,9621,6.912.380.952
15/11/2020 20:00,1.53,44895,4056,35,185,5554,12,9842,6.912.380.952
15/11/2020 21:00,1.5,43862,4037,31,192,5661,13,9934,6.912.380.952
15/11/2020 22:00,1.49,42195,3849,28,202,5679,13,9771,6.912.380.952
15/11/2020 23:00,1.26,40337,3367,29,207,5884,15,9502,6.912.380.952
16/11/2020 00:00,0.59,38315,3416,43,255,6112,17,9843,7.023.095.238
16/11/2020 01:00,0.26,37721,3305,45,256,6240,21,9867,7.023.095.238
16/11/2020 02:00,0.08,37408,3357,48,259,6212,23,9899,7.023.095.238
16/11/2020 03:00,0.08,37461,3165,53,263,6168,24,9673,7.023.095.238
16/11/2020 04:00,0.5,38396,3303,56,269,6115,24,9767,7.023.095.238
16/11/2020 05:00,1.46,40838,3433,58,278,5896,24,9689,7.023.095.238
16/11/2020 06:00,2.1,45119,3390,58,289,5823,26,9586,7.023.095.238
16/11/2020 07:00,2.74,48640,3254,57,293,5876,25,9505,7.023.095.238
16/11/2020 08:00,3.22,49477,3167,54,300,5829,30,9380,7.023.095.238
16/11/2020 09:00,3.26,49482,3070,49,311,5598,32,9060,7.023.095.238
16/11/2020 10:00,3.2,49680,3207,46,315,5560,29,9157,7.023.095.238
16/11/2020 11:00,3.41,49543,3331,44,318,5422,25,9140,7.023.095.238
16/11/2020 12:00,3.39,49424,3332,43,317,5369,24,9085,7.023.095.238
16/11/2020 13:00,3.45,49461,3312,44,306,5404,27,9093,7.023.095.238
16/11/2020 14:00,3.48,49398,3081,46,296,5432,29,8884,7.023.095.238
16/11/2020 15:00,3.57,49854,3018,47,294,5466,33,8858,7.023.095.238
16/11/2020 16:00,3.91,50650,3067,50,286,5617,30,9050,7.023.095.238
16/11/2020 17:00,3.95,51003,3050,54,272,5707,29,9112,7.023.095.238
16/11/2020 18:00,3.66,50266,3022,57,259,5807,26,9171,7.023.095.238
16/11/2020 19:00,3.03,49023,2979,59,240,5902,25,9205,7.023.095.238
16/11/2020 20:00,2.39,47315,2943,60,214,5925,22,9164,7.023.095.238
16/11/2020 21:00,2.24,45868,2978,59,191,5886,23,9137,7.023.095.238
16/11/2020 22:00,1.94,43705,2976,58,169,5793,23,9019,7.023.095.238
16/11/2020 23:00,1.59,41376,2868,56,152,5662,21,8759,7.023.095.238
17/11/2020 00:00,1.43,39110,2637,126,134,5667,17,8581,7.023.095.238
17/11/2020 01:00,1.4,38227,2499,133,116,5602,13,8363,7.023.095.238
17/11/2020 02:00,1.39,37953,2412,140,106,5509,11,8178,7.023.095.238
17/11/2020 03:00,1.41,38162,2318,147,100,5240,11,7816,7.023.095.238
17/11/2020 04:00,1.45,39028,2287,153,96,5331,11,7878,7.023.095.238
17/11/2020 05:00,1.53,41254,2376,159,96,5209,15,7855,7.023.095.238
17/11/2020 06:00,1.83,45251,2503,164,98,5007,14,7786,7.023.095.238
17/11/2020 07:00,3.14,48890,2667,170,100,4887,8,7832,7.023.095.238
17/11/2020 08:00,3.37,50002,2876,179,99,4740,13,7907,7.023.095.238
17/11/2020 09:00,3.07,49884,3131,184,101,4560,14,7990,7.023.095.238
17/11/2020 10:00,2.89,49903,3456,187,107,4592,18,8360,7.023.095.238
17/11/2020 11:00,2.65,49734,3687,187,112,4680,23,8689,7.023.095.238
17/11/2020 12:00,2.64,49472,3825,185,112,4829,16,8967,7.023.095.238
17/11/2020 13:00,2.48,49529,3955,184,114,5061,13,9327,7.023.095.238
17/11/2020 14:00,2.4,49777,3760,182,120,5355,16,9433,7.023.095.238
17/11/2020 15:00,2.77,50261,3759,179,129,5607,18,9692,7.023.095.238
17/11/2020 16:00,3.15,50988,3886,177,143,5883,21,10110,7.023.095.238
17/11/2020 17:00,3.09,51384,4000,176,157,6245,24,10602,7.023.095.238
17/11/2020 18:00,2.39,50399,4141,181,173,6546,27,11068,7.023.095.238
17/11/2020 19:00,1.87,48972,4171,187,188,6482,35,11063,7.023.095.238
17/11/2020 20:00,1.62,47079,4109,189,204,6433,49,10984,7.023.095.238
17/11/2020 21:00,1.5,45542,4101,189,224,6239,53,10806,7.023.095.238
17/11/2020 22:00,1.45,43279,4136,188,247,6220,53,10844,7.023.095.238
17/11/2020 23:00,1.03,40675,4136,191,266,6328,57,10978,7.023.095.238
18/11/2020 00:00,1.03,38487,3939,187,314,6156,46,10642,7.023.095.238
18/11/2020 01:00,0.8,37628,3843,185,331,6267,49,10675,7.023.095.238
18/11/2020 02:00,0.63,37282,3870,183,341,6327,49,10770,7.023.095.238
18/11/2020 03:00,0.7,37415,3714,182,346,6523,49,10814,7.023.095.238
18/11/2020 04:00,0.92,38323,3553,181,343,6644,48,10769,7.023.095.238
18/11/2020 05:00,1.44,40592,3482,179,338,6726,48,10773,7.023.095.238
18/11/2020 06:00,1.57,44580,3443,177,338,6584,48,10590,7.023.095.238
18/11/2020 07:00,2.48,48080,3574,177,339,6395,47,10532,7.023.095.238
18/11/2020 08:00,2.83,48867,3689,176,344,6162,42,10413,7.023.095.238
18/11/2020 09:00,2.9,48802,3743,174,349,6086,45,10397,7.023.095.238
18/11/2020 10:00,2.91,48896,3917,171,349,5895,43,10375,7.023.095.238
18/11/2020 11:00,2.91,48647,4053,165,348,5644,46,10256,7.023.095.238
18/11/2020 12:00,2.75,48330,4072,157,339,5385,46,9999,7.023.095.238
18/11/2020 13:00,2.86,48178,4179,154,328,5447,48,10156,7.023.095.238
18/11/2020 14:00,2.97,48361,4026,157,311,5497,48,10039,7.023.095.238
18/11/2020 15:00,2.96,48929,4117,163,304,5492,48,10124,7.023.095.238
18/11/2020 16:00,3,49734,4287,170,305,5475,48,10285,7.023.095.238
18/11/2020 17:00,3.12,50102,4527,175,315,5451,50,10518,7.023.095.238
18/11/2020 18:00,2.53,49361,4764,177,331,5534,51,10857,7.023.095.238
18/11/2020 19:00,1.79,48204,4831,181,339,5512,52,10915,7.023.095.238
18/11/2020 20:00,1.56,46428,4750,192,339,5503,53,10837,7.023.095.238
18/11/2020 21:00,1.47,45093,4798,203,341,5422,52,10816,7.023.095.238
18/11/2020 22:00,1.34,42971,4957,214,348,5380,51,10950,7.023.095.238
18/11/2020 23:00,0.83,40480,5065,224,370,5430,51,11140,7.023.095.238
19/11/2020 00:00,0.88,38868,5008,242,398,5562,53,11263,7.023.095.238
19/11/2020 01:00,0.23,38027,4869,252,416,5714,53,11304,7.023.095.238
19/11/2020 02:00,0.08,37758,4999,255,413,5798,56,11521,7.023.095.238
19/11/2020 03:00,0.07,37763,4811,253,421,6163,55,11703,7.023.095.238
19/11/2020 04:00,0.09,38515,4677,244,432,6527,55,11935,7.023.095.238
19/11/2020 05:00,0.93,40915,4651,229,444,6726,55,12105,7.023.095.238
19/11/2020 06:00,1.48,45079,4498,212,455,7103,55,12323,7.023.095.238
19/11/2020 07:00,1.68,48818,4497,200,461,7336,56,12550,7.023.095.238
19/11/2020 08:00,1.78,49802,4457,188,463,7403,56,12567,7.023.095.238
19/11/2020 09:00,1.78,49860,4233,169,461,7669,56,12588,7.023.095.238
19/11/2020 10:00,1.77,50055,4430,146,460,7727,56,12819,7.023.095.238
19/11/2020 11:00,1.75,50098,4630,128,453,7744,56,13011,7.023.095.238
19/11/2020 12:00,1.75,50059,4714,116,445,7486,56,12817,7.023.095.238
19/11/2020 13:00,1.77,50459,4724,111,433,7294,56,12618,7.023.095.238
19/11/2020 14:00,1.81,50995,4440,115,423,6948,56,11982,7.023.095.238
19/11/2020 15:00,1.85,51952,4414,124,423,6760,56,11777,7.023.095.238
19/11/2020 16:00,2.2,53111,4547,136,434,6708,56,11881,7.023.095.238
19/11/2020 17:00,2.36,53891,4734,157,444,6857,56,12248,7.023.095.238
19/11/2020 18:00,2.11,53482,4859,182,459,6862,56,12418,7.023.095.238
19/11/2020 19:00,1.83,52507,4822,201,467,6937,56,12483,7.023.095.238
19/11/2020 20:00,1.76,50994,4698,214,473,7003,56,12444,7.023.095.238
19/11/2020 21:00,1.69,49670,4680,224,478,7106,56,12544,7.023.095.238
19/11/2020 22:00,1.55,47625,4695,232,475,7071,56,12529,7.023.095.238
19/11/2020 23:00,1.44,45328,4566,239,465,7164,56,12490,7.023.095.238
20/11/2020 00:00,1.44,44450,4012,256,0,7423,53,11744,7.023.095.238
20/11/2020 01:00,1.41,43544,3803,260,0,7416,46,11525,7.023.095.238
20/11/2020 02:00,1.42,43327,3657,263,0,7395,50,11365,7.023.095.238
20/11/2020 03:00,1.43,43508,3484,268,0,7408,46,11206,7.023.095.238
20/11/2020 04:00,1.48,44306,3241,271,0,7446,57,11015,7.023.095.238
20/11/2020 05:00,1.56,46607,2977,273,0,7378,58,10686,7.023.095.238
20/11/2020 06:00,2.02,50577,2707,274,0,7345,54,10380,7.023.095.238
20/11/2020 07:00,3.66,54269,2515,275,0,7202,55,10047,7.023.095.238
20/11/2020 08:00,4.22,55261,2268,273,0,6893,53,9487,7.023.095.238
20/11/2020 09:00,4.27,55359,2046,271,0,6694,51,9062,7.023.095.238
20/11/2020 10:00,4.33,55343,1982,267,0,6421,50,8720,7.023.095.238
20/11/2020 11:00,4.42,54757,1884,265,0,6056,52,8257,7.023.095.238
20/11/2020 12:00,4.45,53973,1698,260,0,5673,51,7682,7.023.095.238
20/11/2020 13:00,4.46,53440,1628,253,0,5284,49,7214,7.023.095.238
20/11/2020 14:00,4.7,53436,1366,250,0,4954,49,6619,7.023.095.238
20/11/2020 15:00,5,54124,1224,250,0,4649,46,6169,7.023.095.238
20/11/2020 16:00,5.98,55158,1080,252,0,4328,46,5706,7.023.095.238
20/11/2020 17:00,6.81,55667,977,253,0,4009,47,5286,7.023.095.238
20/11/2020 18:00,6.66,55112,972,253,0,3732,39,4996,7.023.095.238
20/11/2020 19:00,5.4,53711,1094,252,0,3184,33,4563,7.023.095.238
20/11/2020 20:00,4.77,51860,1332,251,0,2503,28,4114,7.023.095.238
20/11/2020 21:00,4.26,50627,1719,251,0,2149,20,4139,7.023.095.238
20/11/2020 22:00,3.86,48924,2115,247,0,2068,13,4443,7.023.095.238
20/11/2020 23:00,3.28,47144,2597,241,0,2124,15,4977,7.023.095.238
21/11/2020 00:00,2.65,45767,3302,56,81,2430,18,5887,7.023.095.238
21/11/2020 01:00,1.87,44778,3724,58,68,3110,13,6973,7.023.095.238
21/11/2020 02:00,1.57,44264,4312,57,60,4043,14,8486,7.023.095.238
21/11/2020 03:00,1.48,44085,4512,54,48,5071,12,9697,7.023.095.238
21/11/2020 04:00,1.43,44251,4551,52,45,6241,9,10898,7.023.095.238
21/11/2020 05:00,1.39,44873,4669,53,46,6978,8,11754,7.023.095.238
21/11/2020 06:00,1.32,45981,4538,54,48,7665,7,12312,7.023.095.238
21/11/2020 07:00,1.41,47439,4524,55,54,7999,8,12640,7.023.095.238
21/11/2020 08:00,1.43,48947,4487,53,73,8195,10,12818,7.023.095.238
21/11/2020 09:00,1.47,50438,4275,50,95,8250,11,12681,7.023.095.238
21/11/2020 10:00,1.49,51178,4468,46,122,8089,13,12738,7.023.095.238
21/11/2020 11:00,1.48,51154,4644,44,162,8017,19,12886,7.023.095.238
21/11/2020 12:00,1.47,50845,4690,43,212,7799,31,12775,7.023.095.238
21/11/2020 13:00,1.48,50474,4765,42,257,7489,42,12595,7.023.095.238
21/11/2020 14:00,1.5,50501,4401,44,299,7209,47,12000,7.023.095.238
21/11/2020 15:00,1.59,51299,4176,49,346,6930,58,11559,7.023.095.238
21/11/2020 16:00,1.93,52446,4138,54,380,6711,59,11342,7.023.095.238
21/11/2020 17:00,2.19,52991,4134,58,409,6660,59,11320,7.023.095.238
21/11/2020 18:00,1.97,52244,4116,60,431,6656,60,11323,7.023.095.238
21/11/2020 19:00,1.58,50575,4038,62,443,6755,60,11358,7.023.095.238
21/11/2020 20:00,1.47,48595,3920,63,453,6682,60,11178,7.023.095.238
21/11/2020 21:00,1.44,47452,3941,63,460,6619,60,11143,7.023.095.238
21/11/2020 22:00,1.4,45968,4089,62,465,6758,60,11434,7.023.095.238
21/11/2020 23:00,0.94,44286,4207,59,466,6985,60,11777,7.023.095.238
22/11/2020 00:00,1.31,42786,3979,58,480,6921,60,11498,7.023.095.238
22/11/2020 01:00,0.96,41896,3926,59,474,7131,60,11650,7.023.095.238
22/11/2020 02:00,0.87,41390,3964,61,461,7151,53,11690,7.023.095.238
22/11/2020 03:00,0.82,41235,3992,62,439,7238,51,11782,7.023.095.238
22/11/2020 04:00,0.82,41309,3977,64,418,7317,51,11827,7.023.095.238
22/11/2020 05:00,0.82,41683,4050,67,405,7430,53,12005,7.023.095.238
22/11/2020 06:00,0.76,42487,4059,70,399,7520,50,12098,7.023.095.238
22/11/2020 07:00,0.75,43760,4159,73,392,7677,47,12348,7.023.095.238
22/11/2020 08:00,0.95,45027,4200,76,403,7735,52,12466,7.023.095.238
22/11/2020 09:00,1.31,46477,4024,76,418,7783,56,12357,7.023.095.238
22/11/2020 10:00,1.4,47492,4209,76,426,7674,56,12441,7.023.095.238
22/11/2020 11:00,1.41,47803,4420,74,430,7676,56,12656,7.023.095.238
22/11/2020 12:00,1.41,47635,4515,73,426,7692,46,12752,7.023.095.238
22/11/2020 13:00,1.42,47687,4595,74,416,7672,43,12800,7.023.095.238
22/11/2020 14:00,1.45,48066,4340,76,417,7678,51,12562,7.023.095.238
22/11/2020 15:00,1.53,49099,4325,81,423,7701,54,12584,7.023.095.238
22/11/2020 16:00,1.69,50457,4303,86,428,7693,57,12567,7.023.095.238
22/11/2020 17:00,1.92,51155,4274,93,439,7674,58,12538,7.023.095.238
22/11/2020 18:00,1.93,50682,4202,98,444,7670,59,12473,7.023.095.238
22/11/2020 19:00,1.73,49690,4044,99,450,7530,58,12181,7.023.095.238
22/11/2020 20:00,1.58,48338,3842,100,457,7414,58,11871,7.023.095.238
22/11/2020 21:00,1.52,47439,3804,101,459,7385,59,11808,7.023.095.238
22/11/2020 22:00,1.45,45863,3891,104,465,7131,59,11650,7.023.095.238
22/11/2020 23:00,1.26,44067,3927,106,469,6979,59,11540,7.023.095.238
23/11/2020 00:00,1.35,42763,3702,221,471,6922,58,11374,6.935.892.857
23/11/2020 01:00,1.12,42061,3751,213,471,6936,57,11428,6.935.892.857
23/11/2020 02:00,0.92,41812,3832,200,469,6760,56,11317,6.935.892.857
23/11/2020 03:00,0.99,41937,3829,192,467,6795,54,11337,6.935.892.857
23/11/2020 04:00,1.42,42835,3721,183,462,6727,56,11149,6.935.892.857
23/11/2020 05:00,1.59,45271,3698,166,454,6740,57,11115,6.935.892.857
23/11/2020 06:00,2.69,49455,3537,148,441,6593,57,10776,6.935.892.857
23/11/2020 07:00,3.94,53070,3531,128,426,6431,56,10572,6.935.892.857
23/11/2020 08:00,4.98,53937,3552,114,414,6432,54,10566,6.935.892.857
23/11/2020 09:00,4.85,53770,3419,100,413,6246,54,10232,6.935.892.857
23/11/2020 10:00,4.77,53651,3454,87,412,6213,52,10218,6.935.892.857
23/11/2020 11:00,4.55,53384,3539,86,405,6158,53,10241,6.935.892.857
23/11/2020 12:00,4.14,52935,3574,92,394,6178,54,10292,6.935.892.857
23/11/2020 13:00,4.22,52952,3514,95,382,6061,56,10108,6.935.892.857
23/11/2020 14:00,4.47,53122,3175,104,364,6094,54,9791,6.935.892.857
23/11/2020 15:00,4.97,53857,2938,119,353,6265,55,9730,6.935.892.857
23/11/2020 16:00,5.71,54859,2866,143,348,6347,56,9760,6.935.892.857
23/11/2020 17:00,7.19,55263,2808,147,346,6298,56,9655,6.935.892.857
23/11/2020 18:00,6.91,54606,2771,142,348,6247,57,9565,6.935.892.857
23/11/2020 19:00,5.78,53488,2751,130,351,5970,57,9259,6.935.892.857
23/11/2020 20:00,4.94,51868,2661,115,341,5764,56,8937,6.935.892.857
23/11/2020 21:00,4.29,50574,2726,100,331,5622,54,8833,6.935.892.857
23/11/2020 22:00,3.4,48520,2788,83,321,5358,54,8604,6.935.892.857
23/11/2020 23:00,2.34,46218,2905,68,313,4984,50,8320,6.935.892.857
24/11/2020 00:00,1.88,43774,3644,147,357,4422,51,8621,6.935.892.857
24/11/2020 01:00,1.67,42961,3734,145,351,4077,47,8354,6.935.892.857
24/11/2020 02:00,1.65,42703,3811,149,320,3827,39,8146,6.935.892.857
24/11/2020 03:00,1.64,42841,3829,152,299,3517,44,7841,6.935.892.857
24/11/2020 04:00,1.95,43606,3775,151,288,3170,46,7430,6.935.892.857
24/11/2020 05:00,3.1,45745,3809,147,282,3103,48,7389,6.935.892.857
24/11/2020 06:00,4.5,49619,3810,141,271,3163,47,7432,6.935.892.857
24/11/2020 07:00,6.48,53393,3856,136,257,3388,46,7683,6.935.892.857
24/11/2020 08:00,8.07,54292,3888,134,246,3273,45,7586,6.935.892.857
24/11/2020 09:00,7.02,53955,3682,134,240,3322,43,7421,6.935.892.857
24/11/2020 10:00,6.68,53895,3630,137,248,3358,41,7414,6.935.892.857
24/11/2020 11:00,6.43,53647,3618,142,280,3274,41,7355,6.935.892.857
24/11/2020 12:00,7.21,53143,3557,146,314,3197,41,7255,6.935.892.857
24/11/2020 13:00,7.54,53042,3446,146,330,3095,37,7054,6.935.892.857
24/11/2020 14:00,7.39,53214,3258,147,336,2917,32,6690,6.935.892.857
24/11/2020 15:00,7.89,53865,3218,152,341,2881,28,6620,6.935.892.857
24/11/2020 16:00,8.25,54575,3239,157,345,2816,21,6578,6.935.892.857
24/11/2020 17:00,8.11,54740,3250,164,354,2704,27,6499,6.935.892.857
24/11/2020 18:00,7.39,53841,3244,168,360,2697,31,6500,6.935.892.857
24/11/2020 19:00,6.36,52561,3213,174,359,2615,38,6399,6.935.892.857
24/11/2020 20:00,5.49,50707,3117,174,355,2533,49,6228,6.935.892.857
24/11/2020 21:00,4.99,49099,3179,171,349,2468,53,6220,6.935.892.857
24/11/2020 22:00,3.82,46909,3227,168,341,2537,53,6326,6.935.892.857
24/11/2020 23:00,3.17,44415,3189,166,332,2627,50,6364,6.935.892.857
25/11/2020 00:00,3.17,42058,2992,169,0,2919,33,6113,6.935.892.857
25/11/2020 01:00,2.87,41111,2948,167,0,3194,30,6339,6.935.892.857
25/11/2020 02:00,2.72,40717,2934,163,0,3274,26,6397,6.935.892.857
25/11/2020 03:00,2.61,40732,2834,159,0,3469,24,6486,6.935.892.857
25/11/2020 04:00,2.78,41505,2682,149,0,3729,26,6586,6.935.892.857
25/11/2020 05:00,3.55,43662,2621,134,0,3983,23,6761,6.935.892.857
25/11/2020 06:00,4.58,47589,2514,121,0,4272,19,6926,6.935.892.857
25/11/2020 07:00,5.81,51139,2467,105,0,4379,16,6967,6.935.892.857
25/11/2020 08:00,6.23,51905,2407,96,0,4652,14,7169,6.935.892.857
25/11/2020 09:00,5.61,51658,2247,88,0,4776,11,7122,6.935.892.857
25/11/2020 10:00,5.27,51761,2210,79,0,4779,12,7080,6.935.892.857
25/11/2020 11:00,5.43,51509,2235,69,0,4796,15,7115,6.935.892.857
25/11/2020 12:00,5.25,51230,2128,56,0,4734,20,6938,6.935.892.857
25/11/2020 13:00,5.81,51198,2062,45,0,4567,22,6696,6.935.892.857
25/11/2020 14:00,6.05,51292,1929,34,0,4618,24,6605,6.935.892.857
25/11/2020 15:00,6.17,51988,1785,27,0,4653,28,6493,6.935.892.857
25/11/2020 16:00,6.37,52769,1745,22,0,4796,25,6588,6.935.892.857
25/11/2020 17:00,6.5,52987,1731,20,0,4892,27,6670,6.935.892.857
25/11/2020 18:00,6.8,52172,1713,19,0,5036,32,6800,6.935.892.857
25/11/2020 19:00,6.06,51102,1733,21,0,4915,32,6701,6.935.892.857
25/11/2020 20:00,5.1,49508,1656,24,0,4739,30,6449,6.935.892.857
25/11/2020 21:00,4.95,48118,1746,26,0,4719,31,6522,6.935.892.857
25/11/2020 22:00,4.33,46096,1830,27,0,4602,36,6495,6.935.892.857
25/11/2020 23:00,3.66,43611,1693,26,0,4378,39,6136,6.935.892.857
26/11/2020 00:00,3.56,41391,1998,11,155,4230,34,6428,6.935.892.857
26/11/2020 01:00,3.42,40431,1731,11,149,4117,36,6044,6.935.892.857
26/11/2020 02:00,3.42,40165,1540,10,145,4031,31,5757,6.935.892.857
26/11/2020 03:00,3.58,40223,1466,11,144,3957,27,5605,6.935.892.857
26/11/2020 04:00,3.99,41012,1433,10,140,3938,21,5542,6.935.892.857
26/11/2020 05:00,4.78,43384,1522,10,137,3950,26,5645,6.935.892.857
26/11/2020 06:00,6.23,47470,1512,13,137,3999,30,5691,6.935.892.857
26/11/2020 07:00,9.6,51235,1541,20,138,4123,34,5856,6.935.892.857
26/11/2020 08:00,11.28,52123,1581,27,142,4163,39,5952,6.935.892.857
26/11/2020 09:00,11.12,52121,1533,34,144,4060,38,5809,6.935.892.857
26/11/2020 10:00,10.88,52136,1469,40,148,4020,38,5715,6.935.892.857
26/11/2020 11:00,10.59,51893,1406,51,147,4039,39,5682,6.935.892.857
26/11/2020 12:00,10.86,51601,1324,63,149,4007,36,5579,6.935.892.857
26/11/2020 13:00,10.61,51651,1261,74,149,4088,34,5606,6.935.892.857
26/11/2020 14:00,10.1,52113,1088,84,158,4068,34,5432,6.935.892.857
26/11/2020 15:00,10.85,52925,966,95,173,4071,32,5337,6.935.892.857
26/11/2020 16:00,13.25,54009,959,105,191,4196,29,5480,6.935.892.857
26/11/2020 17:00,18.57,54530,944,114,206,4225,21,5510,6.935.892.857
26/11/2020 18:00,13.36,53984,926,118,223,4079,23,5369,6.935.892.857
26/11/2020 19:00,12,53055,837,122,236,3972,13,5180,6.935.892.857
26/11/2020 20:00,10.34,51493,752,127,247,3766,13,4905,6.935.892.857
26/11/2020 21:00,9.54,50088,660,133,254,3480,9,4536,6.935.892.857
26/11/2020 22:00,8.63,48009,552,139,260,3280,9,4240,6.935.892.857
26/11/2020 23:00,6.08,45715,480,145,260,2921,13,3819,6.935.892.857
27/11/2020 00:00,8.33,44338,446,162,288,2771,19,3686,6.935.892.857
27/11/2020 01:00,7.39,43476,390,160,297,2509,19,3375,6.935.892.857
27/11/2020 02:00,7.28,43253,334,153,280,2275,28,3070,6.935.892.857
27/11/2020 03:00,7.33,43485,283,143,274,1984,29,2713,6.935.892.857
27/11/2020 04:00,8.43,44409,219,138,246,1796,27,2426,6.935.892.857
27/11/2020 05:00,9.23,46734,162,135,208,1491,26,2022,6.935.892.857
27/11/2020 06:00,10.71,50810,123,130,182,1310,25,1770,6.935.892.857
27/11/2020 07:00,24.74,54727,93,124,164,1127,22,1530,6.935.892.857
27/11/2020 08:00,42.61,55749,74,119,151,1084,29,1457,6.935.892.857
27/11/2020 09:00,41.67,55712,56,112,149,921,35,1273,6.935.892.857
27/11/2020 10:00,42.12,55635,48,102,168,892,42,1252,6.935.892.857
27/11/2020 11:00,40.01,55044,40,89,202,809,44,1184,6.935.892.857
27/11/2020 12:00,34.75,54342,30,78,224,820,30,1182,6.935.892.857
27/11/2020 13:00,28.86,53754,31,62,224,817,34,1168,6.935.892.857
27/11/2020 14:00,29.77,53647,41,49,226,961,22,1299,6.935.892.857
27/11/2020 15:00,27.02,54372,56,41,232,999,17,1345,6.935.892.857
27/11/2020 16:00,40.51,55330,57,37,215,915,10,1234,6.935.892.857
27/11/2020 17:00,45.96,55652,70,39,190,921,12,1232,6.935.892.857
27/11/2020 18:00,28.01,54938,82,44,168,879,9,1182,6.935.892.857
27/11/2020 19:00,29.97,53571,98,50,152,864,8,1172,6.935.892.857
27/11/2020 20:00,16.22,51676,119,55,140,793,10,1117,6.935.892.857
27/11/2020 21:00,10.66,50267,149,57,136,689,13,1044,6.935.892.857
27/11/2020 22:00,9.95,48649,203,62,138,595,16,1014,6.935.892.857
27/11/2020 23:00,9.29,46828,238,69,137,554,14,1012,6.935.892.857
28/11/2020 00:00,11.83,46274,310,39,121,497,17,984,6.935.892.857
28/11/2020 01:00,11.34,45254,319,31,121,452,18,941,6.935.892.857
28/11/2020 02:00,11.08,44674,346,30,117,440,16,949,6.935.892.857
28/11/2020 03:00,10.96,44466,359,29,115,407,13,923,6.935.892.857
28/11/2020 04:00,11.02,44602,366,26,114,440,10,956,6.935.892.857
28/11/2020 05:00,11.07,45181,376,24,110,468,8,986,6.935.892.857
28/11/2020 06:00,11.23,46441,364,23,108,563,7,1065,6.935.892.857
28/11/2020 07:00,11.69,48094,338,31,100,616,10,1095,6.935.892.857
28/11/2020 08:00,11.94,49747,348,50,87,715,12,1212,6.935.892.857
28/11/2020 09:00,14.9,51346,355,71,84,915,9,1434,6.935.892.857
28/11/2020 10:00,15.39,52309,344,94,92,1024,9,1563,6.935.892.857
28/11/2020 11:00,14.87,52506,314,125,107,1136,7,1689,6.935.892.857
28/11/2020 12:00,14.37,52277,245,155,124,1191,6,1721,6.935.892.857
28/11/2020 13:00,13.63,51917,229,179,138,1301,8,1855,6.935.892.857
28/11/2020 14:00,13.08,52180,228,202,151,1459,10,2050,6.935.892.857
28/11/2020 15:00,13.48,53192,226,224,160,1496,11,2117,6.935.892.857
28/11/2020 16:00,14.88,54526,262,240,157,1680,12,2351,6.935.892.857
28/11/2020 17:00,15.25,55262,334,251,148,1731,10,2474,6.935.892.857
28/11/2020 18:00,14.91,54649,393,258,138,1840,8,2637,6.935.892.857
28/11/2020 19:00,12.94,53177,412,263,126,1751,9,2561,6.935.892.857
28/11/2020 20:00,11.6,51398,375,264,118,1554,6,2317,6.935.892.857
28/11/2020 21:00,11.5,50266,338,261,112,1510,6,2227,6.935.892.857
28/11/2020 22:00,11.34,48888,320,251,109,1421,5,2106,6.935.892.857
28/11/2020 23:00,10.98,47268,287,232,104,1396,5,2024,6.935.892.857
29/11/2020 00:00,12.15,45977,309,213,0,1337,5,1864,6.935.892.857
29/11/2020 01:00,12.04,44955,303,206,0,1190,5,1704,6.935.892.857
29/11/2020 02:00,12.08,44459,276,199,0,1030,6,1511,6.935.892.857
29/11/2020 03:00,12.09,44362,259,193,0,1015,6,1473,6.935.892.857
29/11/2020 04:00,12.02,44448,260,183,0,968,4,1415,6.935.892.857
29/11/2020 05:00,12.12,45001,234,174,0,936,4,1348,6.935.892.857
29/11/2020 06:00,12.27,45908,212,171,0,899,4,1286,6.935.892.857
29/11/2020 07:00,12.59,47296,195,166,0,954,4,1319,6.935.892.857
29/11/2020 08:00,12.94,48742,171,163,0,877,3,1214,6.935.892.857
29/11/2020 09:00,14.37,50328,122,160,0,858,3,1143,6.935.892.857
29/11/2020 10:00,16.04,51573,107,156,0,785,2,1050,6.935.892.857
29/11/2020 11:00,16.59,52089,103,142,0,759,2,1006,6.935.892.857
29/11/2020 12:00,16.16,52170,86,146,0,746,2,980,6.935.892.857
29/11/2020 13:00,15.81,52252,89,150,0,792,2,1033,6.935.892.857
29/11/2020 14:00,16.22,52683,96,150,0,779,2,1027,6.935.892.857
29/11/2020 15:00,16.51,53634,105,147,0,854,3,1109,6.935.892.857
29/11/2020 16:00,17.19,54854,117,145,0,999,3,1264,6.935.892.857
29/11/2020 17:00,17.94,55492,122,147,0,1123,3,1395,6.935.892.857
29/11/2020 18:00,17.38,55089,114,151,0,1120,2,1387,6.935.892.857
29/11/2020 19:00,16.73,54130,110,153,0,1226,2,1491,6.935.892.857
29/11/2020 20:00,15.03,52851,106,156,0,1374,2,1638,6.935.892.857
29/11/2020 21:00,15.09,51900,116,157,0,1466,2,1741,6.935.892.857
29/11/2020 22:00,13.42,50210,127,154,0,1557,2,1840,6.935.892.857
29/11/2020 23:00,12.35,48342,138,145,0,1515,2,1800,6.935.892.857
30/11/2020 00:00,12.76,47256,160,87,42,1554,2,1845,6.764.464.286
30/11/2020 01:00,11.94,46460,197,98,43,1656,3,1997,6.764.464.286
30/11/2020 02:00,11.73,46138,271,101,40,1761,3,2176,6.764.464.286
30/11/2020 03:00,11.66,46175,368,108,36,1826,3,2341,6.764.464.286
30/11/2020 04:00,12.12,47025,488,105,33,1825,2,2453,6.764.464.286
30/11/2020 05:00,13.18,49401,620,99,27,1832,2,2580,6.764.464.286
30/11/2020 06:00,14.07,53710,757,97,22,1938,2,2816,6.764.464.286
30/11/2020 07:00,21.45,57451,907,99,20,1988,2,3016,6.764.464.286
30/11/2020 08:00,43.53,58334,1143,101,23,2019,2,3288,6.764.464.286
30/11/2020 09:00,20.84,58101,1409,102,28,2249,2,3790,6.764.464.286
30/11/2020 10:00,18.84,58017,1737,106,35,2312,3,4193,6.764.464.286
30/11/2020 11:00,17.74,57804,2018,107,45,2335,2,4507,6.764.464.286
30/11/2020 12:00,17.27,57590,2297,108,51,2439,3,4898,6.764.464.286
30/11/2020 13:00,17.1,57551,2519,111,60,2534,3,5227,6.764.464.286
30/11/2020 14:00,16.74,57634,2681,115,79,2588,3,5466,6.764.464.286
30/11/2020 15:00,17.57,58237,2719,122,97,2632,5,5575,6.764.464.286
30/11/2020 16:00,19.8,58756,2829,129,123,2701,5,5787,6.764.464.286
30/11/2020 17:00,21.01,58790,2885,133,142,2669,3,5832,6.764.464.286
30/11/2020 18:00,18.34,57899,2813,134,151,2719,4,5821,6.764.464.286
30/11/2020 19:00,16.72,56534,2657,128,153,2668,4,5610,6.764.464.286
30/11/2020 20:00,14.42,54715,2348,121,159,2624,5,5257,6.764.464.286
30/11/2020 21:00,13.45,53105,2138,114,169,2591,8,5020,6.764.464.286
30/11/2020 22:00,13.09,50852,1972,109,175,2484,8,4748,6.764.464.286
30/11/2020 23:00,11.53,48307,1824,105,182,2360,8,4479,6.764.464.286
01/12/2020 00:00,11.85,46042,1547,44,172,2220,6,3989,6.764.464.286
01/12/2020 01:00,11.44,45054,1321,40,178,2149,5,3693,6.764.464.286
01/12/2020 02:00,11.46,44673,1148,35,169,2138,6,3496,6.764.464.286
01/12/2020 03:00,11.5,44683,841,29,148,2239,7,3264,6.764.464.286
01/12/2020 04:00,11.63,45407,650,26,133,2307,7,3123,6.764.464.286
01/12/2020 05:00,13.69,47600,523,21,124,2513,16,3197,6.764.464.286
01/12/2020 06:00,14.47,51575,458,17,121,2720,13,3329,6.764.464.286
01/12/2020 07:00,18.21,55447,408,15,121,2975,12,3531,6.764.464.286
01/12/2020 08:00,32.11,56486,406,15,118,3231,12,3782,6.764.464.286
01/12/2020 09:00,32.01,56147,432,15,115,3331,19,3912,6.764.464.286
01/12/2020 10:00,27.17,56210,434,16,114,3420,17,4001,6.764.464.286
01/12/2020 11:00,28.53,56056,471,15,110,3342,16,3954,6.764.464.286
01/12/2020 12:00,23.31,55726,560,14,103,3293,13,3983,6.764.464.286
01/12/2020 13:00,28.74,55725,635,13,98,3229,10,3985,6.764.464.286
01/12/2020 14:00,25.09,55989,657,13,97,3088,8,3863,6.764.464.286
01/12/2020 15:00,22.94,56685,688,14,98,2848,10,3658,6.764.464.286
01/12/2020 16:00,39.25,57349,697,14,99,2725,10,3545,6.764.464.286
01/12/2020 17:00,43.73,57507,670,15,99,2388,10,3182,6.764.464.286
01/12/2020 18:00,34.08,56744,638,17,98,2120,10,2883,6.764.464.286
01/12/2020 19:00,31.4,55699,600,19,96,1506,10,2231,6.764.464.286
01/12/2020 20:00,23.08,53994,554,21,90,1076,9,1750,6.764.464.286
01/12/2020 21:00,18.22,52563,501,25,86,802,8,1422,6.764.464.286
01/12/2020 22:00,16.09,50414,458,29,81,681,7,1256,6.764.464.286
01/12/2020 23:00,14.45,48084,400,32,72,716,6,1226,6.764.464.286
02/12/2020 00:00,16.02,46457,279,29,93,1178,7,1586,6.764.464.286
02/12/2020 01:00,14.41,45552,233,32,85,1699,7,2056,6.764.464.286
02/12/2020 02:00,13.6,45181,206,38,79,2330,6,2659,6.764.464.286
02/12/2020 03:00,12.53,45220,183,43,76,3017,7,3326,6.764.464.286
02/12/2020 04:00,12.6,46093,192,49,78,3507,7,3833,6.764.464.286
02/12/2020 05:00,14.36,48389,220,54,85,3842,7,4208,6.764.464.286
02/12/2020 06:00,16.13,52531,270,59,87,4040,7,4463,6.764.464.286
02/12/2020 07:00,17.87,56339,315,66,86,3979,8,4454,6.764.464.286
02/12/2020 08:00,23.6,57073,401,73,85,3896,7,4462,6.764.464.286
02/12/2020 09:00,22.85,56917,494,78,77,3975,8,4632,6.764.464.286
02/12/2020 10:00,21.98,57007,538,83,72,4175,7,4875,6.764.464.286
02/12/2020 11:00,21.36,56715,548,87,72,4233,6,4946,6.764.464.286
02/12/2020 12:00,20.62,56469,589,89,73,4269,6,5026,6.764.464.286
02/12/2020 13:00,21.26,56454,654,91,78,4190,5,5018,6.764.464.286
02/12/2020 14:00,22.26,56611,725,93,88,4345,5,5256,6.764.464.286
02/12/2020 15:00,21.48,57342,805,94,112,4467,7,5485,6.764.464.286
02/12/2020 16:00,22.9,58046,919,100,134,4590,8,5751,6.764.464.286
02/12/2020 17:00,21.54,58065,1077,103,148,4760,9,6097,6.764.464.286
02/12/2020 18:00,19.4,57370,1295,109,162,4878,10,6454,6.764.464.286
02/12/2020 19:00,16.48,56224,1562,112,170,4981,10,6835,6.764.464.286
02/12/2020 20:00,15.93,54401,1810,114,169,5051,11,7155,6.764.464.286
02/12/2020 21:00,14.23,53016,2034,115,168,5189,10,7516,6.764.464.286
02/12/2020 22:00,12.25,50833,2288,113,159,5240,9,7809,6.764.464.286
02/12/2020 23:00,10.43,48390,2424,107,152,5288,10,7981,6.764.464.286
03/12/2020 00:00,9.09,45840,2736,97,139,5479,13,8464,6.764.464.286
03/12/2020 01:00,8.44,45000,2721,87,141,5444,12,8405,6.764.464.286
03/12/2020 02:00,8.11,44730,2788,79,144,5250,10,8271,6.764.464.286
03/12/2020 03:00,8.26,44913,2817,75,151,5268,9,8320,6.764.464.286
03/12/2020 04:00,8.89,45791,2850,72,164,5262,9,8357,6.764.464.286
03/12/2020 05:00,10.38,48243,2972,69,176,5348,13,8578,6.764.464.286
03/12/2020 06:00,12.87,52381,3007,64,198,5308,17,8594,6.764.464.286
03/12/2020 07:00,18.33,56370,3140,58,219,5322,19,8758,6.764.464.286
03/12/2020 08:00,19.09,57467,3270,57,240,5377,22,8966,6.764.464.286
03/12/2020 09:00,18.93,57372,3086,56,251,5395,19,8807,6.764.464.286
03/12/2020 10:00,18.45,57512,3122,56,261,5454,19,8912,6.764.464.286
03/12/2020 11:00,18.81,57342,3152,55,267,5403,17,8894,6.764.464.286
03/12/2020 12:00,18.79,57210,3052,54,264,5352,16,8738,6.764.464.286
03/12/2020 13:00,19.94,57251,2964,56,273,5333,20,8646,6.764.464.286
03/12/2020 14:00,19.36,57605,3006,58,284,5195,22,8565,6.764.464.286
03/12/2020 15:00,19.46,58394,3066,58,309,5042,20,8495,6.764.464.286
03/12/2020 16:00,20.17,59153,3144,62,327,4961,23,8517,6.764.464.286
03/12/2020 17:00,20,59296,3299,67,341,4932,29,8668,6.764.464.286
03/12/2020 18:00,18.2,58495,3442,73,357,4800,31,8703,6.764.464.286
03/12/2020 19:00,16.61,57318,3556,78,367,4650,33,8684,6.764.464.286
03/12/2020 20:00,15.61,55513,3417,82,376,4627,35,8537,6.764.464.286
03/12/2020 21:00,14.08,53904,3400,83,381,4319,31,8214,6.764.464.286
03/12/2020 22:00,12.4,51645,3333,81,384,4077,31,7906,6.764.464.286
03/12/2020 23:00,10.56,49165,3254,77,390,4055,35,7811,6.764.464.286
04/12/2020 00:00,11.09,46797,3489,75,400,3841,29,7834,6.764.464.286
04/12/2020 01:00,10.79,45774,3454,68,412,3886,30,7850,6.764.464.286
04/12/2020 02:00,10.64,45427,3642,63,411,3813,32,7961,6.764.464.286
04/12/2020 03:00,10.61,45558,3754,62,413,3814,32,8075,6.764.464.286
04/12/2020 04:00,10.64,46363,3760,64,414,3671,34,7943,6.764.464.286
04/12/2020 05:00,12.12,48623,3824,66,414,3742,34,8080,6.764.464.286
04/12/2020 06:00,13.93,52588,3771,67,410,3715,34,7997,6.764.464.286
04/12/2020 07:00,17.79,56510,3759,69,407,3591,34,7860,6.764.464.286
04/12/2020 08:00,19.21,57596,3829,71,405,3472,33,7810,6.764.464.286
04/12/2020 09:00,19.35,57588,3604,76,407,3375,33,7495,6.764.464.286
04/12/2020 10:00,19.48,57684,3604,76,410,3110,35,7235,6.764.464.286
04/12/2020 11:00,19.86,57417,3566,73,417,2950,33,7039,6.764.464.286
04/12/2020 12:00,19.82,56939,3407,73,424,2864,32,6800,6.764.464.286
04/12/2020 13:00,20.08,56577,3267,74,425,2655,30,6451,6.764.464.286
04/12/2020 14:00,21.82,56436,3131,79,426,2467,29,6132,6.764.464.286
04/12/2020 15:00,22.86,56927,3002,85,429,2403,32,5951,6.764.464.286
04/12/2020 16:00,23.55,57457,2888,92,432,2501,33,5946,6.764.464.286
04/12/2020 17:00,23.63,57505,2789,99,434,2300,33,5655,6.764.464.286
04/12/2020 18:00,22.33,56484,2665,105,433,2310,34,5547,6.764.464.286
04/12/2020 19:00,19.97,54926,2448,105,431,2142,37,5163,6.764.464.286
04/12/2020 20:00,18.73,52760,2069,106,425,1985,38,4623,6.764.464.286
04/12/2020 21:00,18.54,51059,1829,106,420,1782,38,4175,6.764.464.286
04/12/2020 22:00,16.92,49221,1581,108,417,1662,38,3806,6.764.464.286
04/12/2020 23:00,14.95,47205,1448,108,414,1555,39,3564,6.764.464.286
05/12/2020 00:00,16.98,45689,1358,117,403,1373,38,3289,6.764.464.286
05/12/2020 01:00,16.59,44535,1399,125,407,1295,40,3266,6.764.464.286
05/12/2020 02:00,15.7,43844,1426,132,398,1223,42,3221,6.764.464.286
05/12/2020 03:00,15.19,43574,1420,136,395,1254,38,3243,6.764.464.286
05/12/2020 04:00,15.4,43717,1497,139,395,1169,38,3238,6.764.464.286
05/12/2020 05:00,16.22,44219,1594,146,402,1118,39,3299,6.764.464.286
05/12/2020 06:00,16.91,45338,1655,152,410,1150,39,3406,6.764.464.286
05/12/2020 07:00,16.8,47016,1691,156,410,1317,38,3612,6.764.464.286
05/12/2020 08:00,18.91,48643,1803,163,413,1307,38,3724,6.764.464.286
05/12/2020 09:00,20.19,50129,1828,166,415,1360,38,3807,6.764.464.286
05/12/2020 10:00,20.5,51114,1883,170,416,1372,38,3879,6.764.464.286
05/12/2020 11:00,20.78,51275,1878,174,417,1424,38,3931,6.764.464.286
05/12/2020 12:00,20.29,51192,1863,176,416,1409,38,3902,6.764.464.286
05/12/2020 13:00,20.28,51030,1876,174,416,1473,38,3977,6.764.464.286
05/12/2020 14:00,20.31,51224,1748,173,417,1632,38,4008,6.764.464.286
05/12/2020 15:00,21.95,52065,1629,175,419,1855,45,4123,6.764.464.286
05/12/2020 16:00,23.65,53063,1589,179,419,1926,42,4155,6.764.464.286
05/12/2020 17:00,24.07,53518,1536,185,419,1819,43,4002,6.764.464.286
05/12/2020 18:00,22.36,52814,1426,190,415,1707,47,3785,6.764.464.286
05/12/2020 19:00,20.22,51296,1332,191,405,1599,45,3572,6.764.464.286
05/12/2020 20:00,19.83,49506,1204,190,397,1475,43,3309,6.764.464.286
05/12/2020 21:00,19.08,48374,1108,190,393,1325,41,3057,6.764.464.286
05/12/2020 22:00,17.06,46879,988,189,392,1275,38,2882,6.764.464.286
05/12/2020 23:00,15.34,45533,829,188,391,990,42,2440,6.764.464.286
06/12/2020 00:00,16.62,43885,1015,190,415,775,37,2432,6.764.464.286
06/12/2020 01:00,16.06,42883,844,188,420,673,37,2162,6.764.464.286
06/12/2020 02:00,15.65,42317,751,186,413,673,35,2058,6.764.464.286
06/12/2020 03:00,15.1,42091,709,184,413,689,33,2028,6.764.464.286
06/12/2020 04:00,15.52,42276,721,181,415,751,30,2098,6.764.464.286
06/12/2020 05:00,16.04,42805,696,178,418,781,35,2108,6.764.464.286
06/12/2020 06:00,16.48,43716,720,177,424,860,37,2218,6.764.464.286
06/12/2020 07:00,16.5,44983,708,176,429,979,42,2334,6.764.464.286
06/12/2020 08:00,16.21,46317,702,174,433,1091,42,2442,6.764.464.286
06/12/2020 09:00,18,47771,662,174,434,1197,41,2508,6.764.464.286
06/12/2020 10:00,19.51,48935,640,173,431,1326,41,2611,6.764.464.286
06/12/2020 11:00,19.74,49392,661,172,425,1389,41,2688,6.764.464.286
06/12/2020 12:00,19.67,49511,747,169,421,1513,39,2889,6.764.464.286
06/12/2020 13:00,19.59,49685,880,166,415,1695,39,3195,6.764.464.286
06/12/2020 14:00,19.69,50134,916,164,426,1973,41,3520,6.764.464.286
06/12/2020 15:00,20.87,51005,1022,165,434,2076,41,3738,6.764.464.286
06/12/2020 16:00,22.48,52008,1126,169,444,2167,45,3951,6.764.464.286
06/12/2020 17:00,22.86,52350,1236,170,447,2247,44,4144,6.764.464.286
06/12/2020 18:00,22.05,51616,1433,171,450,2466,41,4561,6.764.464.286
06/12/2020 19:00,19.89,50664,1524,172,454,2500,41,4691,6.764.464.286
06/12/2020 20:00,19.54,49461,1385,171,456,2628,41,4681,6.764.464.286
06/12/2020 21:00,19.38,48497,1267,167,456,2556,43,4489,6.764.464.286
06/12/2020 22:00,17.14,46765,1342,164,456,2579,45,4586,6.764.464.286
06/12/2020 23:00,15.14,44389,1318,162,455,2631,47,4613,6.764.464.286
07/12/2020 00:00,13.13,43057,1999,174,459,2782,41,5455,6.552.619.048
07/12/2020 01:00,12.27,42271,2077,171,461,2889,41,5639,6.552.619.048
07/12/2020 02:00,11.72,41997,2340,164,461,2831,37,5833,6.552.619.048
07/12/2020 03:00,11.38,42015,2661,159,460,2943,35,6258,6.552.619.048
07/12/2020 04:00,11.93,42811,2820,158,460,3037,33,6508,6.552.619.048
07/12/2020 05:00,13.55,45172,3175,160,462,3046,36,6879,6.552.619.048
07/12/2020 06:00,16.34,49529,3434,163,463,3191,41,7292,6.552.619.048
07/12/2020 07:00,19.32,53602,3583,165,464,3231,38,7481,6.552.619.048
07/12/2020 08:00,19.93,54745,3840,168,464,3295,38,7805,6.552.619.048
07/12/2020 09:00,19.42,54610,3828,170,462,3290,42,7792,6.552.619.048
07/12/2020 10:00,18.86,54681,3965,170,459,3332,42,7968,6.552.619.048
07/12/2020 11:00,18.91,54656,4035,168,455,3358,42,8058,6.552.619.048
07/12/2020 12:00,18.91,54702,4014,165,449,3331,42,8001,6.552.619.048
07/12/2020 13:00,18.96,54758,4140,164,446,3295,38,8083,6.552.619.048
07/12/2020 14:00,18.91,55140,4017,165,453,3312,37,7984,6.552.619.048
07/12/2020 15:00,19.22,55944,4115,167,454,3324,37,8097,6.552.619.048
07/12/2020 16:00,19.83,56450,4155,171,455,3453,38,8272,6.552.619.048
07/12/2020 17:00,20.11,56440,4201,175,457,3549,42,8424,6.552.619.048
07/12/2020 18:00,19.97,55522,4090,177,457,3496,38,8258,6.552.619.048
07/12/2020 19:00,18.01,54272,3710,179,454,3383,37,7763,6.552.619.048
07/12/2020 20:00,17,52576,3305,182,446,3125,33,7091,6.552.619.048
07/12/2020 21:00,16.78,51088,2919,184,441,3016,31,6591,6.552.619.048
07/12/2020 22:00,14.44,48914,2529,185,437,2900,31,6082,6.552.619.048
07/12/2020 23:00,13.18,46507,2235,182,438,2659,33,5547,6.552.619.048
08/12/2020 00:00,14.21,44550,1825,186,435,2821,33,5300,6.552.619.048
08/12/2020 01:00,13.88,43599,1569,183,440,2631,35,4858,6.552.619.048
08/12/2020 02:00,13.8,43172,1264,182,434,2526,37,4443,6.552.619.048
08/12/2020 03:00,14.03,43374,1031,185,433,2493,37,4179,6.552.619.048
08/12/2020 04:00,15.94,44350,906,187,430,2413,33,3969,6.552.619.048
08/12/2020 05:00,17.04,46640,804,186,429,2430,34,3883,6.552.619.048
08/12/2020 06:00,19.46,50721,720,186,429,2450,34,3819,6.552.619.048
08/12/2020 07:00,22.51,54734,682,185,428,2423,33,3751,6.552.619.048
08/12/2020 08:00,26.62,55917,622,183,426,2385,36,3652,6.552.619.048
08/12/2020 09:00,26.49,55770,524,182,418,2234,37,3395,6.552.619.048
08/12/2020 10:00,25.85,55915,532,180,408,2283,40,3443,6.552.619.048
08/12/2020 11:00,27.33,55862,532,176,404,2232,36,3380,6.552.619.048
08/12/2020 12:00,27.6,55643,532,171,390,2149,36,3278,6.552.619.048
08/12/2020 13:00,28.34,55808,542,166,387,2130,30,3255,6.552.619.048
08/12/2020 14:00,29.19,56159,571,165,385,2262,29,3412,6.552.619.048
08/12/2020 15:00,30.94,56978,619,170,389,2410,29,3617,6.552.619.048
08/12/2020 16:00,34.31,57621,682,174,389,2467,27,3739,6.552.619.048
08/12/2020 17:00,29.06,57774,717,178,387,2567,27,3876,6.552.619.048
08/12/2020 18:00,25.76,56989,722,181,381,2698,26,4008,6.552.619.048
08/12/2020 19:00,22.56,55751,644,180,367,2637,24,3852,6.552.619.048
08/12/2020 20:00,20.32,53882,599,178,356,2877,25,4035,6.552.619.048
08/12/2020 21:00,19.79,52349,585,173,343,2532,27,3660,6.552.619.048
08/12/2020 22:00,18.88,50195,568,168,335,2503,29,3603,6.552.619.048
08/12/2020 23:00,17.22,47780,538,160,328,2384,23,3433,6.552.619.048
09/12/2020 00:00,18.51,45871,656,155,331,2225,23,3390,6.552.619.048
09/12/2020 01:00,17.97,44892,697,148,326,2148,23,3342,6.552.619.048
09/12/2020 02:00,17.51,44462,809,139,312,2116,21,3397,6.552.619.048
09/12/2020 03:00,17.36,44486,971,133,301,2189,22,3616,6.552.619.048
09/12/2020 04:00,17.95,45355,1064,130,287,2211,21,3713,6.552.619.048
09/12/2020 05:00,18.91,47700,1149,133,281,2346,21,3930,6.552.619.048
09/12/2020 06:00,20.54,51864,1338,135,275,2313,20,4081,6.552.619.048
09/12/2020 07:00,23.12,55681,1423,135,276,2273,19,4126,6.552.619.048
09/12/2020 08:00,25.98,56551,1507,129,272,2290,19,4217,6.552.619.048
09/12/2020 09:00,26.56,56439,1499,124,263,2397,19,4302,6.552.619.048
09/12/2020 10:00,29.68,56559,1514,120,253,2390,19,4296,6.552.619.048
09/12/2020 11:00,30.47,56483,1545,113,236,2334,18,4246,6.552.619.048
09/12/2020 12:00,26.35,56433,1611,107,217,2427,17,4379,6.552.619.048
09/12/2020 13:00,27.73,56595,1703,101,217,2532,16,4569,6.552.619.048
09/12/2020 14:00,31.01,56895,1630,103,226,2599,14,4572,6.552.619.048
09/12/2020 15:00,32.29,57660,1638,109,238,2829,14,4828,6.552.619.048
09/12/2020 16:00,40.24,58202,1674,116,244,3106,15,5155,6.552.619.048
09/12/2020 17:00,40.34,58188,1785,117,240,3251,16,5409,6.552.619.048
09/12/2020 18:00,29.07,57456,1819,116,235,3277,18,5465,6.552.619.048
09/12/2020 19:00,25.54,56236,1699,115,233,3344,19,5410,6.552.619.048
09/12/2020 20:00,22.24,54404,1615,116,230,3350,18,5329,6.552.619.048
09/12/2020 21:00,20.96,52960,1585,116,225,3236,16,5178,6.552.619.048
09/12/2020 22:00,19.84,50913,1595,115,226,3132,16,5084,6.552.619.048
09/12/2020 23:00,18.63,48397,1611,112,220,2984,16,4943,6.552.619.048
10/12/2020 00:00,18.47,45926,965,107,211,2829,5,4117,6.552.619.048
10/12/2020 01:00,17.56,44994,965,107,208,2871,4,4155,6.552.619.048
10/12/2020 02:00,17.36,44559,1011,107,204,2829,4,4155,6.552.619.048
10/12/2020 03:00,17.59,44688,1026,103,205,2835,4,4173,6.552.619.048
10/12/2020 04:00,18.8,45539,1023,94,210,2745,4,4076,6.552.619.048
10/12/2020 05:00,20.4,47943,1109,87,217,2780,3,4196,6.552.619.048
10/12/2020 06:00,22.94,52056,1244,81,223,2687,4,4239,6.552.619.048
10/12/2020 07:00,26.29,55994,1308,76,232,2589,7,4212,6.552.619.048
10/12/2020 08:00,31.89,56989,1351,71,238,2441,7,4108,6.552.619.048
10/12/2020 09:00,33.74,56886,1384,65,235,2437,7,4128,6.552.619.048
10/12/2020 10:00,31.98,57020,1399,57,232,2319,7,4014,6.552.619.048
10/12/2020 11:00,34.49,56899,1352,50,234,2038,9,3683,6.552.619.048
10/12/2020 12:00,29.97,56649,1276,47,224,1891,7,3445,6.552.619.048
10/12/2020 13:00,32.73,56722,1267,46,229,1873,5,3420,6.552.619.048
10/12/2020 14:00,33.32,57138,1226,49,250,1841,6,3372,6.552.619.048
10/12/2020 15:00,34.45,57836,1249,52,271,1907,10,3489,6.552.619.048
10/12/2020 16:00,46.12,58506,1348,55,287,1902,13,3605,6.552.619.048
10/12/2020 17:00,46.09,58521,1552,55,293,1939,17,3856,6.552.619.048
10/12/2020 18:00,31.94,57604,1750,54,298,1916,15,4033,6.552.619.048
10/12/2020 19:00,28.76,56448,1823,52,296,1813,16,4000,6.552.619.048
10/12/2020 20:00,26.86,54741,1760,49,285,1763,14,3871,6.552.619.048
10/12/2020 21:00,23.8,53189,1664,46,276,1786,11,3783,6.552.619.048
10/12/2020 22:00,21.65,50974,1578,44,262,1698,12,3594,6.552.619.048
10/12/2020 23:00,20.51,48646,1482,42,244,1731,10,3509,6.552.619.048
11/12/2020 00:00,20.11,46786,1303,45,225,1709,6,3288,6.552.619.048
11/12/2020 01:00,19.74,45818,1345,44,220,1701,7,3317,6.552.619.048
11/12/2020 02:00,19.5,45464,1449,43,212,1638,10,3352,6.552.619.048
11/12/2020 03:00,19.13,45554,1601,40,202,1637,10,3490,6.552.619.048
11/12/2020 04:00,19.66,46327,1827,37,188,1607,8,3667,6.552.619.048
11/12/2020 05:00,20.35,48572,1988,34,181,1628,8,3839,6.552.619.048
11/12/2020 06:00,20.98,52640,2154,33,180,1612,8,3987,6.552.619.048
11/12/2020 07:00,23.79,56591,2230,32,178,1592,8,4040,6.552.619.048
11/12/2020 08:00,26.28,57786,2308,29,173,1610,8,4128,6.552.619.048
11/12/2020 09:00,24.35,57795,2293,27,165,1614,8,4107,6.552.619.048
11/12/2020 10:00,24.26,57806,2305,23,156,1600,6,4090,6.552.619.048
11/12/2020 11:00,24.47,57691,2324,20,155,1475,7,3981,6.552.619.048
11/12/2020 12:00,23.9,57391,2354,20,151,1405,6,3936,6.552.619.048
11/12/2020 13:00,23.89,57061,2522,21,148,1320,8,4019,6.552.619.048
11/12/2020 14:00,24.11,57106,2600,25,149,1386,8,4168,6.552.619.048
11/12/2020 15:00,23.83,57764,2715,29,158,1441,7,4350,6.552.619.048
11/12/2020 16:00,24.07,58232,2910,33,165,1545,8,4661,6.552.619.048
11/12/2020 17:00,24.54,58221,3088,38,168,1686,9,4989,6.552.619.048
11/12/2020 18:00,23.29,57358,3267,39,168,1686,13,5173,6.552.619.048
11/12/2020 19:00,21.57,55856,3191,40,171,1553,12,4967,6.552.619.048
11/12/2020 20:00,20.6,53732,3093,41,178,1533,10,4855,6.552.619.048
11/12/2020 21:00,20.33,52146,3062,41,186,1408,10,4707,6.552.619.048
11/12/2020 22:00,20.01,50378,2971,41,201,1376,7,4596,6.552.619.048
11/12/2020 23:00,18.44,48472,2993,40,219,1319,7,4578,6.552.619.048
12/12/2020 00:00,19.57,46457,2886,37,227,1128,11,4289,6.552.619.048
12/12/2020 01:00,18.71,45427,2858,37,245,1120,13,4273,6.552.619.048
12/12/2020 02:00,18.05,44785,2883,37,260,1099,13,4292,6.552.619.048
12/12/2020 03:00,17.77,44681,2929,36,277,1129,13,4384,6.552.619.048
12/12/2020 04:00,18.09,44694,2957,37,288,1127,15,4424,6.552.619.048
12/12/2020 05:00,18.81,45162,2910,41,294,1147,13,4405,6.552.619.048
12/12/2020 06:00,19.81,46309,2905,43,304,1146,15,4413,6.552.619.048
12/12/2020 07:00,20.02,47957,2841,44,308,1134,15,4342,6.552.619.048
12/12/2020 08:00,21.31,49711,2686,43,309,1164,15,4217,6.552.619.048
12/12/2020 09:00,22.88,51163,2427,41,303,1176,18,3965,6.552.619.048
12/12/2020 10:00,23.62,52149,2367,39,289,1184,16,3895,6.552.619.048
12/12/2020 11:00,23.8,52383,2248,36,278,1134,15,3711,6.552.619.048
12/12/2020 12:00,24.1,52365,2144,35,268,1115,12,3574,6.552.619.048
12/12/2020 13:00,23.94,52297,2083,35,253,1100,12,3483,6.552.619.048
12/12/2020 14:00,24.22,52602,1908,34,256,1092,10,3300,6.552.619.048
12/12/2020 15:00,25.9,53505,1811,34,262,1130,11,3248,6.552.619.048
12/12/2020 16:00,28.06,54370,1785,34,267,1103,12,3201,6.552.619.048
12/12/2020 17:00,28.48,54790,1791,35,266,1087,13,3192,6.552.619.048
12/12/2020 18:00,27.91,54081,1795,37,259,1128,13,3232,6.552.619.048
12/12/2020 19:00,27.57,52552,1636,37,251,1095,12,3031,6.552.619.048
12/12/2020 20:00,24.05,50699,1495,38,244,1047,12,2836,6.552.619.048
12/12/2020 21:00,23.63,49546,1368,40,234,971,10,2623,6.552.619.048
12/12/2020 22:00,22.89,48061,1230,43,223,897,11,2404,6.552.619.048
12/12/2020 23:00,21.76,46497,1104,45,205,783,11,2148,6.552.619.048
13/12/2020 00:00,22.54,44866,959,40,200,710,11,1920,6.552.619.048
13/12/2020 01:00,21.98,43813,877,42,190,641,10,1760,6.552.619.048
13/12/2020 02:00,21.69,43184,820,46,177,596,8,1647,6.552.619.048
13/12/2020 03:00,21.65,42939,765,48,164,566,9,1552,6.552.619.048
13/12/2020 04:00,21.82,43013,769,51,151,534,9,1514,6.552.619.048
13/12/2020 05:00,21.94,43479,768,52,143,515,9,1487,6.552.619.048
13/12/2020 06:00,22.28,44462,766,54,136,495,7,1458,6.552.619.048
13/12/2020 07:00,22.64,45802,748,57,127,459,7,1398,6.552.619.048
13/12/2020 08:00,23.47,47301,742,59,119,420,8,1348,6.552.619.048
13/12/2020 09:00,24.61,48896,741,61,106,389,7,1304,6.552.619.048
13/12/2020 10:00,25.56,50221,751,58,92,368,7,1276,6.552.619.048
13/12/2020 11:00,26.25,50857,753,56,76,334,6,1225,6.552.619.048
13/12/2020 12:00,25.21,51085,740,55,63,317,6,1181,6.552.619.048
13/12/2020 13:00,24.97,51224,780,53,52,282,5,1172,6.552.619.048
13/12/2020 14:00,25.08,51683,770,53,55,289,5,1172,6.552.619.048
13/12/2020 15:00,27.12,52633,796,53,60,274,5,1188,6.552.619.048
13/12/2020 16:00,28.76,53483,880,54,62,298,5,1299,6.552.619.048
13/12/2020 17:00,39.91,53880,1038,54,63,371,5,1531,6.552.619.048
13/12/2020 18:00,30.7,53460,1208,54,61,371,5,1699,6.552.619.048
13/12/2020 19:00,29.57,52485,1292,54,57,408,5,1816,6.552.619.048
13/12/2020 20:00,24.15,51176,1340,51,53,434,4,1882,6.552.619.048
13/12/2020 21:00,24.13,50134,1394,50,44,485,4,1977,6.552.619.048
13/12/2020 22:00,23.42,48483,1479,49,42,506,4,2080,6.552.619.048
13/12/2020 23:00,21.59,46556,1590,47,38,551,4,2230,6.552.619.048
14/12/2020 00:00,20.53,45407,2128,43,38,582,6,2797,6.402.559.524
14/12/2020 01:00,19.93,44588,2235,42,35,697,5,3014,6.402.559.524
14/12/2020 02:00,19.24,44261,2426,40,32,716,5,3219,6.402.559.524
14/12/2020 03:00,18.93,44438,2742,38,32,737,5,3554,6.402.559.524
14/12/2020 04:00,19.71,45330,2907,32,30,806,5,3780,6.402.559.524
14/12/2020 05:00,20.3,47659,3174,28,31,931,5,4169,6.402.559.524
14/12/2020 06:00,22.56,51691,3475,25,31,1123,6,4660,6.402.559.524
14/12/2020 07:00,24.59,55508,3652,22,30,1220,5,4929,6.402.559.524
14/12/2020 08:00,27.28,56669,3932,21,27,1374,5,5359,6.402.559.524
14/12/2020 09:00,25.82,56598,3722,19,25,1528,6,5300,6.402.559.524
14/12/2020 10:00,25.41,56741,3645,15,24,1594,5,5283,6.402.559.524
14/12/2020 11:00,25.8,56742,3674,13,21,1645,5,5358,6.402.559.524
14/12/2020 12:00,26.35,56667,3459,11,19,1776,5,5270,6.402.559.524
14/12/2020 13:00,26.53,56809,3458,10,18,1792,5,5283,6.402.559.524
14/12/2020 14:00,26.82,57159,3275,11,20,2011,5,5322,6.402.559.524
14/12/2020 15:00,27.5,57870,3060,14,24,2239,6,5343,6.402.559.524
14/12/2020 16:00,27.86,58329,3071,14,28,2445,6,5564,6.402.559.524
14/12/2020 17:00,28.92,58306,2900,15,31,2526,6,5478,6.402.559.524
14/12/2020 18:00,26.21,57463,2886,14,33,2726,6,5665,6.402.559.524
14/12/2020 19:00,24.91,56290,2776,13,37,2846,7,5679,6.402.559.524
14/12/2020 20:00,24.23,54537,2624,13,36,2814,7,5494,6.402.559.524
14/12/2020 21:00,23.67,52925,2521,12,39,2818,8,5398,6.402.559.524
14/12/2020 22:00,21.78,50782,2376,11,42,2787,8,5224,6.402.559.524
14/12/2020 23:00,18.7,48397,2234,11,41,2724,8,5018,6.402.559.524
15/12/2020 00:00,17.47,46347,2159,12,84,2720,12,4987,6.402.559.524
15/12/2020 01:00,17.57,45266,2128,11,97,2654,14,4904,6.402.559.524
15/12/2020 02:00,16.92,44773,2212,11,109,2660,14,5006,6.402.559.524
15/12/2020 03:00,16.88,44796,2183,10,123,2605,14,4935,6.402.559.524
15/12/2020 04:00,18.95,45554,2024,10,134,2483,14,4665,6.402.559.524
15/12/2020 05:00,20.39,47574,1899,9,145,2553,14,4620,6.402.559.524
15/12/2020 06:00,22.31,51616,1821,9,159,2467,14,4470,6.402.559.524
15/12/2020 07:00,24.59,55543,1768,8,171,2410,14,4371,6.402.559.524
15/12/2020 08:00,31.41,56788,1813,8,182,2306,16,4325,6.402.559.524
15/12/2020 09:00,31.49,56451,1660,7,183,2298,16,4164,6.402.559.524
15/12/2020 10:00,31.62,56636,1536,6,186,2277,16,4021,6.402.559.524
15/12/2020 11:00,30.52,56421,1381,4,188,2236,18,3827,6.402.559.524
15/12/2020 12:00,35.9,56093,1185,4,192,2058,18,3457,6.402.559.524
15/12/2020 13:00,38.1,56024,1086,4,188,2098,19,3395,6.402.559.524
15/12/2020 14:00,40.08,56239,949,5,192,1967,19,3132,6.402.559.524
15/12/2020 15:00,43.08,56946,815,6,202,2024,19,3066,6.402.559.524
15/12/2020 16:00,37.32,57481,821,7,214,1894,20,2956,6.402.559.524
15/12/2020 17:00,51.13,57457,789,8,221,1833,22,2873,6.402.559.524
15/12/2020 18:00,47.54,56575,811,8,223,1682,20,2744,6.402.559.524
15/12/2020 19:00,40.77,55220,872,9,226,1504,22,2633,6.402.559.524
15/12/2020 20:00,35.2,53375,956,10,220,1315,21,2522,6.402.559.524
15/12/2020 21:00,28.45,51789,1043,10,220,1112,21,2406,6.402.559.524
15/12/2020 22:00,23.67,49519,1138,13,220,1177,23,2571,6.402.559.524
15/12/2020 23:00,21.86,47054,1192,14,218,1161,19,2604,6.402.559.524
16/12/2020 00:00,20.48,45239,1013,20,253,1239,25,2550,6.402.559.524
16/12/2020 01:00,19.32,44295,1007,24,243,1324,27,2625,6.402.559.524
16/12/2020 02:00,19,43908,931,27,230,1446,23,2657,6.402.559.524
16/12/2020 03:00,19.02,43884,882,30,222,1463,27,2624,6.402.559.524
16/12/2020 04:00,20.19,44624,756,37,208,1514,27,2542,6.402.559.524
16/12/2020 05:00,21.98,46851,680,45,197,1629,24,2575,6.402.559.524
16/12/2020 06:00,22.71,50800,635,52,187,1799,24,2697,6.402.559.524
16/12/2020 07:00,32.71,54431,692,60,177,1772,23,2724,6.402.559.524
16/12/2020 08:00,48.37,55406,874,68,162,1768,23,2895,6.402.559.524
16/12/2020 09:00,43.68,55371,1003,78,147,1845,19,3092,6.402.559.524
16/12/2020 10:00,42.01,55505,1113,84,138,2036,14,3385,6.402.559.524
16/12/2020 11:00,37.92,55418,1186,88,127,2230,10,3641,6.402.559.524
16/12/2020 12:00,36.56,55270,1214,94,121,2347,14,3790,6.402.559.524
16/12/2020 13:00,36.42,55335,1197,100,118,2430,13,3858,6.402.559.524
16/12/2020 14:00,39.16,55616,1122,105,118,2399,9,3753,6.402.559.524
16/12/2020 15:00,46.54,56248,1118,112,123,2424,11,3788,6.402.559.524
16/12/2020 16:00,46.4,56753,1291,119,123,2469,14,4016,6.402.559.524
16/12/2020 17:00,39.41,56798,1473,126,120,2321,20,4060,6.402.559.524
16/12/2020 18:00,35.78,56198,1768,128,115,2339,17,4367,6.402.559.524
16/12/2020 19:00,24.74,55183,2045,131,111,2229,21,4537,6.402.559.524
16/12/2020 20:00,22.78,53544,2291,133,110,2055,19,4608,6.402.559.524
16/12/2020 21:00,22.15,52310,2485,134,108,1864,16,4607,6.402.559.524
16/12/2020 22:00,21.48,50416,2617,137,111,1760,16,4641,6.402.559.524
16/12/2020 23:00,20.12,48048,2809,135,103,1716,15,4778,6.402.559.524
17/12/2020 00:00,19.03,45917,2693,140,95,1705,10,4643,6.402.559.524
17/12/2020 01:00,17.93,45058,2768,146,93,1562,8,4577,6.402.559.524
17/12/2020 02:00,17.53,44677,2831,151,87,1479,9,4557,6.402.559.524
17/12/2020 03:00,17.28,44790,2913,155,79,1434,8,4589,6.402.559.524
17/12/2020 04:00,17.97,45568,2865,154,73,1516,7,4615,6.402.559.524
17/12/2020 05:00,20,47797,2901,152,70,1628,6,4757,6.402.559.524
17/12/2020 06:00,22.09,51556,2932,154,73,1709,7,4875,6.402.559.524
17/12/2020 07:00,23.64,55219,2871,158,79,1777,7,4892,6.402.559.524
17/12/2020 08:00,26.79,56317,2810,161,85,1927,8,4991,6.402.559.524
17/12/2020 09:00,25.28,56270,2446,158,90,2044,7,4745,6.402.559.524
17/12/2020 10:00,24.43,56335,2260,144,90,2112,7,4613,6.402.559.524
17/12/2020 11:00,24.3,56196,2225,127,84,2153,7,4596,6.402.559.524
17/12/2020 12:00,23.67,55952,2164,125,88,2261,6,4644,6.402.559.524
17/12/2020 13:00,23.99,55940,2104,130,91,2248,6,4579,6.402.559.524
17/12/2020 14:00,23.97,56320,1834,132,99,2421,6,4492,6.402.559.524
17/12/2020 15:00,25.06,57029,1606,133,112,2552,7,4410,6.402.559.524
17/12/2020 16:00,25.38,57508,1656,129,133,2734,8,4660,6.402.559.524
17/12/2020 17:00,26.07,57493,1707,122,159,2774,11,4773,6.402.559.524
17/12/2020 18:00,24.22,56608,1885,117,187,2803,11,5003,6.402.559.524
17/12/2020 19:00,23.16,55383,1994,112,207,2908,12,5233,6.402.559.524
17/12/2020 20:00,22.19,53798,1975,106,217,2906,14,5218,6.402.559.524
17/12/2020 21:00,21.97,52263,1948,101,230,2959,16,5254,6.402.559.524
17/12/2020 22:00,20.76,50180,1995,98,239,3015,14,5361,6.402.559.524
17/12/2020 23:00,18.99,47849,2081,92,244,2865,16,5298,6.402.559.524
18/12/2020 00:00,16.96,45442,1996,84,0,3031,24,5135,6.402.559.524
18/12/2020 01:00,16.65,44457,1870,81,0,2961,26,4938,6.402.559.524
18/12/2020 02:00,16.17,44086,1947,78,0,2806,26,4857,6.402.559.524
18/12/2020 03:00,16.3,44168,1987,81,0,2700,25,4793,6.402.559.524
18/12/2020 04:00,17.3,44913,1898,79,0,2521,23,4521,6.402.559.524
18/12/2020 05:00,19.39,47001,2003,70,0,2424,19,4516,6.402.559.524
18/12/2020 06:00,19.99,50831,2059,58,0,2327,15,4459,6.402.559.524
18/12/2020 07:00,22.43,54634,2198,49,0,2257,18,4522,6.402.559.524
18/12/2020 08:00,23.74,56041,2548,41,0,2203,16,4808,6.402.559.524
18/12/2020 09:00,23.96,56032,2633,36,0,2130,16,4815,6.402.559.524
18/12/2020 10:00,22.82,55993,2682,31,0,2013,22,4748,6.402.559.524
18/12/2020 11:00,22.5,55711,2803,27,0,1978,22,4830,6.402.559.524
18/12/2020 12:00,22.44,55311,2795,23,0,1918,18,4754,6.402.559.524
18/12/2020 13:00,22.23,55034,2931,21,0,1820,23,4795,6.402.559.524
18/12/2020 14:00,22.42,55084,2928,20,0,1780,20,4748,6.402.559.524
18/12/2020 15:00,22.91,55573,2906,19,0,1734,16,4675,6.402.559.524
18/12/2020 16:00,23.11,55968,3138,16,0,1792,19,4965,6.402.559.524
18/12/2020 17:00,23.83,55901,3166,17,0,1785,20,4988,6.402.559.524
18/12/2020 18:00,22.59,55087,3343,23,0,1912,16,5294,6.402.559.524
18/12/2020 19:00,21.01,53514,3397,29,0,2079,14,5519,6.402.559.524
18/12/2020 20:00,19.43,51524,3393,39,0,2131,14,5577,6.402.559.524
18/12/2020 21:00,19.04,50051,3335,50,0,2384,11,5780,6.402.559.524
18/12/2020 22:00,17.82,48318,3272,61,0,2413,11,5757,6.402.559.524
18/12/2020 23:00,15.92,46350,3249,72,0,2610,12,5943,6.402.559.524
19/12/2020 00:00,16.48,43960,3030,81,174,2552,17,5854,6.402.559.524
19/12/2020 01:00,15.98,42856,2999,95,161,2518,18,5791,6.402.559.524
19/12/2020 02:00,15.47,42213,2971,109,150,2491,17,5738,6.402.559.524
19/12/2020 03:00,15.31,41995,2935,119,144,2600,19,5817,6.402.559.524
19/12/2020 04:00,15.3,42062,2832,124,143,2628,17,5744,6.402.559.524
19/12/2020 05:00,15.52,42615,2766,124,145,2671,19,5725,6.402.559.524
19/12/2020 06:00,15.87,43752,2728,126,141,2797,17,5809,6.402.559.524
19/12/2020 07:00,15.92,45345,2650,124,136,2831,23,5764,6.402.559.524
19/12/2020 08:00,16.48,47108,2686,112,133,2995,20,5946,6.402.559.524
19/12/2020 09:00,17.01,48554,2528,97,131,3121,20,5897,6.402.559.524
19/12/2020 10:00,17.36,49465,2477,88,130,3114,21,5830,6.402.559.524
19/12/2020 11:00,17.47,49638,2551,86,121,2976,22,5756,6.402.559.524
19/12/2020 12:00,17.27,49496,2510,87,112,3063,22,5794,6.402.559.524
19/12/2020 13:00,17.29,49414,2686,90,100,3045,20,5941,6.402.559.524
19/12/2020 14:00,17.33,49745,2768,91,92,3110,18,6079,6.402.559.524
19/12/2020 15:00,17.54,50732,2825,96,99,3193,18,6231,6.402.559.524
19/12/2020 16:00,17.96,51729,3027,100,108,3295,17,6547,6.402.559.524
19/12/2020 17:00,18.39,52243,3006,100,120,3479,16,6721,6.402.559.524
19/12/2020 18:00,17.77,51623,3127,100,130,3469,16,6842,6.402.559.524
19/12/2020 19:00,17.03,50147,3149,98,134,3538,16,6935,6.402.559.524
19/12/2020 20:00,15.92,48436,3058,93,131,3520,17,6819,6.402.559.524
19/12/2020 21:00,15.69,47360,2979,86,129,3553,17,6764,6.402.559.524
19/12/2020 22:00,15.22,45946,2905,79,131,3528,16,6659,6.402.559.524
19/12/2020 23:00,13.65,44308,2849,69,134,3651,18,6721,6.402.559.524
20/12/2020 00:00,13,42516,2829,55,143,3583,20,6630,6.402.559.524
20/12/2020 01:00,12.04,41520,2826,45,142,3841,17,6871,6.402.559.524
20/12/2020 02:00,11.79,40957,2819,38,142,3886,19,6904,6.402.559.524
20/12/2020 03:00,11.65,40692,2722,32,139,3871,19,6783,6.402.559.524
20/12/2020 04:00,11.79,40817,2567,28,137,3848,19,6599,6.402.559.524
20/12/2020 05:00,11.98,41249,2558,28,135,3926,17,6664,6.402.559.524
20/12/2020 06:00,12.53,42081,2513,27,134,4044,17,6735,6.402.559.524
20/12/2020 07:00,12.7,43348,2466,28,136,4173,17,6820,6.402.559.524
20/12/2020 08:00,13.25,44846,2567,32,144,4220,19,6982,6.402.559.524
20/12/2020 09:00,14.28,46305,2449,38,152,4236,20,6895,6.402.559.524
20/12/2020 10:00,15.37,47573,2324,37,155,4346,20,6882,6.402.559.524
20/12/2020 11:00,15.94,48196,2290,36,152,4608,19,7105,6.402.559.524
20/12/2020 12:00,15.83,48299,2199,37,147,4774,18,7175,6.402.559.524
20/12/2020 13:00,15.37,48426,2193,38,143,4666,18,7058,6.402.559.524
20/12/2020 14:00,15.98,48916,2139,42,139,4700,16,7036,6.402.559.524
20/12/2020 15:00,16.84,49754,2051,47,154,4824,15,7091,6.402.559.524
20/12/2020 16:00,17.09,50647,2177,54,171,4957,16,7375,6.402.559.524
20/12/2020 17:00,17.29,50995,2235,60,181,4924,18,7418,6.402.559.524
20/12/2020 18:00,17.06,50525,2372,66,185,4962,18,7603,6.402.559.524
20/12/2020 19:00,16.3,49488,2458,75,186,5066,18,7803,6.402.559.524
20/12/2020 20:00,15.32,48216,2523,80,189,4948,19,7759,6.402.559.524
20/12/2020 21:00,15.23,47198,2506,85,193,4745,22,7551,6.402.559.524
20/12/2020 22:00,14.65,45604,2521,89,196,4520,21,7347,6.402.559.524
20/12/2020 23:00,13.02,43832,2590,89,195,4349,22,7245,6.402.559.524
21/12/2020 00:00,11.9,42240,1963,104,221,4247,28,6563,627.25
21/12/2020 01:00,11.2,41400,2013,104,233,4186,23,6559,627.25
21/12/2020 02:00,11.5,40992,2111,102,242,4099,26,6580,627.25
21/12/2020 03:00,11.73,41051,2073,100,256,3879,23,6331,627.25
21/12/2020 04:00,12.81,41965,1963,97,260,3867,26,6213,627.25
21/12/2020 05:00,14.37,44324,2006,94,253,3700,27,6080,627.25
21/12/2020 06:00,16.67,48455,2023,93,248,3577,28,5969,627.25
21/12/2020 07:00,19.74,52160,2046,95,248,3704,33,6126,627.25
21/12/2020 08:00,20.6,53491,2087,103,254,3601,32,6077,627.25
21/12/2020 09:00,19.92,53461,2008,109,258,3715,30,6120,627.25
21/12/2020 10:00,19.32,53621,1896,112,251,3672,30,5961,627.25
21/12/2020 11:00,19.39,53616,1864,108,242,3599,30,5843,627.25
21/12/2020 12:00,19.44,53606,1949,105,229,3515,25,5823,627.25
21/12/2020 13:00,19.2,53678,1965,104,214,3360,21,5664,627.25
21/12/2020 14:00,19.45,53989,1873,103,199,3216,20,5411,627.25
21/12/2020 15:00,20.65,54702,1966,106,193,3163,20,5448,627.25
21/12/2020 16:00,20.55,55194,2219,109,188,3133,21,5670,627.25
21/12/2020 17:00,20.35,55290,2505,111,180,3184,20,6000,627.25
21/12/2020 18:00,19.49,54521,2888,110,176,3338,19,6531,627.25
21/12/2020 19:00,18.03,53304,3213,109,170,3376,12,6880,627.25
21/12/2020 20:00,16.17,51608,3459,108,159,3235,14,6975,627.25
21/12/2020 21:00,14.47,50051,3677,107,146,3512,14,7456,627.25
21/12/2020 22:00,13.18,48023,3982,110,142,3448,14,7696,627.25
21/12/2020 23:00,8.66,45784,4113,111,138,3541,14,7917,627.25
22/12/2020 00:00,7.15,43437,3898,119,130,3208,16,7371,627.25
22/12/2020 01:00,5.51,42495,4014,120,131,3127,14,7406,627.25
22/12/2020 02:00,4.77,42201,3413,122,137,3184,16,6872,627.25
22/12/2020 03:00,4.44,42423,3150,123,140,3200,16,6629,627.25
22/12/2020 04:00,4.84,43363,3257,126,149,3366,17,6915,627.25
22/12/2020 05:00,7.73,45469,2991,132,171,3273,16,6583,627.25
22/12/2020 06:00,12.82,49438,2792,136,205,3472,16,6621,627.25
22/12/2020 07:00,15.97,53305,2763,138,239,3662,16,6818,627.25
22/12/2020 08:00,17.87,54779,2898,142,273,3662,17,6992,627.25
22/12/2020 09:00,18,54715,2971,147,311,3629,19,7077,627.25
22/12/2020 10:00,18.09,54893,3144,156,347,3476,24,7147,627.25
22/12/2020 11:00,18.01,54826,3363,163,373,3052,31,6982,627.25
22/12/2020 12:00,18.01,54519,3344,170,387,2835,31,6767,627.25
22/12/2020 13:00,17.57,54569,3473,176,401,2696,32,6778,627.25
22/12/2020 14:00,18.08,54674,3336,183,396,2672,37,6624,627.25
22/12/2020 15:00,18.62,55493,3074,190,388,2843,37,6532,627.25
22/12/2020 16:00,19.67,56180,2991,191,372,2903,41,6498,627.25
22/12/2020 17:00,19.87,56177,2760,190,346,3024,35,6355,627.25
22/12/2020 18:00,19.79,55417,2664,187,313,3285,34,6483,627.25
22/12/2020 19:00,18.01,54137,2531,184,282,3451,29,6477,627.25
22/12/2020 20:00,16.88,52294,2325,178,249,3546,8,6306,627.25
22/12/2020 21:00,16.05,50871,2201,170,221,3521,7,6120,627.25
22/12/2020 22:00,15.05,48736,2159,160,201,3576,6,6102,627.25
22/12/2020 23:00,13.71,46373,2084,147,195,3671,5,6102,627.25
23/12/2020 00:00,13.38,43198,2190,140,116,3684,12,6142,627.25
23/12/2020 01:00,13.1,42296,2082,128,127,3829,9,6175,627.25
23/12/2020 02:00,12.9,41965,1948,122,176,3901,8,6155,627.25
23/12/2020 03:00,12.93,42024,1786,119,268,3734,8,5915,627.25
23/12/2020 04:00,13.14,42819,1512,113,333,3777,8,5743,627.25
23/12/2020 05:00,14.72,44974,1300,109,335,3700,17,5461,627.25
23/12/2020 06:00,15.99,48654,1176,107,324,3630,23,5260,627.25
23/12/2020 07:00,18.59,52255,1089,101,299,3478,37,5004,627.25
23/12/2020 08:00,19.21,53527,1015,97,273,3363,32,4780,627.25
23/12/2020 09:00,19.51,53793,918,98,252,3152,27,4447,627.25
23/12/2020 10:00,18.97,53953,844,103,242,2956,31,4176,627.25
23/12/2020 11:00,19.33,53752,753,110,253,2812,32,3960,627.25
23/12/2020 12:00,19.55,53377,683,113,259,2690,35,3780,627.25
23/12/2020 13:00,19.4,53306,608,120,254,2698,31,3711,627.25
23/12/2020 14:00,19.66,53548,495,127,228,2673,30,3553,627.25
23/12/2020 15:00,19.96,54413,423,137,216,2744,25,3545,627.25
23/12/2020 16:00,20.56,55186,410,148,210,2851,25,3644,627.25
23/12/2020 17:00,21.79,55144,386,160,205,2828,22,3601,627.25
23/12/2020 18:00,20.77,54357,385,168,201,2857,25,3636,627.25
23/12/2020 19:00,18.95,53055,412,174,190,2812,24,3612,627.25
23/12/2020 20:00,17.82,51210,431,179,178,2764,23,3575,627.25
23/12/2020 21:00,16.94,50048,499,179,168,2647,22,3515,627.25
23/12/2020 22:00,16.16,48444,570,173,152,2534,19,3448,627.25
23/12/2020 23:00,15.07,45604,655,163,138,2521,15,3492,627.25
24/12/2020 00:00,13.44,42892,1063,130,123,2616,14,3946,627.25
24/12/2020 01:00,12.19,41893,1161,123,114,2694,12,4104,627.25
24/12/2020 02:00,10.57,41402,1157,115,110,2722,14,4118,627.25
24/12/2020 03:00,9.44,41344,1122,104,103,2630,12,3971,627.25
24/12/2020 04:00,9.1,41567,1178,93,109,2805,11,4196,627.25
24/12/2020 05:00,10.74,42451,1344,86,122,2781,13,4346,627.25
24/12/2020 06:00,11.36,44037,1560,81,140,2872,12,4665,627.25
24/12/2020 07:00,13.31,46164,1833,74,158,2764,13,4842,627.25
24/12/2020 08:00,16.01,48390,2203,68,173,2956,11,5411,627.25
24/12/2020 09:00,17.78,50269,2436,63,178,3158,9,5844,627.25
24/12/2020 10:00,18.14,51341,2600,54,165,3208,9,6036,627.25
24/12/2020 11:00,18,51603,2768,51,140,3369,9,6337,627.25
24/12/2020 12:00,18.07,51170,2848,56,121,3497,13,6535,627.25
24/12/2020 13:00,17.48,50709,3040,66,111,3562,12,6791,627.25
24/12/2020 14:00,17.35,50860,3071,76,101,3773,14,7035,627.25
24/12/2020 15:00,17.64,51513,3072,86,106,3929,13,7206,627.25
24/12/2020 16:00,18.2,52157,3200,90,108,4145,14,7557,627.25
24/12/2020 17:00,17.55,51189,3090,95,117,4238,16,7556,627.25
24/12/2020 18:00,15.9,49468,3074,95,133,4506,17,7825,627.25
24/12/2020 19:00,14.35,48256,2939,96,147,4464,17,7663,627.25
24/12/2020 20:00,14.49,47470,2675,96,148,4566,16,7501,627.25
24/12/2020 21:00,14.47,47324,2432,92,159,4609,14,7306,627.25
24/12/2020 22:00,14.52,46835,2299,87,168,4620,13,7187,627.25
24/12/2020 23:00,13.94,45933,2190,86,169,4713,13,7171,627.25
25/12/2020 00:00,14.95,42182,1769,84,211,4561,14,6639,627.25
25/12/2020 01:00,14.96,41180,1660,78,210,4658,12,6618,627.25
25/12/2020 02:00,13.97,40663,1597,77,210,4632,15,6531,627.25
25/12/2020 03:00,12.57,40589,1511,73,204,4411,17,6216,627.25
25/12/2020 04:00,12.9,40778,1403,64,197,4352,19,6035,627.25
25/12/2020 05:00,13.5,41364,1371,55,185,4317,21,5949,627.25
25/12/2020 06:00,13.12,42203,1299,49,174,4520,25,6067,627.25
25/12/2020 07:00,14.75,43347,1269,46,162,4187,24,5688,627.25
25/12/2020 08:00,16.82,44521,1265,41,144,4018,19,5487,627.25
25/12/2020 09:00,18.05,45653,1173,32,129,3839,18,5191,627.25
25/12/2020 10:00,18.47,46844,1117,24,119,3653,11,4924,627.25
25/12/2020 11:00,19.4,47351,1006,18,111,3466,16,4617,627.25
25/12/2020 12:00,19.92,47321,925,14,105,3256,15,4315,627.25
25/12/2020 13:00,20.1,47458,941,11,108,3015,16,4091,627.25
25/12/2020 14:00,20.99,47866,984,8,119,2846,16,3973,627.25
25/12/2020 15:00,22.32,48788,1026,9,129,2596,14,3774,627.25
25/12/2020 16:00,22.57,49639,1107,10,132,2397,16,3662,627.25
25/12/2020 17:00,22.7,49895,1139,11,133,2116,15,3414,627.25
25/12/2020 18:00,22.56,49414,1185,14,144,1893,15,3251,627.25
25/12/2020 19:00,22.05,48675,1175,18,153,1618,13,2977,627.25
25/12/2020 20:00,20.77,47763,1043,21,156,1399,7,2626,627.25
25/12/2020 21:00,20.29,47243,935,26,162,1167,8,2298,627.25
25/12/2020 22:00,19.34,46162,820,33,156,928,7,1944,627.25
25/12/2020 23:00,17.63,44546,727,42,140,795,7,1711,627.25
26/12/2020 00:00,19.69,43384,769,34,136,713,4,1656,627.25
26/12/2020 01:00,18.46,42506,866,38,128,709,3,1744,627.25
26/12/2020 02:00,17.97,42071,965,41,112,708,3,1829,627.25
26/12/2020 03:00,16.94,42069,1065,42,95,726,3,1931,627.25
26/12/2020 04:00,15.57,42331,1153,42,83,849,3,2130,627.25
26/12/2020 05:00,15.8,43056,1270,42,76,1005,2,2395,627.25
26/12/2020 06:00,16.02,44117,1442,45,71,1178,2,2738,627.25
26/12/2020 07:00,19.22,45511,1667,50,76,1286,2,3081,627.25
26/12/2020 08:00,19.52,47179,1932,56,84,1454,2,3528,627.25
26/12/2020 09:00,20.06,48604,2183,60,94,1465,2,3804,627.25
26/12/2020 10:00,20.81,49675,2432,63,93,1605,3,4196,627.25
26/12/2020 11:00,20.89,50030,2705,70,87,1684,3,4549,627.25
26/12/2020 12:00,20.71,49890,2937,77,90,1840,4,4948,627.25
26/12/2020 13:00,19.17,49566,3184,82,92,2186,5,5549,627.25
26/12/2020 14:00,17.72,49687,3183,88,93,2562,5,5931,627.25
26/12/2020 15:00,17.99,50504,3203,93,100,2878,6,6280,627.25
26/12/2020 16:00,18.94,51226,3411,99,106,3110,6,6732,627.25
26/12/2020 17:00,18.08,51464,3420,107,100,3386,4,7017,627.25
26/12/2020 18:00,16.72,50931,3572,113,94,3843,4,7626,627.25
26/12/2020 19:00,14.38,49678,3710,117,99,4062,4,7992,627.25
26/12/2020 20:00,11.98,48105,3878,118,114,4444,4,8558,627.25
26/12/2020 21:00,11.26,47252,4039,116,144,4532,5,8836,627.25
26/12/2020 22:00,9.43,46053,4264,116,182,4911,6,9479,627.25
26/12/2020 23:00,5.87,44929,4355,114,206,4951,11,9637,627.25
27/12/2020 00:00,4.71,44700,3904,113,229,5452,28,9726,627.25
27/12/2020 01:00,2.37,43839,3765,110,241,5909,35,10060,627.25
27/12/2020 02:00,1.49,43328,3798,107,243,6173,34,10355,627.25
27/12/2020 03:00,0.96,43179,3693,103,249,6444,34,10523,627.25
27/12/2020 04:00,0.95,43344,4376,94,256,6538,34,11298,627.25
27/12/2020 05:00,1.26,43883,4380,82,269,6708,41,11480,627.25
27/12/2020 06:00,1.02,44758,4367,73,290,6832,45,11607,627.25
27/12/2020 07:00,1.57,46079,4419,64,310,6883,45,11721,627.25
27/12/2020 08:00,2.64,47627,4475,53,329,6740,46,11643,627.25
27/12/2020 09:00,3.99,49104,4296,44,346,6824,50,11560,627.25
27/12/2020 10:00,5.74,50397,4291,35,362,6821,52,11561,627.25
27/12/2020 11:00,7.15,51117,4413,28,367,6999,50,11857,627.25
27/12/2020 12:00,5.95,51306,4339,24,368,7036,50,11817,627.25
27/12/2020 13:00,5.65,51563,4499,20,370,7148,50,12087,627.25
27/12/2020 14:00,6.08,52086,4595,16,370,7279,49,12309,627.25
27/12/2020 15:00,7.91,53121,4605,12,378,7346,50,12391,627.25
27/12/2020 16:00,8.92,54060,4904,9,390,7570,53,12926,627.25
27/12/2020 17:00,9.62,54453,4748,6,401,7577,54,12786,627.25
27/12/2020 18:00,10.33,53854,4650,4,412,7711,54,12831,627.25
27/12/2020 19:00,9.45,52919,4427,4,417,7688,53,12589,627.25
27/12/2020 20:00,8.83,51548,4126,7,419,7674,53,12279,627.25
27/12/2020 21:00,9.49,50415,3794,10,420,7596,53,11873,627.25
27/12/2020 22:00,10.31,48553,3583,16,421,7516,53,11589,627.25
27/12/2020 23:00,7.87,46532,3298,23,423,7497,50,11291,627.25
28/12/2020 00:00,6.23,45081,2899,40,470,7400,52,10861,6.052.440.476
28/12/2020 01:00,4.94,44255,2840,52,469,7440,52,10853,6.052.440.476
28/12/2020 02:00,6.73,43773,2810,71,466,7187,52,10586,6.052.440.476
28/12/2020 03:00,8.63,43747,2743,91,464,7069,51,10418,6.052.440.476
28/12/2020 04:00,10.51,44242,2731,111,464,6879,52,10237,6.052.440.476
28/12/2020 05:00,13.7,46060,2854,133,465,6786,52,10290,6.052.440.476
28/12/2020 06:00,15.18,49264,2927,156,466,6663,54,10266,6.052.440.476
28/12/2020 07:00,17.48,52540,2917,176,466,6550,53,10162,6.052.440.476
28/12/2020 08:00,18.83,54293,2771,188,468,6169,54,9650,6.052.440.476
28/12/2020 09:00,19.44,54563,2688,195,470,6064,54,9471,6.052.440.476
28/12/2020 10:00,19.51,54923,2579,200,471,5859,55,9164,6.052.440.476
28/12/2020 11:00,19.81,55171,2473,204,473,5724,55,8929,6.052.440.476
28/12/2020 12:00,20,55146,2183,208,472,5499,52,8414,6.052.440.476
28/12/2020 13:00,19.91,55171,1965,210,469,5261,52,7957,6.052.440.476
28/12/2020 14:00,20.01,55520,1593,210,462,5160,49,7474,6.052.440.476
28/12/2020 15:00,20.1,56474,1408,209,461,5006,48,7132,6.052.440.476
28/12/2020 16:00,20.54,57152,1335,212,458,4822,52,6879,6.052.440.476
28/12/2020 17:00,20.63,57112,1146,216,456,4722,51,6591,6.052.440.476
28/12/2020 18:00,20.2,56385,999,219,453,4533,49,6253,6.052.440.476
28/12/2020 19:00,19.92,55002,874,221,450,4336,51,5932,6.052.440.476
28/12/2020 20:00,18.87,53236,761,222,450,4094,48,5575,6.052.440.476
28/12/2020 21:00,18.87,51773,681,222,446,3886,48,5283,6.052.440.476
28/12/2020 22:00,17.4,49801,619,222,444,3751,48,5084,6.052.440.476
28/12/2020 23:00,16.59,47265,545,223,445,3673,45,4931,6.052.440.476
29/12/2020 00:00,18.02,44470,495,235,451,3493,42,4716,6.052.440.476
29/12/2020 01:00,17.97,43487,498,231,450,3367,39,4585,6.052.440.476
29/12/2020 02:00,17.67,43042,496,226,449,3371,39,4581,6.052.440.476
29/12/2020 03:00,17.65,42956,473,218,451,3403,42,4587,6.052.440.476
29/12/2020 04:00,18,43435,533,216,453,3255,43,4500,6.052.440.476
29/12/2020 05:00,18.39,44980,621,215,456,3135,49,4476,6.052.440.476
29/12/2020 06:00,19.96,47829,686,216,458,3184,49,4593,6.052.440.476
29/12/2020 07:00,20.93,51019,729,216,460,3228,49,4682,6.052.440.476
29/12/2020 08:00,22.86,52673,736,214,461,3119,47,4577,6.052.440.476
29/12/2020 09:00,23.09,53242,760,212,459,2961,47,4439,6.052.440.476
29/12/2020 10:00,22.8,53731,844,209,454,3007,43,4557,6.052.440.476
29/12/2020 11:00,23.07,53855,858,208,444,2917,44,4471,6.052.440.476
29/12/2020 12:00,23.1,53692,800,208,430,2739,43,4220,6.052.440.476
29/12/2020 13:00,23.07,53796,791,207,420,2745,41,4204,6.052.440.476
29/12/2020 14:00,23.12,54084,754,207,405,2786,39,4191,6.052.440.476
29/12/2020 15:00,23.63,55037,741,208,395,2821,38,4203,6.052.440.476
29/12/2020 16:00,23.82,55670,836,208,392,2739,35,4210,6.052.440.476
29/12/2020 17:00,23.77,55751,792,210,378,2613,33,4026,6.052.440.476
29/12/2020 18:00,23.31,55089,834,211,369,2706,39,4159,6.052.440.476
29/12/2020 19:00,22.61,53915,891,212,360,2671,35,4169,6.052.440.476
29/12/2020 20:00,20.76,52163,885,211,348,2672,27,4143,6.052.440.476
29/12/2020 21:00,20.49,50969,917,209,340,2588,36,4090,6.052.440.476
29/12/2020 22:00,19.01,49228,989,206,336,2506,31,4068,6.052.440.476
29/12/2020 23:00,17.89,46852,1059,203,321,2437,27,4047,6.052.440.476
30/12/2020 00:00,20.05,44157,619,207,0,2265,56,3147,6.052.440.476
30/12/2020 01:00,19.25,43375,706,204,0,2300,52,3262,6.052.440.476
30/12/2020 02:00,18.74,42989,765,202,0,2261,49,3277,6.052.440.476
30/12/2020 03:00,18.68,42929,819,197,0,2253,49,3318,6.052.440.476
30/12/2020 04:00,19.39,43516,854,191,0,2257,46,3348,6.052.440.476
30/12/2020 05:00,21.11,45340,876,184,0,2079,47,3186,6.052.440.476
30/12/2020 06:00,22.18,48166,892,176,0,1962,44,3074,6.052.440.476
30/12/2020 07:00,23.6,51086,921,170,0,2009,38,3138,6.052.440.476
30/12/2020 08:00,24.36,52610,970,171,0,1895,34,3070,6.052.440.476
30/12/2020 09:00,24.92,53372,1015,171,0,1925,33,3144,6.052.440.476
30/12/2020 10:00,24.37,54069,1119,171,0,1861,27,3178,6.052.440.476
30/12/2020 11:00,25.02,54336,1086,169,0,1803,33,3091,6.052.440.476
30/12/2020 12:00,26.61,54266,1015,167,0,1762,30,2974,6.052.440.476
30/12/2020 13:00,26.33,54300,1011,170,0,1718,19,2918,6.052.440.476
30/12/2020 14:00,26.91,54579,980,173,0,1595,12,2760,6.052.440.476
30/12/2020 15:00,28.11,55393,1030,172,0,1519,12,2733,6.052.440.476
30/12/2020 16:00,29.46,56039,1136,170,0,1549,16,2871,6.052.440.476
30/12/2020 17:00,30.05,56057,1183,168,0,1548,15,2914,6.052.440.476
30/12/2020 18:00,28.26,55330,1147,168,0,1576,15,2906,6.052.440.476
30/12/2020 19:00,25.46,54198,1062,168,0,1541,15,2786,6.052.440.476
30/12/2020 20:00,24.05,52512,1061,167,0,1538,12,2778,6.052.440.476
30/12/2020 21:00,23.65,51356,1091,164,0,1539,9,2803,6.052.440.476
30/12/2020 22:00,22.69,49725,1063,158,0,1496,5,2722,6.052.440.476
30/12/2020 23:00,20.51,47395,1072,157,0,1464,4,2697,6.052.440.476
31/12/2020 00:00,21.82,44494,1086,133,14,1510,5,2748,6.052.440.476
31/12/2020 01:00,21.13,43476,1087,140,15,1506,5,2753,6.052.440.476
31/12/2020 02:00,20.84,42884,1065,152,18,1535,5,2775,6.052.440.476
31/12/2020 03:00,20.73,42701,999,172,21,1525,5,2722,6.052.440.476
31/12/2020 04:00,21.8,43218,973,192,25,1495,4,2689,6.052.440.476
31/12/2020 05:00,23.37,44376,968,214,30,1488,4,2704,6.052.440.476
31/12/2020 06:00,23.85,45560,924,229,34,1433,5,2625,6.052.440.476
31/12/2020 07:00,24.11,47451,882,233,39,1319,5,2478,6.052.440.476
31/12/2020 08:00,24.98,48825,851,230,41,1251,5,2378,6.052.440.476
31/12/2020 09:00,25.32,50171,840,226,43,1232,5,2346,6.052.440.476
31/12/2020 10:00,25.22,51565,805,220,42,1201,5,2273,6.052.440.476
31/12/2020 11:00,25.67,52340,789,215,39,1136,5,2184,6.052.440.476
31/12/2020 12:00,26.56,52237,721,209,39,1133,5,2107,6.052.440.476
31/12/2020 13:00,27.11,52063,663,201,39,1051,6,1960,6.052.440.476
31/12/2020 14:00,28.27,52547,594,189,49,986,7,1825,6.052.440.476
31/12/2020 15:00,33.01,53629,545,180,55,938,10,1728,6.052.440.476
31/12/2020 16:00,45.26,54569,550,171,59,994,12,1786,6.052.440.476
31/12/2020 17:00,45.12,54497,544,156,60,1082,11,1853,6.052.440.476
31/12/2020 18:00,37.21,53182,556,139,60,1104,11,1870,6.052.440.476
31/12/2020 19:00,27.28,51165,461,119,59,1044,11,1694,6.052.440.476
31/12/2020 20:00,25.39,49378,419,101,58,1048,11,1637,6.052.440.476
31/12/2020 21:00,25.08,48595,441,84,53,1089,11,1678,6.052.440.476
31/12/2020 22:00,24.82,47646,422,67,49,1092,11,1641,6.052.440.476
31/12/2020 23:00,24.04,46393,343,53,39,1005,11,1451,6.052.440.476
01/01/2021 00:00,24.74,43772,604,47,15,1033,14,1713,6.052.440.476
01/01/2021 01:00,24.28,43000,456,41,12,980,13,1502,6.052.440.476
01/01/2021 02:00,23.9,42363,363,36,11,915,11,1336,6.052.440.476
01/01/2021 03:00,23.61,41991,292,31,10,911,12,1256,6.052.440.476
01/01/2021 04:00,23.66,41971,259,26,10,951,12,1258,6.052.440.476
01/01/2021 05:00,24.06,42392,218,21,10,990,10,1249,6.052.440.476
01/01/2021 06:00,24.43,43066,195,17,9,1014,11,1246,6.052.440.476
01/01/2021 07:00,24.9,43972,213,12,10,943,11,1189,6.052.440.476
01/01/2021 08:00,24.91,44890,271,8,11,934,10,1234,6.052.440.476
01/01/2021 09:00,25.25,45917,261,6,13,913,11,1204,6.052.440.476
01/01/2021 10:00,25.92,47175,283,4,13,861,9,1170,6.052.440.476
01/01/2021 11:00,26.4,47917,261,3,13,734,7,1018,6.052.440.476
01/01/2021 12:00,27,48048,216,3,13,599,6,837,6.052.440.476
01/01/2021 13:00,27.3,48232,184,3,12,551,5,755,6.052.440.476
01/01/2021 14:00,28.06,48948,174,3,12,529,4,722,6.052.440.476
01/01/2021 15:00,29.44,50064,207,5,13,535,4,764,6.052.440.476
01/01/2021 16:00,34.34,51333,242,7,13,570,4,836,6.052.440.476
01/01/2021 17:00,39.82,51829,250,10,13,599,4,876,6.052.440.476
01/01/2021 18:00,34.58,51268,254,13,14,560,4,845,6.052.440.476
01/01/2021 19:00,30.54,50397,323,16,16,517,4,876,6.052.440.476
01/01/2021 20:00,28.7,49116,333,19,19,497,4,872,6.052.440.476
01/01/2021 21:00,28.29,48386,366,21,21,469,4,881,6.052.440.476
01/01/2021 22:00,27.02,47100,386,22,21,443,4,876,6.052.440.476
01/01/2021 23:00,25.71,45723,369,24,23,422,4,842,6.052.440.476
02/01/2021 00:00,25.53,45687,60,113,11,409,4,597,6.052.440.476
02/01/2021 01:00,24.84,44828,71,110,13,418,4,616,6.052.440.476
02/01/2021 02:00,24.67,44387,76,107,15,394,4,596,6.052.440.476
02/01/2021 03:00,24.62,44315,72,103,17,367,4,563,6.052.440.476
02/01/2021 04:00,24.69,44490,80,94,18,354,5,551,6.052.440.476
02/01/2021 05:00,24.92,45047,85,82,18,362,5,552,6.052.440.476
02/01/2021 06:00,25.7,45961,104,73,19,343,5,544,6.052.440.476
02/01/2021 07:00,26.47,47297,114,64,21,317,5,521,6.052.440.476
02/01/2021 08:00,27.46,49009,118,53,23,304,5,503,6.052.440.476
02/01/2021 09:00,28.05,50425,112,44,25,311,5,497,6.052.440.476
02/01/2021 10:00,28.86,51599,108,35,28,284,5,460,6.052.440.476
02/01/2021 11:00,29.03,52240,102,28,30,293,5,458,6.052.440.476
02/01/2021 12:00,28.91,52253,98,24,31,349,5,507,6.052.440.476
02/01/2021 13:00,28.85,52219,94,20,31,413,5,563,6.052.440.476
02/01/2021 14:00,29.29,52502,116,16,32,458,5,627,6.052.440.476
02/01/2021 15:00,30.52,53332,163,12,34,535,5,749,6.052.440.476
02/01/2021 16:00,43.97,54479,210,9,33,600,6,858,6.052.440.476
02/01/2021 17:00,48.56,55169,253,6,33,677,5,974,6.052.440.476
02/01/2021 18:00,47.84,54633,294,4,34,684,5,1021,6.052.440.476
02/01/2021 19:00,36.45,53209,347,4,32,776,6,1165,6.052.440.476
02/01/2021 20:00,28.65,51522,373,7,28,817,6,1231,6.052.440.476
02/01/2021 21:00,28.34,50483,365,10,23,866,6,1270,6.052.440.476
02/01/2021 22:00,27.5,49017,397,16,20,875,6,1314,6.052.440.476
02/01/2021 23:00,25.96,47371,411,23,19,875,5,1333,6.052.440.476
03/01/2021 00:00,25.51,46728,663,40,17,1066,3,1789,6.052.440.476
03/01/2021 01:00,24.74,45703,739,52,14,1223,2,2030,6.052.440.476
03/01/2021 02:00,24.02,45165,873,71,12,1362,2,2320,6.052.440.476
03/01/2021 03:00,23.77,45055,969,91,12,1482,1,2555,6.052.440.476
03/01/2021 04:00,23.51,45292,1094,111,12,1712,1,2930,6.052.440.476
03/01/2021 05:00,23.81,45885,1284,133,12,1743,1,3173,6.052.440.476
03/01/2021 06:00,23.99,46801,1449,156,13,1815,1,3434,6.052.440.476
03/01/2021 07:00,24.76,48253,1566,176,15,1730,1,3488,6.052.440.476
03/01/2021 08:00,24.96,49704,1707,188,17,1787,1,3700,6.052.440.476
03/01/2021 09:00,25.61,51134,1879,195,18,1964,2,4058,6.052.440.476
03/01/2021 10:00,25.97,52236,2053,200,19,2015,1,4288,6.052.440.476
03/01/2021 11:00,26.03,52934,2204,204,21,1986,1,4416,6.052.440.476
03/01/2021 12:00,25.85,53129,2260,208,25,2074,2,4569,6.052.440.476
03/01/2021 13:00,25.82,53309,2502,210,32,2227,2,4973,6.052.440.476
03/01/2021 14:00,26,53717,2669,210,43,2348,2,5272,6.052.440.476
03/01/2021 15:00,26.51,54712,2848,209,56,2432,2,5547,6.052.440.476
03/01/2021 16:00,28.13,55947,3087,212,64,2593,2,5958,6.052.440.476
03/01/2021 17:00,28.62,56673,3088,216,69,2772,2,6147,6.052.440.476
03/01/2021 18:00,28.17,56276,3031,219,71,2932,2,6255,6.052.440.476
03/01/2021 19:00,27.69,55279,2973,221,71,2913,2,6180,6.052.440.476
03/01/2021 20:00,27.18,54065,2943,222,72,3144,2,6383,6.052.440.476
03/01/2021 21:00,26.95,53291,2853,222,74,2966,2,6117,6.052.440.476
03/01/2021 22:00,25.99,51842,2764,222,75,2815,3,5879,6.052.440.476
03/01/2021 23:00,24.85,50357,2750,223,76,2769,3,5821,6.052.440.476
04/01/2021 00:00,24.54,49557,2589,28,102,2685,2,5406,5.775.208.333
04/01/2021 01:00,23.72,48683,2543,25,98,2677,3,5346,5.775.208.333
04/01/2021 02:00,23.46,48336,2483,23,95,2616,3,5220,5.775.208.333
04/01/2021 03:00,23.56,48398,2404,22,95,2590,4,5115,5.775.208.333
04/01/2021 04:00,24.25,49095,2372,21,96,2506,3,4998,5.775.208.333
04/01/2021 05:00,25.55,51058,2373,19,96,2472,4,4964,5.775.208.333
04/01/2021 06:00,27.46,54452,2383,18,96,2403,4,4904,5.775.208.333
04/01/2021 07:00,31.22,57745,2417,16,92,2246,4,4775,5.775.208.333
04/01/2021 08:00,45.95,59252,2411,14,85,2156,4,4670,5.775.208.333
04/01/2021 09:00,48.58,59551,2469,12,81,2167,4,4733,5.775.208.333
04/01/2021 10:00,50.76,59902,2521,9,75,2164,3,4772,5.775.208.333
04/01/2021 11:00,50.94,59903,2491,7,69,2139,2,4708,5.775.208.333
04/01/2021 12:00,50.01,59762,2337,5,68,1978,3,4391,5.775.208.333
04/01/2021 13:00,50.08,59681,2301,3,73,1831,4,4212,5.775.208.333
04/01/2021 14:00,50.72,59743,2274,3,79,1906,4,4266,5.775.208.333
04/01/2021 15:00,50.75,60455,2324,4,82,2072,4,4486,5.775.208.333
04/01/2021 16:00,50.94,61213,2466,5,83,1923,5,4482,5.775.208.333
04/01/2021 17:00,57.98,61356,2472,8,84,2079,5,4648,5.775.208.333
04/01/2021 18:00,50.71,60489,2474,12,85,1911,5,4487,5.775.208.333
04/01/2021 19:00,49.22,59199,2439,17,82,1985,6,4529,5.775.208.333
04/01/2021 20:00,34.77,57515,2417,20,79,1722,5,4243,5.775.208.333
04/01/2021 21:00,33.01,56024,2431,24,77,1633,6,4171,5.775.208.333
04/01/2021 22:00,29.77,54051,2414,29,80,1687,6,4216,5.775.208.333
04/01/2021 23:00,26.68,52064,2476,33,83,1634,9,4235,5.775.208.333
05/01/2021 00:00,27.19,50719,2691,10,107,1843,7,4658,5.775.208.333
05/01/2021 01:00,26.9,49542,2759,11,115,1694,7,4586,5.775.208.333
05/01/2021 02:00,26.65,49169,2772,11,122,1741,8,4654,5.775.208.333
05/01/2021 03:00,26.7,49077,2623,11,130,1696,9,4469,5.775.208.333
05/01/2021 04:00,27.23,49691,2610,13,142,1715,9,4489,5.775.208.333
05/01/2021 05:00,28.88,51534,2591,16,157,1745,10,4519,5.775.208.333
05/01/2021 06:00,33.09,54842,2553,19,172,1743,11,4498,5.775.208.333
05/01/2021 07:00,50.04,58433,2528,21,188,1721,12,4470,5.775.208.333
05/01/2021 08:00,55.45,59900,2508,20,206,1649,14,4397,5.775.208.333
05/01/2021 09:00,55.77,60328,2484,19,221,1701,14,4439,5.775.208.333
05/01/2021 10:00,54.92,60739,2510,16,235,1676,14,4451,5.775.208.333
05/01/2021 11:00,55.36,60576,2525,14,246,1583,14,4382,5.775.208.333
05/01/2021 12:00,55.6,60217,2451,14,259,1577,14,4315,5.775.208.333
05/01/2021 13:00,56.18,60064,2469,18,269,1609,15,4380,5.775.208.333
05/01/2021 14:00,55.57,60103,2474,23,277,1654,17,4445,5.775.208.333
05/01/2021 15:00,56.66,60838,2474,27,283,1701,20,4505,5.775.208.333
05/01/2021 16:00,58.02,61340,2619,27,287,1724,21,4678,5.775.208.333
05/01/2021 17:00,58.02,61678,2556,29,292,1811,21,4709,5.775.208.333
05/01/2021 18:00,54.7,60886,2499,32,295,1886,21,4733,5.775.208.333
05/01/2021 19:00,53.45,59516,2525,32,292,1914,22,4785,5.775.208.333
05/01/2021 20:00,36.3,57777,2556,30,283,2048,19,4936,5.775.208.333
05/01/2021 21:00,37.08,56541,2612,27,271,2080,18,5008,5.775.208.333
05/01/2021 22:00,31.54,54676,2595,26,258,2050,13,4942,5.775.208.333
05/01/2021 23:00,28.8,52593,2638,26,243,2121,13,5041,5.775.208.333
06/01/2021 00:00,29.52,51256,2424,19,261,2201,20,4925,5.775.208.333
06/01/2021 01:00,28.46,49980,2525,18,245,2294,19,5101,5.775.208.333
06/01/2021 02:00,27.62,49366,2621,18,231,2346,18,5234,5.775.208.333
06/01/2021 03:00,27.39,49222,2621,19,222,2340,18,5220,5.775.208.333
06/01/2021 04:00,27.64,49530,2681,21,215,2327,18,5262,5.775.208.333
06/01/2021 05:00,28.52,50651,2741,22,212,2390,15,5380,5.775.208.333
06/01/2021 06:00,30.1,52953,2845,23,207,2483,15,5573,5.775.208.333
06/01/2021 07:00,34.03,55740,2954,25,203,2623,15,5820,5.775.208.333
06/01/2021 08:00,38.38,57269,3013,24,198,2741,13,5989,5.775.208.333
06/01/2021 09:00,39.63,58280,3030,23,193,2732,10,5988,5.775.208.333
06/01/2021 10:00,43.06,59141,3097,22,185,2587,10,5901,5.775.208.333
06/01/2021 11:00,43.41,59601,3130,21,175,2502,11,5839,5.775.208.333
06/01/2021 12:00,45.02,59464,3042,23,164,2418,12,5659,5.775.208.333
06/01/2021 13:00,45.07,59276,3079,27,159,2399,11,5675,5.775.208.333
06/01/2021 14:00,48.01,59488,3126,35,155,2451,10,5777,5.775.208.333
06/01/2021 15:00,52.9,60461,3160,44,151,2507,9,5871,5.775.208.333
06/01/2021 16:00,55.76,61513,3255,48,143,2419,10,5875,5.775.208.333
06/01/2021 17:00,55.78,61885,3129,50,131,2458,8,5776,5.775.208.333
06/01/2021 18:00,54.51,60926,2992,50,118,2408,8,5576,5.775.208.333
06/01/2021 19:00,46.16,59580,2904,49,105,2338,9,5405,5.775.208.333
06/01/2021 20:00,39.12,57888,2814,48,93,2262,9,5226,5.775.208.333
06/01/2021 21:00,39.08,56718,2732,48,83,2195,7,5065,5.775.208.333
06/01/2021 22:00,37.61,54740,2568,48,74,2102,7,4799,5.775.208.333
06/01/2021 23:00,31.14,52769,2461,49,65,2072,7,4654,5.775.208.333
07/01/2021 00:00,39.71,51757,1962,48,76,1881,8,3975,5.775.208.333
07/01/2021 01:00,38.47,50572,1934,50,71,1972,8,4035,5.775.208.333
07/01/2021 02:00,37.49,50114,1860,52,66,1941,7,3926,5.775.208.333
07/01/2021 03:00,38.02,50130,1793,53,65,1885,7,3803,5.775.208.333
07/01/2021 04:00,38.82,50844,1788,55,72,1810,6,3731,5.775.208.333
07/01/2021 05:00,44.23,53000,1785,57,82,1635,6,3565,5.775.208.333
07/01/2021 06:00,52.55,56745,1734,55,91,1763,6,3649,5.775.208.333
07/01/2021 07:00,61.03,60507,1697,53,99,1695,6,3550,5.775.208.333
07/01/2021 08:00,76.4,61819,1634,52,103,1485,5,3279,5.775.208.333
07/01/2021 09:00,75.5,61851,1586,52,105,1591,4,3338,5.775.208.333
07/01/2021 10:00,77.71,62004,1528,50,103,1534,4,3219,5.775.208.333
07/01/2021 11:00,80.05,61912,1412,51,98,1433,4,2998,5.775.208.333
07/01/2021 12:00,77.89,61644,1277,50,90,1330,5,2752,5.775.208.333
07/01/2021 13:00,77.22,61598,1223,50,82,1318,5,2678,5.775.208.333
07/01/2021 14:00,77.22,61775,1161,54,76,1298,5,2594,5.775.208.333
07/01/2021 15:00,79.51,62458,1127,62,75,1241,7,2512,5.775.208.333
07/01/2021 16:00,84.9,63035,1173,69,72,1359,7,2680,5.775.208.333
07/01/2021 17:00,91.26,63251,1132,70,64,1372,7,2645,5.775.208.333
07/01/2021 18:00,83.01,62017,1129,70,56,1220,7,2482,5.775.208.333
07/01/2021 19:00,71.67,60512,1123,69,50,1148,7,2397,5.775.208.333
07/01/2021 20:00,61.67,58565,1080,68,43,1119,8,2318,5.775.208.333
07/01/2021 21:00,55.45,57130,1032,67,37,1093,7,2236,5.775.208.333
07/01/2021 22:00,53.61,54845,973,66,33,1012,8,2092,5.775.208.333
07/01/2021 23:00,50.05,52495,930,63,29,998,6,2026,5.775.208.333
08/01/2021 00:00,47.76,51953,758,59,19,1007,5,1848,5.775.208.333
08/01/2021 01:00,43.82,51072,830,59,18,1012,6,1925,5.775.208.333
08/01/2021 02:00,43.23,50689,852,61,16,1056,6,1991,5.775.208.333
08/01/2021 03:00,42.39,50620,860,63,15,1058,5,2001,5.775.208.333
08/01/2021 04:00,43.24,51460,882,63,14,1090,5,2054,5.775.208.333
08/01/2021 05:00,48.21,53525,860,63,13,1103,4,2043,5.775.208.333
08/01/2021 06:00,55.92,57369,900,61,13,1121,3,2098,5.775.208.333
08/01/2021 07:00,69.94,60850,934,60,13,1091,3,2101,5.775.208.333
08/01/2021 08:00,95.45,62010,983,59,14,1050,4,2110,5.775.208.333
08/01/2021 09:00,99.92,62081,979,56,14,1040,4,2093,5.775.208.333
08/01/2021 10:00,101.77,62358,1009,53,13,1001,3,2079,5.775.208.333
08/01/2021 11:00,100,62253,1022,49,12,953,3,2039,5.775.208.333
08/01/2021 12:00,94.09,61783,966,47,11,915,2,1941,5.775.208.333
08/01/2021 13:00,90.15,61316,972,45,11,893,2,1923,5.775.208.333
08/01/2021 14:00,86.89,61159,971,45,12,895,2,1925,5.775.208.333
08/01/2021 15:00,88.5,61479,996,45,14,1002,2,2059,5.775.208.333
08/01/2021 16:00,86.67,62187,1074,45,16,1063,2,2200,5.775.208.333
08/01/2021 17:00,99.98,62367,1041,46,16,988,3,2094,5.775.208.333
08/01/2021 18:00,87.8,61435,962,46,17,995,3,2023,5.775.208.333
08/01/2021 19:00,73.49,59953,962,46,18,998,3,2027,5.775.208.333
08/01/2021 20:00,58.48,57967,906,43,20,1015,3,1987,5.775.208.333
08/01/2021 21:00,56.74,56576,814,40,22,975,3,1854,5.775.208.333
08/01/2021 22:00,54.03,54802,702,38,24,939,3,1706,5.775.208.333
08/01/2021 23:00,48.97,52843,661,37,28,925,3,1654,5.775.208.333
09/01/2021 00:00,46.91,51342,691,43,14,938,2,1688,5.775.208.333
09/01/2021 01:00,46.08,50267,646,48,15,956,3,1668,5.775.208.333
09/01/2021 02:00,45.55,49660,582,53,15,1004,3,1657,5.775.208.333
09/01/2021 03:00,46.82,49433,495,58,16,975,3,1547,5.775.208.333
09/01/2021 04:00,47.13,49698,428,59,17,949,2,1455,5.775.208.333
09/01/2021 05:00,46.71,50296,375,58,20,934,2,1389,5.775.208.333
09/01/2021 06:00,47.11,51333,296,54,23,953,3,1329,5.775.208.333
09/01/2021 07:00,49.65,53042,247,49,25,943,3,1267,5.775.208.333
09/01/2021 08:00,55.18,54816,191,44,25,980,3,1243,5.775.208.333
09/01/2021 09:00,58.46,56210,133,39,23,1062,2,1259,5.775.208.333
09/01/2021 10:00,59.72,57399,107,35,19,1068,2,1231,5.775.208.333
09/01/2021 11:00,59.27,57786,90,33,16,1127,2,1268,5.775.208.333
09/01/2021 12:00,57.9,57502,72,32,13,1178,2,1297,5.775.208.333
09/01/2021 13:00,55.37,57292,57,30,11,1308,1,1407,5.775.208.333
09/01/2021 14:00,55.26,57443,48,28,12,1450,1,1539,5.775.208.333
09/01/2021 15:00,55.31,58343,64,27,12,1626,1,1730,5.775.208.333
09/01/2021 16:00,55.58,59584,97,27,12,1844,1,1981,5.775.208.333
09/01/2021 17:00,57.73,60411,144,28,10,2128,1,2311,5.775.208.333
09/01/2021 18:00,56.65,59823,230,29,8,2475,1,2743,5.775.208.333
09/01/2021 19:00,55.3,58319,365,29,6,2671,1,3072,5.775.208.333
09/01/2021 20:00,49.56,56578,503,30,3,2915,1,3452,5.775.208.333
09/01/2021 21:00,45.95,55462,657,29,2,3089,1,3778,5.775.208.333
09/01/2021 22:00,41.32,53996,906,29,1,3577,1,4514,5.775.208.333
09/01/2021 23:00,36.03,52279,1255,30,1,3877,0,5163,5.775.208.333
10/01/2021 00:00,38.3,50487,1570,35,2,3960,0,5567,5.775.208.333
10/01/2021 01:00,35.62,49513,1929,36,2,3973,0,5940,5.775.208.333
10/01/2021 02:00,33.81,48966,2262,38,1,3875,0,6176,5.775.208.333
10/01/2021 03:00,33.04,48755,2403,39,1,3838,0,6281,5.775.208.333
10/01/2021 04:00,32.96,48826,2519,40,1,3852,0,6412,5.775.208.333
10/01/2021 05:00,33.49,49232,2537,40,1,3800,0,6378,5.775.208.333
10/01/2021 06:00,33.33,49997,2394,38,2,3864,1,6299,5.775.208.333
10/01/2021 07:00,36.32,51251,2222,38,3,3542,1,5806,5.775.208.333
10/01/2021 08:00,37.98,52521,1951,36,4,3366,3,5360,5.775.208.333
10/01/2021 09:00,39.59,53890,1627,35,5,3145,5,4817,5.775.208.333
10/01/2021 10:00,43.01,54971,1595,34,6,3027,7,4669,5.775.208.333
10/01/2021 11:00,44.65,55496,1560,32,10,2918,4,4524,5.775.208.333
10/01/2021 12:00,44.12,55565,1466,29,16,2742,2,4255,5.775.208.333
10/01/2021 13:00,43.67,55628,1416,26,24,2545,3,4014,5.775.208.333
10/01/2021 14:00,44.91,55942,1344,25,35,2345,4,3753,5.775.208.333
10/01/2021 15:00,46.08,56897,1292,23,50,2249,7,3621,5.775.208.333
10/01/2021 16:00,50.96,58241,1367,20,70,2151,9,3617,5.775.208.333
10/01/2021 17:00,56.35,59007,1284,16,91,1999,15,3405,5.775.208.333
10/01/2021 18:00,55.17,58617,1203,14,113,1902,14,3246,5.775.208.333
10/01/2021 19:00,49.36,57540,1231,11,137,1623,14,3016,5.775.208.333
10/01/2021 20:00,46.51,56390,1294,9,162,1573,19,3057,5.775.208.333
10/01/2021 21:00,44.33,55478,1377,7,190,1502,28,3104,5.775.208.333
10/01/2021 22:00,39.95,53923,1541,7,211,1413,26,3198,5.775.208.333
10/01/2021 23:00,35.79,52247,1799,7,217,1424,30,3477,5.775.208.333
11/01/2021 00:00,40.36,51378,1556,26,139,1385,30,3136,549.797.619
11/01/2021 01:00,39.38,50725,1876,25,143,1439,37,3520,549.797.619
11/01/2021 02:00,37.31,50516,2305,26,147,1464,37,3979,549.797.619
11/01/2021 03:00,35.22,50612,2624,26,149,1605,29,4433,549.797.619
11/01/2021 04:00,37.02,51373,2948,26,144,1817,21,4956,549.797.619
11/01/2021 05:00,41.27,53456,3377,25,144,2007,17,5570,549.797.619
11/01/2021 06:00,42.68,57224,3563,25,141,2303,11,6043,549.797.619
11/01/2021 07:00,50.44,60953,3727,23,133,2535,4,6422,549.797.619
11/01/2021 08:00,54.93,62103,3878,22,128,3015,3,7046,549.797.619
11/01/2021 09:00,49.98,62201,3981,22,123,3123,4,7253,549.797.619
11/01/2021 10:00,47.71,62488,4073,22,117,3450,5,7667,549.797.619
11/01/2021 11:00,44.57,62297,4247,22,110,3805,7,8191,549.797.619
11/01/2021 12:00,43.26,61958,4232,22,105,4102,9,8470,549.797.619
11/01/2021 13:00,42.66,61886,4255,24,104,4238,9,8630,549.797.619
11/01/2021 14:00,42.15,61790,4298,27,108,4295,12,8740,549.797.619
11/01/2021 15:00,42.5,62223,4246,31,120,4526,21,8944,549.797.619
11/01/2021 16:00,43.23,62836,4447,33,135,4597,30,9242,549.797.619
11/01/2021 17:00,44.08,63070,4102,33,149,4702,34,9020,549.797.619
11/01/2021 18:00,42.54,62094,3782,32,164,4580,40,8598,549.797.619
11/01/2021 19:00,39.71,60693,3663,32,177,4604,42,8518,549.797.619
11/01/2021 20:00,37.11,59145,3488,31,190,4456,42,8207,549.797.619
11/01/2021 21:00,34.24,57635,3232,31,204,4771,42,8280,549.797.619
11/01/2021 22:00,33.27,55595,2946,31,211,4761,43,7992,549.797.619
11/01/2021 23:00,28.07,53402,2676,30,219,4766,43,7734,549.797.619
12/01/2021 00:00,23.42,51358,3009,176,394,4830,55,8464,549.797.619
12/01/2021 01:00,22.93,50396,2885,175,408,4943,54,8465,549.797.619
12/01/2021 02:00,22.91,50238,2564,167,418,4956,56,8161,549.797.619
12/01/2021 03:00,24.8,50454,2160,157,425,4837,57,7636,549.797.619
12/01/2021 04:00,27.72,51410,1953,146,431,4762,57,7349,549.797.619
12/01/2021 05:00,34.99,53468,1777,132,434,4466,57,6866,549.797.619
12/01/2021 06:00,36.85,57258,1805,115,435,4500,57,6912,549.797.619
12/01/2021 07:00,41.28,60966,1879,97,435,4416,57,6884,549.797.619
12/01/2021 08:00,44.32,62191,1911,76,435,4163,57,6642,549.797.619
12/01/2021 09:00,41.63,62179,2071,63,432,4077,57,6700,549.797.619
12/01/2021 10:00,42.67,62380,2359,57,429,4022,56,6923,549.797.619
12/01/2021 11:00,42.31,62114,2842,55,425,3827,56,7205,549.797.619
12/01/2021 12:00,41.46,61655,3205,55,414,3738,56,7468,549.797.619
12/01/2021 13:00,40.86,61594,3439,56,400,3633,52,7580,549.797.619
12/01/2021 14:00,41.11,61724,3641,61,386,3522,47,7657,549.797.619
12/01/2021 15:00,42.3,62472,3649,70,371,3410,40,7540,549.797.619
12/01/2021 16:00,48.14,63320,3858,87,352,3549,36,7882,549.797.619
12/01/2021 17:00,48.06,63620,3877,107,321,3433,32,7770,549.797.619
12/01/2021 18:00,47.28,62894,3748,128,285,3223,26,7410,549.797.619
12/01/2021 19:00,41.86,61895,3830,148,252,3054,13,7297,549.797.619
12/01/2021 20:00,39.46,60372,3717,168,219,2879,8,6991,549.797.619
12/01/2021 21:00,37.97,59091,3638,184,179,2818,6,6825,549.797.619
12/01/2021 22:00,36.43,57122,3844,197,138,2762,5,6946,549.797.619
12/01/2021 23:00,34.35,54879,3887,208,108,2792,3,6998,549.797.619
13/01/2021 00:00,32.84,52747,3774,194,126,2988,3,7085,549.797.619
13/01/2021 01:00,32.12,51901,3810,203,109,2920,2,7044,549.797.619
13/01/2021 02:00,31.27,51651,3695,212,95,3009,3,7014,549.797.619
13/01/2021 03:00,30.66,51793,3436,218,82,3243,2,6981,549.797.619
13/01/2021 04:00,31.45,52783,3310,225,69,3452,2,7058,549.797.619
13/01/2021 05:00,36.74,55022,3165,229,57,3488,2,6941,549.797.619
13/01/2021 06:00,40.34,58760,3053,230,47,3584,2,6916,549.797.619
13/01/2021 07:00,43.58,62382,3138,231,42,3638,2,7051,549.797.619
13/01/2021 08:00,51.94,63652,3154,231,44,3719,3,7151,549.797.619
13/01/2021 09:00,46.93,63815,3200,234,47,3846,3,7330,549.797.619
13/01/2021 10:00,48.07,63985,3314,234,44,3868,3,7463,549.797.619
13/01/2021 11:00,46.12,63796,3449,231,37,3855,3,7575,549.797.619
13/01/2021 12:00,42.84,63445,3508,227,31,3852,4,7622,549.797.619
13/01/2021 13:00,41.01,63271,3686,222,27,4047,5,7987,549.797.619
13/01/2021 14:00,40.35,63189,3838,215,28,4207,6,8294,549.797.619
13/01/2021 15:00,42.5,63718,3914,210,30,4323,6,8483,549.797.619
13/01/2021 16:00,48.07,64416,4206,210,29,4456,8,8909,549.797.619
13/01/2021 17:00,56.68,64889,4131,205,23,4513,9,8881,549.797.619
13/01/2021 18:00,55,63969,3957,195,20,4511,9,8692,549.797.619
13/01/2021 19:00,49.66,62951,4000,185,21,4425,9,8640,549.797.619
13/01/2021 20:00,47.32,61252,3813,176,22,4221,10,8242,549.797.619
13/01/2021 21:00,41.6,59967,3646,168,26,4188,10,8038,549.797.619
13/01/2021 22:00,40.05,57996,3590,160,30,4107,10,7897,549.797.619
13/01/2021 23:00,37.86,55682,3422,152,38,3815,11,7438,549.797.619
14/01/2021 00:00,37.21,54248,3790,107,99,3652,10,7658,549.797.619
14/01/2021 01:00,36.86,53416,3695,104,118,3507,13,7437,549.797.619
14/01/2021 02:00,36.8,53140,3440,102,128,3339,11,7020,549.797.619
14/01/2021 03:00,39.06,53257,3146,100,130,3225,12,6613,549.797.619
14/01/2021 04:00,41.55,54085,2964,102,128,3070,11,6275,549.797.619
14/01/2021 05:00,48.08,56161,2693,107,120,2913,9,5842,549.797.619
14/01/2021 06:00,65.98,59732,2446,111,110,2740,8,5415,549.797.619
14/01/2021 07:00,80.9,63345,2243,117,102,2537,9,5008,549.797.619
14/01/2021 08:00,85.06,64605,1930,118,99,2261,7,4415,549.797.619
14/01/2021 09:00,77.55,64846,1707,120,100,2062,7,3996,549.797.619
14/01/2021 10:00,77.56,64981,1578,123,104,1863,7,3675,549.797.619
14/01/2021 11:00,80.88,64841,1412,124,105,1654,9,3304,549.797.619
14/01/2021 12:00,79.64,64499,1198,123,110,1499,11,2941,549.797.619
14/01/2021 13:00,80.8,64416,1059,121,117,1438,10,2745,549.797.619
14/01/2021 14:00,78.22,64416,905,118,123,1587,11,2744,549.797.619
14/01/2021 15:00,85.2,65036,805,118,128,1810,10,2871,549.797.619
14/01/2021 16:00,95.63,65906,784,119,134,1831,11,2879,549.797.619
14/01/2021 17:00,100.09,66250,723,113,136,1980,10,2962,549.797.619
14/01/2021 18:00,90.08,65400,639,104,130,1844,12,2729,549.797.619
14/01/2021 19:00,84.35,64137,606,97,119,1947,9,2778,549.797.619
14/01/2021 20:00,74.38,62662,532,91,106,2049,5,2783,549.797.619
14/01/2021 21:00,62.9,61494,473,86,95,2141,5,2800,549.797.619
14/01/2021 22:00,57.37,59582,450,83,86,2339,6,2964,549.797.619
14/01/2021 23:00,52.2,57453,411,76,80,2538,6,3111,549.797.619
15/01/2021 00:00,46.27,57069,610,81,70,2819,9,3589,549.797.619
15/01/2021 01:00,45.97,56194,695,79,77,2958,6,3815,549.797.619
15/01/2021 02:00,45.57,55886,705,78,74,3037,7,3901,549.797.619
15/01/2021 03:00,45.09,55914,730,79,70,3198,6,4083,549.797.619
15/01/2021 04:00,45.65,56659,797,82,76,3167,8,4130,549.797.619
15/01/2021 05:00,50.5,58659,737,89,80,3290,12,4208,549.797.619
15/01/2021 06:00,54.96,62328,704,99,75,3453,12,4343,549.797.619
15/01/2021 07:00,56.72,65864,673,104,64,3385,10,4236,549.797.619
15/01/2021 08:00,61.07,66898,596,103,52,3506,8,4265,549.797.619
15/01/2021 09:00,66.96,66974,540,101,44,3647,8,4340,549.797.619
15/01/2021 10:00,63.21,66999,542,99,39,3611,7,4298,549.797.619
15/01/2021 11:00,56.72,66702,520,98,40,3511,7,4176,549.797.619
15/01/2021 12:00,56.62,66022,508,98,49,3409,6,4070,549.797.619
15/01/2021 13:00,56.62,65297,499,95,56,3483,5,4138,549.797.619
15/01/2021 14:00,56.22,64909,496,93,66,3725,4,4384,549.797.619
15/01/2021 15:00,56.62,65222,513,92,81,3991,5,4682,549.797.619
15/01/2021 16:00,56.64,66104,505,92,100,4173,7,4877,549.797.619
15/01/2021 17:00,56.71,66413,527,89,113,4328,8,5065,549.797.619
15/01/2021 18:00,59.17,65532,534,85,121,4266,8,5014,549.797.619
15/01/2021 19:00,56.62,64112,492,81,122,4211,6,4912,549.797.619
15/01/2021 20:00,54.33,62212,404,79,114,4221,4,4822,549.797.619
15/01/2021 21:00,51.73,60893,309,78,105,4200,6,4698,549.797.619
15/01/2021 22:00,51.06,59105,253,75,91,4173,7,4599,549.797.619
15/01/2021 23:00,45.56,57126,205,72,75,4085,7,4444,549.797.619
16/01/2021 00:00,43.63,56260,204,40,70,4200,4,4518,549.797.619
16/01/2021 01:00,43.66,55116,181,39,59,4148,3,4430,549.797.619
16/01/2021 02:00,43.66,54481,174,38,47,3965,2,4226,549.797.619
16/01/2021 03:00,43.67,54322,180,37,37,3811,2,4067,549.797.619
16/01/2021 04:00,43.73,54466,194,36,31,3737,1,3999,549.797.619
16/01/2021 05:00,43.73,55047,193,35,34,3502,1,3765,549.797.619
16/01/2021 06:00,43.45,56049,198,32,44,3221,1,3496,549.797.619
16/01/2021 07:00,44.06,57698,228,28,47,2930,1,3234,549.797.619
16/01/2021 08:00,48.48,59225,250,24,45,2549,1,2869,549.797.619
16/01/2021 09:00,54.91,60409,285,19,52,2162,4,2522,549.797.619
16/01/2021 10:00,55.15,61155,310,15,69,1794,8,2196,549.797.619
16/01/2021 11:00,54.29,61213,297,12,87,1430,8,1834,549.797.619
16/01/2021 12:00,50.66,60660,309,12,103,1192,12,1628,549.797.619
16/01/2021 13:00,49.55,60085,306,12,105,988,12,1423,549.797.619
16/01/2021 14:00,47.02,60081,336,12,103,900,10,1361,549.797.619
16/01/2021 15:00,50.1,60792,386,13,101,777,7,1284,549.797.619
16/01/2021 16:00,54.96,62094,445,12,98,626,5,1186,549.797.619
16/01/2021 17:00,61.07,62925,512,11,87,575,2,1187,549.797.619
16/01/2021 18:00,59.08,62300,580,10,73,518,1,1182,549.797.619
16/01/2021 19:00,56.44,60780,633,9,63,556,1,1262,549.797.619
16/01/2021 20:00,54.95,59027,688,7,58,636,1,1390,549.797.619
16/01/2021 21:00,49.08,57889,732,6,50,646,0,1434,549.797.619
16/01/2021 22:00,48.03,56478,796,5,41,716,1,1559,549.797.619
16/01/2021 23:00,44.93,54754,870,5,30,808,0,1713,549.797.619
17/01/2021 00:00,44.92,53673,1132,6,21,986,2,2147,549.797.619
17/01/2021 01:00,44.3,52615,1151,6,12,1171,2,2342,549.797.619
17/01/2021 02:00,44.27,51974,1133,7,7,1226,2,2375,549.797.619
17/01/2021 03:00,44.36,51667,1083,7,4,1304,2,2400,549.797.619
17/01/2021 04:00,44.14,51770,1106,9,3,1288,2,2408,549.797.619
17/01/2021 05:00,44.13,52165,1132,11,3,1335,2,2483,549.797.619
17/01/2021 06:00,44.21,52936,1158,15,3,1233,2,2411,549.797.619
17/01/2021 07:00,44.42,54122,1186,22,2,1374,2,2586,549.797.619
17/01/2021 08:00,44.7,55399,1181,28,2,1355,2,2568,549.797.619
17/01/2021 09:00,45.27,56812,1186,36,2,1371,2,2597,549.797.619
17/01/2021 10:00,50.73,57760,1193,45,2,1310,2,2552,549.797.619
17/01/2021 11:00,51.94,58230,1162,53,1,1304,2,2522,549.797.619
17/01/2021 12:00,50.62,58043,1118,60,1,1311,2,2492,549.797.619
17/01/2021 13:00,48.29,57670,1077,64,1,1324,2,2468,549.797.619
17/01/2021 14:00,47.03,57835,991,65,2,1375,2,2435,549.797.619
17/01/2021 15:00,51.28,58732,931,71,2,1502,2,2508,549.797.619
17/01/2021 16:00,54.91,60232,926,80,2,1463,2,2473,549.797.619
17/01/2021 17:00,60.33,61226,918,90,2,1310,2,2322,549.797.619
17/01/2021 18:00,62.39,60792,924,100,3,1440,3,2470,549.797.619
17/01/2021 19:00,59.77,59624,960,108,5,1484,4,2561,549.797.619
17/01/2021 20:00,55.5,58223,922,116,8,1504,5,2555,549.797.619
17/01/2021 21:00,54.53,57298,863,127,15,1560,7,2572,549.797.619
17/01/2021 22:00,52.07,55654,930,134,22,1457,8,2551,549.797.619
17/01/2021 23:00,46,54007,961,138,30,1556,6,2691,549.797.619
18/01/2021 00:00,43.76,52481,908,80,15,1710,7,2720,5.276.964.286
18/01/2021 01:00,44.44,51505,916,83,20,1607,7,2633,5.276.964.286
18/01/2021 02:00,44.2,51147,945,85,25,1621,9,2685,5.276.964.286
18/01/2021 03:00,44.55,51284,930,87,30,1561,10,2618,5.276.964.286
18/01/2021 04:00,44.86,52123,968,92,37,1495,9,2601,5.276.964.286
18/01/2021 05:00,50.72,54298,1093,93,45,1509,8,2748,5.276.964.286
18/01/2021 06:00,56.42,58377,1250,91,54,1474,11,2880,5.276.964.286
18/01/2021 07:00,70.22,62057,1426,87,61,1440,12,3026,5.276.964.286
18/01/2021 08:00,72.52,63218,1595,86,71,1374,11,3137,5.276.964.286
18/01/2021 09:00,71.31,63123,1683,86,79,1425,10,3283,5.276.964.286
18/01/2021 10:00,70.66,63275,1813,86,78,1287,6,3270,5.276.964.286
18/01/2021 11:00,62.76,63086,1979,83,70,1244,4,3380,5.276.964.286
18/01/2021 12:00,58.73,62712,2062,79,62,1158,5,3366,5.276.964.286
18/01/2021 13:00,56.72,62544,2084,76,56,1102,4,3322,5.276.964.286
18/01/2021 14:00,56.21,62329,1924,72,55,1149,4,3204,5.276.964.286
18/01/2021 15:00,59.39,62699,1815,69,59,1207,4,3154,5.276.964.286
18/01/2021 16:00,55.56,63310,1787,65,65,1379,4,3300,5.276.964.286
18/01/2021 17:00,61.01,63593,1698,59,68,1465,4,3294,5.276.964.286
18/01/2021 18:00,56.32,62670,1473,53,69,1545,5,3145,5.276.964.286
18/01/2021 19:00,53.17,61333,1363,48,70,1507,6,2994,5.276.964.286
18/01/2021 20:00,47.78,59558,1392,45,72,1285,6,2800,5.276.964.286
18/01/2021 21:00,47.75,58089,1451,44,75,1230,6,2806,5.276.964.286
18/01/2021 22:00,43.27,55829,1555,43,79,1249,6,2932,5.276.964.286
18/01/2021 23:00,37.87,53405,1617,44,85,1361,5,3112,5.276.964.286
19/01/2021 00:00,36.76,52320,1369,44,56,1332,9,2810,5.276.964.286
19/01/2021 01:00,35.99,51353,1424,41,63,1333,9,2870,5.276.964.286
19/01/2021 02:00,34.77,51043,1614,39,66,1117,9,2845,5.276.964.286
19/01/2021 03:00,35.98,51136,1709,39,70,1058,11,2887,5.276.964.286
19/01/2021 04:00,36.73,51897,1724,39,75,1047,14,2899,5.276.964.286
19/01/2021 05:00,39.27,53819,1638,35,84,971,14,2742,5.276.964.286
19/01/2021 06:00,42.77,57414,1562,34,95,956,18,2665,5.276.964.286
19/01/2021 07:00,51.2,60984,1532,36,107,964,20,2659,5.276.964.286
19/01/2021 08:00,58.47,62058,1450,37,119,955,17,2578,5.276.964.286
19/01/2021 09:00,54.99,62066,1377,41,125,991,17,2551,5.276.964.286
19/01/2021 10:00,54.45,62104,1390,43,127,1014,13,2587,5.276.964.286
19/01/2021 11:00,54.52,61950,1325,43,128,1044,11,2551,5.276.964.286
19/01/2021 12:00,52.94,61574,1165,45,131,1060,13,2414,5.276.964.286
19/01/2021 13:00,53.29,61481,1019,48,140,1105,13,2325,5.276.964.286
19/01/2021 14:00,53.39,61432,866,51,154,1145,14,2230,5.276.964.286
19/01/2021 15:00,53.46,61861,755,56,169,1303,15,2298,5.276.964.286
19/01/2021 16:00,52.42,62628,695,62,183,1471,21,2432,5.276.964.286
19/01/2021 17:00,54.47,63027,658,68,188,1518,22,2454,5.276.964.286
19/01/2021 18:00,50.47,62171,622,74,186,1540,26,2448,5.276.964.286
19/01/2021 19:00,44.92,60947,637,77,185,1511,24,2434,5.276.964.286
19/01/2021 20:00,41.05,59180,600,79,184,1531,22,2416,5.276.964.286
19/01/2021 21:00,39.63,57830,605,81,182,1664,22,2554,5.276.964.286
19/01/2021 22:00,36.56,55737,687,80,182,1671,18,2638,5.276.964.286
19/01/2021 23:00,31.03,53418,1023,78,184,1653,18,2956,5.276.964.286
20/01/2021 00:00,30.33,51659,1188,72,273,1581,19,3133,5.276.964.286
20/01/2021 01:00,28.4,50686,1666,72,266,1711,18,3733,5.276.964.286
20/01/2021 02:00,27.27,50312,2241,73,266,1799,16,4395,5.276.964.286
20/01/2021 03:00,26.75,50360,2686,72,267,1907,17,4949,5.276.964.286
20/01/2021 04:00,28.85,51162,3064,72,271,2091,21,5519,5.276.964.286
20/01/2021 05:00,31.93,53315,3266,72,277,2118,18,5751,5.276.964.286
20/01/2021 06:00,36.08,57133,3464,74,286,2370,17,6211,5.276.964.286
20/01/2021 07:00,40.07,60814,3653,77,296,2692,19,6737,5.276.964.286
20/01/2021 08:00,44.2,61872,3655,76,307,2711,19,6768,5.276.964.286
20/01/2021 09:00,40.46,61941,3578,75,321,2876,21,6871,5.276.964.286
20/01/2021 10:00,39.13,62071,3649,74,326,3164,24,7237,5.276.964.286
20/01/2021 11:00,39.02,61992,3733,73,322,3189,26,7343,5.276.964.286
20/01/2021 12:00,38.87,61767,3667,73,312,3425,26,7503,5.276.964.286
20/01/2021 13:00,37.61,61676,3694,71,295,3511,26,7597,5.276.964.286
20/01/2021 14:00,37.58,61532,3742,70,278,3603,27,7720,5.276.964.286
20/01/2021 15:00,38.92,61926,3751,73,261,3742,29,7856,5.276.964.286
20/01/2021 16:00,39.72,62765,3796,78,258,3993,29,8154,5.276.964.286
20/01/2021 17:00,41.49,63245,3846,81,261,4041,30,8259,5.276.964.286
20/01/2021 18:00,39.96,62230,3784,83,260,4137,30,8294,5.276.964.286
20/01/2021 19:00,38.11,60879,3596,85,262,4164,31,8138,5.276.964.286
20/01/2021 20:00,35.68,59006,3607,88,272,4068,31,8066,5.276.964.286
20/01/2021 21:00,32.18,57370,3645,90,281,4401,31,8448,5.276.964.286
20/01/2021 22:00,29.49,55224,3681,89,282,4405,31,8488,5.276.964.286
20/01/2021 23:00,25.42,52802,3706,86,276,4563,28,8659,5.276.964.286
21/01/2021 00:00,24.81,50737,3971,74,262,4685,19,9011,5.276.964.286
21/01/2021 01:00,21.54,49835,4051,71,261,4888,23,9294,5.276.964.286
21/01/2021 02:00,20.57,49539,4114,70,254,5012,23,9473,5.276.964.286
21/01/2021 03:00,19.43,49641,4059,71,249,4972,25,9376,5.276.964.286
21/01/2021 04:00,19.66,50303,4080,73,248,5086,27,9514,5.276.964.286
21/01/2021 05:00,24.64,52218,3976,76,250,5165,27,9494,5.276.964.286
21/01/2021 06:00,28.01,55848,4013,81,260,5127,25,9506,5.276.964.286
21/01/2021 07:00,33.03,59474,4275,86,272,5102,25,9760,5.276.964.286
21/01/2021 08:00,35.87,60715,4402,89,277,5164,23,9955,5.276.964.286
21/01/2021 09:00,33.26,60722,4296,90,284,5509,22,10201,5.276.964.286
21/01/2021 10:00,32,60722,4338,89,291,5764,23,10505,5.276.964.286
21/01/2021 11:00,32.41,60465,4418,87,301,6024,23,10853,5.276.964.286
21/01/2021 12:00,31.99,60067,4287,86,311,6402,28,11114,5.276.964.286
21/01/2021 13:00,32.76,59870,4202,85,324,6379,29,11019,5.276.964.286
21/01/2021 14:00,34.85,59891,4157,87,342,6458,29,11073,5.276.964.286
21/01/2021 15:00,35.45,60321,4194,92,362,6664,30,11342,5.276.964.286
21/01/2021 16:00,35.72,61187,4258,98,372,6974,36,11738,5.276.964.286
21/01/2021 17:00,36.12,61587,4410,104,363,7188,37,12102,5.276.964.286
21/01/2021 18:00,35.52,60564,4393,108,353,7365,37,12256,5.276.964.286
21/01/2021 19:00,32.13,59173,4207,110,343,7217,37,11914,5.276.964.286
21/01/2021 20:00,30.14,57555,4144,111,330,7212,35,11832,5.276.964.286
21/01/2021 21:00,29.48,56133,4173,113,316,7221,32,11855,5.276.964.286
21/01/2021 22:00,27.4,54149,4279,113,299,7104,32,11827,5.276.964.286
21/01/2021 23:00,24.36,52046,4323,110,284,7114,26,11857,5.276.964.286
22/01/2021 00:00,19.89,50805,4378,102,267,6942,25,11714,5.276.964.286
22/01/2021 01:00,19.11,49865,4290,99,259,6488,23,11159,5.276.964.286
22/01/2021 02:00,16.78,49496,3966,95,258,6376,25,10720,5.276.964.286
22/01/2021 03:00,16.61,49527,3575,91,259,6344,27,10296,5.276.964.286
22/01/2021 04:00,20.07,50261,3392,89,261,6277,25,10044,5.276.964.286
22/01/2021 05:00,26.91,52290,3087,89,268,6206,25,9675,5.276.964.286
22/01/2021 06:00,29.02,56108,2936,92,280,6130,23,9461,5.276.964.286
22/01/2021 07:00,33.93,59680,3093,95,296,6052,23,9559,5.276.964.286
22/01/2021 08:00,36.44,60804,3140,92,312,5761,23,9328,5.276.964.286
22/01/2021 09:00,35.98,60818,3265,95,325,5537,25,9247,5.276.964.286
22/01/2021 10:00,35.69,60938,3570,96,335,5305,26,9332,5.276.964.286
22/01/2021 11:00,35.15,60606,3895,99,346,5233,33,9606,5.276.964.286
22/01/2021 12:00,34.29,60219,4018,105,352,5187,33,9695,5.276.964.286
22/01/2021 13:00,33.92,59701,4160,110,354,5279,37,9940,5.276.964.286
22/01/2021 14:00,33.23,59336,4245,116,358,5455,36,10210,5.276.964.286
22/01/2021 15:00,33.22,59267,4230,122,352,5610,41,10355,5.276.964.286
22/01/2021 16:00,33.9,59929,4225,141,342,5910,42,10660,5.276.964.286
22/01/2021 17:00,34,60751,4277,153,320,6441,39,11230,5.276.964.286
22/01/2021 18:00,33.34,60068,4164,163,296,6856,33,11512,5.276.964.286
22/01/2021 19:00,31.12,58643,3943,171,272,6997,26,11409,5.276.964.286
22/01/2021 20:00,28.5,56608,3826,175,243,6937,22,11203,5.276.964.286
22/01/2021 21:00,27.83,55218,3786,176,212,6853,16,11043,5.276.964.286
22/01/2021 22:00,26.91,53426,3812,171,188,6839,15,11025,5.276.964.286
22/01/2021 23:00,26.2,51501,3721,160,170,6769,12,10832,5.276.964.286
23/01/2021 00:00,27.35,49143,3411,26,143,6725,12,10317,5.276.964.286
23/01/2021 01:00,27.26,48117,3039,30,135,6373,14,9591,5.276.964.286
23/01/2021 02:00,27.41,47528,2578,36,123,5960,16,8713,5.276.964.286
23/01/2021 03:00,28.31,47350,2087,38,109,5445,16,7695,5.276.964.286
23/01/2021 04:00,30.01,47643,1725,39,90,5242,19,7115,5.276.964.286
23/01/2021 05:00,31.73,48387,1440,37,71,5004,20,6572,5.276.964.286
23/01/2021 06:00,32.98,49606,1190,32,61,4637,22,5942,5.276.964.286
23/01/2021 07:00,34.11,51430,981,25,51,4301,18,5376,5.276.964.286
23/01/2021 08:00,35.91,53178,840,18,44,3972,18,4892,5.276.964.286
23/01/2021 09:00,36.94,54629,765,16,44,3966,16,4807,5.276.964.286
23/01/2021 10:00,38.1,55632,680,14,56,3761,9,4520,5.276.964.286
23/01/2021 11:00,38.25,55852,589,12,72,3599,6,4278,5.276.964.286
23/01/2021 12:00,38.25,55432,541,10,90,3400,0,4041,5.276.964.286
23/01/2021 13:00,38.1,54926,508,7,122,3167,0,3804,5.276.964.286
23/01/2021 14:00,38.25,54862,432,6,178,2991,0,3607,5.276.964.286
23/01/2021 15:00,39.45,55703,385,6,238,2768,0,3397,5.276.964.286
23/01/2021 16:00,44.81,57359,510,5,277,2795,3,3590,5.276.964.286
23/01/2021 17:00,46.57,58562,646,6,302,2629,12,3595,5.276.964.286
23/01/2021 18:00,46.62,57980,741,6,323,2443,14,3527,5.276.964.286
23/01/2021 19:00,46.53,56395,835,5,339,2068,22,3269,5.276.964.286
23/01/2021 20:00,41.63,54677,855,3,347,1801,24,3030,5.276.964.286
23/01/2021 21:00,39.38,53508,846,2,354,1611,24,2837,5.276.964.286
23/01/2021 22:00,38.13,52090,895,2,359,1548,23,2827,5.276.964.286
23/01/2021 23:00,36.69,50515,931,3,358,1447,24,2763,5.276.964.286
24/01/2021 00:00,37.41,48935,761,3,307,1323,13,2407,5.276.964.286
24/01/2021 01:00,37.44,47993,688,4,297,1161,20,2170,5.276.964.286
24/01/2021 02:00,37.31,47553,580,5,280,933,21,1819,5.276.964.286
24/01/2021 03:00,37.38,47500,437,5,272,921,29,1664,5.276.964.286
24/01/2021 04:00,37.64,47737,381,6,265,916,22,1590,5.276.964.286
24/01/2021 05:00,38.1,48306,323,8,252,795,18,1396,5.276.964.286
24/01/2021 06:00,38.59,49214,282,11,229,871,18,1411,5.276.964.286
24/01/2021 07:00,38.98,50518,289,13,204,805,22,1333,5.276.964.286
24/01/2021 08:00,40.93,51892,270,15,181,677,22,1165,5.276.964.286
24/01/2021 09:00,45.97,53503,243,17,159,712,23,1154,5.276.964.286
24/01/2021 10:00,46.85,54537,225,17,131,522,22,917,5.276.964.286
24/01/2021 11:00,48.38,55039,189,18,102,575,22,906,5.276.964.286
24/01/2021 12:00,46.7,54929,178,18,79,427,19,721,5.276.964.286
24/01/2021 13:00,42.77,54837,172,18,64,394,16,664,5.276.964.286
24/01/2021 14:00,41.92,55069,157,19,55,427,11,669,5.276.964.286
24/01/2021 15:00,42.8,55940,147,20,51,393,5,616,5.276.964.286
24/01/2021 16:00,49.73,57527,146,20,50,408,2,626,5.276.964.286
24/01/2021 17:00,55.52,58679,141,19,53,376,1,590,5.276.964.286
24/01/2021 18:00,57.93,58468,140,20,58,322,2,542,5.276.964.286
24/01/2021 19:00,55.61,57464,133,21,63,363,1,581,5.276.964.286
24/01/2021 20:00,54.33,56149,124,22,73,361,0,580,5.276.964.286
24/01/2021 21:00,51.9,55229,120,23,87,386,0,616,5.276.964.286
24/01/2021 22:00,47.72,53647,126,22,101,403,0,652,5.276.964.286
24/01/2021 23:00,42.28,51937,146,21,112,487,0,766,5.276.964.286
25/01/2021 00:00,43.11,49494,174,148,110,507,3,942,4.972.261.905
25/01/2021 01:00,41.01,48742,212,137,144,695,3,1191,4.972.261.905
25/01/2021 02:00,40.43,48520,246,129,171,812,3,1361,4.972.261.905
25/01/2021 03:00,39.82,48744,261,120,195,907,4,1487,4.972.261.905
25/01/2021 04:00,40.58,49709,291,110,210,888,4,1503,4.972.261.905
25/01/2021 05:00,43.04,52112,316,102,206,965,5,1594,4.972.261.905
25/01/2021 06:00,54.92,56257,343,100,198,970,6,1617,4.972.261.905
25/01/2021 07:00,60.64,60100,369,103,182,1133,7,1794,4.972.261.905
25/01/2021 08:00,71.89,61342,387,109,159,1200,8,1863,4.972.261.905
25/01/2021 09:00,75.03,61345,422,118,136,1261,10,1947,4.972.261.905
25/01/2021 10:00,70.08,61489,478,128,107,1108,13,1834,4.972.261.905
25/01/2021 11:00,64.34,61399,484,137,73,1130,15,1839,4.972.261.905
25/01/2021 12:00,64.37,61152,529,147,42,1104,17,1839,4.972.261.905
25/01/2021 13:00,63.29,60947,509,159,24,1176,19,1887,4.972.261.905
25/01/2021 14:00,59.98,60683,525,171,18,1197,17,1928,4.972.261.905
25/01/2021 15:00,62.32,60956,520,181,15,1349,17,2082,4.972.261.905
25/01/2021 16:00,56.01,61625,492,195,15,1437,14,2153,4.972.261.905
25/01/2021 17:00,54.7,62182,469,207,21,1532,10,2239,4.972.261.905
25/01/2021 18:00,54.22,61256,468,216,30,1651,8,2373,4.972.261.905
25/01/2021 19:00,50.02,59898,459,218,46,1679,7,2409,4.972.261.905
25/01/2021 20:00,48.38,58153,467,213,69,1688,6,2443,4.972.261.905
25/01/2021 21:00,46.24,56821,471,202,92,1691,6,2462,4.972.261.905
25/01/2021 22:00,44.14,54554,448,188,114,1816,5,2571,4.972.261.905
25/01/2021 23:00,39.38,52150,401,167,137,1921,4,2630,4.972.261.905
26/01/2021 00:00,42.54,51041,293,31,165,1727,3,2219,4.972.261.905
26/01/2021 01:00,41.89,50129,214,32,181,1758,3,2188,4.972.261.905
26/01/2021 02:00,41.69,49957,231,34,193,1660,3,2121,4.972.261.905
26/01/2021 03:00,41.28,50130,270,38,211,1640,3,2162,4.972.261.905
26/01/2021 04:00,42.91,51121,323,42,229,1819,3,2416,4.972.261.905
26/01/2021 05:00,48.58,53467,435,51,239,1812,5,2542,4.972.261.905
26/01/2021 06:00,49.7,57545,562,64,247,1668,6,2547,4.972.261.905
26/01/2021 07:00,56.8,61442,673,81,265,1537,6,2562,4.972.261.905
26/01/2021 08:00,59.28,62569,672,98,281,1511,8,2570,4.972.261.905
26/01/2021 09:00,64.52,62525,730,120,290,1523,10,2673,4.972.261.905
26/01/2021 10:00,69.97,62440,771,139,297,1345,12,2564,4.972.261.905
26/01/2021 11:00,59.1,62090,831,151,308,1296,15,2601,4.972.261.905
26/01/2021 12:00,57.88,61467,939,158,321,1237,17,2672,4.972.261.905
26/01/2021 13:00,57.42,61035,963,161,332,1216,17,2689,4.972.261.905
26/01/2021 14:00,56.56,60763,1031,157,347,1368,20,2923,4.972.261.905
26/01/2021 15:00,59.59,61169,1060,148,353,1433,20,3014,4.972.261.905
26/01/2021 16:00,57.17,62241,1102,139,357,1598,18,3214,4.972.261.905
26/01/2021 17:00,60.82,63041,1039,132,363,1632,22,3188,4.972.261.905
26/01/2021 18:00,59.19,62504,1103,122,370,1670,28,3293,4.972.261.905
26/01/2021 19:00,55.48,61341,1129,105,376,1819,36,3465,4.972.261.905
26/01/2021 20:00,55.41,59538,1180,84,378,1847,36,3525,4.972.261.905
26/01/2021 21:00,51.99,58203,1227,66,372,1678,36,3379,4.972.261.905
26/01/2021 22:00,49.7,56045,1242,51,369,1607,44,3313,4.972.261.905
26/01/2021 23:00,43.1,53552,1207,40,369,1615,34,3265,4.972.261.905
27/01/2021 00:00,45.58,52079,960,32,345,1545,37,2919,4.972.261.905
27/01/2021 01:00,43.91,51227,946,21,352,1642,45,3006,4.972.261.905
27/01/2021 02:00,42.56,50984,903,15,354,1677,43,2992,4.972.261.905
27/01/2021 03:00,41.44,51218,813,11,350,1667,42,2883,4.972.261.905
27/01/2021 04:00,42.15,52138,795,10,347,1667,45,2864,4.972.261.905
27/01/2021 05:00,44.96,54287,787,11,345,1842,45,3030,4.972.261.905
27/01/2021 06:00,49.93,58089,719,15,344,1781,47,2906,4.972.261.905
27/01/2021 07:00,57.44,61676,699,19,344,1826,49,2937,4.972.261.905
27/01/2021 08:00,64.95,62676,717,24,340,1721,47,2849,4.972.261.905
27/01/2021 09:00,64.94,62683,742,29,327,1639,50,2787,4.972.261.905
27/01/2021 10:00,64.91,62578,795,37,310,1518,45,2705,4.972.261.905
27/01/2021 11:00,64.94,62188,764,47,292,1436,40,2579,4.972.261.905
27/01/2021 12:00,62.95,61616,649,62,278,1422,41,2452,4.972.261.905
27/01/2021 13:00,64.17,61311,642,78,267,1312,39,2338,4.972.261.905
27/01/2021 14:00,64.99,61084,547,89,251,1342,35,2264,4.972.261.905
27/01/2021 15:00,63.92,61525,488,97,234,1419,29,2267,4.972.261.905
27/01/2021 16:00,61.67,62568,496,104,213,1513,29,2355,4.972.261.905
27/01/2021 17:00,65.44,63323,522,111,190,1641,23,2487,4.972.261.905
27/01/2021 18:00,63,62518,541,113,164,1611,17,2446,4.972.261.905
27/01/2021 19:00,55.08,61262,541,111,137,1431,15,2235,4.972.261.905
27/01/2021 20:00,54.76,59578,557,109,114,1270,11,2061,4.972.261.905
27/01/2021 21:00,53.59,58391,624,105,93,1251,6,2079,4.972.261.905
27/01/2021 22:00,50.32,56424,695,100,72,1239,4,2110,4.972.261.905
27/01/2021 23:00,47.47,54085,738,92,54,1248,3,2135,4.972.261.905
28/01/2021 00:00,46.87,53281,768,89,28,1283,1,2169,4.972.261.905
28/01/2021 01:00,44.93,52319,865,77,32,1264,1,2239,4.972.261.905
28/01/2021 02:00,43.83,51969,995,64,41,1247,1,2348,4.972.261.905
28/01/2021 03:00,42.4,52153,1048,52,51,1232,1,2384,4.972.261.905
28/01/2021 04:00,43.64,52959,1010,41,56,1265,2,2374,4.972.261.905
28/01/2021 05:00,45.07,55205,977,34,58,1342,3,2414,4.972.261.905
28/01/2021 06:00,54.66,59129,918,29,62,1348,4,2361,4.972.261.905
28/01/2021 07:00,64.7,63011,899,23,68,1345,4,2339,4.972.261.905
28/01/2021 08:00,71.94,64142,820,19,74,1320,6,2239,4.972.261.905
28/01/2021 09:00,68.79,64132,738,17,81,1334,7,2177,4.972.261.905
28/01/2021 10:00,67.02,64042,673,18,85,1333,5,2114,4.972.261.905
28/01/2021 11:00,64.69,63447,632,18,91,1337,7,2085,4.972.261.905
28/01/2021 12:00,59.47,62879,583,20,99,1386,6,2094,4.972.261.905
28/01/2021 13:00,59.92,62581,560,21,105,1401,5,2092,4.972.261.905
28/01/2021 14:00,60.04,62374,544,23,116,1462,4,2149,4.972.261.905
28/01/2021 15:00,57.49,62736,544,26,128,1541,4,2243,4.972.261.905
28/01/2021 16:00,62.54,63690,547,29,134,1595,6,2311,4.972.261.905
28/01/2021 17:00,68.75,64581,543,30,135,1690,7,2405,4.972.261.905
28/01/2021 18:00,68.73,63808,547,30,132,1681,8,2398,4.972.261.905
28/01/2021 19:00,60.69,62552,542,29,122,1690,8,2391,4.972.261.905
28/01/2021 20:00,56.78,60920,551,28,110,1591,8,2288,4.972.261.905
28/01/2021 21:00,53.53,59592,537,27,98,1540,8,2210,4.972.261.905
28/01/2021 22:00,51.69,57630,544,27,85,1532,9,2197,4.972.261.905
28/01/2021 23:00,45.51,55570,542,25,69,1535,8,2179,4.972.261.905
29/01/2021 00:00,42.7,54329,632,36,38,1471,9,2186,4.972.261.905
29/01/2021 01:00,40.84,53398,631,32,30,1319,7,2019,4.972.261.905
29/01/2021 02:00,39.36,52967,663,26,31,1186,5,1911,4.972.261.905
29/01/2021 03:00,38.75,53080,705,19,36,1061,4,1825,4.972.261.905
29/01/2021 04:00,39.35,54070,768,14,44,986,5,1817,4.972.261.905
29/01/2021 05:00,42.9,56427,886,9,49,960,4,1908,4.972.261.905
29/01/2021 06:00,47.33,60292,1019,6,53,945,3,2026,4.972.261.905
29/01/2021 07:00,59.61,64025,1093,4,50,821,3,1971,4.972.261.905
29/01/2021 08:00,68.8,65110,1154,3,39,808,3,2007,4.972.261.905
29/01/2021 09:00,64.65,65137,1165,3,30,743,3,1944,4.972.261.905
29/01/2021 10:00,64.74,65119,1162,3,27,681,2,1875,4.972.261.905
29/01/2021 11:00,57.42,64704,1097,4,26,619,2,1748,4.972.261.905
29/01/2021 12:00,56.24,64005,1026,4,30,689,2,1751,4.972.261.905
29/01/2021 13:00,53.83,63153,1016,4,36,681,3,1740,4.972.261.905
29/01/2021 14:00,50.08,62714,1007,6,41,685,2,1741,4.972.261.905
29/01/2021 15:00,51.92,62928,1025,7,47,770,2,1851,4.972.261.905
29/01/2021 16:00,56.39,63749,1036,8,55,968,2,2069,4.972.261.905
29/01/2021 17:00,58.96,64647,1052,11,63,970,3,2099,4.972.261.905
29/01/2021 18:00,59.6,63925,1040,14,67,1122,5,2248,4.972.261.905
29/01/2021 19:00,56.36,62421,971,16,63,1088,5,2143,4.972.261.905
29/01/2021 20:00,51.78,60470,925,16,63,1102,5,2111,4.972.261.905
29/01/2021 21:00,49.33,59284,917,16,76,1157,6,2172,4.972.261.905
29/01/2021 22:00,46.05,57655,951,16,92,1257,8,2324,4.972.261.905
29/01/2021 23:00,42.79,55717,1034,15,105,1390,9,2553,4.972.261.905
30/01/2021 00:00,42.33,54463,1025,150,68,1492,15,2750,4.972.261.905
30/01/2021 01:00,40.39,53405,1002,152,74,1432,16,2676,4.972.261.905
30/01/2021 02:00,39.05,52812,982,155,80,1627,13,2857,4.972.261.905
30/01/2021 03:00,37.96,52697,949,157,84,1666,13,2869,4.972.261.905
30/01/2021 04:00,38.07,53127,920,162,84,1761,15,2942,4.972.261.905
30/01/2021 05:00,39.41,53995,909,164,84,1905,19,3081,4.972.261.905
30/01/2021 06:00,41.56,55337,835,168,79,2018,21,3121,4.972.261.905
30/01/2021 07:00,43.35,57245,780,169,76,2158,24,3207,4.972.261.905
30/01/2021 08:00,48.31,58820,613,167,72,2104,31,2987,4.972.261.905
30/01/2021 09:00,56.53,60219,393,160,69,2188,27,2837,4.972.261.905
30/01/2021 10:00,56.53,61011,364,149,72,2222,30,2837,4.972.261.905
30/01/2021 11:00,56.57,60895,535,135,77,2209,29,2985,4.972.261.905
30/01/2021 12:00,54.09,60314,718,119,82,2225,34,3178,4.972.261.905
30/01/2021 13:00,50.57,59638,843,101,91,2374,39,3448,4.972.261.905
30/01/2021 14:00,47.86,59451,981,88,101,2666,37,3873,4.972.261.905
30/01/2021 15:00,48.05,60100,1147,77,110,2855,34,4223,4.972.261.905
30/01/2021 16:00,55.28,61868,1258,64,119,3178,32,4651,4.972.261.905
30/01/2021 17:00,56.65,63466,1261,54,126,3183,28,4652,4.972.261.905
30/01/2021 18:00,56.92,63118,1241,47,130,3187,29,4634,4.972.261.905
30/01/2021 19:00,56.59,61405,1176,46,124,3118,28,4492,4.972.261.905
30/01/2021 20:00,52.88,59555,1171,49,120,2984,26,4350,4.972.261.905
30/01/2021 21:00,46.96,58434,1254,58,122,3048,23,4505,4.972.261.905
30/01/2021 22:00,46.98,57047,1379,74,129,3016,26,4624,4.972.261.905
30/01/2021 23:00,42.3,55388,1502,88,136,2961,26,4713,4.972.261.905
31/01/2021 00:00,42.08,54499,1191,94,201,2796,19,4301,4.972.261.905
31/01/2021 01:00,40.98,53522,1311,108,207,2497,19,4142,4.972.261.905
31/01/2021 02:00,40.51,53032,1405,118,214,2428,24,4189,4.972.261.905
31/01/2021 03:00,39.5,52967,1429,126,222,2288,27,4092,4.972.261.905
31/01/2021 04:00,39.55,53173,1478,130,223,2143,27,4001,4.972.261.905
31/01/2021 05:00,40.53,53601,1415,132,213,2067,25,3852,4.972.261.905
31/01/2021 06:00,40.73,54456,1421,134,202,2145,19,3921,4.972.261.905
31/01/2021 07:00,41.29,55709,1373,135,192,2169,14,3883,4.972.261.905
31/01/2021 08:00,44.85,56977,1299,134,185,1983,13,3614,4.972.261.905
31/01/2021 09:00,49.15,58526,1227,128,173,1872,13,3413,4.972.261.905
31/01/2021 10:00,50.73,59195,1183,115,167,2023,11,3499,4.972.261.905
31/01/2021 11:00,51.14,59363,1226,102,169,1805,12,3314,4.972.261.905
31/01/2021 12:00,50.37,58867,1295,93,165,1420,12,2985,4.972.261.905
31/01/2021 13:00,46.36,58423,1186,83,157,1410,11,2847,4.972.261.905
31/01/2021 14:00,45.94,58424,1037,74,161,1386,9,2667,4.972.261.905
31/01/2021 15:00,47.92,59205,938,67,184,1519,5,2713,4.972.261.905
31/01/2021 16:00,52.92,60942,862,62,211,1705,4,2844,4.972.261.905
31/01/2021 17:00,64.46,62351,803,58,231,1833,2,2927,4.972.261.905
31/01/2021 18:00,63.88,62153,794,56,250,1941,2,3043,4.972.261.905
31/01/2021 19:00,62.35,61212,747,53,256,1840,2,2898,4.972.261.905
31/01/2021 20:00,57.99,60031,701,48,257,1725,2,2733,4.972.261.905
31/01/2021 21:00,51.34,59221,684,45,255,1657,2,2643,4.972.261.905
31/01/2021 22:00,49.28,57682,685,45,244,1624,2,2600,4.972.261.905
31/01/2021 23:00,45.36,55919,749,45,233,1583,4,2614,4.972.261.905
01/02/2021 00:00,42.51,54869,362,18,209,1592,5,2186,4.685.714.286
01/02/2021 01:00,40.98,54184,367,23,197,1611,4,2202,4.685.714.286
01/02/2021 02:00,40.93,54005,391,32,182,1524,5,2134,4.685.714.286
01/02/2021 03:00,40.02,54308,437,39,170,1508,6,2160,4.685.714.286
01/02/2021 04:00,40.64,55157,469,42,156,1520,8,2195,4.685.714.286
01/02/2021 05:00,46.6,57536,428,45,144,1634,9,2260,4.685.714.286
01/02/2021 06:00,55.78,61696,388,50,134,1637,8,2217,4.685.714.286
01/02/2021 07:00,88.36,65573,374,51,120,1477,9,2031,4.685.714.286
01/02/2021 08:00,174.92,66719,387,47,106,1331,8,1879,4.685.714.286
01/02/2021 09:00,140.05,66669,412,48,88,1296,8,1852,4.685.714.286
01/02/2021 10:00,96.87,66402,430,55,69,1200,7,1761,4.685.714.286
01/02/2021 11:00,72.21,65877,421,65,53,1126,7,1672,4.685.714.286
01/02/2021 12:00,72.33,65151,381,80,42,1054,8,1565,4.685.714.286
01/02/2021 13:00,62.63,64642,375,94,36,963,5,1473,4.685.714.286
01/02/2021 14:00,68.82,64238,379,100,38,911,5,1433,4.685.714.286
01/02/2021 15:00,72.04,64527,385,104,50,843,5,1387,4.685.714.286
01/02/2021 16:00,78.47,65421,394,106,70,826,6,1402,4.685.714.286
01/02/2021 17:00,149.26,66325,425,106,85,824,8,1448,4.685.714.286
01/02/2021 18:00,110.01,65659,425,106,87,780,12,1410,4.685.714.286
01/02/2021 19:00,72.28,64446,392,103,83,746,11,1335,4.685.714.286
01/02/2021 20:00,63.07,62661,337,101,87,712,11,1248,4.685.714.286
01/02/2021 21:00,56.23,61318,270,101,99,692,12,1174,4.685.714.286
01/02/2021 22:00,55.21,59164,201,99,117,627,12,1056,4.685.714.286
01/02/2021 23:00,49.38,56865,179,96,133,582,15,1005,4.685.714.286
02/02/2021 00:00,46.13,55039,63,46,137,592,13,851,4.685.714.286
02/02/2021 01:00,45.05,54170,58,43,148,545,15,809,4.685.714.286
02/02/2021 02:00,43.6,53919,54,40,158,525,13,790,4.685.714.286
02/02/2021 03:00,42.44,54189,73,42,165,502,12,794,4.685.714.286
02/02/2021 04:00,43.98,55229,110,44,184,518,11,867,4.685.714.286
02/02/2021 05:00,47.74,57515,121,47,209,615,11,1003,4.685.714.286
02/02/2021 06:00,59.98,61472,114,48,230,659,12,1063,4.685.714.286
02/02/2021 07:00,90.67,65331,127,52,249,689,14,1131,4.685.714.286
02/02/2021 08:00,132.57,66401,128,55,263,645,18,1109,4.685.714.286
02/02/2021 09:00,90.73,66383,151,56,262,647,15,1131,4.685.714.286
02/02/2021 10:00,83.37,66171,168,59,246,639,15,1127,4.685.714.286
02/02/2021 11:00,62.5,65688,179,65,226,642,12,1124,4.685.714.286
02/02/2021 12:00,64.91,64984,196,69,205,726,10,1206,4.685.714.286
02/02/2021 13:00,62.46,64423,210,71,179,790,8,1258,4.685.714.286
02/02/2021 14:00,62.54,64169,243,67,151,965,5,1431,4.685.714.286
02/02/2021 15:00,59.54,64521,264,63,136,1127,4,1594,4.685.714.286
02/02/2021 16:00,60.07,65592,308,59,130,1308,4,1809,4.685.714.286
02/02/2021 17:00,81.65,66495,444,60,126,1587,3,2220,4.685.714.286
02/02/2021 18:00,66.01,65915,575,62,124,1542,3,2306,4.685.714.286
02/02/2021 19:00,59.9,64844,655,62,118,1736,2,2573,4.685.714.286
02/02/2021 20:00,51.09,63120,735,61,113,1773,2,2684,4.685.714.286
02/02/2021 21:00,48.03,61673,792,61,117,1905,1,2876,4.685.714.286
02/02/2021 22:00,46.51,59439,820,59,117,1960,1,2957,4.685.714.286
02/02/2021 23:00,41.48,56886,850,55,107,2120,1,3133,4.685.714.286
03/02/2021 00:00,38.53,55646,1071,50,142,2352,5,3620,4.685.714.286
03/02/2021 01:00,37.31,54802,1178,55,127,2299,5,3664,4.685.714.286
03/02/2021 02:00,36.41,54573,1353,61,104,2509,5,4032,4.685.714.286
03/02/2021 03:00,36,54805,1557,65,80,2649,3,4354,4.685.714.286
03/02/2021 04:00,37.53,55754,1685,70,56,2767,3,4581,4.685.714.286
03/02/2021 05:00,40.75,58085,1827,73,33,3037,4,4974,4.685.714.286
03/02/2021 06:00,44.44,62035,2047,77,20,3210,6,5360,4.685.714.286
03/02/2021 07:00,56.07,65795,2324,77,17,3117,7,5542,4.685.714.286
03/02/2021 08:00,60.06,66787,2475,76,18,3208,7,5784,4.685.714.286
03/02/2021 09:00,58.51,66873,2645,78,16,3193,8,5940,4.685.714.286
03/02/2021 10:00,56.2,66889,2902,77,12,3129,10,6130,4.685.714.286
03/02/2021 11:00,59.85,66423,3140,71,8,3177,12,6408,4.685.714.286
03/02/2021 12:00,54.76,65859,3284,62,7,3139,10,6502,4.685.714.286
03/02/2021 13:00,51.99,65483,3350,52,9,3161,11,6583,4.685.714.286
03/02/2021 14:00,49.83,65178,3414,49,12,3327,9,6811,4.685.714.286
03/02/2021 15:00,49.13,65629,3646,51,16,3651,7,7371,4.685.714.286
03/02/2021 16:00,49.31,66642,3822,53,20,4089,8,7992,4.685.714.286
03/02/2021 17:00,50.19,67765,4074,55,26,4352,8,8515,4.685.714.286
03/02/2021 18:00,49.7,67194,4139,55,31,4684,7,8916,4.685.714.286
03/02/2021 19:00,48.14,66202,4062,53,35,4768,7,8925,4.685.714.286
03/02/2021 20:00,43.35,64497,4121,51,42,4979,5,9198,4.685.714.286
03/02/2021 21:00,41.72,63190,4171,50,56,4886,5,9168,4.685.714.286
03/02/2021 22:00,40.09,61163,4074,47,80,4850,4,9055,4.685.714.286
03/02/2021 23:00,36.86,58696,3986,43,101,5012,4,9146,4.685.714.286
04/02/2021 00:00,34.92,56703,4056,39,135,5121,7,9358,4.685.714.286
04/02/2021 01:00,34.43,55848,3978,31,157,5172,9,9347,4.685.714.286
04/02/2021 02:00,33.91,55760,3872,24,171,5121,12,9200,4.685.714.286
04/02/2021 03:00,34.45,56067,3803,18,188,4839,12,8860,4.685.714.286
04/02/2021 04:00,36.95,57082,3613,15,202,4949,11,8790,4.685.714.286
04/02/2021 05:00,39.62,59355,3309,15,201,4955,12,8492,4.685.714.286
04/02/2021 06:00,45.8,63378,3081,18,196,4624,11,7930,4.685.714.286
04/02/2021 07:00,54.75,67044,2922,25,184,4446,9,7586,4.685.714.286
04/02/2021 08:00,59.17,67980,2589,37,171,4324,9,7130,4.685.714.286
04/02/2021 09:00,59.98,68010,2405,43,161,4107,8,6724,4.685.714.286
04/02/2021 10:00,55.66,67827,2271,41,151,3924,6,6393,4.685.714.286
04/02/2021 11:00,55.55,67184,2111,38,134,3552,6,5841,4.685.714.286
04/02/2021 12:00,54.76,66534,1901,40,120,3274,6,5341,4.685.714.286
04/02/2021 13:00,55.59,66113,1717,47,115,3149,4,5032,4.685.714.286
04/02/2021 14:00,55.55,65963,1599,56,106,3266,4,5031,4.685.714.286
04/02/2021 15:00,54.91,66373,1520,62,93,3377,4,5056,4.685.714.286
04/02/2021 16:00,55.59,67458,1477,69,83,3648,4,5281,4.685.714.286
04/02/2021 17:00,60.03,68773,1467,74,75,3871,4,5491,4.685.714.286
04/02/2021 18:00,59.97,68328,1505,77,63,4017,8,5670,4.685.714.286
04/02/2021 19:00,55.57,67330,1474,78,47,3961,8,5568,4.685.714.286
04/02/2021 20:00,52.73,65768,1472,75,36,3997,5,5585,4.685.714.286
04/02/2021 21:00,48.06,64334,1529,74,27,3956,5,5591,4.685.714.286
04/02/2021 22:00,50.02,62312,1475,72,20,3687,2,5256,4.685.714.286
04/02/2021 23:00,45,60278,1498,70,21,3739,1,5329,4.685.714.286
05/02/2021 00:00,44.72,58624,1664,74,28,3754,2,5522,4.685.714.286
05/02/2021 01:00,43.51,57788,1714,75,39,3918,3,5749,4.685.714.286
05/02/2021 02:00,41.58,57422,1844,74,57,3857,4,5836,4.685.714.286
05/02/2021 03:00,40.72,57580,1992,72,80,3821,18,5983,4.685.714.286
05/02/2021 04:00,40.94,58563,2100,71,100,3717,25,6013,4.685.714.286
05/02/2021 05:00,43.67,60912,2121,72,107,3650,17,5967,4.685.714.286
05/02/2021 06:00,49.18,64690,2136,73,110,3658,12,5989,4.685.714.286
05/02/2021 07:00,64.93,68247,2270,73,108,3550,10,6011,4.685.714.286
05/02/2021 08:00,100.16,69381,2281,72,104,3410,7,5874,4.685.714.286
05/02/2021 09:00,95.94,69435,2357,71,97,3119,6,5650,4.685.714.286
05/02/2021 10:00,88.74,69138,2420,70,87,2795,4,5376,4.685.714.286
05/02/2021 11:00,63.05,68389,2512,66,90,2493,4,5165,4.685.714.286
05/02/2021 12:00,57.95,67471,2523,62,102,2225,10,4922,4.685.714.286
05/02/2021 13:00,54.08,66527,2493,59,98,2094,13,4757,4.685.714.286
05/02/2021 14:00,53.05,65898,2525,56,87,2217,11,4896,4.685.714.286
05/02/2021 15:00,51.35,66012,2601,56,94,2181,11,4943,4.685.714.286
05/02/2021 16:00,53.48,67122,2642,57,102,2465,9,5275,4.685.714.286
05/02/2021 17:00,57.95,68298,2851,56,108,2627,9,5651,4.685.714.286
05/02/2021 18:00,59.05,67846,2926,55,128,2893,11,6013,4.685.714.286
05/02/2021 19:00,50.06,66492,2922,50,127,2977,12,6088,4.685.714.286
05/02/2021 20:00,46.43,64553,3006,44,115,2988,11,6164,4.685.714.286
05/02/2021 21:00,45.26,63380,3077,37,101,2896,6,6117,4.685.714.286
05/02/2021 22:00,46.26,61658,3051,36,88,2871,5,6051,4.685.714.286
05/02/2021 23:00,42.92,59792,3071,39,72,2778,3,5963,4.685.714.286
06/02/2021 00:00,40.11,58025,3414,130,78,2820,3,6445,4.685.714.286
06/02/2021 01:00,39.56,56875,3398,128,67,3008,3,6604,4.685.714.286
06/02/2021 02:00,38.29,56276,3440,125,53,3119,3,6740,4.685.714.286
06/02/2021 03:00,37.56,56123,3447,121,41,3423,5,7037,4.685.714.286
06/02/2021 04:00,37.5,56483,3366,118,36,3652,7,7179,4.685.714.286
06/02/2021 05:00,38.16,57247,3262,113,39,3821,7,7242,4.685.714.286
06/02/2021 06:00,39.62,58648,3150,106,45,3929,7,7237,4.685.714.286
06/02/2021 07:00,40.4,60418,3146,100,51,3963,11,7271,4.685.714.286
06/02/2021 08:00,42.09,61929,3061,95,52,3975,10,7193,4.685.714.286
06/02/2021 09:00,44.57,63333,3039,88,50,3845,5,7027,4.685.714.286
06/02/2021 10:00,48.12,63826,3078,78,43,3574,3,6776,4.685.714.286
06/02/2021 11:00,45.64,63663,3218,72,34,3197,3,6524,4.685.714.286
06/02/2021 12:00,44.08,62975,3291,68,34,2859,5,6257,4.685.714.286
06/02/2021 13:00,42.05,62203,3235,66,34,2776,4,6115,4.685.714.286
06/02/2021 14:00,41.39,61895,3130,65,31,2889,4,6119,4.685.714.286
06/02/2021 15:00,41.32,62448,3138,64,27,2972,3,6204,4.685.714.286
06/02/2021 16:00,41.31,64102,3116,62,26,3226,3,6433,4.685.714.286
06/02/2021 17:00,43.52,66048,3189,58,29,3432,3,6711,4.685.714.286
06/02/2021 18:00,44.91,66097,3244,52,33,3607,3,6939,4.685.714.286
06/02/2021 19:00,42.43,64627,3220,46,33,3684,3,6986,4.685.714.286
06/02/2021 20:00,41.02,62893,3248,39,31,3700,4,7022,4.685.714.286
06/02/2021 21:00,40.18,61784,3334,33,29,3758,4,7158,4.685.714.286
06/02/2021 22:00,39.54,60385,3286,30,26,3864,5,7211,4.685.714.286
06/02/2021 23:00,36.92,58812,3336,30,23,3839,3,7231,4.685.714.286
07/02/2021 00:00,36.01,57267,3546,48,7,3843,2,7446,4.685.714.286
07/02/2021 01:00,35.03,56264,3580,48,7,3699,2,7336,4.685.714.286
07/02/2021 02:00,34.56,55936,3658,45,6,3674,2,7385,4.685.714.286
07/02/2021 03:00,33.97,55877,3789,43,5,3679,2,7518,4.685.714.286
07/02/2021 04:00,33.96,56029,3837,41,5,3753,2,7638,4.685.714.286
07/02/2021 05:00,34.66,56570,3798,38,5,3843,3,7687,4.685.714.286
07/02/2021 06:00,34.69,57504,3798,33,6,3906,3,7746,4.685.714.286
07/02/2021 07:00,34.95,58903,3801,28,9,3898,4,7740,4.685.714.286
07/02/2021 08:00,37.02,60174,3609,25,13,3919,3,7569,4.685.714.286
07/02/2021 09:00,39.91,61767,3543,23,17,3638,3,7224,4.685.714.286
07/02/2021 10:00,40.5,62584,3589,25,15,3369,2,7000,4.685.714.286
07/02/2021 11:00,40.54,62548,3724,26,9,3222,2,6983,4.685.714.286
07/02/2021 12:00,40.51,61913,3752,27,10,3026,2,6817,4.685.714.286
07/02/2021 13:00,40.15,61450,3695,28,16,2938,2,6679,4.685.714.286
07/02/2021 14:00,38.95,61435,3641,28,22,3056,2,6749,4.685.714.286
07/02/2021 15:00,39.43,62028,3707,28,33,3248,2,7018,4.685.714.286
07/02/2021 16:00,40.58,63681,3781,29,47,3516,2,7375,4.685.714.286
07/02/2021 17:00,42.13,65558,3945,30,59,3763,2,7799,4.685.714.286
07/02/2021 18:00,44.33,65807,3930,30,70,3762,3,7795,4.685.714.286
07/02/2021 19:00,42.27,64806,3807,31,73,3691,3,7605,4.685.714.286
07/02/2021 20:00,40.95,63627,3830,35,78,3611,3,7557,4.685.714.286
07/02/2021 21:00,40.75,62741,3896,40,83,3607,3,7629,4.685.714.286
07/02/2021 22:00,40.51,61215,3846,43,84,3506,2,7481,4.685.714.286
07/02/2021 23:00,38.27,59580,3874,41,91,3419,3,7428,4.685.714.286
08/02/2021 00:00,38.64,57502,4483,34,86,3293,2,7898,4.387.738.095
08/02/2021 01:00,37.08,56928,4568,39,92,3294,2,7995,4.387.738.095
08/02/2021 02:00,37.11,56834,4594,42,98,3293,3,8030,4.387.738.095
08/02/2021 03:00,37.44,57096,4644,46,108,3242,3,8043,4.387.738.095
08/02/2021 04:00,38.91,57943,4588,51,121,3272,2,8034,4.387.738.095
08/02/2021 05:00,42.87,60068,4453,58,133,3284,2,7930,4.387.738.095
08/02/2021 06:00,46.57,64046,4378,64,145,3271,3,7861,4.387.738.095
08/02/2021 07:00,55.58,67701,4360,69,157,3134,4,7724,4.387.738.095
08/02/2021 08:00,64.07,68822,4078,71,161,3011,6,7327,4.387.738.095
08/02/2021 09:00,64.91,68730,3946,75,155,2753,6,6935,4.387.738.095
08/02/2021 10:00,62.65,68398,3955,79,150,2707,5,6896,4.387.738.095
08/02/2021 11:00,59.93,67936,4068,83,160,2527,8,6846,4.387.738.095
08/02/2021 12:00,59.47,67316,4066,85,181,2351,11,6694,4.387.738.095
08/02/2021 13:00,58.18,66925,3945,89,203,2447,14,6698,4.387.738.095
08/02/2021 14:00,53.03,66553,3913,93,222,2713,11,6952,4.387.738.095
08/02/2021 15:00,57.61,66640,3953,97,240,2955,11,7256,4.387.738.095
08/02/2021 16:00,58.44,67382,3991,104,259,3176,11,7541,4.387.738.095
08/02/2021 17:00,69.92,68720,4089,108,276,3248,12,7733,4.387.738.095
08/02/2021 18:00,66.29,68446,4013,106,289,3345,14,7767,4.387.738.095
08/02/2021 19:00,62.86,67218,3793,101,296,3396,13,7599,4.387.738.095
08/02/2021 20:00,57.17,65673,3788,94,298,3388,14,7582,4.387.738.095
08/02/2021 21:00,50.06,64407,3794,90,295,3439,14,7632,4.387.738.095
08/02/2021 22:00,47.67,62337,3730,87,292,3409,16,7534,4.387.738.095
08/02/2021 23:00,44.75,60042,3703,85,291,3508,12,7599,4.387.738.095
09/02/2021 00:00,46.68,57469,3948,15,390,3465,23,7841,4.387.738.095
09/02/2021 01:00,46.49,56671,4007,15,380,3515,23,7940,4.387.738.095
09/02/2021 02:00,46.47,56512,4014,14,368,3450,23,7869,4.387.738.095
09/02/2021 03:00,46.04,56746,4086,12,359,3462,23,7942,4.387.738.095
09/02/2021 04:00,46.42,57757,4082,11,353,3536,23,8005,4.387.738.095
09/02/2021 05:00,48.43,59946,3940,11,345,3514,25,7835,4.387.738.095
09/02/2021 06:00,61.02,63463,3776,10,336,3481,27,7630,4.387.738.095
09/02/2021 07:00,81.32,67044,3836,10,327,3363,25,7561,4.387.738.095
09/02/2021 08:00,105.07,68062,3672,9,312,3162,23,7178,4.387.738.095
09/02/2021 09:00,86.43,68006,3595,6,295,2990,24,6910,4.387.738.095
09/02/2021 10:00,81.31,67817,3599,5,287,3001,23,6915,4.387.738.095
09/02/2021 11:00,75.09,67313,3593,4,272,2743,22,6634,4.387.738.095
09/02/2021 12:00,67.29,66676,3531,4,259,2676,22,6492,4.387.738.095
09/02/2021 13:00,70.14,66233,3442,4,246,2671,23,6386,4.387.738.095
09/02/2021 14:00,69.94,66123,3354,5,231,2671,23,6284,4.387.738.095
09/02/2021 15:00,68.2,66284,3238,8,206,2675,21,6148,4.387.738.095
09/02/2021 16:00,69.18,67184,3118,13,184,2676,20,6011,4.387.738.095
09/02/2021 17:00,81.11,68254,3157,17,172,2661,21,6028,4.387.738.095
09/02/2021 18:00,79.04,67896,3144,22,170,2784,16,6136,4.387.738.095
09/02/2021 19:00,65.34,66964,3023,23,163,2701,14,5924,4.387.738.095
09/02/2021 20:00,62.45,65330,2974,21,155,2687,14,5851,4.387.738.095
09/02/2021 21:00,55.5,63975,2934,22,146,2593,10,5705,4.387.738.095
09/02/2021 22:00,55.87,61995,2861,22,140,2577,10,5610,4.387.738.095
09/02/2021 23:00,49.9,59678,2746,22,139,2611,11,5529,4.387.738.095
10/02/2021 00:00,51.42,57768,2671,28,138,2713,7,5557,4.387.738.095
10/02/2021 01:00,49.52,56888,2682,29,138,2690,7,5546,4.387.738.095
10/02/2021 02:00,48.33,56695,2619,30,133,2760,7,5549,4.387.738.095
10/02/2021 03:00,47.47,56949,2618,32,131,2913,8,5702,4.387.738.095
10/02/2021 04:00,47.67,57891,2619,35,136,3055,7,5852,4.387.738.095
10/02/2021 05:00,49.84,60173,2609,38,138,3221,9,6015,4.387.738.095
10/02/2021 06:00,59.6,63961,2599,41,136,3231,7,6014,4.387.738.095
10/02/2021 07:00,69.9,67650,2652,42,128,3327,5,6154,4.387.738.095
10/02/2021 08:00,89.92,68565,2572,41,115,3241,6,5975,4.387.738.095
10/02/2021 09:00,83.48,68503,2548,37,103,3093,7,5788,4.387.738.095
10/02/2021 10:00,82.92,68291,2487,32,95,2855,7,5476,4.387.738.095
10/02/2021 11:00,80.15,67583,2453,30,90,2706,7,5286,4.387.738.095
10/02/2021 12:00,72.12,66719,2371,31,87,2517,7,5013,4.387.738.095
10/02/2021 13:00,70.26,66141,2255,36,95,2587,8,4981,4.387.738.095
10/02/2021 14:00,67.17,65828,2157,43,105,2705,9,5019,4.387.738.095
10/02/2021 15:00,64.95,66047,2019,51,110,2937,9,5126,4.387.738.095
10/02/2021 16:00,66.99,66947,1827,61,110,3249,9,5256,4.387.738.095
10/02/2021 17:00,73.66,68298,1741,66,111,3467,8,5393,4.387.738.095
10/02/2021 18:00,75.59,68060,1665,66,111,3747,8,5597,4.387.738.095
10/02/2021 19:00,67.2,66989,1578,63,109,3958,7,5715,4.387.738.095
10/02/2021 20:00,61.76,65451,1511,59,108,4127,7,5812,4.387.738.095
10/02/2021 21:00,55.93,64133,1411,55,108,4214,7,5795,4.387.738.095
10/02/2021 22:00,53.63,62296,1268,51,110,4240,7,5676,4.387.738.095
10/02/2021 23:00,51.02,59943,1120,47,116,4256,7,5546,4.387.738.095
11/02/2021 00:00,52.92,58719,1071,51,95,4210,8,5435,4.387.738.095
11/02/2021 01:00,51.55,57900,1102,49,99,4208,7,5465,4.387.738.095
11/02/2021 02:00,50.31,57628,1162,46,103,4165,8,5484,4.387.738.095
11/02/2021 03:00,49.54,57868,1245,44,104,4175,10,5578,4.387.738.095
11/02/2021 04:00,49.43,58890,1374,42,103,4159,11,5689,4.387.738.095
11/02/2021 05:00,53.43,61200,1458,38,104,4243,11,5854,4.387.738.095
11/02/2021 06:00,55.15,65194,1522,34,104,4268,12,5940,4.387.738.095
11/02/2021 07:00,84.55,68958,1549,31,104,4350,12,6046,4.387.738.095
11/02/2021 08:00,164.47,69834,1473,26,102,4281,10,5892,4.387.738.095
11/02/2021 09:00,149.92,69704,1467,19,95,4039,11,5631,4.387.738.095
11/02/2021 10:00,111.7,69264,1535,13,93,3761,12,5414,4.387.738.095
11/02/2021 11:00,97.44,68406,1479,10,109,3351,14,4963,4.387.738.095
11/02/2021 12:00,95.04,67489,1308,10,133,3097,15,4563,4.387.738.095
11/02/2021 13:00,72.04,66871,1214,12,158,3051,16,4451,4.387.738.095
11/02/2021 14:00,77.3,66669,1200,17,165,3134,15,4531,4.387.738.095
11/02/2021 15:00,75.88,66914,1255,26,161,3343,11,4796,4.387.738.095
11/02/2021 16:00,86.46,67971,1227,37,166,3715,8,5153,4.387.738.095
11/02/2021 17:00,80.46,69431,1262,45,178,3857,9,5351,4.387.738.095
11/02/2021 18:00,81.24,69231,1305,50,192,4036,10,5593,4.387.738.095
11/02/2021 19:00,64.95,68154,1277,51,191,4144,12,5675,4.387.738.095
11/02/2021 20:00,52.93,66641,1229,52,187,4330,12,5810,4.387.738.095
11/02/2021 21:00,50.63,65385,1231,50,183,4397,13,5874,4.387.738.095
11/02/2021 22:00,49.46,63409,1139,49,183,4538,14,5923,4.387.738.095
11/02/2021 23:00,47.48,61369,1025,47,182,4673,13,5940,4.387.738.095
12/02/2021 00:00,47.67,59706,954,59,165,4915,10,6103,4.387.738.095
12/02/2021 01:00,46.41,58862,832,62,174,5022,8,6098,4.387.738.095
12/02/2021 02:00,46.19,58617,729,62,180,5165,7,6143,4.387.738.095
12/02/2021 03:00,45.53,58691,654,63,180,5358,8,6263,4.387.738.095
12/02/2021 04:00,45.17,59655,646,65,179,5454,8,6352,4.387.738.095
12/02/2021 05:00,47,61934,659,66,184,5584,8,6501,4.387.738.095
12/02/2021 06:00,49.28,65788,648,67,187,5533,8,6443,4.387.738.095
12/02/2021 07:00,52.46,69298,628,64,184,5636,6,6518,4.387.738.095
12/02/2021 08:00,59.76,70148,578,57,181,5542,6,6364,4.387.738.095
12/02/2021 09:00,57.8,69863,515,52,172,5398,5,6142,4.387.738.095
12/02/2021 10:00,53.3,69181,482,53,158,5201,3,5897,4.387.738.095
12/02/2021 11:00,51.07,68159,489,57,154,5042,4,5746,4.387.738.095
12/02/2021 12:00,49.85,67008,495,62,149,4973,5,5684,4.387.738.095
12/02/2021 13:00,48.19,65692,515,64,147,4806,4,5536,4.387.738.095
12/02/2021 14:00,48.12,64724,538,63,144,4947,4,5696,4.387.738.095
12/02/2021 15:00,48.18,64422,565,62,147,5132,4,5910,4.387.738.095
12/02/2021 16:00,49.11,65304,593,61,170,5338,3,6165,4.387.738.095
12/02/2021 17:00,49.4,66662,673,60,199,5485,4,6421,4.387.738.095
12/02/2021 18:00,49.39,66521,804,58,214,5627,5,6708,4.387.738.095
12/02/2021 19:00,49.41,65135,835,54,216,5699,5,6809,4.387.738.095
12/02/2021 20:00,48.65,63288,816,50,206,5695,6,6773,4.387.738.095
12/02/2021 21:00,47.78,62018,777,45,186,5778,7,6793,4.387.738.095
12/02/2021 22:00,47.67,60452,714,42,165,5640,7,6568,4.387.738.095
12/02/2021 23:00,45.09,58544,645,36,158,5585,9,6433,4.387.738.095
13/02/2021 00:00,44.8,57487,353,23,152,5409,16,5953,4.387.738.095
13/02/2021 01:00,44.7,56617,288,22,171,5256,14,5751,4.387.738.095
13/02/2021 02:00,44.72,56094,258,24,191,5105,18,5596,4.387.738.095
13/02/2021 03:00,44.06,55844,231,26,203,4987,16,5463,4.387.738.095
13/02/2021 04:00,43.1,56633,220,24,209,4865,18,5336,4.387.738.095
13/02/2021 05:00,43.87,57126,198,22,213,4862,23,5318,4.387.738.095
13/02/2021 06:00,43.4,58604,189,20,221,4825,27,5282,4.387.738.095
13/02/2021 07:00,45.91,60008,179,17,227,4847,32,5302,4.387.738.095
13/02/2021 08:00,48.54,61722,153,14,231,4816,34,5248,4.387.738.095
13/02/2021 09:00,49.29,62578,142,11,236,4565,41,4995,4.387.738.095
13/02/2021 10:00,49.46,63206,138,8,253,4593,41,5033,4.387.738.095
13/02/2021 11:00,49.1,62440,120,6,293,4403,39,4861,4.387.738.095
13/02/2021 12:00,47.43,60887,99,6,327,4218,42,4692,4.387.738.095
13/02/2021 13:00,45.17,59733,92,7,348,4144,44,4635,4.387.738.095
13/02/2021 14:00,44.89,59195,89,9,344,4234,39,4715,4.387.738.095
13/02/2021 15:00,46.18,59788,99,11,324,4352,33,4819,4.387.738.095
13/02/2021 16:00,48.17,61045,116,11,309,4676,31,5143,4.387.738.095
13/02/2021 17:00,49.72,63448,139,13,303,4759,27,5241,4.387.738.095
13/02/2021 18:00,49.86,63987,172,17,303,4955,36,5483,4.387.738.095
13/02/2021 19:00,49.74,62490,182,21,300,5018,38,5559,4.387.738.095
13/02/2021 20:00,48.89,60550,181,26,295,5021,36,5559,4.387.738.095
13/02/2021 21:00,47.6,59575,190,30,288,4996,38,5542,4.387.738.095
13/02/2021 22:00,46.97,58300,202,32,284,4910,38,5466,4.387.738.095
13/02/2021 23:00,44.64,56862,223,32,281,4686,34,5256,4.387.738.095
14/02/2021 00:00,44.25,56136,386,33,219,4668,29,5335,4.387.738.095
14/02/2021 01:00,43.9,55432,458,37,224,4460,28,5207,4.387.738.095
14/02/2021 02:00,43.08,55107,502,36,231,4299,34,5102,4.387.738.095
14/02/2021 03:00,42.9,55094,549,37,235,4328,42,5191,4.387.738.095
14/02/2021 04:00,42.37,55244,591,41,243,4187,43,5105,4.387.738.095
14/02/2021 05:00,42.14,55833,595,47,260,3881,42,4825,4.387.738.095
14/02/2021 06:00,42.59,56664,585,50,272,3693,47,4647,4.387.738.095
14/02/2021 07:00,43.68,57799,609,49,267,3337,35,4297,4.387.738.095
14/02/2021 08:00,45.54,59245,642,48,255,2891,43,3879,4.387.738.095
14/02/2021 09:00,46.48,60525,716,46,248,2403,49,3462,4.387.738.095
14/02/2021 10:00,46.31,60948,758,43,243,1967,31,3042,4.387.738.095
14/02/2021 11:00,46,60676,805,38,230,1610,30,2713,4.387.738.095
14/02/2021 12:00,44.86,59960,831,34,208,1350,32,2455,4.387.738.095
14/02/2021 13:00,43.39,59305,832,31,193,1193,37,2286,4.387.738.095
14/02/2021 14:00,42.26,58989,855,29,187,1207,35,2313,4.387.738.095
14/02/2021 15:00,43.44,59430,888,27,183,1303,34,2435,4.387.738.095
14/02/2021 16:00,45.15,60994,963,28,181,1394,34,2600,4.387.738.095
14/02/2021 17:00,51.25,63231,1130,29,190,1511,26,2886,4.387.738.095
14/02/2021 18:00,55.58,63791,1327,30,193,1560,21,3131,4.387.738.095
14/02/2021 19:00,51.17,62886,1408,29,183,1579,12,3211,4.387.738.095
14/02/2021 20:00,46.88,61800,1491,27,173,1474,8,3173,4.387.738.095
14/02/2021 21:00,44.42,61093,1581,22,158,1396,5,3162,4.387.738.095
14/02/2021 22:00,44.51,59788,1669,17,139,1432,3,3260,4.387.738.095
14/02/2021 23:00,41.85,58351,1795,13,129,1456,2,3395,4.387.738.095
15/02/2021 00:00,39.15,57005,2825,23,102,1777,7,4734,4.132.857.143
15/02/2021 01:00,38.37,56342,2864,22,81,1876,7,4850,4.132.857.143
15/02/2021 02:00,37.79,56236,3095,24,66,1951,6,5142,4.132.857.143
15/02/2021 03:00,37.38,56444,3207,26,59,2123,6,5421,4.132.857.143
15/02/2021 04:00,38.41,57395,3313,24,53,2348,6,5744,4.132.857.143
15/02/2021 05:00,43.32,59702,3420,22,49,2532,5,6028,4.132.857.143
15/02/2021 06:00,47.39,63407,3419,20,46,2759,4,6248,4.132.857.143
15/02/2021 07:00,55.63,66643,3351,17,40,2960,3,6371,4.132.857.143
15/02/2021 08:00,61.85,67539,3280,14,30,2956,3,6283,4.132.857.143
15/02/2021 09:00,55.62,67301,3291,11,17,2915,2,6236,4.132.857.143
15/02/2021 10:00,55.55,66979,3278,8,8,2817,2,6113,4.132.857.143
15/02/2021 11:00,55.94,66396,3404,6,6,2505,3,5924,4.132.857.143
15/02/2021 12:00,55.6,65530,3466,6,4,2403,2,5881,4.132.857.143
15/02/2021 13:00,52.54,64761,3567,7,3,2521,3,6101,4.132.857.143
15/02/2021 14:00,51.73,64357,3621,9,2,2533,3,6168,4.132.857.143
15/02/2021 15:00,50.55,64214,3539,11,3,2767,3,6323,4.132.857.143
15/02/2021 16:00,52.54,64747,3305,11,6,3008,4,6334,4.132.857.143
15/02/2021 17:00,62.91,65922,3076,13,11,3163,4,6267,4.132.857.143
15/02/2021 18:00,64.96,65907,2612,17,23,3388,5,6045,4.132.857.143
15/02/2021 19:00,56.55,64950,2190,21,42,3441,6,5700,4.132.857.143
15/02/2021 20:00,55.55,63432,1801,26,63,3473,6,5369,4.132.857.143
15/02/2021 21:00,48.73,62245,1386,30,84,3398,6,4904,4.132.857.143
15/02/2021 22:00,50.3,60142,1037,32,101,3368,7,4545,4.132.857.143
15/02/2021 23:00,46.28,57959,761,32,112,3095,7,4007,4.132.857.143
16/02/2021 00:00,45.18,55776,412,38,90,2986,9,3535,4.132.857.143
16/02/2021 01:00,44.28,54834,287,35,101,2652,9,3084,4.132.857.143
16/02/2021 02:00,43.52,54563,222,32,106,2470,10,2840,4.132.857.143
16/02/2021 03:00,42.22,54792,202,26,106,2177,10,2521,4.132.857.143
16/02/2021 04:00,42.35,55715,223,19,101,1838,11,2192,4.132.857.143
16/02/2021 05:00,44.93,57775,304,14,95,1645,11,2069,4.132.857.143
16/02/2021 06:00,51.8,61192,398,11,93,1488,10,2000,4.132.857.143
16/02/2021 07:00,66.86,64487,506,9,89,1341,10,1955,4.132.857.143
16/02/2021 08:00,71.08,65379,580,7,84,1125,8,1804,4.132.857.143
16/02/2021 09:00,69.75,65412,729,7,73,865,7,1681,4.132.857.143
16/02/2021 10:00,67.12,65256,842,9,57,659,5,1572,4.132.857.143
16/02/2021 11:00,64.07,64808,991,12,47,517,5,1572,4.132.857.143
16/02/2021 12:00,59.87,64194,1187,17,42,490,5,1741,4.132.857.143
16/02/2021 13:00,56.35,63765,1320,23,42,466,6,1857,4.132.857.143
16/02/2021 14:00,54.76,63354,1530,32,43,505,6,2116,4.132.857.143
16/02/2021 15:00,49.84,63527,1731,46,46,663,6,2492,4.132.857.143
16/02/2021 16:00,51.07,64415,1981,63,54,888,5,2991,4.132.857.143
16/02/2021 17:00,55.77,65627,2237,77,62,1135,4,3515,4.132.857.143
16/02/2021 18:00,57.05,65569,2414,87,63,1459,5,4028,4.132.857.143
16/02/2021 19:00,49.97,64702,2391,96,60,1654,5,4206,4.132.857.143
16/02/2021 20:00,48,63193,2287,102,52,1875,5,4321,4.132.857.143
16/02/2021 21:00,47.31,61861,2117,108,40,2016,4,4285,4.132.857.143
16/02/2021 22:00,46.34,59879,1996,116,29,2113,5,4259,4.132.857.143
16/02/2021 23:00,42.93,57709,1939,122,20,2236,5,4322,4.132.857.143
17/02/2021 00:00,41.67,55519,1684,153,13,2457,3,4310,4.132.857.143
17/02/2021 01:00,41.03,54836,1559,155,8,2577,3,4302,4.132.857.143
17/02/2021 02:00,39.56,54683,1520,155,5,2758,5,4443,4.132.857.143
17/02/2021 03:00,37.54,54919,1417,157,7,2825,5,4411,4.132.857.143
17/02/2021 04:00,38.7,55771,1229,162,17,2842,5,4255,4.132.857.143
17/02/2021 05:00,40.05,57806,1159,162,34,2912,6,4273,4.132.857.143
17/02/2021 06:00,42.01,61074,1019,156,53,3025,8,4261,4.132.857.143
17/02/2021 07:00,52.2,64050,999,142,70,2992,10,4213,4.132.857.143
17/02/2021 08:00,56.36,64830,986,122,79,2976,14,4177,4.132.857.143
17/02/2021 09:00,56.38,64872,988,103,79,2858,12,4040,4.132.857.143
17/02/2021 10:00,55.09,64818,895,80,67,2738,9,3789,4.132.857.143
17/02/2021 11:00,50.23,64406,817,61,58,2584,9,3529,4.132.857.143
17/02/2021 12:00,47.29,63896,772,49,58,2488,8,3375,4.132.857.143
17/02/2021 13:00,44.93,63568,667,43,60,2488,8,3266,4.132.857.143
17/02/2021 14:00,46.18,63280,658,46,65,2491,10,3270,4.132.857.143
17/02/2021 15:00,46.9,63384,642,51,77,2614,8,3392,4.132.857.143
17/02/2021 16:00,49.76,64144,792,54,101,2745,7,3699,4.132.857.143
17/02/2021 17:00,55.47,65314,951,60,124,3002,8,4145,4.132.857.143
17/02/2021 18:00,55.21,65258,1078,65,140,3166,10,4459,4.132.857.143
17/02/2021 19:00,50.74,64300,1202,68,144,3343,10,4767,4.132.857.143
17/02/2021 20:00,48.4,62861,1339,69,141,3550,9,5108,4.132.857.143
17/02/2021 21:00,46.2,61695,1438,67,137,3793,10,5445,4.132.857.143
17/02/2021 22:00,45.95,60053,1494,64,131,4084,10,5783,4.132.857.143
17/02/2021 23:00,42.93,58105,1528,59,123,4104,9,5823,4.132.857.143
18/02/2021 00:00,42.01,55679,1842,44,123,4256,7,6272,4.132.857.143
18/02/2021 01:00,40.77,54866,1845,41,123,4319,8,6336,4.132.857.143
18/02/2021 02:00,39.35,54590,1972,38,121,4387,6,6524,4.132.857.143
18/02/2021 03:00,39.06,54687,1963,35,114,4267,6,6385,4.132.857.143
18/02/2021 04:00,38.41,55522,1974,32,101,4483,6,6596,4.132.857.143
18/02/2021 05:00,41.15,57509,2000,30,89,4423,5,6547,4.132.857.143
18/02/2021 06:00,44.5,60835,2076,29,84,4503,5,6697,4.132.857.143
18/02/2021 07:00,51.54,63932,2245,27,82,4433,6,6793,4.132.857.143
18/02/2021 08:00,53.65,64760,2287,23,76,4258,5,6649,4.132.857.143
18/02/2021 09:00,52.17,64756,2387,19,62,3963,4,6435,4.132.857.143
18/02/2021 10:00,48.73,64467,2269,16,51,3701,4,6041,4.132.857.143
18/02/2021 11:00,46.27,63921,2250,17,50,3346,4,5667,4.132.857.143
18/02/2021 12:00,44.5,63205,2288,21,48,3083,5,5445,4.132.857.143
18/02/2021 13:00,43.01,62816,2385,26,48,2949,5,5413,4.132.857.143
18/02/2021 14:00,43.07,62635,2548,30,56,3006,6,5646,4.132.857.143
18/02/2021 15:00,42.2,62556,2765,34,72,3078,5,5954,4.132.857.143
18/02/2021 16:00,42.98,63152,3099,38,99,3193,5,6434,4.132.857.143
18/02/2021 17:00,46,64359,3482,40,143,3381,8,7054,4.132.857.143
18/02/2021 18:00,47.56,64386,3781,38,181,3585,10,7595,4.132.857.143
18/02/2021 19:00,45.26,63164,3902,35,201,3669,13,7820,4.132.857.143
18/02/2021 20:00,41.83,61610,3951,30,212,3692,15,7900,4.132.857.143
18/02/2021 21:00,39.96,60320,3896,26,222,3698,15,7857,4.132.857.143
18/02/2021 22:00,37.65,58436,3839,24,231,3553,14,7661,4.132.857.143
18/02/2021 23:00,36.14,56477,3690,20,239,3415,15,7379,4.132.857.143
19/02/2021 00:00,36.91,53483,3085,12,236,3148,18,6499,4.132.857.143
19/02/2021 01:00,36.79,52494,2619,10,244,3050,15,5938,4.132.857.143
19/02/2021 02:00,36.61,52170,2498,8,246,3031,17,5800,4.132.857.143
19/02/2021 03:00,36.36,52154,2508,5,246,2922,17,5698,4.132.857.143
19/02/2021 04:00,37.88,52938,2307,5,245,2686,16,5259,4.132.857.143
19/02/2021 05:00,39.75,55143,2264,5,250,2444,15,4978,4.132.857.143
19/02/2021 06:00,43.69,58571,2289,5,259,2186,16,4755,4.132.857.143
19/02/2021 07:00,51.93,61765,2292,6,263,2027,18,4606,4.132.857.143
19/02/2021 08:00,56.16,62594,2217,7,249,1835,12,4320,4.132.857.143
19/02/2021 09:00,56.4,62704,2233,8,217,1626,12,4096,4.132.857.143
19/02/2021 10:00,53.95,62541,2105,8,192,1425,12,3742,4.132.857.143
19/02/2021 11:00,48.65,62084,2050,10,174,1175,8,3417,4.132.857.143
19/02/2021 12:00,46.07,61453,1909,11,158,1070,8,3156,4.132.857.143
19/02/2021 13:00,44.17,60568,1783,13,143,1035,5,2979,4.132.857.143
19/02/2021 14:00,44.83,59797,1546,14,126,1044,5,2735,4.132.857.143
19/02/2021 15:00,50.67,59473,1299,18,113,1142,5,2577,4.132.857.143
19/02/2021 16:00,54.05,60061,1294,24,106,1187,5,2616,4.132.857.143
19/02/2021 17:00,57.3,61186,1402,30,99,1256,5,2792,4.132.857.143
19/02/2021 18:00,57.38,61228,1494,34,91,1286,5,2910,4.132.857.143
19/02/2021 19:00,53.82,59915,1527,39,84,1349,5,3004,4.132.857.143
19/02/2021 20:00,47.35,57964,1667,43,77,1357,5,3149,4.132.857.143
19/02/2021 21:00,44.57,56593,1820,45,71,1270,4,3210,4.132.857.143
19/02/2021 22:00,43.7,54985,1982,47,66,1284,4,3383,4.132.857.143
19/02/2021 23:00,40.69,53106,2183,47,62,1416,3,3711,4.132.857.143
20/02/2021 00:00,39.38,50569,2976,33,61,1568,4,4642,4.132.857.143
20/02/2021 01:00,37.62,49556,2806,34,49,1767,4,4660,4.132.857.143
20/02/2021 02:00,36.33,49022,2913,36,48,2033,4,5034,4.132.857.143
20/02/2021 03:00,36.02,48869,2948,43,56,2169,3,5219,4.132.857.143
20/02/2021 04:00,36.03,49087,2882,53,65,2242,3,5245,4.132.857.143
20/02/2021 05:00,34.95,49948,2985,63,70,2525,3,5646,4.132.857.143
20/02/2021 06:00,36.4,50897,3001,68,69,2668,3,5809,4.132.857.143
20/02/2021 07:00,37.16,52366,2903,69,68,2768,3,5811,4.132.857.143
20/02/2021 08:00,38.89,54094,2797,68,71,2923,3,5862,4.132.857.143
20/02/2021 09:00,38.42,55456,2772,67,76,3125,3,6043,4.132.857.143
20/02/2021 10:00,36.58,56000,2533,67,76,3318,3,5997,4.132.857.143
20/02/2021 11:00,35.56,55915,2425,67,70,3367,3,5932,4.132.857.143
20/02/2021 12:00,34.44,55333,2242,66,67,3310,4,5689,4.132.857.143
20/02/2021 13:00,34.42,54558,2131,68,65,3262,3,5529,4.132.857.143
20/02/2021 14:00,34.43,54118,2048,71,61,3171,4,5355,4.132.857.143
20/02/2021 15:00,34.91,54350,2001,77,60,3146,6,5290,4.132.857.143
20/02/2021 16:00,37.54,55684,2193,82,60,3208,8,5551,4.132.857.143
20/02/2021 17:00,40.54,57650,2513,81,64,3275,10,5943,4.132.857.143
20/02/2021 18:00,42.58,58079,2822,79,78,3266,13,6258,4.132.857.143
20/02/2021 19:00,39.73,56481,2850,73,92,3190,13,6218,4.132.857.143
20/02/2021 20:00,36.27,54403,2942,69,103,3040,15,6169,4.132.857.143
20/02/2021 21:00,33.2,53038,3018,62,114,2872,15,6081,4.132.857.143
20/02/2021 22:00,32.82,51542,3031,54,122,2678,18,5903,4.132.857.143
20/02/2021 23:00,31.41,49926,3063,47,132,2469,18,5729,4.132.857.143
21/02/2021 00:00,29.58,47548,3424,63,160,2342,22,6011,4.132.857.143
21/02/2021 01:00,29.1,46665,3156,61,163,2251,19,5650,4.132.857.143
21/02/2021 02:00,28.31,46319,3198,58,159,2159,20,5594,4.132.857.143
21/02/2021 03:00,28.12,46263,3077,55,156,2105,21,5414,4.132.857.143
21/02/2021 04:00,28.28,46464,2846,56,157,2182,23,5264,4.132.857.143
21/02/2021 05:00,29.39,46958,2762,57,158,2301,19,5297,4.132.857.143
21/02/2021 06:00,29.43,47572,2587,59,150,2587,17,5400,4.132.857.143
21/02/2021 07:00,29.95,48661,2260,59,132,2741,15,5207,4.132.857.143
21/02/2021 08:00,31.99,50165,1947,60,111,2977,13,5108,4.132.857.143
21/02/2021 09:00,34.45,51585,1798,60,86,2877,11,4832,4.132.857.143
21/02/2021 10:00,33.26,52262,1418,59,67,2743,10,4297,4.132.857.143
21/02/2021 11:00,33.03,52369,1203,61,60,2691,7,4022,4.132.857.143
21/02/2021 12:00,33.56,51896,992,64,58,2421,7,3542,4.132.857.143
21/02/2021 13:00,33.42,51337,888,69,62,2083,10,3112,4.132.857.143
21/02/2021 14:00,34.16,51301,761,71,68,1922,12,2834,4.132.857.143
21/02/2021 15:00,35.94,51539,656,77,80,2008,13,2834,4.132.857.143
21/02/2021 16:00,40.06,52974,646,87,103,2090,16,2942,4.132.857.143
21/02/2021 17:00,42.51,55202,743,95,125,2361,18,3342,4.132.857.143
21/02/2021 18:00,45.03,56062,857,97,137,2428,19,3538,4.132.857.143
21/02/2021 19:00,43.92,55092,934,89,136,2344,17,3520,4.132.857.143
21/02/2021 20:00,42.18,53585,1014,77,127,2002,19,3239,4.132.857.143
21/02/2021 21:00,40.79,52515,993,65,120,1699,21,2898,4.132.857.143
21/02/2021 22:00,40.85,51037,1015,54,118,1500,20,2707,4.132.857.143
21/02/2021 23:00,39.2,49313,1030,44,116,1268,20,2478,4.132.857.143
22/02/2021 00:00,38.83,47941,573,55,145,1118,16,1907,4.017.797.619
22/02/2021 01:00,38.12,47138,599,56,134,972,14,1775,4.017.797.619
22/02/2021 02:00,36.98,46903,707,55,116,852,14,1744,4.017.797.619
22/02/2021 03:00,36.86,47202,837,54,103,761,10,1765,4.017.797.619
22/02/2021 04:00,37.18,48165,821,51,94,648,9,1623,4.017.797.619
22/02/2021 05:00,39.21,50775,845,51,85,588,7,1576,4.017.797.619
22/02/2021 06:00,46.33,55264,959,49,72,578,6,1664,4.017.797.619
22/02/2021 07:00,51.86,58885,1106,46,58,608,4,1822,4.017.797.619
22/02/2021 08:00,53.55,59857,1146,43,45,628,4,1866,4.017.797.619
22/02/2021 09:00,49.36,59828,1244,39,35,631,3,1952,4.017.797.619
22/02/2021 10:00,45.7,59462,1202,36,25,686,3,1952,4.017.797.619
22/02/2021 11:00,44.57,59119,1173,35,17,689,2,1916,4.017.797.619
22/02/2021 12:00,43.6,58500,1138,33,11,709,2,1893,4.017.797.619
22/02/2021 13:00,42.55,57988,1106,31,9,774,2,1922,4.017.797.619
22/02/2021 14:00,43.57,57773,1081,30,8,912,2,2033,4.017.797.619
22/02/2021 15:00,45.63,57741,1091,30,8,1178,2,2309,4.017.797.619
22/02/2021 16:00,46.75,58240,1230,33,7,1517,2,2789,4.017.797.619
22/02/2021 17:00,48.8,59616,1516,35,6,1891,3,3451,4.017.797.619
22/02/2021 18:00,48.27,59930,1824,37,6,2207,3,4077,4.017.797.619
22/02/2021 19:00,45.66,58855,1934,35,8,2487,4,4468,4.017.797.619
22/02/2021 20:00,42.29,57146,2149,34,10,2671,5,4869,4.017.797.619
22/02/2021 21:00,40.94,55620,2338,34,14,2775,5,5166,4.017.797.619
22/02/2021 22:00,39.98,53367,2442,32,20,2780,5,5279,4.017.797.619
22/02/2021 23:00,37.54,51012,2523,32,26,2860,5,5446,4.017.797.619
23/02/2021 00:00,36.18,49048,2595,44,39,3045,7,5730,4.017.797.619
23/02/2021 01:00,35.26,48164,2279,40,42,3141,7,5509,4.017.797.619
23/02/2021 02:00,35,47837,2068,36,44,3200,7,5355,4.017.797.619
23/02/2021 03:00,35.93,48039,1852,33,47,3220,7,5159,4.017.797.619
23/02/2021 04:00,36.23,48936,1519,31,56,3039,8,4653,4.017.797.619
23/02/2021 05:00,37.69,51199,1303,36,68,2934,9,4350,4.017.797.619
23/02/2021 06:00,39.65,55144,1094,49,73,2791,13,4020,4.017.797.619
23/02/2021 07:00,41.61,58702,1026,57,74,2592,11,3760,4.017.797.619
23/02/2021 08:00,43.1,59580,873,55,75,2454,14,3471,4.017.797.619
23/02/2021 09:00,41.91,59510,798,53,79,2362,15,3307,4.017.797.619
23/02/2021 10:00,41.04,59333,760,55,85,2179,19,3098,4.017.797.619
23/02/2021 11:00,39.94,58850,813,60,92,2116,24,3105,4.017.797.619
23/02/2021 12:00,38.88,57972,852,63,97,1989,23,3024,4.017.797.619
23/02/2021 13:00,38.34,57461,852,65,104,1758,26,2805,4.017.797.619
23/02/2021 14:00,38.55,57069,976,66,114,1458,24,2638,4.017.797.619
23/02/2021 15:00,38.88,57260,1085,66,124,1265,18,2558,4.017.797.619
23/02/2021 16:00,41.22,58030,1309,68,138,1246,10,2771,4.017.797.619
23/02/2021 17:00,43.95,59476,1571,69,156,1317,6,3119,4.017.797.619
23/02/2021 18:00,43.61,59735,1664,67,171,1358,6,3266,4.017.797.619
23/02/2021 19:00,42.65,58608,1755,65,170,1500,4,3494,4.017.797.619
23/02/2021 20:00,40.29,56772,1989,67,160,1790,4,4010,4.017.797.619
23/02/2021 21:00,39.26,55327,2196,72,155,2026,5,4454,4.017.797.619
23/02/2021 22:00,37.6,53102,2412,77,155,2401,6,5051,4.017.797.619
23/02/2021 23:00,34.38,50695,2595,83,145,2856,8,5687,4.017.797.619
24/02/2021 00:00,29.49,48457,3553,92,128,3522,6,7301,4.017.797.619
24/02/2021 01:00,26.6,47627,3630,101,117,4126,5,7979,4.017.797.619
24/02/2021 02:00,24.02,47355,3773,111,114,4547,3,8548,4.017.797.619
24/02/2021 03:00,21.83,47471,3870,120,111,4932,2,9035,4.017.797.619
24/02/2021 04:00,25.11,48265,3826,130,106,5168,2,9232,4.017.797.619
24/02/2021 05:00,28.17,50441,3970,142,101,5499,3,9715,4.017.797.619
24/02/2021 06:00,32.48,54172,4060,158,95,5619,3,9935,4.017.797.619
24/02/2021 07:00,35,57467,4110,175,88,5571,6,9950,4.017.797.619
24/02/2021 08:00,35.71,58161,3948,187,89,5487,6,9717,4.017.797.619
24/02/2021 09:00,34.78,57922,3909,197,95,5501,6,9708,4.017.797.619
24/02/2021 10:00,34.24,57678,3864,203,98,5484,8,9657,4.017.797.619
24/02/2021 11:00,33.07,56869,3861,202,102,5239,11,9415,4.017.797.619
24/02/2021 12:00,32.16,56050,3738,198,116,5120,15,9187,4.017.797.619
24/02/2021 13:00,32.45,55464,3718,190,130,5127,16,9181,4.017.797.619
24/02/2021 14:00,32.94,55025,3565,174,139,5059,17,8954,4.017.797.619
24/02/2021 15:00,33.05,54985,3296,156,157,5108,23,8740,4.017.797.619
24/02/2021 16:00,33.53,55471,3321,136,184,5138,25,8804,4.017.797.619
24/02/2021 17:00,35.64,56867,3320,116,211,5198,23,8868,4.017.797.619
24/02/2021 18:00,35.49,56972,3396,102,228,5274,26,9026,4.017.797.619
24/02/2021 19:00,33.65,55731,3398,96,244,5355,25,9118,4.017.797.619
24/02/2021 20:00,32.81,53906,3474,90,263,5463,23,9313,4.017.797.619
24/02/2021 21:00,31.95,52376,3484,79,280,5563,24,9430,4.017.797.619
24/02/2021 22:00,30.04,50271,3510,70,286,5908,22,9796,4.017.797.619
24/02/2021 23:00,28.18,47963,3497,65,284,5924,25,9795,4.017.797.619
25/02/2021 00:00,24.91,45999,3836,42,320,6198,24,10420,4.017.797.619
25/02/2021 01:00,24.02,45169,3671,40,314,6199,24,10248,4.017.797.619
25/02/2021 02:00,23.67,44798,3623,47,304,6089,23,10086,4.017.797.619
25/02/2021 03:00,24.23,44864,3516,46,297,5955,23,9837,4.017.797.619
25/02/2021 04:00,25.64,45768,3241,31,290,5789,25,9376,4.017.797.619
25/02/2021 05:00,27.8,47878,3181,24,277,5677,26,9185,4.017.797.619
25/02/2021 06:00,30.33,51552,3044,25,259,5519,23,8870,4.017.797.619
25/02/2021 07:00,33.84,54692,3094,30,236,5390,24,8774,4.017.797.619
25/02/2021 08:00,34.41,55583,3119,36,217,5386,23,8781,4.017.797.619
25/02/2021 09:00,34.22,55315,3139,46,192,5268,24,8669,4.017.797.619
25/02/2021 10:00,34.12,55077,3007,66,169,5087,24,8353,4.017.797.619
25/02/2021 11:00,33.59,54562,2810,84,158,4844,28,7924,4.017.797.619
25/02/2021 12:00,32.98,53936,2573,102,154,4734,30,7593,4.017.797.619
25/02/2021 13:00,33.33,53533,2483,123,160,4803,30,7599,4.017.797.619
25/02/2021 14:00,32.91,53268,2480,140,173,4836,25,7654,4.017.797.619
25/02/2021 15:00,32.22,53247,2412,160,198,5024,25,7819,4.017.797.619
25/02/2021 16:00,33.05,53846,2506,175,231,5231,28,8171,4.017.797.619
25/02/2021 17:00,35,55219,2647,181,260,5435,24,8547,4.017.797.619
25/02/2021 18:00,34.97,55576,2687,184,279,5526,25,8701,4.017.797.619
25/02/2021 19:00,33.7,54460,2761,185,295,5611,25,8877,4.017.797.619
25/02/2021 20:00,31.54,52838,2807,183,303,5801,28,9122,4.017.797.619
25/02/2021 21:00,30.56,51485,2718,177,302,6046,31,9274,4.017.797.619
25/02/2021 22:00,28.25,49650,2767,170,304,6182,34,9457,4.017.797.619
25/02/2021 23:00,26.8,47652,2870,158,316,6212,32,9588,4.017.797.619
26/02/2021 00:00,24.75,45517,3485,154,363,6444,39,10485,4.017.797.619
26/02/2021 01:00,24.34,44742,3522,141,366,6682,39,10750,4.017.797.619
26/02/2021 02:00,23.27,44594,3592,128,378,6774,43,10915,4.017.797.619
26/02/2021 03:00,24.1,44778,3663,120,390,6746,44,10963,4.017.797.619
26/02/2021 04:00,24.96,45691,3593,117,390,6915,40,11055,4.017.797.619
26/02/2021 05:00,26.99,48170,3613,118,381,6905,34,11051,4.017.797.619
26/02/2021 06:00,29.4,51885,3578,119,365,6999,30,11091,4.017.797.619
26/02/2021 07:00,32.47,55235,3617,119,351,7146,28,11261,4.017.797.619
26/02/2021 08:00,33.92,56045,3585,120,349,7029,30,11113,4.017.797.619
26/02/2021 09:00,33.08,55751,3716,121,362,6925,31,11155,4.017.797.619
26/02/2021 10:00,31.45,55225,3731,124,386,6832,34,11107,4.017.797.619
26/02/2021 11:00,29.42,54386,3819,128,403,6790,36,11176,4.017.797.619
26/02/2021 12:00,27.94,53584,3828,131,408,6870,34,11271,4.017.797.619
26/02/2021 13:00,27.52,52648,3891,135,409,7024,31,11490,4.017.797.619
26/02/2021 14:00,26.76,51885,3926,143,403,7094,31,11597,4.017.797.619
26/02/2021 15:00,26.95,51699,3793,155,392,7059,31,11430,4.017.797.619
26/02/2021 16:00,27.92,52359,3847,168,384,7088,33,11520,4.017.797.619
26/02/2021 17:00,30.11,53942,3803,172,372,6988,33,11368,4.017.797.619
26/02/2021 18:00,31.4,54557,3568,173,349,6804,33,10927,4.017.797.619
26/02/2021 19:00,29.4,53355,3427,176,321,6632,31,10587,4.017.797.619
26/02/2021 20:00,27.57,51348,3197,180,299,6478,32,10186,4.017.797.619
26/02/2021 21:00,27.16,49951,2857,188,287,6130,30,9492,4.017.797.619
26/02/2021 22:00,26.51,48446,2633,191,275,5877,30,9006,4.017.797.619
26/02/2021 23:00,25.57,46733,2335,185,266,5513,27,8326,4.017.797.619
27/02/2021 00:00,26.35,45065,2200,33,246,5335,30,7844,4.017.797.619
27/02/2021 01:00,26.47,44378,1900,33,271,5033,30,7267,4.017.797.619
27/02/2021 02:00,26.94,44117,1827,33,304,4663,32,6859,4.017.797.619
27/02/2021 03:00,27.25,44122,1759,35,330,4321,30,6475,4.017.797.619
27/02/2021 04:00,27.9,44556,1520,39,347,4024,36,5966,4.017.797.619
27/02/2021 05:00,28.82,45442,1229,43,355,3596,36,5259,4.017.797.619
27/02/2021 06:00,30.51,46422,952,46,354,3254,35,4641,4.017.797.619
27/02/2021 07:00,31.73,47957,864,47,345,2940,37,4233,4.017.797.619
27/02/2021 08:00,33.85,49562,751,48,334,2688,37,3858,4.017.797.619
27/02/2021 09:00,36.23,50620,735,48,330,2543,39,3695,4.017.797.619
27/02/2021 10:00,36.32,50864,657,44,336,2374,39,3450,4.017.797.619
27/02/2021 11:00,35.83,50351,641,42,330,2650,39,3702,4.017.797.619
27/02/2021 12:00,33.97,49428,741,40,326,2934,38,4079,4.017.797.619
27/02/2021 13:00,31.87,48513,851,40,307,3324,27,4549,4.017.797.619
27/02/2021 14:00,31.27,47957,944,42,285,3793,20,5084,4.017.797.619
27/02/2021 15:00,30.86,48188,1013,47,261,4280,18,5619,4.017.797.619
27/02/2021 16:00,31.17,49619,1144,55,233,4776,17,6225,4.017.797.619
27/02/2021 17:00,32.34,51948,1275,62,209,5266,12,6824,4.017.797.619
27/02/2021 18:00,33.38,52858,1338,70,188,5542,10,7148,4.017.797.619
27/02/2021 19:00,31.38,51424,1345,80,173,5803,10,7411,4.017.797.619
27/02/2021 20:00,30.03,49306,1372,92,154,5881,7,7506,4.017.797.619
27/02/2021 21:00,29.34,48174,1364,106,137,5905,5,7517,4.017.797.619
27/02/2021 22:00,28.52,47028,1390,120,126,6003,6,7645,4.017.797.619
27/02/2021 23:00,27.41,45617,1357,132,119,6031,9,7648,4.017.797.619
28/02/2021 00:00,26.93,44251,1872,172,128,6058,9,8239,4.017.797.619
28/02/2021 01:00,26.14,43354,1797,172,126,5992,7,8094,4.017.797.619
28/02/2021 02:00,25.81,42914,1954,166,137,5889,10,8156,4.017.797.619
28/02/2021 03:00,25.76,42873,1983,157,159,5899,13,8211,4.017.797.619
28/02/2021 04:00,25.96,43087,1866,142,185,5778,16,7987,4.017.797.619
28/02/2021 05:00,26.24,43668,1660,127,208,5658,16,7669,4.017.797.619
28/02/2021 06:00,26.75,44380,1406,114,223,5651,13,7407,4.017.797.619
28/02/2021 07:00,27.3,45387,1284,97,226,5678,14,7299,4.017.797.619
28/02/2021 08:00,28.58,46824,1215,80,219,5598,13,7125,4.017.797.619
28/02/2021 09:00,29.67,47975,1246,63,210,5325,12,6856,4.017.797.619
28/02/2021 10:00,30.05,48258,1222,46,210,4953,13,6444,4.017.797.619
28/02/2021 11:00,29.18,48114,1149,33,214,4911,11,6318,4.017.797.619
28/02/2021 12:00,27.22,47371,1042,25,210,4732,14,6023,4.017.797.619
28/02/2021 13:00,25.55,46692,1014,20,199,4657,14,5904,4.017.797.619
28/02/2021 14:00,24.94,46490,999,20,184,4431,11,5645,4.017.797.619
28/02/2021 15:00,26.07,46732,957,22,171,4411,11,5572,4.017.797.619
28/02/2021 16:00,28.12,48050,954,27,167,4422,11,5581,4.017.797.619
28/02/2021 17:00,31.17,50497,964,34,181,4600,11,5790,4.017.797.619
28/02/2021 18:00,32.68,51796,927,40,192,4788,13,5960,4.017.797.619
28/02/2021 19:00,31.66,51099,1001,46,199,4689,11,5946,4.017.797.619
28/02/2021 20:00,30.56,49699,1126,52,199,4726,9,6112,4.017.797.619
28/02/2021 21:00,29.91,48883,1167,56,183,4798,10,6214,4.017.797.619
28/02/2021 22:00,28.68,47567,1205,57,158,4864,12,6296,4.017.797.619
28/02/2021 23:00,27.82,45973,1153,51,128,4764,11,6107,4.017.797.619
01/03/2021 00:00,26.95,44440,1444,219,58,5075,6,6802,3.838.095.238
01/03/2021 01:00,26.59,43767,1425,225,34,5165,4,6853,3.838.095.238
01/03/2021 02:00,26.24,43578,1488,228,26,5291,4,7037,3.838.095.238
01/03/2021 03:00,26.98,43915,1510,227,31,5431,6,7205,3.838.095.238
01/03/2021 04:00,28.47,44955,1507,228,39,5596,6,7376,3.838.095.238
01/03/2021 05:00,31.11,47456,1529,226,47,5733,7,7542,3.838.095.238
01/03/2021 06:00,33.16,51378,1546,220,57,5824,12,7659,3.838.095.238
01/03/2021 07:00,35.77,54591,1610,205,64,5786,10,7675,3.838.095.238
01/03/2021 08:00,37.64,55340,1624,184,63,5565,8,7444,3.838.095.238
01/03/2021 09:00,36.88,55082,1535,161,60,5309,9,7074,3.838.095.238
01/03/2021 10:00,35.93,54469,1403,142,68,5084,9,6706,3.838.095.238
01/03/2021 11:00,35.04,53789,1256,129,97,4980,14,6476,3.838.095.238
01/03/2021 12:00,34.89,53020,1127,114,143,4965,15,6364,3.838.095.238
01/03/2021 13:00,34.59,52337,1096,104,188,4935,14,6337,3.838.095.238
01/03/2021 14:00,34.47,51972,1079,101,212,4882,12,6286,3.838.095.238
01/03/2021 15:00,33.98,51966,1036,104,228,4897,10,6275,3.838.095.238
01/03/2021 16:00,34.11,52436,1113,109,250,5084,8,6564,3.838.095.238
01/03/2021 17:00,35.63,53902,1233,115,267,5385,9,7009,3.838.095.238
01/03/2021 18:00,36.67,54692,1261,120,276,5661,12,7330,3.838.095.238
01/03/2021 19:00,35.19,53935,1230,128,270,5788,11,7427,3.838.095.238
01/03/2021 20:00,33.59,52234,1221,139,263,5891,10,7524,3.838.095.238
01/03/2021 21:00,32.37,50944,1192,152,258,6019,11,7632,3.838.095.238
01/03/2021 22:00,31,48978,1202,160,248,6167,10,7787,3.838.095.238
01/03/2021 23:00,28.5,46883,1211,167,239,6317,11,7945,3.838.095.238
02/03/2021 00:00,28.47,44888,1163,70,260,6421,19,7933,3.838.095.238
02/03/2021 01:00,28.37,44091,1083,70,266,6337,23,7779,3.838.095.238
02/03/2021 02:00,28.27,43957,1017,75,268,6225,22,7607,3.838.095.238
02/03/2021 03:00,28.51,44184,957,82,267,6074,23,7403,3.838.095.238
02/03/2021 04:00,29.57,45116,926,90,265,5837,25,7143,3.838.095.238
02/03/2021 05:00,32.27,47270,872,92,263,5512,22,6761,3.838.095.238
02/03/2021 06:00,35.52,50933,781,97,258,5225,20,6381,3.838.095.238
02/03/2021 07:00,38.95,54006,737,97,238,4885,19,5976,3.838.095.238
02/03/2021 08:00,40.09,54742,674,93,214,4404,17,5402,3.838.095.238
02/03/2021 09:00,39.78,54421,624,90,189,3970,12,4885,3.838.095.238
02/03/2021 10:00,39.11,53828,539,94,171,3765,16,4585,3.838.095.238
02/03/2021 11:00,37.67,52881,423,104,158,3777,15,4477,3.838.095.238
02/03/2021 12:00,37.03,51956,334,117,155,3752,14,4372,3.838.095.238
02/03/2021 13:00,36.13,51223,305,122,164,3758,12,4361,3.838.095.238
02/03/2021 14:00,35.7,50802,256,123,172,3675,12,4238,3.838.095.238
02/03/2021 15:00,35.45,50851,243,117,174,3543,11,4088,3.838.095.238
02/03/2021 16:00,36.69,51491,219,116,180,3556,11,4082,3.838.095.238
02/03/2021 17:00,38.97,52975,195,121,196,3689,14,4215,3.838.095.238
02/03/2021 18:00,39.85,53800,211,126,196,3829,15,4377,3.838.095.238
02/03/2021 19:00,39.22,53199,219,128,177,3881,16,4421,3.838.095.238
02/03/2021 20:00,36.99,51620,227,127,151,3864,13,4382,3.838.095.238
02/03/2021 21:00,35.34,50306,200,122,131,3855,10,4318,3.838.095.238
02/03/2021 22:00,34.48,48503,192,117,113,3810,7,4239,3.838.095.238
02/03/2021 23:00,32.84,46514,199,113,94,3790,4,4200,3.838.095.238
03/03/2021 00:00,30.31,45506,232,114,55,3860,6,4267,3.838.095.238
03/03/2021 01:00,30.21,44787,235,116,61,3944,6,4362,3.838.095.238
03/03/2021 02:00,29.8,44545,228,123,65,4059,9,4484,3.838.095.238
03/03/2021 03:00,29.94,44726,228,132,74,4223,11,4668,3.838.095.238
03/03/2021 04:00,32.07,45597,240,139,75,4348,12,4814,3.838.095.238
03/03/2021 05:00,33.6,47799,234,149,74,4378,10,4845,3.838.095.238
03/03/2021 06:00,37.27,51470,214,156,74,4341,10,4795,3.838.095.238
03/03/2021 07:00,40.94,54589,209,152,74,4233,10,4678,3.838.095.238
03/03/2021 08:00,42.44,55398,214,146,76,4075,12,4523,3.838.095.238
03/03/2021 09:00,42.35,55151,226,149,78,3929,14,4396,3.838.095.238
03/03/2021 10:00,40.54,54759,251,154,86,3827,14,4332,3.838.095.238
03/03/2021 11:00,37.58,54040,276,153,94,3860,17,4400,3.838.095.238
03/03/2021 12:00,36.95,53255,289,149,98,3963,15,4514,3.838.095.238
03/03/2021 13:00,36.04,52662,393,150,111,4065,14,4733,3.838.095.238
03/03/2021 14:00,36.04,52296,480,155,126,4135,12,4908,3.838.095.238
03/03/2021 15:00,36.39,52362,591,163,140,4188,12,5094,3.838.095.238
03/03/2021 16:00,36.93,52856,720,173,149,4255,13,5310,3.838.095.238
03/03/2021 17:00,39.14,54362,805,175,158,4376,14,5528,3.838.095.238
03/03/2021 18:00,39.61,55055,938,172,165,4544,14,5833,3.838.095.238
03/03/2021 19:00,37.37,54266,1121,169,160,4650,14,6114,3.838.095.238
03/03/2021 20:00,34.48,52761,1364,160,151,4684,12,6371,3.838.095.238
03/03/2021 21:00,33.79,51607,1572,148,149,4700,11,6580,3.838.095.238
03/03/2021 22:00,32.96,49825,1611,139,157,4731,10,6648,3.838.095.238
03/03/2021 23:00,29.92,47788,1603,135,152,4816,10,6716,3.838.095.238
04/03/2021 00:00,29.26,46558,1536,126,120,4782,9,6573,3.838.095.238
04/03/2021 01:00,29.26,45977,1643,125,114,4924,8,6814,3.838.095.238
04/03/2021 02:00,29.3,45914,1697,120,106,5088,8,7019,3.838.095.238
04/03/2021 03:00,29.45,46152,1794,112,99,5194,7,7206,3.838.095.238
04/03/2021 04:00,30.76,47100,1738,106,99,5243,8,7194,3.838.095.238
04/03/2021 05:00,32.69,49225,1814,101,104,5248,10,7277,3.838.095.238
04/03/2021 06:00,35.87,52901,1842,98,107,5198,9,7254,3.838.095.238
04/03/2021 07:00,39.14,56105,1927,95,103,5047,10,7182,3.838.095.238
04/03/2021 08:00,40.34,57178,2014,87,105,4711,10,6927,3.838.095.238
04/03/2021 09:00,39.74,56922,2136,81,111,4406,14,6748,3.838.095.238
04/03/2021 10:00,39.25,56457,2068,82,128,4267,16,6561,3.838.095.238
04/03/2021 11:00,38.85,55824,1902,92,144,4177,18,6333,3.838.095.238
04/03/2021 12:00,38.57,54946,1783,102,159,4022,21,6087,3.838.095.238
04/03/2021 13:00,38.44,54343,1842,110,175,3893,19,6039,3.838.095.238
04/03/2021 14:00,38.57,54026,1805,121,174,3781,22,5903,3.838.095.238
04/03/2021 15:00,38.5,53956,1702,130,163,3600,21,5616,3.838.095.238
04/03/2021 16:00,38.74,54565,1698,140,150,3451,17,5456,3.838.095.238
04/03/2021 17:00,40.21,56287,1606,143,141,3545,16,5451,3.838.095.238
04/03/2021 18:00,41.03,57175,1545,137,142,3819,21,5664,3.838.095.238
04/03/2021 19:00,38.99,56366,1426,129,139,3997,20,5711,3.838.095.238
04/03/2021 20:00,37.11,54882,1285,120,130,4079,22,5636,3.838.095.238
04/03/2021 21:00,36.19,53681,1026,112,121,4099,18,5376,3.838.095.238
04/03/2021 22:00,35.31,51891,841,100,112,4072,17,5142,3.838.095.238
04/03/2021 23:00,34.24,50197,684,91,102,4034,19,4930,3.838.095.238
05/03/2021 00:00,33.67,49298,614,98,84,4343,12,5151,3.838.095.238
05/03/2021 01:00,33.39,48704,608,93,82,4298,9,5090,3.838.095.238
05/03/2021 02:00,33.39,48624,537,91,88,4207,9,4932,3.838.095.238
05/03/2021 03:00,33.94,48931,508,88,97,4111,7,4811,3.838.095.238
05/03/2021 04:00,35.38,49885,528,85,95,3985,9,4702,3.838.095.238
05/03/2021 05:00,38.43,52106,529,84,83,3838,5,4539,3.838.095.238
05/03/2021 06:00,40.92,55710,526,86,73,3690,6,4381,3.838.095.238
05/03/2021 07:00,42.38,58795,576,86,59,3392,6,4119,3.838.095.238
05/03/2021 08:00,45.16,59713,542,85,48,2833,5,3513,3.838.095.238
05/03/2021 09:00,46.85,59310,482,83,45,2278,4,2892,3.838.095.238
05/03/2021 10:00,47.35,58494,507,80,60,1958,5,2610,3.838.095.238
05/03/2021 11:00,44.43,57436,547,76,76,1845,14,2558,3.838.095.238
05/03/2021 12:00,42.62,56508,543,72,99,1805,19,2538,3.838.095.238
05/03/2021 13:00,41.38,55613,572,68,133,1809,22,2604,3.838.095.238
05/03/2021 14:00,40.51,54782,586,65,164,1823,13,2651,3.838.095.238
05/03/2021 15:00,40.68,54482,545,64,172,1835,13,2629,3.838.095.238
05/03/2021 16:00,40.68,55039,506,73,152,1972,13,2716,3.838.095.238
05/03/2021 17:00,40.86,56693,458,86,135,2397,10,3086,3.838.095.238
05/03/2021 18:00,40.73,57748,458,93,135,2996,9,3691,3.838.095.238
05/03/2021 19:00,39.83,56916,422,95,140,3532,8,4197,3.838.095.238
05/03/2021 20:00,37.7,55196,390,94,142,3986,7,4619,3.838.095.238
05/03/2021 21:00,35.22,53846,360,92,139,4389,6,4986,3.838.095.238
05/03/2021 22:00,33.92,52268,361,91,125,4757,5,5339,3.838.095.238
05/03/2021 23:00,31.87,50573,429,86,105,5091,5,5716,3.838.095.238
06/03/2021 00:00,29.69,49179,937,176,83,5186,4,6386,3.838.095.238
06/03/2021 01:00,29.34,48275,1240,178,68,5446,4,6936,3.838.095.238
06/03/2021 02:00,28.96,47843,1635,178,56,5670,5,7544,3.838.095.238
06/03/2021 03:00,27.85,47778,1946,179,50,5853,6,8034,3.838.095.238
06/03/2021 04:00,27.92,48112,2346,175,50,5971,9,8551,3.838.095.238
06/03/2021 05:00,27.94,48710,2783,173,58,6074,11,9099,3.838.095.238
06/03/2021 06:00,28.45,49522,2927,170,71,6215,17,9400,3.838.095.238
06/03/2021 07:00,28.64,50638,3180,163,91,6340,20,9794,3.838.095.238
06/03/2021 08:00,29.08,52154,3292,150,110,6408,27,9987,3.838.095.238
06/03/2021 09:00,29.21,53055,3511,136,145,6519,32,10343,3.838.095.238
06/03/2021 10:00,29.05,53104,3739,122,224,6812,35,10932,3.838.095.238
06/03/2021 11:00,27.76,52677,3839,111,305,7254,36,11545,3.838.095.238
06/03/2021 12:00,26.78,51870,3953,105,359,7624,37,12078,3.838.095.238
06/03/2021 13:00,26.34,51084,4275,100,400,7880,37,12692,3.838.095.238
06/03/2021 14:00,25.93,50623,4219,95,422,7997,37,12770,3.838.095.238
06/03/2021 15:00,25.9,50768,4151,95,428,8031,36,12741,3.838.095.238
06/03/2021 16:00,26.41,51696,4478,99,424,8070,36,13107,3.838.095.238
06/03/2021 17:00,28.93,53749,4448,96,427,8144,36,13151,3.838.095.238
06/03/2021 18:00,29.19,54848,4325,88,433,8251,36,13133,3.838.095.238
06/03/2021 19:00,28.54,53701,4241,78,435,8287,36,13077,3.838.095.238
06/03/2021 20:00,26.72,51960,4297,68,440,8195,36,13036,3.838.095.238
06/03/2021 21:00,26.37,50831,4250,63,445,7950,37,12745,3.838.095.238
06/03/2021 22:00,26.27,49730,4241,63,450,7675,37,12466,3.838.095.238
06/03/2021 23:00,25.47,48498,4183,68,453,7478,37,12219,3.838.095.238
07/03/2021 00:00,24.4,47455,4468,114,462,7699,41,12784,3.838.095.238
07/03/2021 01:00,24.37,46830,4559,129,469,7680,42,12879,3.838.095.238
07/03/2021 02:00,24.31,46612,4608,138,467,7682,31,12926,3.838.095.238
07/03/2021 03:00,24.39,46698,4728,144,460,7657,27,13016,3.838.095.238
07/03/2021 04:00,24.7,47095,4726,148,451,7613,30,12968,3.838.095.238
07/03/2021 05:00,25.25,47735,4819,153,435,7552,39,12998,3.838.095.238
07/03/2021 06:00,26.05,48427,4418,155,413,7493,40,12519,3.838.095.238
07/03/2021 07:00,26.13,49449,4164,150,397,7445,43,12199,3.838.095.238
07/03/2021 08:00,27.59,50971,3624,139,385,7367,43,11558,3.838.095.238
07/03/2021 09:00,28.73,52204,3105,126,375,7329,43,10978,3.838.095.238
07/03/2021 10:00,28.95,52528,2693,114,381,7343,43,10574,3.838.095.238
07/03/2021 11:00,29.09,52485,2256,102,397,7327,42,10124,3.838.095.238
07/03/2021 12:00,28.93,52155,1843,90,417,7218,41,9609,3.838.095.238
07/03/2021 13:00,28.27,51746,1717,82,411,7039,42,9291,3.838.095.238
07/03/2021 14:00,29.11,51634,1572,74,383,6758,41,8828,3.838.095.238
07/03/2021 15:00,29.95,52016,1418,72,349,6361,41,8241,3.838.095.238
07/03/2021 16:00,32.54,53019,1386,75,321,5957,41,7780,3.838.095.238
07/03/2021 17:00,35.43,55001,1107,73,306,5701,42,7229,3.838.095.238
07/03/2021 18:00,38.04,56317,928,67,299,5544,40,6878,3.838.095.238
07/03/2021 19:00,39.17,55820,827,68,294,5380,39,6608,3.838.095.238
07/03/2021 20:00,37.81,54467,755,79,278,5177,40,6329,3.838.095.238
07/03/2021 21:00,37.55,53600,658,87,259,4922,37,5963,3.838.095.238
07/03/2021 22:00,36.76,52417,583,88,227,4631,34,5563,3.838.095.238
07/03/2021 23:00,36.13,51041,465,87,207,4332,27,5118,3.838.095.238
08/03/2021 00:00,35.79,49498,410,100,342,4107,31,4990,3.632.857.143
08/03/2021 01:00,35.17,48942,354,90,323,3799,28,4594,3.632.857.143
08/03/2021 02:00,35.32,48859,292,83,287,3495,22,4179,3.632.857.143
08/03/2021 03:00,36.09,49324,235,75,248,3184,23,3765,3.632.857.143
08/03/2021 04:00,37.74,50456,211,67,201,2850,22,3351,3.632.857.143
08/03/2021 05:00,40.76,52787,206,60,157,2494,23,2940,3.632.857.143
08/03/2021 06:00,50.07,56797,188,52,123,2170,20,2553,3.632.857.143
08/03/2021 07:00,64,60030,165,45,102,1820,19,2151,3.632.857.143
08/03/2021 08:00,79.25,60762,125,42,114,1462,16,1759,3.632.857.143
08/03/2021 09:00,56.26,60273,94,42,148,1212,16,1512,3.632.857.143
08/03/2021 10:00,55.1,59307,98,41,167,1118,18,1442,3.632.857.143
08/03/2021 11:00,50.11,58463,89,41,168,1138,13,1449,3.632.857.143
08/03/2021 12:00,48.48,57645,79,46,167,1199,13,1504,3.632.857.143
08/03/2021 13:00,45.11,56981,113,53,169,1259,13,1607,3.632.857.143
08/03/2021 14:00,44.04,56601,150,62,166,1329,15,1722,3.632.857.143
08/03/2021 15:00,44,56598,152,68,158,1446,15,1839,3.632.857.143
08/03/2021 16:00,44.58,57114,185,67,134,1637,15,2038,3.632.857.143
08/03/2021 17:00,45.36,58566,189,63,108,1923,9,2292,3.632.857.143
08/03/2021 18:00,45.72,59613,230,61,97,2232,5,2625,3.632.857.143
08/03/2021 19:00,45.92,59184,255,57,98,2377,4,2791,3.632.857.143
08/03/2021 20:00,43.15,57560,282,48,96,2413,3,2842,3.632.857.143
08/03/2021 21:00,42.25,56200,278,37,86,2435,2,2838,3.632.857.143
08/03/2021 22:00,40.33,54304,310,30,67,2430,2,2839,3.632.857.143
08/03/2021 23:00,37.64,52199,405,23,48,2438,1,2915,3.632.857.143
09/03/2021 00:00,37.65,50299,610,155,37,2478,1,3281,3.632.857.143
09/03/2021 01:00,37.12,49500,610,153,24,2560,2,3349,3.632.857.143
09/03/2021 02:00,36.67,49322,586,148,16,2660,2,3412,3.632.857.143
09/03/2021 03:00,36.84,49576,552,139,12,2767,5,3475,3.632.857.143
09/03/2021 04:00,37.64,50495,527,128,11,2803,6,3475,3.632.857.143
09/03/2021 05:00,39.83,52453,511,113,15,2769,4,3412,3.632.857.143
09/03/2021 06:00,43.94,55963,468,94,25,2729,5,3321,3.632.857.143
09/03/2021 07:00,52.11,59203,399,77,33,2583,6,3098,3.632.857.143
09/03/2021 08:00,55.69,59962,349,62,34,2321,9,2775,3.632.857.143
09/03/2021 09:00,54.47,59545,312,52,34,2168,13,2579,3.632.857.143
09/03/2021 10:00,51.09,59038,282,46,43,2137,19,2527,3.632.857.143
09/03/2021 11:00,50.03,58299,271,43,60,2117,23,2514,3.632.857.143
09/03/2021 12:00,49.13,57530,242,40,76,2096,27,2481,3.632.857.143
09/03/2021 13:00,48.45,56991,197,38,89,2058,30,2412,3.632.857.143
09/03/2021 14:00,48.61,56631,180,38,98,1983,29,2328,3.632.857.143
09/03/2021 15:00,49.28,56644,143,37,101,1902,30,2213,3.632.857.143
09/03/2021 16:00,49.71,56929,120,34,99,1828,28,2109,3.632.857.143
09/03/2021 17:00,55.13,58288,119,29,98,1817,29,2092,3.632.857.143
09/03/2021 18:00,55.37,59122,137,23,103,1874,27,2164,3.632.857.143
09/03/2021 19:00,52.53,58639,158,19,112,1923,25,2237,3.632.857.143
09/03/2021 20:00,44.11,57218,158,13,123,1939,23,2256,3.632.857.143
09/03/2021 21:00,41.78,55930,155,9,134,1922,19,2239,3.632.857.143
09/03/2021 22:00,39.49,54056,165,7,144,1861,15,2192,3.632.857.143
09/03/2021 23:00,38.48,52121,195,6,153,1770,8,2132,3.632.857.143
10/03/2021 00:00,37.23,50452,304,7,193,1860,10,2374,3.632.857.143
10/03/2021 01:00,36.41,49846,373,13,202,1854,11,2453,3.632.857.143
10/03/2021 02:00,35.98,49743,473,22,199,1898,10,2602,3.632.857.143
10/03/2021 03:00,35.66,50010,624,31,195,1995,9,2854,3.632.857.143
10/03/2021 04:00,36.77,50913,852,46,190,2118,8,3214,3.632.857.143
10/03/2021 05:00,39.11,53026,1126,62,179,2262,4,3633,3.632.857.143
10/03/2021 06:00,40.56,56725,1355,72,159,2432,4,4022,3.632.857.143
10/03/2021 07:00,43.87,60005,1552,70,127,2572,3,4324,3.632.857.143
10/03/2021 08:00,45.61,61183,1774,64,101,2628,3,4570,3.632.857.143
10/03/2021 09:00,43.13,60960,2101,67,86,2771,4,5029,3.632.857.143
10/03/2021 10:00,41.26,60570,2522,76,84,2954,4,5640,3.632.857.143
10/03/2021 11:00,40.39,59928,3080,82,85,3101,4,6352,3.632.857.143
10/03/2021 12:00,39.75,59186,3364,85,86,3258,3,6796,3.632.857.143
10/03/2021 13:00,39.05,58688,3517,83,79,3439,3,7121,3.632.857.143
10/03/2021 14:00,38.66,58396,3696,78,64,3655,3,7496,3.632.857.143
10/03/2021 15:00,38.51,58592,3669,77,53,3874,3,7676,3.632.857.143
10/03/2021 16:00,37.69,59058,3862,84,47,4195,3,8191,3.632.857.143
10/03/2021 17:00,37.78,60619,4099,95,46,4705,3,8948,3.632.857.143
10/03/2021 18:00,37.38,61493,4272,107,43,5288,2,9712,3.632.857.143
10/03/2021 19:00,35.46,60788,4596,122,39,5737,2,10496,3.632.857.143
10/03/2021 20:00,32.86,59425,4866,136,34,6019,2,11057,3.632.857.143
10/03/2021 21:00,31.82,58098,4951,143,29,6212,2,11337,3.632.857.143
10/03/2021 22:00,29.08,55985,4992,148,26,6347,1,11514,3.632.857.143
10/03/2021 23:00,25.61,53847,5016,149,21,6483,1,11670,3.632.857.143
11/03/2021 00:00,22.91,52382,5235,193,62,6732,1,12223,3.632.857.143
11/03/2021 01:00,19.04,51713,5275,194,75,6901,2,12447,3.632.857.143
11/03/2021 02:00,15.21,51514,5198,189,87,7116,2,12592,3.632.857.143
11/03/2021 03:00,15.49,51702,5383,185,105,7328,3,13004,3.632.857.143
11/03/2021 04:00,18.15,52516,5481,179,131,7526,6,13323,3.632.857.143
11/03/2021 05:00,22.98,54397,5530,170,162,7723,7,13592,3.632.857.143
11/03/2021 06:00,26.18,57837,5467,161,193,7889,10,13720,3.632.857.143
11/03/2021 07:00,29.03,60988,5593,149,208,7997,14,13961,3.632.857.143
11/03/2021 08:00,31.87,62045,5488,140,222,7997,13,13860,3.632.857.143
11/03/2021 09:00,31.73,61821,5492,133,257,7996,15,13893,3.632.857.143
11/03/2021 10:00,29.74,61632,5247,125,311,8005,24,13712,3.632.857.143
11/03/2021 11:00,29.53,61305,5178,119,363,7980,30,13670,3.632.857.143
11/03/2021 12:00,29.73,60680,4996,115,406,7955,31,13503,3.632.857.143
11/03/2021 13:00,27.63,60257,5095,109,433,7935,33,13605,3.632.857.143
11/03/2021 14:00,27.45,59853,5095,101,444,7891,33,13564,3.632.857.143
11/03/2021 15:00,27.51,59559,4843,96,449,7838,37,13263,3.632.857.143
11/03/2021 16:00,27.95,59610,4853,95,452,7749,38,13187,3.632.857.143
11/03/2021 17:00,31.65,60715,5022,95,457,7637,38,13249,3.632.857.143
11/03/2021 18:00,33.9,61321,5118,96,462,7467,38,13181,3.632.857.143
11/03/2021 19:00,29.06,60315,5377,94,461,7294,38,13264,3.632.857.143
11/03/2021 20:00,27.13,58494,5536,93,460,7088,38,13215,3.632.857.143
11/03/2021 21:00,26.86,56834,5387,93,458,6817,38,12793,3.632.857.143
11/03/2021 22:00,25.2,54715,5308,92,455,6517,37,12409,3.632.857.143
11/03/2021 23:00,21.03,52639,5154,85,450,6279,37,12005,3.632.857.143
12/03/2021 00:00,22.65,49705,4521,84,452,5792,35,10884,3.632.857.143
12/03/2021 01:00,21.76,48744,4467,82,438,5691,33,10711,3.632.857.143
12/03/2021 02:00,21.17,48475,4424,80,429,5569,33,10535,3.632.857.143
12/03/2021 03:00,21.64,48597,4581,80,434,5396,32,10523,3.632.857.143
12/03/2021 04:00,24.11,49299,4687,82,440,5127,32,10368,3.632.857.143
12/03/2021 05:00,26.39,51177,4842,86,449,4806,34,10217,3.632.857.143
12/03/2021 06:00,32.04,54524,4964,94,456,4505,32,10051,3.632.857.143
12/03/2021 07:00,36.48,57775,5201,97,460,4245,32,10035,3.632.857.143
12/03/2021 08:00,36.04,58825,5336,98,456,4011,39,9940,3.632.857.143
12/03/2021 09:00,34.02,58760,5561,110,450,3859,39,10019,3.632.857.143
12/03/2021 10:00,32.27,58404,5459,126,447,3822,39,9893,3.632.857.143
12/03/2021 11:00,30.92,57591,5429,146,441,3852,39,9907,3.632.857.143
12/03/2021 12:00,29.31,56863,5111,165,438,3895,39,9648,3.632.857.143
12/03/2021 13:00,28.81,55980,5180,177,432,3931,38,9758,3.632.857.143
12/03/2021 14:00,28.96,55242,5117,184,425,3898,38,9662,3.632.857.143
12/03/2021 15:00,29.93,54826,4647,197,423,3780,38,9085,3.632.857.143
12/03/2021 16:00,33.83,55086,4108,213,425,3627,38,8411,3.632.857.143
12/03/2021 17:00,38.94,56319,3357,226,416,3564,38,7601,3.632.857.143
12/03/2021 18:00,41.52,57062,2717,235,402,3548,38,6940,3.632.857.143
12/03/2021 19:00,41.63,56029,2468,241,394,3480,37,6620,3.632.857.143
12/03/2021 20:00,36.94,54131,2436,245,386,3339,37,6443,3.632.857.143
12/03/2021 21:00,35.29,52616,2412,247,378,3180,36,6253,3.632.857.143
12/03/2021 22:00,33.29,50896,2499,249,373,2995,35,6151,3.632.857.143
12/03/2021 23:00,29.75,49272,2665,249,365,2783,31,6093,3.632.857.143
13/03/2021 00:00,30.01,47955,2537,13,301,2393,22,5266,3.632.857.143
13/03/2021 01:00,27.93,47170,2666,16,273,2188,22,5165,3.632.857.143
13/03/2021 02:00,26.94,46815,2643,25,250,1995,20,4933,3.632.857.143
13/03/2021 03:00,26.96,46811,2609,39,236,1821,20,4725,3.632.857.143
13/03/2021 04:00,28.06,47211,2559,55,231,1687,17,4549,3.632.857.143
13/03/2021 05:00,28.9,47928,2492,77,239,1597,14,4419,3.632.857.143
13/03/2021 06:00,28.57,48814,2447,113,250,1525,9,4344,3.632.857.143
13/03/2021 07:00,29.24,50014,2389,153,252,1471,10,4275,3.632.857.143
13/03/2021 08:00,30.96,51667,2531,173,249,1453,10,4416,3.632.857.143
13/03/2021 09:00,32.13,52741,2877,186,248,1414,9,4734,3.632.857.143
13/03/2021 10:00,31.94,53027,3181,199,256,1343,9,4988,3.632.857.143
13/03/2021 11:00,30.17,52759,3521,209,263,1281,8,5282,3.632.857.143
13/03/2021 12:00,29.75,52163,3651,216,257,1244,12,5380,3.632.857.143
13/03/2021 13:00,29.16,51842,3551,221,242,1231,14,5259,3.632.857.143
13/03/2021 14:00,28.84,51300,3329,228,209,1207,14,4987,3.632.857.143
13/03/2021 15:00,28.87,51273,2846,234,167,1145,14,4406,3.632.857.143
13/03/2021 16:00,30.26,51861,2515,233,139,1099,13,3999,3.632.857.143
13/03/2021 17:00,35.74,53509,1961,232,156,1149,18,3516,3.632.857.143
13/03/2021 18:00,38.91,54576,1636,232,204,1284,11,3367,3.632.857.143
13/03/2021 19:00,40,53625,1579,229,251,1374,7,3440,3.632.857.143
13/03/2021 20:00,33.64,51775,1690,222,282,1377,9,3580,3.632.857.143
13/03/2021 21:00,31.51,50573,1574,207,299,1319,10,3409,3.632.857.143
13/03/2021 22:00,29.9,49407,1604,206,296,1215,14,3335,3.632.857.143
13/03/2021 23:00,28.99,48085,1713,207,276,1105,15,3316,3.632.857.143
14/03/2021 00:00,29.37,46346,1843,225,290,769,10,3137,3.632.857.143
14/03/2021 01:00,28.98,45732,2142,230,274,697,9,3352,3.632.857.143
14/03/2021 02:00,28.66,45479,2346,230,266,648,8,3498,3.632.857.143
14/03/2021 03:00,28.45,45494,2607,227,259,654,8,3755,3.632.857.143
14/03/2021 04:00,28.63,45745,2683,222,255,672,11,3843,3.632.857.143
14/03/2021 05:00,29,46269,2547,218,267,688,10,3730,3.632.857.143
14/03/2021 06:00,28.7,46833,2349,209,276,699,8,3541,3.632.857.143
14/03/2021 07:00,28.98,47794,2152,200,275,701,6,3334,3.632.857.143
14/03/2021 08:00,30,49286,2078,199,277,711,8,3273,3.632.857.143
14/03/2021 09:00,30.62,50605,2262,207,289,758,7,3523,3.632.857.143
14/03/2021 10:00,30.85,51024,2400,211,312,836,6,3765,3.632.857.143
14/03/2021 11:00,30.48,50911,2559,207,315,924,6,4011,3.632.857.143
14/03/2021 12:00,29.88,50467,2615,201,312,1004,8,4140,3.632.857.143
14/03/2021 13:00,28.57,50064,2695,197,297,1021,6,4216,3.632.857.143
14/03/2021 14:00,28.46,49902,2891,195,270,940,5,4301,3.632.857.143
14/03/2021 15:00,29.12,49995,2928,195,240,801,4,4168,3.632.857.143
14/03/2021 16:00,30.38,50663,3172,189,212,669,3,4245,3.632.857.143
14/03/2021 17:00,36.77,52550,3403,186,192,588,3,4372,3.632.857.143
14/03/2021 18:00,43.81,54074,3576,182,183,612,3,4556,3.632.857.143
14/03/2021 19:00,44.63,53721,3892,175,188,657,3,4915,3.632.857.143
14/03/2021 20:00,43.56,52305,4111,166,199,704,3,5183,3.632.857.143
14/03/2021 21:00,42.02,51235,4135,161,210,747,3,5256,3.632.857.143
14/03/2021 22:00,40.76,49830,4132,155,219,777,4,5287,3.632.857.143
14/03/2021 23:00,38.09,48349,4126,149,221,796,6,5298,3.632.857.143
15/03/2021 00:00,37.18,45774,3743,245,171,961,8,5128,3.411.488.095
15/03/2021 01:00,36.07,45047,3639,244,150,970,10,5013,3.411.488.095
15/03/2021 02:00,35.19,44950,3396,244,124,986,10,4760,3.411.488.095
15/03/2021 03:00,34.69,45253,3331,243,103,1019,9,4705,3.411.488.095
15/03/2021 04:00,36.71,46311,3151,242,90,1047,7,4537,3.411.488.095
15/03/2021 05:00,40.12,48629,2969,240,91,1053,6,4359,3.411.488.095
15/03/2021 06:00,45.98,52421,2974,235,93,1078,7,4387,3.411.488.095
15/03/2021 07:00,56.74,55831,3072,225,86,1045,7,4435,3.411.488.095
15/03/2021 08:00,64.36,56781,3161,210,85,934,5,4395,3.411.488.095
15/03/2021 09:00,52.67,56474,3222,190,91,870,4,4377,3.411.488.095
15/03/2021 10:00,48.48,56020,3305,167,94,885,5,4456,3.411.488.095
15/03/2021 11:00,44.6,55403,3322,154,92,965,5,4538,3.411.488.095
15/03/2021 12:00,43.71,54795,3223,153,86,1062,4,4528,3.411.488.095
15/03/2021 13:00,42.46,54295,3153,153,75,1182,4,4567,3.411.488.095
15/03/2021 14:00,39.97,53884,3148,159,60,1306,4,4677,3.411.488.095
15/03/2021 15:00,39.81,53732,3067,160,44,1386,3,4660,3.411.488.095
15/03/2021 16:00,41.87,53837,2944,165,33,1491,3,4636,3.411.488.095
15/03/2021 17:00,44.23,54937,2818,170,24,1690,3,4705,3.411.488.095
15/03/2021 18:00,44.96,55709,2739,178,22,2003,3,4945,3.411.488.095
15/03/2021 19:00,45.97,55188,2659,185,23,2247,3,5117,3.411.488.095
15/03/2021 20:00,44.07,53433,2415,190,25,2418,3,5051,3.411.488.095
15/03/2021 21:00,42.4,52074,2100,192,25,2579,3,4899,3.411.488.095
15/03/2021 22:00,40.07,50171,1886,191,22,2720,3,4822,3.411.488.095
15/03/2021 23:00,37.49,48082,1754,182,17,2837,3,4793,3.411.488.095
16/03/2021 00:00,38.11,46752,1832,56,23,3133,3,5047,3.411.488.095
16/03/2021 01:00,37.53,45959,1777,60,19,3197,3,5056,3.411.488.095
16/03/2021 02:00,37.34,45881,1683,64,16,3229,3,4995,3.411.488.095
16/03/2021 03:00,37.55,46279,1565,70,14,3272,3,4924,3.411.488.095
16/03/2021 04:00,38.94,47220,1488,76,12,3285,3,4864,3.411.488.095
16/03/2021 05:00,40.08,49169,1417,79,12,3247,3,4758,3.411.488.095
16/03/2021 06:00,42.77,52479,1327,79,11,3179,3,4599,3.411.488.095
16/03/2021 07:00,46.48,55658,1225,76,10,2930,3,4244,3.411.488.095
16/03/2021 08:00,49.52,56341,1121,73,8,2455,3,3660,3.411.488.095
16/03/2021 09:00,50.06,55564,1021,71,7,2163,3,3265,3.411.488.095
16/03/2021 10:00,46.84,54987,961,69,7,2041,3,3081,3.411.488.095
16/03/2021 11:00,44.39,54198,872,69,7,1948,3,2899,3.411.488.095
16/03/2021 12:00,43.05,53405,756,70,7,1876,3,2712,3.411.488.095
16/03/2021 13:00,42.16,52717,714,66,8,1821,3,2612,3.411.488.095
16/03/2021 14:00,42.01,52342,734,61,12,1760,3,2570,3.411.488.095
16/03/2021 15:00,42.02,52454,771,53,20,1678,3,2525,3.411.488.095
16/03/2021 16:00,44.01,52859,799,49,29,1640,4,2521,3.411.488.095
16/03/2021 17:00,49.01,54111,801,46,44,1724,4,2619,3.411.488.095
16/03/2021 18:00,50.38,55167,865,45,62,1918,4,2894,3.411.488.095
16/03/2021 19:00,50.85,54878,867,44,71,2038,4,3024,3.411.488.095
16/03/2021 20:00,46.46,53573,825,41,75,2030,4,2975,3.411.488.095
16/03/2021 21:00,43.49,52350,849,36,76,1940,4,2905,3.411.488.095
16/03/2021 22:00,42.01,50372,822,32,79,1802,4,2739,3.411.488.095
16/03/2021 23:00,40.69,48331,772,28,81,1674,5,2560,3.411.488.095
17/03/2021 00:00,39.39,46982,702,23,36,1452,2,2215,3.411.488.095
17/03/2021 01:00,38.89,46399,623,20,39,1427,2,2111,3.411.488.095
17/03/2021 02:00,38.83,46294,625,17,41,1429,2,2114,3.411.488.095
17/03/2021 03:00,38.92,46542,546,15,44,1483,2,2090,3.411.488.095
17/03/2021 04:00,39.69,47493,559,12,47,1583,3,2204,3.411.488.095
17/03/2021 05:00,42.29,49554,577,9,48,1727,3,2364,3.411.488.095
17/03/2021 06:00,48.83,52977,533,7,49,1822,3,2414,3.411.488.095
17/03/2021 07:00,52.6,56172,459,5,51,1694,2,2211,3.411.488.095
17/03/2021 08:00,56.63,56925,394,4,53,1321,3,1775,3.411.488.095
17/03/2021 09:00,56.74,56435,366,4,51,1029,4,1454,3.411.488.095
17/03/2021 10:00,52.76,55994,378,4,50,980,5,1417,3.411.488.095
17/03/2021 11:00,50.96,55331,400,5,58,1038,7,1508,3.411.488.095
17/03/2021 12:00,49.15,54517,380,7,70,1113,8,1578,3.411.488.095
17/03/2021 13:00,44.74,53872,394,9,82,1233,8,1726,3.411.488.095
17/03/2021 14:00,43.65,53309,457,11,94,1329,8,1899,3.411.488.095
17/03/2021 15:00,43.64,53238,475,12,102,1384,9,1982,3.411.488.095
17/03/2021 16:00,48.21,53555,516,13,96,1440,7,2072,3.411.488.095
17/03/2021 17:00,50.9,54862,519,15,81,1590,7,2212,3.411.488.095
17/03/2021 18:00,51.67,55881,540,15,81,1876,6,2518,3.411.488.095
17/03/2021 19:00,50.91,55535,561,16,84,2107,5,2773,3.411.488.095
17/03/2021 20:00,43.27,54259,525,17,79,2224,4,2849,3.411.488.095
17/03/2021 21:00,42.24,52995,434,19,70,2282,4,2809,3.411.488.095
17/03/2021 22:00,40.73,51101,399,20,60,2325,3,2807,3.411.488.095
17/03/2021 23:00,38.56,49169,370,20,50,2351,3,2794,3.411.488.095
18/03/2021 00:00,38.42,47406,467,16,79,2636,3,3201,3.411.488.095
18/03/2021 01:00,38.19,46724,423,16,76,2635,3,3153,3.411.488.095
18/03/2021 02:00,38.11,46668,445,19,72,2599,3,3138,3.411.488.095
18/03/2021 03:00,38.17,47030,434,21,67,2517,2,3041,3.411.488.095
18/03/2021 04:00,39.21,47888,389,23,64,2392,2,2870,3.411.488.095
18/03/2021 05:00,41.09,49867,330,24,61,2240,1,2656,3.411.488.095
18/03/2021 06:00,43.64,53216,289,25,54,2078,1,2447,3.411.488.095
18/03/2021 07:00,55.12,56278,256,25,44,1818,1,2144,3.411.488.095
18/03/2021 08:00,58.03,57101,250,24,39,1440,1,1754,3.411.488.095
18/03/2021 09:00,58.02,56406,252,23,36,1248,1,1560,3.411.488.095
18/03/2021 10:00,52.53,55691,284,26,34,1256,1,1601,3.411.488.095
18/03/2021 11:00,48.89,54962,308,29,32,1371,1,1741,3.411.488.095
18/03/2021 12:00,45.74,54124,389,32,29,1501,1,1952,3.411.488.095
18/03/2021 13:00,43.45,53867,515,36,28,1614,1,2194,3.411.488.095
18/03/2021 14:00,42.52,53649,734,39,31,1699,1,2504,3.411.488.095
18/03/2021 15:00,42,53470,755,43,35,1790,2,2625,3.411.488.095
18/03/2021 16:00,42.92,53766,842,45,33,1904,2,2826,3.411.488.095
18/03/2021 17:00,44.97,55122,916,45,33,2097,2,3093,3.411.488.095
18/03/2021 18:00,50.89,56293,1035,46,40,2393,2,3516,3.411.488.095
18/03/2021 19:00,50.77,55940,1132,45,47,2587,1,3812,3.411.488.095
18/03/2021 20:00,43.82,54540,1156,42,45,2684,1,3928,3.411.488.095
18/03/2021 21:00,42.24,53318,1063,38,38,2750,3,3892,3.411.488.095
18/03/2021 22:00,40.96,51706,1087,37,35,2738,5,3902,3.411.488.095
18/03/2021 23:00,39.06,50216,1089,36,37,2645,6,3813,3.411.488.095
19/03/2021 00:00,39.52,48672,787,32,39,2522,10,3390,3.411.488.095
19/03/2021 01:00,38.93,48115,796,26,58,2427,12,3319,3.411.488.095
19/03/2021 02:00,38.75,48092,925,20,79,2274,12,3310,3.411.488.095
19/03/2021 03:00,39.21,48461,1001,14,114,2126,12,3267,3.411.488.095
19/03/2021 04:00,40.52,49334,1214,10,159,1997,11,3391,3.411.488.095
19/03/2021 05:00,42.83,51459,1579,7,193,1925,8,3712,3.411.488.095
19/03/2021 06:00,47.16,54635,1813,6,217,1925,10,3971,3.411.488.095
19/03/2021 07:00,50.92,57681,2002,6,229,1933,9,4179,3.411.488.095
19/03/2021 08:00,52.04,58480,2171,6,235,1929,10,4351,3.411.488.095
19/03/2021 09:00,47.18,57905,2186,8,232,1965,11,4402,3.411.488.095
19/03/2021 10:00,43.8,57185,2134,13,223,2011,9,4390,3.411.488.095
19/03/2021 11:00,42.47,56118,1907,15,206,2106,9,4243,3.411.488.095
19/03/2021 12:00,41.2,55345,1516,18,191,2270,9,4004,3.411.488.095
19/03/2021 13:00,39.68,54585,1141,22,189,2477,9,3838,3.411.488.095
19/03/2021 14:00,39.02,54003,887,33,192,2634,10,3756,3.411.488.095
19/03/2021 15:00,38.63,53865,676,53,192,2777,10,3708,3.411.488.095
19/03/2021 16:00,38.82,54347,553,71,179,2952,10,3765,3.411.488.095
19/03/2021 17:00,39.26,55879,425,90,169,3157,6,3847,3.411.488.095
19/03/2021 18:00,39.75,57206,336,111,165,3472,4,4088,3.411.488.095
19/03/2021 19:00,40.09,56808,302,116,163,3735,3,4319,3.411.488.095
19/03/2021 20:00,39.02,55004,260,107,153,3930,3,4453,3.411.488.095
19/03/2021 21:00,37.86,53543,230,100,138,4128,3,4599,3.411.488.095
19/03/2021 22:00,36.54,52083,241,101,122,4338,3,4805,3.411.488.095
19/03/2021 23:00,33.7,50561,335,98,104,4481,3,5021,3.411.488.095
20/03/2021 00:00,31.06,48524,663,164,89,5185,1,6102,3.411.488.095
20/03/2021 01:00,30.12,47743,918,160,74,5327,1,6480,3.411.488.095
20/03/2021 02:00,29.81,47321,1186,152,58,5463,1,6860,3.411.488.095
20/03/2021 03:00,29.55,47111,1492,145,42,5570,0,7249,3.411.488.095
20/03/2021 04:00,29.55,47424,1876,141,31,5556,0,7604,3.411.488.095
20/03/2021 05:00,30.16,48028,2191,138,23,5405,1,7758,3.411.488.095
20/03/2021 06:00,30.28,48610,2486,133,15,5255,1,7890,3.411.488.095
20/03/2021 07:00,30.59,49792,2702,124,11,5092,2,7931,3.411.488.095
20/03/2021 08:00,31.57,51319,2880,117,12,4834,2,7845,3.411.488.095
20/03/2021 09:00,32.53,52295,3091,115,22,4667,4,7899,3.411.488.095
20/03/2021 10:00,32.48,52493,3274,115,44,4711,6,8150,3.411.488.095
20/03/2021 11:00,31.56,52166,3472,109,75,4905,11,8572,3.411.488.095
20/03/2021 12:00,30.82,51429,3575,99,118,5159,16,8967,3.411.488.095
20/03/2021 13:00,29.92,50879,3940,89,167,5457,20,9673,3.411.488.095
20/03/2021 14:00,28.46,50404,4186,87,211,5783,23,10290,3.411.488.095
20/03/2021 15:00,27.54,50399,4420,90,247,6067,25,10849,3.411.488.095
20/03/2021 16:00,27.05,50883,4637,95,268,6427,25,11452,3.411.488.095
20/03/2021 17:00,28.24,52495,4859,95,278,6789,25,12046,3.411.488.095
20/03/2021 18:00,30.22,53591,4948,95,299,7063,26,12431,3.411.488.095
20/03/2021 19:00,28.47,52791,5188,93,330,7202,26,12839,3.411.488.095
20/03/2021 20:00,25.87,50892,5289,92,354,7277,26,13038,3.411.488.095
20/03/2021 21:00,24.84,49750,5262,89,374,7390,27,13142,3.411.488.095
20/03/2021 22:00,22.5,48679,5248,82,396,7521,27,13274,3.411.488.095
20/03/2021 23:00,20.24,47439,5220,78,412,7667,27,13404,3.411.488.095
21/03/2021 00:00,22.13,45974,5112,56,302,7669,21,13160,3.411.488.095
21/03/2021 01:00,21.55,45400,5247,55,312,7758,20,13392,3.411.488.095
21/03/2021 02:00,21.07,45126,5099,54,319,7719,18,13209,3.411.488.095
21/03/2021 03:00,21.26,45232,5067,52,322,7665,17,13123,3.411.488.095
21/03/2021 04:00,21.79,45637,4847,52,324,7658,13,12894,3.411.488.095
21/03/2021 05:00,22.15,46217,4561,55,317,7636,11,12580,3.411.488.095
21/03/2021 06:00,21.53,46561,4304,59,301,7594,9,12267,3.411.488.095
21/03/2021 07:00,22.19,47368,4170,61,280,7519,12,12042,3.411.488.095
21/03/2021 08:00,23.64,48494,3993,60,259,7513,12,11837,3.411.488.095
21/03/2021 09:00,23.55,49322,3965,59,240,7656,6,11926,3.411.488.095
21/03/2021 10:00,23.64,49571,3775,58,226,7759,14,11832,3.411.488.095
21/03/2021 11:00,23.55,49346,3447,55,217,7777,20,11516,3.411.488.095
21/03/2021 12:00,23.56,48946,3105,51,218,7714,22,11110,3.411.488.095
21/03/2021 13:00,23.13,48659,2998,47,218,7579,22,10864,3.411.488.095
21/03/2021 14:00,22.82,48702,2923,42,222,7362,23,10572,3.411.488.095
21/03/2021 15:00,23.53,49085,2746,38,224,7007,23,10038,3.411.488.095
21/03/2021 16:00,25,50049,2497,35,213,6362,23,9130,3.411.488.095
21/03/2021 17:00,29.98,51989,2207,32,201,5548,22,8010,3.411.488.095
21/03/2021 18:00,32.62,53374,2008,30,190,4927,21,7176,3.411.488.095
21/03/2021 19:00,33.99,53296,1846,29,179,4529,21,6604,3.411.488.095
21/03/2021 20:00,32.67,52146,1684,27,169,4309,19,6208,3.411.488.095
21/03/2021 21:00,32.43,51206,1508,26,163,4196,18,5911,3.411.488.095
21/03/2021 22:00,31.66,50024,1305,25,159,4146,19,5654,3.411.488.095
21/03/2021 23:00,30.19,48620,1187,26,159,4079,17,5468,3.411.488.095
22/03/2021 00:00,29.82,46501,1398,98,194,3889,15,5594,3.273.869.048
22/03/2021 01:00,29.92,45967,1294,99,194,3723,14,5324,3.273.869.048
22/03/2021 02:00,30.16,45903,1222,101,187,3547,11,5068,3.273.869.048
22/03/2021 03:00,30.62,46221,1171,105,177,3403,13,4869,3.273.869.048
22/03/2021 04:00,32.96,47220,1200,109,174,3336,15,4834,3.273.869.048
22/03/2021 05:00,36.41,49306,1339,113,167,3314,13,4946,3.273.869.048
22/03/2021 06:00,40.04,52651,1458,123,155,3289,13,5038,3.273.869.048
22/03/2021 07:00,43.64,55589,1466,136,125,3100,9,4836,3.273.869.048
22/03/2021 08:00,44.28,56058,1416,142,112,2678,10,4358,3.273.869.048
22/03/2021 09:00,43.86,54982,1349,144,135,2320,11,3959,3.273.869.048
22/03/2021 10:00,42.54,54056,1402,140,159,2171,9,3881,3.273.869.048
22/03/2021 11:00,40.69,53150,1584,134,163,2221,7,4109,3.273.869.048
22/03/2021 12:00,39.87,52422,1702,126,169,2322,7,4326,3.273.869.048
22/03/2021 13:00,37.78,51881,1952,112,189,2455,6,4714,3.273.869.048
22/03/2021 14:00,37.18,51675,2302,94,200,2569,6,5171,3.273.869.048
22/03/2021 15:00,36.95,51658,2635,79,198,2684,4,5600,3.273.869.048
22/03/2021 16:00,37.38,52129,2722,64,179,2872,3,5840,3.273.869.048
22/03/2021 17:00,38.62,53180,2782,48,159,3235,2,6226,3.273.869.048
22/03/2021 18:00,39.38,54176,2841,33,145,3745,2,6766,3.273.869.048
22/03/2021 19:00,37.71,53983,2851,22,133,4137,1,7144,3.273.869.048
22/03/2021 20:00,35.45,52389,2868,15,116,4314,0,7313,3.273.869.048
22/03/2021 21:00,35.77,50918,2802,9,96,4428,0,7335,3.273.869.048
22/03/2021 22:00,33.93,49040,2660,6,72,4435,0,7173,3.273.869.048
22/03/2021 23:00,30.66,47106,2500,6,51,4334,0,6891,3.273.869.048
23/03/2021 00:00,29.77,44936,2147,213,27,4235,0,6622,3.273.869.048
23/03/2021 01:00,29.78,44200,1978,206,19,4267,0,6470,3.273.869.048
23/03/2021 02:00,29.69,43986,1827,200,13,4274,0,6314,3.273.869.048
23/03/2021 03:00,29.95,44321,1689,194,9,4269,0,6161,3.273.869.048
23/03/2021 04:00,31.65,45220,1562,184,9,4294,1,6050,3.273.869.048
23/03/2021 05:00,32.29,47087,1482,168,10,4290,1,5951,3.273.869.048
23/03/2021 06:00,36.76,50370,1445,150,10,4244,1,5850,3.273.869.048
23/03/2021 07:00,39.92,53379,1310,135,8,4117,1,5571,3.273.869.048
23/03/2021 08:00,40.86,53896,1229,120,4,3794,1,5148,3.273.869.048
23/03/2021 09:00,39.86,52951,1116,108,3,3439,1,4667,3.273.869.048
23/03/2021 10:00,39,52110,1081,95,4,3299,1,4480,3.273.869.048
23/03/2021 11:00,37.34,51180,985,80,4,3459,0,4528,3.273.869.048
23/03/2021 12:00,36.9,50284,914,68,4,3588,0,4574,3.273.869.048
23/03/2021 13:00,35.26,49531,906,59,4,3673,0,4642,3.273.869.048
23/03/2021 14:00,34.62,49043,928,50,6,3801,1,4786,3.273.869.048
23/03/2021 15:00,34.43,49000,1006,42,7,3969,1,5025,3.273.869.048
23/03/2021 16:00,34.19,49339,1146,37,9,4219,0,5411,3.273.869.048
23/03/2021 17:00,35,50684,1270,35,11,4678,0,5994,3.273.869.048
23/03/2021 18:00,37.11,51750,1441,34,17,5197,1,6690,3.273.869.048
23/03/2021 19:00,35.7,51536,1601,31,24,5497,2,7155,3.273.869.048
23/03/2021 20:00,32.19,49961,1778,29,29,5568,2,7406,3.273.869.048
23/03/2021 21:00,30.77,48609,1902,25,34,5543,3,7507,3.273.869.048
23/03/2021 22:00,29.76,46736,2055,23,40,5501,3,7622,3.273.869.048
23/03/2021 23:00,27.14,44699,2276,23,46,5492,4,7841,3.273.869.048
24/03/2021 00:00,24.49,43385,2469,8,34,5479,2,7992,3.273.869.048
24/03/2021 01:00,23.93,42782,2513,9,40,5604,3,8169,3.273.869.048
24/03/2021 02:00,23.27,42669,2542,12,42,5698,4,8298,3.273.869.048
24/03/2021 03:00,23.48,42952,2536,15,45,5780,6,8382,3.273.869.048
24/03/2021 04:00,24.21,43714,2509,21,46,5811,5,8392,3.273.869.048
24/03/2021 05:00,27.08,45582,2459,31,47,5783,6,8326,3.273.869.048
24/03/2021 06:00,32.08,48888,2458,40,50,5706,6,8260,3.273.869.048
24/03/2021 07:00,36.22,51934,2394,41,53,5545,6,8039,3.273.869.048
24/03/2021 08:00,37.35,52611,2436,39,57,5355,8,7895,3.273.869.048
24/03/2021 09:00,36.39,52282,2616,39,60,5266,5,7986,3.273.869.048
24/03/2021 10:00,34.45,51806,2800,41,63,5350,7,8261,3.273.869.048
24/03/2021 11:00,33.98,51155,2824,45,69,5641,11,8590,3.273.869.048
24/03/2021 12:00,33.19,50493,2648,48,74,5905,9,8684,3.273.869.048
24/03/2021 13:00,32.82,50037,2546,52,79,6008,9,8694,3.273.869.048
24/03/2021 14:00,32.04,49673,2483,54,83,6068,8,8696,3.273.869.048
24/03/2021 15:00,31.88,49579,2481,57,88,6056,7,8689,3.273.869.048
24/03/2021 16:00,31.96,49859,2391,65,93,5979,6,8534,3.273.869.048
24/03/2021 17:00,33.99,51070,2268,79,94,5942,7,8390,3.273.869.048
24/03/2021 18:00,36.5,51865,2131,89,96,5943,7,8266,3.273.869.048
24/03/2021 19:00,35.79,51414,2012,96,97,5979,7,8191,3.273.869.048
24/03/2021 20:00,33.06,49921,1879,100,96,5967,7,8049,3.273.869.048
24/03/2021 21:00,31.41,48663,1688,105,98,5884,7,7782,3.273.869.048
24/03/2021 22:00,29.59,46862,1543,110,101,5692,7,7453,3.273.869.048
24/03/2021 23:00,26.7,44975,1399,118,102,5486,7,7112,3.273.869.048
25/03/2021 00:00,22.98,42504,1316,127,111,5544,4,7102,3.273.869.048
25/03/2021 01:00,22.8,41797,1281,138,118,5274,4,6815,3.273.869.048
25/03/2021 02:00,22.89,41761,1221,149,122,5036,3,6531,3.273.869.048
25/03/2021 03:00,23.05,42171,1209,159,124,4830,4,6326,3.273.869.048
25/03/2021 04:00,25.11,42946,1241,169,120,4565,4,6099,3.273.869.048
25/03/2021 05:00,32.21,44851,1289,176,115,4268,4,5852,3.273.869.048
25/03/2021 06:00,37.46,48217,1387,180,107,3965,4,5643,3.273.869.048
25/03/2021 07:00,40.44,51348,1480,175,92,3603,4,5354,3.273.869.048
25/03/2021 08:00,42.23,52063,1557,173,79,3164,3,4976,3.273.869.048
25/03/2021 09:00,41.74,51638,1666,182,75,2892,4,4819,3.273.869.048
25/03/2021 10:00,41.26,50776,1838,198,78,2839,5,4958,3.273.869.048
25/03/2021 11:00,39.35,49903,1938,206,80,2935,6,5165,3.273.869.048
25/03/2021 12:00,39.07,49060,1910,208,79,3121,8,5326,3.273.869.048
25/03/2021 13:00,38.1,48451,1881,215,78,3273,7,5454,3.273.869.048
25/03/2021 14:00,36.64,48115,1803,217,75,3246,7,5348,3.273.869.048
25/03/2021 15:00,37.96,48204,1739,214,67,3061,4,5085,3.273.869.048
25/03/2021 16:00,38.26,48743,1626,203,58,2846,3,4736,3.273.869.048
25/03/2021 17:00,39.6,50181,1412,192,53,2815,2,4474,3.273.869.048
25/03/2021 18:00,40.26,51472,1312,186,54,3003,1,4556,3.273.869.048
25/03/2021 19:00,39.76,51124,1342,181,58,3150,1,4732,3.273.869.048
25/03/2021 20:00,38.99,49626,1471,175,59,3158,1,4864,3.273.869.048
25/03/2021 21:00,35.89,48193,1595,165,56,3082,1,4899,3.273.869.048
25/03/2021 22:00,34.96,46495,1613,154,52,2964,1,4784,3.273.869.048
25/03/2021 23:00,31.54,44926,1618,143,49,2800,1,4611,3.273.869.048
26/03/2021 00:00,30.85,43536,1701,133,50,2369,2,4255,3.273.869.048
26/03/2021 01:00,30.07,42912,1780,123,48,2138,1,4090,3.273.869.048
26/03/2021 02:00,29.12,42728,1812,115,44,1895,2,3868,3.273.869.048
26/03/2021 03:00,29.85,42904,1790,109,41,1704,2,3646,3.273.869.048
26/03/2021 04:00,32.66,43645,1937,106,39,1599,2,3683,3.273.869.048
26/03/2021 05:00,35.62,45634,2182,103,35,1602,2,3924,3.273.869.048
26/03/2021 06:00,39.16,48815,2430,99,32,1694,2,4257,3.273.869.048
26/03/2021 07:00,40.71,51933,2704,94,26,1776,2,4602,3.273.869.048
26/03/2021 08:00,41.02,52479,3025,87,21,1772,2,4907,3.273.869.048
26/03/2021 09:00,39.15,51647,3280,86,19,1842,2,5229,3.273.869.048
26/03/2021 10:00,38.18,50962,3509,84,22,2117,2,5734,3.273.869.048
26/03/2021 11:00,34.9,49803,3719,77,25,2563,2,6386,3.273.869.048
26/03/2021 12:00,31.63,48972,3684,72,27,3040,2,6825,3.273.869.048
26/03/2021 13:00,29.63,48075,3667,68,29,3405,1,7170,3.273.869.048
26/03/2021 14:00,30.07,47399,3568,62,30,3658,1,7319,3.273.869.048
26/03/2021 15:00,30.96,47247,3437,57,29,3829,2,7354,3.273.869.048
26/03/2021 16:00,31.52,47734,3346,54,27,3963,2,7392,3.273.869.048
26/03/2021 17:00,32.47,49179,3184,54,28,4221,1,7488,3.273.869.048
26/03/2021 18:00,33.06,50406,3236,56,33,4586,1,7912,3.273.869.048
26/03/2021 19:00,30.57,49942,3324,56,47,4856,1,8284,3.273.869.048
26/03/2021 20:00,26.12,48030,3459,57,67,5022,1,8606,3.273.869.048
26/03/2021 21:00,23.53,46591,3564,57,83,5163,1,8868,3.273.869.048
26/03/2021 22:00,22.17,45217,3552,56,97,5243,1,8949,3.273.869.048
26/03/2021 23:00,20.94,43716,3347,55,111,5260,1,8774,3.273.869.048
27/03/2021 00:00,22.62,42066,2766,17,109,5313,7,8212,3.273.869.048
27/03/2021 01:00,22.12,41355,2361,26,121,5238,6,7752,3.273.869.048
27/03/2021 02:00,21.08,41053,2065,35,126,5185,4,7415,3.273.869.048
27/03/2021 03:00,20.08,41144,1882,46,130,5152,4,7214,3.273.869.048
27/03/2021 04:00,20.03,41419,1929,61,132,5080,4,7206,3.273.869.048
27/03/2021 05:00,20.66,41859,2073,75,132,4983,5,7268,3.273.869.048
27/03/2021 06:00,21.1,42512,2284,91,131,4866,6,7378,3.273.869.048
27/03/2021 07:00,21.59,43846,2496,110,115,4742,4,7467,3.273.869.048
27/03/2021 08:00,21.51,45264,2620,135,104,4590,3,7452,3.273.869.048
27/03/2021 09:00,20.29,46260,2561,163,110,4559,4,7397,3.273.869.048
27/03/2021 10:00,19.91,46755,2427,188,124,4611,7,7357,3.273.869.048
27/03/2021 11:00,19.16,46485,2318,208,139,4647,7,7319,3.273.869.048
27/03/2021 12:00,18.27,45968,2316,224,152,4700,6,7398,3.273.869.048
27/03/2021 13:00,16.88,45533,2560,226,166,4674,7,7633,3.273.869.048
27/03/2021 14:00,15.93,45297,2869,223,175,4547,8,7822,3.273.869.048
27/03/2021 15:00,17.45,45381,3246,214,181,4398,9,8048,3.273.869.048
27/03/2021 16:00,21.82,45984,3318,206,180,4366,6,8076,3.273.869.048
27/03/2021 17:00,29.64,47713,3289,201,186,4465,7,8148,3.273.869.048
27/03/2021 18:00,34.36,49041,3258,192,204,4522,8,8184,3.273.869.048
27/03/2021 19:00,34.96,48556,3296,190,203,4474,7,8170,3.273.869.048
27/03/2021 20:00,29.86,46638,3435,186,184,4290,7,8102,3.273.869.048
27/03/2021 21:00,26.37,45545,3482,183,163,4085,5,7918,3.273.869.048
27/03/2021 22:00,23.49,44531,3389,179,139,3892,8,7607,3.273.869.048
27/03/2021 23:00,23.01,43453,3211,172,127,3715,7,7232,3.273.869.048
28/03/2021 00:00,24.85,42172,2979,175,202,3482,6,6844,3.273.869.048
28/03/2021 01:00,23.62,41537,2947,170,192,3382,7,6698,3.273.869.048
28/03/2021 02:00,22.74,41515,2879,158,174,3306,8,6525,3.273.869.048
28/03/2021 03:00,22.86,41692,2818,136,152,3210,6,6322,3.273.869.048
28/03/2021 04:00,22.93,42210,2806,119,137,3060,7,6129,3.273.869.048
28/03/2021 05:00,23.44,42646,2900,117,131,2953,5,6106,3.273.869.048
28/03/2021 06:00,23.75,43711,3045,125,131,2839,6,6146,3.273.869.048
28/03/2021 07:00,25.43,45285,3160,139,146,2720,8,6173,3.273.869.048
28/03/2021 08:00,27.68,46650,3462,156,168,2679,10,6475,3.273.869.048
28/03/2021 09:00,23.45,47035,3856,174,177,2725,10,6942,3.273.869.048
28/03/2021 10:00,22.04,46789,4184,191,186,2800,9,7370,3.273.869.048
28/03/2021 11:00,21.1,46276,4511,200,186,2913,11,7821,3.273.869.048
28/03/2021 12:00,20.75,46085,4659,209,194,3078,12,8152,3.273.869.048
28/03/2021 13:00,19.62,45798,4706,217,211,3266,13,8413,3.273.869.048
28/03/2021 14:00,18.46,45625,4801,223,204,3442,11,8681,3.273.869.048
28/03/2021 15:00,18.93,46081,4763,230,165,3648,12,8818,3.273.869.048
28/03/2021 16:00,22,47020,4644,236,112,3932,11,8935,3.273.869.048
28/03/2021 17:00,26.32,47875,4359,239,76,4275,9,8958,3.273.869.048
28/03/2021 18:00,30.56,48547,4108,241,67,4591,7,9014,3.273.869.048
28/03/2021 19:00,30.78,48499,3915,239,85,4745,6,8990,3.273.869.048
28/03/2021 20:00,29.68,47640,3744,235,123,4735,5,8842,3.273.869.048
28/03/2021 21:00,27.38,46482,3574,229,168,4594,6,8571,3.273.869.048
28/03/2021 22:00,23.74,44758,3519,222,197,4335,6,8279,3.273.869.048
28/03/2021 23:00,22.3,42566,3817,209,202,4025,6,8259,3.273.869.048
29/03/2021 00:00,21.47,42064,3955,68,208,3790,6,8027,328.047.619
29/03/2021 01:00,21.42,41849,4187,68,223,3574,5,8057,328.047.619
29/03/2021 02:00,21.66,42035,4514,63,232,3331,7,8147,328.047.619
29/03/2021 03:00,22.01,42757,4676,59,235,3163,7,8140,328.047.619
29/03/2021 04:00,24.24,44772,4788,58,236,3158,7,8247,328.047.619
29/03/2021 05:00,30.84,48163,4921,59,235,3303,7,8525,328.047.619
29/03/2021 06:00,35.85,51312,4877,54,231,3518,7,8687,328.047.619
29/03/2021 07:00,36.35,52299,4806,46,219,3840,8,8919,328.047.619
29/03/2021 08:00,35.77,51975,4773,41,212,4306,7,9339,328.047.619
29/03/2021 09:00,32.21,51770,4787,37,205,4780,6,9815,328.047.619
29/03/2021 10:00,28.63,51389,4843,34,197,5220,6,10300,328.047.619
29/03/2021 11:00,24.75,50983,4896,33,192,5584,5,10710,328.047.619
29/03/2021 12:00,20.81,50637,4876,32,187,5832,5,10932,328.047.619
29/03/2021 13:00,19.7,50234,4768,31,185,5946,6,10936,328.047.619
29/03/2021 14:00,20.77,49944,4721,27,183,6015,6,10952,328.047.619
29/03/2021 15:00,21.71,49298,4677,23,184,6123,7,11014,328.047.619
29/03/2021 16:00,25.15,49046,4452,21,191,6306,8,10978,328.047.619
29/03/2021 17:00,27,49143,4163,21,208,6490,10,10892,328.047.619
29/03/2021 18:00,26.92,49529,4030,22,227,6657,13,10949,328.047.619
29/03/2021 19:00,25.29,49156,4025,28,241,6803,13,11110,328.047.619
29/03/2021 20:00,22.89,47850,3912,35,250,6832,14,11043,328.047.619
29/03/2021 21:00,21.36,45902,3775,40,259,6807,14,10895,328.047.619
29/03/2021 22:00,19.89,43842,3577,43,262,6843,14,10739,328.047.619
29/03/2021 23:00,18.8,41382,3647,152,242,6717,10,10768,328.047.619
30/03/2021 00:00,18.62,40622,3475,155,233,6579,7,10449,328.047.619
30/03/2021 01:00,17.63,40374,3262,161,222,6539,5,10189,328.047.619
30/03/2021 02:00,17.69,40538,3191,166,211,6604,7,10179,328.047.619
30/03/2021 03:00,18.18,41343,3084,171,206,6707,5,10173,328.047.619
30/03/2021 04:00,20.27,43066,2997,180,206,6806,5,10194,328.047.619
30/03/2021 05:00,23.18,46242,2950,189,203,6839,5,10186,328.047.619
30/03/2021 06:00,29.82,49332,2898,192,203,6756,5,10054,328.047.619
30/03/2021 07:00,32.93,50101,2804,194,196,6513,6,9713,328.047.619
30/03/2021 08:00,34.42,49850,2708,199,193,6378,4,9482,328.047.619
30/03/2021 09:00,33.03,49747,2641,202,191,6330,6,9370,328.047.619
30/03/2021 10:00,30.88,49080,2630,204,193,6368,8,9403,328.047.619
30/03/2021 11:00,28.19,48378,2648,208,200,6417,7,9480,328.047.619
30/03/2021 12:00,25.12,47737,2624,207,206,6403,7,9447,328.047.619
30/03/2021 13:00,24.33,47056,2604,202,210,6319,6,9341,328.047.619
30/03/2021 14:00,24.44,46678,2572,200,219,6176,6,9173,328.047.619
30/03/2021 15:00,25.7,46428,2518,207,226,5965,6,8922,328.047.619
30/03/2021 16:00,30.11,46836,2355,223,221,5775,5,8579,328.047.619
30/03/2021 17:00,33,47073,2144,235,221,5728,3,8331,328.047.619
30/03/2021 18:00,34.71,47348,2022,242,229,5804,3,8300,328.047.619
30/03/2021 19:00,32.47,47238,2056,246,234,5861,4,8401,328.047.619
30/03/2021 20:00,28.65,46329,2095,249,230,5855,4,8433,328.047.619
30/03/2021 21:00,24.75,44564,2122,249,222,5765,4,8362,328.047.619
30/03/2021 22:00,22.97,42535,2061,242,214,5650,4,8171,328.047.619
30/03/2021 23:00,22,41130,1819,233,171,5471,3,7697,328.047.619
31/03/2021 00:00,21.65,40459,1690,223,164,5294,4,7375,328.047.619
31/03/2021 01:00,21.56,40302,1553,207,167,5140,4,7071,328.047.619
31/03/2021 02:00,21.75,40527,1408,190,173,5024,5,6800,328.047.619
31/03/2021 03:00,22.78,41188,1243,168,180,4950,5,6546,328.047.619
31/03/2021 04:00,26.34,43036,1141,148,186,4860,6,6341,328.047.619
31/03/2021 05:00,33.72,46242,1102,130,192,4747,5,6176,328.047.619
31/03/2021 06:00,37.38,49223,1034,114,193,4569,5,5915,328.047.619
31/03/2021 07:00,38.82,50083,1004,103,191,4216,5,5519,328.047.619
31/03/2021 08:00,37.97,50045,926,99,201,4008,5,5239,328.047.619
31/03/2021 09:00,37.74,49734,826,104,212,3988,5,5135,328.047.619
31/03/2021 10:00,37.16,49192,745,111,221,3995,4,5076,328.047.619
31/03/2021 11:00,36.08,48395,739,118,219,3990,4,5070,328.047.619
31/03/2021 12:00,35.26,47788,768,121,216,3981,4,5090,328.047.619
31/03/2021 13:00,35.44,47210,788,116,204,3987,3,5098,328.047.619
31/03/2021 14:00,35.17,46962,810,106,179,3975,3,5073,328.047.619
31/03/2021 15:00,35.18,46791,783,92,151,3931,3,4960,328.047.619
31/03/2021 16:00,35.87,47182,717,79,121,3752,3,4672,328.047.619
31/03/2021 17:00,37.58,47522,698,73,101,3648,3,4523,328.047.619
31/03/2021 18:00,37.72,47932,703,68,93,3806,3,4673,328.047.619
31/03/2021 19:00,35.85,47943,732,62,88,4102,3,4987,328.047.619
31/03/2021 20:00,32.98,47184,746,54,81,4368,3,5252,328.047.619
31/03/2021 21:00,29.84,45565,782,46,72,4588,3,5491,328.047.619
31/03/2021 22:00,24.92,43659,810,42,69,4706,3,5630,328.047.619
31/03/2021 23:00,22.84,41880,1407,34,122,4614,3,6180,328.047.619
01/04/2021 00:00,22.4,41131,1685,33,119,4599,3,6439,328.047.619
01/04/2021 01:00,22.01,40870,1734,35,108,4688,3,6568,328.047.619
01/04/2021 02:00,21.88,41119,1807,37,92,4806,3,6745,328.047.619
01/04/2021 03:00,22.26,41768,2036,42,81,4871,3,7033,328.047.619
01/04/2021 04:00,25.04,43154,2257,44,77,4793,3,7174,328.047.619
01/04/2021 05:00,32.5,45062,2330,44,77,4587,3,7041,328.047.619
01/04/2021 06:00,35.1,46859,2370,44,81,4276,4,6775,328.047.619
01/04/2021 07:00,37.33,47943,2422,42,79,3778,4,6325,328.047.619
01/04/2021 08:00,38.95,48310,2412,43,78,3514,3,6050,328.047.619
01/04/2021 09:00,37.98,48445,2284,38,86,3521,3,5932,328.047.619
01/04/2021 10:00,36.38,48108,2099,27,112,3459,3,5700,328.047.619
01/04/2021 11:00,33.35,47387,1832,22,141,3452,3,5450,328.047.619
01/04/2021 12:00,28.69,46621,1596,26,155,3533,4,5314,328.047.619
01/04/2021 13:00,22.47,45837,1384,34,156,3647,5,5226,328.047.619
01/04/2021 14:00,25.36,45396,1427,44,154,3768,6,5399,328.047.619
01/04/2021 15:00,31.12,45232,1408,54,154,3841,7,5464,328.047.619
01/04/2021 16:00,32.94,45682,1341,65,158,3828,8,5400,328.047.619
01/04/2021 17:00,35.23,46219,1241,76,152,3806,6,5281,328.047.619
01/04/2021 18:00,35.72,46570,1143,84,166,3927,5,5325,328.047.619
01/04/2021 19:00,34.39,46542,1046,84,179,4170,4,5483,328.047.619
01/04/2021 20:00,30.86,45945,1030,77,176,4410,4,5697,328.047.619
01/04/2021 21:00,29.33,44608,1107,67,162,4593,5,5934,328.047.619
01/04/2021 22:00,24.98,43015,1193,59,149,4670,5,6076,328.047.619
01/04/2021 23:00,24.49,41662,1148,62,96,4613,5,5924,328.047.619
02/04/2021 00:00,23.95,40876,1271,58,89,4635,4,6057,328.047.619
02/04/2021 01:00,22.77,40617,1343,54,82,4625,4,6108,328.047.619
02/04/2021 02:00,22.51,40748,1659,53,71,4588,5,6376,328.047.619
02/04/2021 03:00,22.71,41170,1952,51,66,4603,5,6677,328.047.619
02/04/2021 04:00,23.03,41741,2175,48,66,4615,5,6909,328.047.619
02/04/2021 05:00,26.7,42593,2491,46,63,4575,6,7181,328.047.619
02/04/2021 06:00,27.89,43693,2795,41,61,4458,6,7361,328.047.619
02/04/2021 07:00,27.58,44926,2998,36,57,4366,5,7462,328.047.619
02/04/2021 08:00,27.95,45754,3285,37,54,4565,5,7946,328.047.619
02/04/2021 09:00,23.95,46035,3489,41,63,4891,5,8489,328.047.619
02/04/2021 10:00,21.81,45681,3524,47,83,5087,5,8746,328.047.619
02/04/2021 11:00,20.22,45184,3556,54,97,5236,4,8947,328.047.619
02/04/2021 12:00,14.42,44400,3522,63,101,5389,4,9079,328.047.619
02/04/2021 13:00,4.58,43805,3345,71,109,5534,4,9063,328.047.619
02/04/2021 14:00,4.94,43602,3306,83,112,5636,3,9140,328.047.619
02/04/2021 15:00,9.78,43842,3095,91,102,5716,3,9007,328.047.619
02/04/2021 16:00,18.34,44686,3005,91,88,5769,4,8957,328.047.619
02/04/2021 17:00,21.82,45240,2757,97,74,5720,4,8652,328.047.619
02/04/2021 18:00,24.09,45386,2548,99,66,5796,4,8513,328.047.619
02/04/2021 19:00,25.28,45673,2510,94,62,5994,4,8664,328.047.619
02/04/2021 20:00,25,45612,2467,91,63,6159,4,8784,328.047.619
02/04/2021 21:00,23.26,44424,2356,85,65,6225,4,8735,328.047.619
02/04/2021 22:00,22.14,43014,2179,73,64,6186,5,8507,328.047.619
02/04/2021 23:00,22.86,41599,2071,107,77,5917,6,8178,328.047.619
03/04/2021 00:00,20.93,40931,2018,44,80,5800,7,7949,328.047.619
03/04/2021 01:00,20.11,40675,1845,48,89,5625,9,7616,328.047.619
03/04/2021 02:00,20.29,40772,1778,51,95,5421,7,7352,328.047.619
03/04/2021 03:00,20.66,41237,1614,57,99,5140,7,6917,328.047.619
03/04/2021 04:00,21.14,41581,1516,64,105,4710,6,6401,328.047.619
03/04/2021 05:00,24.14,42098,1432,67,104,4250,7,5860,328.047.619
03/04/2021 06:00,30.93,43134,1270,62,102,3740,6,5180,328.047.619
03/04/2021 07:00,34.04,44553,1125,55,107,3234,8,4529,328.047.619
03/04/2021 08:00,34.17,45471,1002,50,120,3025,8,4205,328.047.619
03/04/2021 09:00,33.04,45758,879,45,128,2975,11,4038,328.047.619
03/04/2021 10:00,28.45,45414,820,44,128,2875,11,3878,328.047.619
03/04/2021 11:00,24,44830,847,47,133,2923,11,3961,328.047.619
03/04/2021 12:00,19.88,44232,888,50,143,3172,11,4264,328.047.619
03/04/2021 13:00,16.65,43590,984,56,157,3493,11,4701,328.047.619
03/04/2021 14:00,14.42,43468,1129,62,171,3797,10,5169,328.047.619
03/04/2021 15:00,18.63,43672,1194,73,181,4094,9,5551,328.047.619
03/04/2021 16:00,21.21,44295,1113,89,185,4313,8,5708,328.047.619
03/04/2021 17:00,25.48,44494,968,106,175,4476,6,5731,328.047.619
03/04/2021 18:00,30.17,44615,852,126,170,4654,5,5807,328.047.619
03/04/2021 19:00,31.12,44904,833,148,170,4884,5,6040,328.047.619
03/04/2021 20:00,27.68,44941,879,159,159,5079,5,6281,328.047.619
03/04/2021 21:00,24.84,43969,1001,162,143,5210,4,6520,328.047.619
03/04/2021 22:00,21.87,42493,1076,158,119,5287,4,6644,328.047.619
03/04/2021 23:00,21.84,41471,1017,147,94,5449,4,6711,328.047.619
04/04/2021 00:00,20.98,40876,1203,163,82,5485,4,6937,328.047.619
04/04/2021 01:00,19.6,40694,1508,158,85,5555,5,7311,328.047.619
04/04/2021 02:00,19.41,40815,1827,145,89,5698,6,7765,328.047.619
04/04/2021 03:00,19.11,41062,2107,130,95,5894,6,8232,328.047.619
04/04/2021 04:00,18.83,41468,2368,119,103,6056,6,8652,328.047.619
04/04/2021 05:00,18.28,41931,2609,113,108,6130,6,8966,328.047.619
04/04/2021 06:00,18.61,42749,2807,112,99,6129,6,9153,328.047.619
04/04/2021 07:00,18.98,43985,3070,106,85,5999,5,9265,328.047.619
04/04/2021 08:00,18.85,44845,3375,103,89,5880,6,9453,328.047.619
04/04/2021 09:00,18.21,45595,3563,110,111,5951,7,9742,328.047.619
04/04/2021 10:00,15.07,45567,3680,115,140,6227,10,10172,328.047.619
04/04/2021 11:00,14.43,45116,3967,117,170,6629,10,10893,328.047.619
04/04/2021 12:00,8.77,44612,4227,116,200,7012,12,11567,328.047.619
04/04/2021 13:00,3.24,44243,4440,117,228,7262,13,12060,328.047.619
04/04/2021 14:00,1.53,43837,4829,119,248,7389,14,12599,328.047.619
04/04/2021 15:00,2.39,44110,5144,119,257,7469,14,13003,328.047.619
04/04/2021 16:00,8.93,45152,5280,119,243,7571,15,13228,328.047.619
04/04/2021 17:00,14.58,45733,5382,122,233,7654,14,13405,328.047.619
04/04/2021 18:00,17.02,46278,5399,127,267,7686,15,13494,328.047.619
04/04/2021 19:00,16.92,46530,5647,136,319,7720,16,13838,328.047.619
04/04/2021 20:00,15.98,46124,5687,144,355,7790,16,13992,328.047.619
04/04/2021 21:00,11.38,44755,5676,147,373,7828,16,14040,328.047.619
04/04/2021 22:00,6.93,43243,5671,147,388,7735,16,13957,328.047.619
04/04/2021 23:00,1.51,41852,5813,74,380,7656,16,13939,328.047.619
05/04/2021 00:00,0.1,41702,5488,75,384,6985,16,12948,315.922.619
05/04/2021 01:00,0.06,41819,5347,78,388,6668,16,12497,315.922.619
05/04/2021 02:00,0.08,42291,5223,79,390,6567,16,12275,315.922.619
05/04/2021 03:00,0.08,42896,4979,73,396,6443,16,11907,315.922.619
05/04/2021 04:00,0.1,43438,4871,61,402,6302,16,11652,315.922.619
05/04/2021 05:00,1.08,44191,4771,51,413,6480,16,11731,315.922.619
05/04/2021 06:00,1.59,45393,4741,41,423,6318,16,11539,315.922.619
05/04/2021 07:00,3.25,47295,4850,36,434,6134,16,11470,315.922.619
05/04/2021 08:00,5.1,48668,4978,38,453,6060,16,11545,315.922.619
05/04/2021 09:00,4.89,49510,5175,41,469,5951,16,11652,315.922.619
05/04/2021 10:00,5.77,49547,5287,43,474,5837,16,11657,315.922.619
05/04/2021 11:00,3.89,49103,5294,47,456,5771,16,11584,315.922.619
05/04/2021 12:00,2.43,48744,5080,53,419,5683,10,11245,315.922.619
05/04/2021 13:00,1.47,48214,4856,56,389,5626,8,10935,315.922.619
05/04/2021 14:00,1.42,47994,4842,62,365,5723,12,11004,315.922.619
05/04/2021 15:00,1.72,48041,5387,63,338,5830,10,11628,315.922.619
05/04/2021 16:00,3.82,48491,5553,57,327,5803,10,11750,315.922.619
05/04/2021 17:00,9.03,48970,5404,52,322,5658,8,11444,315.922.619
05/04/2021 18:00,19.22,49225,4759,49,308,5625,5,10746,315.922.619
05/04/2021 19:00,21.06,49736,4826,46,291,5755,5,10923,315.922.619
05/04/2021 20:00,19.97,49601,5005,43,280,5873,6,11207,315.922.619
05/04/2021 21:00,18.53,48306,4988,42,278,5934,5,11247,315.922.619
05/04/2021 22:00,12.32,46775,5051,41,281,5912,5,11290,315.922.619
05/04/2021 23:00,15.47,45632,5347,272,263,5888,5,11775,315.922.619
06/04/2021 00:00,13.95,45172,5143,271,263,5653,4,11334,315.922.619
06/04/2021 01:00,12.65,44937,5169,271,268,5441,5,11154,315.922.619
06/04/2021 02:00,14.91,45199,5097,272,285,5289,5,10948,315.922.619
06/04/2021 03:00,16.55,45885,4847,272,301,5208,6,10634,315.922.619
06/04/2021 04:00,22,47678,4777,273,309,5167,9,10535,315.922.619
06/04/2021 05:00,34.66,50236,4765,273,319,5053,10,10420,315.922.619
06/04/2021 06:00,37.85,53128,4697,273,330,4861,11,10172,315.922.619
06/04/2021 07:00,40.63,54061,4807,273,335,4643,11,10069,315.922.619
06/04/2021 08:00,37.84,53844,4909,273,346,4629,10,10167,315.922.619
06/04/2021 09:00,35.91,53548,5052,271,362,4741,11,10437,315.922.619
06/04/2021 10:00,32.55,52937,5139,263,370,4864,13,10649,315.922.619
06/04/2021 11:00,27.99,52219,5223,252,365,4906,13,10759,315.922.619
06/04/2021 12:00,21,51824,5153,237,358,4866,14,10628,315.922.619
06/04/2021 13:00,19.63,51386,5100,229,351,4777,15,10472,315.922.619
06/04/2021 14:00,19.38,51160,5137,218,325,4692,15,10387,315.922.619
06/04/2021 15:00,22.99,51098,5128,206,281,4581,14,10210,315.922.619
06/04/2021 16:00,32.58,51501,5078,176,236,4553,13,10056,315.922.619
06/04/2021 17:00,37.53,51584,5096,151,186,4534,11,9978,315.922.619
06/04/2021 18:00,37.85,51688,4743,128,156,4602,11,9640,315.922.619
06/04/2021 19:00,36.47,51547,4361,124,156,4805,11,9457,315.922.619
06/04/2021 20:00,34.94,50680,3729,133,166,5010,10,9048,315.922.619
06/04/2021 21:00,33.96,49043,3191,144,174,5198,9,8716,315.922.619
06/04/2021 22:00,29.77,47057,2662,144,181,5352,9,8348,315.922.619
06/04/2021 23:00,24.14,45654,3273,145,135,5710,21,9284,315.922.619
07/04/2021 00:00,24.24,44875,2737,150,136,5917,19,8959,315.922.619
07/04/2021 01:00,25.4,44704,2259,160,138,6034,15,8606,315.922.619
07/04/2021 02:00,26.68,44979,1985,168,134,6047,14,8348,315.922.619
07/04/2021 03:00,26.59,45742,1806,175,132,6018,14,8145,315.922.619
07/04/2021 04:00,32.27,47703,1742,183,127,5910,12,7974,315.922.619
07/04/2021 05:00,36.91,51173,1755,186,117,5685,15,7758,315.922.619
07/04/2021 06:00,38.69,54456,1841,184,105,5294,13,7437,315.922.619
07/04/2021 07:00,39.59,55295,1965,191,105,4845,14,7120,315.922.619
07/04/2021 08:00,39.21,54943,2154,196,121,4619,15,7105,315.922.619
07/04/2021 09:00,38.99,54551,2402,197,137,4369,24,7129,315.922.619
07/04/2021 10:00,38.87,53944,2497,200,149,4074,27,6947,315.922.619
07/04/2021 11:00,37.89,53185,2631,204,165,3848,28,6876,315.922.619
07/04/2021 12:00,36.93,52728,2727,211,180,3705,25,6848,315.922.619
07/04/2021 13:00,34.99,52210,2841,213,189,3611,24,6878,315.922.619
07/04/2021 14:00,34.76,51833,3030,208,190,3515,22,6965,315.922.619
07/04/2021 15:00,36.7,51666,3222,206,185,3393,14,7020,315.922.619
07/04/2021 16:00,37.7,51974,3346,199,165,3244,10,6964,315.922.619
07/04/2021 17:00,38.94,51850,3307,185,142,2988,6,6628,315.922.619
07/04/2021 18:00,39.52,52047,3141,184,130,2964,5,6424,315.922.619
07/04/2021 19:00,39.51,51966,3202,193,134,3184,5,6718,315.922.619
07/04/2021 20:00,39.05,51123,3340,200,133,3404,4,7081,315.922.619
07/04/2021 21:00,37.72,49194,3419,206,124,3562,3,7314,315.922.619
07/04/2021 22:00,34.28,47081,3389,206,116,3608,4,7323,315.922.619
07/04/2021 23:00,35.24,45178,3742,203,146,2876,11,6978,315.922.619
08/04/2021 00:00,35.14,44463,3583,197,139,2801,9,6729,315.922.619
08/04/2021 01:00,35.28,44369,3574,188,136,2716,9,6623,315.922.619
08/04/2021 02:00,35.98,44691,3564,177,132,2598,10,6481,315.922.619
08/04/2021 03:00,36.65,45386,3481,164,135,2485,12,6277,315.922.619
08/04/2021 04:00,38.33,47218,3441,150,138,2313,10,6052,315.922.619
08/04/2021 05:00,41.13,50392,3463,138,139,2062,8,5810,315.922.619
08/04/2021 06:00,46.52,53296,3304,124,124,1736,6,5294,315.922.619
08/04/2021 07:00,66.31,54127,3366,117,120,1400,7,5010,315.922.619
08/04/2021 08:00,55.48,53655,3488,112,129,1275,7,5011,315.922.619
08/04/2021 09:00,49.35,53156,3610,105,130,1323,7,5175,315.922.619
08/04/2021 10:00,44.68,52390,3657,98,140,1513,11,5419,315.922.619
08/04/2021 11:00,42.45,51525,3730,89,155,1817,7,5798,315.922.619
08/04/2021 12:00,40.65,50866,3941,77,171,2193,6,6388,315.922.619
08/04/2021 13:00,38.77,50371,4300,65,188,2558,8,7119,315.922.619
08/04/2021 14:00,38.01,50139,4715,54,192,2861,9,7831,315.922.619
08/04/2021 15:00,37.59,50307,5001,42,183,3079,13,8318,315.922.619
08/04/2021 16:00,38.06,50814,5056,34,162,3146,11,8409,315.922.619
08/04/2021 17:00,38.38,51114,5049,29,143,3116,9,8346,315.922.619
08/04/2021 18:00,38.33,51402,4907,27,141,3248,6,8329,315.922.619
08/04/2021 19:00,37.7,51307,5077,24,156,3735,6,8998,315.922.619
08/04/2021 20:00,35.17,50575,5280,21,182,4413,8,9904,315.922.619
08/04/2021 21:00,30.4,49002,5431,19,210,5029,10,10699,315.922.619
08/04/2021 22:00,20.8,47198,5502,20,238,5490,11,11261,315.922.619
08/04/2021 23:00,21.59,45378,5779,10,286,5725,27,11827,315.922.619
09/04/2021 00:00,21.59,44630,5579,9,286,5964,24,11862,315.922.619
09/04/2021 01:00,20.66,44341,5670,9,288,6149,25,12141,315.922.619
09/04/2021 02:00,20.8,44421,5652,9,297,6296,25,12279,315.922.619
09/04/2021 03:00,21.6,44987,5576,11,307,6405,27,12326,315.922.619
09/04/2021 04:00,22.66,46630,5599,16,319,6456,33,12423,315.922.619
09/04/2021 05:00,27.46,49608,5686,20,335,6402,39,12482,315.922.619
09/04/2021 06:00,34.61,52566,5613,20,350,6277,39,12299,315.922.619
09/04/2021 07:00,35.47,53409,5562,21,371,6164,39,12157,315.922.619
09/04/2021 08:00,35.3,53264,5400,26,406,6120,40,11992,315.922.619
09/04/2021 09:00,34.61,53058,5355,36,441,6142,40,12014,315.922.619
09/04/2021 10:00,31.49,52552,5348,53,464,6216,40,12121,315.922.619
09/04/2021 11:00,28.26,51812,5298,73,470,6309,40,12190,315.922.619
09/04/2021 12:00,24.9,50990,5179,86,467,6489,41,12262,315.922.619
09/04/2021 13:00,21.95,50203,5128,90,462,6671,41,12392,315.922.619
09/04/2021 14:00,21.44,49541,5219,91,454,6893,41,12698,315.922.619
09/04/2021 15:00,21.63,49349,5224,92,444,7047,41,12848,315.922.619
09/04/2021 16:00,24.34,49651,5109,93,431,7026,41,12700,315.922.619
09/04/2021 17:00,28.3,49718,4770,85,406,6768,41,12070,315.922.619
09/04/2021 18:00,33.48,49515,4227,75,378,6519,40,11239,315.922.619
09/04/2021 19:00,34.12,49155,3918,68,369,6345,40,10740,315.922.619
09/04/2021 20:00,33.62,48413,3694,63,364,6227,39,10387,315.922.619
09/04/2021 21:00,31.36,47119,3511,66,352,6168,39,10136,315.922.619
09/04/2021 22:00,26.07,45752,3373,67,328,6091,37,9896,315.922.619
09/04/2021 23:00,26.62,44563,2961,36,307,5625,34,8963,315.922.619
10/04/2021 00:00,26.92,43646,2897,38,295,5566,33,8829,315.922.619
10/04/2021 01:00,27.11,43346,2868,42,269,5510,30,8719,315.922.619
10/04/2021 02:00,28.06,43474,2751,48,236,5432,27,8494,315.922.619
10/04/2021 03:00,29.58,43716,2532,54,208,5358,24,8176,315.922.619
10/04/2021 04:00,31.74,44261,2344,54,189,5255,25,7867,315.922.619
10/04/2021 05:00,33.85,44938,2192,51,173,5040,25,7481,315.922.619
10/04/2021 06:00,34.99,46193,1986,53,162,4687,25,6913,315.922.619
10/04/2021 07:00,36.92,47808,1876,53,154,4381,28,6492,315.922.619
10/04/2021 08:00,37.98,48696,1879,53,157,4403,32,6524,315.922.619
10/04/2021 09:00,38.24,48676,1804,55,168,4469,31,6527,315.922.619
10/04/2021 10:00,37.91,48224,1595,55,171,4463,32,6316,315.922.619
10/04/2021 11:00,36.86,47646,1342,58,171,4468,31,6070,315.922.619
10/04/2021 12:00,35.9,46806,1060,59,173,4499,28,5819,315.922.619
10/04/2021 13:00,34.84,46190,901,58,163,4521,25,5668,315.922.619
10/04/2021 14:00,34.56,45919,824,58,139,4527,25,5573,315.922.619
10/04/2021 15:00,34.88,46132,720,59,111,4478,20,5388,315.922.619
10/04/2021 16:00,36.86,46965,618,56,82,4250,16,5022,315.922.619
10/04/2021 17:00,38.31,47550,480,59,57,3938,11,4545,315.922.619
10/04/2021 18:00,39.09,47498,349,67,43,3814,9,4282,315.922.619
10/04/2021 19:00,38.07,47404,284,68,39,3904,9,4304,315.922.619
10/04/2021 20:00,37.35,47201,269,61,35,4025,10,4400,315.922.619
10/04/2021 21:00,36.45,46306,267,50,33,4100,11,4461,315.922.619
10/04/2021 22:00,34.95,45105,296,43,30,4087,12,4468,315.922.619
10/04/2021 23:00,36.65,43778,277,52,19,4010,11,4369,315.922.619
11/04/2021 00:00,36.59,43103,400,53,21,3888,11,4373,315.922.619
11/04/2021 01:00,35.97,42825,615,60,21,3756,11,4463,315.922.619
11/04/2021 02:00,36.31,42765,836,64,22,3620,12,4554,315.922.619
11/04/2021 03:00,36.29,43000,1104,62,29,3524,11,4730,315.922.619
11/04/2021 04:00,35.12,43426,1370,61,43,3411,12,4897,315.922.619
11/04/2021 05:00,35.85,43825,1617,65,61,3268,12,5023,315.922.619
11/04/2021 06:00,34.62,44828,1811,69,76,3127,10,5093,315.922.619
11/04/2021 07:00,36.3,46028,1980,70,75,3020,4,5149,315.922.619
11/04/2021 08:00,37.07,46932,2077,73,63,2996,3,5212,315.922.619
11/04/2021 09:00,37.04,47159,2127,89,69,3057,3,5345,315.922.619
11/04/2021 10:00,36.7,46979,2017,113,87,3141,4,5362,315.922.619
11/04/2021 11:00,36.7,46546,1915,137,120,3228,4,5404,315.922.619
11/04/2021 12:00,36.42,46143,1837,159,168,3293,5,5462,315.922.619
11/04/2021 13:00,35.33,45742,1866,185,200,3269,4,5524,315.922.619
11/04/2021 14:00,35.48,45496,1973,206,220,3161,7,5567,315.922.619
11/04/2021 15:00,36.08,45841,1988,221,232,3014,10,5465,315.922.619
11/04/2021 16:00,38.7,46695,2005,237,251,2822,14,5329,315.922.619
11/04/2021 17:00,40.34,47434,1907,252,294,2680,20,5153,315.922.619
11/04/2021 18:00,41.3,47853,1711,261,342,2630,21,4965,315.922.619
11/04/2021 19:00,41.4,47828,1595,266,370,2602,22,4855,315.922.619
11/04/2021 20:00,41.12,47296,1546,269,381,2486,21,4703,315.922.619
11/04/2021 21:00,40.22,46049,1469,271,388,2377,21,4526,315.922.619
11/04/2021 22:00,37.02,44592,1489,272,394,2266,22,4443,315.922.619
11/04/2021 23:00,36.82,43775,2698,85,393,2942,22,6140,315.922.619
12/04/2021 00:00,35.54,43124,2806,98,385,2969,23,6281,2.972.380.952
12/04/2021 01:00,34.84,42694,2877,110,371,3021,26,6405,2.972.380.952
12/04/2021 02:00,34.73,42817,2976,127,354,3091,26,6574,2.972.380.952
12/04/2021 03:00,34.93,43423,3023,149,340,3169,26,6707,2.972.380.952
12/04/2021 04:00,37.48,45104,3039,170,332,3231,24,6796,2.972.380.952
12/04/2021 05:00,40.9,48031,3110,193,324,3245,21,6893,2.972.380.952
12/04/2021 06:00,46.96,50960,3080,218,309,3256,19,6882,2.972.380.952
12/04/2021 07:00,54.06,51866,3146,237,287,3301,17,6988,2.972.380.952
12/04/2021 08:00,49.26,51875,3382,251,268,3447,14,7362,2.972.380.952
12/04/2021 09:00,47.07,51828,3622,260,255,3591,15,7743,2.972.380.952
12/04/2021 10:00,45.33,51276,3758,265,234,3705,14,7976,2.972.380.952
12/04/2021 11:00,41.72,50584,3939,268,199,3812,16,8234,2.972.380.952
12/04/2021 12:00,39.92,50200,4068,269,161,3917,18,8433,2.972.380.952
12/04/2021 13:00,37.8,49784,4139,272,127,3938,23,8499,2.972.380.952
12/04/2021 14:00,37.71,49489,4276,274,104,3875,15,8544,2.972.380.952
12/04/2021 15:00,38.1,49219,4360,276,97,3809,14,8556,2.972.380.952
12/04/2021 16:00,40.62,49372,4201,275,112,3739,11,8338,2.972.380.952
12/04/2021 17:00,41.53,49586,3934,275,122,3590,9,7930,2.972.380.952
12/04/2021 18:00,42.5,49861,3653,274,119,3505,9,7560,2.972.380.952
12/04/2021 19:00,41.62,49556,3615,273,118,3551,7,7564,2.972.380.952
12/04/2021 20:00,41.55,48845,3627,271,116,3651,8,7673,2.972.380.952
12/04/2021 21:00,39.26,47020,3623,268,109,3785,7,7792,2.972.380.952
12/04/2021 22:00,36.01,45065,3705,262,108,3908,7,7990,2.972.380.952
12/04/2021 23:00,36.98,44978,3250,125,101,3666,6,7148,2.972.380.952
13/04/2021 00:00,35.38,44079,3263,138,85,3684,5,7175,2.972.380.952
13/04/2021 01:00,34.92,43667,3434,150,82,3692,6,7364,2.972.380.952
13/04/2021 02:00,34.97,43657,3428,162,80,3711,6,7387,2.972.380.952
13/04/2021 03:00,35.5,44305,3354,174,76,3724,6,7334,2.972.380.952
13/04/2021 04:00,39.05,46139,3360,178,70,3681,6,7295,2.972.380.952
13/04/2021 05:00,41.86,49441,3317,179,66,3603,7,7172,2.972.380.952
13/04/2021 06:00,47.13,52738,3300,177,66,3463,7,7013,2.972.380.952
13/04/2021 07:00,51.18,53705,3296,179,63,3253,6,6797,2.972.380.952
13/04/2021 08:00,46.78,53326,3353,181,61,3151,6,6752,2.972.380.952
13/04/2021 09:00,43.49,52927,3546,181,65,3089,6,6887,2.972.380.952
13/04/2021 10:00,43.05,52481,3622,178,72,3000,7,6879,2.972.380.952
13/04/2021 11:00,42.15,51785,3687,177,78,2901,8,6851,2.972.380.952
13/04/2021 12:00,41.8,51300,3632,175,82,2838,11,6738,2.972.380.952
13/04/2021 13:00,39.46,50766,3704,170,85,2779,13,6751,2.972.380.952
13/04/2021 14:00,39.68,50514,3871,163,90,2741,14,6879,2.972.380.952
13/04/2021 15:00,41.22,50460,3942,155,92,2682,14,6885,2.972.380.952
13/04/2021 16:00,42.73,50875,3951,134,88,2596,14,6783,2.972.380.952
13/04/2021 17:00,44,51018,3748,109,82,2479,11,6429,2.972.380.952
13/04/2021 18:00,46.45,51198,3361,91,75,2451,8,5986,2.972.380.952
13/04/2021 19:00,46.07,51078,3171,79,73,2590,7,5920,2.972.380.952
13/04/2021 20:00,45.59,50391,3113,67,70,2794,11,6055,2.972.380.952
13/04/2021 21:00,43.08,48584,3041,60,63,3103,11,6278,2.972.380.952
13/04/2021 22:00,39.03,46350,2962,55,57,3381,10,6465,2.972.380.952
13/04/2021 23:00,38.96,44143,2005,47,52,3181,10,5295,2.972.380.952
14/04/2021 00:00,37.93,43345,1868,42,47,3376,9,5342,2.972.380.952
14/04/2021 01:00,37.68,43249,1775,33,42,3469,8,5327,2.972.380.952
14/04/2021 02:00,38.61,43467,1588,26,34,3510,8,5166,2.972.380.952
14/04/2021 03:00,39.59,44186,1402,23,30,3581,7,5043,2.972.380.952
14/04/2021 04:00,41.69,46045,1232,21,27,3597,7,4884,2.972.380.952
14/04/2021 05:00,47.35,49298,1112,19,24,3444,7,4606,2.972.380.952
14/04/2021 06:00,51.28,52452,993,15,23,3093,7,4131,2.972.380.952
14/04/2021 07:00,64.14,52969,879,14,28,2639,7,3567,2.972.380.952
14/04/2021 08:00,50.8,52223,787,14,36,2488,7,3332,2.972.380.952
14/04/2021 09:00,44.95,51634,682,15,44,2573,8,3322,2.972.380.952
14/04/2021 10:00,44.95,51052,611,17,54,2629,9,3320,2.972.380.952
14/04/2021 11:00,44.99,50312,564,19,68,2657,10,3318,2.972.380.952
14/04/2021 12:00,44.18,49791,544,19,88,2648,11,3310,2.972.380.952
14/04/2021 13:00,42.3,49226,564,22,103,2569,13,3271,2.972.380.952
14/04/2021 14:00,42.2,49032,658,24,118,2470,16,3286,2.972.380.952
14/04/2021 15:00,42.6,49025,760,24,132,2349,17,3282,2.972.380.952
14/04/2021 16:00,44.32,49491,849,23,140,2172,18,3202,2.972.380.952
14/04/2021 17:00,49.21,49508,859,21,145,1978,16,3019,2.972.380.952
14/04/2021 18:00,50.29,49671,789,22,168,1914,14,2907,2.972.380.952
14/04/2021 19:00,49.73,49806,747,23,198,2072,15,3055,2.972.380.952
14/04/2021 20:00,49.36,49363,767,26,214,2328,15,3350,2.972.380.952
14/04/2021 21:00,47.08,47670,735,27,226,2545,15,3548,2.972.380.952
14/04/2021 22:00,40.98,45652,662,24,239,2676,15,3616,2.972.380.952
14/04/2021 23:00,42.63,43570,357,21,226,2795,16,3415,2.972.380.952
15/04/2021 00:00,42.06,42873,350,18,232,2849,14,3463,2.972.380.952
15/04/2021 01:00,40.35,42805,339,12,238,2905,15,3509,2.972.380.952
15/04/2021 02:00,41.59,43002,309,10,241,3006,14,3580,2.972.380.952
15/04/2021 03:00,41.86,43663,291,10,247,3166,16,3730,2.972.380.952
15/04/2021 04:00,43.99,45363,292,10,255,3296,15,3868,2.972.380.952
15/04/2021 05:00,49.27,48268,302,10,260,3228,15,3815,2.972.380.952
15/04/2021 06:00,54.07,51025,313,8,260,2899,14,3494,2.972.380.952
15/04/2021 07:00,64.94,51681,309,7,253,2377,12,2958,2.972.380.952
15/04/2021 08:00,59.05,51072,298,9,251,2042,14,2614,2.972.380.952
15/04/2021 09:00,52.92,50500,308,14,257,1958,22,2559,2.972.380.952
15/04/2021 10:00,53.06,49707,393,21,271,1995,31,2711,2.972.380.952
15/04/2021 11:00,46.18,48736,487,29,286,2061,33,2896,2.972.380.952
15/04/2021 12:00,45.26,48210,577,36,293,2094,32,3032,2.972.380.952
15/04/2021 13:00,43.92,47699,705,42,296,2094,34,3171,2.972.380.952
15/04/2021 14:00,43.47,47322,909,44,290,2069,32,3344,2.972.380.952
15/04/2021 15:00,44.3,47321,1094,45,282,2033,32,3486,2.972.380.952
15/04/2021 16:00,45.26,47688,1266,46,277,1950,30,3569,2.972.380.952
15/04/2021 17:00,48.32,47900,1296,47,275,1905,30,3553,2.972.380.952
15/04/2021 18:00,56.9,48094,1234,49,272,2045,26,3626,2.972.380.952
15/04/2021 19:00,53.26,48003,1255,53,266,2329,23,3926,2.972.380.952
15/04/2021 20:00,45.29,47435,1280,57,260,2598,17,4212,2.972.380.952
15/04/2021 21:00,43.9,45991,1270,64,249,2831,18,4432,2.972.380.952
15/04/2021 22:00,42.37,44176,1197,71,237,2991,19,4515,2.972.380.952
15/04/2021 23:00,43.02,43058,1186,62,231,3081,23,4583,2.972.380.952
16/04/2021 00:00,42.73,42325,1100,67,230,3103,21,4521,2.972.380.952
16/04/2021 01:00,42.28,42074,1081,73,232,3095,19,4500,2.972.380.952
16/04/2021 02:00,42.63,42211,1067,72,234,3075,18,4466,2.972.380.952
16/04/2021 03:00,43.41,42769,1045,68,235,3025,18,4391,2.972.380.952
16/04/2021 04:00,45.04,44347,1057,67,235,2877,16,4252,2.972.380.952
16/04/2021 05:00,49.93,47088,1045,64,232,2578,18,3937,2.972.380.952
16/04/2021 06:00,62.4,49757,1030,54,223,2142,18,3467,2.972.380.952
16/04/2021 07:00,73.86,50378,986,46,212,1691,19,2954,2.972.380.952
16/04/2021 08:00,56.77,49891,944,53,202,1535,21,2755,2.972.380.952
16/04/2021 09:00,48.95,49259,1025,64,192,1604,24,2909,2.972.380.952
16/04/2021 10:00,48.4,48431,1192,75,180,1786,28,3261,2.972.380.952
16/04/2021 11:00,47.25,47724,1407,87,177,1962,34,3667,2.972.380.952
16/04/2021 12:00,45.44,46848,1508,102,178,2030,35,3853,2.972.380.952
16/04/2021 13:00,44.13,45729,1574,115,183,2022,35,3929,2.972.380.952
16/04/2021 14:00,43.24,45280,1693,123,182,1987,37,4022,2.972.380.952
16/04/2021 15:00,44.19,45242,1749,123,180,1935,35,4022,2.972.380.952
16/04/2021 16:00,45.1,45681,1823,115,175,1875,30,4018,2.972.380.952
16/04/2021 17:00,45.6,45890,1833,111,173,1815,29,3961,2.972.380.952
16/04/2021 18:00,45.99,45856,1658,109,166,1841,32,3806,2.972.380.952
16/04/2021 19:00,44.72,45613,1604,107,163,1966,29,3869,2.972.380.952
16/04/2021 20:00,44.17,45158,1571,109,164,2081,24,3949,2.972.380.952
16/04/2021 21:00,44.09,43946,1523,117,166,2164,16,3986,2.972.380.952
16/04/2021 22:00,43,42559,1550,123,166,2202,16,4057,2.972.380.952
16/04/2021 23:00,45.32,41397,1330,253,216,2207,13,4019,2.972.380.952
17/04/2021 00:00,44.79,40658,1252,244,214,2186,14,3910,2.972.380.952
17/04/2021 01:00,44.26,40398,1229,234,210,2161,14,3848,2.972.380.952
17/04/2021 02:00,44.36,40325,1252,226,205,2162,16,3861,2.972.380.952
17/04/2021 03:00,44.54,40497,1228,221,195,2208,17,3869,2.972.380.952
17/04/2021 04:00,44.42,40867,1202,217,177,2236,16,3848,2.972.380.952
17/04/2021 05:00,43.86,41268,1196,214,157,2175,16,3758,2.972.380.952
17/04/2021 06:00,44.42,42255,1232,217,135,1984,15,3583,2.972.380.952
17/04/2021 07:00,44.83,43418,1234,226,117,1757,10,3344,2.972.380.952
17/04/2021 08:00,44.88,44067,1238,231,103,1672,10,3254,2.972.380.952
17/04/2021 09:00,44.83,44051,1283,232,97,1740,10,3362,2.972.380.952
17/04/2021 10:00,44.16,43388,1387,228,101,1863,13,3592,2.972.380.952
17/04/2021 11:00,43.35,42804,1530,219,109,1940,13,3811,2.972.380.952
17/04/2021 12:00,41.73,42183,1591,207,117,1929,14,3858,2.972.380.952
17/04/2021 13:00,41.84,41626,1577,195,120,1870,13,3775,2.972.380.952
17/04/2021 14:00,41.94,41443,1534,183,123,1786,15,3641,2.972.380.952
17/04/2021 15:00,41.86,41652,1449,169,130,1712,16,3476,2.972.380.952
17/04/2021 16:00,44.05,42533,1419,148,124,1661,14,3366,2.972.380.952
17/04/2021 17:00,45.2,43054,1280,126,116,1654,11,3187,2.972.380.952
17/04/2021 18:00,46.29,42984,1069,116,123,1740,10,3058,2.972.380.952
17/04/2021 19:00,46.55,42875,1021,121,134,1902,12,3190,2.972.380.952
17/04/2021 20:00,46.29,42741,1109,129,143,2029,13,3423,2.972.380.952
17/04/2021 21:00,46.02,41842,1278,138,153,2083,15,3667,2.972.380.952
17/04/2021 22:00,44.11,40718,1323,138,157,2065,16,3699,2.972.380.952
17/04/2021 23:00,43.48,39334,1223,139,149,1988,20,3519,2.972.380.952
18/04/2021 00:00,42.2,38707,1194,134,152,1937,18,3435,2.972.380.952
18/04/2021 01:00,41.3,38391,1133,128,154,1880,17,3312,2.972.380.952
18/04/2021 02:00,41.45,38341,1072,119,152,1838,19,3200,2.972.380.952
18/04/2021 03:00,41.68,38439,1005,108,150,1803,18,3084,2.972.380.952
18/04/2021 04:00,41.96,38615,1026,98,146,1762,19,3051,2.972.380.952
18/04/2021 05:00,43.13,38857,1119,87,137,1671,16,3030,2.972.380.952
18/04/2021 06:00,43.4,39534,1181,71,108,1526,12,2898,2.972.380.952
18/04/2021 07:00,44.03,40447,1139,56,68,1328,7,2598,2.972.380.952
18/04/2021 08:00,44.82,40968,1015,47,49,1208,6,2325,2.972.380.952
18/04/2021 09:00,44.81,41079,886,38,51,1219,6,2200,2.972.380.952
18/04/2021 10:00,44.17,40782,860,30,69,1313,9,2281,2.972.380.952
18/04/2021 11:00,43.75,40261,899,23,83,1415,12,2432,2.972.380.952
18/04/2021 12:00,42.72,39709,934,16,83,1488,13,2534,2.972.380.952
18/04/2021 13:00,40.98,39392,943,11,77,1506,12,2549,2.972.380.952
18/04/2021 14:00,40.1,39311,961,8,82,1476,12,2539,2.972.380.952
18/04/2021 15:00,41.88,39709,970,9,95,1423,12,2509,2.972.380.952
18/04/2021 16:00,44.72,40590,1031,14,108,1407,13,2573,2.972.380.952
18/04/2021 17:00,45.69,41286,1004,24,115,1518,12,2673,2.972.380.952
18/04/2021 18:00,46.32,41691,892,39,141,1838,12,2922,2.972.380.952
18/04/2021 19:00,46.01,41872,912,57,188,2234,16,3407,2.972.380.952
18/04/2021 20:00,46.06,41667,1008,71,225,2531,20,3855,2.972.380.952
18/04/2021 21:00,44.98,40756,1098,91,239,2705,20,4153,2.972.380.952
18/04/2021 22:00,40.5,39482,1058,109,238,2724,20,4149,2.972.380.952
18/04/2021 23:00,38.93,38300,1167,132,232,2686,20,4237,2.972.380.952
19/04/2021 00:00,38.29,37681,1130,134,225,2589,21,4099,289.25
19/04/2021 01:00,38.19,37605,1017,140,223,2480,21,3881,289.25
19/04/2021 02:00,39.07,37821,959,146,222,2348,23,3698,289.25
19/04/2021 03:00,40.44,38402,869,150,220,2244,21,3504,289.25
19/04/2021 04:00,45.26,39830,822,154,215,2117,20,3328,289.25
19/04/2021 05:00,47.18,42636,838,156,193,1941,20,3148,289.25
19/04/2021 06:00,56.06,45474,857,152,143,1684,14,2850,289.25
19/04/2021 07:00,65.84,46126,821,154,95,1361,7,2438,289.25
19/04/2021 08:00,58.47,45640,765,164,80,1162,6,2177,289.25
19/04/2021 09:00,55.56,45182,719,178,91,1139,7,2134,289.25
19/04/2021 10:00,48.54,44440,733,191,116,1248,11,2299,289.25
19/04/2021 11:00,47.06,43701,761,197,131,1403,14,2506,289.25
19/04/2021 12:00,46.21,43157,770,200,121,1536,13,2640,289.25
19/04/2021 13:00,45.26,42525,813,201,105,1605,12,2736,289.25
19/04/2021 14:00,45.61,42162,871,203,104,1630,12,2820,289.25
19/04/2021 15:00,45.69,41998,881,204,109,1618,12,2824,289.25
19/04/2021 16:00,46.93,42383,905,203,110,1637,11,2866,289.25
19/04/2021 17:00,46.98,42560,962,201,109,1851,10,3133,289.25
19/04/2021 18:00,46.72,42792,985,197,124,2355,9,3670,289.25
19/04/2021 19:00,45.35,42749,1097,191,141,2883,14,4326,289.25
19/04/2021 20:00,44.38,42529,1146,180,149,3217,20,4712,289.25
19/04/2021 21:00,43.35,41136,1214,168,147,3374,19,4922,289.25
19/04/2021 22:00,39.53,39481,1180,151,141,3333,18,4823,289.25
19/04/2021 23:00,40.67,38312,882,90,116,2646,19,3753,289.25
20/04/2021 00:00,40.39,37536,766,87,105,2516,21,3495,289.25
20/04/2021 01:00,40.04,37447,666,86,94,2442,21,3309,289.25
20/04/2021 02:00,40.87,37718,586,82,80,2443,18,3209,289.25
20/04/2021 03:00,43,38382,498,77,66,2489,14,3144,289.25
20/04/2021 04:00,43.97,39948,447,73,57,2477,11,3065,289.25
20/04/2021 05:00,45.58,42933,408,62,48,2335,12,2865,289.25
20/04/2021 06:00,47.11,45859,374,43,34,2014,9,2474,289.25
20/04/2021 07:00,53.07,46564,311,31,20,1567,5,1934,289.25
20/04/2021 08:00,49.99,45817,245,31,10,1264,5,1555,289.25
20/04/2021 09:00,46.95,45101,200,39,8,1216,5,1468,289.25
20/04/2021 10:00,45.47,44373,182,49,10,1378,6,1625,289.25
20/04/2021 11:00,45.02,43542,189,57,12,1655,5,1918,289.25
20/04/2021 12:00,44.56,43044,192,64,13,1930,5,2204,289.25
20/04/2021 13:00,43.08,42607,194,71,22,2100,5,2392,289.25
20/04/2021 14:00,43.32,42329,226,79,33,2216,6,2560,289.25
20/04/2021 15:00,43.09,42253,295,85,43,2276,6,2705,289.25
20/04/2021 16:00,44.6,42580,355,88,55,2338,7,2843,289.25
20/04/2021 17:00,43.55,42659,392,88,62,2519,6,3067,289.25
20/04/2021 18:00,43.55,42808,429,90,72,2877,5,3473,289.25
20/04/2021 19:00,41.75,42909,416,89,72,3291,6,3874,289.25
20/04/2021 20:00,40.03,42565,402,84,52,3574,8,4120,289.25
20/04/2021 21:00,38.54,41003,453,80,39,3702,9,4283,289.25
20/04/2021 22:00,34.02,39061,548,75,32,3693,7,4355,289.25
20/04/2021 23:00,31.4,38656,980,64,22,4015,5,5086,289.25
21/04/2021 00:00,31.11,37966,1148,59,15,4045,5,5272,289.25
21/04/2021 01:00,29.94,37867,1343,56,16,4017,5,5437,289.25
21/04/2021 02:00,31.55,38046,1659,55,16,3945,5,5680,289.25
21/04/2021 03:00,34.01,38747,2014,55,19,3821,5,5914,289.25
21/04/2021 04:00,37.67,40399,2285,53,23,3539,5,5905,289.25
21/04/2021 05:00,42.98,43415,2708,43,23,3180,5,5959,289.25
21/04/2021 06:00,46.04,46421,3063,28,25,2827,5,5948,289.25
21/04/2021 07:00,46.64,47183,3455,19,25,2551,5,6055,289.25
21/04/2021 08:00,44.92,46845,3640,21,24,2586,5,6276,289.25
21/04/2021 09:00,42.42,46459,3931,30,28,2802,5,6796,289.25
21/04/2021 10:00,41.02,46001,4240,38,42,3093,5,7418,289.25
21/04/2021 11:00,38.86,45535,4544,47,65,3437,6,8099,289.25
21/04/2021 12:00,34.04,45311,4791,57,90,3763,7,8708,289.25
21/04/2021 13:00,29.95,44866,5068,64,103,4010,7,9252,289.25
21/04/2021 14:00,29.04,44732,5264,64,107,4247,8,9690,289.25
21/04/2021 15:00,28.17,44645,5394,63,103,4522,8,10090,289.25
21/04/2021 16:00,30.31,45019,5504,59,88,4802,7,10460,289.25
21/04/2021 17:00,33.98,45148,5404,52,71,5007,7,10541,289.25
21/04/2021 18:00,34.36,45227,5102,45,65,5258,8,10478,289.25
21/04/2021 19:00,33.9,45133,4980,41,79,5515,12,10627,289.25
21/04/2021 20:00,31.5,44795,4990,41,98,5794,14,10937,289.25
21/04/2021 21:00,27.47,43097,5026,40,109,6116,15,11306,289.25
21/04/2021 22:00,25.42,41100,5125,35,108,6456,13,11737,289.25
21/04/2021 23:00,21.27,40698,4947,31,172,7395,18,12563,289.25
22/04/2021 00:00,21.3,39989,4780,28,183,7575,16,12582,289.25
22/04/2021 01:00,21.21,39848,4760,25,188,7707,15,12695,289.25
22/04/2021 02:00,21.6,40032,4696,22,198,7764,17,12697,289.25
22/04/2021 03:00,22.01,40587,4663,20,212,7773,15,12683,289.25
22/04/2021 04:00,22.36,42102,4657,19,232,7727,21,12656,289.25
22/04/2021 05:00,27.28,45050,4742,12,251,7578,18,12601,289.25
22/04/2021 06:00,38.25,48127,4579,6,281,7359,16,12241,289.25
22/04/2021 07:00,39.94,49283,4807,4,310,7220,18,12359,289.25
22/04/2021 08:00,37.39,49151,4927,4,322,7197,18,12468,289.25
22/04/2021 09:00,33.25,49115,4976,6,343,7157,23,12505,289.25
22/04/2021 10:00,28.76,48904,4999,7,352,7093,28,12479,289.25
22/04/2021 11:00,24.6,48389,4881,9,353,7020,30,12293,289.25
22/04/2021 12:00,20.99,48016,4692,12,363,6931,28,12026,289.25
22/04/2021 13:00,17.37,47716,4623,13,372,6739,28,11775,289.25
22/04/2021 14:00,18.22,47416,4547,13,371,6543,28,11502,289.25
22/04/2021 15:00,21.95,47463,4543,14,357,6346,30,11290,289.25
22/04/2021 16:00,30.38,47788,4504,13,324,6099,24,10964,289.25
22/04/2021 17:00,35.31,47830,4184,12,286,5740,24,10246,289.25
22/04/2021 18:00,39.63,47792,3733,13,247,5447,20,9460,289.25
22/04/2021 19:00,39.22,47598,3620,15,216,5482,17,9350,289.25
22/04/2021 20:00,38.2,47081,3783,19,198,5727,13,9740,289.25
22/04/2021 21:00,33.22,45545,3922,24,207,5996,12,10161,289.25
22/04/2021 22:00,26.93,43706,4080,34,235,6228,13,10590,289.25
22/04/2021 23:00,26.91,42241,3538,52,302,6259,16,10167,289.25
23/04/2021 00:00,27.02,41409,3398,61,311,6410,16,10196,289.25
23/04/2021 01:00,26.94,41169,3404,68,309,6538,22,10341,289.25
23/04/2021 02:00,27.8,41281,3290,72,317,6652,41,10372,289.25
23/04/2021 03:00,30.62,41833,3118,75,327,6746,42,10308,289.25
23/04/2021 04:00,31.71,43350,3003,77,328,6780,41,10229,289.25
23/04/2021 05:00,41.29,46213,2868,75,306,6727,40,10016,289.25
23/04/2021 06:00,45.28,49034,2682,71,267,6634,33,9687,289.25
23/04/2021 07:00,45.9,49857,2795,70,247,6737,26,9875,289.25
23/04/2021 08:00,45.11,49540,2787,71,258,7022,32,10170,289.25
23/04/2021 09:00,42.98,49222,2704,73,280,7247,32,10336,289.25
23/04/2021 10:00,41.28,48503,2727,79,300,7452,34,10592,289.25
23/04/2021 11:00,38.44,47959,2627,89,316,7633,34,10699,289.25
23/04/2021 12:00,32.94,47162,2412,95,324,7760,34,10625,289.25
23/04/2021 13:00,26.05,46403,2371,93,327,7783,34,10608,289.25
23/04/2021 14:00,26.53,46134,2425,82,326,7732,34,10599,289.25
23/04/2021 15:00,27.94,46124,2457,65,307,7585,32,10446,289.25
23/04/2021 16:00,32.69,46457,2362,52,281,7331,31,10057,289.25
23/04/2021 17:00,36.14,46517,2177,40,246,6913,31,9407,289.25
23/04/2021 18:00,39.5,46339,1902,34,214,6536,30,8716,289.25
23/04/2021 19:00,39.66,45909,1693,33,206,6431,32,8395,289.25
23/04/2021 20:00,40.12,45706,1670,38,208,6514,28,8458,289.25
23/04/2021 21:00,39.58,44540,1728,43,203,6638,22,8634,289.25
23/04/2021 22:00,37.12,42989,1797,46,199,6744,19,8805,289.25
23/04/2021 23:00,35.09,41611,2177,141,195,6786,16,9315,289.25
24/04/2021 00:00,34.64,40803,1934,135,205,6837,18,9129,289.25
24/04/2021 01:00,34.49,40513,1797,132,210,6882,22,9043,289.25
24/04/2021 02:00,34.39,40440,1681,131,215,6905,17,8949,289.25
24/04/2021 03:00,35.08,40601,1603,130,215,6890,14,8852,289.25
24/04/2021 04:00,35.07,41015,1452,125,208,6822,15,8622,289.25
24/04/2021 05:00,39.83,41457,1272,115,196,6701,12,8296,289.25
24/04/2021 06:00,40.43,42606,1065,101,178,6650,16,8010,289.25
24/04/2021 07:00,42.45,43993,1028,93,185,6764,25,8095,289.25
24/04/2021 08:00,42.24,44954,952,97,225,6915,23,8212,289.25
24/04/2021 09:00,40.23,45322,879,108,272,7049,21,8329,289.25
24/04/2021 10:00,34.67,45040,956,121,308,7207,21,8613,289.25
24/04/2021 11:00,27.96,44476,993,131,330,7354,23,8831,289.25
24/04/2021 12:00,24.69,44033,1086,136,337,7460,26,9045,289.25
24/04/2021 13:00,21.75,43678,1293,140,342,7462,27,9264,289.25
24/04/2021 14:00,21.17,43562,1586,143,341,7361,27,9458,289.25
24/04/2021 15:00,23.87,43896,1843,146,329,7196,23,9537,289.25
24/04/2021 16:00,27.68,44833,1861,147,304,6903,21,9236,289.25
24/04/2021 17:00,38.83,45371,1591,151,265,6415,21,8443,289.25
24/04/2021 18:00,42.42,45150,1427,156,215,5923,19,7740,289.25
24/04/2021 19:00,43.95,44843,1284,155,184,5742,20,7385,289.25
24/04/2021 20:00,43.56,44936,1206,148,172,5825,22,7373,289.25
24/04/2021 21:00,42.85,44148,1110,137,173,5981,26,7427,289.25
24/04/2021 22:00,40.77,42795,979,125,173,6104,29,7410,289.25
24/04/2021 23:00,39.31,41242,921,118,179,5762,34,7014,289.25
25/04/2021 00:00,35,40499,799,111,178,5808,33,6929,289.25
25/04/2021 01:00,33.97,40179,714,110,177,5849,33,6883,289.25
25/04/2021 02:00,31.03,40228,783,110,175,5860,34,6962,289.25
25/04/2021 03:00,29.44,40315,840,110,182,5864,35,7031,289.25
25/04/2021 04:00,27.65,40346,959,106,187,5819,33,7104,289.25
25/04/2021 05:00,27.37,40715,1092,95,180,5693,32,7092,289.25
25/04/2021 06:00,27.42,41605,1130,78,177,5679,32,7096,289.25
25/04/2021 07:00,27.93,42857,1242,65,204,5869,35,7415,289.25
25/04/2021 08:00,26.54,43768,1309,63,229,6051,35,7687,289.25
25/04/2021 09:00,24.83,44271,1361,70,243,6143,32,7849,289.25
25/04/2021 10:00,23.57,44144,1543,80,261,6198,32,8114,289.25
25/04/2021 11:00,23.43,43962,1700,88,291,6213,32,8324,289.25
25/04/2021 12:00,17.19,43897,1855,100,314,6198,32,8499,289.25
25/04/2021 13:00,10.43,43837,2047,112,318,6078,32,8587,289.25
25/04/2021 14:00,11.86,43804,2269,119,312,5940,32,8672,289.25
25/04/2021 15:00,17.63,44151,2311,120,305,5743,32,8511,289.25
25/04/2021 16:00,23.96,45036,2218,118,295,5404,32,8067,289.25
25/04/2021 17:00,39.3,45627,1947,116,269,4800,30,7162,289.25
25/04/2021 18:00,45.32,45738,1816,112,233,4166,28,6355,289.25
25/04/2021 19:00,46.67,45637,1522,107,211,3927,28,5795,289.25
25/04/2021 20:00,46.94,45749,1254,101,204,4014,31,5604,289.25
25/04/2021 21:00,46.73,44722,1096,94,208,4181,26,5605,289.25
25/04/2021 22:00,46.13,43139,980,87,213,4325,29,5634,289.25
25/04/2021 23:00,43.29,42184,698,19,165,4153,21,5056,289.25
26/04/2021 00:00,41.54,41513,592,18,165,4209,21,5005,2.723.154.762
26/04/2021 01:00,41.85,41288,484,17,158,4223,20,4902,2.723.154.762
26/04/2021 02:00,41.98,41393,422,17,152,4203,19,4813,2.723.154.762
26/04/2021 03:00,43.66,41858,382,17,148,4145,15,4707,2.723.154.762
26/04/2021 04:00,46.75,43427,318,19,142,3900,15,4394,2.723.154.762
26/04/2021 05:00,53.31,46423,260,24,133,3438,16,3871,2.723.154.762
26/04/2021 06:00,80.13,49436,217,28,134,2927,17,3323,2.723.154.762
26/04/2021 07:00,82.44,50370,208,28,149,2628,20,3033,2.723.154.762
26/04/2021 08:00,72.67,50116,205,27,157,2593,19,3001,2.723.154.762
26/04/2021 09:00,52.5,49871,226,33,171,2559,18,3007,2.723.154.762
26/04/2021 10:00,50.75,49434,291,48,190,2397,17,2943,2.723.154.762
26/04/2021 11:00,49.82,48898,298,68,213,2178,15,2772,2.723.154.762
26/04/2021 12:00,47.96,48491,308,91,237,1996,14,2646,2.723.154.762
26/04/2021 13:00,47.23,47990,318,113,259,1865,14,2569,2.723.154.762
26/04/2021 14:00,47.98,47537,317,127,270,1758,13,2485,2.723.154.762
26/04/2021 15:00,49.48,47314,307,138,271,1637,13,2366,2.723.154.762
26/04/2021 16:00,52.76,47489,317,136,255,1511,11,2230,2.723.154.762
26/04/2021 17:00,65.02,47550,286,119,230,1364,10,2009,2.723.154.762
26/04/2021 18:00,74.99,47553,275,93,197,1282,10,1857,2.723.154.762
26/04/2021 19:00,80.95,47341,254,73,176,1319,11,1833,2.723.154.762
26/04/2021 20:00,74.97,47219,247,62,166,1424,10,1909,2.723.154.762
26/04/2021 21:00,65.22,45752,245,58,162,1522,10,1997,2.723.154.762
26/04/2021 22:00,51.97,43774,241,65,162,1553,10,2031,2.723.154.762
26/04/2021 23:00,50.93,41921,181,73,113,1462,11,1840,2.723.154.762
27/04/2021 00:00,48.34,41109,197,69,114,1492,10,1882,2.723.154.762
27/04/2021 01:00,48.15,40840,250,62,121,1570,10,2013,2.723.154.762
27/04/2021 02:00,47.82,40985,291,53,127,1686,10,2167,2.723.154.762
27/04/2021 03:00,48.92,41510,306,45,132,1761,10,2254,2.723.154.762
27/04/2021 04:00,51.63,43166,325,38,134,1768,10,2275,2.723.154.762
27/04/2021 05:00,60.12,46108,326,34,133,1631,9,2133,2.723.154.762
27/04/2021 06:00,85.56,48897,313,31,139,1359,10,1852,2.723.154.762
27/04/2021 07:00,86.71,49719,285,28,139,1200,9,1661,2.723.154.762
27/04/2021 08:00,60.53,49237,260,30,132,1259,9,1690,2.723.154.762
27/04/2021 09:00,51.85,48686,243,37,124,1353,9,1766,2.723.154.762
27/04/2021 10:00,50.67,48054,254,44,117,1354,8,1777,2.723.154.762
27/04/2021 11:00,48.53,47427,250,47,114,1310,9,1730,2.723.154.762
27/04/2021 12:00,46.68,47065,225,46,116,1274,10,1671,2.723.154.762
27/04/2021 13:00,45.92,46668,206,44,120,1240,11,1621,2.723.154.762
27/04/2021 14:00,46.74,46398,233,40,129,1231,11,1644,2.723.154.762
27/04/2021 15:00,49.57,46268,285,35,134,1198,12,1664,2.723.154.762
27/04/2021 16:00,53.27,46558,316,32,129,1122,12,1611,2.723.154.762
27/04/2021 17:00,60.84,46396,396,31,113,1000,11,1551,2.723.154.762
27/04/2021 18:00,60.46,46262,542,33,96,918,10,1599,2.723.154.762
27/04/2021 19:00,58.09,46164,616,40,86,976,8,1726,2.723.154.762
27/04/2021 20:00,58.62,46001,648,48,80,1143,8,1927,2.723.154.762
27/04/2021 21:00,53.01,44587,644,55,73,1297,8,2077,2.723.154.762
27/04/2021 22:00,48.66,42557,620,58,64,1331,7,2080,2.723.154.762
27/04/2021 23:00,47.1,41106,549,49,43,1346,7,1994,2.723.154.762
28/04/2021 00:00,46.64,40302,502,46,34,1376,7,1965,2.723.154.762
28/04/2021 01:00,46.99,40151,507,43,27,1396,7,1980,2.723.154.762
28/04/2021 02:00,47.9,40350,467,39,20,1381,7,1914,2.723.154.762
28/04/2021 03:00,48.92,40917,452,35,15,1347,7,1856,2.723.154.762
28/04/2021 04:00,52.38,42439,460,32,11,1225,7,1735,2.723.154.762
28/04/2021 05:00,69.8,45360,455,28,8,1000,6,1497,2.723.154.762
28/04/2021 06:00,80.06,48295,435,25,5,745,6,1216,2.723.154.762
28/04/2021 07:00,84.96,49006,402,24,5,610,7,1048,2.723.154.762
28/04/2021 08:00,69.6,48551,353,25,7,612,7,1004,2.723.154.762
28/04/2021 09:00,55.83,48176,349,25,10,647,7,1038,2.723.154.762
28/04/2021 10:00,51.6,47882,408,25,14,667,7,1121,2.723.154.762
28/04/2021 11:00,49.41,47275,455,28,16,665,8,1172,2.723.154.762
28/04/2021 12:00,49.33,46842,516,32,17,672,8,1245,2.723.154.762
28/04/2021 13:00,50.08,46482,589,36,17,663,8,1313,2.723.154.762
28/04/2021 14:00,53.66,46257,665,40,24,631,7,1367,2.723.154.762
28/04/2021 15:00,56.02,46262,768,42,29,592,7,1438,2.723.154.762
28/04/2021 16:00,62.5,46647,853,43,24,521,7,1448,2.723.154.762
28/04/2021 17:00,67.18,46577,898,42,24,467,7,1438,2.723.154.762
28/04/2021 18:00,74.92,46415,1004,38,27,481,6,1556,2.723.154.762
28/04/2021 19:00,64.35,46192,1084,33,44,565,6,1732,2.723.154.762
28/04/2021 20:00,61.69,46072,1123,30,68,665,7,1893,2.723.154.762
28/04/2021 21:00,55.01,44682,1205,28,95,769,7,2104,2.723.154.762
28/04/2021 22:00,49.08,42674,1187,28,122,845,8,2190,2.723.154.762
28/04/2021 23:00,48.27,41226,1600,45,99,1109,6,2859,2.723.154.762
29/04/2021 00:00,47.62,40470,1600,44,93,1213,7,2957,2.723.154.762
29/04/2021 01:00,47.19,40302,1669,42,87,1319,8,3125,2.723.154.762
29/04/2021 02:00,47.6,40413,1724,38,76,1406,8,3252,2.723.154.762
29/04/2021 03:00,48.39,40828,1825,33,65,1517,8,3448,2.723.154.762
29/04/2021 04:00,49.13,42255,1965,27,61,1501,7,3561,2.723.154.762
29/04/2021 05:00,57.66,45143,2071,23,53,1362,10,3519,2.723.154.762
29/04/2021 06:00,77.42,47880,2140,20,41,1180,7,3388,2.723.154.762
29/04/2021 07:00,81.17,48619,2240,18,35,1160,7,3460,2.723.154.762
29/04/2021 08:00,68.72,48131,2363,17,34,1346,7,3767,2.723.154.762
29/04/2021 09:00,64.18,47805,2600,17,38,1572,7,4234,2.723.154.762
29/04/2021 10:00,58.37,47383,2931,19,43,1774,8,4775,2.723.154.762
29/04/2021 11:00,55.52,46788,3082,22,48,1939,7,5098,2.723.154.762
29/04/2021 12:00,48.85,46166,3142,26,48,2110,8,5334,2.723.154.762
29/04/2021 13:00,46.7,45847,3339,28,45,2280,10,5702,2.723.154.762
29/04/2021 14:00,45.42,45507,3427,27,45,2455,10,5964,2.723.154.762
29/04/2021 15:00,46.87,45576,3534,22,46,2634,9,6245,2.723.154.762
29/04/2021 16:00,48.45,46096,3519,17,52,2737,10,6335,2.723.154.762
29/04/2021 17:00,50.68,45892,3316,13,65,2767,10,6171,2.723.154.762
29/04/2021 18:00,50.78,45833,3223,11,82,2795,10,6121,2.723.154.762
29/04/2021 19:00,49.41,45687,3197,11,109,3027,12,6356,2.723.154.762
29/04/2021 20:00,49.52,45501,3019,13,129,3406,14,6581,2.723.154.762
29/04/2021 21:00,47.64,44237,2810,15,131,3745,14,6715,2.723.154.762
29/04/2021 22:00,46.03,42289,2742,15,118,3916,14,6805,2.723.154.762
29/04/2021 23:00,44.94,41328,2121,8,178,3975,15,6297,2.723.154.762
30/04/2021 00:00,44.77,40565,1917,8,154,4004,12,6095,2.723.154.762
30/04/2021 01:00,44.9,40304,1675,8,135,4053,12,5883,2.723.154.762
30/04/2021 02:00,45.44,40370,1417,8,120,4097,11,5653,2.723.154.762
30/04/2021 03:00,45.68,40718,1280,7,119,4114,10,5530,2.723.154.762
30/04/2021 04:00,46.99,41947,1252,5,127,3886,9,5279,2.723.154.762
30/04/2021 05:00,52.48,44306,1164,4,128,3416,9,4721,2.723.154.762
30/04/2021 06:00,59.09,46635,989,2,136,2985,9,4121,2.723.154.762
30/04/2021 07:00,59.27,47033,889,2,165,2811,9,3876,2.723.154.762
30/04/2021 08:00,59.17,46725,700,2,198,2758,10,3668,2.723.154.762
30/04/2021 09:00,58.55,46326,508,2,234,2669,9,3422,2.723.154.762
30/04/2021 10:00,55.85,45853,427,3,252,2630,9,3321,2.723.154.762
30/04/2021 11:00,48.99,45446,337,4,240,2674,9,3264,2.723.154.762
30/04/2021 12:00,48.26,44792,236,6,230,2724,9,3205,2.723.154.762
30/04/2021 13:00,48.55,44385,202,8,199,2751,9,3169,2.723.154.762
30/04/2021 14:00,47.94,44238,215,12,160,2829,12,3228,2.723.154.762
30/04/2021 15:00,48.67,44276,244,14,142,2935,15,3350,2.723.154.762
30/04/2021 16:00,49.04,44664,242,15,128,2864,16,3265,2.723.154.762
30/04/2021 17:00,49.84,44709,223,16,101,2616,16,2972,2.723.154.762
30/04/2021 18:00,50.15,44433,260,18,86,2375,13,2752,2.723.154.762
30/04/2021 19:00,49.38,43982,283,23,88,2314,9,2717,2.723.154.762
30/04/2021 20:00,48.15,44215,315,27,89,2434,8,2873,2.723.154.762
30/04/2021 21:00,48.26,43228,375,28,90,2678,8,3179,2.723.154.762
30/04/2021 22:00,46.78,41977,408,28,88,2812,7,3343,2.723.154.762
30/04/2021 23:00,48.95,40477,261,146,67,2797,8,3279,2.723.154.762
01/05/2021 00:00,48.28,39851,284,145,65,2823,7,3324,2.723.154.762
01/05/2021 01:00,48,39723,302,139,61,2737,7,3246,2.723.154.762
01/05/2021 02:00,48,39835,309,127,55,2600,7,3098,2.723.154.762
01/05/2021 03:00,48.15,39802,372,118,48,2443,9,2990,2.723.154.762
01/05/2021 04:00,48.38,39930,450,116,45,2173,10,2794,2.723.154.762
01/05/2021 05:00,48.84,40442,471,118,39,1713,5,2346,2.723.154.762
01/05/2021 06:00,49.99,41406,487,127,21,1309,5,1949,2.723.154.762
01/05/2021 07:00,51.45,42319,560,132,10,1151,5,1858,2.723.154.762
01/05/2021 08:00,52.99,43188,619,136,10,1162,5,1932,2.723.154.762
01/05/2021 09:00,51.49,43717,698,137,12,1246,5,2098,2.723.154.762
01/05/2021 10:00,50.69,43693,838,136,12,1326,6,2318,2.723.154.762
01/05/2021 11:00,49.97,43381,918,140,12,1399,6,2475,2.723.154.762
01/05/2021 12:00,48.66,43131,1000,146,12,1469,8,2635,2.723.154.762
01/05/2021 13:00,46.57,42914,1040,150,12,1511,9,2722,2.723.154.762
01/05/2021 14:00,45.44,42872,1160,151,14,1517,9,2851,2.723.154.762
01/05/2021 15:00,47.3,43132,1185,148,15,1503,7,2858,2.723.154.762
01/05/2021 16:00,48.95,43798,1148,138,16,1436,6,2744,2.723.154.762
01/05/2021 17:00,51.93,44090,984,133,21,1299,5,2442,2.723.154.762
01/05/2021 18:00,52.79,44028,896,124,32,1175,5,2232,2.723.154.762
01/05/2021 19:00,53.43,43747,869,117,46,1237,5,2274,2.723.154.762
01/05/2021 20:00,54.64,44055,900,109,60,1497,5,2571,2.723.154.762
01/05/2021 21:00,53.06,43590,965,102,73,1746,5,2891,2.723.154.762
01/05/2021 22:00,49.93,42252,918,99,91,1838,5,2951,2.723.154.762
01/05/2021 23:00,50.99,40819,796,111,98,1372,4,2381,2.723.154.762
02/05/2021 00:00,48.66,39982,795,101,114,1296,4,2310,2.723.154.762
02/05/2021 01:00,47.66,39609,811,95,131,1226,4,2267,2.723.154.762
02/05/2021 02:00,47.33,39561,813,92,142,1153,4,2204,2.723.154.762
02/05/2021 03:00,47.8,39537,844,87,152,1084,4,2171,2.723.154.762
02/05/2021 04:00,47.89,39416,861,78,164,974,6,2083,2.723.154.762
02/05/2021 05:00,47.18,39619,782,70,165,800,8,1825,2.723.154.762
02/05/2021 06:00,48.06,40314,742,66,132,629,7,1576,2.723.154.762
02/05/2021 07:00,49.58,41237,710,65,114,607,5,1501,2.723.154.762
02/05/2021 08:00,48.05,41914,686,68,145,714,5,1618,2.723.154.762
02/05/2021 09:00,46.6,42201,681,73,196,840,6,1796,2.723.154.762
02/05/2021 10:00,46.33,42053,748,77,237,922,6,1990,2.723.154.762
02/05/2021 11:00,44.22,41748,668,88,265,964,7,1992,2.723.154.762
02/05/2021 12:00,35.45,41591,600,101,289,984,10,1984,2.723.154.762
02/05/2021 13:00,33.58,41542,615,112,305,956,13,2001,2.723.154.762
02/05/2021 14:00,33.33,41547,683,123,318,881,14,2019,2.723.154.762
02/05/2021 15:00,35.52,42027,810,128,329,782,14,2063,2.723.154.762
02/05/2021 16:00,41.97,42853,1037,125,339,684,12,2197,2.723.154.762
02/05/2021 17:00,46.53,43478,1145,119,348,595,10,2217,2.723.154.762
02/05/2021 18:00,50.89,43658,1092,111,351,558,10,2122,2.723.154.762
02/05/2021 19:00,52.43,43603,1153,105,354,600,10,2222,2.723.154.762
02/05/2021 20:00,54.06,43853,1151,100,344,691,10,2296,2.723.154.762
02/05/2021 21:00,55.68,43328,1163,94,322,757,12,2348,2.723.154.762
02/05/2021 22:00,51.75,41992,1371,89,308,717,15,2500,2.723.154.762
02/05/2021 23:00,52.43,39842,958,47,369,661,17,2052,2.723.154.762
03/05/2021 00:00,50.98,39202,988,51,376,644,16,2075,2.608.988.095
03/05/2021 01:00,49.93,39052,1063,54,384,630,17,2148,2.608.988.095
03/05/2021 02:00,50.11,39277,1163,56,392,638,15,2264,2.608.988.095
03/05/2021 03:00,50.08,39715,1306,59,408,665,14,2452,2.608.988.095
03/05/2021 04:00,54.82,41098,1379,59,428,610,16,2492,2.608.988.095
03/05/2021 05:00,66.94,43967,1421,52,431,490,18,2412,2.608.988.095
03/05/2021 06:00,80.73,46794,1392,43,432,381,16,2264,2.608.988.095
03/05/2021 07:00,85.66,47674,1562,43,428,356,16,2405,2.608.988.095
03/05/2021 08:00,66.91,47461,1660,49,424,417,21,2571,2.608.988.095
03/05/2021 09:00,59.18,47343,1772,52,422,504,25,2775,2.608.988.095
03/05/2021 10:00,55.56,46948,1932,55,424,622,26,3059,2.608.988.095
03/05/2021 11:00,51.93,46623,1871,62,428,766,26,3153,2.608.988.095
03/05/2021 12:00,49.85,46262,1725,72,432,925,25,3179,2.608.988.095
03/05/2021 13:00,50.71,46036,1632,85,436,1056,23,3232,2.608.988.095
03/05/2021 14:00,49.98,45740,1532,100,434,1157,24,3247,2.608.988.095
03/05/2021 15:00,49.87,45572,1397,111,424,1288,24,3244,2.608.988.095
03/05/2021 16:00,54.85,45604,1239,115,408,1329,21,3112,2.608.988.095
03/05/2021 17:00,62.21,45529,933,112,380,1294,17,2736,2.608.988.095
03/05/2021 18:00,78.94,45465,732,106,340,1312,15,2505,2.608.988.095
03/05/2021 19:00,79.97,45139,676,101,306,1418,11,2512,2.608.988.095
03/05/2021 20:00,69.92,45142,725,97,274,1609,9,2714,2.608.988.095
03/05/2021 21:00,64.79,43853,930,94,246,1826,9,3105,2.608.988.095
03/05/2021 22:00,51.32,41950,1138,86,218,1950,10,3402,2.608.988.095
03/05/2021 23:00,48.89,40756,1642,99,163,1661,6,3571,2.608.988.095
04/05/2021 00:00,45.78,40085,1924,123,152,1685,6,3890,2.608.988.095
04/05/2021 01:00,43.96,39860,2451,148,136,1726,7,4468,2.608.988.095
04/05/2021 02:00,40.41,40016,3144,166,115,1777,5,5207,2.608.988.095
04/05/2021 03:00,36.01,40494,3831,181,105,1826,6,5949,2.608.988.095
04/05/2021 04:00,38.91,41997,4475,191,96,1852,5,6619,2.608.988.095
04/05/2021 05:00,45.52,45012,4958,197,86,1833,5,7079,2.608.988.095
04/05/2021 06:00,51.95,47969,4962,202,86,1821,4,7075,2.608.988.095
04/05/2021 07:00,52.04,49049,5007,207,100,2021,4,7339,2.608.988.095
04/05/2021 08:00,47.99,48823,4882,212,102,2551,4,7751,2.608.988.095
04/05/2021 09:00,45.97,48449,4717,214,96,3185,4,8216,2.608.988.095
04/05/2021 10:00,45.5,48122,4519,217,101,3728,5,8570,2.608.988.095
04/05/2021 11:00,45.04,47726,4176,215,105,4170,6,8672,2.608.988.095
04/05/2021 12:00,43.49,47554,3821,206,98,4526,5,8656,2.608.988.095
04/05/2021 13:00,38.32,47369,3610,193,88,4763,6,8660,2.608.988.095
04/05/2021 14:00,33.54,47183,3596,180,97,4929,5,8807,2.608.988.095
04/05/2021 15:00,33.59,47062,3547,169,125,5049,5,8895,2.608.988.095
04/05/2021 16:00,41.09,47385,3420,150,158,5010,5,8743,2.608.988.095
04/05/2021 17:00,45.94,47211,2985,129,190,4886,6,8196,2.608.988.095
04/05/2021 18:00,48.71,47117,2571,115,261,4743,8,7698,2.608.988.095
04/05/2021 19:00,49.53,46878,2433,116,318,4713,11,7591,2.608.988.095
04/05/2021 20:00,47.62,46782,2349,124,335,4753,15,7576,2.608.988.095
04/05/2021 21:00,45.73,45474,2346,128,322,4769,16,7581,2.608.988.095
04/05/2021 22:00,40.57,43335,2496,130,299,4714,18,7657,2.608.988.095
04/05/2021 23:00,30.41,40968,2047,132,294,4869,19,7361,2.608.988.095
05/05/2021 00:00,25.95,40268,1888,143,281,4804,17,7133,2.608.988.095
05/05/2021 01:00,25.85,40122,1836,143,276,4742,13,7010,2.608.988.095
05/05/2021 02:00,30.19,40308,1776,137,275,4682,12,6882,2.608.988.095
05/05/2021 03:00,34.83,40756,1786,131,275,4649,12,6853,2.608.988.095
05/05/2021 04:00,41.9,42127,1813,121,270,4569,12,6785,2.608.988.095
05/05/2021 05:00,51.98,45034,1796,108,258,4417,11,6590,2.608.988.095
05/05/2021 06:00,63.45,47858,1819,98,249,4317,14,6497,2.608.988.095
05/05/2021 07:00,64.64,48741,2092,89,261,4407,16,6865,2.608.988.095
05/05/2021 08:00,51.56,48543,2399,80,284,4839,20,7622,2.608.988.095
05/05/2021 09:00,47.63,48454,2639,73,308,5303,20,8343,2.608.988.095
05/05/2021 10:00,43.22,48273,2894,65,318,5502,23,8802,2.608.988.095
05/05/2021 11:00,41.72,47930,3145,58,306,5501,24,9034,2.608.988.095
05/05/2021 12:00,41.42,47823,3376,50,297,5485,26,9234,2.608.988.095
05/05/2021 13:00,37.56,47748,3481,42,298,5413,22,9256,2.608.988.095
05/05/2021 14:00,36.14,47700,3781,32,276,5322,27,9438,2.608.988.095
05/05/2021 15:00,37.56,47689,4330,26,211,5234,20,9821,2.608.988.095
05/05/2021 16:00,46.07,48104,4494,19,161,5044,21,9739,2.608.988.095
05/05/2021 17:00,49.98,47885,4402,15,126,4820,21,9384,2.608.988.095
05/05/2021 18:00,57.66,47543,3989,15,103,4614,15,8736,2.608.988.095
05/05/2021 19:00,58.35,47115,3774,25,116,4482,12,8409,2.608.988.095
05/05/2021 20:00,57.38,46954,3506,50,131,4435,11,8133,2.608.988.095
05/05/2021 21:00,51.84,45516,3341,66,142,4434,9,7992,2.608.988.095
05/05/2021 22:00,48.01,43512,3399,74,150,4444,9,8076,2.608.988.095
05/05/2021 23:00,48.27,41583,3488,84,157,4334,9,8072,2.608.988.095
06/05/2021 00:00,47.4,40823,3369,96,172,4303,8,7948,2.608.988.095
06/05/2021 01:00,46.28,40568,3414,109,200,4273,6,8002,2.608.988.095
06/05/2021 02:00,48.1,40662,3242,119,240,4250,7,7858,2.608.988.095
06/05/2021 03:00,48.59,40889,3096,128,271,4204,8,7707,2.608.988.095
06/05/2021 04:00,51.83,42142,3036,135,294,4084,9,7558,2.608.988.095
06/05/2021 05:00,59.99,45108,2957,139,324,3905,8,7333,2.608.988.095
06/05/2021 06:00,70.59,47922,2711,142,376,3815,7,7051,2.608.988.095
06/05/2021 07:00,67.41,48862,2710,144,422,3917,10,7203,2.608.988.095
06/05/2021 08:00,54.56,48740,2586,135,451,4020,8,7200,2.608.988.095
06/05/2021 09:00,55.64,48650,2447,118,471,3990,10,7036,2.608.988.095
06/05/2021 10:00,56.07,48386,2542,102,482,3887,14,7027,2.608.988.095
06/05/2021 11:00,60.04,47959,2573,88,489,3755,17,6922,2.608.988.095
06/05/2021 12:00,59.24,47514,2457,75,493,3605,22,6652,2.608.988.095
06/05/2021 13:00,58.22,47264,2463,68,491,3397,21,6440,2.608.988.095
06/05/2021 14:00,60.72,47062,2423,55,491,3173,22,6164,2.608.988.095
06/05/2021 15:00,62.05,47155,2321,44,488,2906,25,5784,2.608.988.095
06/05/2021 16:00,70.01,47421,2171,35,479,2613,25,5323,2.608.988.095
06/05/2021 17:00,75.79,47106,1798,31,455,2265,24,4573,2.608.988.095
06/05/2021 18:00,83.64,46811,1486,30,422,1936,23,3897,2.608.988.095
06/05/2021 19:00,79.93,46469,1281,35,389,1755,23,3483,2.608.988.095
06/05/2021 20:00,79.92,46298,1076,39,368,1746,25,3254,2.608.988.095
06/05/2021 21:00,78.11,45061,998,43,357,1809,21,3228,2.608.988.095
06/05/2021 22:00,65.16,43194,901,46,338,1870,20,3175,2.608.988.095
06/05/2021 23:00,61.16,41299,769,37,293,1619,17,2735,2.608.988.095
07/05/2021 00:00,57.88,40388,764,32,281,1689,16,2782,2.608.988.095
07/05/2021 01:00,57.11,40096,760,30,252,1759,13,2814,2.608.988.095
07/05/2021 02:00,57.28,40204,718,24,220,1789,11,2762,2.608.988.095
07/05/2021 03:00,57.97,40663,774,21,198,1789,10,2792,2.608.988.095
07/05/2021 04:00,65.9,42051,882,17,169,1679,9,2756,2.608.988.095
07/05/2021 05:00,74.04,45176,946,13,124,1448,8,2539,2.608.988.095
07/05/2021 06:00,87.9,48266,919,9,84,1299,8,2319,2.608.988.095
07/05/2021 07:00,99.9,49067,939,7,69,1365,7,2387,2.608.988.095
07/05/2021 08:00,79.85,48857,863,7,62,1464,6,2402,2.608.988.095
07/05/2021 09:00,76.77,48614,868,9,59,1516,6,2458,2.608.988.095
07/05/2021 10:00,76.15,48176,988,12,62,1519,6,2587,2.608.988.095
07/05/2021 11:00,67.39,47609,1136,16,58,1489,6,2705,2.608.988.095
07/05/2021 12:00,60.61,46791,1323,22,48,1479,6,2878,2.608.988.095
07/05/2021 13:00,53.88,46011,1456,21,40,1455,6,2978,2.608.988.095
07/05/2021 14:00,52.22,45530,1802,20,37,1456,6,3321,2.608.988.095
07/05/2021 15:00,53.06,45368,2033,21,35,1437,6,3532,2.608.988.095
07/05/2021 16:00,55.39,45629,2137,20,38,1383,6,3584,2.608.988.095
07/05/2021 17:00,59.71,45674,2150,18,44,1263,6,3481,2.608.988.095
07/05/2021 18:00,72.33,45266,2030,17,56,1148,6,3257,2.608.988.095
07/05/2021 19:00,59.98,44681,2094,20,65,1169,6,3354,2.608.988.095
07/05/2021 20:00,59.9,44585,2132,24,76,1381,6,3619,2.608.988.095
07/05/2021 21:00,58.59,43589,2161,28,94,1670,6,3959,2.608.988.095
07/05/2021 22:00,53.78,41970,2399,31,112,1892,7,4441,2.608.988.095
07/05/2021 23:00,55.28,39624,1952,67,96,2078,8,4201,2.608.988.095
08/05/2021 00:00,54.9,38808,2002,61,91,2141,9,4304,2.608.988.095
08/05/2021 01:00,55.09,38558,2052,56,82,2164,11,4365,2.608.988.095
08/05/2021 02:00,55.66,38456,2061,51,71,2163,10,4356,2.608.988.095
08/05/2021 03:00,55.52,38385,2059,46,61,2170,10,4346,2.608.988.095
08/05/2021 04:00,55.09,38502,2033,39,57,2003,8,4140,2.608.988.095
08/05/2021 05:00,53.39,39107,2003,28,45,1603,8,3687,2.608.988.095
08/05/2021 06:00,54.3,40206,1780,22,42,1204,8,3056,2.608.988.095
08/05/2021 07:00,55.26,41553,1733,24,63,1116,9,2945,2.608.988.095
08/05/2021 08:00,52.11,42521,1606,32,85,1239,8,2970,2.608.988.095
08/05/2021 09:00,47.24,42964,1523,41,110,1392,7,3073,2.608.988.095
08/05/2021 10:00,42.65,42697,1521,51,131,1553,7,3263,2.608.988.095
08/05/2021 11:00,40.11,42139,1498,59,139,1714,9,3419,2.608.988.095
08/05/2021 12:00,36.32,41560,1436,62,138,1890,11,3537,2.608.988.095
08/05/2021 13:00,32.99,41284,1367,58,135,2021,11,3592,2.608.988.095
08/05/2021 14:00,35.47,41095,1295,53,135,2094,10,3587,2.608.988.095
08/05/2021 15:00,43,41305,1246,49,129,2105,10,3539,2.608.988.095
08/05/2021 16:00,50.21,42237,1222,44,123,1994,10,3393,2.608.988.095
08/05/2021 17:00,53.6,42694,1219,41,102,1744,8,3114,2.608.988.095
08/05/2021 18:00,59.26,42444,1345,39,78,1507,7,2976,2.608.988.095
08/05/2021 19:00,62.31,42044,1610,36,69,1515,6,3236,2.608.988.095
08/05/2021 20:00,58.85,42335,2036,37,74,1722,7,3876,2.608.988.095
08/05/2021 21:00,53.59,41756,2770,39,86,1931,9,4835,2.608.988.095
08/05/2021 22:00,49.25,40503,3580,39,87,1996,9,5711,2.608.988.095
08/05/2021 23:00,38.79,39563,4192,40,47,2209,9,6497,2.608.988.095
09/05/2021 00:00,24.96,38631,4415,37,42,2235,10,6739,2.608.988.095
09/05/2021 01:00,21.63,38365,4605,32,39,2237,8,6921,2.608.988.095
09/05/2021 02:00,21.43,38366,4542,28,38,2288,7,6903,2.608.988.095
09/05/2021 03:00,20.87,38229,4272,25,39,2394,7,6737,2.608.988.095
09/05/2021 04:00,21.08,38109,4006,20,39,2439,8,6512,2.608.988.095
09/05/2021 05:00,20.94,38477,3777,13,39,2355,8,6192,2.608.988.095
09/05/2021 06:00,21.1,39342,3412,8,41,2241,9,5711,2.608.988.095
09/05/2021 07:00,21.97,40550,3209,7,60,2294,10,5580,2.608.988.095
09/05/2021 08:00,21.76,41460,3097,6,87,2515,12,5717,2.608.988.095
09/05/2021 09:00,21.79,42118,3083,6,113,2835,17,6054,2.608.988.095
09/05/2021 10:00,21.56,42171,3077,6,135,3117,19,6354,2.608.988.095
09/05/2021 11:00,21.67,42004,2962,9,161,3242,21,6395,2.608.988.095
09/05/2021 12:00,21.38,41869,2754,11,178,3307,18,6268,2.608.988.095
09/05/2021 13:00,21.06,41695,2530,15,185,3305,22,6057,2.608.988.095
09/05/2021 14:00,21.21,41585,2665,19,206,3227,21,6138,2.608.988.095
09/05/2021 15:00,21.74,41822,2900,21,230,3086,19,6256,2.608.988.095
09/05/2021 16:00,26.3,42459,2777,22,249,2908,23,5979,2.608.988.095
09/05/2021 17:00,42.98,43010,2357,29,264,2723,25,5398,2.608.988.095
09/05/2021 18:00,51.25,42942,2022,40,271,2652,27,5012,2.608.988.095
09/05/2021 19:00,51.95,42818,1947,51,283,2714,24,5019,2.608.988.095
09/05/2021 20:00,51.99,42893,1950,61,288,2855,24,5178,2.608.988.095
09/05/2021 21:00,51.93,41989,2050,70,289,3033,25,5467,2.608.988.095
09/05/2021 22:00,44.33,40247,2003,76,288,3116,24,5507,2.608.988.095
09/05/2021 23:00,32.04,38731,1986,28,313,2973,21,5321,2.608.988.095
10/05/2021 00:00,31.28,37994,1851,27,313,2841,21,5053,2.879.702.381
10/05/2021 01:00,30.12,37775,1803,25,310,2718,21,4877,2.879.702.381
10/05/2021 02:00,30.05,37861,1882,24,306,2601,21,4834,2.879.702.381
10/05/2021 03:00,30.24,38241,1940,25,302,2471,19,4757,2.879.702.381
10/05/2021 04:00,42.03,39690,1968,23,296,2343,19,4649,2.879.702.381
10/05/2021 05:00,51.49,42784,2238,20,270,2167,16,4711,2.879.702.381
10/05/2021 06:00,55.4,46231,2379,18,235,1965,19,4616,2.879.702.381
10/05/2021 07:00,57.07,47585,2403,17,220,1831,13,4484,2.879.702.381
10/05/2021 08:00,54.38,47409,2416,19,228,1766,13,4442,2.879.702.381
10/05/2021 09:00,51.94,47118,2494,21,258,1747,15,4535,2.879.702.381
10/05/2021 10:00,51.28,46773,2672,25,297,1747,23,4764,2.879.702.381
10/05/2021 11:00,50.09,46370,3250,32,332,1782,29,5425,2.879.702.381
10/05/2021 12:00,47.32,45989,3776,40,353,1828,34,6031,2.879.702.381
10/05/2021 13:00,48.53,45543,4027,45,366,1862,29,6329,2.879.702.381
10/05/2021 14:00,51.56,45193,4020,46,374,1892,27,6359,2.879.702.381
10/05/2021 15:00,51.85,44799,3707,42,376,1933,23,6081,2.879.702.381
10/05/2021 16:00,52.73,44917,3369,40,368,1973,21,5771,2.879.702.381
10/05/2021 17:00,53.42,44661,2609,36,363,2018,23,5049,2.879.702.381
10/05/2021 18:00,54.19,44088,2050,31,362,2145,27,4615,2.879.702.381
10/05/2021 19:00,53.64,43547,1749,26,364,2386,25,4550,2.879.702.381
10/05/2021 20:00,52.57,43383,1614,24,362,2636,23,4659,2.879.702.381
10/05/2021 21:00,51.5,42058,1519,26,367,2837,25,4774,2.879.702.381
10/05/2021 22:00,49.06,39979,1453,27,376,2940,27,4823,2.879.702.381
10/05/2021 23:00,42.99,37038,1079,204,367,2730,25,4405,2.879.702.381
11/05/2021 00:00,39.48,36282,939,203,366,2845,23,4376,2.879.702.381
11/05/2021 01:00,37.24,36210,856,198,362,2900,20,4336,2.879.702.381
11/05/2021 02:00,36.58,36296,872,196,354,2940,20,4382,2.879.702.381
11/05/2021 03:00,37.94,36687,898,191,350,2965,21,4425,2.879.702.381
11/05/2021 04:00,45.72,38251,887,179,348,2842,21,4277,2.879.702.381
11/05/2021 05:00,52.58,41479,974,166,330,2523,17,4010,2.879.702.381
11/05/2021 06:00,55.53,44833,1064,157,305,2125,13,3664,2.879.702.381
11/05/2021 07:00,57.43,46051,1200,151,301,1799,12,3463,2.879.702.381
11/05/2021 08:00,56.39,45819,1364,151,313,1659,13,3500,2.879.702.381
11/05/2021 09:00,55.7,45487,1444,151,333,1643,15,3586,2.879.702.381
11/05/2021 10:00,55.53,45039,1473,158,366,1659,21,3677,2.879.702.381
11/05/2021 11:00,56.28,44500,1481,171,386,1711,24,3773,2.879.702.381
11/05/2021 12:00,55.51,44262,1505,177,394,1763,25,3864,2.879.702.381
11/05/2021 13:00,54.49,43910,1530,179,396,1771,25,3901,2.879.702.381
11/05/2021 14:00,53.83,43749,1470,183,397,1779,24,3853,2.879.702.381
11/05/2021 15:00,53.68,43699,1508,182,395,1815,24,3924,2.879.702.381
11/05/2021 16:00,53.84,43913,1708,178,388,1849,23,4146,2.879.702.381
11/05/2021 17:00,55.56,43757,1547,176,382,1924,23,4052,2.879.702.381
11/05/2021 18:00,55.56,43415,1557,180,377,2060,27,4201,2.879.702.381
11/05/2021 19:00,53.86,42970,1620,189,379,2152,26,4366,2.879.702.381
11/05/2021 20:00,53.24,42770,1765,198,380,2193,24,4560,2.879.702.381
11/05/2021 21:00,51.89,41411,1925,203,373,2186,25,4712,2.879.702.381
11/05/2021 22:00,49.22,39260,2040,199,365,2106,23,4733,2.879.702.381
11/05/2021 23:00,41.85,36554,1692,203,335,2051,23,4304,2.879.702.381
12/05/2021 00:00,40.35,35849,1500,196,322,2017,23,4058,2.879.702.381
12/05/2021 01:00,39.92,35768,1378,188,318,1972,21,3877,2.879.702.381
12/05/2021 02:00,39.34,35926,1342,180,320,1920,20,3782,2.879.702.381
12/05/2021 03:00,40.14,36293,1389,173,317,1870,21,3770,2.879.702.381
12/05/2021 04:00,45.45,37826,1341,165,309,1758,21,3594,2.879.702.381
12/05/2021 05:00,52.75,41212,1263,154,286,1592,17,3312,2.879.702.381
12/05/2021 06:00,56.23,44427,1144,145,246,1430,15,2980,2.879.702.381
12/05/2021 07:00,57.89,45179,1039,141,224,1381,13,2798,2.879.702.381
12/05/2021 08:00,57.32,44904,972,141,232,1448,17,2810,2.879.702.381
12/05/2021 09:00,56.39,44767,1036,140,260,1545,18,2999,2.879.702.381
12/05/2021 10:00,56.14,44356,1152,142,299,1635,24,3252,2.879.702.381
12/05/2021 11:00,55.24,43777,1148,147,326,1751,25,3397,2.879.702.381
12/05/2021 12:00,54.75,43353,1162,150,338,1859,26,3535,2.879.702.381
12/05/2021 13:00,52.66,42979,1239,148,345,1911,26,3669,2.879.702.381
12/05/2021 14:00,50.84,42832,1174,142,344,1929,25,3614,2.879.702.381
12/05/2021 15:00,49.91,42793,1152,130,328,1952,25,3587,2.879.702.381
12/05/2021 16:00,51.92,42948,1141,116,291,1989,23,3560,2.879.702.381
12/05/2021 17:00,53.44,42825,1043,110,257,2029,19,3458,2.879.702.381
12/05/2021 18:00,54.03,42628,986,112,253,2098,15,3464,2.879.702.381
12/05/2021 19:00,52.8,42206,964,120,265,2189,12,3550,2.879.702.381
12/05/2021 20:00,52.45,42105,919,129,267,2294,12,3621,2.879.702.381
12/05/2021 21:00,49.4,40875,882,136,250,2367,16,3651,2.879.702.381
12/05/2021 22:00,44.84,38910,864,133,221,2345,12,3575,2.879.702.381
12/05/2021 23:00,42.63,35708,639,135,332,1696,11,2813,2.879.702.381
13/05/2021 00:00,38.58,34795,615,131,328,1564,10,2648,2.879.702.381
13/05/2021 01:00,36.38,34459,628,128,324,1440,11,2531,2.879.702.381
13/05/2021 02:00,36.48,34279,679,126,326,1369,12,2512,2.879.702.381
13/05/2021 03:00,35.71,34180,720,124,323,1301,11,2479,2.879.702.381
13/05/2021 04:00,40.2,34577,747,115,309,1122,10,2303,2.879.702.381
13/05/2021 05:00,46.54,35407,799,98,289,849,8,2043,2.879.702.381
13/05/2021 06:00,49.75,36667,767,83,260,614,6,1730,2.879.702.381
13/05/2021 07:00,50.73,37997,767,75,244,566,6,1658,2.879.702.381
13/05/2021 08:00,51.57,38967,776,72,254,665,6,1773,2.879.702.381
13/05/2021 09:00,51.05,39477,851,72,273,824,9,2029,2.879.702.381
13/05/2021 10:00,50.76,39537,979,78,301,1008,10,2376,2.879.702.381
13/05/2021 11:00,50.45,39278,1061,81,325,1204,9,2680,2.879.702.381
13/05/2021 12:00,47.02,38911,1076,80,337,1354,12,2859,2.879.702.381
13/05/2021 13:00,42.85,38232,1108,76,341,1430,12,2967,2.879.702.381
13/05/2021 14:00,41.07,38078,1109,70,340,1451,10,2980,2.879.702.381
13/05/2021 15:00,43.26,38267,1099,64,328,1486,19,2996,2.879.702.381
13/05/2021 16:00,47.82,38736,1096,58,304,1539,9,3006,2.879.702.381
13/05/2021 17:00,49.41,39119,1016,54,275,1603,7,2955,2.879.702.381
13/05/2021 18:00,49.43,39043,974,58,264,1733,10,3039,2.879.702.381
13/05/2021 19:00,47.5,38514,927,68,257,1950,11,3213,2.879.702.381
13/05/2021 20:00,46.87,38610,831,78,256,2168,9,3342,2.879.702.381
13/05/2021 21:00,44.63,38098,730,80,243,2284,11,3348,2.879.702.381
13/05/2021 22:00,41.68,36540,684,70,213,2268,8,3243,2.879.702.381
13/05/2021 23:00,37.26,35265,479,75,119,2150,10,2833,2.879.702.381
14/05/2021 00:00,36.99,34387,464,61,105,2101,9,2740,2.879.702.381
14/05/2021 01:00,35.05,34299,414,48,92,2089,10,2653,2.879.702.381
14/05/2021 02:00,35.05,34400,398,39,80,2122,10,2649,2.879.702.381
14/05/2021 03:00,35.08,34605,364,34,71,2201,10,2680,2.879.702.381
14/05/2021 04:00,41.6,35798,336,34,63,2204,10,2647,2.879.702.381
14/05/2021 05:00,47.6,38205,318,36,54,2075,9,2492,2.879.702.381
14/05/2021 06:00,50.18,40845,309,45,47,1858,10,2269,2.879.702.381
14/05/2021 07:00,51.48,42102,325,61,45,1716,10,2157,2.879.702.381
14/05/2021 08:00,51.27,42700,264,68,38,1698,10,2078,2.879.702.381
14/05/2021 09:00,50.52,42734,202,78,30,1711,10,2031,2.879.702.381
14/05/2021 10:00,50.14,42388,238,90,24,1717,10,2079,2.879.702.381
14/05/2021 11:00,49.77,41978,284,92,21,1735,9,2141,2.879.702.381
14/05/2021 12:00,48.98,41561,337,89,18,1768,9,2221,2.879.702.381
14/05/2021 13:00,47.92,41086,391,89,18,1822,9,2329,2.879.702.381
14/05/2021 14:00,46.83,40839,475,88,20,1858,8,2449,2.879.702.381
14/05/2021 15:00,46.74,40748,594,83,21,1881,8,2587,2.879.702.381
14/05/2021 16:00,48.26,40991,643,73,19,1863,8,2606,2.879.702.381
14/05/2021 17:00,48.86,41034,683,60,14,1825,8,2590,2.879.702.381
14/05/2021 18:00,48.8,40875,723,52,16,1797,8,2596,2.879.702.381
14/05/2021 19:00,47.43,40227,753,52,20,1864,8,2697,2.879.702.381
14/05/2021 20:00,45.88,39868,757,58,23,1990,8,2836,2.879.702.381
14/05/2021 21:00,44.2,39205,808,63,24,2103,8,3006,2.879.702.381
14/05/2021 22:00,35.23,38003,938,63,23,2141,8,3173,2.879.702.381
14/05/2021 23:00,34.66,35478,1289,37,22,2143,7,3498,2.879.702.381
15/05/2021 00:00,32.44,34672,1506,47,19,2133,7,3712,2.879.702.381
15/05/2021 01:00,29.92,34382,1559,56,15,2171,7,3808,2.879.702.381
15/05/2021 02:00,28.83,34248,1584,59,10,2251,6,3910,2.879.702.381
15/05/2021 03:00,27.97,34160,1643,62,6,2315,6,4032,2.879.702.381
15/05/2021 04:00,26.65,34388,1721,67,4,2264,6,4062,2.879.702.381
15/05/2021 05:00,27.87,35118,1788,78,3,2123,6,3998,2.879.702.381
15/05/2021 06:00,29.01,36309,1706,80,2,2015,6,3809,2.879.702.381
15/05/2021 07:00,37.06,37971,1698,74,3,1959,6,3740,2.879.702.381
15/05/2021 08:00,41.94,39196,1632,69,3,1979,6,3689,2.879.702.381
15/05/2021 09:00,42.64,39898,1596,68,5,1995,6,3670,2.879.702.381
15/05/2021 10:00,42.48,39915,1604,68,7,1994,6,3679,2.879.702.381
15/05/2021 11:00,40.9,39570,1535,73,11,2007,6,3632,2.879.702.381
15/05/2021 12:00,35.04,39172,1430,90,15,2025,6,3566,2.879.702.381
15/05/2021 13:00,29.55,38927,1308,108,23,2005,7,3451,2.879.702.381
15/05/2021 14:00,33.72,38728,1063,120,38,1955,7,3183,2.879.702.381
15/05/2021 15:00,40.05,38918,835,119,52,1903,7,2916,2.879.702.381
15/05/2021 16:00,45.99,39713,610,109,54,1852,6,2631,2.879.702.381
15/05/2021 17:00,46.66,40163,386,94,46,1794,6,2326,2.879.702.381
15/05/2021 18:00,46.27,39849,310,81,36,1772,6,2205,2.879.702.381
15/05/2021 19:00,45.44,39228,289,76,25,1768,6,2164,2.879.702.381
15/05/2021 20:00,44.07,39266,280,74,19,1785,6,2164,2.879.702.381
15/05/2021 21:00,40.95,38687,288,75,16,1784,6,2169,2.879.702.381
15/05/2021 22:00,33.84,37501,305,76,15,1711,6,2113,2.879.702.381
15/05/2021 23:00,32.1,36254,207,71,11,1600,5,1894,2.879.702.381
16/05/2021 00:00,26.86,35508,186,68,13,1462,5,1734,2.879.702.381
16/05/2021 01:00,24.41,35201,188,66,14,1311,5,1584,2.879.702.381
16/05/2021 02:00,22.92,35137,212,68,18,1172,5,1475,2.879.702.381
16/05/2021 03:00,22.67,34975,291,69,27,1055,4,1446,2.879.702.381
16/05/2021 04:00,22.47,34914,351,63,34,988,4,1440,2.879.702.381
16/05/2021 05:00,21.32,35301,428,52,32,956,4,1472,2.879.702.381
16/05/2021 06:00,22.37,36328,442,48,25,939,4,1458,2.879.702.381
16/05/2021 07:00,24.48,37645,436,49,27,975,4,1491,2.879.702.381
16/05/2021 08:00,27.52,38780,438,55,36,1063,5,1597,2.879.702.381
16/05/2021 09:00,24.34,39512,435,64,49,1164,5,1717,2.879.702.381
16/05/2021 10:00,29.04,39652,430,70,67,1251,5,1823,2.879.702.381
16/05/2021 11:00,23.81,39653,416,73,86,1341,6,1922,2.879.702.381
16/05/2021 12:00,14.48,39472,413,75,103,1418,6,2015,2.879.702.381
16/05/2021 13:00,12.46,39386,409,78,114,1450,7,2058,2.879.702.381
16/05/2021 14:00,20.14,39424,397,79,128,1433,8,2045,2.879.702.381
16/05/2021 15:00,22.86,39845,378,80,136,1409,8,2011,2.879.702.381
16/05/2021 16:00,40.82,40542,362,78,123,1356,11,1930,2.879.702.381
16/05/2021 17:00,49.89,40979,344,78,111,1276,6,1815,2.879.702.381
16/05/2021 18:00,51.93,41004,316,83,105,1224,7,1735,2.879.702.381
16/05/2021 19:00,52.59,40576,307,95,98,1285,9,1794,2.879.702.381
16/05/2021 20:00,52.42,40659,337,117,90,1431,11,1986,2.879.702.381
16/05/2021 21:00,50.62,39844,374,149,86,1527,11,2147,2.879.702.381
16/05/2021 22:00,48.7,38300,362,167,74,1496,10,2109,2.879.702.381
16/05/2021 23:00,42.06,36592,321,39,109,1165,15,1649,2.879.702.381
17/05/2021 00:00,39.46,36056,276,46,98,1040,12,1472,3.405.535.714
17/05/2021 01:00,39.28,36046,216,47,82,916,8,1269,3.405.535.714
17/05/2021 02:00,39.82,36134,192,42,65,817,9,1125,3.405.535.714
17/05/2021 03:00,41.69,36339,154,36,55,782,7,1034,3.405.535.714
17/05/2021 04:00,48.14,37571,135,31,47,837,7,1057,3.405.535.714
17/05/2021 05:00,53.39,40362,125,26,35,959,7,1152,3.405.535.714
17/05/2021 06:00,57.06,42887,117,23,26,1092,5,1263,3.405.535.714
17/05/2021 07:00,59.33,44250,124,23,25,1206,4,1382,3.405.535.714
17/05/2021 08:00,58.95,44750,166,28,21,1335,4,1554,3.405.535.714
17/05/2021 09:00,58.16,44966,211,32,19,1460,4,1726,3.405.535.714
17/05/2021 10:00,56.98,44998,290,38,19,1568,5,1920,3.405.535.714
17/05/2021 11:00,55.69,44621,376,40,19,1660,5,2100,3.405.535.714
17/05/2021 12:00,55.06,44159,471,45,18,1755,5,2294,3.405.535.714
17/05/2021 13:00,53.99,43800,510,47,13,1829,5,2404,3.405.535.714
17/05/2021 14:00,52.98,43426,537,47,9,1890,5,2488,3.405.535.714
17/05/2021 15:00,52.58,43124,522,47,7,1899,4,2479,3.405.535.714
17/05/2021 16:00,53.22,43245,413,43,7,1808,3,2274,3.405.535.714
17/05/2021 17:00,54.28,43098,349,38,8,1675,3,2073,3.405.535.714
17/05/2021 18:00,54.72,42519,296,39,10,1555,3,1903,3.405.535.714
17/05/2021 19:00,52.61,41815,278,45,14,1524,3,1864,3.405.535.714
17/05/2021 20:00,51.93,41584,280,51,21,1627,3,1982,3.405.535.714
17/05/2021 21:00,50.59,40679,307,54,31,1820,3,2215,3.405.535.714
17/05/2021 22:00,45.4,38864,351,52,41,2025,3,2472,3.405.535.714
17/05/2021 23:00,43.37,36923,263,78,115,2085,5,2546,3.405.535.714
18/05/2021 00:00,40.6,36145,277,84,89,2093,4,2547,3.405.535.714
18/05/2021 01:00,40.31,35907,291,89,66,2090,2,2538,3.405.535.714
18/05/2021 02:00,40.3,35984,299,94,47,1988,2,2430,3.405.535.714
18/05/2021 03:00,42.84,36108,319,93,42,1896,2,2352,3.405.535.714
18/05/2021 04:00,47.73,37585,361,89,42,1730,2,2224,3.405.535.714
18/05/2021 05:00,52.89,40654,432,82,35,1547,2,2098,3.405.535.714
18/05/2021 06:00,57.93,43804,450,76,25,1396,2,1949,3.405.535.714
18/05/2021 07:00,63.43,45036,445,74,23,1307,2,1851,3.405.535.714
18/05/2021 08:00,59.99,44982,488,79,26,1357,2,1952,3.405.535.714
18/05/2021 09:00,58.71,44898,535,86,32,1425,2,2080,3.405.535.714
18/05/2021 10:00,58.05,44665,629,86,36,1488,2,2241,3.405.535.714
18/05/2021 11:00,57.66,44166,740,81,43,1500,4,2368,3.405.535.714
18/05/2021 12:00,57.21,43812,853,71,54,1476,5,2459,3.405.535.714
18/05/2021 13:00,55.88,43431,923,60,60,1411,5,2459,3.405.535.714
18/05/2021 14:00,55.43,43229,996,49,70,1309,5,2429,3.405.535.714
18/05/2021 15:00,54.85,43093,1088,39,79,1176,6,2388,3.405.535.714
18/05/2021 16:00,57.35,43240,1044,32,86,1021,5,2188,3.405.535.714
18/05/2021 17:00,58.56,42948,961,28,90,892,5,1976,3.405.535.714
18/05/2021 18:00,58.89,42527,865,23,88,812,4,1792,3.405.535.714
18/05/2021 19:00,56.14,41890,753,19,86,835,3,1696,3.405.535.714
18/05/2021 20:00,55.43,41616,749,16,86,973,3,1827,3.405.535.714
18/05/2021 21:00,54.91,40615,825,14,86,1148,3,2076,3.405.535.714
18/05/2021 22:00,51.41,38578,895,13,81,1285,2,2276,3.405.535.714
18/05/2021 23:00,51.13,36758,832,21,84,1024,4,1965,3.405.535.714
19/05/2021 00:00,50.1,35976,904,24,91,1044,5,2068,3.405.535.714
19/05/2021 01:00,48.81,35799,942,24,90,1071,5,2132,3.405.535.714
19/05/2021 02:00,48.27,35811,941,24,93,1124,4,2186,3.405.535.714
19/05/2021 03:00,48.67,36121,919,24,97,1153,4,2197,3.405.535.714
19/05/2021 04:00,51.28,37621,901,24,89,1104,4,2122,3.405.535.714
19/05/2021 05:00,56.19,40884,850,22,74,969,3,1918,3.405.535.714
19/05/2021 06:00,59.02,44049,757,27,64,808,3,1659,3.405.535.714
19/05/2021 07:00,59.96,44891,710,28,78,766,3,1585,3.405.535.714
19/05/2021 08:00,58.99,44737,778,30,94,851,3,1756,3.405.535.714
19/05/2021 09:00,58.54,44739,827,34,113,952,4,1930,3.405.535.714
19/05/2021 10:00,57.81,44586,905,36,136,1053,4,2134,3.405.535.714
19/05/2021 11:00,56.45,44178,985,37,157,1158,4,2341,3.405.535.714
19/05/2021 12:00,56.05,44010,1038,42,172,1263,4,2519,3.405.535.714
19/05/2021 13:00,54.59,43590,1096,48,177,1339,4,2664,3.405.535.714
19/05/2021 14:00,53.52,43394,1160,56,175,1414,4,2809,3.405.535.714
19/05/2021 15:00,53.34,43368,1232,62,163,1472,4,2933,3.405.535.714
19/05/2021 16:00,53.6,43463,1182,69,144,1514,5,2914,3.405.535.714
19/05/2021 17:00,55.79,43261,1126,80,121,1510,3,2840,3.405.535.714
19/05/2021 18:00,55.81,42910,1061,85,103,1576,3,2828,3.405.535.714
19/05/2021 19:00,53.85,42200,971,87,92,1811,2,2963,3.405.535.714
19/05/2021 20:00,52.8,41908,1004,93,88,2236,4,3425,3.405.535.714
19/05/2021 21:00,51.22,40863,1148,98,83,2721,4,4054,3.405.535.714
19/05/2021 22:00,46.16,38896,1328,98,81,3080,3,4590,3.405.535.714
19/05/2021 23:00,42.08,36626,1661,110,99,3024,6,4900,3.405.535.714
20/05/2021 00:00,35.7,35842,1824,113,92,3175,4,5208,3.405.535.714
20/05/2021 01:00,28.59,35576,2015,113,82,3220,3,5433,3.405.535.714
20/05/2021 02:00,27.41,35633,2209,114,77,3205,3,5608,3.405.535.714
20/05/2021 03:00,27.42,35950,2355,113,74,3144,4,5690,3.405.535.714
20/05/2021 04:00,37.34,37441,2500,111,73,2970,5,5659,3.405.535.714
20/05/2021 05:00,50.73,40340,2641,109,70,2650,3,5473,3.405.535.714
20/05/2021 06:00,55.52,43111,2624,105,73,2313,2,5117,3.405.535.714
20/05/2021 07:00,56.86,44117,2648,101,105,2165,3,5022,3.405.535.714
20/05/2021 08:00,54.98,44055,2928,105,142,2135,4,5314,3.405.535.714
20/05/2021 09:00,56.13,44075,3154,111,179,2120,6,5570,3.405.535.714
20/05/2021 10:00,53.67,43876,3275,114,223,2113,7,5732,3.405.535.714
20/05/2021 11:00,53.22,43568,3315,117,266,2100,9,5807,3.405.535.714
20/05/2021 12:00,52.99,43174,3274,122,293,2098,11,5798,3.405.535.714
20/05/2021 13:00,51.21,42797,3239,130,305,2109,11,5794,3.405.535.714
20/05/2021 14:00,50.08,42501,3304,133,307,2137,13,5894,3.405.535.714
20/05/2021 15:00,50.93,42470,3262,128,300,2157,16,5863,3.405.535.714
20/05/2021 16:00,53.02,42626,2903,118,283,2143,15,5462,3.405.535.714
20/05/2021 17:00,55.59,42359,2499,105,254,2088,11,4957,3.405.535.714
20/05/2021 18:00,56.11,42013,2122,93,220,2024,9,4468,3.405.535.714
20/05/2021 19:00,53.75,41392,1639,82,191,2051,12,3975,3.405.535.714
20/05/2021 20:00,53.28,41223,1276,78,182,2249,11,3796,3.405.535.714
20/05/2021 21:00,52.13,40412,1182,76,191,2494,9,3952,3.405.535.714
20/05/2021 22:00,49.19,38787,1154,71,209,2652,11,4097,3.405.535.714
20/05/2021 23:00,40,36630,864,115,175,2318,10,3482,3.405.535.714
21/05/2021 00:00,23.96,35724,996,110,186,2365,11,3668,3.405.535.714
21/05/2021 01:00,17.76,35351,1126,105,187,2373,18,3809,3.405.535.714
21/05/2021 02:00,7.97,35354,1381,98,186,2345,21,4031,3.405.535.714
21/05/2021 03:00,7.36,35712,1522,89,184,2306,21,4122,3.405.535.714
21/05/2021 04:00,20.47,37307,1744,76,174,2206,21,4221,3.405.535.714
21/05/2021 05:00,46.98,40371,1991,60,165,2026,26,4268,3.405.535.714
21/05/2021 06:00,53.31,43249,2075,45,177,1923,25,4245,3.405.535.714
21/05/2021 07:00,53.88,44343,2057,34,207,1966,22,4286,3.405.535.714
21/05/2021 08:00,49.74,44404,2207,32,218,2069,17,4543,3.405.535.714
21/05/2021 09:00,40.39,44338,2355,39,218,2209,19,4840,3.405.535.714
21/05/2021 10:00,25.58,44043,2437,49,211,2324,22,5043,3.405.535.714
21/05/2021 11:00,22.98,43529,2478,61,189,2391,27,5146,3.405.535.714
21/05/2021 12:00,20.62,42928,2462,73,161,2452,33,5181,3.405.535.714
21/05/2021 13:00,17.16,42317,2394,85,129,2484,33,5125,3.405.535.714
21/05/2021 14:00,8.36,41957,2442,93,103,2466,34,5138,3.405.535.714
21/05/2021 15:00,11.31,41820,2454,100,82,2425,28,5089,3.405.535.714
21/05/2021 16:00,21.01,42007,2407,112,77,2405,24,5025,3.405.535.714
21/05/2021 17:00,42.89,41982,2319,115,83,2358,15,4890,3.405.535.714
21/05/2021 18:00,47.08,41454,2206,109,95,2297,7,4714,3.405.535.714
21/05/2021 19:00,44.62,40528,2139,111,116,2262,4,4632,3.405.535.714
21/05/2021 20:00,44.99,40192,2181,108,146,2313,4,4752,3.405.535.714
21/05/2021 21:00,42.09,39537,2315,107,164,2373,5,4964,3.405.535.714
21/05/2021 22:00,23.35,37914,2435,110,158,2412,11,5126,3.405.535.714
21/05/2021 23:00,22.73,36139,2711,63,200,2422,8,5404,3.405.535.714
22/05/2021 00:00,4.86,35169,2966,61,178,2450,4,5659,3.405.535.714
22/05/2021 01:00,1.49,34672,3207,58,173,2453,3,5894,3.405.535.714
22/05/2021 02:00,0.57,34357,3292,51,171,2460,6,5980,3.405.535.714
22/05/2021 03:00,0.12,34499,3350,43,150,2441,6,5990,3.405.535.714
22/05/2021 04:00,0.23,34986,3433,36,120,2352,4,5945,3.405.535.714
22/05/2021 05:00,0.7,35765,3462,28,98,2216,4,5808,3.405.535.714
22/05/2021 06:00,1.01,37066,3270,23,85,2140,5,5523,3.405.535.714
22/05/2021 07:00,3.17,38649,3105,18,94,2081,6,5304,3.405.535.714
22/05/2021 08:00,11.65,39798,3303,16,90,2061,11,5481,3.405.535.714
22/05/2021 09:00,19.39,40488,3591,16,80,2019,14,5720,3.405.535.714
22/05/2021 10:00,20.41,40242,3715,15,74,2027,12,5843,3.405.535.714
22/05/2021 11:00,18.35,39859,3700,15,70,2073,10,5868,3.405.535.714
22/05/2021 12:00,15.02,39374,3717,17,66,2090,10,5900,3.405.535.714
22/05/2021 13:00,8.97,39081,3535,18,67,2073,7,5700,3.405.535.714
22/05/2021 14:00,9.19,39007,3349,18,66,2061,10,5504,3.405.535.714
22/05/2021 15:00,16.48,39283,3160,17,61,2003,8,5249,3.405.535.714
22/05/2021 16:00,24.13,39939,3088,14,65,1922,7,5096,3.405.535.714
22/05/2021 17:00,19.95,40280,3151,11,71,1892,2,5127,3.405.535.714
22/05/2021 18:00,35.1,39949,3275,9,68,1796,2,5150,3.405.535.714
22/05/2021 19:00,39.92,39184,3223,11,74,1801,2,5111,3.405.535.714
22/05/2021 20:00,40.92,39093,3167,13,71,1908,2,5161,3.405.535.714
22/05/2021 21:00,39.9,38493,3188,13,77,2033,7,5318,3.405.535.714
22/05/2021 22:00,23.56,37257,3308,16,98,2106,2,5530,3.405.535.714
22/05/2021 23:00,23.25,35740,3125,18,71,2057,2,5273,3.405.535.714
23/05/2021 00:00,16.81,34900,3277,18,79,2059,3,5436,3.405.535.714
23/05/2021 01:00,16.85,34488,3461,17,82,2084,3,5647,3.405.535.714
23/05/2021 02:00,12.03,34402,3663,16,83,2116,2,5880,3.405.535.714
23/05/2021 03:00,12.78,34191,3830,14,82,2140,2,6068,3.405.535.714
23/05/2021 04:00,11.06,34374,4066,12,81,2144,3,6306,3.405.535.714
23/05/2021 05:00,9.91,34967,4236,8,77,2142,4,6467,3.405.535.714
23/05/2021 06:00,14.95,35987,4190,6,77,2147,3,6423,3.405.535.714
23/05/2021 07:00,13.24,37357,4176,5,90,2175,3,6449,3.405.535.714
23/05/2021 08:00,13.82,38626,4574,5,105,2255,4,6943,3.405.535.714
23/05/2021 09:00,10.66,39537,4738,5,123,2353,6,7225,3.405.535.714
23/05/2021 10:00,10,39858,4771,6,144,2457,7,7385,3.405.535.714
23/05/2021 11:00,7.06,39907,4873,6,174,2571,10,7634,3.405.535.714
23/05/2021 12:00,2.62,39719,4779,6,196,2663,12,7656,3.405.535.714
23/05/2021 13:00,1.7,39643,4549,6,192,2713,14,7474,3.405.535.714
23/05/2021 14:00,2.3,39626,4429,5,174,2720,17,7345,3.405.535.714
23/05/2021 15:00,5.04,39881,4189,5,157,2694,14,7059,3.405.535.714
23/05/2021 16:00,25.25,40482,3822,6,139,2609,15,6591,3.405.535.714
23/05/2021 17:00,43.84,40617,3286,8,105,2491,14,5904,3.405.535.714
23/05/2021 18:00,51.12,40542,2781,14,67,2356,18,5236,3.405.535.714
23/05/2021 19:00,51.7,40044,2179,26,62,2257,16,4540,3.405.535.714
23/05/2021 20:00,52.94,39879,1767,40,80,2235,15,4137,3.405.535.714
23/05/2021 21:00,53.15,39211,1577,55,106,2248,18,4004,3.405.535.714
23/05/2021 22:00,51.86,37904,1392,65,132,2225,21,3835,3.405.535.714
23/05/2021 23:00,46.95,34466,1214,104,150,2009,13,3490,3.405.535.714
24/05/2021 00:00,39.94,34123,1223,98,166,2027,12,3526,3.815.416.667
24/05/2021 01:00,22.16,34377,1291,90,182,1997,14,3574,3.815.416.667
24/05/2021 02:00,11.03,34595,1412,86,191,1913,10,3612,3.815.416.667
24/05/2021 03:00,7.78,34681,1457,86,189,1794,10,3536,3.815.416.667
24/05/2021 04:00,9.98,35806,1621,83,173,1615,9,3501,3.815.416.667
24/05/2021 05:00,23.14,37996,1825,79,140,1391,9,3444,3.815.416.667
24/05/2021 06:00,35.47,40234,1949,75,120,1204,13,3361,3.815.416.667
24/05/2021 07:00,40.42,41610,1955,79,134,1091,12,3271,3.815.416.667
24/05/2021 08:00,43.62,42352,2175,86,137,1062,13,3473,3.815.416.667
24/05/2021 09:00,43.86,42742,2258,96,132,1051,13,3550,3.815.416.667
24/05/2021 10:00,44.32,42944,2348,103,124,1045,15,3635,3.815.416.667
24/05/2021 11:00,44.29,42725,2459,114,106,1035,14,3728,3.815.416.667
24/05/2021 12:00,39.93,42182,2403,123,86,1052,16,3680,3.815.416.667
24/05/2021 13:00,34.12,41730,2181,129,64,1064,14,3452,3.815.416.667
24/05/2021 14:00,34.55,41538,1955,132,46,1062,10,3205,3.815.416.667
24/05/2021 15:00,39.94,41385,1805,132,30,1054,6,3027,3.815.416.667
24/05/2021 16:00,49,41592,1819,128,20,1040,4,3011,3.815.416.667
24/05/2021 17:00,51.48,41659,1923,118,15,1025,3,3084,3.815.416.667
24/05/2021 18:00,53.04,41141,2102,107,21,1062,3,3295,3.815.416.667
24/05/2021 19:00,53.11,40426,2084,97,42,1234,3,3460,3.815.416.667
24/05/2021 20:00,53.23,40150,2103,89,79,1529,3,3803,3.815.416.667
24/05/2021 21:00,52.55,39412,2180,85,116,1847,5,4233,3.815.416.667
24/05/2021 22:00,48.21,37745,2192,81,145,2009,12,4439,3.815.416.667
24/05/2021 23:00,47.29,36253,2129,80,169,2167,7,4552,3.815.416.667
25/05/2021 00:00,42.92,35372,1935,75,187,2155,8,4360,3.815.416.667
25/05/2021 01:00,40.35,35051,1733,69,210,2109,8,4129,3.815.416.667
25/05/2021 02:00,35.26,34990,1448,64,238,2037,10,3797,3.815.416.667
25/05/2021 03:00,34.76,35101,1233,58,258,1995,10,3554,3.815.416.667
25/05/2021 04:00,42.35,36627,1148,50,264,1922,13,3397,3.815.416.667
25/05/2021 05:00,52.71,39929,1047,46,266,1812,12,3183,3.815.416.667
25/05/2021 06:00,56.25,43117,901,43,271,1752,9,2976,3.815.416.667
25/05/2021 07:00,57.12,44411,757,42,283,1848,8,2938,3.815.416.667
25/05/2021 08:00,55.98,44453,852,42,294,2128,8,3324,3.815.416.667
25/05/2021 09:00,54.95,44551,1078,47,304,2411,11,3851,3.815.416.667
25/05/2021 10:00,54.31,44349,1215,51,319,2616,13,4214,3.815.416.667
25/05/2021 11:00,52.61,43662,1324,49,346,2806,16,4541,3.815.416.667
25/05/2021 12:00,47.52,43463,1517,46,360,2999,14,4936,3.815.416.667
25/05/2021 13:00,41.21,43193,1548,45,340,3146,12,5091,3.815.416.667
25/05/2021 14:00,39.97,42929,1464,47,305,3249,12,5077,3.815.416.667
25/05/2021 15:00,40.71,42793,1538,47,261,3307,18,5171,3.815.416.667
25/05/2021 16:00,47.69,43143,1619,40,209,3266,16,5150,3.815.416.667
25/05/2021 17:00,51.47,42853,1699,34,161,3204,15,5113,3.815.416.667
25/05/2021 18:00,51.75,42456,1644,29,121,3101,17,4912,3.815.416.667
25/05/2021 19:00,50.32,41812,1468,27,95,3106,15,4711,3.815.416.667
25/05/2021 20:00,49.28,41471,1513,28,78,3233,17,4869,3.815.416.667
25/05/2021 21:00,47,40588,1561,29,69,3375,15,5049,3.815.416.667
25/05/2021 22:00,40.48,38600,1676,28,67,3442,13,5226,3.815.416.667
25/05/2021 23:00,33.18,36512,1538,20,52,3506,4,5120,3.815.416.667
26/05/2021 00:00,29.98,35763,1766,17,62,3577,4,5426,3.815.416.667
26/05/2021 01:00,28.22,35449,1940,13,82,3583,4,5622,3.815.416.667
26/05/2021 02:00,26.73,35364,2292,10,103,3537,4,5946,3.815.416.667
26/05/2021 03:00,28.14,35627,2565,8,108,3457,4,6142,3.815.416.667
26/05/2021 04:00,34.97,37192,2653,6,93,3370,6,6128,3.815.416.667
26/05/2021 05:00,48.02,40542,2641,4,76,3212,6,5939,3.815.416.667
26/05/2021 06:00,52.43,43630,2658,5,88,3101,6,5858,3.815.416.667
26/05/2021 07:00,53.85,44817,2754,7,121,3164,8,6054,3.815.416.667
26/05/2021 08:00,52.78,44915,2899,9,144,3450,11,6513,3.815.416.667
26/05/2021 09:00,52.63,45027,3027,12,173,3720,16,6948,3.815.416.667
26/05/2021 10:00,52.6,44899,3214,17,216,3928,15,7390,3.815.416.667
26/05/2021 11:00,52.41,44755,3369,23,256,4091,8,7747,3.815.416.667
26/05/2021 12:00,52.08,44512,3378,31,258,4246,12,7925,3.815.416.667
26/05/2021 13:00,48.4,44138,3104,42,232,4345,12,7735,3.815.416.667
26/05/2021 14:00,47.4,43954,3036,50,195,4440,16,7737,3.815.416.667
26/05/2021 15:00,46.74,44001,2972,58,161,4510,20,7721,3.815.416.667
26/05/2021 16:00,47.69,44109,3051,67,130,4496,17,7761,3.815.416.667
26/05/2021 17:00,48.91,43786,3003,73,105,4354,16,7551,3.815.416.667
26/05/2021 18:00,48.55,43444,2863,78,87,4152,13,7193,3.815.416.667
26/05/2021 19:00,45.63,42637,2667,89,96,4014,10,6876,3.815.416.667
26/05/2021 20:00,45.05,42241,2553,98,125,3986,9,6771,3.815.416.667
26/05/2021 21:00,40.91,41242,2539,107,133,3994,9,6782,3.815.416.667
26/05/2021 22:00,32.91,39106,2434,111,127,3936,8,6616,3.815.416.667
26/05/2021 23:00,29.37,36731,1653,141,167,4402,8,6371,3.815.416.667
27/05/2021 00:00,26.92,35841,1635,142,160,4306,8,6251,3.815.416.667
27/05/2021 01:00,25.3,35525,1572,142,142,4184,7,6047,3.815.416.667
27/05/2021 02:00,24.94,35569,1528,144,144,4077,7,5900,3.815.416.667
27/05/2021 03:00,24.8,35816,1478,143,141,3977,7,5746,3.815.416.667
27/05/2021 04:00,34.96,37220,1489,141,123,3910,6,5669,3.815.416.667
27/05/2021 05:00,45.98,40243,1542,137,94,3875,5,5653,3.815.416.667
27/05/2021 06:00,49.47,43232,1607,135,88,3882,4,5716,3.815.416.667
27/05/2021 07:00,52.04,44398,1540,135,96,3888,5,5664,3.815.416.667
27/05/2021 08:00,51.57,44471,1436,136,99,3957,5,5633,3.815.416.667
27/05/2021 09:00,51.87,44577,1476,143,98,3928,5,5650,3.815.416.667
27/05/2021 10:00,52.02,44522,1670,154,96,3787,4,5711,3.815.416.667
27/05/2021 11:00,51.7,44314,1812,169,102,3588,4,5675,3.815.416.667
27/05/2021 12:00,51.41,43939,1935,174,113,3408,5,5635,3.815.416.667
27/05/2021 13:00,50.27,43478,1878,190,114,3225,6,5413,3.815.416.667
27/05/2021 14:00,49.5,43159,1863,203,101,3037,6,5210,3.815.416.667
27/05/2021 15:00,48.97,43127,1835,190,81,2838,5,4949,3.815.416.667
27/05/2021 16:00,49.41,43307,1819,179,57,2618,5,4678,3.815.416.667
27/05/2021 17:00,49.99,42870,1628,168,34,2367,5,4202,3.815.416.667
27/05/2021 18:00,50.85,42383,1414,157,21,2161,4,3757,3.815.416.667
27/05/2021 19:00,49.54,41635,1188,150,15,2127,4,3484,3.815.416.667
27/05/2021 20:00,48.92,41054,1110,146,15,2245,3,3519,3.815.416.667
27/05/2021 21:00,47.75,40239,1103,142,18,2376,3,3642,3.815.416.667
27/05/2021 22:00,45.09,38497,1107,138,24,2457,4,3730,3.815.416.667
27/05/2021 23:00,41.14,37031,1006,140,14,2279,4,3443,3.815.416.667
28/05/2021 00:00,39.68,36099,1000,134,18,2556,4,3712,3.815.416.667
28/05/2021 01:00,37.28,35667,960,128,18,2800,4,3910,3.815.416.667
28/05/2021 02:00,35.95,35695,905,121,16,2963,4,4009,3.815.416.667
28/05/2021 03:00,37.07,36016,861,113,14,3028,4,4020,3.815.416.667
28/05/2021 04:00,40.17,37496,821,100,11,2817,4,3753,3.815.416.667
28/05/2021 05:00,49.7,40435,717,88,7,2356,4,3172,3.815.416.667
28/05/2021 06:00,52.29,43413,610,83,4,1969,4,2670,3.815.416.667
28/05/2021 07:00,52.62,44720,512,78,4,1875,4,2473,3.815.416.667
28/05/2021 08:00,52.46,44836,483,71,6,1973,4,2537,3.815.416.667
28/05/2021 09:00,51.56,44711,487,65,9,2108,4,2673,3.815.416.667
28/05/2021 10:00,50.45,44248,465,60,12,2214,4,2755,3.815.416.667
28/05/2021 11:00,49.68,43593,469,55,18,2326,4,2872,3.815.416.667
28/05/2021 12:00,49.76,42689,485,50,31,2458,4,3028,3.815.416.667
28/05/2021 13:00,47.55,41959,542,46,39,2561,4,3192,3.815.416.667
28/05/2021 14:00,45.99,41433,663,38,39,2634,4,3378,3.815.416.667
28/05/2021 15:00,44.65,41244,778,30,47,2664,4,3523,3.815.416.667
28/05/2021 16:00,45.53,41203,823,27,53,2569,4,3476,3.815.416.667
28/05/2021 17:00,47.84,40912,743,28,57,2403,4,3235,3.815.416.667
28/05/2021 18:00,47.81,40284,639,27,59,2224,4,2953,3.815.416.667
28/05/2021 19:00,46.16,39436,539,26,58,2171,4,2798,3.815.416.667
28/05/2021 20:00,46.48,38937,504,24,61,2237,4,2830,3.815.416.667
28/05/2021 21:00,45.27,38243,530,24,64,2359,4,2981,3.815.416.667
28/05/2021 22:00,39.41,36876,545,24,65,2396,4,3034,3.815.416.667
28/05/2021 23:00,40.67,34938,901,81,53,2618,3,3656,3.815.416.667
29/05/2021 00:00,39.92,34012,956,74,49,2589,3,3671,3.815.416.667
29/05/2021 01:00,37.82,33583,962,68,48,2499,3,3580,3.815.416.667
29/05/2021 02:00,39.5,33338,966,63,43,2346,3,3421,3.815.416.667
29/05/2021 03:00,43.01,33215,995,59,37,2151,3,3245,3.815.416.667
29/05/2021 04:00,45.08,33469,949,51,30,1790,3,2823,3.815.416.667
29/05/2021 05:00,47.28,34071,886,38,22,1292,3,2241,3.815.416.667
29/05/2021 06:00,48.84,35380,843,30,17,948,3,1841,3.815.416.667
29/05/2021 07:00,49.58,36979,768,31,17,812,3,1631,3.815.416.667
29/05/2021 08:00,50.35,38238,656,38,13,807,3,1517,3.815.416.667
29/05/2021 09:00,49.85,38826,545,43,13,837,3,1441,3.815.416.667
29/05/2021 10:00,47.69,38599,574,47,16,878,4,1519,3.815.416.667
29/05/2021 11:00,40.75,38197,576,50,19,912,5,1562,3.815.416.667
29/05/2021 12:00,28.6,37635,565,48,26,933,5,1577,3.815.416.667
29/05/2021 13:00,22.24,37253,513,45,35,935,6,1534,3.815.416.667
29/05/2021 14:00,22.99,37115,501,41,45,922,7,1516,3.815.416.667
29/05/2021 15:00,25.59,37285,486,35,56,893,8,1478,3.815.416.667
29/05/2021 16:00,37.77,37889,515,26,62,860,9,1472,3.815.416.667
29/05/2021 17:00,48.54,38170,516,17,61,834,9,1437,3.815.416.667
29/05/2021 18:00,50.31,37833,527,13,65,857,8,1470,3.815.416.667
29/05/2021 19:00,49.8,37166,543,11,73,937,7,1571,3.815.416.667
29/05/2021 20:00,49.41,37049,577,11,93,1123,6,1810,3.815.416.667
29/05/2021 21:00,48.59,36565,573,10,115,1377,6,2081,3.815.416.667
29/05/2021 22:00,47.39,35494,512,9,126,1508,7,2162,3.815.416.667
29/05/2021 23:00,41.54,34129,590,12,155,1342,8,2107,3.815.416.667
30/05/2021 00:00,39.91,33272,488,8,159,1339,7,2001,3.815.416.667
30/05/2021 01:00,35.89,32862,343,6,157,1308,7,1821,3.815.416.667
30/05/2021 02:00,31.53,32718,237,6,155,1233,6,1637,3.815.416.667
30/05/2021 03:00,31.32,32355,182,9,153,1116,6,1466,3.815.416.667
30/05/2021 04:00,29.75,32352,146,12,140,889,6,1193,3.815.416.667
30/05/2021 05:00,29.46,32816,148,13,117,611,5,894,3.815.416.667
30/05/2021 06:00,30.88,33781,171,15,106,437,3,732,3.815.416.667
30/05/2021 07:00,31.4,35118,161,18,126,416,3,724,3.815.416.667
30/05/2021 08:00,27.75,36374,162,22,140,499,3,826,3.815.416.667
30/05/2021 09:00,20.9,37130,162,28,149,593,4,936,3.815.416.667
30/05/2021 10:00,18.43,37314,196,35,150,681,5,1067,3.815.416.667
30/05/2021 11:00,16.1,37203,225,39,143,770,6,1183,3.815.416.667
30/05/2021 12:00,15.19,36846,238,43,134,864,7,1286,3.815.416.667
30/05/2021 13:00,14.93,36633,223,47,121,941,6,1338,3.815.416.667
30/05/2021 14:00,14.6,36635,234,49,117,1017,6,1423,3.815.416.667
30/05/2021 15:00,19.54,36914,243,48,119,1086,7,1503,3.815.416.667
30/05/2021 16:00,22.37,37429,272,45,122,1144,7,1590,3.815.416.667
30/05/2021 17:00,34.97,37750,276,42,108,1198,6,1630,3.815.416.667
30/05/2021 18:00,43.73,37780,274,42,86,1347,4,1753,3.815.416.667
30/05/2021 19:00,44.56,37427,237,42,78,1659,3,2019,3.815.416.667
30/05/2021 20:00,45.46,37306,204,45,89,2064,4,2406,3.815.416.667
30/05/2021 21:00,43.02,36802,182,47,100,2459,6,2794,3.815.416.667
30/05/2021 22:00,38.12,35511,176,47,105,2629,6,2963,3.815.416.667
30/05/2021 23:00,36.05,34316,188,16,65,2854,5,3128,3.815.416.667
31/05/2021 00:00,35.06,33556,219,17,55,2806,6,3103,4.261.309.524
31/05/2021 01:00,34.69,33277,260,16,48,2798,4,3126,4.261.309.524
31/05/2021 02:00,34.68,33204,283,15,41,2780,3,3122,4.261.309.524
31/05/2021 03:00,36.65,33371,283,13,35,2643,2,2976,4.261.309.524
31/05/2021 04:00,41.82,34898,291,9,27,2342,2,2671,4.261.309.524
31/05/2021 05:00,49.63,37920,284,7,16,1924,1,2232,4.261.309.524
31/05/2021 06:00,53.43,41078,262,6,7,1526,1,1802,4.261.309.524
31/05/2021 07:00,55,42525,236,6,5,1283,1,1531,4.261.309.524
31/05/2021 08:00,54.74,42840,263,7,7,1215,1,1493,4.261.309.524
31/05/2021 09:00,54.15,42879,329,8,9,1165,1,1512,4.261.309.524
31/05/2021 10:00,53.62,42685,382,10,11,1136,1,1540,4.261.309.524
31/05/2021 11:00,53.17,42366,442,12,14,1127,1,1596,4.261.309.524
31/05/2021 12:00,51.55,42064,517,16,19,1133,1,1686,4.261.309.524
31/05/2021 13:00,51.11,41697,552,22,28,1121,2,1725,4.261.309.524
31/05/2021 14:00,51.28,41487,617,26,42,1103,3,1791,4.261.309.524
31/05/2021 15:00,51.05,41298,681,27,59,1082,3,1852,4.261.309.524
31/05/2021 16:00,53.42,41463,762,25,73,1026,3,1889,4.261.309.524
31/05/2021 17:00,54.84,41259,809,22,73,955,3,1862,4.261.309.524
31/05/2021 18:00,56.11,40784,872,22,66,915,3,1878,4.261.309.524
31/05/2021 19:00,53.49,39955,829,27,52,996,2,1906,4.261.309.524
31/05/2021 20:00,53.42,39588,804,33,42,1115,3,1997,4.261.309.524
31/05/2021 21:00,51.33,38760,860,36,32,1222,4,2154,4.261.309.524
31/05/2021 22:00,48.83,36994,873,37,23,1232,4,2169,4.261.309.524
31/05/2021 23:00,45.29,35075,751,9,8,1402,3,2173,4.261.309.524
01/06/2021 00:00,43.85,34000,750,7,10,1288,4,2059,4.261.309.524
01/06/2021 01:00,42.88,33643,716,6,12,1192,3,1929,4.261.309.524
01/06/2021 02:00,42.54,33437,653,6,14,1124,2,1799,4.261.309.524
01/06/2021 03:00,43.63,33526,590,7,18,1084,2,1701,4.261.309.524
01/06/2021 04:00,48.61,34948,525,9,19,980,3,1536,4.261.309.524
01/06/2021 05:00,52.72,37870,392,9,13,816,3,1233,4.261.309.524
01/06/2021 06:00,55.78,41036,272,8,12,753,2,1047,4.261.309.524
01/06/2021 07:00,57.14,42287,212,8,15,842,2,1079,4.261.309.524
01/06/2021 08:00,56.29,42409,185,12,16,1045,2,1260,4.261.309.524
01/06/2021 09:00,55.97,42630,193,18,21,1273,2,1507,4.261.309.524
01/06/2021 10:00,55.88,42446,213,23,28,1497,4,1765,4.261.309.524
01/06/2021 11:00,54.6,42015,247,28,32,1702,6,2015,4.261.309.524
01/06/2021 12:00,53.95,41818,275,32,38,1883,5,2233,4.261.309.524
01/06/2021 13:00,53.43,41466,277,32,41,1995,7,2352,4.261.309.524
01/06/2021 14:00,52.93,41200,294,30,38,2019,9,2390,4.261.309.524
01/06/2021 15:00,52.45,41050,330,30,42,1997,8,2407,4.261.309.524
01/06/2021 16:00,53.52,41263,399,25,47,1913,7,2391,4.261.309.524
01/06/2021 17:00,53.63,40951,528,17,53,1817,6,2421,4.261.309.524
01/06/2021 18:00,53.63,40606,771,15,57,1740,3,2586,4.261.309.524
01/06/2021 19:00,52.39,39897,897,17,66,1776,5,2761,4.261.309.524
01/06/2021 20:00,52.04,39428,996,26,81,1964,6,3073,4.261.309.524
01/06/2021 21:00,49.45,38668,1007,33,91,2211,8,3350,4.261.309.524
01/06/2021 22:00,45.09,36882,1008,37,88,2336,8,3477,4.261.309.524
01/06/2021 23:00,43.9,34450,1156,32,141,2460,13,3802,4.261.309.524
02/06/2021 00:00,42.88,33593,1298,36,129,2438,13,3914,4.261.309.524
02/06/2021 01:00,42.81,33342,1295,42,120,2376,14,3847,4.261.309.524
02/06/2021 02:00,42.73,33215,1271,43,114,2297,15,3740,4.261.309.524
02/06/2021 03:00,43.17,33284,1234,38,111,2186,12,3581,4.261.309.524
02/06/2021 04:00,47.4,34630,1251,32,96,1975,9,3363,4.261.309.524
02/06/2021 05:00,52.15,37603,1169,24,68,1680,6,2947,4.261.309.524
02/06/2021 06:00,55.43,40349,1138,20,38,1480,3,2679,4.261.309.524
02/06/2021 07:00,56.27,41345,1100,21,30,1496,3,2650,4.261.309.524
02/06/2021 08:00,55.37,41334,1101,24,37,1682,2,2846,4.261.309.524
02/06/2021 09:00,55.1,41433,1166,26,49,1888,3,3132,4.261.309.524
02/06/2021 10:00,54.47,41277,1203,28,55,2041,5,3332,4.261.309.524
02/06/2021 11:00,53.42,41073,1321,30,50,2125,5,3531,4.261.309.524
02/06/2021 12:00,52.15,40918,1391,32,44,2177,3,3647,4.261.309.524
02/06/2021 13:00,51.51,40628,1398,35,42,2166,3,3644,4.261.309.524
02/06/2021 14:00,51.03,40323,1374,42,43,2100,4,3563,4.261.309.524
02/06/2021 15:00,50.85,40176,1357,43,44,2049,4,3497,4.261.309.524
02/06/2021 16:00,52.31,40082,1440,40,41,1981,5,3507,4.261.309.524
02/06/2021 17:00,54.73,39766,1547,35,40,1908,4,3534,4.261.309.524
02/06/2021 18:00,54.51,39424,1744,33,41,1851,4,3673,4.261.309.524
02/06/2021 19:00,52.15,38748,1832,32,46,1994,4,3908,4.261.309.524
02/06/2021 20:00,50,38431,2024,33,62,2355,4,4478,4.261.309.524
02/06/2021 21:00,47.7,37730,2306,36,79,2765,5,5191,4.261.309.524
02/06/2021 22:00,41.64,35983,2414,32,89,2944,6,5485,4.261.309.524
02/06/2021 23:00,38.14,33609,3188,33,108,2726,7,6062,4.261.309.524
03/06/2021 00:00,35.96,32707,3447,29,110,2667,6,6259,4.261.309.524
03/06/2021 01:00,33.36,32430,3420,23,102,2549,6,6100,4.261.309.524
03/06/2021 02:00,31.4,32534,3310,17,94,2386,6,5813,4.261.309.524
03/06/2021 03:00,34.43,32765,3281,12,87,2203,6,5589,4.261.309.524
03/06/2021 04:00,39.4,34148,3394,10,74,1914,4,5396,4.261.309.524
03/06/2021 05:00,47.02,36959,3495,8,51,1503,4,5061,4.261.309.524
03/06/2021 06:00,53.37,39715,3353,4,28,1165,4,4554,4.261.309.524
03/06/2021 07:00,56.29,40808,3216,4,17,1115,4,4356,4.261.309.524
03/06/2021 08:00,54.52,40878,3223,4,15,1329,4,4575,4.261.309.524
03/06/2021 09:00,51.78,40881,3208,6,17,1604,4,4839,4.261.309.524
03/06/2021 10:00,47.83,40813,3387,8,20,1816,4,5235,4.261.309.524
03/06/2021 11:00,47.37,40480,3696,11,19,1944,4,5674,4.261.309.524
03/06/2021 12:00,46.95,40130,3884,13,16,2027,4,5944,4.261.309.524
03/06/2021 13:00,47.83,39808,3629,15,18,2050,5,5717,4.261.309.524
03/06/2021 14:00,47.77,39537,3433,16,20,2045,5,5519,4.261.309.524
03/06/2021 15:00,47.67,39407,3305,18,21,1977,5,5326,4.261.309.524
03/06/2021 16:00,51.28,39367,3278,21,21,1908,5,5233,4.261.309.524
03/06/2021 17:00,53.26,38956,3206,24,23,1815,4,5072,4.261.309.524
03/06/2021 18:00,53.32,38460,3403,26,27,1787,4,5247,4.261.309.524
03/06/2021 19:00,49.76,37807,3281,28,31,2003,4,5347,4.261.309.524
03/06/2021 20:00,47.74,37382,3350,29,38,2378,6,5801,4.261.309.524
03/06/2021 21:00,44.64,36804,3456,32,47,2756,5,6296,4.261.309.524
03/06/2021 22:00,35.87,35241,3446,32,59,2868,5,6410,4.261.309.524
03/06/2021 23:00,37.24,33313,2664,31,64,2834,6,5599,4.261.309.524
04/06/2021 00:00,37.73,32293,2529,32,58,2697,5,5321,4.261.309.524
04/06/2021 01:00,38.15,31977,2361,33,49,2486,5,4934,4.261.309.524
04/06/2021 02:00,39.72,31956,2086,32,44,2270,4,4436,4.261.309.524
04/06/2021 03:00,41.63,32102,1834,29,38,2078,4,3983,4.261.309.524
04/06/2021 04:00,46.32,33498,1729,22,26,1798,3,3578,4.261.309.524
04/06/2021 05:00,49.97,36461,1585,13,15,1391,3,3007,4.261.309.524
04/06/2021 06:00,52.85,39435,1468,8,7,1029,3,2515,4.261.309.524
04/06/2021 07:00,55.82,40722,1349,8,3,911,3,2274,4.261.309.524
04/06/2021 08:00,54.93,40823,1426,12,2,1013,3,2456,4.261.309.524
04/06/2021 09:00,53.38,40852,1428,18,3,1149,3,2601,4.261.309.524
04/06/2021 10:00,52.89,40576,1540,27,4,1228,3,2802,4.261.309.524
04/06/2021 11:00,52.75,40116,1639,35,8,1258,3,2943,4.261.309.524
04/06/2021 12:00,52.9,39532,1655,41,14,1282,4,2996,4.261.309.524
04/06/2021 13:00,52.99,38900,1604,44,18,1267,4,2937,4.261.309.524
04/06/2021 14:00,49.99,38431,1625,45,20,1196,4,2890,4.261.309.524
04/06/2021 15:00,49.43,38252,1542,40,22,1114,4,2722,4.261.309.524
04/06/2021 16:00,50.59,38206,1549,33,24,1030,4,2640,4.261.309.524
04/06/2021 17:00,52.29,37948,1421,28,23,928,4,2404,4.261.309.524
04/06/2021 18:00,52.04,37456,1373,25,21,903,3,2325,4.261.309.524
04/06/2021 19:00,50.09,36693,1263,28,21,1030,3,2345,4.261.309.524
04/06/2021 20:00,48.67,36217,1252,31,24,1290,4,2601,4.261.309.524
04/06/2021 21:00,47.77,35533,1346,32,26,1563,4,2971,4.261.309.524
04/06/2021 22:00,46.55,34248,1293,29,22,1654,3,3001,4.261.309.524
04/06/2021 23:00,47.48,32378,1067,34,16,1445,3,2565,4.261.309.524
05/06/2021 00:00,47.44,31359,1132,33,13,1457,3,2638,4.261.309.524
05/06/2021 01:00,45.05,30808,1153,37,11,1362,3,2566,4.261.309.524
05/06/2021 02:00,42.79,30472,1142,54,10,1216,3,2425,4.261.309.524
05/06/2021 03:00,42.83,30321,1128,70,10,1070,4,2282,4.261.309.524
05/06/2021 04:00,42.37,30603,1188,75,10,878,5,2156,4.261.309.524
05/06/2021 05:00,45.27,31077,1229,74,8,663,4,1978,4.261.309.524
05/06/2021 06:00,47.42,32297,1157,72,4,499,3,1735,4.261.309.524
05/06/2021 07:00,49.2,33952,1038,69,3,438,3,1551,4.261.309.524
05/06/2021 08:00,51.32,35209,953,68,4,490,3,1518,4.261.309.524
05/06/2021 09:00,49.82,35875,973,70,5,555,3,1606,4.261.309.524
05/06/2021 10:00,47.69,35765,1053,74,7,586,3,1723,4.261.309.524
05/06/2021 11:00,47.61,35433,984,74,10,598,4,1670,4.261.309.524
05/06/2021 12:00,45.31,34998,915,68,14,632,5,1634,4.261.309.524
05/06/2021 13:00,42.88,34674,873,61,21,652,5,1612,4.261.309.524
05/06/2021 14:00,44.87,34498,839,55,30,671,6,1601,4.261.309.524
05/06/2021 15:00,45.33,34727,784,50,41,674,6,1555,4.261.309.524
05/06/2021 16:00,49.27,35370,795,44,51,628,6,1524,4.261.309.524
05/06/2021 17:00,50.72,35688,760,36,48,604,5,1453,4.261.309.524
05/06/2021 18:00,50.46,35376,790,30,44,619,4,1487,4.261.309.524
05/06/2021 19:00,49.82,34751,740,29,48,680,4,1501,4.261.309.524
05/06/2021 20:00,49.28,34472,717,32,58,801,4,1612,4.261.309.524
05/06/2021 21:00,49.08,34092,748,34,69,967,5,1823,4.261.309.524
05/06/2021 22:00,47.67,33152,689,34,71,1108,5,1907,4.261.309.524
05/06/2021 23:00,46.71,31815,619,21,53,1182,6,1881,4.261.309.524
06/06/2021 00:00,45.59,30848,546,25,53,1182,4,1810,4.261.309.524
06/06/2021 01:00,44.53,30281,455,25,46,1148,4,1678,4.261.309.524
06/06/2021 02:00,42.83,29885,391,24,41,1084,4,1544,4.261.309.524
06/06/2021 03:00,40.52,29533,362,21,36,1022,3,1444,4.261.309.524
06/06/2021 04:00,39.23,29656,362,16,28,868,4,1278,4.261.309.524
06/06/2021 05:00,39.7,30171,394,12,19,647,4,1076,4.261.309.524
06/06/2021 06:00,39.75,31254,391,12,11,484,2,900,4.261.309.524
06/06/2021 07:00,42.76,32718,347,15,11,448,2,823,4.261.309.524
06/06/2021 08:00,45.67,34039,275,18,17,490,2,802,4.261.309.524
06/06/2021 09:00,46.08,34665,245,22,23,550,2,842,4.261.309.524
06/06/2021 10:00,46.37,34787,270,27,26,619,2,944,4.261.309.524
06/06/2021 11:00,45.86,34683,309,32,32,673,3,1049,4.261.309.524
06/06/2021 12:00,44.15,34403,315,33,40,722,3,1113,4.261.309.524
06/06/2021 13:00,42.04,34305,329,33,48,753,4,1167,4.261.309.524
06/06/2021 14:00,41.5,34440,390,31,59,768,3,1251,4.261.309.524
06/06/2021 15:00,42.74,34892,452,28,67,770,3,1320,4.261.309.524
06/06/2021 16:00,45.76,35462,522,24,65,779,2,1392,4.261.309.524
06/06/2021 17:00,48.44,35946,569,18,58,741,2,1388,4.261.309.524
06/06/2021 18:00,48.9,36081,582,15,52,749,2,1400,4.261.309.524
06/06/2021 19:00,48.1,35783,576,14,49,861,2,1502,4.261.309.524
06/06/2021 20:00,47.78,35589,574,13,46,1031,2,1666,4.261.309.524
06/06/2021 21:00,47.71,35061,600,11,43,1172,3,1829,4.261.309.524
06/06/2021 22:00,46.44,33815,616,9,39,1187,3,1854,4.261.309.524
06/06/2021 23:00,46.47,31737,429,34,36,1090,6,1595,4.261.309.524
07/06/2021 00:00,46.7,30995,380,32,30,1001,4,1447,4.674.166.667
07/06/2021 01:00,46.44,30737,340,28,26,912,5,1311,4.674.166.667
07/06/2021 02:00,46.48,30596,314,24,24,827,5,1194,4.674.166.667
07/06/2021 03:00,46.53,30716,279,20,23,795,5,1122,4.674.166.667
07/06/2021 04:00,47.48,32307,261,15,21,732,5,1034,4.674.166.667
07/06/2021 05:00,52.45,35436,261,9,15,637,5,927,4.674.166.667
07/06/2021 06:00,57,38489,287,5,9,599,3,903,4.674.166.667
07/06/2021 07:00,57.46,39949,296,4,7,618,3,928,4.674.166.667
07/06/2021 08:00,57.47,40259,292,4,9,686,3,994,4.674.166.667
07/06/2021 09:00,57.44,40340,323,7,12,741,3,1086,4.674.166.667
07/06/2021 10:00,57.46,40204,373,12,15,787,3,1190,4.674.166.667
07/06/2021 11:00,57.42,39938,355,17,17,821,4,1214,4.674.166.667
07/06/2021 12:00,57.15,39675,359,23,22,851,4,1259,4.674.166.667
07/06/2021 13:00,57.39,39330,399,25,30,873,4,1331,4.674.166.667
07/06/2021 14:00,56.54,39115,498,25,43,916,4,1486,4.674.166.667
07/06/2021 15:00,55.52,38999,575,24,58,938,4,1599,4.674.166.667
07/06/2021 16:00,55.96,39036,651,22,70,896,4,1643,4.674.166.667
07/06/2021 17:00,56.05,38942,719,21,78,805,4,1627,4.674.166.667
07/06/2021 18:00,56.37,38488,799,21,80,749,3,1652,4.674.166.667
07/06/2021 19:00,51.63,37648,787,22,80,709,3,1601,4.674.166.667
07/06/2021 20:00,50.14,37117,775,21,90,721,2,1609,4.674.166.667
07/06/2021 21:00,49.31,36328,752,21,97,783,3,1656,4.674.166.667
07/06/2021 22:00,47.64,34568,686,20,86,801,4,1597,4.674.166.667
07/06/2021 23:00,48.43,33218,585,29,50,824,4,1492,4.674.166.667
08/06/2021 00:00,48.37,32176,591,28,43,793,4,1459,4.674.166.667
08/06/2021 01:00,48.12,31749,583,27,35,775,2,1422,4.674.166.667
08/06/2021 02:00,47.98,31481,575,27,29,762,2,1395,4.674.166.667
08/06/2021 03:00,48.22,31526,594,26,26,722,2,1370,4.674.166.667
08/06/2021 04:00,48.78,33121,570,21,23,618,2,1234,4.674.166.667
08/06/2021 05:00,52.58,36461,561,14,16,498,2,1091,4.674.166.667
08/06/2021 06:00,56.25,39763,551,9,9,448,3,1020,4.674.166.667
08/06/2021 07:00,57.95,41070,557,9,8,475,3,1052,4.674.166.667
08/06/2021 08:00,57.83,41099,554,10,11,554,2,1131,4.674.166.667
08/06/2021 09:00,57.63,41387,584,14,15,625,4,1242,4.674.166.667
08/06/2021 10:00,57.49,41329,618,19,22,689,5,1353,4.674.166.667
08/06/2021 11:00,57.25,40931,701,23,31,749,4,1508,4.674.166.667
08/06/2021 12:00,56.99,40862,815,26,41,823,6,1711,4.674.166.667
08/06/2021 13:00,56.67,40500,866,28,49,868,6,1817,4.674.166.667
08/06/2021 14:00,55.71,40131,909,31,56,914,7,1917,4.674.166.667
08/06/2021 15:00,55.57,40047,887,31,65,950,8,1941,4.674.166.667
08/06/2021 16:00,55.99,40166,912,26,63,926,4,1931,4.674.166.667
08/06/2021 17:00,56.25,39869,855,22,57,869,3,1806,4.674.166.667
08/06/2021 18:00,56.84,39438,765,21,50,820,2,1658,4.674.166.667
08/06/2021 19:00,54.33,38730,609,21,39,818,2,1489,4.674.166.667
08/06/2021 20:00,53.28,38204,568,19,34,912,2,1535,4.674.166.667
08/06/2021 21:00,51.91,37342,571,17,32,1062,2,1684,4.674.166.667
08/06/2021 22:00,50.29,35334,618,14,31,1147,2,1812,4.674.166.667
08/06/2021 23:00,52.05,33051,813,19,28,898,2,1760,4.674.166.667
09/06/2021 00:00,51.93,32491,841,16,26,904,2,1789,4.674.166.667
09/06/2021 01:00,51.88,31938,823,14,24,883,2,1746,4.674.166.667
09/06/2021 02:00,51.61,31459,757,13,25,847,2,1644,4.674.166.667
09/06/2021 03:00,51.67,31396,753,11,26,811,2,1603,4.674.166.667
09/06/2021 04:00,51.54,32817,723,8,25,730,3,1489,4.674.166.667
09/06/2021 05:00,55.8,36089,653,5,17,608,3,1286,4.674.166.667
09/06/2021 06:00,57.02,39106,562,4,10,541,2,1119,4.674.166.667
09/06/2021 07:00,58.92,40286,522,4,9,564,2,1101,4.674.166.667
09/06/2021 08:00,58.91,40351,501,4,11,653,2,1171,4.674.166.667
09/06/2021 09:00,58.46,40493,495,7,14,759,2,1277,4.674.166.667
09/06/2021 10:00,58.29,40512,502,11,20,867,3,1403,4.674.166.667
09/06/2021 11:00,57.3,40302,532,16,27,980,3,1558,4.674.166.667
09/06/2021 12:00,57.14,40081,585,21,35,1112,3,1756,4.674.166.667
09/06/2021 13:00,57.13,39757,612,22,48,1215,5,1902,4.674.166.667
09/06/2021 14:00,55.94,39568,664,22,61,1298,6,2051,4.674.166.667
09/06/2021 15:00,55.79,39451,679,21,68,1365,6,2139,4.674.166.667
09/06/2021 16:00,55.78,39559,715,21,72,1361,6,2175,4.674.166.667
09/06/2021 17:00,56.04,39190,662,23,66,1300,4,2055,4.674.166.667
09/06/2021 18:00,56.49,38792,578,24,58,1231,3,1894,4.674.166.667
09/06/2021 19:00,55,38015,478,27,52,1253,3,1813,4.674.166.667
09/06/2021 20:00,53.32,37518,449,32,51,1429,2,1963,4.674.166.667
09/06/2021 21:00,51.88,36688,460,32,54,1641,3,2190,4.674.166.667
09/06/2021 22:00,49.63,34798,511,30,51,1796,3,2391,4.674.166.667
09/06/2021 23:00,50.96,32677,490,18,29,1673,3,2213,4.674.166.667
10/06/2021 00:00,51.08,32021,516,18,25,1676,3,2238,4.674.166.667
10/06/2021 01:00,50.77,31467,514,16,20,1651,3,2204,4.674.166.667
10/06/2021 02:00,50.47,30897,498,12,17,1557,3,2087,4.674.166.667
10/06/2021 03:00,50.92,31054,462,10,14,1426,3,1915,4.674.166.667
10/06/2021 04:00,50.37,32536,413,7,10,1209,3,1642,4.674.166.667
10/06/2021 05:00,54.89,35641,375,3,7,911,3,1299,4.674.166.667
10/06/2021 06:00,56.62,38888,316,2,4,734,3,1059,4.674.166.667
10/06/2021 07:00,57.74,40278,276,3,4,789,3,1075,4.674.166.667
10/06/2021 08:00,58,40448,249,3,4,967,3,1226,4.674.166.667
10/06/2021 09:00,57.53,40603,254,5,6,1145,3,1413,4.674.166.667
10/06/2021 10:00,57.23,40620,288,7,9,1300,3,1607,4.674.166.667
10/06/2021 11:00,57.92,40453,364,8,13,1425,3,1813,4.674.166.667
10/06/2021 12:00,57.22,40196,442,10,19,1555,3,2029,4.674.166.667
10/06/2021 13:00,56.58,39933,465,12,27,1649,4,2157,4.674.166.667
10/06/2021 14:00,55.53,39543,524,14,35,1724,4,2301,4.674.166.667
10/06/2021 15:00,55.19,39314,557,15,42,1764,4,2382,4.674.166.667
10/06/2021 16:00,55.52,39369,593,14,46,1744,4,2401,4.674.166.667
10/06/2021 17:00,55.94,38859,488,14,43,1661,4,2210,4.674.166.667
10/06/2021 18:00,56.22,38289,396,15,39,1605,3,2058,4.674.166.667
10/06/2021 19:00,54.37,37533,311,14,34,1724,3,2086,4.674.166.667
10/06/2021 20:00,52.7,37104,290,15,29,2082,3,2419,4.674.166.667
10/06/2021 21:00,51.65,36393,323,15,26,2514,3,2881,4.674.166.667
10/06/2021 22:00,50.15,34731,349,16,22,2741,3,3131,4.674.166.667
10/06/2021 23:00,48.34,33110,442,14,14,2924,2,3396,4.674.166.667
11/06/2021 00:00,45.99,32373,489,12,9,2920,2,3432,4.674.166.667
11/06/2021 01:00,45.56,31841,517,10,8,2819,2,3356,4.674.166.667
11/06/2021 02:00,45.21,31335,572,9,6,2661,2,3250,4.674.166.667
11/06/2021 03:00,45.11,31327,593,8,4,2453,2,3060,4.674.166.667
11/06/2021 04:00,45.79,32875,581,6,5,2184,2,2778,4.674.166.667
11/06/2021 05:00,50.78,36127,622,3,4,1917,2,2548,4.674.166.667
11/06/2021 06:00,54.74,39056,720,2,2,1876,2,2602,4.674.166.667
11/06/2021 07:00,56.09,40510,786,2,1,2233,2,3024,4.674.166.667
11/06/2021 08:00,55,40668,830,2,1,2928,2,3763,4.674.166.667
11/06/2021 09:00,52.44,40818,928,3,2,3639,3,4575,4.674.166.667
11/06/2021 10:00,51.39,40716,1039,5,2,4207,2,5255,4.674.166.667
11/06/2021 11:00,50.54,40369,1120,7,3,4628,3,5761,4.674.166.667
11/06/2021 12:00,49.2,39811,1275,9,6,4920,3,6213,4.674.166.667
11/06/2021 13:00,48.9,39203,1323,10,12,5123,4,6472,4.674.166.667
11/06/2021 14:00,46.02,38794,1463,11,17,5302,4,6797,4.674.166.667
11/06/2021 15:00,45.43,38676,1568,11,22,5448,4,7053,4.674.166.667
11/06/2021 16:00,45.95,38677,1737,12,27,5476,4,7256,4.674.166.667
11/06/2021 17:00,48.26,38390,1644,12,19,5357,4,7036,4.674.166.667
11/06/2021 18:00,48.72,37697,1529,13,11,5198,3,6754,4.674.166.667
11/06/2021 19:00,44.76,36798,1534,15,9,5193,2,6753,4.674.166.667
11/06/2021 20:00,43.29,36249,1701,15,8,5267,2,6993,4.674.166.667
11/06/2021 21:00,40.98,35519,1873,15,5,5321,2,7216,4.674.166.667
11/06/2021 22:00,34.4,33961,2083,15,4,5377,2,7481,4.674.166.667
11/06/2021 23:00,31.58,32562,2257,10,9,5456,2,7734,4.674.166.667
12/06/2021 00:00,30.76,31437,2470,10,14,5432,2,7928,4.674.166.667
12/06/2021 01:00,28.2,30773,2512,10,18,5366,3,7909,4.674.166.667
12/06/2021 02:00,28.55,30338,2524,10,19,5260,3,7816,4.674.166.667
12/06/2021 03:00,24.91,30120,2573,9,19,5159,3,7763,4.674.166.667
12/06/2021 04:00,28.09,30531,2564,7,20,5078,3,7672,4.674.166.667
12/06/2021 05:00,32.28,31142,2630,6,23,5108,4,7771,4.674.166.667
12/06/2021 06:00,33.53,32585,2674,4,28,5245,4,7955,4.674.166.667
12/06/2021 07:00,34.75,34476,2845,4,43,5319,6,8217,4.674.166.667
12/06/2021 08:00,33.21,35814,2946,5,58,5521,10,8540,4.674.166.667
12/06/2021 09:00,31.97,36531,3024,6,75,5730,12,8847,4.674.166.667
12/06/2021 10:00,25.89,36509,3187,8,95,5742,11,9043,4.674.166.667
12/06/2021 11:00,18.16,36290,3519,11,116,5638,11,9295,4.674.166.667
12/06/2021 12:00,1.97,35916,3937,14,137,5541,11,9640,4.674.166.667
12/06/2021 13:00,0.92,35789,3975,19,142,5462,9,9607,4.674.166.667
12/06/2021 14:00,0.1,35794,4323,22,132,5359,8,9844,4.674.166.667
12/06/2021 15:00,0.91,36069,4522,26,127,5253,11,9939,4.674.166.667
12/06/2021 16:00,4.68,36650,5104,27,133,5074,11,10349,4.674.166.667
12/06/2021 17:00,22.9,36774,5162,26,130,4845,10,10173,4.674.166.667
12/06/2021 18:00,32.43,36350,5187,23,117,4619,9,9955,4.674.166.667
12/06/2021 19:00,32.69,35622,4916,22,102,4503,9,9552,4.674.166.667
12/06/2021 20:00,33.44,35174,4782,22,94,4548,16,9462,4.674.166.667
12/06/2021 21:00,32.79,34659,4737,22,95,4757,17,9628,4.674.166.667
12/06/2021 22:00,28.99,33694,4715,22,100,5046,15,9898,4.674.166.667
12/06/2021 23:00,21.79,32268,5014,25,158,5342,25,10564,4.674.166.667
13/06/2021 00:00,13.99,31518,4994,23,167,5523,28,10735,4.674.166.667
13/06/2021 01:00,6.46,30906,4807,23,177,5579,32,10618,4.674.166.667
13/06/2021 02:00,4.86,30324,4615,23,194,5452,44,10328,4.674.166.667
13/06/2021 03:00,4.37,29829,4459,22,210,5228,49,9968,4.674.166.667
13/06/2021 04:00,2.91,30077,4108,18,207,5048,43,9424,4.674.166.667
13/06/2021 05:00,3.84,30686,3981,11,210,5002,42,9246,4.674.166.667
13/06/2021 06:00,6.86,31882,3903,7,241,5026,41,9218,4.674.166.667
13/06/2021 07:00,3.96,33441,3854,6,265,4956,41,9122,4.674.166.667
13/06/2021 08:00,3.88,34890,3565,8,284,4950,41,8848,4.674.166.667
13/06/2021 09:00,1.46,35655,3363,11,306,5019,47,8746,4.674.166.667
13/06/2021 10:00,1.42,35918,3208,15,329,5103,45,8700,4.674.166.667
13/06/2021 11:00,0.54,35893,3044,19,343,5182,43,8631,4.674.166.667
13/06/2021 12:00,0.09,35746,2804,23,359,5258,45,8489,4.674.166.667
13/06/2021 13:00,0.07,35669,2501,26,369,5247,43,8186,4.674.166.667
13/06/2021 14:00,0.84,35604,2696,28,359,5159,50,8292,4.674.166.667
13/06/2021 15:00,1.63,35855,2693,32,353,4952,48,8078,4.674.166.667
13/06/2021 16:00,21.75,36337,2612,35,333,4648,36,7664,4.674.166.667
13/06/2021 17:00,36.97,36661,2252,37,301,4199,28,6817,4.674.166.667
13/06/2021 18:00,44.41,36758,1863,33,254,3641,17,5808,4.674.166.667
13/06/2021 19:00,46.35,36422,1461,31,210,3097,6,4805,4.674.166.667
13/06/2021 20:00,47.18,36203,1288,29,179,2783,4,4283,4.674.166.667
13/06/2021 21:00,46.66,35639,1303,30,159,2700,4,4196,4.674.166.667
13/06/2021 22:00,44.57,34286,1306,30,146,2691,3,4176,4.674.166.667
13/06/2021 23:00,36.98,33047,1504,14,159,3118,3,4798,4.674.166.667
14/06/2021 00:00,35.44,32323,1444,14,149,3317,3,4927,497.702.381
14/06/2021 01:00,34,31798,1365,13,136,3309,3,4826,497.702.381
14/06/2021 02:00,34.08,31414,1283,12,123,3173,3,4594,497.702.381
14/06/2021 03:00,35.66,31602,1222,10,109,2981,3,4325,497.702.381
14/06/2021 04:00,36.67,33127,1212,8,86,2853,2,4161,497.702.381
14/06/2021 05:00,39.97,36322,1290,5,53,2782,2,4132,497.702.381
14/06/2021 06:00,46.73,39536,1460,2,27,2778,2,4269,497.702.381
14/06/2021 07:00,48,41057,1797,2,21,2856,2,4678,497.702.381
14/06/2021 08:00,48.1,41557,2168,2,18,3045,3,5236,497.702.381
14/06/2021 09:00,47.52,41914,2594,4,15,3270,3,5886,497.702.381
14/06/2021 10:00,46.99,41895,2992,5,14,3556,4,6571,497.702.381
14/06/2021 11:00,46.69,41606,3444,6,18,3813,4,7285,497.702.381
14/06/2021 12:00,45.17,41406,3740,8,23,4028,5,7804,497.702.381
14/06/2021 13:00,41.58,41069,3655,10,28,4238,6,7937,497.702.381
14/06/2021 14:00,43.06,40783,3326,12,34,4463,7,7842,497.702.381
14/06/2021 15:00,41.6,40691,2904,10,42,4695,8,7659,497.702.381
14/06/2021 16:00,41.15,40756,2764,8,50,4895,9,7726,497.702.381
14/06/2021 17:00,39.21,40534,2555,7,52,5077,9,7700,497.702.381
14/06/2021 18:00,36.62,39922,2430,7,50,5370,10,7867,497.702.381
14/06/2021 19:00,36.57,38868,2216,9,46,5688,9,7968,497.702.381
14/06/2021 20:00,34.11,38330,2071,14,56,5962,8,8111,497.702.381
14/06/2021 21:00,30.91,37535,1910,18,75,6117,10,8130,497.702.381
14/06/2021 22:00,29.26,35601,1749,23,98,6151,10,8031,497.702.381
14/06/2021 23:00,28.02,34014,1894,63,87,6212,13,8269,497.702.381
15/06/2021 00:00,27.06,33006,1782,49,114,6306,15,8266,497.702.381
15/06/2021 01:00,23.81,32521,1671,46,137,6205,17,8076,497.702.381
15/06/2021 02:00,23.01,31884,1553,44,159,6116,20,7892,497.702.381
15/06/2021 03:00,23.19,32002,1568,36,171,6049,17,7841,497.702.381
15/06/2021 04:00,25.22,33572,1521,27,161,5927,14,7650,497.702.381
15/06/2021 05:00,29.95,36832,1478,17,132,5890,9,7526,497.702.381
15/06/2021 06:00,36.95,40021,1535,12,103,5924,6,7580,497.702.381
15/06/2021 07:00,41.41,41325,1654,11,96,5914,5,7680,497.702.381
15/06/2021 08:00,41.4,41568,1568,12,96,6018,6,7700,497.702.381
15/06/2021 09:00,40.99,41994,1559,16,97,6151,6,7829,497.702.381
15/06/2021 10:00,40.25,42094,1558,25,101,6184,6,7874,497.702.381
15/06/2021 11:00,40.83,41649,1646,38,109,6118,7,7918,497.702.381
15/06/2021 12:00,40.8,41581,1681,50,116,6071,6,7924,497.702.381
15/06/2021 13:00,40.64,41232,1617,57,119,6034,6,7833,497.702.381
15/06/2021 14:00,37.96,40984,1607,62,122,5967,6,7764,497.702.381
15/06/2021 15:00,38.15,40883,1529,70,123,5858,6,7586,497.702.381
15/06/2021 16:00,41.55,41187,1487,81,118,5726,5,7417,497.702.381
15/06/2021 17:00,41.87,40822,1316,89,104,5373,4,6886,497.702.381
15/06/2021 18:00,43.06,40349,1100,101,84,4931,4,6220,497.702.381
15/06/2021 19:00,41.71,39668,884,123,64,4612,4,5687,497.702.381
15/06/2021 20:00,41.57,39060,697,144,56,4456,4,5357,497.702.381
15/06/2021 21:00,41.66,38157,577,163,51,4364,4,5159,497.702.381
15/06/2021 22:00,39.77,36170,478,175,44,4199,4,4900,497.702.381
15/06/2021 23:00,40.66,34347,391,212,46,3578,4,4231,497.702.381
16/06/2021 00:00,41.29,33751,319,217,37,3305,5,3883,497.702.381
16/06/2021 01:00,41.19,33303,240,212,27,2997,5,3481,497.702.381
16/06/2021 02:00,41.18,32897,209,205,21,2641,5,3081,497.702.381
16/06/2021 03:00,41.67,33070,199,194,16,2282,5,2696,497.702.381
16/06/2021 04:00,41.23,34598,189,185,12,1960,5,2351,497.702.381
16/06/2021 05:00,43.37,37628,201,179,8,1722,4,2114,497.702.381
16/06/2021 06:00,47.86,40683,225,173,5,1618,3,2024,497.702.381
16/06/2021 07:00,49.28,41803,260,157,5,1616,3,2041,497.702.381
16/06/2021 08:00,49.26,41940,304,136,6,1740,3,2189,497.702.381
16/06/2021 09:00,47.43,42129,371,120,7,1898,3,2399,497.702.381
16/06/2021 10:00,46.96,42126,403,108,11,2032,4,2558,497.702.381
16/06/2021 11:00,47.13,41969,437,99,16,2106,5,2663,497.702.381
16/06/2021 12:00,46.94,41769,468,94,19,2190,5,2776,497.702.381
16/06/2021 13:00,46.69,41450,468,93,21,2208,5,2795,497.702.381
16/06/2021 14:00,44.95,41153,459,91,20,2176,5,2751,497.702.381
16/06/2021 15:00,44.15,40833,518,90,19,2095,4,2726,497.702.381
16/06/2021 16:00,45.98,40839,617,86,20,1945,3,2671,497.702.381
16/06/2021 17:00,46.09,40421,681,81,21,1771,3,2557,497.702.381
16/06/2021 18:00,46.51,40026,807,76,24,1654,3,2564,497.702.381
16/06/2021 19:00,45.99,39325,941,70,24,1572,3,2610,497.702.381
16/06/2021 20:00,43.43,38767,1218,65,23,1664,3,2973,497.702.381
16/06/2021 21:00,41.31,37983,1663,62,19,1889,3,3636,497.702.381
16/06/2021 22:00,36.3,36096,1948,58,15,2134,3,4158,497.702.381
16/06/2021 23:00,34.53,34255,2175,56,7,2344,4,4586,497.702.381
17/06/2021 00:00,34.59,33746,2291,49,8,2455,5,4808,497.702.381
17/06/2021 01:00,33.39,33177,2317,43,8,2438,5,4811,497.702.381
17/06/2021 02:00,33.57,32776,2201,39,9,2368,5,4622,497.702.381
17/06/2021 03:00,35.4,32722,2108,33,12,2306,4,4463,497.702.381
17/06/2021 04:00,36.35,33896,2009,24,14,2131,4,4182,497.702.381
17/06/2021 05:00,40.16,36995,1963,14,12,1804,4,3797,497.702.381
17/06/2021 06:00,45.33,39944,1886,7,7,1543,4,3447,497.702.381
17/06/2021 07:00,48.59,41307,1890,6,5,1558,4,3463,497.702.381
17/06/2021 08:00,48.82,41423,1759,6,5,1760,4,3534,497.702.381
17/06/2021 09:00,47.62,41616,1725,10,7,1985,4,3731,497.702.381
17/06/2021 10:00,47.58,41673,1797,14,9,2190,4,4014,497.702.381
17/06/2021 11:00,46.67,41445,1967,21,11,2380,4,4383,497.702.381
17/06/2021 12:00,44.93,41214,2233,27,13,2558,5,4836,497.702.381
17/06/2021 13:00,42.53,40911,2421,30,13,2719,5,5188,497.702.381
17/06/2021 14:00,41.6,40632,2585,27,13,2875,5,5505,497.702.381
17/06/2021 15:00,41.05,40366,2743,23,12,2972,4,5754,497.702.381
17/06/2021 16:00,40.14,40265,2745,20,10,2933,4,5712,497.702.381
17/06/2021 17:00,41.55,39768,2342,15,9,2791,4,5161,497.702.381
17/06/2021 18:00,41.4,39293,2070,11,11,2712,4,4808,497.702.381
17/06/2021 19:00,39.65,38435,1927,10,14,2934,4,4889,497.702.381
17/06/2021 20:00,39.22,37942,1876,12,25,3414,4,5331,497.702.381
17/06/2021 21:00,36.49,37241,1841,13,41,3857,5,5757,497.702.381
17/06/2021 22:00,29.82,35776,1784,14,58,4036,5,5897,497.702.381
17/06/2021 23:00,37.11,33965,2111,18,106,3921,5,6161,497.702.381
18/06/2021 00:00,36.62,33322,1960,20,123,4029,17,6149,497.702.381
18/06/2021 01:00,34.74,32609,1792,21,117,4032,27,5989,497.702.381
18/06/2021 02:00,31.85,32107,1474,24,107,3942,28,5575,497.702.381
18/06/2021 03:00,29.92,32201,1062,23,97,3813,24,5019,497.702.381
18/06/2021 04:00,34.02,33523,801,18,83,3580,22,4504,497.702.381
18/06/2021 05:00,39.17,36223,677,10,60,3216,21,3984,497.702.381
18/06/2021 06:00,42.36,39285,559,5,35,2846,12,3457,497.702.381
18/06/2021 07:00,44.28,40703,522,5,25,2673,4,3229,497.702.381
18/06/2021 08:00,44.59,40900,487,7,24,2715,4,3237,497.702.381
18/06/2021 09:00,43.84,41043,550,9,30,2819,5,3413,497.702.381
18/06/2021 10:00,42.86,40994,604,12,38,3020,7,3681,497.702.381
18/06/2021 11:00,42.44,40577,636,12,44,3265,7,3964,497.702.381
18/06/2021 12:00,41.43,40071,676,13,47,3540,7,4283,497.702.381
18/06/2021 13:00,39.27,39451,747,13,47,3882,9,4698,497.702.381
18/06/2021 14:00,34.28,38983,872,13,44,4217,6,5152,497.702.381
18/06/2021 15:00,29.95,38756,1063,12,40,4311,6,5432,497.702.381
18/06/2021 16:00,35.02,38749,1182,11,38,4172,6,5409,497.702.381
18/06/2021 17:00,36.54,38423,1218,9,37,3947,4,5215,497.702.381
18/06/2021 18:00,38.68,37792,1247,10,41,3621,3,4922,497.702.381
18/06/2021 19:00,35.15,36975,1286,15,52,3275,3,4631,497.702.381
18/06/2021 20:00,34.71,36273,1315,22,75,3131,3,4546,497.702.381
18/06/2021 21:00,32.88,35517,1258,30,105,3074,4,4471,497.702.381
18/06/2021 22:00,29.92,34558,1216,37,134,2990,10,4387,497.702.381
18/06/2021 23:00,29.42,33031,1088,35,172,2711,10,4016,497.702.381
19/06/2021 00:00,28.8,31996,1075,40,186,2650,14,3965,497.702.381
19/06/2021 01:00,27.95,31465,1142,42,186,2514,22,3906,497.702.381
19/06/2021 02:00,27.89,31040,1083,44,177,2367,23,3694,497.702.381
19/06/2021 03:00,27.83,30755,993,46,162,2237,22,3460,497.702.381
19/06/2021 04:00,28.77,30920,842,43,136,2051,18,3090,497.702.381
19/06/2021 05:00,32.39,31550,772,37,95,1812,14,2730,497.702.381
19/06/2021 06:00,35.81,32877,786,37,53,1627,9,2512,497.702.381
19/06/2021 07:00,38.7,34528,848,44,39,1523,3,2457,497.702.381
19/06/2021 08:00,40.67,35890,913,53,38,1555,2,2561,497.702.381
19/06/2021 09:00,43.32,36629,1143,62,42,1640,3,2890,497.702.381
19/06/2021 10:00,41.72,36616,1390,72,49,1742,3,3256,497.702.381
19/06/2021 11:00,39.41,36292,1716,81,53,1844,5,3699,497.702.381
19/06/2021 12:00,36.96,35981,1961,92,55,1923,5,4036,497.702.381
19/06/2021 13:00,38.81,35696,1958,84,53,1918,6,4019,497.702.381
19/06/2021 14:00,40.39,35568,1868,68,51,1892,7,3886,497.702.381
19/06/2021 15:00,40.06,35857,1750,57,48,1890,6,3751,497.702.381
19/06/2021 16:00,40.47,36433,1591,38,44,1830,5,3508,497.702.381
19/06/2021 17:00,41.03,36485,1196,27,41,1802,4,3070,497.702.381
19/06/2021 18:00,40.97,36106,949,21,40,1808,3,2821,497.702.381
19/06/2021 19:00,40.09,35373,833,21,48,1793,3,2698,497.702.381
19/06/2021 20:00,38.92,34863,771,23,67,1783,2,2646,497.702.381
19/06/2021 21:00,38.66,34332,635,25,91,1731,2,2484,497.702.381
19/06/2021 22:00,36.58,33676,547,24,120,1606,4,2301,497.702.381
19/06/2021 23:00,36.02,32484,283,24,148,1244,14,1713,497.702.381
20/06/2021 00:00,34.14,31573,265,23,168,1148,13,1617,497.702.381
20/06/2021 01:00,32.28,31445,250,23,172,1030,18,1493,497.702.381
20/06/2021 02:00,31.21,31214,247,29,171,886,18,1351,497.702.381
20/06/2021 03:00,27.83,29914,297,39,164,759,15,1274,497.702.381
20/06/2021 04:00,26.77,29918,421,56,139,637,17,1270,497.702.381
20/06/2021 05:00,25.23,30402,676,81,97,548,13,1415,497.702.381
20/06/2021 06:00,28.29,31379,955,103,57,537,6,1658,497.702.381
20/06/2021 07:00,37.22,32878,1098,117,48,582,3,1848,497.702.381
20/06/2021 08:00,38.91,34287,1178,128,52,641,4,2003,497.702.381
20/06/2021 09:00,35.92,35069,1396,135,66,723,4,2324,497.702.381
20/06/2021 10:00,33.75,35398,1437,137,80,806,8,2468,497.702.381
20/06/2021 11:00,32.64,35472,1441,143,86,883,8,2561,497.702.381
20/06/2021 12:00,26.32,35233,1599,164,84,982,9,2838,497.702.381
20/06/2021 13:00,24.19,35078,1581,188,81,1071,7,2928,497.702.381
20/06/2021 14:00,27.6,35149,1583,200,79,1156,8,3026,497.702.381
20/06/2021 15:00,35.85,35453,1746,199,88,1221,5,3259,497.702.381
20/06/2021 16:00,41.07,35992,1865,191,104,1291,4,3455,497.702.381
20/06/2021 17:00,41.69,36235,1865,175,108,1380,3,3531,497.702.381
20/06/2021 18:00,41.44,36254,1974,159,106,1544,2,3785,497.702.381
20/06/2021 19:00,40.92,35890,1916,146,110,1778,2,3952,497.702.381
20/06/2021 20:00,38.95,35734,1833,134,135,2058,3,4163,497.702.381
20/06/2021 21:00,36.36,35235,1628,121,157,2354,3,4263,497.702.381
20/06/2021 22:00,32.83,34223,1370,106,167,2529,5,4177,497.702.381
20/06/2021 23:00,27.23,32639,1585,49,195,3290,9,5128,497.702.381
21/06/2021 00:00,26.03,31879,1363,56,190,3423,17,5049,5.148.214.286
21/06/2021 01:00,24.94,31432,1153,64,180,3498,16,4911,5.148.214.286
21/06/2021 02:00,24.02,31067,1057,69,166,3490,16,4798,5.148.214.286
21/06/2021 03:00,23.62,31013,1049,70,149,3469,17,4754,5.148.214.286
21/06/2021 04:00,25.66,32393,1000,65,127,3321,15,4528,5.148.214.286
21/06/2021 05:00,31.7,35567,1024,51,93,3083,8,4259,5.148.214.286
21/06/2021 06:00,40.43,38830,1111,39,60,2831,5,4046,5.148.214.286
21/06/2021 07:00,41.93,40468,1203,35,58,2686,3,3985,5.148.214.286
21/06/2021 08:00,41.95,40984,1288,38,69,2647,3,4045,5.148.214.286
21/06/2021 09:00,41.91,41277,1380,43,92,2583,4,4102,5.148.214.286
21/06/2021 10:00,41.71,41269,1491,48,128,2456,4,4127,5.148.214.286
21/06/2021 11:00,41.57,41070,1545,54,151,2367,4,4121,5.148.214.286
21/06/2021 12:00,41.03,40885,1453,58,153,2333,3,4000,5.148.214.286
21/06/2021 13:00,41.28,40548,1406,62,146,2273,3,3890,5.148.214.286
21/06/2021 14:00,40.43,40242,1365,63,142,2196,3,3769,5.148.214.286
21/06/2021 15:00,41.15,40070,1397,62,147,2060,3,3669,5.148.214.286
21/06/2021 16:00,42.83,40045,1399,57,158,1868,4,3486,5.148.214.286
21/06/2021 17:00,43.13,39670,1334,51,165,1659,4,3213,5.148.214.286
21/06/2021 18:00,41.94,39024,1226,47,167,1470,4,2914,5.148.214.286
21/06/2021 19:00,40.3,38128,1178,50,165,1437,4,2834,5.148.214.286
21/06/2021 20:00,39.32,37622,1243,53,172,1562,6,3036,5.148.214.286
21/06/2021 21:00,36.93,36728,1216,56,177,1749,12,3210,5.148.214.286
21/06/2021 22:00,30.92,35292,1189,60,168,1889,16,3322,5.148.214.286
21/06/2021 23:00,36.21,34288,1867,56,193,1310,19,3445,5.148.214.286
22/06/2021 00:00,34.98,33405,1835,74,177,1411,18,3515,5.148.214.286
22/06/2021 01:00,33.8,32682,1770,84,160,1508,17,3539,5.148.214.286
22/06/2021 02:00,30.67,32175,1759,86,145,1618,16,3624,5.148.214.286
22/06/2021 03:00,29.28,32124,1722,83,128,1728,14,3675,5.148.214.286
22/06/2021 04:00,33.92,33655,1633,76,104,1824,13,3650,5.148.214.286
22/06/2021 05:00,40.83,36936,1598,63,71,1931,9,3672,5.148.214.286
22/06/2021 06:00,43.98,39995,1655,56,44,2130,6,3891,5.148.214.286
22/06/2021 07:00,45.28,41317,1637,58,38,2319,5,4057,5.148.214.286
22/06/2021 08:00,46.33,41743,1503,62,40,2501,4,4110,5.148.214.286
22/06/2021 09:00,46.03,42457,1491,65,49,2594,4,4203,5.148.214.286
22/06/2021 10:00,46.32,42292,1498,69,62,2614,5,4248,5.148.214.286
22/06/2021 11:00,46.91,41888,1482,74,75,2562,5,4198,5.148.214.286
22/06/2021 12:00,45.94,41821,1436,75,84,2538,4,4137,5.148.214.286
22/06/2021 13:00,46.02,41532,1342,71,81,2474,6,3974,5.148.214.286
22/06/2021 14:00,45,41077,1233,62,76,2381,5,3757,5.148.214.286
22/06/2021 15:00,44.82,40703,1252,54,77,2250,4,3637,5.148.214.286
22/06/2021 16:00,45.5,40828,1252,45,72,2083,4,3456,5.148.214.286
22/06/2021 17:00,45.08,40017,1149,33,69,1886,3,3140,5.148.214.286
22/06/2021 18:00,45.37,39330,988,25,62,1688,3,2766,5.148.214.286
22/06/2021 19:00,44.91,38760,880,28,62,1638,3,2611,5.148.214.286
22/06/2021 20:00,43.84,38004,874,40,67,1744,3,2728,5.148.214.286
22/06/2021 21:00,41.97,37220,880,52,69,1898,3,2902,5.148.214.286
22/06/2021 22:00,39.19,36078,865,61,66,1983,3,2978,5.148.214.286
22/06/2021 23:00,33.74,34104,846,75,41,1735,3,2700,5.148.214.286
23/06/2021 00:00,32.22,33396,784,79,53,1739,4,2659,5.148.214.286
23/06/2021 01:00,31.79,32655,821,80,58,1733,8,2700,5.148.214.286
23/06/2021 02:00,31.71,32179,820,75,59,1667,7,2628,5.148.214.286
23/06/2021 03:00,31.7,32256,806,67,55,1504,4,2436,5.148.214.286
23/06/2021 04:00,34.98,33345,777,56,47,1229,5,2114,5.148.214.286
23/06/2021 05:00,42.49,36801,670,42,34,927,5,1678,5.148.214.286
23/06/2021 06:00,46.62,39932,578,35,14,751,4,1382,5.148.214.286
23/06/2021 07:00,48.47,41139,569,33,12,671,4,1289,5.148.214.286
23/06/2021 08:00,48.47,41506,516,36,20,661,9,1242,5.148.214.286
23/06/2021 09:00,48.3,41929,546,42,31,654,6,1279,5.148.214.286
23/06/2021 10:00,48.52,42115,532,47,39,646,4,1268,5.148.214.286
23/06/2021 11:00,48.48,41928,563,54,40,642,5,1304,5.148.214.286
23/06/2021 12:00,47.72,41715,602,58,42,655,5,1362,5.148.214.286
23/06/2021 13:00,47.55,41315,621,56,48,657,5,1387,5.148.214.286
23/06/2021 14:00,47.32,40908,654,50,53,641,5,1403,5.148.214.286
23/06/2021 15:00,46.98,40533,678,46,58,596,5,1383,5.148.214.286
23/06/2021 16:00,47.31,40392,690,36,60,532,4,1322,5.148.214.286
23/06/2021 17:00,46.87,39919,669,28,55,461,4,1217,5.148.214.286
23/06/2021 18:00,47.2,39277,653,26,59,413,4,1155,5.148.214.286
23/06/2021 19:00,46.69,38407,599,24,56,404,4,1087,5.148.214.286
23/06/2021 20:00,45.73,37390,646,27,51,439,4,1167,5.148.214.286
23/06/2021 21:00,44.11,36675,697,31,45,505,4,1282,5.148.214.286
23/06/2021 22:00,41.25,35329,748,28,41,555,4,1376,5.148.214.286
23/06/2021 23:00,42.7,33644,477,27,43,620,3,1170,5.148.214.286
24/06/2021 00:00,42.68,32895,498,24,40,665,3,1230,5.148.214.286
24/06/2021 01:00,41.1,32385,509,22,36,673,2,1242,5.148.214.286
24/06/2021 02:00,40.49,32895,468,20,23,654,3,1168,5.148.214.286
24/06/2021 03:00,40.87,31604,435,19,15,600,3,1072,5.148.214.286
24/06/2021 04:00,43.1,32962,371,13,11,486,4,885,5.148.214.286
24/06/2021 05:00,48.88,35975,313,7,8,356,3,687,5.148.214.286
24/06/2021 06:00,53.3,39267,272,3,6,306,3,590,5.148.214.286
24/06/2021 07:00,56.64,41039,273,4,6,353,3,639,5.148.214.286
24/06/2021 08:00,56.85,41112,225,6,8,451,3,693,5.148.214.286
24/06/2021 09:00,56.7,41474,246,9,10,560,4,829,5.148.214.286
24/06/2021 10:00,56.44,41472,288,12,13,677,4,994,5.148.214.286
24/06/2021 11:00,56.2,41402,334,15,16,779,4,1148,5.148.214.286
24/06/2021 12:00,54.73,41074,402,18,19,853,4,1296,5.148.214.286
24/06/2021 13:00,53.07,41014,428,23,23,907,4,1385,5.148.214.286
24/06/2021 14:00,52.66,40562,438,21,26,934,4,1423,5.148.214.286
24/06/2021 15:00,51.22,40172,470,23,30,909,4,1436,5.148.214.286
24/06/2021 16:00,49.8,39890,483,18,35,854,3,1393,5.148.214.286
24/06/2021 17:00,49.67,39456,444,15,35,773,3,1270,5.148.214.286
24/06/2021 18:00,50.16,38873,430,14,34,720,3,1201,5.148.214.286
24/06/2021 19:00,49,38077,405,15,34,718,3,1175,5.148.214.286
24/06/2021 20:00,48.53,37526,404,16,31,810,2,1263,5.148.214.286
24/06/2021 21:00,46.43,36688,438,19,30,946,3,1436,5.148.214.286
24/06/2021 22:00,44.27,35606,460,21,27,1009,3,1520,5.148.214.286
24/06/2021 23:00,41.36,33589,487,22,37,842,5,1393,5.148.214.286
25/06/2021 00:00,39.6,33629,499,17,33,786,4,1339,5.148.214.286
25/06/2021 01:00,38.42,33184,533,15,32,723,7,1310,5.148.214.286
25/06/2021 02:00,37.7,32822,485,13,30,621,5,1154,5.148.214.286
25/06/2021 03:00,38.59,31855,459,9,26,528,4,1026,5.148.214.286
25/06/2021 04:00,40.03,32598,392,7,25,442,4,870,5.148.214.286
25/06/2021 05:00,46.01,35253,316,6,24,361,4,711,5.148.214.286
25/06/2021 06:00,49.03,38122,322,3,23,334,5,687,5.148.214.286
25/06/2021 07:00,50.02,39623,359,3,27,384,4,777,5.148.214.286
25/06/2021 08:00,51.65,40048,329,4,30,474,4,841,5.148.214.286
25/06/2021 09:00,52.13,40348,358,5,38,575,5,981,5.148.214.286
25/06/2021 10:00,51.64,40375,348,6,43,669,7,1073,5.148.214.286
25/06/2021 11:00,50.78,39993,330,7,40,741,7,1125,5.148.214.286
25/06/2021 12:00,49.37,39486,345,8,42,809,8,1212,5.148.214.286
25/06/2021 13:00,48.77,38993,365,7,52,870,9,1303,5.148.214.286
25/06/2021 14:00,47.21,38549,367,7,53,958,10,1395,5.148.214.286
25/06/2021 15:00,46.27,38358,380,7,51,1044,7,1489,5.148.214.286
25/06/2021 16:00,47.87,38360,357,7,52,1052,8,1476,5.148.214.286
25/06/2021 17:00,48.11,38051,298,7,49,1067,8,1429,5.148.214.286
25/06/2021 18:00,47.62,37371,266,8,47,1066,6,1393,5.148.214.286
25/06/2021 19:00,45.36,36486,228,9,43,1113,5,1398,5.148.214.286
25/06/2021 20:00,43.02,35882,219,9,41,1217,4,1490,5.148.214.286
25/06/2021 21:00,40.48,35246,237,10,40,1404,4,1695,5.148.214.286
25/06/2021 22:00,39.01,34075,257,10,37,1579,5,1888,5.148.214.286
25/06/2021 23:00,38.58,32532,180,64,34,1476,4,1758,5.148.214.286
26/06/2021 00:00,37.64,32597,206,63,31,1575,4,1879,5.148.214.286
26/06/2021 01:00,36.32,31972,230,63,27,1629,6,1955,5.148.214.286
26/06/2021 02:00,35.67,31139,232,63,24,1585,6,1910,5.148.214.286
26/06/2021 03:00,35.52,29961,254,66,23,1438,4,1785,5.148.214.286
26/06/2021 04:00,36.66,30043,238,62,23,1148,4,1475,5.148.214.286
26/06/2021 05:00,38.57,30654,207,45,22,787,3,1064,5.148.214.286
26/06/2021 06:00,39.4,32085,194,29,23,593,4,843,5.148.214.286
26/06/2021 07:00,43.61,33890,223,23,27,528,6,807,5.148.214.286
26/06/2021 08:00,46.38,35403,213,24,27,532,4,800,5.148.214.286
26/06/2021 09:00,47.65,36141,257,27,27,547,3,861,5.148.214.286
26/06/2021 10:00,47.6,36199,315,30,29,562,3,939,5.148.214.286
26/06/2021 11:00,47.23,36023,379,34,32,574,4,1023,5.148.214.286
26/06/2021 12:00,47.07,35695,452,37,42,592,4,1127,5.148.214.286
26/06/2021 13:00,46.14,35414,517,36,52,606,4,1215,5.148.214.286
26/06/2021 14:00,46.25,35250,585,35,57,602,5,1284,5.148.214.286
26/06/2021 15:00,46.95,35554,629,34,59,584,5,1311,5.148.214.286
26/06/2021 16:00,47.07,35835,626,33,58,560,5,1282,5.148.214.286
26/06/2021 17:00,47.24,35877,557,33,54,532,4,1180,5.148.214.286
26/06/2021 18:00,47.32,35361,521,35,47,550,4,1157,5.148.214.286
26/06/2021 19:00,46.23,34632,460,39,41,677,3,1220,5.148.214.286
26/06/2021 20:00,43.93,34125,422,45,38,921,3,1429,5.148.214.286
26/06/2021 21:00,40.53,33707,445,51,37,1183,3,1719,5.148.214.286
26/06/2021 22:00,38.18,32945,516,58,37,1360,3,1974,5.148.214.286
26/06/2021 23:00,38.5,31548,600,55,53,1475,4,2187,5.148.214.286
27/06/2021 00:00,37.33,30646,648,56,45,1562,4,2315,5.148.214.286
27/06/2021 01:00,36.25,30005,719,59,36,1565,4,2383,5.148.214.286
27/06/2021 02:00,35.39,29477,765,66,31,1482,4,2348,5.148.214.286
27/06/2021 03:00,34.76,29906,781,71,29,1392,4,2277,5.148.214.286
27/06/2021 04:00,34.69,28984,753,67,26,1252,3,2101,5.148.214.286
27/06/2021 05:00,35.26,29692,745,53,22,1081,4,1905,5.148.214.286
27/06/2021 06:00,34.67,30553,788,42,22,1002,4,1858,5.148.214.286
27/06/2021 07:00,36.12,32186,829,37,25,1027,4,1922,5.148.214.286
27/06/2021 08:00,36.71,33614,781,37,25,1092,4,1939,5.148.214.286
27/06/2021 09:00,35.5,34314,849,41,26,1141,4,2061,5.148.214.286
27/06/2021 10:00,35.89,34734,933,47,28,1182,4,2194,5.148.214.286
27/06/2021 11:00,35.25,34955,994,50,34,1205,5,2288,5.148.214.286
27/06/2021 12:00,31.26,34942,1016,50,44,1251,5,2366,5.148.214.286
27/06/2021 13:00,29.12,34615,1026,49,56,1307,5,2443,5.148.214.286
27/06/2021 14:00,31.41,34801,1048,44,63,1333,4,2492,5.148.214.286
27/06/2021 15:00,34.89,34856,1079,38,65,1342,5,2529,5.148.214.286
27/06/2021 16:00,39.65,35296,1097,30,64,1291,5,2487,5.148.214.286
27/06/2021 17:00,45.98,35635,996,23,57,1217,4,2297,5.148.214.286
27/06/2021 18:00,49.9,35458,934,20,45,1139,4,2142,5.148.214.286
27/06/2021 19:00,48.34,34991,893,23,40,1145,3,2104,5.148.214.286
27/06/2021 20:00,47.21,34852,845,28,44,1249,3,2169,5.148.214.286
27/06/2021 21:00,45.09,34245,846,33,48,1429,4,2360,5.148.214.286
27/06/2021 22:00,40.82,33086,861,39,48,1552,4,2504,5.148.214.286
27/06/2021 23:00,36.41,31627,829,10,66,1638,3,2546,5.148.214.286
28/06/2021 00:00,37.38,30980,810,10,59,1634,3,2516,5.166.071.429
28/06/2021 01:00,36.96,30423,777,12,47,1565,3,2404,5.166.071.429
28/06/2021 02:00,35.96,30079,729,13,38,1450,3,2233,5.166.071.429
28/06/2021 03:00,37.26,30127,682,13,32,1281,3,2011,5.166.071.429
28/06/2021 04:00,41.17,31566,639,12,29,1040,3,1723,5.166.071.429
28/06/2021 05:00,52.66,34637,582,9,23,741,3,1358,5.166.071.429
28/06/2021 06:00,54.05,37734,580,8,19,627,3,1237,5.166.071.429
28/06/2021 07:00,55.78,39372,620,9,27,613,3,1272,5.166.071.429
28/06/2021 08:00,55.91,39756,588,11,37,685,3,1324,5.166.071.429
28/06/2021 09:00,55.65,40217,672,14,47,802,4,1539,5.166.071.429
28/06/2021 10:00,55.51,40499,647,18,55,952,4,1676,5.166.071.429
28/06/2021 11:00,55.48,40471,585,22,61,1088,5,1761,5.166.071.429
28/06/2021 12:00,54.25,40193,562,26,71,1220,6,1885,5.166.071.429
28/06/2021 13:00,53.93,40037,536,29,80,1304,7,1956,5.166.071.429
28/06/2021 14:00,53.21,39544,532,33,81,1320,7,1973,5.166.071.429
28/06/2021 15:00,52.68,39619,549,38,77,1280,7,1951,5.166.071.429
28/06/2021 16:00,53.32,39492,532,41,74,1184,4,1835,5.166.071.429
28/06/2021 17:00,53.67,39185,508,40,64,1068,5,1685,5.166.071.429
28/06/2021 18:00,53.24,38597,475,40,43,990,5,1553,5.166.071.429
28/06/2021 19:00,52.92,37524,451,36,39,1038,4,1568,5.166.071.429
28/06/2021 20:00,52.56,36947,471,33,44,1211,5,1764,5.166.071.429
28/06/2021 21:00,51.34,35938,531,31,46,1452,6,2066,5.166.071.429
28/06/2021 22:00,47.17,34251,558,31,42,1565,7,2203,5.166.071.429
28/06/2021 23:00,41.75,32697,616,43,35,1460,8,2162,5.166.071.429
29/06/2021 00:00,40.18,32051,591,39,31,1389,6,2056,5.166.071.429
29/06/2021 01:00,39.82,31466,584,35,28,1314,5,1966,5.166.071.429
29/06/2021 02:00,39.34,31100,593,31,25,1202,5,1856,5.166.071.429
29/06/2021 03:00,39.95,31180,606,25,21,1055,4,1711,5.166.071.429
29/06/2021 04:00,43.58,32620,569,18,17,846,3,1453,5.166.071.429
29/06/2021 05:00,50.96,35268,555,14,13,593,4,1179,5.166.071.429
29/06/2021 06:00,54.93,37645,571,12,12,477,4,1076,5.166.071.429
29/06/2021 07:00,57.05,39132,699,13,16,491,3,1222,5.166.071.429
29/06/2021 08:00,59.02,39674,760,15,19,564,3,1361,5.166.071.429
29/06/2021 09:00,59.82,40131,771,19,24,641,4,1459,5.166.071.429
29/06/2021 10:00,59.78,40136,762,23,33,723,4,1545,5.166.071.429
29/06/2021 11:00,59.95,40341,767,28,40,792,4,1631,5.166.071.429
29/06/2021 12:00,58.3,40285,729,34,49,882,5,1699,5.166.071.429
29/06/2021 13:00,57.18,39903,670,38,55,977,6,1746,5.166.071.429
29/06/2021 14:00,56.01,39540,677,42,57,1105,5,1886,5.166.071.429
29/06/2021 15:00,54.96,39445,765,46,55,1223,4,2093,5.166.071.429
29/06/2021 16:00,53.85,39420,762,49,47,1305,3,2166,5.166.071.429
29/06/2021 17:00,53.19,38912,778,51,35,1314,3,2181,5.166.071.429
29/06/2021 18:00,52.59,38512,779,51,26,1407,3,2266,5.166.071.429
29/06/2021 19:00,50.89,37675,813,54,22,1613,3,2505,5.166.071.429
29/06/2021 20:00,49.8,36976,857,55,24,1873,3,2812,5.166.071.429
29/06/2021 21:00,46.22,36417,878,55,23,2187,3,3146,5.166.071.429
29/06/2021 22:00,39.9,34664,856,53,20,2462,3,3394,5.166.071.429
29/06/2021 23:00,40.49,33446,542,53,9,2597,2,3203,5.166.071.429
30/06/2021 00:00,40.02,32791,541,50,8,2805,2,3406,5.166.071.429
30/06/2021 01:00,39.19,32045,545,47,6,2884,2,3484,5.166.071.429
30/06/2021 02:00,38.8,31442,543,45,4,2852,2,3446,5.166.071.429
30/06/2021 03:00,38.89,31251,579,43,4,2771,2,3399,5.166.071.429
30/06/2021 04:00,41.66,32817,576,40,5,2582,3,3206,5.166.071.429
30/06/2021 05:00,50.28,36215,558,38,4,2309,3,2912,5.166.071.429
30/06/2021 06:00,53.42,39164,578,36,3,2103,2,2722,5.166.071.429
30/06/2021 07:00,56.08,40602,649,36,2,1980,2,2669,5.166.071.429
30/06/2021 08:00,57.01,41081,680,36,1,1933,2,2652,5.166.071.429
30/06/2021 09:00,57.01,41583,711,39,2,1906,2,2660,5.166.071.429
30/06/2021 10:00,57.06,41818,794,44,2,1863,2,2705,5.166.071.429
30/06/2021 11:00,57.32,41835,892,48,3,1806,2,2751,5.166.071.429
30/06/2021 12:00,57,41639,946,51,4,1781,2,2784,5.166.071.429
30/06/2021 13:00,56.74,41387,1008,56,5,1773,3,2845,5.166.071.429
30/06/2021 14:00,54.91,40965,1146,59,7,1778,4,2994,5.166.071.429
30/06/2021 15:00,53.35,40495,1214,60,10,1777,5,3066,5.166.071.429
30/06/2021 16:00,55.51,40375,1303,61,16,1749,9,3138,5.166.071.429
30/06/2021 17:00,55.84,40057,1430,61,24,1704,10,3229,5.166.071.429
30/06/2021 18:00,55.07,39451,1627,57,37,1665,10,3396,5.166.071.429
30/06/2021 19:00,53.08,38540,1624,54,60,1699,6,3443,5.166.071.429
30/06/2021 20:00,52.04,37919,1694,52,87,1838,7,3678,5.166.071.429
30/06/2021 21:00,49.24,37077,1732,49,105,1999,9,3894,5.166.071.429
30/06/2021 22:00,46.49,34968,1800,46,109,2101,13,4069,5.166.071.429
30/06/2021 23:00,39.72,33504,1764,34,78,2402,12,4290,5.166.071.429
01/07/2021 00:00,40.49,32879,1910,30,64,2537,13,4554,5.166.071.429
01/07/2021 01:00,39.29,32351,2064,27,48,2650,11,4800,5.166.071.429
01/07/2021 02:00,38.82,31925,2190,25,37,2756,13,5021,5.166.071.429
01/07/2021 03:00,39.14,31887,2377,21,30,2842,12,5282,5.166.071.429
01/07/2021 04:00,41.48,33118,2444,13,25,2840,12,5334,5.166.071.429
01/07/2021 05:00,47.64,36026,2480,7,16,2769,7,5279,5.166.071.429
01/07/2021 06:00,52.29,38784,2570,6,10,2777,4,5367,5.166.071.429
01/07/2021 07:00,53.84,40590,2811,5,8,2931,4,5759,5.166.071.429
01/07/2021 08:00,55.77,41053,2864,6,8,3112,4,5994,5.166.071.429
01/07/2021 09:00,56.09,41636,3000,8,10,3233,5,6256,5.166.071.429
01/07/2021 10:00,56.01,41781,3125,11,11,3280,7,6434,5.166.071.429
01/07/2021 11:00,56.19,41506,3094,13,10,3283,8,6408,5.166.071.429
01/07/2021 12:00,55.94,41422,3007,15,9,3256,9,6296,5.166.071.429
01/07/2021 13:00,55.8,41163,3037,15,9,3168,5,6234,5.166.071.429
01/07/2021 14:00,54.75,40840,3036,17,11,3060,4,6128,5.166.071.429
01/07/2021 15:00,53.83,40527,2899,19,14,2907,4,5843,5.166.071.429
01/07/2021 16:00,53.8,40740,2793,22,17,2781,3,5616,5.166.071.429
01/07/2021 17:00,53.67,40129,2447,23,21,2617,3,5111,5.166.071.429
01/07/2021 18:00,53.6,39469,2166,25,21,2466,4,4682,5.166.071.429
01/07/2021 19:00,53.47,38550,1989,29,18,2443,4,4483,5.166.071.429
01/07/2021 20:00,52.9,37912,1859,35,20,2538,5,4457,5.166.071.429
01/07/2021 21:00,48.05,37123,1767,42,22,2649,6,4486,5.166.071.429
01/07/2021 22:00,44.46,35174,1707,48,26,2708,9,4498,5.166.071.429
01/07/2021 23:00,45.67,33451,993,44,36,2481,11,3565,5.166.071.429
02/07/2021 00:00,45.94,32527,908,46,36,2398,10,3398,5.166.071.429
02/07/2021 01:00,45.42,31891,845,46,38,2259,13,3201,5.166.071.429
02/07/2021 02:00,44.22,31341,789,47,40,2097,16,2989,5.166.071.429
02/07/2021 03:00,45.53,31395,720,47,42,1975,14,2798,5.166.071.429
02/07/2021 04:00,47.39,32659,689,44,41,1814,12,2600,5.166.071.429
02/07/2021 05:00,53.49,35404,687,40,32,1555,9,2323,5.166.071.429
02/07/2021 06:00,55.98,38069,702,37,22,1287,3,2051,5.166.071.429
02/07/2021 07:00,57.51,39883,710,37,18,1149,3,1917,5.166.071.429
02/07/2021 08:00,58.49,40870,700,38,16,1134,3,1891,5.166.071.429
02/07/2021 09:00,59.5,41232,704,41,17,1148,5,1915,5.166.071.429
02/07/2021 10:00,59.62,40721,714,45,21,1176,6,1962,5.166.071.429
02/07/2021 11:00,59.2,40417,702,47,25,1195,8,1977,5.166.071.429
02/07/2021 12:00,58.26,40215,707,49,25,1198,7,1986,5.166.071.429
02/07/2021 13:00,57.76,39641,689,53,27,1146,6,1921,5.166.071.429
02/07/2021 14:00,57.54,38981,679,59,35,1068,5,1846,5.166.071.429
02/07/2021 15:00,57.28,39475,743,65,41,963,6,1818,5.166.071.429
02/07/2021 16:00,57.27,39224,803,62,41,853,6,1765,5.166.071.429
02/07/2021 17:00,57.2,38634,843,62,43,772,6,1726,5.166.071.429
02/07/2021 18:00,57.09,37861,860,64,46,732,6,1708,5.166.071.429
02/07/2021 19:00,56.26,36807,801,69,48,758,4,1680,5.166.071.429
02/07/2021 20:00,55.77,36119,749,71,53,838,4,1715,5.166.071.429
02/07/2021 21:00,54.38,35650,741,70,60,922,4,1797,5.166.071.429
02/07/2021 22:00,53.42,34210,778,68,71,943,5,1865,5.166.071.429
02/07/2021 23:00,52.39,32548,897,11,70,1134,11,2123,5.166.071.429
03/07/2021 00:00,51.27,32133,878,12,76,1075,10,2051,5.166.071.429
03/07/2021 01:00,50.01,31277,855,10,73,986,9,1933,5.166.071.429
03/07/2021 02:00,49.93,30562,849,10,67,898,9,1833,5.166.071.429
03/07/2021 03:00,49.38,29607,874,10,62,826,10,1782,5.166.071.429
03/07/2021 04:00,49.79,29739,808,8,56,736,10,1618,5.166.071.429
03/07/2021 05:00,52.46,30511,694,6,43,602,7,1352,5.166.071.429
03/07/2021 06:00,53.87,31983,663,6,32,498,5,1204,5.166.071.429
03/07/2021 07:00,55.62,33834,655,6,33,500,6,1200,5.166.071.429
03/07/2021 08:00,55.74,35447,571,6,36,596,5,1214,5.166.071.429
03/07/2021 09:00,56.03,36636,506,6,40,729,7,1288,5.166.071.429
03/07/2021 10:00,56.01,36676,506,7,41,860,7,1421,5.166.071.429
03/07/2021 11:00,55.81,36486,469,10,37,968,7,1491,5.166.071.429
03/07/2021 12:00,55.76,36254,417,12,32,1070,8,1539,5.166.071.429
03/07/2021 13:00,55.63,35945,378,14,30,1135,8,1565,5.166.071.429
03/07/2021 14:00,55.8,35801,362,16,35,1168,7,1588,5.166.071.429
03/07/2021 15:00,56.07,36018,343,16,40,1180,8,1587,5.166.071.429
03/07/2021 16:00,56.78,36403,319,14,38,1175,6,1552,5.166.071.429
03/07/2021 17:00,57.12,36344,300,14,37,1164,6,1521,5.166.071.429
03/07/2021 18:00,57.05,35719,284,12,37,1185,4,1522,5.166.071.429
03/07/2021 19:00,56.07,34849,227,13,34,1299,4,1577,5.166.071.429
03/07/2021 20:00,54.95,34796,183,14,36,1592,4,1829,5.166.071.429
03/07/2021 21:00,53.64,34308,156,14,44,1923,6,2143,5.166.071.429
03/07/2021 22:00,50.23,33176,139,14,55,2075,6,2289,5.166.071.429
03/07/2021 23:00,51.89,32191,83,27,81,2073,8,2272,5.166.071.429
04/07/2021 00:00,50.41,30904,86,28,87,2048,7,2256,5.166.071.429
04/07/2021 01:00,49.89,30424,80,27,84,1909,8,2108,5.166.071.429
04/07/2021 02:00,49.51,31057,61,28,78,1719,8,1894,5.166.071.429
04/07/2021 03:00,49.34,30619,56,25,69,1500,8,1658,5.166.071.429
04/07/2021 04:00,50.36,30699,54,23,58,1228,7,1370,5.166.071.429
04/07/2021 05:00,52.96,31364,48,20,40,922,6,1036,5.166.071.429
04/07/2021 06:00,54.66,32551,57,17,21,691,4,790,5.166.071.429
04/07/2021 07:00,55.06,33929,66,16,19,661,4,766,5.166.071.429
04/07/2021 08:00,56.32,35713,67,15,22,803,4,911,5.166.071.429
04/07/2021 09:00,56.63,36752,83,15,28,987,5,1118,5.166.071.429
04/07/2021 10:00,56.73,36660,110,17,30,1164,5,1326,5.166.071.429
04/07/2021 11:00,56.59,36742,138,18,28,1341,5,1530,5.166.071.429
04/07/2021 12:00,55.82,36497,156,20,24,1489,7,1696,5.166.071.429
04/07/2021 13:00,55.87,36947,169,22,21,1527,6,1745,5.166.071.429
04/07/2021 14:00,55.79,37343,202,27,21,1479,5,1734,5.166.071.429
04/07/2021 15:00,56.52,37559,229,31,25,1442,5,1732,5.166.071.429
04/07/2021 16:00,57.49,37813,239,33,27,1410,4,1713,5.166.071.429
04/07/2021 17:00,57.97,37943,274,35,29,1369,4,1711,5.166.071.429
04/07/2021 18:00,58.19,37952,331,36,33,1347,4,1751,5.166.071.429
04/07/2021 19:00,58.01,37280,357,38,39,1435,4,1873,5.166.071.429
04/07/2021 20:00,57.87,36989,418,43,53,1693,6,2213,5.166.071.429
04/07/2021 21:00,56.73,36334,526,45,70,1986,10,2637,5.166.071.429
04/07/2021 22:00,55.02,35251,617,43,88,2150,11,2909,5.166.071.429
04/07/2021 23:00,53.06,34211,632,64,47,2051,10,2804,5.166.071.429
05/07/2021 00:00,51.9,33208,729,62,47,1977,11,2826,5.256.130.952
05/07/2021 01:00,50.98,32648,780,59,46,1850,11,2746,5.256.130.952
05/07/2021 02:00,50.32,32306,832,57,51,1702,11,2653,5.256.130.952
05/07/2021 03:00,51.04,32072,990,52,56,1546,9,2653,5.256.130.952
05/07/2021 04:00,53.23,33392,1086,41,54,1299,9,2489,5.256.130.952
05/07/2021 05:00,56.76,36944,1091,32,44,990,8,2165,5.256.130.952
05/07/2021 06:00,59.28,39531,1024,26,34,755,6,1845,5.256.130.952
05/07/2021 07:00,61.3,40591,1073,26,38,785,5,1927,5.256.130.952
05/07/2021 08:00,61.2,41330,1086,29,38,1015,5,2173,5.256.130.952
05/07/2021 09:00,61.05,41970,1143,32,41,1315,6,2537,5.256.130.952
05/07/2021 10:00,60.44,41973,1183,38,50,1604,6,2881,5.256.130.952
05/07/2021 11:00,59.62,42078,1074,43,50,1834,5,3006,5.256.130.952
05/07/2021 12:00,59.33,41468,941,47,48,2017,6,3059,5.256.130.952
05/07/2021 13:00,58.76,41080,966,48,48,2148,5,3215,5.256.130.952
05/07/2021 14:00,58.15,40965,913,48,43,2208,4,3216,5.256.130.952
05/07/2021 15:00,58,40786,839,49,39,2194,5,3126,5.256.130.952
05/07/2021 16:00,59.01,40415,741,50,36,2104,6,2937,5.256.130.952
05/07/2021 17:00,59.21,40204,592,49,27,1963,5,2636,5.256.130.952
05/07/2021 18:00,59.75,39671,464,46,25,1766,6,2307,5.256.130.952
05/07/2021 19:00,58.88,38397,360,45,29,1637,4,2075,5.256.130.952
05/07/2021 20:00,57.98,37817,316,46,33,1718,5,2118,5.256.130.952
05/07/2021 21:00,57.5,36704,345,45,37,1884,6,2317,5.256.130.952
05/07/2021 22:00,54.78,35266,344,41,39,1981,7,2412,5.256.130.952
05/07/2021 23:00,55.01,33859,428,46,53,1949,10,2486,5.256.130.952
06/07/2021 00:00,53.07,33040,440,44,48,1813,9,2354,5.256.130.952
06/07/2021 01:00,51.31,32294,462,44,41,1630,7,2184,5.256.130.952
06/07/2021 02:00,49.89,31697,457,44,33,1400,7,1941,5.256.130.952
06/07/2021 03:00,49.9,31695,482,43,25,1184,6,1740,5.256.130.952
06/07/2021 04:00,53.24,33007,614,38,20,978,7,1657,5.256.130.952
06/07/2021 05:00,55.96,35738,781,28,15,784,5,1613,5.256.130.952
06/07/2021 06:00,57.89,38576,954,20,12,697,5,1688,5.256.130.952
06/07/2021 07:00,59.05,40083,1273,18,13,787,5,2096,5.256.130.952
06/07/2021 08:00,58.87,40821,1594,22,15,978,6,2615,5.256.130.952
06/07/2021 09:00,59.05,41753,2016,27,17,1192,6,3258,5.256.130.952
06/07/2021 10:00,57.98,41843,2345,30,19,1415,8,3817,5.256.130.952
06/07/2021 11:00,56.32,41782,2567,32,21,1673,8,4301,5.256.130.952
06/07/2021 12:00,55.48,41532,2653,35,23,1918,7,4636,5.256.130.952
06/07/2021 13:00,54.68,40984,2561,37,22,2019,6,4645,5.256.130.952
06/07/2021 14:00,55.04,40828,2447,36,23,2025,5,4536,5.256.130.952
06/07/2021 15:00,55.96,40581,2365,32,22,2083,5,4507,5.256.130.952
06/07/2021 16:00,57.78,40923,2233,28,15,2036,4,4316,5.256.130.952
06/07/2021 17:00,57.99,40145,1995,25,13,1885,3,3921,5.256.130.952
06/07/2021 18:00,58.87,39729,1780,23,10,1731,3,3547,5.256.130.952
06/07/2021 19:00,58.53,39013,1789,26,9,1737,3,3564,5.256.130.952
06/07/2021 20:00,57.67,38136,1780,35,11,1925,3,3754,5.256.130.952
06/07/2021 21:00,56.76,37337,1579,44,15,2159,3,3800,5.256.130.952
06/07/2021 22:00,53.57,35395,1540,50,25,2258,3,3876,5.256.130.952
06/07/2021 23:00,49.5,33452,1995,55,32,2317,5,4404,5.256.130.952
07/07/2021 00:00,48.57,32726,2126,57,44,2239,5,4471,5.256.130.952
07/07/2021 01:00,48.35,32072,2097,59,49,2129,7,4341,5.256.130.952
07/07/2021 02:00,48.06,31452,2007,61,52,2047,9,4176,5.256.130.952
07/07/2021 03:00,48.16,31332,1963,59,50,1950,11,4033,5.256.130.952
07/07/2021 04:00,48.62,32518,1887,52,44,1865,13,3861,5.256.130.952
07/07/2021 05:00,53.81,35230,1814,41,30,1774,10,3669,5.256.130.952
07/07/2021 06:00,56.81,38116,1845,35,17,1720,6,3623,5.256.130.952
07/07/2021 07:00,57.3,39481,1903,37,17,1750,6,3713,5.256.130.952
07/07/2021 08:00,57.18,40090,1769,41,23,1977,6,3816,5.256.130.952
07/07/2021 09:00,57.08,40550,1794,46,29,2279,7,4155,5.256.130.952
07/07/2021 10:00,56.82,41228,1863,47,30,2512,7,4459,5.256.130.952
07/07/2021 11:00,56.02,41226,1955,47,29,2678,7,4716,5.256.130.952
07/07/2021 12:00,56.31,40883,1915,46,28,2831,7,4827,5.256.130.952
07/07/2021 13:00,56.43,40628,1795,45,27,2913,7,4787,5.256.130.952
07/07/2021 14:00,55.08,40480,1656,40,28,2929,7,4660,5.256.130.952
07/07/2021 15:00,55.1,40264,1392,35,29,2963,8,4427,5.256.130.952
07/07/2021 16:00,56.63,40287,1182,31,32,2990,6,4241,5.256.130.952
07/07/2021 17:00,56.11,39926,965,24,33,3020,6,4048,5.256.130.952
07/07/2021 18:00,57.65,39547,816,19,35,2854,5,3729,5.256.130.952
07/07/2021 19:00,57.21,38454,670,17,44,2790,4,3525,5.256.130.952
07/07/2021 20:00,56.92,38097,634,20,64,2864,4,3586,5.256.130.952
07/07/2021 21:00,54.47,37356,714,24,84,3012,6,3840,5.256.130.952
07/07/2021 22:00,49.88,35694,737,25,95,3128,5,3990,5.256.130.952
07/07/2021 23:00,51.07,33733,760,27,173,3122,18,4100,5.256.130.952
08/07/2021 00:00,49.44,33034,777,26,169,3044,20,4036,5.256.130.952
08/07/2021 01:00,48.84,32486,752,25,145,2905,20,3847,5.256.130.952
08/07/2021 02:00,48.11,31866,694,23,116,2755,12,3600,5.256.130.952
08/07/2021 03:00,48.94,31859,685,20,86,2552,8,3351,5.256.130.952
08/07/2021 04:00,51.2,33001,649,16,63,2222,4,2954,5.256.130.952
08/07/2021 05:00,57.39,35726,570,11,47,1822,5,2455,5.256.130.952
08/07/2021 06:00,58.68,38635,486,11,38,1556,6,2097,5.256.130.952
08/07/2021 07:00,59.24,40423,458,12,39,1547,7,2063,5.256.130.952
08/07/2021 08:00,59.36,40927,421,16,37,1692,7,2173,5.256.130.952
08/07/2021 09:00,59.45,41436,417,20,38,1852,7,2334,5.256.130.952
08/07/2021 10:00,59.33,41868,460,24,43,1939,6,2472,5.256.130.952
08/07/2021 11:00,59.35,41492,474,25,46,1955,5,2505,5.256.130.952
08/07/2021 12:00,59.27,41343,474,23,51,1957,5,2510,5.256.130.952
08/07/2021 13:00,59.23,41255,511,21,56,1899,5,2492,5.256.130.952
08/07/2021 14:00,58.88,40865,531,18,57,1764,5,2375,5.256.130.952
08/07/2021 15:00,58.92,40444,463,15,49,1623,5,2155,5.256.130.952
08/07/2021 16:00,59.16,40384,401,13,37,1390,6,1847,5.256.130.952
08/07/2021 17:00,59.7,39838,313,12,32,1142,6,1505,5.256.130.952
08/07/2021 18:00,59.41,39283,249,12,29,917,5,1212,5.256.130.952
08/07/2021 19:00,59.39,38477,168,15,33,834,5,1055,5.256.130.952
08/07/2021 20:00,59.45,37789,126,19,43,885,5,1078,5.256.130.952
08/07/2021 21:00,58.68,36978,132,24,61,987,6,1210,5.256.130.952
08/07/2021 22:00,57.39,35175,133,27,83,1027,6,1276,5.256.130.952
08/07/2021 23:00,57.29,33654,162,33,95,1142,6,1438,5.256.130.952
09/07/2021 00:00,56.97,32882,143,33,100,1095,7,1378,5.256.130.952
09/07/2021 01:00,56.44,32234,146,33,106,1003,8,1296,5.256.130.952
09/07/2021 02:00,56.47,31557,169,34,111,928,10,1252,5.256.130.952
09/07/2021 03:00,56.52,31468,187,34,113,862,10,1206,5.256.130.952
09/07/2021 04:00,57.38,32776,188,28,113,725,9,1063,5.256.130.952
09/07/2021 05:00,58.25,35427,186,21,103,551,11,872,5.256.130.952
09/07/2021 06:00,59.9,37887,171,17,88,460,13,749,5.256.130.952
09/07/2021 07:00,60.99,39614,183,17,97,469,18,784,5.256.130.952
09/07/2021 08:00,61.05,40516,210,18,113,551,12,904,5.256.130.952
09/07/2021 09:00,61.02,40925,234,21,141,642,17,1055,5.256.130.952
09/07/2021 10:00,61.01,41216,248,24,183,719,8,1182,5.256.130.952
09/07/2021 11:00,61.01,40958,282,29,223,776,6,1316,5.256.130.952
09/07/2021 12:00,60.54,40619,362,29,240,823,13,1467,5.256.130.952
09/07/2021 13:00,59.5,40223,461,27,238,841,18,1585,5.256.130.952
09/07/2021 14:00,59.14,39593,567,25,237,844,15,1688,5.256.130.952
09/07/2021 15:00,59,39331,631,23,225,833,17,1729,5.256.130.952
09/07/2021 16:00,59.04,39244,554,19,191,821,14,1599,5.256.130.952
09/07/2021 17:00,59.63,38882,572,16,164,812,10,1574,5.256.130.952
09/07/2021 18:00,59.58,38071,647,14,148,810,7,1626,5.256.130.952
09/07/2021 19:00,59.04,37202,714,12,145,840,9,1720,5.256.130.952
09/07/2021 20:00,58.58,36704,739,13,134,934,8,1828,5.256.130.952
09/07/2021 21:00,57.85,36232,738,14,100,1031,13,1896,5.256.130.952
09/07/2021 22:00,57.19,34705,748,14,88,1059,13,1922,5.256.130.952
09/07/2021 23:00,56.89,32650,1460,44,183,1276,20,2983,5.256.130.952
10/07/2021 00:00,56.21,31790,1438,42,164,1340,22,3006,5.256.130.952
10/07/2021 01:00,55.29,31260,1505,40,170,1423,15,3153,5.256.130.952
10/07/2021 02:00,54.75,30686,1563,37,173,1529,16,3318,5.256.130.952
10/07/2021 03:00,54.35,30221,1855,32,159,1636,21,3703,5.256.130.952
10/07/2021 04:00,54.32,30458,1940,23,140,1710,17,3830,5.256.130.952
10/07/2021 05:00,54.63,31175,1987,14,114,1732,16,3863,5.256.130.952
10/07/2021 06:00,55.5,32498,1992,11,95,1735,12,3845,5.256.130.952
10/07/2021 07:00,56.81,34021,2142,13,103,1833,11,4102,5.256.130.952
10/07/2021 08:00,57.38,35894,2073,17,110,2023,13,4236,5.256.130.952
10/07/2021 09:00,57.38,36894,2082,23,120,2243,12,4480,5.256.130.952
10/07/2021 10:00,57.39,37251,2092,30,140,2400,12,4674,5.256.130.952
10/07/2021 11:00,57.23,37205,2236,37,156,2506,17,4952,5.256.130.952
10/07/2021 12:00,57.07,37097,2237,42,162,2638,16,5095,5.256.130.952
10/07/2021 13:00,56.83,36603,2166,47,161,2747,22,5143,5.256.130.952
10/07/2021 14:00,56.82,36251,2131,48,154,2795,28,5156,5.256.130.952
10/07/2021 15:00,56.56,36610,1948,46,142,2832,28,4996,5.256.130.952
10/07/2021 16:00,57.1,37091,1791,42,123,2850,21,4827,5.256.130.952
10/07/2021 17:00,57.25,37058,1714,42,103,2791,21,4671,5.256.130.952
10/07/2021 18:00,57.28,36387,1552,45,79,2749,21,4446,5.256.130.952
10/07/2021 19:00,57.11,35503,1320,49,56,2751,20,4196,5.256.130.952
10/07/2021 20:00,56.73,35018,1220,52,41,2752,16,4081,5.256.130.952
10/07/2021 21:00,56.24,34511,1157,53,33,2749,14,4006,5.256.130.952
10/07/2021 22:00,54.76,33203,1092,49,29,2740,14,3924,5.256.130.952
10/07/2021 23:00,55.86,31937,930,48,48,2984,10,4020,5.256.130.952
11/07/2021 00:00,55.09,31317,802,47,37,2943,10,3839,5.256.130.952
11/07/2021 01:00,54.78,30845,740,42,28,2807,9,3626,5.256.130.952
11/07/2021 02:00,54.76,30233,686,37,23,2608,8,3362,5.256.130.952
11/07/2021 03:00,54.46,29633,642,33,19,2460,7,3161,5.256.130.952
11/07/2021 04:00,54.71,29758,559,28,16,2348,6,2957,5.256.130.952
11/07/2021 05:00,55.51,30364,471,18,12,2278,6,2785,5.256.130.952
11/07/2021 06:00,56.02,31534,436,11,10,2284,6,2747,5.256.130.952
11/07/2021 07:00,56.8,32858,397,9,13,2339,7,2765,5.256.130.952
11/07/2021 08:00,57.46,34304,275,13,13,2422,7,2730,5.256.130.952
11/07/2021 09:00,58,35341,218,18,12,2512,7,2767,5.256.130.952
11/07/2021 10:00,58.09,35860,208,25,12,2576,6,2827,5.256.130.952
11/07/2021 11:00,57.96,35864,210,32,11,2661,6,2920,5.256.130.952
11/07/2021 12:00,57.87,35751,219,38,11,2652,5,2925,5.256.130.952
11/07/2021 13:00,57.75,35656,255,43,12,2612,5,2927,5.256.130.952
11/07/2021 14:00,57.94,35720,265,48,16,2522,5,2856,5.256.130.952
11/07/2021 15:00,57.62,35946,275,49,21,2394,5,2744,5.256.130.952
11/07/2021 16:00,58.14,36325,278,49,27,2253,5,2612,5.256.130.952
11/07/2021 17:00,58.51,36517,334,47,32,2042,5,2460,5.256.130.952
11/07/2021 18:00,59.15,36294,423,49,39,1803,5,2319,5.256.130.952
11/07/2021 19:00,58.74,35671,477,51,50,1696,5,2279,5.256.130.952
11/07/2021 20:00,58.65,35419,577,52,65,1758,5,2457,5.256.130.952
11/07/2021 21:00,58.43,34830,700,54,76,1897,5,2732,5.256.130.952
11/07/2021 22:00,58.16,33292,796,51,78,1987,5,2917,5.256.130.952
11/07/2021 23:00,57.09,32201,777,11,62,2104,6,2960,5.256.130.952
12/07/2021 00:00,56.54,31560,803,12,62,2012,6,2895,5.280.059.524
12/07/2021 01:00,56.26,31181,902,14,62,1868,7,2853,5.280.059.524
12/07/2021 02:00,56.32,30654,1052,16,64,1718,7,2857,5.280.059.524
12/07/2021 03:00,56.64,30716,1158,15,64,1537,8,2782,5.280.059.524
12/07/2021 04:00,57.31,31983,1208,13,56,1301,8,2586,5.280.059.524
12/07/2021 05:00,58.71,34605,1322,11,41,1067,8,2449,5.280.059.524
12/07/2021 06:00,59.36,37455,1418,10,28,908,7,2371,5.280.059.524
12/07/2021 07:00,59.5,39258,1513,10,24,870,7,2424,5.280.059.524
12/07/2021 08:00,59.99,40171,1557,11,20,909,6,2503,5.280.059.524
12/07/2021 09:00,60.06,40899,1552,11,19,977,7,2566,5.280.059.524
12/07/2021 10:00,60.05,41149,1617,13,19,1035,7,2691,5.280.059.524
12/07/2021 11:00,59.84,40577,1686,17,18,1079,7,2807,5.280.059.524
12/07/2021 12:00,59.55,40654,1759,21,17,1121,7,2925,5.280.059.524
12/07/2021 13:00,59.59,40447,1727,22,16,1129,7,2901,5.280.059.524
12/07/2021 14:00,59.4,40108,1820,25,18,1098,7,2968,5.280.059.524
12/07/2021 15:00,59.55,39877,1864,29,22,1050,7,2972,5.280.059.524
12/07/2021 16:00,59.61,39558,1885,29,30,956,8,2908,5.280.059.524
12/07/2021 17:00,59.87,39159,1858,28,38,853,8,2785,5.280.059.524
12/07/2021 18:00,59.95,38529,1880,28,49,780,8,2745,5.280.059.524
12/07/2021 19:00,59.68,37553,1773,32,49,804,8,2666,5.280.059.524
12/07/2021 20:00,59.49,36994,1749,41,61,936,11,2798,5.280.059.524
12/07/2021 21:00,58.79,36148,1848,46,74,1107,10,3085,5.280.059.524
12/07/2021 22:00,58.01,34450,1905,48,78,1218,10,3259,5.280.059.524
12/07/2021 23:00,58.85,32856,1849,10,139,1173,12,3183,5.280.059.524
13/07/2021 00:00,58.6,31973,1711,9,125,1140,8,2993,5.280.059.524
13/07/2021 01:00,58.44,31386,1582,8,116,1095,8,2809,5.280.059.524
13/07/2021 02:00,58.21,30938,1497,7,117,1041,12,2674,5.280.059.524
13/07/2021 03:00,58.1,30957,1459,6,114,1030,14,2623,5.280.059.524
13/07/2021 04:00,58.42,32069,1367,4,98,986,15,2470,5.280.059.524
13/07/2021 05:00,58.93,34762,1278,2,73,901,9,2263,5.280.059.524
13/07/2021 06:00,59.93,37362,1136,1,42,820,8,2007,5.280.059.524
13/07/2021 07:00,60.38,38920,1087,1,28,823,6,1945,5.280.059.524
13/07/2021 08:00,60.56,39908,973,1,24,925,6,1929,5.280.059.524
13/07/2021 09:00,60.64,40463,930,1,25,1063,6,2025,5.280.059.524
13/07/2021 10:00,60.58,40581,889,2,24,1174,6,2095,5.280.059.524
13/07/2021 11:00,60.57,40528,821,4,24,1300,6,2155,5.280.059.524
13/07/2021 12:00,60.56,40491,782,5,23,1382,6,2198,5.280.059.524
13/07/2021 13:00,60.52,40203,742,6,32,1396,6,2182,5.280.059.524
13/07/2021 14:00,60.37,39927,697,8,49,1358,6,2118,5.280.059.524
13/07/2021 15:00,60.38,39743,657,9,53,1288,9,2016,5.280.059.524
13/07/2021 16:00,60.5,39737,655,9,56,1172,8,1900,5.280.059.524
13/07/2021 17:00,60.55,39344,647,9,56,1081,6,1799,5.280.059.524
13/07/2021 18:00,60.47,38671,641,9,59,1051,6,1766,5.280.059.524
13/07/2021 19:00,60.24,37949,672,13,70,1125,6,1886,5.280.059.524
13/07/2021 20:00,60,37355,712,17,81,1280,9,2099,5.280.059.524
13/07/2021 21:00,59.68,36594,755,19,88,1461,6,2329,5.280.059.524
13/07/2021 22:00,58.56,34730,794,19,96,1546,6,2461,5.280.059.524
13/07/2021 23:00,59.97,32665,754,27,82,1289,5,2157,5.280.059.524
14/07/2021 00:00,59.87,31993,741,26,78,1284,5,2134,5.280.059.524
14/07/2021 01:00,59.74,31359,700,26,75,1283,4,2088,5.280.059.524
14/07/2021 02:00,59.62,30792,664,26,81,1244,4,2019,5.280.059.524
14/07/2021 03:00,59.56,30734,636,23,90,1176,4,1929,5.280.059.524
14/07/2021 04:00,59.73,32016,609,20,94,1033,5,1761,5.280.059.524
14/07/2021 05:00,60.2,34341,590,14,69,861,6,1540,5.280.059.524
14/07/2021 06:00,60.81,37007,569,9,43,732,5,1358,5.280.059.524
14/07/2021 07:00,61.26,38501,570,6,37,699,4,1316,5.280.059.524
14/07/2021 08:00,61.71,39259,550,5,36,756,4,1351,5.280.059.524
14/07/2021 09:00,62.23,39964,568,5,42,853,5,1473,5.280.059.524
14/07/2021 10:00,61.97,40357,604,7,48,970,5,1634,5.280.059.524
14/07/2021 11:00,61.88,40344,656,10,45,1065,5,1781,5.280.059.524
14/07/2021 12:00,61.37,39994,705,14,37,1126,5,1887,5.280.059.524
14/07/2021 13:00,61.16,39786,738,20,25,1130,5,1918,5.280.059.524
14/07/2021 14:00,60.93,39471,787,23,19,1099,4,1932,5.280.059.524
14/07/2021 15:00,60.77,39215,815,22,19,1043,4,1903,5.280.059.524
14/07/2021 16:00,61.21,39221,878,19,20,944,14,1875,5.280.059.524
14/07/2021 17:00,61.22,38778,963,17,25,888,9,1902,5.280.059.524
14/07/2021 18:00,61.35,38198,1022,15,39,930,8,2014,5.280.059.524
14/07/2021 19:00,60.95,37424,1000,15,50,1017,6,2088,5.280.059.524
14/07/2021 20:00,60.62,37081,993,17,60,1159,7,2236,5.280.059.524
14/07/2021 21:00,60,36203,1022,19,69,1353,6,2469,5.280.059.524
14/07/2021 22:00,59.15,34426,1028,19,67,1443,5,2562,5.280.059.524
14/07/2021 23:00,59.33,32727,943,17,32,1431,6,2429,5.280.059.524
15/07/2021 00:00,58.41,31976,932,15,30,1455,6,2438,5.280.059.524
15/07/2021 01:00,57.33,31336,907,16,26,1437,10,2396,5.280.059.524
15/07/2021 02:00,56.01,30925,814,15,21,1389,9,2248,5.280.059.524
15/07/2021 03:00,55.93,30883,778,13,23,1324,10,2148,5.280.059.524
15/07/2021 04:00,56.3,31949,756,11,29,1207,9,2012,5.280.059.524
15/07/2021 05:00,58.89,34301,767,9,25,1058,6,1865,5.280.059.524
15/07/2021 06:00,60.74,36566,677,5,21,1002,4,1709,5.280.059.524
15/07/2021 07:00,61.61,38381,679,4,16,996,3,1698,5.280.059.524
15/07/2021 08:00,61.82,39023,707,5,9,1111,3,1835,5.280.059.524
15/07/2021 09:00,61.69,39603,769,5,7,1267,3,2051,5.280.059.524
15/07/2021 10:00,61.57,39844,844,7,7,1477,3,2338,5.280.059.524
15/07/2021 11:00,61.28,39774,963,9,7,1732,3,2714,5.280.059.524
15/07/2021 12:00,61.1,39800,1066,11,8,2063,3,3151,5.280.059.524
15/07/2021 13:00,60.55,39686,1176,12,11,2400,3,3602,5.280.059.524
15/07/2021 14:00,59.61,39147,1307,12,10,2706,5,4040,5.280.059.524
15/07/2021 15:00,58.59,38858,1416,10,14,2945,5,4390,5.280.059.524
15/07/2021 16:00,59,39040,1589,8,21,3097,5,4720,5.280.059.524
15/07/2021 17:00,58.83,38588,1571,8,37,3211,4,4831,5.280.059.524
15/07/2021 18:00,58.48,38080,1580,9,49,3228,3,4869,5.280.059.524
15/07/2021 19:00,57.38,37156,1471,9,34,3438,15,4967,5.280.059.524
15/07/2021 20:00,57.03,36789,1409,12,38,3613,6,5078,5.280.059.524
15/07/2021 21:00,55.94,36134,1389,11,42,3628,3,5073,5.280.059.524
15/07/2021 22:00,54.33,34462,1382,10,27,3570,10,4999,5.280.059.524
15/07/2021 23:00,53.91,32769,1040,7,26,3632,8,4713,5.280.059.524
16/07/2021 00:00,53.15,31965,1100,5,21,3606,4,4736,5.280.059.524
16/07/2021 01:00,52.83,31589,1040,5,16,3564,3,4628,5.280.059.524
16/07/2021 02:00,52.99,31167,885,4,11,3512,3,4415,5.280.059.524
16/07/2021 03:00,53.36,30969,809,3,10,3399,3,4224,5.280.059.524
16/07/2021 04:00,53.49,31947,756,2,14,3159,3,3934,5.280.059.524
16/07/2021 05:00,55.27,34242,760,1,14,2983,4,3762,5.280.059.524
16/07/2021 06:00,58.57,36619,697,1,12,2879,3,3592,5.280.059.524
16/07/2021 07:00,60.89,38474,679,1,12,2648,3,3343,5.280.059.524
16/07/2021 08:00,62.21,39442,683,1,5,2385,3,3077,5.280.059.524
16/07/2021 09:00,62.45,39670,730,1,4,2146,3,2884,5.280.059.524
16/07/2021 10:00,62.51,40008,865,2,6,1952,4,2829,5.280.059.524
16/07/2021 11:00,62.51,39834,1067,4,5,1800,5,2881,5.280.059.524
16/07/2021 12:00,62.38,39488,1243,4,6,1663,3,2919,5.280.059.524
16/07/2021 13:00,62.04,38929,1337,5,8,1573,4,2927,5.280.059.524
16/07/2021 14:00,61.35,38512,1408,6,10,1550,3,2977,5.280.059.524
16/07/2021 15:00,60.9,38207,1460,6,10,1548,3,3027,5.280.059.524
16/07/2021 16:00,61.08,38084,1724,5,11,1483,4,3227,5.280.059.524
16/07/2021 17:00,61.24,37610,1728,5,18,1398,4,3153,5.280.059.524
16/07/2021 18:00,60.91,36898,1726,5,29,1318,4,3082,5.280.059.524
16/07/2021 19:00,59.59,36290,1688,6,29,1337,4,3064,5.280.059.524
16/07/2021 20:00,58.57,35882,1712,6,31,1528,3,3280,5.280.059.524
16/07/2021 21:00,56.61,35412,1794,7,34,1803,4,3642,5.280.059.524
16/07/2021 22:00,53.91,33859,1872,8,39,2059,4,3982,5.280.059.524
16/07/2021 23:00,52.92,32084,1752,61,26,2219,9,4067,5.280.059.524
17/07/2021 00:00,51.58,31218,1732,59,20,2356,8,4175,5.280.059.524
17/07/2021 01:00,49.78,30571,1773,57,20,2421,6,4277,5.280.059.524
17/07/2021 02:00,48.73,30042,1776,56,23,2459,5,4319,5.280.059.524
17/07/2021 03:00,47.46,29613,1841,55,23,2468,7,4394,5.280.059.524
17/07/2021 04:00,47.1,29624,1970,50,22,2341,7,4390,5.280.059.524
17/07/2021 05:00,50.01,30280,1960,39,17,2131,6,4153,5.280.059.524
17/07/2021 06:00,52.07,31775,1879,34,12,1991,4,3920,5.280.059.524
17/07/2021 07:00,54.26,33256,2018,38,12,1955,4,4027,5.280.059.524
17/07/2021 08:00,55.82,35036,2033,42,11,2075,4,4165,5.280.059.524
17/07/2021 09:00,55.89,35813,2065,48,8,2227,4,4352,5.280.059.524
17/07/2021 10:00,54.13,35870,2087,57,6,2333,5,4488,5.280.059.524
17/07/2021 11:00,51.31,35838,2088,61,5,2434,6,4594,5.280.059.524
17/07/2021 12:00,42.16,35636,2173,64,6,2517,5,4765,5.280.059.524
17/07/2021 13:00,36.1,35207,2284,64,7,2566,6,4927,5.280.059.524
17/07/2021 14:00,28.96,35139,2471,61,10,2625,7,5174,5.280.059.524
17/07/2021 15:00,36.6,35671,2576,54,15,2676,8,5329,5.280.059.524
17/07/2021 16:00,48.19,35969,2753,43,24,2681,8,5509,5.280.059.524
17/07/2021 17:00,52.68,35818,2922,37,27,2692,7,5685,5.280.059.524
17/07/2021 18:00,53.88,35353,2961,37,18,2627,6,5649,5.280.059.524
17/07/2021 19:00,53.04,34425,2734,38,21,2743,5,5541,5.280.059.524
17/07/2021 20:00,50.61,34222,2719,37,27,3096,5,5884,5.280.059.524
17/07/2021 21:00,49.31,33862,2709,36,21,3520,4,6290,5.280.059.524
17/07/2021 22:00,46.48,32278,2725,35,16,3959,4,6739,5.280.059.524
17/07/2021 23:00,44.87,31187,2794,37,36,4557,3,7427,5.280.059.524
18/07/2021 00:00,39.93,30700,2872,35,33,4920,3,7863,5.280.059.524
18/07/2021 01:00,29.38,30155,2923,33,32,5150,4,8142,5.280.059.524
18/07/2021 02:00,27.17,29458,2876,37,34,5129,6,8082,5.280.059.524
18/07/2021 03:00,24.94,29117,2830,39,35,5014,6,7924,5.280.059.524
18/07/2021 04:00,28.18,29102,2748,36,34,4867,7,7692,5.280.059.524
18/07/2021 05:00,30.94,29719,2830,34,27,4799,11,7701,5.280.059.524
18/07/2021 06:00,35.54,30928,3052,33,21,4963,7,8076,5.280.059.524
18/07/2021 07:00,37.61,32163,3401,36,30,5138,7,8612,5.280.059.524
18/07/2021 08:00,36.5,33826,3484,39,46,5201,14,8784,5.280.059.524
18/07/2021 09:00,27.63,34465,3453,40,63,5244,12,8812,5.280.059.524
18/07/2021 10:00,21.45,34828,3402,40,82,5289,9,8822,5.280.059.524
18/07/2021 11:00,19.32,34872,3450,38,108,5353,11,8960,5.280.059.524
18/07/2021 12:00,3.32,34890,3521,35,138,5431,12,9137,5.280.059.524
18/07/2021 13:00,1.4,34952,3558,31,158,5540,12,9299,5.280.059.524
18/07/2021 14:00,1.43,34884,3567,27,168,5586,11,9359,5.280.059.524
18/07/2021 15:00,1.75,35329,3489,23,172,5570,11,9265,5.280.059.524
18/07/2021 16:00,19.99,35614,3495,18,172,5467,10,9162,5.280.059.524
18/07/2021 17:00,42.53,35850,3506,14,164,5251,7,8942,5.280.059.524
18/07/2021 18:00,48.23,35771,3318,12,145,4959,6,8440,5.280.059.524
18/07/2021 19:00,50.39,35162,3009,10,121,4750,4,7894,5.280.059.524
18/07/2021 20:00,51.69,34927,2811,10,102,4727,5,7655,5.280.059.524
18/07/2021 21:00,52.53,34715,2651,10,90,4804,4,7559,5.280.059.524
18/07/2021 22:00,49.52,33238,2439,10,79,4804,4,7336,5.280.059.524
18/07/2021 23:00,46.89,31608,2803,18,78,4548,5,7452,5.280.059.524
19/07/2021 00:00,46.48,30919,2656,21,67,4431,6,7181,5.268.630.952
19/07/2021 01:00,46.54,30565,2453,22,53,4230,6,6764,5.268.630.952
19/07/2021 02:00,47.28,30113,2189,19,49,3957,6,6220,5.268.630.952
19/07/2021 03:00,48.7,30267,2035,18,47,3675,6,5781,5.268.630.952
19/07/2021 04:00,49.82,31516,1916,14,42,3350,9,5331,5.268.630.952
19/07/2021 05:00,53.32,33859,1820,9,36,3141,7,5013,5.268.630.952
19/07/2021 06:00,54.98,36214,1659,7,31,3278,5,4980,5.268.630.952
19/07/2021 07:00,57.24,38023,1593,7,31,3388,4,5023,5.268.630.952
19/07/2021 08:00,57.8,39119,1486,8,27,3449,6,4976,5.268.630.952
19/07/2021 09:00,57.92,39757,1335,12,24,3471,5,4847,5.268.630.952
19/07/2021 10:00,57.93,40017,1229,17,24,3499,4,4773,5.268.630.952
19/07/2021 11:00,57.8,39672,1119,22,27,3601,4,4773,5.268.630.952
19/07/2021 12:00,57.53,39076,1028,26,29,3719,4,4806,5.268.630.952
19/07/2021 13:00,56.76,38870,969,28,37,3819,6,4859,5.268.630.952
19/07/2021 14:00,55.88,38684,1012,31,50,3903,7,5003,5.268.630.952
19/07/2021 15:00,55.41,38190,1012,36,49,3943,8,5048,5.268.630.952
19/07/2021 16:00,56.55,38252,1098,38,38,3879,8,5061,5.268.630.952
19/07/2021 17:00,56.66,38243,1215,38,35,3698,7,4993,5.268.630.952
19/07/2021 18:00,56.49,37521,1261,39,37,3515,6,4858,5.268.630.952
19/07/2021 19:00,55.56,36761,1239,39,39,3527,5,4849,5.268.630.952
19/07/2021 20:00,53.89,36640,1287,39,43,3739,5,5113,5.268.630.952
19/07/2021 21:00,51.44,35805,1384,38,50,4008,4,5484,5.268.630.952
19/07/2021 22:00,48.31,34189,1433,34,51,4197,4,5719,5.268.630.952
19/07/2021 23:00,48.88,32025,1698,75,43,3957,3,5776,5.268.630.952
20/07/2021 00:00,47.99,31318,1665,74,37,4020,3,5799,5.268.630.952
20/07/2021 01:00,47.7,30794,1645,73,27,3998,3,5746,5.268.630.952
20/07/2021 02:00,47.83,30646,1663,72,21,3955,3,5714,5.268.630.952
20/07/2021 03:00,48.09,30507,1769,69,16,3854,3,5711,5.268.630.952
20/07/2021 04:00,48.23,31449,1895,67,11,3655,4,5632,5.268.630.952
20/07/2021 05:00,50.73,33895,2106,65,7,3516,5,5699,5.268.630.952
20/07/2021 06:00,55.64,36267,2374,65,4,3580,4,6027,5.268.630.952
20/07/2021 07:00,56.95,37607,2677,59,6,3739,4,6485,5.268.630.952
20/07/2021 08:00,57.27,38434,2749,55,11,3975,5,6795,5.268.630.952
20/07/2021 09:00,57.28,39118,2670,51,17,4234,10,6982,5.268.630.952
20/07/2021 10:00,56.85,39338,2665,50,28,4505,14,7262,5.268.630.952
20/07/2021 11:00,56.37,39097,2648,52,42,4797,16,7555,5.268.630.952
20/07/2021 12:00,55.06,38842,2748,57,58,5034,16,7913,5.268.630.952
20/07/2021 13:00,53.6,38501,2878,64,74,5207,14,8237,5.268.630.952
20/07/2021 14:00,52.52,38212,2938,70,92,5323,16,8439,5.268.630.952
20/07/2021 15:00,52.36,38212,2915,74,108,5393,19,8509,5.268.630.952
20/07/2021 16:00,53.91,38315,3020,74,117,5287,17,8515,5.268.630.952
20/07/2021 17:00,56.3,38056,3084,71,116,5011,15,8297,5.268.630.952
20/07/2021 18:00,56.21,37474,3030,64,105,4651,13,7863,5.268.630.952
20/07/2021 19:00,56.25,36567,2850,56,94,4273,10,7283,5.268.630.952
20/07/2021 20:00,55.92,36052,2719,53,93,4002,9,6876,5.268.630.952
20/07/2021 21:00,54.48,35385,2547,58,95,3897,6,6603,5.268.630.952
20/07/2021 22:00,51.03,33540,2339,62,94,3882,6,6383,5.268.630.952
20/07/2021 23:00,49.57,31832,2407,59,76,3874,7,6423,5.268.630.952
21/07/2021 00:00,48.83,31354,2258,55,66,3850,6,6235,5.268.630.952
21/07/2021 01:00,47.86,30856,2098,48,51,3801,9,6007,5.268.630.952
21/07/2021 02:00,47.6,30387,1870,44,48,3681,7,5650,5.268.630.952
21/07/2021 03:00,48.14,30288,1656,42,50,3495,7,5250,5.268.630.952
21/07/2021 04:00,50.09,31311,1467,40,46,3167,6,4726,5.268.630.952
21/07/2021 05:00,51.94,33416,1314,38,37,2964,5,4358,5.268.630.952
21/07/2021 06:00,56.86,35685,1164,47,32,2941,4,4188,5.268.630.952
21/07/2021 07:00,59.07,36960,1115,55,37,2766,5,3978,5.268.630.952
21/07/2021 08:00,59.41,37783,1008,54,33,2630,5,3730,5.268.630.952
21/07/2021 09:00,59.39,38262,902,61,27,2603,4,3597,5.268.630.952
21/07/2021 10:00,59.34,38452,783,74,26,2758,5,3646,5.268.630.952
21/07/2021 11:00,59.18,38306,701,88,27,2903,5,3724,5.268.630.952
21/07/2021 12:00,59.09,37920,651,98,33,2970,13,3765,5.268.630.952
21/07/2021 13:00,57.89,37679,595,107,44,3168,7,3921,5.268.630.952
21/07/2021 14:00,56.71,37513,562,111,54,3341,8,4076,5.268.630.952
21/07/2021 15:00,55.98,37363,530,106,62,3475,10,4183,5.268.630.952
21/07/2021 16:00,55.94,37405,498,96,70,3517,10,4191,5.268.630.952
21/07/2021 17:00,57.94,37269,489,83,71,3440,10,4093,5.268.630.952
21/07/2021 18:00,57.96,36957,467,72,71,3278,7,3895,5.268.630.952
21/07/2021 19:00,57.21,36060,466,68,70,3239,7,3850,5.268.630.952
21/07/2021 20:00,55.07,35770,474,67,72,3375,7,3995,5.268.630.952
21/07/2021 21:00,52.24,35161,458,73,74,3602,6,4213,5.268.630.952
21/07/2021 22:00,50.15,33769,438,76,70,3801,6,4391,5.268.630.952
21/07/2021 23:00,46.9,31940,513,73,64,4208,6,4864,5.268.630.952
22/07/2021 00:00,46.84,31312,494,71,50,4346,4,4965,5.268.630.952
22/07/2021 01:00,46.38,30844,486,78,37,4402,4,5007,5.268.630.952
22/07/2021 02:00,46.16,30508,458,82,28,4391,3,4962,5.268.630.952
22/07/2021 03:00,46.17,30387,445,72,22,4331,3,4873,5.268.630.952
22/07/2021 04:00,46.21,31234,432,60,15,4168,3,4678,5.268.630.952
22/07/2021 05:00,50.02,33155,408,54,9,3926,4,4401,5.268.630.952
22/07/2021 06:00,53.15,35367,367,54,5,3736,5,4167,5.268.630.952
22/07/2021 07:00,55.62,36906,402,53,6,3751,4,4216,5.268.630.952
22/07/2021 08:00,55.85,37408,478,52,10,4013,5,4558,5.268.630.952
22/07/2021 09:00,55,38131,556,54,19,4300,8,4937,5.268.630.952
22/07/2021 10:00,54.68,38288,649,58,36,4513,10,5266,5.268.630.952
22/07/2021 11:00,54.33,38065,725,64,61,4684,12,5546,5.268.630.952
22/07/2021 12:00,52.31,37909,852,73,89,4832,10,5856,5.268.630.952
22/07/2021 13:00,51.84,37677,992,80,109,4957,10,6148,5.268.630.952
22/07/2021 14:00,51.1,37372,1141,84,120,5013,10,6368,5.268.630.952
22/07/2021 15:00,51.04,37312,1270,84,124,5027,12,6517,5.268.630.952
22/07/2021 16:00,51.81,37431,1374,83,119,4957,11,6544,5.268.630.952
22/07/2021 17:00,55,37179,1406,82,105,4823,14,6430,5.268.630.952
22/07/2021 18:00,55.39,36696,1398,80,86,4639,13,6216,5.268.630.952
22/07/2021 19:00,55.03,36077,1364,74,75,4502,16,6031,5.268.630.952
22/07/2021 20:00,54.6,35697,1381,65,73,4438,19,5976,5.268.630.952
22/07/2021 21:00,53.67,35074,1384,59,73,4384,21,5921,5.268.630.952
22/07/2021 22:00,50.65,33550,1257,56,73,4204,23,5613,5.268.630.952
22/07/2021 23:00,51.19,31541,1216,61,52,3986,18,5333,5.268.630.952
23/07/2021 00:00,50.01,30828,1115,56,52,3680,17,4920,5.268.630.952
23/07/2021 01:00,49.94,30443,992,46,46,3431,17,4532,5.268.630.952
23/07/2021 02:00,49.76,30061,835,44,44,3261,14,4198,5.268.630.952
23/07/2021 03:00,49.81,29871,715,49,44,3106,9,3923,5.268.630.952
23/07/2021 04:00,53.44,30639,590,49,44,2878,7,3568,5.268.630.952
23/07/2021 05:00,57.25,32804,465,50,40,2762,9,3326,5.268.630.952
23/07/2021 06:00,58.61,34970,359,57,39,2724,7,3186,5.268.630.952
23/07/2021 07:00,59.56,36738,317,67,51,2443,6,2884,5.268.630.952
23/07/2021 08:00,59.68,37414,286,79,60,2228,6,2659,5.268.630.952
23/07/2021 09:00,59.91,38021,265,87,67,2096,7,2522,5.268.630.952
23/07/2021 10:00,59.92,38378,236,96,74,2060,8,2474,5.268.630.952
23/07/2021 11:00,59.95,38055,193,111,80,2076,10,2470,5.268.630.952
23/07/2021 12:00,59.71,37621,169,125,84,2096,13,2487,5.268.630.952
23/07/2021 13:00,59.66,37196,153,127,88,2120,14,2502,5.268.630.952
23/07/2021 14:00,59.61,36809,150,126,92,2131,18,2517,5.268.630.952
23/07/2021 15:00,59.62,36635,148,127,94,2108,19,2496,5.268.630.952
23/07/2021 16:00,59.82,36507,127,126,90,1997,18,2358,5.268.630.952
23/07/2021 17:00,60.03,36311,106,121,80,1830,15,2152,5.268.630.952
23/07/2021 18:00,60.14,35681,89,113,67,1636,10,1915,5.268.630.952
23/07/2021 19:00,60.1,34796,72,100,58,1514,8,1752,5.268.630.952
23/07/2021 20:00,59.88,34543,69,87,53,1590,6,1805,5.268.630.952
23/07/2021 21:00,59.52,34118,71,76,51,1764,6,1968,5.268.630.952
23/07/2021 22:00,58.72,32755,58,70,50,1824,6,2008,5.268.630.952
23/07/2021 23:00,58.26,31233,70,47,93,1816,4,2030,5.268.630.952
24/07/2021 00:00,56.98,30308,68,42,81,1738,4,1933,5.268.630.952
24/07/2021 01:00,56.42,29718,71,35,70,1607,4,1787,5.268.630.952
24/07/2021 02:00,55.94,29276,87,31,66,1444,4,1632,5.268.630.952
24/07/2021 03:00,55.53,29029,122,25,61,1265,3,1476,5.268.630.952
24/07/2021 04:00,55.91,29099,156,19,52,1028,3,1258,5.268.630.952
24/07/2021 05:00,56.57,29657,173,12,32,757,3,977,5.268.630.952
24/07/2021 06:00,58.29,30934,185,9,12,590,3,799,5.268.630.952
24/07/2021 07:00,58.76,32296,206,8,8,585,3,810,5.268.630.952
24/07/2021 08:00,59.25,33767,263,7,5,668,3,946,5.268.630.952
24/07/2021 09:00,59.39,34472,394,8,3,767,4,1176,5.268.630.952
24/07/2021 10:00,59.36,34606,557,10,3,853,4,1427,5.268.630.952
24/07/2021 11:00,59.16,34421,740,12,5,936,4,1697,5.268.630.952
24/07/2021 12:00,58.84,34203,908,14,8,1019,4,1953,5.268.630.952
24/07/2021 13:00,58.5,33951,1116,16,12,1077,5,2226,5.268.630.952
24/07/2021 14:00,58.5,33993,1368,16,16,1101,6,2507,5.268.630.952
24/07/2021 15:00,58.79,34113,1555,15,17,1121,6,2714,5.268.630.952
24/07/2021 16:00,59.03,34156,1742,13,18,1108,6,2887,5.268.630.952
24/07/2021 17:00,59.44,34179,1840,12,20,1059,6,2937,5.268.630.952
24/07/2021 18:00,59.47,33795,1880,11,21,1034,5,2951,5.268.630.952
24/07/2021 19:00,59.24,33148,1927,9,25,1085,5,3051,5.268.630.952
24/07/2021 20:00,58.99,32918,2232,10,33,1252,5,3532,5.268.630.952
24/07/2021 21:00,58.29,32481,2476,10,36,1503,6,4031,5.268.630.952
24/07/2021 22:00,55.48,31459,2707,10,37,1703,7,4464,5.268.630.952
24/07/2021 23:00,51.82,30478,3002,7,59,1976,9,5053,5.268.630.952
25/07/2021 00:00,48.81,29920,3079,9,62,1904,9,5063,5.268.630.952
25/07/2021 01:00,47.88,29409,3075,13,63,1731,8,4890,5.268.630.952
25/07/2021 02:00,46.56,28782,3033,19,73,1539,7,4671,5.268.630.952
25/07/2021 03:00,46.55,28362,2994,26,85,1374,7,4486,5.268.630.952
25/07/2021 04:00,46.71,28385,2962,32,91,1171,8,4264,5.268.630.952
25/07/2021 05:00,47.1,28898,2990,36,74,953,7,4060,5.268.630.952
25/07/2021 06:00,47.33,29871,3008,43,43,815,6,3915,5.268.630.952
25/07/2021 07:00,49.4,31139,3105,54,28,851,5,4043,5.268.630.952
25/07/2021 08:00,50.61,32427,3068,65,25,996,4,4158,5.268.630.952
25/07/2021 09:00,48.87,33331,3111,71,24,1154,4,4364,5.268.630.952
25/07/2021 10:00,49.59,33597,3141,75,22,1291,4,4533,5.268.630.952
25/07/2021 11:00,48.6,33586,3105,77,20,1391,4,4597,5.268.630.952
25/07/2021 12:00,47.96,33436,3067,82,19,1446,4,4618,5.268.630.952
25/07/2021 13:00,46.31,33456,3013,83,20,1464,5,4585,5.268.630.952
25/07/2021 14:00,48.01,33434,2847,86,23,1451,5,4412,5.268.630.952
25/07/2021 15:00,52.67,33753,2585,93,27,1417,6,4128,5.268.630.952
25/07/2021 16:00,58.51,34370,2390,107,33,1377,6,3913,5.268.630.952
25/07/2021 17:00,59.2,34742,2245,112,43,1304,6,3710,5.268.630.952
25/07/2021 18:00,59.36,34491,2076,105,59,1263,6,3509,5.268.630.952
25/07/2021 19:00,59.24,33756,1838,90,86,1370,7,3391,5.268.630.952
25/07/2021 20:00,58.94,33780,1683,77,120,1644,11,3535,5.268.630.952
25/07/2021 21:00,58.46,33322,1547,74,147,1869,15,3652,5.268.630.952
25/07/2021 22:00,57.18,32284,1473,76,166,1916,13,3644,5.268.630.952
25/07/2021 23:00,55.86,31181,1226,67,189,2141,12,3635,5.268.630.952
26/07/2021 00:00,53.23,30542,1116,62,180,2065,15,3438,529.172.619
26/07/2021 01:00,53.08,30138,1028,61,166,1906,17,3178,529.172.619
26/07/2021 02:00,52.93,29629,991,62,162,1738,19,2972,529.172.619
26/07/2021 03:00,53.47,29644,969,63,161,1595,20,2808,529.172.619
26/07/2021 04:00,55.99,30647,961,62,155,1408,20,2606,529.172.619
26/07/2021 05:00,57.97,32681,949,63,135,1183,18,2348,529.172.619
26/07/2021 06:00,59.14,34836,931,66,102,1001,7,2107,529.172.619
26/07/2021 07:00,59.4,36474,857,68,82,942,4,1953,529.172.619
26/07/2021 08:00,59.48,37276,704,64,79,1036,4,1887,529.172.619
26/07/2021 09:00,59.45,37982,621,58,92,1196,5,1972,529.172.619
26/07/2021 10:00,59.43,38411,576,55,113,1371,7,2122,529.172.619
26/07/2021 11:00,59.35,38376,529,58,132,1534,7,2260,529.172.619
26/07/2021 12:00,59.32,38200,527,60,145,1655,7,2394,529.172.619
26/07/2021 13:00,59.4,37922,544,61,150,1734,6,2495,529.172.619
26/07/2021 14:00,59.35,37943,502,64,147,1773,6,2492,529.172.619
26/07/2021 15:00,59.33,37629,485,68,138,1798,6,2495,529.172.619
26/07/2021 16:00,59.45,37663,507,71,128,1790,7,2503,529.172.619
26/07/2021 17:00,59.48,37337,444,69,121,1729,11,2374,529.172.619
26/07/2021 18:00,59.5,36723,358,63,126,1738,9,2294,529.172.619
26/07/2021 19:00,59.48,36005,290,55,158,1915,8,2426,529.172.619
26/07/2021 20:00,59.16,35548,297,51,192,2175,11,2726,529.172.619
26/07/2021 21:00,58.61,34810,310,49,212,2446,11,3028,529.172.619
26/07/2021 22:00,55.69,33623,284,44,219,2501,16,3064,529.172.619
26/07/2021 23:00,53.83,31854,337,12,160,2316,16,2841,529.172.619
27/07/2021 00:00,52.05,31223,290,13,145,2158,17,2623,529.172.619
27/07/2021 01:00,52.47,30718,235,14,125,1938,17,2329,529.172.619
27/07/2021 02:00,52.16,30343,184,14,112,1720,19,2049,529.172.619
27/07/2021 03:00,52.41,30283,145,13,111,1556,19,1844,529.172.619
27/07/2021 04:00,53.19,31060,129,12,111,1375,19,1646,529.172.619
27/07/2021 05:00,55.34,33011,148,10,105,1189,17,1469,529.172.619
27/07/2021 06:00,56.72,34959,192,7,101,1026,13,1339,529.172.619
27/07/2021 07:00,58.51,36513,205,5,102,997,9,1318,529.172.619
27/07/2021 08:00,58.97,37497,226,4,104,1125,9,1468,529.172.619
27/07/2021 09:00,59.14,38393,251,4,104,1310,10,1679,529.172.619
27/07/2021 10:00,58.98,38654,304,6,91,1488,15,1904,529.172.619
27/07/2021 11:00,58.94,38560,392,7,85,1662,26,2172,529.172.619
27/07/2021 12:00,58.51,38436,510,9,76,1779,29,2403,529.172.619
27/07/2021 13:00,58.46,38385,640,13,62,1798,20,2533,529.172.619
27/07/2021 14:00,58.62,38261,772,16,50,1746,29,2613,529.172.619
27/07/2021 15:00,59.01,37931,885,20,43,1667,19,2634,529.172.619
27/07/2021 16:00,59.21,37938,845,20,42,1552,12,2471,529.172.619
27/07/2021 17:00,59.52,37669,720,19,40,1394,10,2183,529.172.619
27/07/2021 18:00,59.49,37138,622,23,36,1296,7,1984,529.172.619
27/07/2021 19:00,59.16,36489,517,27,36,1390,5,1975,529.172.619
27/07/2021 20:00,58.89,36041,481,34,38,1602,6,2161,529.172.619
27/07/2021 21:00,57.95,35251,454,44,40,1763,5,2306,529.172.619
27/07/2021 22:00,54.86,33420,417,53,48,1787,5,2310,529.172.619
27/07/2021 23:00,53.64,31458,651,57,72,1571,6,2357,529.172.619
28/07/2021 00:00,52.94,30997,785,59,69,1475,8,2396,529.172.619
28/07/2021 01:00,51.88,30547,844,59,58,1347,8,2316,529.172.619
28/07/2021 02:00,51.49,30256,800,59,48,1241,7,2155,529.172.619
28/07/2021 03:00,50.44,30240,739,58,39,1182,11,2029,529.172.619
28/07/2021 04:00,51.54,30953,635,54,31,1104,12,1836,529.172.619
28/07/2021 05:00,54.58,32756,637,43,23,983,11,1697,529.172.619
28/07/2021 06:00,56.53,35156,710,29,20,863,12,1634,529.172.619
28/07/2021 07:00,57.98,36276,903,20,25,856,13,1817,529.172.619
28/07/2021 08:00,58.63,37037,1086,23,30,993,14,2146,529.172.619
28/07/2021 09:00,58.1,38147,1122,30,35,1209,17,2413,529.172.619
28/07/2021 10:00,57.99,38246,1155,36,44,1444,18,2697,529.172.619
28/07/2021 11:00,57.89,38073,1244,38,57,1653,18,3010,529.172.619
28/07/2021 12:00,57.45,37842,1358,39,66,1789,17,3269,529.172.619
28/07/2021 13:00,55.4,37693,1374,42,69,1837,18,3340,529.172.619
28/07/2021 14:00,54.14,37597,1396,50,64,1787,18,3315,529.172.619
28/07/2021 15:00,54.18,37257,1370,59,54,1700,15,3198,529.172.619
28/07/2021 16:00,57.57,37113,1317,54,42,1590,16,3019,529.172.619
28/07/2021 17:00,57.63,36846,1324,52,30,1459,12,2877,529.172.619
28/07/2021 18:00,57.55,36544,1322,54,21,1357,9,2763,529.172.619
28/07/2021 19:00,57.56,35696,1380,59,19,1383,7,2848,529.172.619
28/07/2021 20:00,56.38,35474,1610,64,22,1540,7,3243,529.172.619
28/07/2021 21:00,55.61,34828,1839,69,29,1722,7,3666,529.172.619
28/07/2021 22:00,53.38,33341,1905,63,42,1870,9,3889,529.172.619
28/07/2021 23:00,50.12,31417,2327,63,40,1347,7,3784,529.172.619
29/07/2021 00:00,46.3,30775,2472,66,50,1421,8,4017,529.172.619
29/07/2021 01:00,44.23,30255,2458,66,46,1497,7,4074,529.172.619
29/07/2021 02:00,41.63,29899,2499,66,39,1595,6,4205,529.172.619
29/07/2021 03:00,41.71,29816,2540,66,35,1688,6,4335,529.172.619
29/07/2021 04:00,45.3,30576,2640,64,34,1691,6,4435,529.172.619
29/07/2021 05:00,51.1,32746,2965,63,29,1655,8,4720,529.172.619
29/07/2021 06:00,54.25,34699,3296,61,29,1649,12,5047,529.172.619
29/07/2021 07:00,54.25,36074,3615,58,41,1761,15,5490,529.172.619
29/07/2021 08:00,50.91,36801,3802,53,52,1979,16,5902,529.172.619
29/07/2021 09:00,42.97,37513,4027,52,65,2227,15,6386,529.172.619
29/07/2021 10:00,41.24,37677,4208,54,82,2473,17,6834,529.172.619
29/07/2021 11:00,40.72,37438,4255,59,105,2699,21,7139,529.172.619
29/07/2021 12:00,38.89,37293,4163,61,128,2877,23,7252,529.172.619
29/07/2021 13:00,36.62,37254,4105,63,145,2991,14,7318,529.172.619
29/07/2021 14:00,39.13,37006,4354,60,158,3050,26,7648,529.172.619
29/07/2021 15:00,40.24,36862,4588,57,152,3108,21,7926,529.172.619
29/07/2021 16:00,46.71,36937,4784,49,126,3099,23,8081,529.172.619
29/07/2021 17:00,51.5,36740,4908,38,100,3048,31,8125,529.172.619
29/07/2021 18:00,53.04,36167,4822,34,84,3018,29,7987,529.172.619
29/07/2021 19:00,52.6,35307,4367,35,80,3062,26,7570,529.172.619
29/07/2021 20:00,51.54,35118,4122,39,79,3222,28,7490,529.172.619
29/07/2021 21:00,50.22,34289,3863,46,78,3416,28,7431,529.172.619
29/07/2021 22:00,44.38,32639,3734,52,91,3619,31,7527,529.172.619
29/07/2021 23:00,46.22,30985,3792,63,126,3339,28,7348,529.172.619
30/07/2021 00:00,43.95,30491,3801,64,150,3443,31,7489,529.172.619
30/07/2021 01:00,43,29979,3804,65,166,3526,37,7598,529.172.619
30/07/2021 02:00,41.08,29510,3832,68,189,3573,34,7696,529.172.619
30/07/2021 03:00,39.99,29438,3808,70,208,3642,34,7762,529.172.619
30/07/2021 04:00,42.17,30198,3806,74,205,3648,36,7769,529.172.619
30/07/2021 05:00,43.53,32106,3775,76,206,3569,31,7657,529.172.619
30/07/2021 06:00,48.48,34111,3771,78,240,3499,34,7622,529.172.619
30/07/2021 07:00,49.81,35590,4023,80,302,3458,38,7901,529.172.619
30/07/2021 08:00,50,36655,4080,86,346,3468,41,8021,529.172.619
30/07/2021 09:00,50.41,37303,4234,93,381,3471,43,8222,529.172.619
30/07/2021 10:00,49.76,37423,4281,101,412,3488,41,8323,529.172.619
30/07/2021 11:00,49.05,37074,4178,106,429,3527,43,8283,529.172.619
30/07/2021 12:00,43.55,36813,4098,107,441,3580,44,8270,529.172.619
30/07/2021 13:00,42.98,36514,3971,107,445,3637,46,8206,529.172.619
30/07/2021 14:00,45.08,36183,3868,106,444,3643,46,8107,529.172.619
30/07/2021 15:00,48.76,35860,3718,113,439,3622,46,7938,529.172.619
30/07/2021 16:00,53.91,35694,3666,111,424,3549,46,7796,529.172.619
30/07/2021 17:00,55.94,35675,3423,116,397,3413,46,7395,529.172.619
30/07/2021 18:00,58.51,35156,2993,113,374,3253,36,6769,529.172.619
30/07/2021 19:00,58.54,34345,2290,116,362,3164,40,5972,529.172.619
30/07/2021 20:00,58.44,34068,1731,132,364,3154,41,5422,529.172.619
30/07/2021 21:00,56.44,33551,1297,148,369,3172,44,5030,529.172.619
30/07/2021 22:00,54.4,32296,1009,151,371,3122,44,4697,529.172.619
30/07/2021 23:00,52.53,30830,986,39,368,3113,44,4550,529.172.619
31/07/2021 00:00,49.03,30174,873,35,355,2892,44,4199,529.172.619
31/07/2021 01:00,41.25,29529,850,31,331,2632,43,3887,529.172.619
31/07/2021 02:00,38.67,29017,894,26,302,2373,40,3635,529.172.619
31/07/2021 03:00,35.52,28783,971,22,272,2146,35,3446,529.172.619
31/07/2021 04:00,32.36,28730,1021,17,240,1905,32,3215,529.172.619
31/07/2021 05:00,39.99,29181,1138,11,214,1644,19,3026,529.172.619
31/07/2021 06:00,41.25,30508,1297,8,204,1482,15,3006,529.172.619
31/07/2021 07:00,38.72,32230,1454,8,210,1427,16,3115,529.172.619
31/07/2021 08:00,39.65,33740,1518,8,213,1447,17,3203,529.172.619
31/07/2021 09:00,43.16,34540,1691,9,202,1514,26,3442,529.172.619
31/07/2021 10:00,43.1,34769,1815,11,180,1574,33,3613,529.172.619
31/07/2021 11:00,43.12,34657,1821,12,161,1639,30,3663,529.172.619
31/07/2021 12:00,39.5,34483,1881,15,139,1707,27,3769,529.172.619
31/07/2021 13:00,37.72,34380,1969,16,120,1744,21,3870,529.172.619
31/07/2021 14:00,37.23,34486,2157,15,122,1741,19,4054,529.172.619
31/07/2021 15:00,37.12,34390,2394,13,137,1724,11,4279,529.172.619
31/07/2021 16:00,43.06,34811,2807,12,135,1610,6,4570,529.172.619
31/07/2021 17:00,49.18,34918,3190,11,115,1482,6,4804,529.172.619
31/07/2021 18:00,52.43,34460,3329,11,97,1393,6,4836,529.172.619
31/07/2021 19:00,54.54,33954,3169,11,79,1426,22,4707,529.172.619
31/07/2021 20:00,55.33,33714,3237,12,70,1598,7,4924,529.172.619
31/07/2021 21:00,55.15,33168,3287,13,67,1814,6,5187,529.172.619
31/07/2021 22:00,52.34,32334,3296,13,60,2013,7,5389,529.172.619
31/07/2021 23:00,50.55,30953,3374,14,78,1994,11,5471,529.172.619
01/08/2021 00:00,48.38,30368,3313,13,117,2122,12,5577,529.172.619
01/08/2021 01:00,48.37,29877,3171,12,163,2268,15,5629,529.172.619
01/08/2021 02:00,47.74,29400,3017,12,218,2397,15,5659,529.172.619
01/08/2021 03:00,47.25,29117,2917,12,276,2521,19,5745,529.172.619
01/08/2021 04:00,47.09,28988,2764,11,295,2563,31,5664,529.172.619
01/08/2021 05:00,46.75,29373,2535,8,282,2550,36,5411,529.172.619
01/08/2021 06:00,48.93,30344,2376,4,262,2614,40,5296,529.172.619
01/08/2021 07:00,51.92,31821,2525,2,260,2731,38,5556,529.172.619
01/08/2021 08:00,53.83,33070,2605,2,260,2838,36,5741,529.172.619
01/08/2021 09:00,55.06,33764,2726,2,253,2945,33,5959,529.172.619
01/08/2021 10:00,54.95,34134,2833,2,237,3054,35,6161,529.172.619
01/08/2021 11:00,55.34,34030,2864,3,215,3133,28,6243,529.172.619
01/08/2021 12:00,52.67,33854,2933,4,193,3166,28,6324,529.172.619
01/08/2021 13:00,49.64,33816,3013,5,159,3159,26,6362,529.172.619
01/08/2021 14:00,49.39,33873,3067,5,123,3050,22,6267,529.172.619
01/08/2021 15:00,50.88,34057,3019,5,93,2876,27,6020,529.172.619
01/08/2021 16:00,54.48,34473,3095,3,69,2646,29,5842,529.172.619
01/08/2021 17:00,57.86,34934,3122,2,47,2337,20,5528,529.172.619
01/08/2021 18:00,58.48,34825,3007,2,27,2072,13,5121,529.172.619
01/08/2021 19:00,58.23,34387,2699,3,19,1976,10,4707,529.172.619
01/08/2021 20:00,57.94,34337,2652,6,17,2049,10,4734,529.172.619
01/08/2021 21:00,57.54,33695,2633,9,19,2205,8,4874,529.172.619
01/08/2021 22:00,54.66,32438,2730,11,25,2368,8,5142,529.172.619
01/08/2021 23:00,53.83,31443,2673,153,31,2559,6,5422,529.172.619
02/08/2021 00:00,51.79,30809,2675,143,33,2637,6,5494,5.218.214.286
02/08/2021 01:00,48.83,30532,2663,140,42,2675,6,5526,5.218.214.286
02/08/2021 02:00,44.98,30280,2616,140,52,2692,6,5506,5.218.214.286
02/08/2021 03:00,48.33,30188,2668,145,57,2706,6,5582,5.218.214.286
02/08/2021 04:00,52.37,31106,2726,153,59,2602,5,5545,5.218.214.286
02/08/2021 05:00,54.5,33509,2671,162,60,2390,6,5289,5.218.214.286
02/08/2021 06:00,56.98,35781,2643,169,66,2204,6,5088,5.218.214.286
02/08/2021 07:00,58.31,37419,2733,171,80,2115,6,5105,5.218.214.286
02/08/2021 08:00,58.59,38235,2765,178,93,2087,6,5129,5.218.214.286
02/08/2021 09:00,58.79,38771,2802,183,116,2089,10,5200,5.218.214.286
02/08/2021 10:00,58.87,38841,2628,186,150,2112,12,5088,5.218.214.286
02/08/2021 11:00,59.13,38579,2588,188,192,2144,14,5126,5.218.214.286
02/08/2021 12:00,58.84,38319,2583,183,233,2177,14,5190,5.218.214.286
02/08/2021 13:00,58.7,37938,2549,182,260,2197,20,5208,5.218.214.286
02/08/2021 14:00,58.57,37723,2535,183,286,2155,25,5184,5.218.214.286
02/08/2021 15:00,58.56,37452,2455,175,296,2090,27,5043,5.218.214.286
02/08/2021 16:00,58.53,37493,2364,155,279,1980,27,4805,5.218.214.286
02/08/2021 17:00,58.82,37296,2264,136,254,1798,24,4476,5.218.214.286
02/08/2021 18:00,58.94,36854,2057,127,231,1648,17,4080,5.218.214.286
02/08/2021 19:00,58.98,36168,1808,113,219,1644,17,3801,5.218.214.286
02/08/2021 20:00,58.76,35873,1679,99,225,1821,16,3840,5.218.214.286
02/08/2021 21:00,58.09,35118,1596,82,235,2116,12,4041,5.218.214.286
02/08/2021 22:00,56.23,33642,1522,73,234,2382,13,4224,5.218.214.286
02/08/2021 23:00,57.2,32219,1560,58,211,2551,12,4392,5.218.214.286
03/08/2021 00:00,56.34,31550,1507,54,205,2745,16,4527,5.218.214.286
03/08/2021 01:00,55.09,31016,1418,49,187,2859,17,4530,5.218.214.286
03/08/2021 02:00,54.74,30644,1352,42,161,2878,19,4452,5.218.214.286
03/08/2021 03:00,54.78,30708,1376,39,141,2856,18,4430,5.218.214.286
03/08/2021 04:00,56.86,31734,1347,35,123,2665,18,4188,5.218.214.286
03/08/2021 05:00,58.63,33820,1255,25,106,2278,19,3683,5.218.214.286
03/08/2021 06:00,59.71,36300,1169,13,98,1898,18,3196,5.218.214.286
03/08/2021 07:00,60.02,37813,1176,8,107,1715,17,3023,5.218.214.286
03/08/2021 08:00,60.33,38608,1220,6,124,1694,16,3060,5.218.214.286
03/08/2021 09:00,60.82,39124,1241,5,154,1718,14,3132,5.218.214.286
03/08/2021 10:00,60.47,39124,1173,7,182,1738,14,3114,5.218.214.286
03/08/2021 11:00,59.96,38755,1084,11,192,1758,14,3059,5.218.214.286
03/08/2021 12:00,59.84,38784,1051,16,189,1781,15,3052,5.218.214.286
03/08/2021 13:00,59.97,38568,1026,20,174,1819,18,3057,5.218.214.286
03/08/2021 14:00,59.83,38115,1013,28,153,1840,15,3049,5.218.214.286
03/08/2021 15:00,59.79,37734,960,31,123,1828,14,2956,5.218.214.286
03/08/2021 16:00,60.13,37931,897,33,88,1720,14,2752,5.218.214.286
03/08/2021 17:00,60.69,37612,765,36,61,1529,11,2402,5.218.214.286
03/08/2021 18:00,60.74,37167,618,35,39,1329,8,2029,5.218.214.286
03/08/2021 19:00,60.05,36557,490,38,23,1256,6,1813,5.218.214.286
03/08/2021 20:00,59.44,36207,403,46,16,1342,6,1813,5.218.214.286
03/08/2021 21:00,59.05,35436,359,52,13,1504,6,1934,5.218.214.286
03/08/2021 22:00,58.11,33745,345,54,11,1640,6,2056,5.218.214.286
03/08/2021 23:00,58.11,31991,348,58,7,1743,3,2159,5.218.214.286
04/08/2021 00:00,57.83,31401,316,63,6,1717,3,2105,5.218.214.286
04/08/2021 01:00,57.6,30891,307,69,4,1633,3,2016,5.218.214.286
04/08/2021 02:00,57.56,30548,299,73,4,1528,4,1908,5.218.214.286
04/08/2021 03:00,57.81,30554,282,79,5,1408,4,1778,5.218.214.286
04/08/2021 04:00,58.36,31563,243,88,7,1198,6,1542,5.218.214.286
04/08/2021 05:00,60.04,33629,201,102,10,925,7,1245,5.218.214.286
04/08/2021 06:00,61.1,36217,177,112,13,733,5,1040,5.218.214.286
04/08/2021 07:00,62.19,37858,175,120,11,704,3,1013,5.218.214.286
04/08/2021 08:00,63.16,38765,183,122,9,787,3,1104,5.218.214.286
04/08/2021 09:00,63.44,39223,194,126,9,901,3,1233,5.218.214.286
04/08/2021 10:00,63.17,39256,196,126,7,971,3,1303,5.218.214.286
04/08/2021 11:00,62.79,39108,184,122,8,986,3,1303,5.218.214.286
04/08/2021 12:00,63.1,38866,179,119,9,975,3,1285,5.218.214.286
04/08/2021 13:00,62.23,38660,163,119,8,952,3,1245,5.218.214.286
04/08/2021 14:00,62.25,38587,148,119,7,887,3,1164,5.218.214.286
04/08/2021 15:00,62.66,38269,151,118,7,802,4,1082,5.218.214.286
04/08/2021 16:00,63.97,38215,148,111,9,692,4,964,5.218.214.286
04/08/2021 17:00,64.94,38122,153,97,9,567,4,830,5.218.214.286
04/08/2021 18:00,66.53,37522,145,81,10,482,6,724,5.218.214.286
04/08/2021 19:00,63.79,36827,126,68,17,475,5,691,5.218.214.286
04/08/2021 20:00,61.98,36705,120,60,27,543,8,758,5.218.214.286
04/08/2021 21:00,61.52,35949,125,50,32,623,10,840,5.218.214.286
04/08/2021 22:00,59.5,33889,140,42,34,658,10,884,5.218.214.286
04/08/2021 23:00,59.93,32203,97,37,28,811,13,986,5.218.214.286
05/08/2021 00:00,59.62,31504,117,31,24,812,10,994,5.218.214.286
05/08/2021 01:00,59.33,31070,132,26,19,780,9,966,5.218.214.286
05/08/2021 02:00,59.18,30669,153,23,18,701,11,906,5.218.214.286
05/08/2021 03:00,59.26,30664,177,22,19,624,9,851,5.218.214.286
05/08/2021 04:00,59.83,31780,206,21,19,544,10,800,5.218.214.286
05/08/2021 05:00,61.9,34131,236,16,16,472,9,749,5.218.214.286
05/08/2021 06:00,62.75,36328,273,11,13,422,9,728,5.218.214.286
05/08/2021 07:00,63.79,38165,316,10,14,425,5,770,5.218.214.286
05/08/2021 08:00,64.04,39123,346,10,17,532,6,911,5.218.214.286
05/08/2021 09:00,63.9,39423,402,9,22,702,6,1141,5.218.214.286
05/08/2021 10:00,63.77,39620,495,9,26,866,6,1402,5.218.214.286
05/08/2021 11:00,63.12,39073,612,10,25,1021,5,1673,5.218.214.286
05/08/2021 12:00,63.84,39449,699,11,26,1122,5,1863,5.218.214.286
05/08/2021 13:00,63.04,39298,727,11,31,1164,6,1939,5.218.214.286
05/08/2021 14:00,62.88,38732,772,11,36,1179,7,2005,5.218.214.286
05/08/2021 15:00,62.76,38015,805,10,45,1152,9,2021,5.218.214.286
05/08/2021 16:00,63.2,38149,910,8,58,1072,10,2058,5.218.214.286
05/08/2021 17:00,64.81,38372,1061,6,71,1010,11,2159,5.218.214.286
05/08/2021 18:00,64.72,37969,1173,4,90,1037,9,2313,5.218.214.286
05/08/2021 19:00,62.08,37296,1214,4,124,1250,11,2603,5.218.214.286
05/08/2021 20:00,61.82,36327,1317,5,157,1658,13,3150,5.218.214.286
05/08/2021 21:00,60.59,35472,1532,6,180,2085,14,3817,5.218.214.286
05/08/2021 22:00,59.12,33599,1725,8,191,2248,16,4188,5.218.214.286
05/08/2021 23:00,60.24,32415,2017,5,203,2167,20,4412,5.218.214.286
06/08/2021 00:00,58.99,31651,2077,6,206,2070,20,4379,5.218.214.286
06/08/2021 01:00,58.17,31267,2141,5,207,1964,21,4338,5.218.214.286
06/08/2021 02:00,57.98,30852,2199,5,212,1866,20,4302,5.218.214.286
06/08/2021 03:00,58.22,30884,2262,5,221,1802,21,4311,5.218.214.286
06/08/2021 04:00,59.32,32127,2312,4,234,1700,18,4268,5.218.214.286
06/08/2021 05:00,60.95,34180,2245,4,253,1494,12,4008,5.218.214.286
06/08/2021 06:00,62.67,36444,2202,3,271,1240,11,3727,5.218.214.286
06/08/2021 07:00,62.74,38397,2324,3,299,1198,9,3833,5.218.214.286
06/08/2021 08:00,62.93,39087,2472,3,322,1432,20,4249,5.218.214.286
06/08/2021 09:00,62.76,39515,2647,3,336,1737,31,4754,5.218.214.286
06/08/2021 10:00,62.34,39556,2684,3,344,1972,36,5039,5.218.214.286
06/08/2021 11:00,61.94,39256,2735,4,342,2102,36,5219,5.218.214.286
06/08/2021 12:00,59.86,38932,2936,7,324,2174,38,5479,5.218.214.286
06/08/2021 13:00,56.12,38302,3095,10,302,2195,38,5640,5.218.214.286
06/08/2021 14:00,56.85,38017,3254,14,284,2207,34,5793,5.218.214.286
06/08/2021 15:00,59.68,37894,3437,17,258,2238,23,5973,5.218.214.286
06/08/2021 16:00,61.95,37797,3777,18,228,2210,18,6251,5.218.214.286
06/08/2021 17:00,62.91,37635,3968,18,208,2129,14,6337,5.218.214.286
06/08/2021 18:00,62.89,36668,3803,21,198,2065,14,6101,5.218.214.286
06/08/2021 19:00,61.16,36096,3473,31,190,2152,13,5859,5.218.214.286
06/08/2021 20:00,60.97,35932,3158,36,182,2319,18,5713,5.218.214.286
06/08/2021 21:00,60.03,35242,3065,39,175,2401,20,5700,5.218.214.286
06/08/2021 22:00,56.92,33550,3043,39,162,2363,20,5627,5.218.214.286
06/08/2021 23:00,58.18,31612,3103,137,144,2291,19,5694,5.218.214.286
07/08/2021 00:00,55.79,31028,2811,137,114,2180,13,5255,5.218.214.286
07/08/2021 01:00,54.18,30360,2403,127,85,2091,12,4718,5.218.214.286
07/08/2021 02:00,52.16,29946,2013,115,63,2006,12,4209,5.218.214.286
07/08/2021 03:00,52.16,29913,1727,99,46,1934,11,3817,5.218.214.286
07/08/2021 04:00,54.43,29684,1490,84,33,1824,9,3440,5.218.214.286
07/08/2021 05:00,55.01,30313,1352,69,25,1651,7,3104,5.218.214.286
07/08/2021 06:00,57.98,31605,1295,61,23,1401,6,2786,5.218.214.286
07/08/2021 07:00,58.61,33319,1300,58,26,1358,5,2747,5.218.214.286
07/08/2021 08:00,57.44,35083,1336,57,29,1721,4,3147,5.218.214.286
07/08/2021 09:00,55.92,35701,1427,60,38,2319,4,3848,5.218.214.286
07/08/2021 10:00,53.55,35735,1407,68,52,2833,4,4364,5.218.214.286
07/08/2021 11:00,53.15,35750,1213,76,71,3147,3,4510,5.218.214.286
07/08/2021 12:00,50.38,35466,1012,82,108,3315,3,4520,5.218.214.286
07/08/2021 13:00,51.22,35357,812,85,169,3355,3,4424,5.218.214.286
07/08/2021 14:00,55.25,35219,643,81,217,3336,3,4280,5.218.214.286
07/08/2021 15:00,57.88,35079,483,73,236,3242,4,4038,5.218.214.286
07/08/2021 16:00,60.28,35607,397,63,231,3059,4,3754,5.218.214.286
07/08/2021 17:00,62.03,34452,341,50,206,2854,6,3457,5.218.214.286
07/08/2021 18:00,61.93,33765,306,42,182,2747,6,3283,5.218.214.286
07/08/2021 19:00,61.26,33192,307,40,160,2789,7,3303,5.218.214.286
07/08/2021 20:00,60.41,33013,398,46,138,2891,9,3482,5.218.214.286
07/08/2021 21:00,57.99,33913,518,57,120,2980,13,3688,5.218.214.286
07/08/2021 22:00,53.93,32587,666,66,109,3023,13,3877,5.218.214.286
07/08/2021 23:00,30.53,31043,595,67,66,3273,17,4018,5.218.214.286
08/08/2021 00:00,17,30488,662,73,71,3276,12,4094,5.218.214.286
08/08/2021 01:00,7.92,30024,657,81,79,3325,8,4150,5.218.214.286
08/08/2021 02:00,4.31,29670,675,90,96,3394,8,4263,5.218.214.286
08/08/2021 03:00,2.11,29373,759,93,115,3432,7,4406,5.218.214.286
08/08/2021 04:00,1.49,29414,889,99,125,3414,6,4533,5.218.214.286
08/08/2021 05:00,1.48,30002,1005,95,118,3298,7,4523,5.218.214.286
08/08/2021 06:00,2.23,29830,1112,113,99,3266,6,4596,5.218.214.286
08/08/2021 07:00,4.43,31193,1292,117,89,3385,6,4889,5.218.214.286
08/08/2021 08:00,19.4,32508,1448,116,84,3555,5,5208,5.218.214.286
08/08/2021 09:00,26.42,33214,1660,109,83,3652,6,5510,5.218.214.286
08/08/2021 10:00,28.71,33754,1859,114,83,3622,6,5684,5.218.214.286
08/08/2021 11:00,26.22,33781,2027,138,84,3592,7,5848,5.218.214.286
08/08/2021 12:00,29.27,33685,2265,160,87,3520,6,6038,5.218.214.286
08/08/2021 13:00,27.8,33894,2402,170,107,3314,4,5997,5.218.214.286
08/08/2021 14:00,29.28,33724,2646,172,134,3046,4,6002,5.218.214.286
08/08/2021 15:00,26.97,34042,2810,167,146,2771,6,5900,5.218.214.286
08/08/2021 16:00,40.37,34603,2952,156,147,2504,6,5765,5.218.214.286
08/08/2021 17:00,50.37,34892,2944,131,141,2286,10,5512,5.218.214.286
08/08/2021 18:00,59.75,35432,2828,104,129,2172,7,5240,5.218.214.286
08/08/2021 19:00,60.6,34779,2615,85,110,2137,8,4955,5.218.214.286
08/08/2021 20:00,62.31,34935,2362,75,97,2121,7,4662,5.218.214.286
08/08/2021 21:00,60.8,34211,2263,72,95,2108,9,4547,5.218.214.286
08/08/2021 22:00,56.13,32736,2350,70,96,2014,9,4539,5.218.214.286
08/08/2021 23:00,44.51,31249,2061,43,93,1603,13,3813,5.218.214.286
09/08/2021 00:00,34.76,30426,2127,46,73,1526,13,3785,5.172.678.571
09/08/2021 01:00,30.05,30339,2121,47,54,1456,13,3691,5.172.678.571
09/08/2021 02:00,29.18,30166,2076,47,45,1394,13,3575,5.172.678.571
09/08/2021 03:00,39.91,30562,2066,46,40,1318,11,3481,5.172.678.571
09/08/2021 04:00,53.85,31789,2079,46,37,1243,10,3415,5.172.678.571
09/08/2021 05:00,63.81,33893,2069,40,42,1167,10,3328,5.172.678.571
09/08/2021 06:00,67.5,36824,2156,37,48,1162,9,3412,5.172.678.571
09/08/2021 07:00,69.98,38312,2301,45,52,1249,10,3657,5.172.678.571
09/08/2021 08:00,66.96,38872,2480,65,54,1408,11,4018,5.172.678.571
09/08/2021 09:00,63.76,39530,2697,86,50,1559,10,4402,5.172.678.571
09/08/2021 10:00,62.74,39605,2741,103,32,1659,10,4545,5.172.678.571
09/08/2021 11:00,61.92,39610,2629,119,28,1731,10,4517,5.172.678.571
09/08/2021 12:00,61.42,39428,2558,132,30,1782,13,4515,5.172.678.571
09/08/2021 13:00,61.66,39314,2550,146,34,1820,15,4565,5.172.678.571
09/08/2021 14:00,61.27,38986,2414,156,35,1842,17,4464,5.172.678.571
09/08/2021 15:00,62.59,38468,2175,161,35,1806,16,4193,5.172.678.571
09/08/2021 16:00,69.63,38443,1874,164,33,1724,10,3805,5.172.678.571
09/08/2021 17:00,74.91,38122,1469,162,26,1589,7,3253,5.172.678.571
09/08/2021 18:00,77.74,37462,1310,156,19,1483,7,2975,5.172.678.571
09/08/2021 19:00,69.68,37572,1112,156,17,1475,7,2767,5.172.678.571
09/08/2021 20:00,67.54,36741,1000,157,20,1526,9,2712,5.172.678.571
09/08/2021 21:00,65.85,35810,978,158,26,1594,11,2767,5.172.678.571
09/08/2021 22:00,63.27,34896,849,158,34,1609,13,2663,5.172.678.571
09/08/2021 23:00,65.91,33074,962,37,37,1479,14,2529,5.172.678.571
10/08/2021 00:00,65.42,32598,965,40,49,1388,14,2456,5.172.678.571
10/08/2021 01:00,64.2,32254,906,40,55,1279,14,2294,5.172.678.571
10/08/2021 02:00,62.76,32122,839,39,58,1157,13,2106,5.172.678.571
10/08/2021 03:00,64.44,32230,830,43,59,1035,10,1977,5.172.678.571
10/08/2021 04:00,66.54,33295,845,47,55,901,11,1859,5.172.678.571
10/08/2021 05:00,68.74,35597,839,51,46,754,8,1698,5.172.678.571
10/08/2021 06:00,71.79,38204,853,51,34,631,7,1576,5.172.678.571
10/08/2021 07:00,74.1,39658,862,58,28,572,8,1528,5.172.678.571
10/08/2021 08:00,74.78,40195,862,61,21,603,8,1555,5.172.678.571
10/08/2021 09:00,73.07,40590,868,62,21,667,8,1626,5.172.678.571
10/08/2021 10:00,71.17,40618,857,62,28,733,7,1687,5.172.678.571
10/08/2021 11:00,71.17,40400,906,60,37,809,8,1820,5.172.678.571
10/08/2021 12:00,69.91,40165,988,57,42,851,9,1947,5.172.678.571
10/08/2021 13:00,69.93,39904,993,52,45,868,9,1967,5.172.678.571
10/08/2021 14:00,69.34,39520,1000,51,42,855,9,1957,5.172.678.571
10/08/2021 15:00,69.87,39287,1013,54,33,807,8,1915,5.172.678.571
10/08/2021 16:00,72.51,39340,959,50,23,737,6,1775,5.172.678.571
10/08/2021 17:00,78.02,38916,836,46,23,667,6,1578,5.172.678.571
10/08/2021 18:00,78.08,38462,778,43,23,632,6,1482,5.172.678.571
10/08/2021 19:00,72.43,37788,622,43,23,694,6,1388,5.172.678.571
10/08/2021 20:00,71.59,37415,529,45,30,840,6,1450,5.172.678.571
10/08/2021 21:00,69.93,36361,556,47,46,985,6,1640,5.172.678.571
10/08/2021 22:00,67.66,34307,593,48,52,1030,6,1729,5.172.678.571
10/08/2021 23:00,70.75,33111,763,56,56,974,8,1857,5.172.678.571
11/08/2021 00:00,69.51,31291,840,54,45,935,7,1881,5.172.678.571
11/08/2021 01:00,68.77,31295,865,53,31,869,7,1825,5.172.678.571
11/08/2021 02:00,68.32,31356,847,51,25,849,7,1779,5.172.678.571
11/08/2021 03:00,68.64,30199,822,49,25,857,6,1759,5.172.678.571
11/08/2021 04:00,71.29,31353,788,47,23,832,6,1696,5.172.678.571
11/08/2021 05:00,73.49,33964,736,42,22,748,6,1554,5.172.678.571
11/08/2021 06:00,75.35,36824,703,34,26,640,6,1409,5.172.678.571
11/08/2021 07:00,77.08,38320,682,30,31,575,6,1324,5.172.678.571
11/08/2021 08:00,76.61,38972,695,32,33,605,6,1371,5.172.678.571
11/08/2021 09:00,75.82,39327,714,33,39,681,6,1473,5.172.678.571
11/08/2021 10:00,74.5,39298,710,34,53,773,6,1576,5.172.678.571
11/08/2021 11:00,73.15,39079,721,36,62,861,6,1686,5.172.678.571
11/08/2021 12:00,72.61,38927,761,37,72,958,6,1834,5.172.678.571
11/08/2021 13:00,71.9,38828,796,35,84,1049,6,1970,5.172.678.571
11/08/2021 14:00,71.92,38514,840,33,77,1101,7,2058,5.172.678.571
11/08/2021 15:00,73.14,38296,848,25,67,1116,7,2063,5.172.678.571
11/08/2021 16:00,75.66,38326,814,19,63,1038,8,1942,5.172.678.571
11/08/2021 17:00,77.65,38084,728,18,62,914,7,1729,5.172.678.571
11/08/2021 18:00,76.32,37555,627,16,63,829,7,1542,5.172.678.571
11/08/2021 19:00,73.52,36779,498,15,65,918,7,1503,5.172.678.571
11/08/2021 20:00,74.37,36605,434,20,72,1111,6,1643,5.172.678.571
11/08/2021 21:00,73.25,35420,448,25,78,1317,7,1875,5.172.678.571
11/08/2021 22:00,70.82,33284,458,26,77,1444,7,2012,5.172.678.571
11/08/2021 23:00,71.81,31601,500,16,84,1375,8,1983,5.172.678.571
12/08/2021 00:00,71.22,32071,551,17,74,1388,7,2037,5.172.678.571
12/08/2021 01:00,70.6,32050,590,15,65,1373,9,2052,5.172.678.571
12/08/2021 02:00,69.99,32317,646,13,64,1335,11,2069,5.172.678.571
12/08/2021 03:00,70.34,31184,678,13,64,1302,8,2065,5.172.678.571
12/08/2021 04:00,72.04,32240,666,11,58,1159,8,1902,5.172.678.571
12/08/2021 05:00,74.5,34863,675,9,56,936,9,1685,5.172.678.571
12/08/2021 06:00,75.18,37449,650,7,55,725,10,1447,5.172.678.571
12/08/2021 07:00,79.74,39114,648,4,61,629,10,1352,5.172.678.571
12/08/2021 08:00,78.4,39779,621,3,74,678,8,1384,5.172.678.571
12/08/2021 09:00,76.22,40367,610,3,89,749,8,1459,5.172.678.571
12/08/2021 10:00,75.37,40345,631,3,106,807,7,1554,5.172.678.571
12/08/2021 11:00,74.48,40166,682,3,132,871,9,1697,5.172.678.571
12/08/2021 12:00,74.01,40195,808,3,164,939,10,1924,5.172.678.571
12/08/2021 13:00,74.02,39881,875,4,182,993,12,2066,5.172.678.571
12/08/2021 14:00,74.22,39499,873,5,190,1004,12,2084,5.172.678.571
12/08/2021 15:00,74.77,39274,844,6,186,971,11,2018,5.172.678.571
12/08/2021 16:00,76.12,39338,853,7,172,907,11,1950,5.172.678.571
12/08/2021 17:00,75.75,39096,737,8,146,812,11,1714,5.172.678.571
12/08/2021 18:00,75.88,38558,677,9,117,723,10,1536,5.172.678.571
12/08/2021 19:00,74.53,37815,635,11,98,809,8,1561,5.172.678.571
12/08/2021 20:00,74.22,37543,654,13,89,997,8,1761,5.172.678.571
12/08/2021 21:00,73.24,36340,767,16,84,1206,8,2081,5.172.678.571
12/08/2021 22:00,71.52,34584,793,17,78,1332,8,2228,5.172.678.571
12/08/2021 23:00,72.43,32533,842,14,79,1475,6,2416,5.172.678.571
13/08/2021 00:00,70.76,31901,795,14,71,1489,7,2376,5.172.678.571
13/08/2021 01:00,70.49,31787,743,12,58,1451,8,2272,5.172.678.571
13/08/2021 02:00,70.42,31858,740,11,49,1387,7,2194,5.172.678.571
13/08/2021 03:00,70.53,30815,754,12,45,1302,6,2119,5.172.678.571
13/08/2021 04:00,70.99,31892,717,13,47,1177,4,1958,5.172.678.571
13/08/2021 05:00,71.09,34274,677,12,45,1016,4,1754,5.172.678.571
13/08/2021 06:00,72.71,37087,704,10,36,845,5,1600,5.172.678.571
13/08/2021 07:00,74.63,38889,755,8,35,756,5,1559,5.172.678.571
13/08/2021 08:00,74.97,39356,899,7,36,816,5,1763,5.172.678.571
13/08/2021 09:00,74.94,39000,1084,9,37,955,5,2090,5.172.678.571
13/08/2021 10:00,73.63,38969,1341,11,39,1132,6,2529,5.172.678.571
13/08/2021 11:00,72.7,39354,1649,15,38,1298,7,3007,5.172.678.571
13/08/2021 12:00,71.4,38299,2010,18,38,1438,8,3512,5.172.678.571
13/08/2021 13:00,69.83,39890,2307,21,40,1548,7,3923,5.172.678.571
13/08/2021 14:00,69.7,39459,2433,24,39,1604,9,4109,5.172.678.571
13/08/2021 15:00,70.4,39246,2540,28,34,1615,9,4226,5.172.678.571
13/08/2021 16:00,71.91,37282,2987,29,27,1569,5,4617,5.172.678.571
13/08/2021 17:00,73.01,37562,3195,29,23,1492,6,4745,5.172.678.571
13/08/2021 18:00,72.1,36191,3185,30,27,1513,6,4761,5.172.678.571
13/08/2021 19:00,71.22,36012,2961,36,45,1667,6,4715,5.172.678.571
13/08/2021 20:00,71.69,35781,2752,43,84,1894,7,4780,5.172.678.571
13/08/2021 21:00,70.52,34784,2703,48,132,2120,9,5012,5.172.678.571
13/08/2021 22:00,68.36,33066,2560,48,173,2255,12,5048,5.172.678.571
13/08/2021 23:00,68.66,31631,2726,147,213,2428,17,5531,5.172.678.571
14/08/2021 00:00,67.25,30636,2540,148,221,2423,20,5352,5.172.678.571
14/08/2021 01:00,66,30079,2304,150,221,2439,14,5128,5.172.678.571
14/08/2021 02:00,62.92,29887,2141,155,209,2476,14,4995,5.172.678.571
14/08/2021 03:00,61.73,29672,2050,163,188,2482,27,4910,5.172.678.571
14/08/2021 04:00,62.5,29709,2026,168,158,2501,20,4873,5.172.678.571
14/08/2021 05:00,65.07,30284,2047,174,126,2539,14,4900,5.172.678.571
14/08/2021 06:00,67.48,31667,2198,172,105,2627,13,5115,5.172.678.571
14/08/2021 07:00,67.74,33450,2526,164,112,2793,16,5611,5.172.678.571
14/08/2021 08:00,67.72,34936,3037,154,125,2967,21,6304,5.172.678.571
14/08/2021 09:00,65.19,35766,3518,144,144,3158,20,6984,5.172.678.571
14/08/2021 10:00,58.74,35978,3752,131,172,3377,23,7455,5.172.678.571
14/08/2021 11:00,54.13,35854,3863,117,205,3653,24,7862,5.172.678.571
14/08/2021 12:00,50.25,35664,3990,103,237,3938,25,8293,5.172.678.571
14/08/2021 13:00,31.34,35476,4192,90,244,4090,27,8643,5.172.678.571
14/08/2021 14:00,40.45,35413,4382,77,237,4107,31,8834,5.172.678.571
14/08/2021 15:00,52.52,35503,4490,65,223,4054,30,8862,5.172.678.571
14/08/2021 16:00,62.97,35958,4856,53,208,3937,32,9086,5.172.678.571
14/08/2021 17:00,66.87,36014,4727,44,178,3787,32,8768,5.172.678.571
14/08/2021 18:00,67.62,35562,4415,35,150,3668,31,8299,5.172.678.571
14/08/2021 19:00,67.91,34913,4075,32,138,3625,29,7899,5.172.678.571
14/08/2021 20:00,69.16,34846,3750,30,150,3639,31,7600,5.172.678.571
14/08/2021 21:00,68.06,33988,3653,30,178,3641,39,7541,5.172.678.571
14/08/2021 22:00,66.93,32519,3564,31,212,3632,44,7483,5.172.678.571
14/08/2021 23:00,64.38,32653,3366,26,236,3646,47,7321,5.172.678.571
15/08/2021 00:00,60.09,31746,3249,28,275,3633,45,7230,5.172.678.571
15/08/2021 01:00,58.18,30973,3090,31,288,3639,40,7088,5.172.678.571
15/08/2021 02:00,54.76,30305,3077,32,285,3634,38,7066,5.172.678.571
15/08/2021 03:00,52.14,30149,3078,36,276,3620,38,7048,5.172.678.571
15/08/2021 04:00,53.89,30195,2985,39,256,3581,39,6900,5.172.678.571
15/08/2021 05:00,54.99,30628,2751,38,240,3536,39,6604,5.172.678.571
15/08/2021 06:00,54.94,31633,2578,39,234,3521,40,6412,5.172.678.571
15/08/2021 07:00,55,33126,2625,39,253,3599,41,6557,5.172.678.571
15/08/2021 08:00,51.54,34620,2704,38,273,3695,44,6754,5.172.678.571
15/08/2021 09:00,52.15,35413,2714,38,298,3757,44,6851,5.172.678.571
15/08/2021 10:00,51.92,34675,2660,33,324,3804,47,6868,5.172.678.571
15/08/2021 11:00,52.09,34661,2533,28,338,3854,46,6799,5.172.678.571
15/08/2021 12:00,48.23,34700,2469,23,332,3895,47,6766,5.172.678.571
15/08/2021 13:00,45.67,34707,2326,20,318,3938,48,6650,5.172.678.571
15/08/2021 14:00,50.02,34697,2096,17,316,3875,47,6351,5.172.678.571
15/08/2021 15:00,55.93,35047,1881,15,315,3679,48,5938,5.172.678.571
15/08/2021 16:00,67.1,36961,1647,15,296,3379,46,5383,5.172.678.571
15/08/2021 17:00,69.69,37373,1246,22,259,3075,45,4647,5.172.678.571
15/08/2021 18:00,71.17,36935,914,29,216,2845,43,4047,5.172.678.571
15/08/2021 19:00,72.4,36383,658,39,182,2737,40,3656,5.172.678.571
15/08/2021 20:00,73.77,36846,492,52,158,2655,36,3393,5.172.678.571
15/08/2021 21:00,72.78,35662,464,58,143,2557,35,3257,5.172.678.571
15/08/2021 22:00,68.89,33905,489,62,131,2420,32,3134,5.172.678.571
15/08/2021 23:00,67.74,32007,1050,52,108,2213,21,3444,5.172.678.571
16/08/2021 00:00,65.86,31768,1170,47,93,2046,19,3375,516.452.381
16/08/2021 01:00,63.66,31249,1233,43,81,1916,14,3287,516.452.381
16/08/2021 02:00,61.94,31186,1157,41,81,1815,10,3104,516.452.381
16/08/2021 03:00,64.88,31705,1218,38,86,1753,8,3103,516.452.381
16/08/2021 04:00,67.83,33046,1257,36,95,1668,8,3064,516.452.381
16/08/2021 05:00,74.07,36051,1105,33,100,1566,9,2813,516.452.381
16/08/2021 06:00,77.05,38551,996,30,95,1500,9,2630,516.452.381
16/08/2021 07:00,77.88,40322,880,31,93,1412,8,2424,516.452.381
16/08/2021 08:00,77.71,40687,803,35,104,1383,14,2339,516.452.381
16/08/2021 09:00,75.48,41190,806,42,134,1351,14,2347,516.452.381
16/08/2021 10:00,73.76,41446,1001,50,177,1303,13,2544,516.452.381
16/08/2021 11:00,72.51,41657,1346,57,212,1274,14,2903,516.452.381
16/08/2021 12:00,71.39,41227,1499,65,216,1279,9,3068,516.452.381
16/08/2021 13:00,69.55,41032,1559,67,187,1303,9,3125,516.452.381
16/08/2021 14:00,67.81,40719,1688,62,153,1307,7,3217,516.452.381
16/08/2021 15:00,67.77,40447,1832,54,144,1310,9,3349,516.452.381
16/08/2021 16:00,70,40555,1984,49,149,1308,12,3502,516.452.381
16/08/2021 17:00,70.01,40057,2014,43,134,1292,6,3489,516.452.381
16/08/2021 18:00,73.27,39415,2054,45,132,1356,5,3592,516.452.381
16/08/2021 19:00,72.66,38918,2120,50,129,1465,6,3770,516.452.381
16/08/2021 20:00,72.53,38506,2245,60,116,1616,5,4042,516.452.381
16/08/2021 21:00,67.9,37291,2417,72,93,1745,5,4332,516.452.381
16/08/2021 22:00,62.89,35027,2467,83,79,1799,5,4433,516.452.381
16/08/2021 23:00,62.22,33276,2112,128,62,1588,5,3895,516.452.381
17/08/2021 00:00,60.3,32340,2158,121,49,1677,6,4011,516.452.381
17/08/2021 01:00,48.44,31961,2178,115,35,1806,6,4140,516.452.381
17/08/2021 02:00,38.89,31868,2208,103,28,1975,5,4319,516.452.381
17/08/2021 03:00,37.15,31973,2315,88,24,2160,5,4592,516.452.381
17/08/2021 04:00,50.09,33177,2369,81,27,2318,7,4802,516.452.381
17/08/2021 05:00,65.23,35935,2374,72,36,2420,6,4908,516.452.381
17/08/2021 06:00,69.76,38974,2562,68,51,2487,6,5174,516.452.381
17/08/2021 07:00,70.21,40951,2889,67,86,2584,7,5633,516.452.381
17/08/2021 08:00,68.41,41370,3304,66,117,2765,6,6258,516.452.381
17/08/2021 09:00,67.95,41928,3749,60,157,2918,7,6891,516.452.381
17/08/2021 10:00,66.99,41720,4028,53,208,3018,6,7313,516.452.381
17/08/2021 11:00,66.26,41617,4188,52,243,3130,5,7618,516.452.381
17/08/2021 12:00,65.68,41399,4401,50,268,3264,5,7988,516.452.381
17/08/2021 13:00,65.05,40256,4633,46,290,3380,5,8354,516.452.381
17/08/2021 14:00,65.28,39926,4655,39,308,3461,6,8469,516.452.381
17/08/2021 15:00,65.76,40904,4573,33,312,3509,8,8435,516.452.381
17/08/2021 16:00,68.71,41134,4899,30,304,3587,12,8832,516.452.381
17/08/2021 17:00,70.1,40661,4754,38,291,3642,13,8738,516.452.381
17/08/2021 18:00,71.17,40283,4455,52,295,3764,12,8578,516.452.381
17/08/2021 19:00,69.77,39276,4132,72,326,4050,14,8594,516.452.381
17/08/2021 20:00,69.04,38680,3992,85,354,4393,20,8844,516.452.381
17/08/2021 21:00,66.07,37841,4055,93,378,4688,29,9243,516.452.381
17/08/2021 22:00,62.55,35504,4121,89,400,4944,37,9591,516.452.381
17/08/2021 23:00,54.38,34070,4173,89,387,5205,28,9882,516.452.381
18/08/2021 00:00,47.48,32949,4050,89,390,5589,21,10139,516.452.381
18/08/2021 01:00,39.43,32530,3923,82,399,5980,27,10411,516.452.381
18/08/2021 02:00,39.09,32533,3876,73,406,6336,31,10722,516.452.381
18/08/2021 03:00,40.03,32519,3854,68,407,6632,27,10988,516.452.381
18/08/2021 04:00,53.9,33860,3760,60,408,6826,17,11071,516.452.381
18/08/2021 05:00,63.17,36768,3581,50,414,6915,13,10973,516.452.381
18/08/2021 06:00,66.91,39763,3608,39,430,6884,13,10974,516.452.381
18/08/2021 07:00,69,41506,3835,33,446,6769,20,11103,516.452.381
18/08/2021 08:00,67.63,42033,4239,31,459,6630,22,11381,516.452.381
18/08/2021 09:00,67.82,41873,4568,29,463,6421,18,11499,516.452.381
18/08/2021 10:00,68.28,42078,4765,28,457,6126,27,11403,516.452.381
18/08/2021 11:00,68.56,41969,4792,28,446,5780,24,11070,516.452.381
18/08/2021 12:00,66.94,41897,4879,32,435,5547,25,10918,516.452.381
18/08/2021 13:00,66.41,41342,5075,42,419,5391,33,10960,516.452.381
18/08/2021 14:00,66.27,40853,5053,57,401,5209,32,10752,516.452.381
18/08/2021 15:00,66.31,40877,4967,69,379,4983,29,10427,516.452.381
18/08/2021 16:00,67.56,41273,5329,75,348,4730,35,10517,516.452.381
18/08/2021 17:00,68.69,40990,5221,90,312,4476,37,10136,516.452.381
18/08/2021 18:00,68.12,40289,4845,101,281,4321,37,9585,516.452.381
18/08/2021 19:00,66.91,39633,4486,113,282,4207,41,9129,516.452.381
18/08/2021 20:00,66.91,39269,4263,130,305,4121,44,8863,516.452.381
18/08/2021 21:00,64.92,37835,4133,143,335,4026,44,8681,516.452.381
18/08/2021 22:00,58.87,35517,4041,144,355,3923,45,8508,516.452.381
18/08/2021 23:00,56.55,33872,4143,153,373,3710,29,8408,516.452.381
19/08/2021 00:00,55.31,33213,4080,158,377,3736,28,8379,516.452.381
19/08/2021 01:00,51.03,32691,3919,162,380,3780,37,8278,516.452.381
19/08/2021 02:00,48.34,32696,3803,166,387,3821,35,8212,516.452.381
19/08/2021 03:00,53.07,32926,3738,171,393,3843,33,8178,516.452.381
19/08/2021 04:00,55.51,34133,3614,179,400,3798,30,8021,516.452.381
19/08/2021 05:00,64.34,36908,3357,184,406,3690,25,7662,516.452.381
19/08/2021 06:00,69.62,40046,3248,189,407,3593,27,7464,516.452.381
19/08/2021 07:00,71.39,40830,3238,192,411,3563,28,7432,516.452.381
19/08/2021 08:00,70.93,41118,3472,189,412,3656,29,7758,516.452.381
19/08/2021 09:00,70.83,41442,3672,189,405,3724,32,8022,516.452.381
19/08/2021 10:00,71.58,41236,3765,193,386,3770,33,8147,516.452.381
19/08/2021 11:00,72.1,40888,3783,198,370,3899,33,8283,516.452.381
19/08/2021 12:00,71.92,40730,3873,200,366,4085,38,8562,516.452.381
19/08/2021 13:00,71.26,41514,4020,196,359,4261,36,8872,516.452.381
19/08/2021 14:00,70.16,40117,3931,201,354,4408,36,8930,516.452.381
19/08/2021 15:00,71.3,39970,3734,212,340,4466,35,8787,516.452.381
19/08/2021 16:00,72.95,40051,3836,218,307,4404,33,8798,516.452.381
19/08/2021 17:00,72.91,39590,3554,216,267,4239,27,8303,516.452.381
19/08/2021 18:00,72.99,39156,3128,206,229,4109,25,7697,516.452.381
19/08/2021 19:00,71.71,38475,2748,200,205,4144,19,7316,516.452.381
19/08/2021 20:00,71.38,38107,2537,199,206,4222,19,7183,516.452.381
19/08/2021 21:00,68.12,36682,2539,199,216,4304,20,7278,516.452.381
19/08/2021 22:00,65.22,34816,2510,201,222,4356,19,7308,516.452.381
19/08/2021 23:00,64.14,32915,2286,188,220,4435,17,7146,516.452.381
20/08/2021 00:00,62.37,33058,2143,178,226,4391,16,6954,516.452.381
20/08/2021 01:00,61.96,32885,1980,176,232,4293,20,6701,516.452.381
20/08/2021 02:00,63.18,33126,1838,176,232,4156,20,6422,516.452.381
20/08/2021 03:00,63.71,32677,1749,181,225,4007,21,6183,516.452.381
20/08/2021 04:00,62.96,34051,1651,182,213,3809,19,5874,516.452.381
20/08/2021 05:00,67.98,36910,1476,180,190,3519,19,5384,516.452.381
20/08/2021 06:00,74.06,39896,1351,170,164,3160,13,4858,516.452.381
20/08/2021 07:00,78.45,41545,1321,158,175,2975,14,4643,516.452.381
20/08/2021 08:00,78.59,41655,1456,146,185,3043,22,4852,516.452.381
20/08/2021 09:00,78.19,41804,1555,128,178,3084,23,4968,516.452.381
20/08/2021 10:00,76.99,41602,1653,131,168,3109,23,5084,516.452.381
20/08/2021 11:00,75.86,41160,1671,142,162,3192,21,5188,516.452.381
20/08/2021 12:00,74.01,40661,1731,154,156,3342,23,5406,516.452.381
20/08/2021 13:00,72.69,40132,1841,165,140,3532,23,5701,516.452.381
20/08/2021 14:00,70.09,39684,1866,172,123,3676,23,5860,516.452.381
20/08/2021 15:00,69.63,39388,1823,170,105,3745,23,5866,516.452.381
20/08/2021 16:00,69.46,39567,1902,162,83,3691,22,5860,516.452.381
20/08/2021 17:00,69.34,39143,1821,151,65,3585,14,5636,516.452.381
20/08/2021 18:00,70.1,38410,1635,141,59,3564,13,5412,516.452.381
20/08/2021 19:00,68.82,37584,1411,131,56,3683,10,5291,516.452.381
20/08/2021 20:00,69.35,37326,1274,128,56,3840,11,5309,516.452.381
20/08/2021 21:00,66.69,35996,1254,125,60,3959,10,5408,516.452.381
20/08/2021 22:00,64.82,34221,1228,117,65,4019,10,5439,516.452.381
20/08/2021 23:00,62.7,32285,1242,98,100,3898,10,5348,516.452.381
21/08/2021 00:00,62.09,32846,1184,107,110,3917,11,5329,516.452.381
21/08/2021 01:00,60.33,32238,1106,117,109,3932,12,5276,516.452.381
21/08/2021 02:00,59.9,32011,1007,121,111,3947,11,5197,516.452.381
21/08/2021 03:00,59.83,32559,919,128,116,3941,14,5118,516.452.381
21/08/2021 04:00,60.08,32733,845,131,110,3870,17,4973,516.452.381
21/08/2021 05:00,61.73,33396,744,130,100,3709,17,4700,516.452.381
21/08/2021 06:00,63.38,34808,657,131,91,3500,13,4392,516.452.381
21/08/2021 07:00,65.06,36487,580,137,101,3405,16,4239,516.452.381
21/08/2021 08:00,67.41,37817,595,143,117,3457,17,4329,516.452.381
21/08/2021 09:00,65.84,38399,590,138,130,3412,16,4286,516.452.381
21/08/2021 10:00,64.6,38338,590,119,139,3288,16,4152,516.452.381
21/08/2021 11:00,64.36,37270,541,120,151,3152,14,3978,516.452.381
21/08/2021 12:00,63.86,37023,481,124,158,3043,14,3820,516.452.381
21/08/2021 13:00,63.72,37000,418,127,156,2933,15,3649,516.452.381
21/08/2021 14:00,64.12,36793,352,129,151,2782,15,3429,516.452.381
21/08/2021 15:00,65.01,37579,301,128,137,2576,15,3157,516.452.381
21/08/2021 16:00,69.96,38195,280,126,115,2278,13,2812,516.452.381
21/08/2021 17:00,71.2,38147,248,119,89,1991,11,2458,516.452.381
21/08/2021 18:00,71.92,37695,187,115,70,1815,8,2195,516.452.381
21/08/2021 19:00,70.8,37211,126,125,64,1830,7,2152,516.452.381
21/08/2021 20:00,70.23,37071,103,134,65,1960,7,2269,516.452.381
21/08/2021 21:00,68.2,35900,97,140,63,2107,7,2414,516.452.381
21/08/2021 22:00,65.28,34295,103,146,56,2198,7,2510,516.452.381
21/08/2021 23:00,63.5,33354,199,150,60,2399,8,2816,516.452.381
22/08/2021 00:00,58.1,32076,259,146,50,2413,8,2876,516.452.381
22/08/2021 01:00,56.49,32125,299,136,36,2428,8,2907,516.452.381
22/08/2021 02:00,54.77,31323,348,144,27,2412,9,2940,516.452.381
22/08/2021 03:00,53.64,31213,410,152,22,2379,9,2972,516.452.381
22/08/2021 04:00,52.74,31252,461,153,19,2263,10,2906,516.452.381
22/08/2021 05:00,53.46,31657,525,162,18,2032,9,2746,516.452.381
22/08/2021 06:00,55.1,32681,604,169,21,1758,8,2560,516.452.381
22/08/2021 07:00,59.27,34162,656,177,26,1571,8,2438,516.452.381
22/08/2021 08:00,63.77,35474,779,190,25,1522,8,2524,516.452.381
22/08/2021 09:00,64.65,36390,897,201,27,1493,8,2626,516.452.381
22/08/2021 10:00,64.86,36814,975,205,31,1476,9,2696,516.452.381
22/08/2021 11:00,64.8,36732,957,201,36,1459,9,2662,516.452.381
22/08/2021 12:00,64.67,36340,984,199,41,1422,11,2657,516.452.381
22/08/2021 13:00,63.43,36212,1015,198,42,1378,11,2644,516.452.381
22/08/2021 14:00,63.69,36434,995,192,42,1334,10,2573,516.452.381
22/08/2021 15:00,65.03,36588,999,187,40,1267,9,2502,516.452.381
22/08/2021 16:00,66.67,37474,1109,183,38,1187,9,2526,516.452.381
22/08/2021 17:00,72.61,37878,1121,175,38,1078,8,2420,516.452.381
22/08/2021 18:00,77.06,36995,1070,163,42,1037,8,2320,516.452.381
22/08/2021 19:00,76.16,36762,1042,147,48,1153,8,2398,516.452.381
22/08/2021 20:00,75.92,36666,1046,136,54,1346,8,2590,516.452.381
22/08/2021 21:00,71.96,35432,1074,131,60,1553,8,2826,516.452.381
22/08/2021 22:00,65.29,33807,1055,123,64,1696,9,2947,516.452.381
22/08/2021 23:00,59.01,32464,998,113,50,1796,9,2966,516.452.381
23/08/2021 00:00,59.32,31136,993,110,51,1864,8,3026,5.117.916.667
23/08/2021 01:00,57.91,31548,972,108,46,1919,9,3054,5.117.916.667
23/08/2021 02:00,56.78,32090,950,99,46,1954,9,3058,5.117.916.667
23/08/2021 03:00,58.62,32615,939,86,48,1991,9,3073,5.117.916.667
23/08/2021 04:00,63.15,34257,899,80,47,1932,8,2966,5.117.916.667
23/08/2021 05:00,68.39,37302,822,79,42,1729,7,2679,5.117.916.667
23/08/2021 06:00,76.38,40292,734,76,35,1431,7,2283,5.117.916.667
23/08/2021 07:00,80.68,41883,593,75,27,1230,7,1932,5.117.916.667
23/08/2021 08:00,81.11,41917,463,77,19,1192,7,1758,5.117.916.667
23/08/2021 09:00,80.76,41988,375,77,19,1233,8,1712,5.117.916.667
23/08/2021 10:00,80,41904,339,80,20,1257,8,1704,5.117.916.667
23/08/2021 11:00,79.76,41458,297,82,22,1245,7,1653,5.117.916.667
23/08/2021 12:00,79.87,41399,313,81,27,1215,8,1644,5.117.916.667
23/08/2021 13:00,79.02,41301,360,75,31,1142,10,1618,5.117.916.667
23/08/2021 14:00,77.84,40980,396,68,35,1044,10,1553,5.117.916.667
23/08/2021 15:00,78.3,40606,414,58,41,923,11,1447,5.117.916.667
23/08/2021 16:00,80.99,40945,443,47,52,759,11,1312,5.117.916.667
23/08/2021 17:00,81.95,40590,463,39,71,596,11,1180,5.117.916.667
23/08/2021 18:00,82.44,40133,435,33,97,516,9,1090,5.117.916.667
23/08/2021 19:00,80.93,39582,372,30,126,527,10,1065,5.117.916.667
23/08/2021 20:00,80.01,39105,331,30,153,567,11,1092,5.117.916.667
23/08/2021 21:00,75.4,37647,299,31,161,611,14,1116,5.117.916.667
23/08/2021 22:00,70.03,35358,242,32,152,627,14,1067,5.117.916.667
23/08/2021 23:00,73.15,33857,194,71,151,416,13,845,5.117.916.667
24/08/2021 00:00,72.57,33263,156,72,136,433,12,809,5.117.916.667
24/08/2021 01:00,72.54,32538,135,74,122,454,14,799,5.117.916.667
24/08/2021 02:00,72.59,33501,112,76,120,483,16,807,5.117.916.667
24/08/2021 03:00,73.03,33213,98,80,118,521,16,833,5.117.916.667
24/08/2021 04:00,79.79,34658,93,84,112,543,12,844,5.117.916.667
24/08/2021 05:00,84.7,37648,89,85,100,558,12,844,5.117.916.667
24/08/2021 06:00,86.51,40594,94,87,83,562,11,837,5.117.916.667
24/08/2021 07:00,89.91,41599,94,89,81,565,11,840,5.117.916.667
24/08/2021 08:00,89.35,41967,104,85,93,623,14,919,5.117.916.667
24/08/2021 09:00,87.88,42148,121,82,100,767,16,1086,5.117.916.667
24/08/2021 10:00,85.97,41999,145,86,88,980,19,1318,5.117.916.667
24/08/2021 11:00,85.71,41736,171,94,86,1247,20,1618,5.117.916.667
24/08/2021 12:00,80.08,41594,216,102,88,1507,19,1932,5.117.916.667
24/08/2021 13:00,76.99,40211,271,110,87,1774,20,2262,5.117.916.667
24/08/2021 14:00,74.68,40131,335,113,88,2045,19,2600,5.117.916.667
24/08/2021 15:00,77.47,40030,412,111,83,2287,16,2909,5.117.916.667
24/08/2021 16:00,78.98,41376,504,107,78,2636,13,3338,5.117.916.667
24/08/2021 17:00,74.48,40771,550,103,78,3267,10,4008,5.117.916.667
24/08/2021 18:00,73.6,40418,549,99,81,3998,6,4733,5.117.916.667
24/08/2021 19:00,72.11,39984,577,95,79,4629,5,5385,5.117.916.667
24/08/2021 20:00,70.79,39338,692,100,80,5128,4,6004,5.117.916.667
24/08/2021 21:00,64.64,37667,892,105,76,5520,4,6597,5.117.916.667
24/08/2021 22:00,55.18,35133,1150,109,58,5742,4,7063,5.117.916.667
24/08/2021 23:00,50.01,33612,1963,116,29,6068,4,8180,5.117.916.667
25/08/2021 00:00,54.4,32773,2308,116,17,6192,7,8640,5.117.916.667
25/08/2021 01:00,52.46,33462,2565,119,11,6326,12,9033,5.117.916.667
25/08/2021 02:00,48.37,33349,2855,122,13,6370,19,9379,5.117.916.667
25/08/2021 03:00,46.9,32490,3277,122,22,6407,21,9849,5.117.916.667
25/08/2021 04:00,49.84,33811,3632,120,33,6431,19,10235,5.117.916.667
25/08/2021 05:00,63.33,37011,3828,117,40,6374,17,10376,5.117.916.667
25/08/2021 06:00,69.27,40178,3987,106,52,6264,15,10424,5.117.916.667
25/08/2021 07:00,70.44,41227,4171,91,69,6149,14,10494,5.117.916.667
25/08/2021 08:00,70.57,41503,4518,83,92,6257,23,10973,5.117.916.667
25/08/2021 09:00,69.28,41725,4787,75,128,6419,20,11429,5.117.916.667
25/08/2021 10:00,66.83,42292,4833,69,156,6602,21,11681,5.117.916.667
25/08/2021 11:00,62.26,41919,4603,62,178,6724,22,11589,5.117.916.667
25/08/2021 12:00,55.54,41647,4428,54,199,6802,29,11512,5.117.916.667
25/08/2021 13:00,48.5,41520,4401,47,212,6842,36,11538,5.117.916.667
25/08/2021 14:00,53.99,41495,4254,39,225,6881,36,11435,5.117.916.667
25/08/2021 15:00,59.49,41518,3987,30,241,6902,37,11197,5.117.916.667
25/08/2021 16:00,66.89,41586,3769,21,262,6860,21,10933,5.117.916.667
25/08/2021 17:00,69.42,41263,3275,14,283,6796,10,10378,5.117.916.667
25/08/2021 18:00,69.93,40679,2764,9,303,6745,6,9827,5.117.916.667
25/08/2021 19:00,67.33,40074,2386,7,301,6689,6,9389,5.117.916.667
25/08/2021 20:00,67.4,39509,2254,6,284,6647,5,9196,5.117.916.667
25/08/2021 21:00,60.58,37753,2201,8,272,6600,4,9085,5.117.916.667
25/08/2021 22:00,50.58,35688,2195,12,259,6555,4,9025,5.117.916.667
25/08/2021 23:00,44.96,34169,2555,17,267,6815,4,9658,5.117.916.667
26/08/2021 00:00,43.27,33664,2504,27,243,6744,5,9523,5.117.916.667
26/08/2021 01:00,42.47,33316,2562,37,212,6721,5,9537,5.117.916.667
26/08/2021 02:00,42.74,33094,2644,52,180,6699,4,9579,5.117.916.667
26/08/2021 03:00,47.89,33430,2730,70,157,6645,5,9607,5.117.916.667
26/08/2021 04:00,57.52,34676,2806,91,140,6544,5,9586,5.117.916.667
26/08/2021 05:00,65.11,37241,2880,112,130,6371,5,9498,5.117.916.667
26/08/2021 06:00,74.92,40239,2955,128,123,6120,5,9331,5.117.916.667
26/08/2021 07:00,79.15,40602,3196,145,123,5931,6,9401,5.117.916.667
26/08/2021 08:00,79.86,40773,3788,162,118,5923,7,9998,5.117.916.667
26/08/2021 09:00,80.03,41010,4256,171,114,5911,8,10460,5.117.916.667
26/08/2021 10:00,79.22,40837,4433,176,108,5798,10,10525,5.117.916.667
26/08/2021 11:00,76.97,40594,4325,179,102,5649,10,10265,5.117.916.667
26/08/2021 12:00,76.8,41619,4362,180,100,5523,12,10177,5.117.916.667
26/08/2021 13:00,75.04,41300,4409,171,98,5402,13,10093,5.117.916.667
26/08/2021 14:00,74.01,41144,4440,173,102,5278,15,10008,5.117.916.667
26/08/2021 15:00,74.02,41127,4278,174,105,5133,13,9703,5.117.916.667
26/08/2021 16:00,77.65,41516,4369,166,111,4985,17,9648,5.117.916.667
26/08/2021 17:00,77.92,41132,4194,154,116,4839,18,9321,5.117.916.667
26/08/2021 18:00,79.54,40567,3910,145,116,4755,15,8941,5.117.916.667
26/08/2021 19:00,76.67,39993,3613,141,115,4721,14,8604,5.117.916.667
26/08/2021 20:00,75.18,39283,3547,138,118,4696,12,8511,5.117.916.667
26/08/2021 21:00,72.62,38268,3648,136,121,4639,12,8556,5.117.916.667
26/08/2021 22:00,64.65,36278,3771,138,119,4548,15,8591,5.117.916.667
26/08/2021 23:00,59.78,34563,3834,115,107,4476,11,8543,5.117.916.667
27/08/2021 00:00,58.81,33882,3865,124,99,4350,11,8449,5.117.916.667
27/08/2021 01:00,57.46,33528,3822,133,95,4249,11,8310,5.117.916.667
27/08/2021 02:00,55.41,33495,3784,135,94,4152,14,8179,5.117.916.667
27/08/2021 03:00,58.09,33998,3821,136,91,4054,12,8114,5.117.916.667
27/08/2021 04:00,62.26,35308,3734,138,91,3957,14,7934,5.117.916.667
27/08/2021 05:00,74.31,38097,3539,138,88,3844,14,7623,5.117.916.667
27/08/2021 06:00,81.53,41134,3378,132,89,3643,12,7254,5.117.916.667
27/08/2021 07:00,86.24,42637,3324,125,95,3512,9,7065,5.117.916.667
27/08/2021 08:00,86.44,42614,3447,120,90,3511,11,7179,5.117.916.667
27/08/2021 09:00,86.4,42527,3559,115,85,3553,11,7323,5.117.916.667
27/08/2021 10:00,84.75,42334,3557,114,81,3540,10,7302,5.117.916.667
27/08/2021 11:00,82.8,41778,3380,116,77,3500,7,7080,5.117.916.667
27/08/2021 12:00,82.25,41504,3329,119,69,3430,6,6953,5.117.916.667
27/08/2021 13:00,76.71,40967,3338,122,62,3319,6,6847,5.117.916.667
27/08/2021 14:00,76.19,40531,3358,128,53,3169,6,6714,5.117.916.667
27/08/2021 15:00,76.64,40186,3317,128,48,3000,6,6499,5.117.916.667
27/08/2021 16:00,81.93,40573,3411,125,43,2853,6,6438,5.117.916.667
27/08/2021 17:00,83.25,40319,3379,118,40,2765,7,6309,5.117.916.667
27/08/2021 18:00,82.8,39596,3275,116,44,2763,6,6204,5.117.916.667
27/08/2021 19:00,81.11,38893,3066,113,51,2813,8,6051,5.117.916.667
27/08/2021 20:00,77.9,38324,3005,110,60,2855,9,6039,5.117.916.667
27/08/2021 21:00,74.93,36942,3027,110,65,2864,7,6073,5.117.916.667
27/08/2021 22:00,73.47,35441,3013,106,66,2842,6,6033,5.117.916.667
27/08/2021 23:00,70.97,33936,2968,33,35,2699,7,5742,5.117.916.667
28/08/2021 00:00,65,33123,2885,34,30,2663,8,5620,5.117.916.667
28/08/2021 01:00,63.75,32566,2777,32,22,2636,7,5474,5.117.916.667
28/08/2021 02:00,63.31,32373,2642,26,19,2611,7,5305,5.117.916.667
28/08/2021 03:00,63.17,32339,2537,22,16,2618,7,5200,5.117.916.667
28/08/2021 04:00,63.32,32497,2515,18,12,2623,7,5175,5.117.916.667
28/08/2021 05:00,63.85,33003,2487,13,11,2624,8,5143,5.117.916.667
28/08/2021 06:00,68.18,34491,2478,9,11,2566,10,5074,5.117.916.667
28/08/2021 07:00,73.74,36217,2428,9,11,2507,12,4967,5.117.916.667
28/08/2021 08:00,77.35,37444,2548,7,12,2538,14,5119,5.117.916.667
28/08/2021 09:00,75.88,38008,2641,12,14,2586,13,5266,5.117.916.667
28/08/2021 10:00,73.82,37927,2673,19,13,2565,13,5283,5.117.916.667
28/08/2021 11:00,72.92,37580,2564,22,10,2495,12,5103,5.117.916.667
28/08/2021 12:00,71.29,37167,2514,28,11,2450,14,5017,5.117.916.667
28/08/2021 13:00,67.34,36847,2587,45,12,2396,14,5054,5.117.916.667
28/08/2021 14:00,70.73,36690,2574,55,14,2303,15,4961,5.117.916.667
28/08/2021 15:00,72.32,36855,2535,63,17,2204,13,4832,5.117.916.667
28/08/2021 16:00,76.54,37500,2542,65,19,2106,10,4742,5.117.916.667
28/08/2021 17:00,79.51,37660,2370,64,20,2043,9,4506,5.117.916.667
28/08/2021 18:00,81.49,37311,2299,65,24,2056,10,4454,5.117.916.667
28/08/2021 19:00,81.28,36822,2174,68,26,2089,9,4366,5.117.916.667
28/08/2021 20:00,80.84,36484,2155,74,25,2103,8,4365,5.117.916.667
28/08/2021 21:00,77.55,35300,2195,77,23,2092,7,4394,5.117.916.667
28/08/2021 22:00,71.63,33730,2218,77,23,2050,6,4374,5.117.916.667
28/08/2021 23:00,65.78,32599,2202,74,71,2064,13,4424,5.117.916.667
29/08/2021 00:00,63.04,32397,2187,75,72,2019,11,4364,5.117.916.667
29/08/2021 01:00,60.97,31838,2149,77,71,1989,10,4296,5.117.916.667
29/08/2021 02:00,57.13,31512,2154,75,77,1982,9,4297,5.117.916.667
29/08/2021 03:00,55.09,31445,2149,67,86,1996,8,4306,5.117.916.667
29/08/2021 04:00,55.89,31492,2086,60,86,2011,7,4250,5.117.916.667
29/08/2021 05:00,57.47,31725,2108,56,79,1976,8,4227,5.117.916.667
29/08/2021 06:00,61.5,32767,2102,49,80,1878,8,4117,5.117.916.667
29/08/2021 07:00,66.31,34333,2102,40,83,1720,7,3952,5.117.916.667
29/08/2021 08:00,75.7,35797,2256,36,74,1618,8,3992,5.117.916.667
29/08/2021 09:00,77.49,36650,2336,36,64,1621,8,4065,5.117.916.667
29/08/2021 10:00,78.92,36798,2261,43,54,1625,10,3993,5.117.916.667
29/08/2021 11:00,78.25,36765,2100,51,44,1596,8,3799,5.117.916.667
29/08/2021 12:00,73.24,36401,2029,62,34,1547,7,3679,5.117.916.667
29/08/2021 13:00,69.59,36086,1995,73,29,1502,6,3605,5.117.916.667
29/08/2021 14:00,72.65,36214,1923,76,28,1446,7,3480,5.117.916.667
29/08/2021 15:00,75.94,36571,1816,74,28,1365,8,3291,5.117.916.667
29/08/2021 16:00,81.44,37242,1818,72,30,1287,7,3214,5.117.916.667
29/08/2021 17:00,83.97,37773,1733,71,36,1260,6,3106,5.117.916.667
29/08/2021 18:00,86.64,37797,1662,73,47,1399,6,3187,5.117.916.667
29/08/2021 19:00,86.64,37573,1557,76,55,1644,7,3339,5.117.916.667
29/08/2021 20:00,85.34,37230,1546,78,64,1846,8,3542,5.117.916.667
29/08/2021 21:00,80.15,35591,1580,79,69,1958,9,3695,5.117.916.667
29/08/2021 22:00,71.51,33756,1502,79,70,1953,9,3613,5.117.916.667
29/08/2021 23:00,61.59,32454,1425,112,71,2090,7,3705,5.117.916.667
30/08/2021 00:00,61.5,31921,1440,112,67,2110,6,3735,5.042.083.333
30/08/2021 01:00,59.92,31657,1460,112,63,2127,7,3769,5.042.083.333
30/08/2021 02:00,59.87,31743,1412,113,64,2121,7,3717,5.042.083.333
30/08/2021 03:00,66.09,32160,1380,115,67,2119,8,3689,5.042.083.333
30/08/2021 04:00,74.8,33919,1331,120,75,2059,8,3593,5.042.083.333
30/08/2021 05:00,87.11,36912,1262,123,84,1921,8,3398,5.042.083.333
30/08/2021 06:00,94.52,40121,1286,126,90,1661,8,3171,5.042.083.333
30/08/2021 07:00,108.76,41531,1266,129,102,1322,7,2826,5.042.083.333
30/08/2021 08:00,110.99,41564,1329,135,109,1175,7,2755,5.042.083.333
30/08/2021 09:00,107.38,41733,1391,137,113,1200,7,2848,5.042.083.333
30/08/2021 10:00,102.96,42192,1469,135,120,1265,10,2999,5.042.083.333
30/08/2021 11:00,100.34,41394,1493,135,131,1340,10,3109,5.042.083.333
30/08/2021 12:00,97.23,41222,1565,136,139,1392,13,3245,5.042.083.333
30/08/2021 13:00,93.97,41207,1584,138,144,1423,13,3302,5.042.083.333
30/08/2021 14:00,91.34,41247,1514,133,156,1431,13,3247,5.042.083.333
30/08/2021 15:00,91.01,40989,1419,121,161,1422,13,3136,5.042.083.333
30/08/2021 16:00,94.07,41334,1397,111,162,1410,15,3095,5.042.083.333
30/08/2021 17:00,94.25,40516,1221,102,176,1457,11,2967,5.042.083.333
30/08/2021 18:00,97.05,40043,1147,98,192,1667,10,3114,5.042.083.333
30/08/2021 19:00,94.24,39696,1075,97,207,1978,10,3367,5.042.083.333
30/08/2021 20:00,90.07,39124,1085,96,218,2265,14,3678,5.042.083.333
30/08/2021 21:00,86.92,37637,1113,94,222,2516,13,3958,5.042.083.333
30/08/2021 22:00,74.93,35383,1042,93,224,2645,13,4017,5.042.083.333
30/08/2021 23:00,70.91,33745,854,62,216,2937,15,4084,5.042.083.333
31/08/2021 00:00,62.17,33111,857,63,211,3103,15,4249,5.042.083.333
31/08/2021 01:00,59.16,32862,853,64,204,3220,15,4356,5.042.083.333
31/08/2021 02:00,58.15,32793,816,63,202,3315,15,4411,5.042.083.333
31/08/2021 03:00,60.76,33058,812,61,202,3422,15,4512,5.042.083.333
31/08/2021 04:00,72.45,34545,802,62,205,3451,15,4535,5.042.083.333
31/08/2021 05:00,88.35,37712,755,64,211,3361,16,4407,5.042.083.333
31/08/2021 06:00,93.01,40824,725,66,217,3099,15,4122,5.042.083.333
31/08/2021 07:00,96.87,41561,665,68,230,2931,17,3911,5.042.083.333
31/08/2021 08:00,96.03,41682,616,71,235,3109,24,4055,5.042.083.333
31/08/2021 09:00,91.3,42001,544,72,240,3346,28,4230,5.042.083.333
31/08/2021 10:00,89.95,42021,501,71,236,3623,30,4461,5.042.083.333
31/08/2021 11:00,87.63,41983,486,71,225,3952,32,4766,5.042.083.333
31/08/2021 12:00,83.28,41929,533,70,216,4206,28,5053,5.042.083.333
31/08/2021 13:00,78.34,41491,609,70,202,4439,26,5346,5.042.083.333
31/08/2021 14:00,75.94,41242,711,71,193,4609,24,5608,5.042.083.333
31/08/2021 15:00,78.37,41066,812,70,190,4652,20,5744,5.042.083.333
31/08/2021 16:00,81.99,41172,959,68,193,4569,16,5805,5.042.083.333
31/08/2021 17:00,82.57,40621,1046,68,197,4549,13,5873,5.042.083.333
31/08/2021 18:00,83.07,40298,1124,68,201,4690,16,6099,5.042.083.333
31/08/2021 19:00,79.52,39784,1101,69,207,4962,19,6358,5.042.083.333
31/08/2021 20:00,76.82,39020,1111,69,212,5142,22,6556,5.042.083.333
31/08/2021 21:00,63.62,37511,1127,70,214,5289,20,6720,5.042.083.333
31/08/2021 22:00,52.48,35355,1075,70,217,5363,17,6742,5.042.083.333
31/08/2021 23:00,49.13,33715,772,56,199,5427,18,6472,5.042.083.333
01/09/2021 00:00,48.11,33198,755,59,194,5459,14,6481,5.042.083.333
01/09/2021 01:00,47.43,32783,756,62,186,5455,13,6472,5.042.083.333
01/09/2021 02:00,46.93,32515,711,62,183,5368,14,6338,5.042.083.333
01/09/2021 03:00,50,32914,687,61,179,5229,15,6171,5.042.083.333
01/09/2021 04:00,65,34313,676,61,176,5021,16,5950,5.042.083.333
01/09/2021 05:00,81.62,37336,674,59,164,4735,17,5649,5.042.083.333
01/09/2021 06:00,89.52,40509,553,53,149,4290,17,5062,5.042.083.333
01/09/2021 07:00,89.92,41884,465,49,158,4004,21,4697,5.042.083.333
01/09/2021 08:00,89.36,42109,337,52,176,4212,23,4800,5.042.083.333
01/09/2021 09:00,85.91,42311,261,52,201,4441,29,4984,5.042.083.333
01/09/2021 10:00,82.86,42176,245,53,225,4641,32,5196,5.042.083.333
01/09/2021 11:00,78.94,41737,279,54,243,4856,34,5466,5.042.083.333
01/09/2021 12:00,75.54,39142,326,57,261,5074,34,5752,5.042.083.333
01/09/2021 13:00,74,38734,393,60,280,5239,38,6010,5.042.083.333
01/09/2021 14:00,73.32,38429,505,60,299,5283,38,6185,5.042.083.333
01/09/2021 15:00,74.5,41305,691,54,305,5276,39,6365,5.042.083.333
01/09/2021 16:00,78.96,41175,852,47,302,5029,39,6269,5.042.083.333
01/09/2021 17:00,82.84,40827,884,44,292,4695,38,5953,5.042.083.333
01/09/2021 18:00,81.64,40450,801,41,278,4465,37,5622,5.042.083.333
01/09/2021 19:00,80.4,40178,655,34,259,4366,34,5348,5.042.083.333
01/09/2021 20:00,80.32,39842,641,34,239,4265,33,5212,5.042.083.333
01/09/2021 21:00,75.05,37804,664,48,219,4102,31,5064,5.042.083.333
01/09/2021 22:00,66.38,35519,614,62,203,3897,32,4808,5.042.083.333
01/09/2021 23:00,56.85,33598,484,92,161,4554,20,5311,5.042.083.333
02/09/2021 00:00,56.22,33297,428,90,156,4227,18,4919,5.042.083.333
02/09/2021 01:00,53.77,32994,422,86,141,3842,16,4507,5.042.083.333
02/09/2021 02:00,59.68,32912,405,85,139,3384,16,4029,5.042.083.333
02/09/2021 03:00,65.05,33175,397,90,146,2964,14,3611,5.042.083.333
02/09/2021 04:00,77.81,34393,338,97,150,2644,12,3241,5.042.083.333
02/09/2021 05:00,87.65,37535,298,97,152,2420,11,2978,5.042.083.333
02/09/2021 06:00,91.41,40675,244,98,141,2288,10,2781,5.042.083.333
02/09/2021 07:00,91.91,41997,182,108,124,2340,7,2761,5.042.083.333
02/09/2021 08:00,93.28,41844,127,119,115,2646,8,3015,5.042.083.333
02/09/2021 09:00,90.07,42029,88,132,121,3091,14,3446,5.042.083.333
02/09/2021 10:00,87.31,41899,83,142,140,3622,18,4005,5.042.083.333
02/09/2021 11:00,81.04,41570,134,153,160,4096,19,4562,5.042.083.333
02/09/2021 12:00,80.03,41468,278,162,173,4493,20,5126,5.042.083.333
02/09/2021 13:00,79.27,41212,486,171,183,4791,20,5651,5.042.083.333
02/09/2021 14:00,77.19,41026,731,175,197,5022,20,6145,5.042.083.333
02/09/2021 15:00,73.72,41082,1022,179,203,5191,17,6612,5.042.083.333
02/09/2021 16:00,79.16,41478,1238,182,191,5297,17,6925,5.042.083.333
02/09/2021 17:00,80.65,41164,1370,180,163,5400,12,7125,5.042.083.333
02/09/2021 18:00,80.1,40590,1467,176,146,5686,11,7486,5.042.083.333
02/09/2021 19:00,79.85,40260,1561,169,145,6055,13,7943,5.042.083.333
02/09/2021 20:00,79.13,39583,1782,160,161,6354,14,8471,5.042.083.333
02/09/2021 21:00,68.15,38074,2057,147,182,6533,22,8941,5.042.083.333
02/09/2021 22:00,53.52,36128,2317,133,203,6574,27,9254,5.042.083.333
02/09/2021 23:00,50.26,34390,2389,135,267,5902,33,8726,5.042.083.333
03/09/2021 00:00,49.19,33821,2630,130,287,5784,24,8855,5.042.083.333
03/09/2021 01:00,48.81,33398,2706,122,289,5663,24,8804,5.042.083.333
03/09/2021 02:00,47.06,33216,2759,116,289,5574,34,8772,5.042.083.333
03/09/2021 03:00,48.28,33638,2796,113,299,5495,30,8733,5.042.083.333
03/09/2021 04:00,52.68,35031,2743,109,308,5404,22,8586,5.042.083.333
03/09/2021 05:00,67.54,37878,2492,98,308,5228,23,8149,5.042.083.333
03/09/2021 06:00,81.03,40780,2317,89,309,4918,24,7657,5.042.083.333
03/09/2021 07:00,84.43,42156,2076,91,320,4720,28,7235,5.042.083.333
03/09/2021 08:00,84.82,42335,1863,90,325,4839,35,7152,5.042.083.333
03/09/2021 09:00,83.72,42182,1583,89,334,4922,37,6965,5.042.083.333
03/09/2021 10:00,81.07,42129,1415,91,339,4929,40,6814,5.042.083.333
03/09/2021 11:00,71.38,41491,1216,106,318,4922,39,6601,5.042.083.333
03/09/2021 12:00,67.05,41132,1149,126,289,4917,41,6522,5.042.083.333
03/09/2021 13:00,66,40595,1115,148,266,4828,40,6397,5.042.083.333
03/09/2021 14:00,66.12,40028,1032,158,253,4757,36,6236,5.042.083.333
03/09/2021 15:00,75.19,39932,1054,156,247,4582,34,6073,5.042.083.333
03/09/2021 16:00,82.57,40195,1247,142,229,4129,33,5780,5.042.083.333
03/09/2021 17:00,84.35,40108,1278,125,199,3607,28,5237,5.042.083.333
03/09/2021 18:00,84.43,39726,1176,114,180,3310,23,4803,5.042.083.333
03/09/2021 19:00,82.13,38977,1058,125,169,3304,23,4679,5.042.083.333
03/09/2021 20:00,81.61,38485,922,131,162,3386,21,4622,5.042.083.333
03/09/2021 21:00,76.4,37019,670,143,147,3451,18,4429,5.042.083.333
03/09/2021 22:00,68.99,35516,578,157,129,3412,18,4294,5.042.083.333
03/09/2021 23:00,75.17,34074,712,99,112,3654,13,4590,5.042.083.333
04/09/2021 00:00,72.18,33515,658,100,103,3621,11,4493,5.042.083.333
04/09/2021 01:00,69.08,33495,600,101,92,3548,12,4353,5.042.083.333
04/09/2021 02:00,62.09,33304,580,104,84,3434,12,4214,5.042.083.333
04/09/2021 03:00,62.1,32663,595,107,80,3297,11,4090,5.042.083.333
04/09/2021 04:00,66.44,32920,576,108,80,3107,10,3881,5.042.083.333
04/09/2021 05:00,76.92,33562,556,104,74,2813,7,3554,5.042.083.333
04/09/2021 06:00,80.69,35509,601,98,64,2309,7,3079,5.042.083.333
04/09/2021 07:00,85.96,37099,614,90,54,1904,6,2668,5.042.083.333
04/09/2021 08:00,88.45,38341,628,85,41,1818,10,2582,5.042.083.333
04/09/2021 09:00,85.9,38774,623,86,48,1777,6,2540,5.042.083.333
04/09/2021 10:00,83.16,38601,685,92,60,1756,14,2607,5.042.083.333
04/09/2021 11:00,79.96,38246,756,97,73,1742,22,2690,5.042.083.333
04/09/2021 12:00,71.63,37727,800,102,90,1662,19,2673,5.042.083.333
04/09/2021 13:00,71.32,37487,868,106,103,1501,24,2602,5.042.083.333
04/09/2021 14:00,79.97,37529,901,108,111,1300,15,2435,5.042.083.333
04/09/2021 15:00,83.51,37678,915,107,117,1046,14,2199,5.042.083.333
04/09/2021 16:00,88.73,38191,964,108,113,762,15,1962,5.042.083.333
04/09/2021 17:00,92.81,38467,960,109,93,533,13,1708,5.042.083.333
04/09/2021 18:00,93.35,38377,1004,108,95,459,10,1676,5.042.083.333
04/09/2021 19:00,92.92,38099,1040,103,107,488,10,1748,5.042.083.333
04/09/2021 20:00,92.46,37796,1149,97,117,521,11,1895,5.042.083.333
04/09/2021 21:00,91.46,36533,1232,91,117,557,10,2007,5.042.083.333
04/09/2021 22:00,89.4,35170,1250,87,106,610,9,2062,5.042.083.333
04/09/2021 23:00,89.34,33963,1295,97,116,879,8,2395,5.042.083.333
05/09/2021 00:00,84.62,34166,1297,95,97,974,8,2471,5.042.083.333
05/09/2021 01:00,76.09,33628,1224,93,80,1052,6,2455,5.042.083.333
05/09/2021 02:00,70.02,32592,1154,90,67,1088,7,2406,5.042.083.333
05/09/2021 03:00,69.19,32465,1158,87,55,1131,8,2439,5.042.083.333
05/09/2021 04:00,69.61,32601,1115,86,47,1150,8,2406,5.042.083.333
05/09/2021 05:00,71.44,32859,1114,85,35,1147,8,2389,5.042.083.333
05/09/2021 06:00,73.98,33853,1101,85,24,1122,6,2338,5.042.083.333
05/09/2021 07:00,81.21,35511,1114,86,19,995,6,2220,5.042.083.333
05/09/2021 08:00,85.43,36930,1179,85,14,859,7,2144,5.042.083.333
05/09/2021 09:00,84.14,37466,1259,86,18,822,8,2193,5.042.083.333
05/09/2021 10:00,75.43,37822,1280,88,27,893,8,2296,5.042.083.333
05/09/2021 11:00,71.99,37739,1194,89,32,986,8,2309,5.042.083.333
05/09/2021 12:00,66.95,37498,1115,89,36,1056,8,2304,5.042.083.333
05/09/2021 13:00,68.93,37317,1033,88,40,1128,8,2297,5.042.083.333
05/09/2021 14:00,71.5,37326,908,86,44,1183,8,2229,5.042.083.333
05/09/2021 15:00,82.57,37526,815,83,44,1211,7,2160,5.042.083.333
05/09/2021 16:00,87,38168,825,81,41,1220,6,2173,5.042.083.333
05/09/2021 17:00,91.83,38823,815,79,39,1276,5,2214,5.042.083.333
05/09/2021 18:00,93.38,38685,804,77,42,1500,5,2428,5.042.083.333
05/09/2021 19:00,93.82,39028,861,74,43,1772,5,2755,5.042.083.333
05/09/2021 20:00,93.26,38150,962,73,42,1973,5,3055,5.042.083.333
05/09/2021 21:00,91.62,36507,1026,70,39,2104,5,3244,5.042.083.333
05/09/2021 22:00,85.88,34884,1024,66,38,2145,5,3278,5.042.083.333
05/09/2021 23:00,83.31,34427,821,203,13,2053,7,3097,5.042.083.333
06/09/2021 00:00,80.13,33576,761,213,11,1954,14,2953,5.005.059.524
06/09/2021 01:00,78.84,32877,644,214,14,1886,19,2777,5.005.059.524
06/09/2021 02:00,73.83,32922,526,215,21,1832,20,2614,5.005.059.524
06/09/2021 03:00,81.52,33632,422,219,29,1784,20,2474,5.005.059.524
06/09/2021 04:00,89.05,35261,329,223,38,1719,18,2327,5.005.059.524
06/09/2021 05:00,95.12,38310,273,228,46,1650,11,2208,5.005.059.524
06/09/2021 06:00,101.81,41858,234,228,58,1515,11,2046,5.005.059.524
06/09/2021 07:00,99.9,43292,208,223,69,1252,12,1764,5.005.059.524
06/09/2021 08:00,97.52,43399,187,209,64,1088,9,1557,5.005.059.524
06/09/2021 09:00,96.62,43760,163,193,65,1083,13,1517,5.005.059.524
06/09/2021 10:00,95.05,43336,140,182,75,1178,15,1590,5.005.059.524
06/09/2021 11:00,92.91,42926,121,169,75,1285,19,1669,5.005.059.524
06/09/2021 12:00,92.01,42550,125,159,74,1417,23,1798,5.005.059.524
06/09/2021 13:00,92.36,42325,137,148,68,1493,23,1869,5.005.059.524
06/09/2021 14:00,94.27,42094,165,139,61,1520,20,1905,5.005.059.524
06/09/2021 15:00,95.17,41854,202,134,54,1478,19,1887,5.005.059.524
06/09/2021 16:00,95.43,42054,220,133,44,1387,16,1800,5.005.059.524
06/09/2021 17:00,96.34,41614,195,135,43,1390,14,1777,5.005.059.524
06/09/2021 18:00,96.62,41418,191,138,49,1597,12,1987,5.005.059.524
06/09/2021 19:00,95.67,40869,186,143,55,1875,12,2271,5.005.059.524
06/09/2021 20:00,92.44,40210,190,139,62,2095,12,2498,5.005.059.524
06/09/2021 21:00,88.42,38237,201,143,72,2287,12,2715,5.005.059.524
06/09/2021 22:00,77.58,36082,215,137,84,2452,10,2898,5.005.059.524
06/09/2021 23:00,73.26,34506,280,55,89,2332,7,2763,5.005.059.524
07/09/2021 00:00,72.18,33902,309,59,115,2356,8,2847,5.005.059.524
07/09/2021 01:00,69.83,33405,331,64,128,2372,7,2902,5.005.059.524
07/09/2021 02:00,67.21,33263,331,68,133,2369,6,2907,5.005.059.524
07/09/2021 03:00,69.97,33668,323,66,128,2390,7,2914,5.005.059.524
07/09/2021 04:00,73.8,35349,312,61,120,2455,13,2961,5.005.059.524
07/09/2021 05:00,90.18,38423,303,53,113,2602,14,3085,5.005.059.524
07/09/2021 06:00,95.47,41387,319,42,105,2698,14,3178,5.005.059.524
07/09/2021 07:00,97.92,42235,335,31,89,2757,10,3222,5.005.059.524
07/09/2021 08:00,96.91,42282,383,24,64,2835,5,3311,5.005.059.524
07/09/2021 09:00,95.46,42415,420,20,59,2946,7,3452,5.005.059.524
07/09/2021 10:00,94.88,42186,487,19,65,3275,9,3855,5.005.059.524
07/09/2021 11:00,89.41,41788,558,18,74,3727,10,4387,5.005.059.524
07/09/2021 12:00,83.77,41683,652,22,82,4116,13,4885,5.005.059.524
07/09/2021 13:00,80.75,41410,665,26,83,4362,14,5150,5.005.059.524
07/09/2021 14:00,77.26,41129,645,26,83,4514,20,5288,5.005.059.524
07/09/2021 15:00,79.75,41085,604,24,81,4606,21,5336,5.005.059.524
07/09/2021 16:00,79.91,41224,564,22,76,4640,24,5326,5.005.059.524
07/09/2021 17:00,78.14,40798,450,25,78,4699,23,5275,5.005.059.524
07/09/2021 18:00,77.46,40683,382,25,90,4807,20,5324,5.005.059.524
07/09/2021 19:00,78.93,40402,361,24,110,4902,21,5418,5.005.059.524
07/09/2021 20:00,78.94,39526,399,24,146,4985,22,5576,5.005.059.524
07/09/2021 21:00,70.68,37726,467,23,189,5061,21,5761,5.005.059.524
07/09/2021 22:00,53.21,35435,532,25,215,5075,22,5869,5.005.059.524
07/09/2021 23:00,53.54,33968,484,39,222,5087,25,5857,5.005.059.524
08/09/2021 00:00,51.39,33547,543,40,234,5013,25,5855,5.005.059.524
08/09/2021 01:00,50.55,33137,597,41,234,4958,24,5854,5.005.059.524
08/09/2021 02:00,50.57,32952,636,41,229,4928,19,5853,5.005.059.524
08/09/2021 03:00,51.96,33222,652,41,221,4930,17,5861,5.005.059.524
08/09/2021 04:00,55.33,34330,601,43,208,4959,16,5827,5.005.059.524
08/09/2021 05:00,67.94,37687,524,43,189,4980,15,5751,5.005.059.524
08/09/2021 06:00,77.08,40177,464,39,172,4967,14,5656,5.005.059.524
08/09/2021 07:00,83.94,41326,430,33,146,4950,10,5569,5.005.059.524
08/09/2021 08:00,82.23,41550,429,35,118,5011,12,5605,5.005.059.524
08/09/2021 09:00,82.22,41754,426,41,118,5057,20,5662,5.005.059.524
08/09/2021 10:00,82.31,41742,445,51,130,5131,22,5779,5.005.059.524
08/09/2021 11:00,79.18,41522,448,63,151,5148,25,5835,5.005.059.524
08/09/2021 12:00,71.44,41109,454,74,169,5122,31,5850,5.005.059.524
08/09/2021 13:00,72.87,40883,434,79,169,4968,35,5685,5.005.059.524
08/09/2021 14:00,79.04,40711,383,81,158,4739,35,5396,5.005.059.524
08/09/2021 15:00,81.12,40965,340,79,140,4396,36,4991,5.005.059.524
08/09/2021 16:00,85.66,40728,324,76,117,3926,30,4473,5.005.059.524
08/09/2021 17:00,89.95,40529,264,78,104,3500,23,3969,5.005.059.524
08/09/2021 18:00,90.78,40206,206,81,100,3309,19,3715,5.005.059.524
08/09/2021 19:00,90.23,39929,185,86,98,3243,17,3629,5.005.059.524
08/09/2021 20:00,86.76,39432,181,92,104,3186,16,3579,5.005.059.524
08/09/2021 21:00,82.13,37070,204,97,113,3100,15,3529,5.005.059.524
08/09/2021 22:00,71.47,35106,243,99,116,2958,14,3430,5.005.059.524
08/09/2021 23:00,63.52,33234,316,107,100,2619,15,3157,5.005.059.524
09/09/2021 00:00,62.07,33079,328,110,103,2448,13,3002,5.005.059.524
09/09/2021 01:00,60.05,32758,349,107,103,2315,10,2884,5.005.059.524
09/09/2021 02:00,57.92,32822,384,102,103,2208,9,2806,5.005.059.524
09/09/2021 03:00,64.44,33011,404,96,100,2076,8,2684,5.005.059.524
09/09/2021 04:00,82.18,34389,348,91,92,1981,7,2519,5.005.059.524
09/09/2021 05:00,93.04,37118,346,85,82,1898,7,2418,5.005.059.524
09/09/2021 06:00,99.24,40054,341,83,71,1737,6,2238,5.005.059.524
09/09/2021 07:00,100.79,41224,343,91,60,1476,6,1976,5.005.059.524
09/09/2021 08:00,100.79,41369,331,98,46,1331,6,1812,5.005.059.524
09/09/2021 09:00,100.83,41574,328,104,40,1332,6,1810,5.005.059.524
09/09/2021 10:00,100.85,41414,358,110,45,1395,8,1916,5.005.059.524
09/09/2021 11:00,100.37,41171,421,113,57,1451,9,2051,5.005.059.524
09/09/2021 12:00,100.5,40893,447,117,70,1477,8,2119,5.005.059.524
09/09/2021 13:00,100.38,40690,444,123,80,1480,10,2137,5.005.059.524
09/09/2021 14:00,100.49,40605,414,128,80,1444,9,2075,5.005.059.524
09/09/2021 15:00,100.21,40631,403,133,69,1369,10,1984,5.005.059.524
09/09/2021 16:00,100.22,40950,420,130,54,1225,9,1838,5.005.059.524
09/09/2021 17:00,100.73,40858,439,125,53,1135,8,1760,5.005.059.524
09/09/2021 18:00,100.98,40682,500,118,63,1224,8,1913,5.005.059.524
09/09/2021 19:00,100.6,40287,595,104,71,1395,9,2174,5.005.059.524
09/09/2021 20:00,99.02,39220,649,89,85,1480,11,2314,5.005.059.524
09/09/2021 21:00,94.41,37568,653,75,110,1487,10,2335,5.005.059.524
09/09/2021 22:00,89.22,35924,660,64,145,1395,10,2274,5.005.059.524
09/09/2021 23:00,89.91,34154,812,64,156,1195,16,2243,5.005.059.524
10/09/2021 00:00,87.7,33914,740,54,158,1072,15,2039,5.005.059.524
10/09/2021 01:00,86.95,33841,651,46,147,951,14,1809,5.005.059.524
10/09/2021 02:00,86.27,33968,644,40,135,851,13,1683,5.005.059.524
10/09/2021 03:00,89.5,33382,622,37,123,794,12,1588,5.005.059.524
10/09/2021 04:00,92.77,34984,506,38,105,751,12,1412,5.005.059.524
10/09/2021 05:00,100.08,38013,465,38,86,721,12,1322,5.005.059.524
10/09/2021 06:00,102.63,40964,463,33,75,680,11,1262,5.005.059.524
10/09/2021 07:00,103.8,42121,429,28,55,650,11,1173,5.005.059.524
10/09/2021 08:00,104.32,42096,402,29,27,645,10,1113,5.005.059.524
10/09/2021 09:00,103.75,42250,408,36,17,711,10,1182,5.005.059.524
10/09/2021 10:00,102.8,41992,419,49,19,830,10,1327,5.005.059.524
10/09/2021 11:00,102.36,41453,462,65,27,941,10,1505,5.005.059.524
10/09/2021 12:00,102.85,40938,521,76,34,1050,10,1691,5.005.059.524
10/09/2021 13:00,102.25,40374,468,83,37,1129,10,1727,5.005.059.524
10/09/2021 14:00,100.94,40012,436,86,35,1171,10,1738,5.005.059.524
10/09/2021 15:00,100.77,39905,456,86,30,1160,10,1742,5.005.059.524
10/09/2021 16:00,102.32,40295,402,81,27,1156,10,1676,5.005.059.524
10/09/2021 17:00,102.73,40291,334,74,33,1174,10,1625,5.005.059.524
10/09/2021 18:00,102.67,39567,304,67,48,1307,10,1736,5.005.059.524
10/09/2021 19:00,101.19,39026,271,57,63,1448,10,1849,5.005.059.524
10/09/2021 20:00,100.06,38016,242,48,79,1484,10,1863,5.005.059.524
10/09/2021 21:00,95.45,36582,254,40,102,1471,11,1878,5.005.059.524
10/09/2021 22:00,90.99,34813,272,30,130,1387,12,1831,5.005.059.524
10/09/2021 23:00,88.61,33528,276,122,110,803,6,1317,5.005.059.524
11/09/2021 00:00,86.17,33366,276,116,117,724,5,1238,5.005.059.524
11/09/2021 01:00,84.99,32964,288,112,110,673,6,1189,5.005.059.524
11/09/2021 02:00,84.81,32886,315,108,97,620,6,1146,5.005.059.524
11/09/2021 03:00,84.94,32541,323,101,86,593,5,1108,5.005.059.524
11/09/2021 04:00,84.81,32909,306,96,82,590,5,1079,5.005.059.524
11/09/2021 05:00,86.33,33562,350,88,84,585,6,1113,5.005.059.524
11/09/2021 06:00,88.78,34956,367,83,82,571,5,1108,5.005.059.524
11/09/2021 07:00,96.88,36573,387,79,65,523,5,1059,5.005.059.524
11/09/2021 08:00,100.94,37878,453,74,42,512,4,1085,5.005.059.524
11/09/2021 09:00,101.18,38387,521,72,34,547,4,1178,5.005.059.524
11/09/2021 10:00,100.66,38366,570,69,34,605,4,1282,5.005.059.524
11/09/2021 11:00,101.05,38100,613,70,40,662,4,1389,5.005.059.524
11/09/2021 12:00,99.98,37893,663,71,45,728,4,1511,5.005.059.524
11/09/2021 13:00,96.49,37487,732,75,46,771,4,1628,5.005.059.524
11/09/2021 14:00,97.55,37564,789,79,41,821,4,1734,5.005.059.524
11/09/2021 15:00,100.17,37984,877,79,35,856,4,1851,5.005.059.524
11/09/2021 16:00,101.21,38671,904,74,33,893,4,1908,5.005.059.524
11/09/2021 17:00,100.76,38754,781,70,41,933,4,1829,5.005.059.524
11/09/2021 18:00,101.17,38380,677,69,51,1033,5,1835,5.005.059.524
11/09/2021 19:00,100.09,37813,671,70,58,1136,6,1941,5.005.059.524
11/09/2021 20:00,97.5,37091,748,66,73,1230,7,2124,5.005.059.524
11/09/2021 21:00,94.02,35745,888,63,86,1305,9,2351,5.005.059.524
11/09/2021 22:00,89.79,34081,1025,58,87,1328,9,2507,5.005.059.524
11/09/2021 23:00,82.61,32690,1371,52,83,1396,8,2910,5.005.059.524
12/09/2021 00:00,70.1,32438,1681,50,78,1385,10,3204,5.005.059.524
12/09/2021 01:00,67.46,31563,1818,49,74,1366,9,3316,5.005.059.524
12/09/2021 02:00,64.35,31274,1954,45,67,1338,9,3413,5.005.059.524
12/09/2021 03:00,65.32,31127,2097,42,64,1300,9,3512,5.005.059.524
12/09/2021 04:00,65.68,31481,2174,40,68,1287,10,3579,5.005.059.524
12/09/2021 05:00,66.76,31731,2252,40,69,1305,10,3676,5.005.059.524
12/09/2021 06:00,71.86,32733,2244,42,67,1334,13,3700,5.005.059.524
12/09/2021 07:00,85.69,34151,2230,48,70,1393,14,3755,5.005.059.524
12/09/2021 08:00,84.85,35819,2443,49,70,1492,15,4069,5.005.059.524
12/09/2021 09:00,82.92,36806,2652,42,77,1609,15,4395,5.005.059.524
12/09/2021 10:00,79.08,37164,2789,36,89,1731,13,4658,5.005.059.524
12/09/2021 11:00,69.61,37263,2927,34,97,1869,16,4943,5.005.059.524
12/09/2021 12:00,62.31,36947,3030,33,110,2070,17,5260,5.005.059.524
12/09/2021 13:00,59.23,36787,3145,33,109,2286,18,5591,5.005.059.524
12/09/2021 14:00,61.06,36951,3147,34,107,2521,16,5825,5.005.059.524
12/09/2021 15:00,65.61,37600,3170,36,112,2775,15,6108,5.005.059.524
12/09/2021 16:00,74.69,38351,3233,36,111,3097,13,6490,5.005.059.524
12/09/2021 17:00,88.92,38979,3184,36,108,3459,15,6802,5.005.059.524
12/09/2021 18:00,88.83,38700,3059,37,118,3910,17,7141,5.005.059.524
12/09/2021 19:00,85.03,38352,2917,38,127,4287,18,7387,5.005.059.524
12/09/2021 20:00,79.54,37969,2945,38,144,4572,19,7718,5.005.059.524
12/09/2021 21:00,70.97,36321,2905,40,158,4820,19,7942,5.005.059.524
12/09/2021 22:00,60.88,34567,2844,46,170,5036,21,8117,5.005.059.524
12/09/2021 23:00,59.44,33572,2482,4,178,5214,22,7900,5.005.059.524
13/09/2021 00:00,58.84,32790,2400,3,186,5430,23,8042,4.887.619.048
13/09/2021 01:00,57.54,32483,2230,2,191,5633,28,8084,4.887.619.048
13/09/2021 02:00,57.22,32768,2072,1,197,5778,25,8073,4.887.619.048
13/09/2021 03:00,57.38,33251,1838,1,200,5826,30,7895,4.887.619.048
13/09/2021 04:00,60.03,35196,1587,1,208,5759,28,7583,4.887.619.048
13/09/2021 05:00,69.81,38474,1352,1,218,5590,30,7191,4.887.619.048
13/09/2021 06:00,79.87,41703,1124,0,228,5242,36,6630,4.887.619.048
13/09/2021 07:00,83.46,43137,966,0,244,5108,30,6348,4.887.619.048
13/09/2021 08:00,84.04,43440,905,0,247,5226,22,6400,4.887.619.048
13/09/2021 09:00,79.79,43518,785,0,246,5253,22,6306,4.887.619.048
13/09/2021 10:00,79.53,43223,760,0,247,5179,22,6208,4.887.619.048
13/09/2021 11:00,79.59,42839,692,1,244,5069,23,6029,4.887.619.048
13/09/2021 12:00,79.4,42422,551,1,225,4974,24,5775,4.887.619.048
13/09/2021 13:00,78.32,42173,503,1,193,4870,25,5592,4.887.619.048
13/09/2021 14:00,78.61,41900,406,1,169,4812,21,5409,4.887.619.048
13/09/2021 15:00,79.79,41552,348,1,153,4688,20,5210,4.887.619.048
13/09/2021 16:00,88.25,41826,325,1,135,4429,19,4909,4.887.619.048
13/09/2021 17:00,91.54,41611,308,1,117,4209,16,4651,4.887.619.048
13/09/2021 18:00,94.46,41514,255,1,104,4145,12,4517,4.887.619.048
13/09/2021 19:00,91.09,41265,216,2,92,4101,8,4419,4.887.619.048
13/09/2021 20:00,88.05,40297,173,2,86,4050,7,4318,4.887.619.048
13/09/2021 21:00,79.6,38239,195,3,76,4017,4,4295,4.887.619.048
13/09/2021 22:00,69.18,36380,208,2,60,3947,3,4220,4.887.619.048
13/09/2021 23:00,66.17,34738,266,59,45,3885,3,4258,4.887.619.048
14/09/2021 00:00,66.37,34246,280,61,40,3748,4,4133,4.887.619.048
14/09/2021 01:00,66.19,34534,267,63,27,3619,5,3981,4.887.619.048
14/09/2021 02:00,65.11,34671,260,63,20,3491,5,3839,4.887.619.048
14/09/2021 03:00,71.68,34335,290,63,17,3358,7,3735,4.887.619.048
14/09/2021 04:00,79.55,36165,270,67,16,3255,9,3617,4.887.619.048
14/09/2021 05:00,96.08,39502,214,87,19,3144,10,3474,4.887.619.048
14/09/2021 06:00,102.95,42534,181,116,26,2916,10,3249,4.887.619.048
14/09/2021 07:00,103.69,43459,161,140,28,2669,13,3011,4.887.619.048
14/09/2021 08:00,104.19,43653,168,155,19,2614,12,2968,4.887.619.048
14/09/2021 09:00,104.61,43541,176,171,15,2615,16,2993,4.887.619.048
14/09/2021 10:00,104.22,43270,167,184,18,2572,13,2954,4.887.619.048
14/09/2021 11:00,104.18,42698,148,196,22,2527,13,2906,4.887.619.048
14/09/2021 12:00,103.78,42469,132,202,24,2457,11,2826,4.887.619.048
14/09/2021 13:00,104.45,42030,120,205,25,2318,8,2676,4.887.619.048
14/09/2021 14:00,105.36,41862,114,208,25,2100,6,2453,4.887.619.048
14/09/2021 15:00,106.59,41809,108,207,24,1804,4,2147,4.887.619.048
14/09/2021 16:00,107.09,41969,115,205,23,1457,3,1803,4.887.619.048
14/09/2021 17:00,106.99,41628,127,202,26,1213,3,1571,4.887.619.048
14/09/2021 18:00,107.43,41842,147,197,30,1165,3,1542,4.887.619.048
14/09/2021 19:00,107.14,41222,186,189,30,1167,2,1574,4.887.619.048
14/09/2021 20:00,104.57,40216,235,173,26,1117,2,1553,4.887.619.048
14/09/2021 21:00,103.98,38253,309,159,20,1043,2,1533,4.887.619.048
14/09/2021 22:00,102.08,36287,407,153,15,949,2,1526,4.887.619.048
14/09/2021 23:00,94.22,34721,642,183,15,1084,3,1927,4.887.619.048
15/09/2021 00:00,93.76,34973,743,182,12,963,2,1902,4.887.619.048
15/09/2021 01:00,93.3,34771,850,179,11,883,2,1925,4.887.619.048
15/09/2021 02:00,93.51,34794,1014,180,9,818,3,2024,4.887.619.048
15/09/2021 03:00,94.54,34389,1265,180,9,771,4,2229,4.887.619.048
15/09/2021 04:00,96.16,36175,1546,165,13,748,3,2475,4.887.619.048
15/09/2021 05:00,110.87,39295,1872,168,22,768,3,2833,4.887.619.048
15/09/2021 06:00,114.48,42249,2160,169,30,784,3,3146,4.887.619.048
15/09/2021 07:00,116.03,43461,2430,170,34,730,3,3367,4.887.619.048
15/09/2021 08:00,115.82,43685,2797,171,28,715,3,3714,4.887.619.048
15/09/2021 09:00,115.96,43671,3042,171,19,816,2,4050,4.887.619.048
15/09/2021 10:00,116.3,43237,3211,171,13,963,2,4360,4.887.619.048
15/09/2021 11:00,116.35,42966,3257,174,9,1103,2,4545,4.887.619.048
15/09/2021 12:00,116.39,42619,3079,178,9,1215,3,4484,4.887.619.048
15/09/2021 13:00,116.33,42393,2913,180,9,1296,2,4400,4.887.619.048
15/09/2021 14:00,116.02,42203,2806,179,9,1369,2,4365,4.887.619.048
15/09/2021 15:00,115.68,42305,2632,174,9,1463,3,4281,4.887.619.048
15/09/2021 16:00,118.36,42429,2466,168,18,1623,3,4278,4.887.619.048
15/09/2021 17:00,119.25,42391,2258,162,42,1955,3,4420,4.887.619.048
15/09/2021 18:00,117.45,42325,2092,156,74,2469,3,4794,4.887.619.048
15/09/2021 19:00,113.57,41768,1912,152,103,2865,5,5037,4.887.619.048
15/09/2021 20:00,108,40496,1708,144,129,3062,6,5049,4.887.619.048
15/09/2021 21:00,102.88,38605,1477,134,146,3140,10,4907,4.887.619.048
15/09/2021 22:00,96.6,36655,1349,123,157,3117,11,4757,4.887.619.048
15/09/2021 23:00,95.45,34818,1561,102,174,2991,13,4841,4.887.619.048
16/09/2021 00:00,93.84,34455,1357,98,181,3000,15,4651,4.887.619.048
16/09/2021 01:00,93.49,34088,1306,97,185,3024,13,4625,4.887.619.048
16/09/2021 02:00,93.13,33913,1333,99,193,3049,14,4688,4.887.619.048
16/09/2021 03:00,93.37,34353,1362,102,206,3067,12,4749,4.887.619.048
16/09/2021 04:00,94.84,36206,1288,92,211,3067,13,4671,4.887.619.048
16/09/2021 05:00,110.01,39260,1206,88,213,3073,14,4594,4.887.619.048
16/09/2021 06:00,116.1,42451,1135,84,214,3055,16,4504,4.887.619.048
16/09/2021 07:00,120.68,43952,1140,77,205,2951,17,4390,4.887.619.048
16/09/2021 08:00,122.9,43888,1226,70,183,2938,8,4425,4.887.619.048
16/09/2021 09:00,123.72,44156,1313,61,171,2947,9,4501,4.887.619.048
16/09/2021 10:00,126.77,44095,1347,52,175,2944,9,4527,4.887.619.048
16/09/2021 11:00,124.17,43851,1377,44,181,2908,11,4521,4.887.619.048
16/09/2021 12:00,125.09,43655,1450,39,185,2857,13,4544,4.887.619.048
16/09/2021 13:00,120.64,43409,1485,33,179,2794,14,4505,4.887.619.048
16/09/2021 14:00,120.91,43135,1592,27,181,2712,12,4524,4.887.619.048
16/09/2021 15:00,122.36,42967,1780,22,183,2619,13,4617,4.887.619.048
16/09/2021 16:00,127.99,43312,1879,18,188,2570,12,4667,4.887.619.048
16/09/2021 17:00,126.05,43280,1899,14,202,2596,15,4726,4.887.619.048
16/09/2021 18:00,124.93,43328,1942,12,213,2694,18,4879,4.887.619.048
16/09/2021 19:00,114.98,42679,1921,11,215,2780,18,4945,4.887.619.048
16/09/2021 20:00,113.11,41196,2008,10,212,2797,22,5049,4.887.619.048
16/09/2021 21:00,109.99,39188,2146,9,206,2762,20,5143,4.887.619.048
16/09/2021 22:00,98.44,37159,2111,7,200,2691,18,5027,4.887.619.048
16/09/2021 23:00,89.39,35841,2307,8,121,2579,14,5029,4.887.619.048
17/09/2021 00:00,87.24,35797,2418,8,111,2520,15,5072,4.887.619.048
17/09/2021 01:00,84.8,35285,2519,7,104,2499,13,5142,4.887.619.048
17/09/2021 02:00,84.16,35028,2431,7,106,2512,13,5069,4.887.619.048
17/09/2021 03:00,86.31,34921,2353,8,109,2535,16,5021,4.887.619.048
17/09/2021 04:00,90.55,36515,2341,9,111,2569,15,5045,4.887.619.048
17/09/2021 05:00,104.93,39838,2365,10,116,2614,15,5120,4.887.619.048
17/09/2021 06:00,114.93,42922,2341,11,122,2631,15,5120,4.887.619.048
17/09/2021 07:00,116.2,44219,2342,11,135,2610,14,5112,4.887.619.048
17/09/2021 08:00,116.22,44466,2444,11,145,2674,14,5288,4.887.619.048
17/09/2021 09:00,117.98,44483,2442,13,157,2778,16,5406,4.887.619.048
17/09/2021 10:00,116.49,44076,2352,14,173,2848,18,5405,4.887.619.048
17/09/2021 11:00,116.39,43575,2221,15,188,2851,18,5293,4.887.619.048
17/09/2021 12:00,116.26,43011,2084,16,196,2807,23,5126,4.887.619.048
17/09/2021 13:00,116.04,42546,1995,18,195,2729,25,4962,4.887.619.048
17/09/2021 14:00,115.29,42208,1854,21,197,2658,22,4752,4.887.619.048
17/09/2021 15:00,116.36,42044,1727,25,201,2577,22,4552,4.887.619.048
17/09/2021 16:00,118.22,42244,1632,33,213,2543,20,4441,4.887.619.048
17/09/2021 17:00,117.33,42364,1590,43,232,2550,17,4432,4.887.619.048
17/09/2021 18:00,116.09,41974,1600,52,250,2629,18,4549,4.887.619.048
17/09/2021 19:00,111.17,41115,1575,56,265,2681,15,4592,4.887.619.048
17/09/2021 20:00,110.45,40149,1621,58,270,2656,16,4621,4.887.619.048
17/09/2021 21:00,101.97,38670,1703,59,264,2576,16,4618,4.887.619.048
17/09/2021 22:00,95.43,37214,1705,59,260,2452,18,4494,4.887.619.048
17/09/2021 23:00,90.76,35612,1730,18,266,2261,14,4289,4.887.619.048
18/09/2021 00:00,90.32,35186,1641,17,258,2137,15,4068,4.887.619.048
18/09/2021 01:00,89.64,34686,1619,15,249,2042,15,3940,4.887.619.048
18/09/2021 02:00,89.72,35013,1546,13,241,1969,13,3782,4.887.619.048
18/09/2021 03:00,89.56,34489,1446,11,237,1907,15,3616,4.887.619.048
18/09/2021 04:00,90.03,34889,1391,10,234,1877,17,3529,4.887.619.048
18/09/2021 05:00,88.9,35516,1388,8,229,1862,16,3503,4.887.619.048
18/09/2021 06:00,90.03,37016,1416,6,227,1804,14,3467,4.887.619.048
18/09/2021 07:00,95.08,38339,1420,4,233,1700,14,3371,4.887.619.048
18/09/2021 08:00,99.65,39904,1468,3,229,1698,17,3415,4.887.619.048
18/09/2021 09:00,103.02,40116,1513,2,225,1806,26,3572,4.887.619.048
18/09/2021 10:00,98.12,39830,1506,2,224,1888,31,3651,4.887.619.048
18/09/2021 11:00,92.66,39493,1458,3,231,1888,36,3616,4.887.619.048
18/09/2021 12:00,89.66,39219,1372,3,241,1839,36,3491,4.887.619.048
18/09/2021 13:00,89.15,39038,1259,3,243,1755,36,3296,4.887.619.048
18/09/2021 14:00,91.68,38908,1151,3,241,1636,36,3067,4.887.619.048
18/09/2021 15:00,99.99,39481,1039,3,230,1511,36,2819,4.887.619.048
18/09/2021 16:00,104.95,40122,1033,3,217,1419,27,2699,4.887.619.048
18/09/2021 17:00,107.84,40543,1130,3,212,1413,18,2776,4.887.619.048
18/09/2021 18:00,106.95,40324,1222,3,213,1577,14,3029,4.887.619.048
18/09/2021 19:00,99.96,39640,1307,4,216,1759,11,3297,4.887.619.048
18/09/2021 20:00,96.22,38567,1460,4,221,1847,15,3547,4.887.619.048
18/09/2021 21:00,90.05,37191,1567,5,229,1869,16,3686,4.887.619.048
18/09/2021 22:00,79.96,35815,1618,6,241,1834,15,3714,4.887.619.048
18/09/2021 23:00,71.53,34498,1451,14,250,1784,16,3515,4.887.619.048
19/09/2021 00:00,68.62,33985,1393,17,256,1713,16,3395,4.887.619.048
19/09/2021 01:00,66.54,33586,1325,22,258,1669,18,3292,4.887.619.048
19/09/2021 02:00,65.16,33406,1301,25,260,1659,18,3263,4.887.619.048
19/09/2021 03:00,65.03,33516,1338,28,260,1681,16,3323,4.887.619.048
19/09/2021 04:00,65.66,33953,1385,31,259,1703,16,3394,4.887.619.048
19/09/2021 05:00,65.01,34344,1417,33,256,1722,17,3445,4.887.619.048
19/09/2021 06:00,65.29,35279,1467,35,253,1701,20,3476,4.887.619.048
19/09/2021 07:00,68.59,37098,1574,37,258,1603,18,3490,4.887.619.048
19/09/2021 08:00,70.91,38441,1751,38,260,1549,25,3623,4.887.619.048
19/09/2021 09:00,69.34,38901,1826,40,261,1628,34,3789,4.887.619.048
19/09/2021 10:00,69.74,39078,1852,44,253,1702,35,3886,4.887.619.048
19/09/2021 11:00,73.81,38921,1761,50,237,1691,30,3769,4.887.619.048
19/09/2021 12:00,68.8,38700,1676,52,223,1610,29,3590,4.887.619.048
19/09/2021 13:00,68.74,38561,1652,57,213,1517,26,3465,4.887.619.048
19/09/2021 14:00,75.83,38798,1631,58,208,1459,26,3382,4.887.619.048
19/09/2021 15:00,84.24,39174,1647,55,200,1409,22,3333,4.887.619.048
19/09/2021 16:00,96.2,40050,1576,51,189,1372,19,3207,4.887.619.048
19/09/2021 17:00,105.39,40700,1507,49,176,1427,14,3173,4.887.619.048
19/09/2021 18:00,107.84,39710,1457,49,178,1606,12,3302,4.887.619.048
19/09/2021 19:00,106.13,40079,1485,54,191,1744,12,3486,4.887.619.048
19/09/2021 20:00,100.35,39444,1489,61,192,1777,13,3532,4.887.619.048
19/09/2021 21:00,90.02,39017,1403,65,184,1751,12,3415,4.887.619.048
19/09/2021 22:00,80.14,37284,1332,67,177,1675,14,3265,4.887.619.048
19/09/2021 23:00,80.27,36146,1145,53,171,1549,17,2935,4.887.619.048
20/09/2021 00:00,74.52,35590,1063,55,167,1491,15,2791,4.865.416.667
20/09/2021 01:00,78.42,34576,1022,59,166,1494,12,2753,4.865.416.667
20/09/2021 02:00,78.78,34449,1070,62,165,1493,11,2801,4.865.416.667
20/09/2021 03:00,81.68,35322,1136,64,162,1467,13,2842,4.865.416.667
20/09/2021 04:00,89.45,37339,1089,65,156,1445,13,2768,4.865.416.667
20/09/2021 05:00,100.81,40594,1072,66,149,1431,14,2732,4.865.416.667
20/09/2021 06:00,112.81,43860,1016,64,137,1356,14,2587,4.865.416.667
20/09/2021 07:00,116.49,45262,976,61,137,1203,9,2386,4.865.416.667
20/09/2021 08:00,116.76,45258,938,61,137,1132,12,2280,4.865.416.667
20/09/2021 09:00,115.94,45506,808,69,137,1169,14,2197,4.865.416.667
20/09/2021 10:00,113.96,45264,665,70,137,1181,11,2064,4.865.416.667
20/09/2021 11:00,112.87,44938,508,76,137,1124,10,1855,4.865.416.667
20/09/2021 12:00,113.24,44592,408,74,137,1078,8,1705,4.865.416.667
20/09/2021 13:00,113.15,44496,354,75,137,1032,8,1606,4.865.416.667
20/09/2021 14:00,110.88,44392,308,77,137,1030,8,1560,4.865.416.667
20/09/2021 15:00,110.38,44172,282,76,137,1045,8,1548,4.865.416.667
20/09/2021 16:00,113.87,44466,244,75,137,1067,8,1531,4.865.416.667
20/09/2021 17:00,112.61,44331,222,77,137,1142,7,1585,4.865.416.667
20/09/2021 18:00,113.74,44286,196,79,137,1308,7,1727,4.865.416.667
20/09/2021 19:00,108.81,43672,170,83,137,1446,6,1842,4.865.416.667
20/09/2021 20:00,105.34,42167,148,76,137,1533,7,1901,4.865.416.667
20/09/2021 21:00,95.31,40384,121,71,137,1623,7,1959,4.865.416.667
20/09/2021 22:00,87.87,38396,94,66,137,1672,5,1974,4.865.416.667
20/09/2021 23:00,87.25,36938,263,95,137,1727,5,2227,4.865.416.667
21/09/2021 00:00,85.97,36113,399,92,137,1840,3,2471,4.865.416.667
21/09/2021 01:00,84.21,35856,437,91,137,1963,3,2631,4.865.416.667
21/09/2021 02:00,83.77,35876,560,90,137,2101,4,2892,4.865.416.667
21/09/2021 03:00,84.94,36010,736,92,137,2238,6,3209,4.865.416.667
21/09/2021 04:00,89.88,37667,826,96,137,2379,5,3443,4.865.416.667
21/09/2021 05:00,97.13,41129,953,99,137,2544,5,3738,4.865.416.667
21/09/2021 06:00,105.92,44305,958,99,137,2635,4,3833,4.865.416.667
21/09/2021 07:00,109.52,44957,1052,102,137,2641,5,3937,4.865.416.667
21/09/2021 08:00,107.62,45433,1192,118,137,2637,4,4088,4.865.416.667
21/09/2021 09:00,106.52,45550,1400,131,137,2685,5,4358,4.865.416.667
21/09/2021 10:00,105.36,45299,1528,131,137,2628,4,4428,4.865.416.667
21/09/2021 11:00,107.06,45037,1644,132,137,2496,3,4412,4.865.416.667
21/09/2021 12:00,107.37,44941,1782,137,137,2318,6,4380,4.865.416.667
21/09/2021 13:00,108.15,44778,1922,140,137,2109,9,4317,4.865.416.667
21/09/2021 14:00,108.39,44434,2050,139,137,1899,7,4232,4.865.416.667
21/09/2021 15:00,109,44369,2190,134,137,1700,7,4168,4.865.416.667
21/09/2021 16:00,110.36,44578,2140,125,137,1519,7,3928,4.865.416.667
21/09/2021 17:00,110.09,44303,1903,111,137,1458,5,3614,4.865.416.667
21/09/2021 18:00,111.67,44773,1831,96,137,1507,5,3576,4.865.416.667
21/09/2021 19:00,110.44,44057,1851,82,137,1550,5,3625,4.865.416.667
21/09/2021 20:00,105.49,42531,1915,66,137,1604,6,3728,4.865.416.667
21/09/2021 21:00,97.15,40452,1867,53,137,1685,7,3749,4.865.416.667
21/09/2021 22:00,90.59,38117,1767,45,137,1782,7,3738,4.865.416.667
21/09/2021 23:00,86.06,36618,1952,39,82,1925,9,4007,4.865.416.667
22/09/2021 00:00,72.58,36046,1731,36,92,2086,12,3957,4.865.416.667
22/09/2021 01:00,67.34,35724,1546,33,101,2289,11,3980,4.865.416.667
22/09/2021 02:00,66.33,35545,1343,30,106,2539,13,4031,4.865.416.667
22/09/2021 03:00,68.88,36098,1151,29,108,2807,12,4107,4.865.416.667
22/09/2021 04:00,82.82,37876,1014,30,113,3104,11,4272,4.865.416.667
22/09/2021 05:00,92.41,41121,935,32,112,3424,11,4514,4.865.416.667
22/09/2021 06:00,100.2,44435,926,31,103,3673,11,4744,4.865.416.667
22/09/2021 07:00,102.08,45780,945,30,84,3808,9,4876,4.865.416.667
22/09/2021 08:00,99.95,45876,1082,31,64,4005,7,5189,4.865.416.667
22/09/2021 09:00,97.96,45628,1313,31,68,4192,6,5610,4.865.416.667
22/09/2021 10:00,97.11,44920,1578,32,76,4444,6,6136,4.865.416.667
22/09/2021 11:00,92.43,44494,1835,37,84,4759,7,6722,4.865.416.667
22/09/2021 12:00,89.11,44126,2058,43,87,5090,7,7285,4.865.416.667
22/09/2021 13:00,87.97,43525,2188,47,83,5342,8,7668,4.865.416.667
22/09/2021 14:00,87.13,43539,2365,48,74,5495,8,7990,4.865.416.667
22/09/2021 15:00,86.73,43385,2468,47,64,5551,7,8137,4.865.416.667
22/09/2021 16:00,86.93,43478,2622,46,52,5536,6,8262,4.865.416.667
22/09/2021 17:00,86.59,43817,2848,44,47,5593,5,8537,4.865.416.667
22/09/2021 18:00,88.27,43754,2938,40,55,5666,5,8704,4.865.416.667
22/09/2021 19:00,86.16,42826,2964,38,55,5656,5,8718,4.865.416.667
22/09/2021 20:00,80.84,41535,3084,35,46,5568,5,8738,4.865.416.667
22/09/2021 21:00,67.81,39672,3140,32,29,5465,5,8671,4.865.416.667
22/09/2021 22:00,61.46,37238,3151,29,16,5287,5,8488,4.865.416.667
22/09/2021 23:00,61.94,35601,3334,33,10,4847,6,8230,4.865.416.667
23/09/2021 00:00,62.26,35182,3375,33,13,4607,14,8042,4.865.416.667
23/09/2021 01:00,57.77,34578,3457,35,28,4509,15,8044,4.865.416.667
23/09/2021 02:00,55.72,34610,3569,37,51,4517,14,8188,4.865.416.667
23/09/2021 03:00,55.92,35255,3700,37,74,4561,12,8384,4.865.416.667
23/09/2021 04:00,59.11,37068,3818,37,97,4601,14,8567,4.865.416.667
23/09/2021 05:00,68.92,40695,4136,37,110,4615,15,8913,4.865.416.667
23/09/2021 06:00,85.99,43726,4276,32,125,4593,14,9040,4.865.416.667
23/09/2021 07:00,87.74,44620,4344,23,140,4595,12,9114,4.865.416.667
23/09/2021 08:00,88.43,44973,4756,19,140,4771,12,9698,4.865.416.667
23/09/2021 09:00,81.95,45233,5104,16,141,4958,16,10235,4.865.416.667
23/09/2021 10:00,64.79,45054,5227,13,158,5140,14,10552,4.865.416.667
23/09/2021 11:00,62.62,44859,5152,13,190,5306,11,10672,4.865.416.667
23/09/2021 12:00,61.35,42942,5140,15,224,5540,11,10930,4.865.416.667
23/09/2021 13:00,57.52,42657,5231,17,247,5727,14,11236,4.865.416.667
23/09/2021 14:00,59.03,43758,5300,18,277,5909,18,11522,4.865.416.667
23/09/2021 15:00,62.44,43752,5317,18,304,6124,23,11786,4.865.416.667
23/09/2021 16:00,65.78,44436,5192,17,337,6365,33,11944,4.865.416.667
23/09/2021 17:00,68.64,44076,5098,17,368,6671,36,12190,4.865.416.667
23/09/2021 18:00,69.21,43933,5030,16,407,6864,36,12353,4.865.416.667
23/09/2021 19:00,65.03,43392,5020,15,429,6904,40,12408,4.865.416.667
23/09/2021 20:00,62.35,42043,5133,13,417,6875,26,12464,4.865.416.667
23/09/2021 21:00,58.85,40110,5216,11,377,6811,27,12442,4.865.416.667
23/09/2021 22:00,55.25,38343,5188,10,349,6728,21,12296,4.865.416.667
23/09/2021 23:00,50.33,36627,5133,11,376,6744,14,12278,4.865.416.667
24/09/2021 00:00,50.83,35944,5030,15,369,6560,19,11993,4.865.416.667
24/09/2021 01:00,54.14,35703,4848,18,370,6351,24,11611,4.865.416.667
24/09/2021 02:00,56.01,35825,4595,20,381,6076,24,11096,4.865.416.667
24/09/2021 03:00,58.44,36390,4349,23,391,5722,36,10521,4.865.416.667
24/09/2021 04:00,63.26,38123,4123,33,396,5315,41,9908,4.865.416.667
24/09/2021 05:00,82.82,41082,3976,41,403,4913,45,9378,4.865.416.667
24/09/2021 06:00,96.67,44127,3585,45,407,4410,38,8485,4.865.416.667
24/09/2021 07:00,105.13,45326,3182,49,415,3832,32,7510,4.865.416.667
24/09/2021 08:00,109.26,45435,3067,65,431,3287,31,6881,4.865.416.667
24/09/2021 09:00,107.2,44837,3055,92,438,2879,30,6494,4.865.416.667
24/09/2021 10:00,97.96,44792,3087,118,440,2573,25,6243,4.865.416.667
24/09/2021 11:00,89.01,44062,3337,138,440,2433,25,6373,4.865.416.667
24/09/2021 12:00,82.36,44115,3669,153,438,2444,36,6740,4.865.416.667
24/09/2021 13:00,68.71,43405,4052,163,431,2551,47,7244,4.865.416.667
24/09/2021 14:00,69.76,43359,4476,175,414,2784,45,7894,4.865.416.667
24/09/2021 15:00,76.49,43564,4774,188,391,3149,45,8547,4.865.416.667
24/09/2021 16:00,83.38,43750,4647,204,359,3562,38,8810,4.865.416.667
24/09/2021 17:00,82.31,43666,4429,216,313,3982,33,8973,4.865.416.667
24/09/2021 18:00,82.03,43484,4210,223,268,4251,24,8976,4.865.416.667
24/09/2021 19:00,71.5,42205,4053,227,230,4326,13,8849,4.865.416.667
24/09/2021 20:00,67.34,40865,4047,227,210,4300,10,8794,4.865.416.667
24/09/2021 21:00,63.55,39436,3992,223,203,4232,11,8661,4.865.416.667
24/09/2021 22:00,59.62,37814,3893,213,211,4145,11,8473,4.865.416.667
24/09/2021 23:00,60.89,36014,3715,63,215,4342,11,8346,4.865.416.667
25/09/2021 00:00,60.76,35385,3586,62,242,4375,12,8277,4.865.416.667
25/09/2021 01:00,60.04,34858,3560,61,288,4485,19,8413,4.865.416.667
25/09/2021 02:00,59.8,34506,3520,63,339,4664,32,8618,4.865.416.667
25/09/2021 03:00,60.4,34710,3390,63,373,4871,36,8733,4.865.416.667
25/09/2021 04:00,61.17,35297,3174,64,388,5051,36,8713,4.865.416.667
25/09/2021 05:00,65.01,35660,3002,61,392,5175,33,8663,4.865.416.667
25/09/2021 06:00,69.86,37409,2658,54,394,5200,33,8339,4.865.416.667
25/09/2021 07:00,79.28,39189,2476,45,398,5150,35,8104,4.865.416.667
25/09/2021 08:00,84.52,40249,2487,42,395,5051,31,8006,4.865.416.667
25/09/2021 09:00,83.4,40574,2536,49,399,5106,28,8118,4.865.416.667
25/09/2021 10:00,75.04,40272,2367,57,403,5241,34,8102,4.865.416.667
25/09/2021 11:00,69.82,39727,2036,64,395,5233,36,7764,4.865.416.667
25/09/2021 12:00,69.82,39295,1728,67,385,5189,37,7406,4.865.416.667
25/09/2021 13:00,70.74,39092,1445,71,377,5075,36,7004,4.865.416.667
25/09/2021 14:00,81.05,38881,1204,78,354,4816,31,6483,4.865.416.667
25/09/2021 15:00,87.13,39618,1036,82,321,4438,25,5902,4.865.416.667
25/09/2021 16:00,94.96,40284,773,80,271,4065,17,5206,4.865.416.667
25/09/2021 17:00,99.13,40801,476,77,225,3837,16,4631,4.865.416.667
25/09/2021 18:00,102.24,40777,260,73,202,3777,12,4324,4.865.416.667
25/09/2021 19:00,98.19,39938,149,71,186,3620,9,4035,4.865.416.667
25/09/2021 20:00,96.11,39205,87,70,168,3347,9,3681,4.865.416.667
25/09/2021 21:00,91.81,38000,80,69,144,3030,6,3329,4.865.416.667
25/09/2021 22:00,85.99,36602,110,68,117,2652,6,2953,4.865.416.667
25/09/2021 23:00,86.89,35334,131,73,85,2186,8,2483,4.865.416.667
26/09/2021 00:00,84.64,34033,196,73,70,1849,8,2196,4.865.416.667
26/09/2021 01:00,82.28,33737,245,74,58,1549,7,1933,4.865.416.667
26/09/2021 02:00,74.25,33632,306,75,49,1305,8,1743,4.865.416.667
26/09/2021 03:00,75.01,34053,369,76,42,1158,7,1652,4.865.416.667
26/09/2021 04:00,79.34,34254,430,78,36,1107,6,1657,4.865.416.667
26/09/2021 05:00,83.08,34858,472,77,29,1201,5,1784,4.865.416.667
26/09/2021 06:00,84.18,36690,553,80,24,1413,5,2075,4.865.416.667
26/09/2021 07:00,94.98,38168,638,90,20,1587,5,2340,4.865.416.667
26/09/2021 08:00,96.05,37704,764,110,13,1466,5,2358,4.865.416.667
26/09/2021 09:00,91.9,38832,835,130,8,1232,5,2210,4.865.416.667
26/09/2021 10:00,86.31,38696,966,134,9,1182,5,2296,4.865.416.667
26/09/2021 11:00,83.49,38662,1124,132,11,1239,5,2511,4.865.416.667
26/09/2021 12:00,78.79,38212,1245,130,11,1330,5,2721,4.865.416.667
26/09/2021 13:00,76,38072,1369,129,11,1425,5,2939,4.865.416.667
26/09/2021 14:00,82.02,38247,1485,127,10,1521,5,3148,4.865.416.667
26/09/2021 15:00,86.98,38433,1703,124,10,1649,5,3491,4.865.416.667
26/09/2021 16:00,97.42,39688,1799,122,14,2048,5,3988,4.865.416.667
26/09/2021 17:00,97.8,39713,1970,119,28,2745,5,4867,4.865.416.667
26/09/2021 18:00,97.21,39811,2176,114,48,3479,6,5823,4.865.416.667
26/09/2021 19:00,92.81,39197,2361,110,67,3886,8,6432,4.865.416.667
26/09/2021 20:00,86.38,38236,2645,103,84,4039,8,6879,4.865.416.667
26/09/2021 21:00,77.5,37435,2745,96,112,4113,9,7075,4.865.416.667
26/09/2021 22:00,67.83,36071,2751,91,141,4139,12,7134,4.865.416.667
26/09/2021 23:00,67.68,34410,2347,173,157,3997,11,6685,4.865.416.667
27/09/2021 00:00,65.81,34000,2205,143,145,3962,13,6468,498.672.619
27/09/2021 01:00,61.96,33661,2108,131,131,3933,15,6318,498.672.619
27/09/2021 02:00,60.15,33584,2045,120,121,3904,14,6204,498.672.619
27/09/2021 03:00,62.17,34228,2018,108,111,3887,15,6139,498.672.619
27/09/2021 04:00,69.82,36176,2002,101,104,3900,15,6122,498.672.619
27/09/2021 05:00,85.85,39762,2050,96,108,3973,15,6242,498.672.619
27/09/2021 06:00,96.03,43197,2030,89,116,4025,12,6272,498.672.619
27/09/2021 07:00,99.46,44004,2057,86,100,3887,9,6139,498.672.619
27/09/2021 08:00,101.47,43885,2206,82,66,3622,7,5983,498.672.619
27/09/2021 09:00,102.61,44351,2325,70,56,3342,7,5800,498.672.619
27/09/2021 10:00,99.84,44183,2347,56,59,3434,7,5903,498.672.619
27/09/2021 11:00,96.57,43519,2512,43,68,3750,8,6381,498.672.619
27/09/2021 12:00,90.39,42823,2618,36,73,4025,9,6761,498.672.619
27/09/2021 13:00,88.07,42384,2730,30,80,4222,9,7071,498.672.619
27/09/2021 14:00,87.68,42614,2862,25,91,4379,9,7366,498.672.619
27/09/2021 15:00,87.33,42697,2947,21,98,4529,9,7604,498.672.619
27/09/2021 16:00,89.23,43087,2877,18,107,4818,9,7829,498.672.619
27/09/2021 17:00,88.8,43337,2877,18,136,5363,9,8403,498.672.619
27/09/2021 18:00,86.05,43597,2963,18,170,5884,12,9047,498.672.619
27/09/2021 19:00,83.15,42772,3022,20,184,6110,14,9350,498.672.619
27/09/2021 20:00,73.15,40790,3042,25,188,6126,13,9394,498.672.619
27/09/2021 21:00,64.68,39115,2960,31,193,6082,16,9282,498.672.619
27/09/2021 22:00,60.89,36730,2782,37,191,6011,15,9036,498.672.619
27/09/2021 23:00,60.94,35236,2435,11,173,6025,12,8656,498.672.619
28/09/2021 00:00,60.17,34554,2096,10,164,5839,14,8123,498.672.619
28/09/2021 01:00,59.56,34675,1772,10,153,5638,14,7587,498.672.619
28/09/2021 02:00,59.89,33906,1551,10,140,5460,12,7173,498.672.619
28/09/2021 03:00,62.67,34465,1426,10,139,5285,11,6871,498.672.619
28/09/2021 04:00,69.6,37178,1243,10,150,5124,10,6537,498.672.619
28/09/2021 05:00,84.29,41027,1061,10,157,4930,10,6168,498.672.619
28/09/2021 06:00,95.82,43863,965,9,154,4688,10,5826,498.672.619
28/09/2021 07:00,101.07,44625,890,8,138,4410,8,5454,498.672.619
28/09/2021 08:00,102.71,44839,813,6,118,4226,8,5171,498.672.619
28/09/2021 09:00,103.28,44412,780,7,122,4028,9,4946,498.672.619
28/09/2021 10:00,102.91,44394,718,6,141,3891,12,4768,498.672.619
28/09/2021 11:00,100.99,43194,651,6,161,3770,15,4603,498.672.619
28/09/2021 12:00,100.11,43234,614,6,168,3598,17,4403,498.672.619
28/09/2021 13:00,101.49,42745,566,6,156,3345,14,4087,498.672.619
28/09/2021 14:00,102.43,42514,490,9,136,3075,11,3721,498.672.619
28/09/2021 15:00,103.06,42504,424,12,113,2849,9,3407,498.672.619
28/09/2021 16:00,105.29,42974,362,19,104,2696,8,3189,498.672.619
28/09/2021 17:00,105.89,43012,325,27,116,2671,9,3148,498.672.619
28/09/2021 18:00,107.33,43173,335,34,134,2743,10,3256,498.672.619
28/09/2021 19:00,101.92,42288,328,41,143,2773,11,3296,498.672.619
28/09/2021 20:00,95.91,40952,339,45,148,2733,11,3276,498.672.619
28/09/2021 21:00,90.69,38839,415,46,149,2688,10,3308,498.672.619
28/09/2021 22:00,83.82,36726,527,42,152,2645,10,3376,498.672.619
28/09/2021 23:00,77.7,35071,826,44,149,2706,10,3735,498.672.619
29/09/2021 00:00,73.18,34598,926,43,149,2676,10,3804,498.672.619
29/09/2021 01:00,63.67,34184,981,42,147,2693,10,3873,498.672.619
29/09/2021 02:00,61.61,34034,1125,41,145,2726,10,4047,498.672.619
29/09/2021 03:00,62.07,34554,1244,40,145,2771,8,4208,498.672.619
29/09/2021 04:00,74.94,36614,1299,40,147,2863,9,4358,498.672.619
29/09/2021 05:00,88.07,39870,1475,40,150,2970,10,4645,498.672.619
29/09/2021 06:00,101.95,43129,1550,39,155,3042,10,4796,498.672.619
29/09/2021 07:00,107.13,44319,1598,32,149,3086,10,4875,498.672.619
29/09/2021 08:00,104.98,44094,1685,24,136,3178,10,5033,498.672.619
29/09/2021 09:00,103.48,44092,1839,23,143,3320,11,5336,498.672.619
29/09/2021 10:00,103.92,43950,1888,25,172,3473,12,5570,498.672.619
29/09/2021 11:00,102.96,43986,1942,25,212,3550,12,5741,498.672.619
29/09/2021 12:00,94.35,43365,2068,23,235,3593,12,5931,498.672.619
29/09/2021 13:00,90.61,43295,2214,22,238,3626,12,6112,498.672.619
29/09/2021 14:00,85.71,43376,2265,19,238,3710,13,6245,498.672.619
29/09/2021 15:00,89.66,43369,2200,17,232,3755,14,6218,498.672.619
29/09/2021 16:00,104.6,43784,2279,19,231,3844,12,6385,498.672.619
29/09/2021 17:00,104.59,44019,2260,25,250,4051,13,6599,498.672.619
29/09/2021 18:00,102.3,44083,2283,31,270,4264,13,6861,498.672.619
29/09/2021 19:00,93.89,43064,2384,37,285,4365,16,7087,498.672.619
29/09/2021 20:00,85.39,41529,2468,40,298,4336,17,7159,498.672.619
29/09/2021 21:00,69.2,39486,2575,40,310,4242,17,7184,498.672.619
29/09/2021 22:00,57.89,37178,2676,36,310,4150,16,7188,498.672.619
29/09/2021 23:00,55.76,35543,2380,44,322,4011,22,6779,498.672.619
30/09/2021 00:00,55.06,35111,2505,46,328,3890,21,6790,498.672.619
30/09/2021 01:00,53.14,34773,2554,47,333,3834,22,6790,498.672.619
30/09/2021 02:00,54.15,34828,2586,46,333,3789,20,6774,498.672.619
30/09/2021 03:00,55.83,35420,2795,44,323,3734,24,6920,498.672.619
30/09/2021 04:00,63.08,37450,2797,42,310,3693,22,6864,498.672.619
30/09/2021 05:00,76.97,40845,2886,41,298,3642,25,6892,498.672.619
30/09/2021 06:00,94.21,43816,2966,38,294,3552,28,6878,498.672.619
30/09/2021 07:00,98.18,44954,3175,31,291,3490,25,7012,498.672.619
30/09/2021 08:00,94.29,44772,3426,25,271,3536,22,7280,498.672.619
30/09/2021 09:00,85.5,45007,3750,24,250,3633,26,7683,498.672.619
30/09/2021 10:00,81.84,44750,3860,26,232,3737,25,7880,498.672.619
30/09/2021 11:00,67.34,44367,3856,29,207,3849,20,7961,498.672.619
30/09/2021 12:00,63.58,44297,4014,28,174,3963,18,8197,498.672.619
30/09/2021 13:00,64.27,44436,4150,27,149,4044,15,8385,498.672.619
30/09/2021 14:00,70.9,44210,4347,24,134,4126,13,8644,498.672.619
30/09/2021 15:00,85.7,44606,4451,24,121,4184,13,8793,498.672.619
30/09/2021 16:00,90.05,44670,4159,27,108,4253,15,8562,498.672.619
30/09/2021 17:00,91.31,44757,3801,36,94,4355,13,8299,498.672.619
30/09/2021 18:00,91.77,44916,3552,45,77,4437,14,8125,498.672.619
30/09/2021 19:00,86.46,43764,3602,51,62,4500,13,8228,498.672.619
30/09/2021 20:00,73.65,42165,3743,57,52,4514,11,8377,498.672.619
30/09/2021 21:00,65.22,39988,3915,60,46,4536,9,8566,498.672.619
30/09/2021 22:00,55.96,38198,4229,60,43,4561,9,8902,498.672.619
30/09/2021 23:00,50.37,36469,4478,56,45,4649,12,9240,498.672.619
01/10/2021 00:00,42.71,35836,4928,55,41,4773,13,9810,498.672.619
01/10/2021 01:00,30.9,35500,5115,56,37,4931,13,10152,498.672.619
01/10/2021 02:00,35.69,35180,5014,58,34,5072,13,10191,498.672.619
01/10/2021 03:00,39.66,35882,4793,61,32,5213,12,10111,498.672.619
01/10/2021 04:00,46.54,37766,4571,63,32,5478,12,10156,498.672.619
01/10/2021 05:00,56.06,41142,4507,64,34,5812,11,10428,498.672.619
01/10/2021 06:00,62.85,44711,4318,61,36,6121,13,10549,498.672.619
01/10/2021 07:00,65.34,45728,4230,56,34,6346,12,10678,498.672.619
01/10/2021 08:00,63.91,45900,4539,57,28,6537,11,11172,498.672.619
01/10/2021 09:00,58.23,46024,4835,61,22,6687,11,11616,498.672.619
01/10/2021 10:00,56.21,45522,4911,67,21,6812,12,11823,498.672.619
01/10/2021 11:00,54.98,45036,4862,71,24,6885,13,11855,498.672.619
01/10/2021 12:00,50.53,44508,4808,73,25,6899,14,11819,498.672.619
01/10/2021 13:00,54.37,43649,4773,74,25,6918,15,11805,498.672.619
01/10/2021 14:00,55.46,43335,4752,73,24,7017,14,11880,498.672.619
01/10/2021 15:00,57.77,43239,4730,72,29,7069,13,11913,498.672.619
01/10/2021 16:00,59.76,43871,4534,77,48,7121,11,11791,498.672.619
01/10/2021 17:00,60.21,43847,4334,84,83,7221,12,11734,498.672.619
01/10/2021 18:00,59.64,43225,4231,91,119,7348,15,11804,498.672.619
01/10/2021 19:00,56.12,41448,4168,96,132,7452,16,11864,498.672.619
01/10/2021 20:00,53.55,39784,4137,100,133,7479,18,11867,498.672.619
01/10/2021 21:00,50.51,38397,3945,101,131,7465,16,11658,498.672.619
01/10/2021 22:00,47.01,36845,3552,96,133,7434,16,11231,498.672.619
01/10/2021 23:00,41.14,34992,2729,28,136,7721,12,10626,498.672.619
02/10/2021 00:00,46.15,34570,2407,32,138,7616,11,10204,498.672.619
02/10/2021 01:00,49.49,34282,2068,35,134,7475,11,9723,498.672.619
02/10/2021 02:00,55.1,33915,1708,35,132,7327,11,9213,498.672.619
02/10/2021 03:00,56.09,34105,1437,39,133,7204,13,8826,498.672.619
02/10/2021 04:00,57.55,35205,1239,42,137,7110,13,8541,498.672.619
02/10/2021 05:00,57.19,36586,1134,37,139,7049,14,8373,498.672.619
02/10/2021 06:00,58.35,37724,1022,32,142,6959,13,8168,498.672.619
02/10/2021 07:00,62.56,39039,926,34,154,6845,13,7972,498.672.619
02/10/2021 08:00,67.24,40334,912,39,159,6778,14,7902,498.672.619
02/10/2021 09:00,69.82,41133,929,44,169,6752,15,7909,498.672.619
02/10/2021 10:00,67.44,40364,840,50,204,6701,16,7811,498.672.619
02/10/2021 11:00,63.8,40243,751,56,239,6555,16,7617,498.672.619
02/10/2021 12:00,57.63,39815,809,63,265,6351,16,7504,498.672.619
02/10/2021 13:00,56.25,39660,887,74,261,6104,18,7344,498.672.619
02/10/2021 14:00,55.88,39674,960,83,246,5875,18,7182,498.672.619
02/10/2021 15:00,57.43,39864,1064,86,229,5724,15,7118,498.672.619
02/10/2021 16:00,65.39,40844,1155,94,217,5685,12,7163,498.672.619
02/10/2021 17:00,74.35,41288,1404,113,229,5786,15,7547,498.672.619
02/10/2021 18:00,69.88,41086,1743,126,244,5919,18,8050,498.672.619
02/10/2021 19:00,61.75,39621,2161,136,244,6012,19,8572,498.672.619
02/10/2021 20:00,49.42,38516,2802,145,236,6009,16,9208,498.672.619
02/10/2021 21:00,31.9,37452,3279,157,231,5971,15,9653,498.672.619
02/10/2021 22:00,5.94,35969,3589,157,226,5915,17,9904,498.672.619
02/10/2021 23:00,0.07,34233,4289,172,196,6007,15,10679,498.672.619
03/10/2021 00:00,0.04,32938,4532,165,185,5756,16,10654,498.672.619
03/10/2021 01:00,-0.01,32889,4910,156,180,5302,13,10561,498.672.619
03/10/2021 02:00,-0.03,31469,5103,149,189,5374,12,10827,498.672.619
03/10/2021 03:00,-0.08,31349,5076,141,205,5335,13,10770,498.672.619
03/10/2021 04:00,-0.03,31839,5062,130,223,5853,13,11281,498.672.619
03/10/2021 05:00,0.02,33836,5129,115,237,6554,14,12049,498.672.619
03/10/2021 06:00,0.01,34661,4957,100,241,6893,15,12206,498.672.619
03/10/2021 07:00,0.33,36261,4810,87,239,7399,16,12551,498.672.619
03/10/2021 08:00,3.61,37386,4975,77,222,7813,15,13102,498.672.619
03/10/2021 09:00,8.36,38492,5056,67,213,7972,15,13323,498.672.619
03/10/2021 10:00,23.33,38882,4947,61,228,8085,17,13338,498.672.619
03/10/2021 11:00,22.94,38899,4540,54,248,8144,17,13003,498.672.619
03/10/2021 12:00,19.95,38698,4055,48,272,8165,17,12557,498.672.619
03/10/2021 13:00,22.55,38813,3661,43,287,8198,21,12210,498.672.619
03/10/2021 14:00,26.01,38957,3416,37,299,8251,20,12023,498.672.619
03/10/2021 15:00,34.23,39156,3285,29,315,8282,19,11930,498.672.619
03/10/2021 16:00,48.34,39942,3188,25,333,8356,20,11922,498.672.619
03/10/2021 17:00,52.44,41055,3041,23,354,8517,23,11958,498.672.619
03/10/2021 18:00,55.64,41169,2965,21,370,8667,25,12048,498.672.619
03/10/2021 19:00,51.49,40000,2865,21,369,8715,28,11998,498.672.619
03/10/2021 20:00,49.3,38981,2760,20,358,8691,28,11857,498.672.619
03/10/2021 21:00,46.22,37617,2573,18,345,8575,26,11537,498.672.619
03/10/2021 22:00,31.56,35678,2478,16,337,8340,26,11197,498.672.619
03/10/2021 23:00,19.16,34112,2747,86,332,8375,24,11564,498.672.619
04/10/2021 00:00,20,33159,2692,79,328,8021,24,11144,5.157.261.905
04/10/2021 01:00,20.15,32840,2667,73,325,7661,24,10750,5.157.261.905
04/10/2021 02:00,20.09,32554,2598,69,315,7356,24,10362,5.157.261.905
04/10/2021 03:00,32.31,33317,2503,66,304,6998,21,9892,5.157.261.905
04/10/2021 04:00,50.51,35857,2457,64,298,6699,21,9539,5.157.261.905
04/10/2021 05:00,61.04,39459,2378,60,295,6383,21,9137,5.157.261.905
04/10/2021 06:00,64.81,42135,2232,54,287,6020,21,8614,5.157.261.905
04/10/2021 07:00,67.24,43170,2186,49,273,5640,21,8169,5.157.261.905
04/10/2021 08:00,67.33,43565,2376,46,254,5419,18,8113,5.157.261.905
04/10/2021 09:00,67.12,43981,2518,43,245,5209,18,8033,5.157.261.905
04/10/2021 10:00,67.03,43671,2591,40,246,5052,18,7947,5.157.261.905
04/10/2021 11:00,67.05,43079,2584,40,253,4952,17,7846,5.157.261.905
04/10/2021 12:00,65.09,42605,2476,41,258,4826,18,7619,5.157.261.905
04/10/2021 13:00,64.69,42278,2513,42,248,4625,18,7446,5.157.261.905
04/10/2021 14:00,67.3,42348,2568,42,242,4400,17,7269,5.157.261.905
04/10/2021 15:00,67.85,42420,2589,45,245,4291,15,7185,5.157.261.905
04/10/2021 16:00,70.54,43138,2489,49,257,4331,11,7137,5.157.261.905
04/10/2021 17:00,70.69,43600,2348,57,267,4493,14,7179,5.157.261.905
04/10/2021 18:00,73.32,43821,2360,64,266,4655,14,7359,5.157.261.905
04/10/2021 19:00,66.25,42154,2430,70,256,4747,14,7517,5.157.261.905
04/10/2021 20:00,61.88,40436,2628,72,246,4749,16,7711,5.157.261.905
04/10/2021 21:00,56.7,38578,2776,71,236,4685,15,7783,5.157.261.905
04/10/2021 22:00,46.84,36437,2729,65,231,4613,13,7651,5.157.261.905
04/10/2021 23:00,45.16,34402,2712,190,228,4509,15,7654,5.157.261.905
05/10/2021 00:00,46.35,33998,2542,189,230,4448,14,7423,5.157.261.905
05/10/2021 01:00,46.2,33680,2353,187,227,4368,14,7149,5.157.261.905
05/10/2021 02:00,45.07,33590,2252,185,228,4256,12,6933,5.157.261.905
05/10/2021 03:00,47.98,34292,2123,184,237,4137,12,6693,5.157.261.905
05/10/2021 04:00,55.83,36246,2042,185,249,4064,13,6553,5.157.261.905
05/10/2021 05:00,71.44,39646,2061,184,263,4090,13,6611,5.157.261.905
05/10/2021 06:00,89.06,43246,1985,182,284,4092,13,6556,5.157.261.905
05/10/2021 07:00,91.98,44277,1990,179,299,3976,12,6456,5.157.261.905
05/10/2021 08:00,91.32,44021,2055,179,308,4026,11,6579,5.157.261.905
05/10/2021 09:00,90.94,44275,2116,181,327,4067,11,6702,5.157.261.905
05/10/2021 10:00,90.5,43887,2132,181,347,4026,10,6696,5.157.261.905
05/10/2021 11:00,90.6,44062,2172,179,358,3959,11,6679,5.157.261.905
05/10/2021 12:00,89.8,43527,2215,178,373,3868,13,6647,5.157.261.905
05/10/2021 13:00,89.51,43225,2180,175,382,3732,14,6483,5.157.261.905
05/10/2021 14:00,90.85,43284,2222,179,396,3594,14,6405,5.157.261.905
05/10/2021 15:00,90.92,43498,2257,183,417,3569,17,6443,5.157.261.905
05/10/2021 16:00,91.89,43873,2103,185,440,3784,19,6531,5.157.261.905
05/10/2021 17:00,95.64,44258,1923,188,455,4127,23,6716,5.157.261.905
05/10/2021 18:00,95.78,44272,1781,193,465,4390,23,6852,5.157.261.905
05/10/2021 19:00,91.99,42711,1682,198,464,4407,29,6780,5.157.261.905
05/10/2021 20:00,89.55,41069,1631,200,465,4269,35,6600,5.157.261.905
05/10/2021 21:00,78.7,39154,1578,199,465,4121,36,6399,5.157.261.905
05/10/2021 22:00,67.53,36988,1439,193,462,3927,36,6057,5.157.261.905
05/10/2021 23:00,49.71,35564,1520,188,465,3954,39,6166,5.157.261.905
06/10/2021 00:00,45.67,34995,1339,181,463,3741,40,5764,5.157.261.905
06/10/2021 01:00,40.02,34586,1198,174,463,3514,39,5388,5.157.261.905
06/10/2021 02:00,34.31,34772,1131,170,458,3306,38,5103,5.157.261.905
06/10/2021 03:00,43.65,35218,1145,169,451,3148,36,4949,5.157.261.905
06/10/2021 04:00,55.31,37152,1184,170,444,3011,37,4846,5.157.261.905
06/10/2021 05:00,87.71,40924,1282,175,436,2855,37,4785,5.157.261.905
06/10/2021 06:00,100.41,44094,1346,179,429,2739,36,4729,5.157.261.905
06/10/2021 07:00,105.59,45171,1358,182,424,2603,36,4603,5.157.261.905
06/10/2021 08:00,105.8,45213,1416,185,422,2568,34,4625,5.157.261.905
06/10/2021 09:00,105.49,45361,1387,188,423,2609,31,4638,5.157.261.905
06/10/2021 10:00,105.16,45166,1288,188,421,2625,32,4554,5.157.261.905
06/10/2021 11:00,104.02,44939,1113,185,420,2574,29,4321,5.157.261.905
06/10/2021 12:00,103.04,44166,975,179,420,2475,31,4080,5.157.261.905
06/10/2021 13:00,102.53,43710,860,175,413,2356,31,3835,5.157.261.905
06/10/2021 14:00,102.12,43570,784,173,402,2252,29,3640,5.157.261.905
06/10/2021 15:00,103.24,43692,763,172,385,2200,22,3542,5.157.261.905
06/10/2021 16:00,103.54,44192,655,175,373,2242,20,3465,5.157.261.905
06/10/2021 17:00,103.32,44631,548,179,367,2367,22,3483,5.157.261.905
06/10/2021 18:00,103.97,44596,517,186,360,2484,24,3571,5.157.261.905
06/10/2021 19:00,98.74,43179,512,195,361,2560,24,3652,5.157.261.905
06/10/2021 20:00,96.13,41704,462,201,363,2585,22,3633,5.157.261.905
06/10/2021 21:00,91.05,39624,427,202,356,2611,23,3619,5.157.261.905
06/10/2021 22:00,71.91,37250,404,203,341,2650,23,3621,5.157.261.905
06/10/2021 23:00,72.4,35441,392,203,305,2085,22,3007,5.157.261.905
07/10/2021 00:00,71.01,34555,370,204,295,2192,20,3081,5.157.261.905
07/10/2021 01:00,68.56,34324,325,205,281,2312,17,3140,5.157.261.905
07/10/2021 02:00,68.22,34458,288,207,271,2394,17,3177,5.157.261.905
07/10/2021 03:00,70.94,35068,267,212,262,2534,17,3292,5.157.261.905
07/10/2021 04:00,76.3,37105,249,216,252,2691,17,3425,5.157.261.905
07/10/2021 05:00,99.57,40967,249,218,243,2890,15,3615,5.157.261.905
07/10/2021 06:00,106.06,44168,266,220,232,3029,14,3761,5.157.261.905
07/10/2021 07:00,110.96,45110,286,221,215,3018,14,3754,5.157.261.905
07/10/2021 08:00,111.77,45106,351,222,192,3038,14,3817,5.157.261.905
07/10/2021 09:00,112.19,45120,408,227,168,3017,12,3832,5.157.261.905
07/10/2021 10:00,110.31,44726,426,229,141,2983,11,3790,5.157.261.905
07/10/2021 11:00,109.37,44217,431,229,130,2967,9,3766,5.157.261.905
07/10/2021 12:00,107.74,43927,438,228,122,2920,8,3716,5.157.261.905
07/10/2021 13:00,105.93,43660,378,224,116,2713,8,3439,5.157.261.905
07/10/2021 14:00,109.88,43574,322,225,105,2364,7,3023,5.157.261.905
07/10/2021 15:00,113.03,43778,291,224,91,1987,7,2600,5.157.261.905
07/10/2021 16:00,117.94,44267,255,222,97,1770,6,2350,5.157.261.905
07/10/2021 17:00,120.43,44717,257,221,132,1742,6,2358,5.157.261.905
07/10/2021 18:00,121.11,44690,291,224,169,1766,6,2456,5.157.261.905
07/10/2021 19:00,112.17,43442,320,225,177,1716,6,2444,5.157.261.905
07/10/2021 20:00,109.08,41967,362,226,171,1630,7,2396,5.157.261.905
07/10/2021 21:00,103.64,39963,428,225,163,1580,8,2404,5.157.261.905
07/10/2021 22:00,99.18,37711,476,220,152,1563,8,2419,5.157.261.905
07/10/2021 23:00,82.5,36269,552,215,141,1577,8,2493,5.157.261.905
08/10/2021 00:00,78.22,35419,570,210,129,1494,8,2411,5.157.261.905
08/10/2021 01:00,74.14,35025,559,204,118,1566,7,2454,5.157.261.905
08/10/2021 02:00,73.26,35113,537,200,111,1772,7,2627,5.157.261.905
08/10/2021 03:00,74.17,35844,475,197,106,2005,7,2790,5.157.261.905
08/10/2021 04:00,85.53,37875,445,194,99,2212,7,2957,5.157.261.905
08/10/2021 05:00,98.55,41543,462,191,96,2451,8,3208,5.157.261.905
08/10/2021 06:00,106.57,44709,477,187,92,2636,8,3400,5.157.261.905
08/10/2021 07:00,109.75,45581,469,182,76,2666,8,3401,5.157.261.905
08/10/2021 08:00,109.29,45694,501,180,41,2646,6,3374,5.157.261.905
08/10/2021 09:00,109.3,45425,533,178,19,2630,6,3366,5.157.261.905
08/10/2021 10:00,109,44689,506,168,18,2632,6,3330,5.157.261.905
08/10/2021 11:00,108.35,44002,486,152,25,2560,7,3230,5.157.261.905
08/10/2021 12:00,107.08,43357,500,138,30,2419,8,3095,5.157.261.905
08/10/2021 13:00,105.94,42892,470,127,28,2265,7,2897,5.157.261.905
08/10/2021 14:00,105.69,42575,403,116,21,2150,7,2697,5.157.261.905
08/10/2021 15:00,105.86,42820,359,109,15,2107,7,2597,5.157.261.905
08/10/2021 16:00,108.48,43368,326,104,14,2229,6,2679,5.157.261.905
08/10/2021 17:00,110.18,43734,352,97,24,2440,7,2920,5.157.261.905
08/10/2021 18:00,109.27,43252,393,90,40,2636,7,3166,5.157.261.905
08/10/2021 19:00,105.69,41527,401,82,48,2712,7,3250,5.157.261.905
08/10/2021 20:00,101.49,40196,419,75,58,2704,7,3263,5.157.261.905
08/10/2021 21:00,96.71,38656,456,67,71,2673,8,3275,5.157.261.905
08/10/2021 22:00,95.32,36795,497,59,82,2602,9,3249,5.157.261.905
08/10/2021 23:00,78.66,35516,569,56,79,2788,17,3509,5.157.261.905
09/10/2021 00:00,73.99,34721,532,59,74,2648,19,3332,5.157.261.905
09/10/2021 01:00,73.87,34304,501,62,67,2494,18,3142,5.157.261.905
09/10/2021 02:00,77.08,34316,507,62,58,2371,18,3016,5.157.261.905
09/10/2021 03:00,79.05,34461,505,66,53,2242,16,2882,5.157.261.905
09/10/2021 04:00,90.99,35071,468,70,48,2084,15,2685,5.157.261.905
09/10/2021 05:00,94.03,36130,436,72,42,1972,12,2534,5.157.261.905
09/10/2021 06:00,94.47,37315,386,71,40,1909,11,2417,5.157.261.905
09/10/2021 07:00,99.17,38797,387,71,39,1808,11,2316,5.157.261.905
09/10/2021 08:00,102.93,40117,410,71,31,1705,9,2226,5.157.261.905
09/10/2021 09:00,101.42,40770,414,74,20,1594,7,2109,5.157.261.905
09/10/2021 10:00,96,40563,426,77,11,1549,6,2069,5.157.261.905
09/10/2021 11:00,73.84,40166,414,79,10,1560,6,2069,5.157.261.905
09/10/2021 12:00,61.02,39544,422,77,11,1601,6,2117,5.157.261.905
09/10/2021 13:00,66.9,39287,415,73,11,1658,7,2164,5.157.261.905
09/10/2021 14:00,88.66,39213,391,66,10,1761,7,2235,5.157.261.905
09/10/2021 15:00,98.81,39638,363,59,10,1938,7,2377,5.157.261.905
09/10/2021 16:00,105.45,40882,328,62,12,2255,7,2664,5.157.261.905
09/10/2021 17:00,106.13,41688,339,73,15,2639,7,3073,5.157.261.905
09/10/2021 18:00,103.1,41297,410,85,18,2977,8,3498,5.157.261.905
09/10/2021 19:00,96.15,39730,507,93,21,3180,8,3809,5.157.261.905
09/10/2021 20:00,93.67,38630,617,96,25,3289,8,4035,5.157.261.905
09/10/2021 21:00,76.46,37393,735,97,31,3396,7,4266,5.157.261.905
09/10/2021 22:00,54.75,35843,824,96,45,3538,9,4512,5.157.261.905
09/10/2021 23:00,53.4,34819,1230,100,52,3906,10,5298,5.157.261.905
10/10/2021 00:00,53.8,33950,1257,96,63,4028,10,5454,5.157.261.905
10/10/2021 01:00,52.24,33623,1245,92,67,4109,9,5522,5.157.261.905
10/10/2021 02:00,50.44,33519,1184,90,67,4156,9,5506,5.157.261.905
10/10/2021 03:00,50.19,33580,1139,93,64,4166,10,5472,5.157.261.905
10/10/2021 04:00,52.41,34142,1120,97,59,4122,10,5408,5.157.261.905
10/10/2021 05:00,54.96,34912,1153,100,57,4025,9,5344,5.157.261.905
10/10/2021 06:00,55.63,35775,1186,101,60,3907,10,5264,5.157.261.905
10/10/2021 07:00,62.39,37265,1253,98,60,3697,11,5119,5.157.261.905
10/10/2021 08:00,70.14,38570,1411,97,47,3492,8,5055,5.157.261.905
10/10/2021 09:00,74.77,39309,1489,102,27,3334,7,4959,5.157.261.905
10/10/2021 10:00,70.05,39447,1504,111,21,3307,7,4950,5.157.261.905
10/10/2021 11:00,59.45,39291,1563,121,27,3341,11,5063,5.157.261.905
10/10/2021 12:00,51.16,38856,1643,129,31,3408,15,5226,5.157.261.905
10/10/2021 13:00,50.09,38754,1701,132,34,3472,15,5354,5.157.261.905
10/10/2021 14:00,55.95,39085,1681,131,34,3560,16,5422,5.157.261.905
10/10/2021 15:00,68.39,39513,1666,132,33,3701,14,5546,5.157.261.905
10/10/2021 16:00,88.38,40689,1635,144,39,3935,12,5765,5.157.261.905
10/10/2021 17:00,88.81,41915,1659,160,62,4220,12,6113,5.157.261.905
10/10/2021 18:00,88.41,41955,1784,171,97,4579,13,6644,5.157.261.905
10/10/2021 19:00,74.56,40646,1848,180,133,4879,17,7057,5.157.261.905
10/10/2021 20:00,66.73,39839,1898,185,173,4996,16,7268,5.157.261.905
10/10/2021 21:00,59.43,38711,1962,189,206,4995,14,7366,5.157.261.905
10/10/2021 22:00,52.82,37014,2035,186,225,4856,16,7318,5.157.261.905
10/10/2021 23:00,46.81,36268,1935,57,223,4178,14,6407,5.157.261.905
11/10/2021 00:00,46.16,35509,2103,51,214,4016,14,6398,5.260.238.095
11/10/2021 01:00,45.56,34706,2194,48,205,3879,14,6340,5.260.238.095
11/10/2021 02:00,45.27,34861,2342,43,207,3740,14,6346,5.260.238.095
11/10/2021 03:00,45.93,35928,2550,38,210,3650,13,6461,5.260.238.095
11/10/2021 04:00,51.28,38124,2611,37,209,3555,14,6426,5.260.238.095
11/10/2021 05:00,87.08,41441,2785,36,211,3503,15,6550,5.260.238.095
11/10/2021 06:00,96.55,44739,2865,34,219,3417,14,6549,5.260.238.095
11/10/2021 07:00,103.32,46152,2941,31,200,3174,15,6361,5.260.238.095
11/10/2021 08:00,100.49,46369,3320,29,141,2980,14,6484,5.260.238.095
11/10/2021 09:00,96.87,46301,3762,31,100,2841,15,6749,5.260.238.095
11/10/2021 10:00,91.1,45472,4083,33,104,2814,16,7050,5.260.238.095
11/10/2021 11:00,87.67,45157,4340,37,127,2834,18,7356,5.260.238.095
11/10/2021 12:00,87.04,44787,4500,41,154,2885,25,7605,5.260.238.095
11/10/2021 13:00,78.28,44548,4641,43,164,2996,22,7866,5.260.238.095
11/10/2021 14:00,80.02,44532,4747,41,155,3134,22,8099,5.260.238.095
11/10/2021 15:00,85.85,44348,4894,41,139,3348,19,8441,5.260.238.095
11/10/2021 16:00,90.5,45218,4809,47,138,3604,18,8616,5.260.238.095
11/10/2021 17:00,96.58,46165,4568,55,156,3987,17,8783,5.260.238.095
11/10/2021 18:00,95.55,46432,4260,60,179,4325,15,8839,5.260.238.095
11/10/2021 19:00,87.93,44506,4085,65,188,4549,13,8900,5.260.238.095
11/10/2021 20:00,79.93,42987,3978,68,188,4598,12,8844,5.260.238.095
11/10/2021 21:00,70.63,41313,3868,70,188,4592,15,8733,5.260.238.095
11/10/2021 22:00,51.27,38832,3705,69,189,4535,14,8512,5.260.238.095
11/10/2021 23:00,43.62,37430,3602,162,214,4303,11,8292,5.260.238.095
12/10/2021 00:00,42.92,37047,3514,160,203,4241,11,8129,5.260.238.095
12/10/2021 01:00,41.19,36619,3459,155,189,4153,9,7965,5.260.238.095
12/10/2021 02:00,41.45,36306,3349,150,178,4082,9,7768,5.260.238.095
12/10/2021 03:00,44.11,37205,3198,146,179,4016,7,7546,5.260.238.095
12/10/2021 04:00,54.41,39736,3054,148,175,3940,6,7323,5.260.238.095
12/10/2021 05:00,87.79,43367,2954,154,161,3887,7,7163,5.260.238.095
12/10/2021 06:00,101.51,46640,2818,154,148,3834,6,6960,5.260.238.095
12/10/2021 07:00,107.26,47723,2732,150,150,3654,6,6692,5.260.238.095
12/10/2021 08:00,110.03,47726,2691,148,151,3515,6,6511,5.260.238.095
12/10/2021 09:00,110.06,47144,2596,155,155,3489,6,6401,5.260.238.095
12/10/2021 10:00,105.89,46581,2424,160,162,3612,6,6364,5.260.238.095
12/10/2021 11:00,103.32,46090,2280,161,167,3720,6,6334,5.260.238.095
12/10/2021 12:00,99.96,45486,2205,163,159,3802,6,6335,5.260.238.095
12/10/2021 13:00,99.75,44955,2114,162,156,3879,5,6316,5.260.238.095
12/10/2021 14:00,99.74,44606,2086,157,151,3917,6,6317,5.260.238.095
12/10/2021 15:00,100.87,44554,2116,155,132,3843,6,6252,5.260.238.095
12/10/2021 16:00,105.2,45358,2013,158,118,3847,5,6141,5.260.238.095
12/10/2021 17:00,107.69,46610,1854,161,117,4082,5,6219,5.260.238.095
12/10/2021 18:00,107.51,46745,1777,164,131,4306,5,6383,5.260.238.095
12/10/2021 19:00,103.49,45547,1740,163,139,4366,5,6413,5.260.238.095
12/10/2021 20:00,100.85,44069,1564,156,142,4317,5,6184,5.260.238.095
12/10/2021 21:00,96.42,42234,1301,145,137,4209,6,5798,5.260.238.095
12/10/2021 22:00,87.59,40135,1216,127,128,4046,6,5523,5.260.238.095
12/10/2021 23:00,88.29,38308,1263,110,73,3994,6,5446,5.260.238.095
13/10/2021 00:00,88.43,37759,1441,102,72,3853,5,5473,5.260.238.095
13/10/2021 01:00,88.33,37577,1512,95,70,3689,6,5372,5.260.238.095
13/10/2021 02:00,88.49,37631,1564,85,69,3478,7,5203,5.260.238.095
13/10/2021 03:00,91.65,38255,1592,74,66,3271,7,5010,5.260.238.095
13/10/2021 04:00,93.17,40750,1528,58,61,3089,8,4744,5.260.238.095
13/10/2021 05:00,109.58,44564,1509,44,52,2923,8,4536,5.260.238.095
13/10/2021 06:00,120.01,47955,1423,38,42,2703,8,4214,5.260.238.095
13/10/2021 07:00,126.97,49140,1343,31,30,2307,7,3718,5.260.238.095
13/10/2021 08:00,127.95,48636,1257,29,19,1773,6,3084,5.260.238.095
13/10/2021 09:00,129.47,48740,1173,26,14,1276,6,2495,5.260.238.095
13/10/2021 10:00,125.83,48171,1105,26,13,1062,6,2212,5.260.238.095
13/10/2021 11:00,125.66,47207,1062,26,15,948,6,2057,5.260.238.095
13/10/2021 12:00,122.79,46320,1106,24,18,846,6,2000,5.260.238.095
13/10/2021 13:00,122.76,46149,1068,23,24,754,5,1874,5.260.238.095
13/10/2021 14:00,120.06,46059,1008,20,30,681,5,1744,5.260.238.095
13/10/2021 15:00,121.47,46562,851,18,38,615,6,1528,5.260.238.095
13/10/2021 16:00,125.66,47508,760,18,47,608,6,1439,5.260.238.095
13/10/2021 17:00,126.98,48414,720,16,54,694,5,1489,5.260.238.095
13/10/2021 18:00,127.34,48281,763,14,63,839,5,1684,5.260.238.095
13/10/2021 19:00,119.33,46359,833,12,59,1036,5,1945,5.260.238.095
13/10/2021 20:00,111.7,44317,989,11,48,1315,6,2369,5.260.238.095
13/10/2021 21:00,100.31,42365,1161,11,37,1707,6,2922,5.260.238.095
13/10/2021 22:00,88.37,40353,1219,11,31,2112,5,3378,5.260.238.095
13/10/2021 23:00,48.47,38834,1926,10,40,2776,5,4757,5.260.238.095
14/10/2021 00:00,42.49,38310,2043,9,35,3075,5,5167,5.260.238.095
14/10/2021 01:00,38.4,37854,2095,8,34,3426,6,5569,5.260.238.095
14/10/2021 02:00,35.69,35401,2221,6,35,3830,5,6097,5.260.238.095
14/10/2021 03:00,35.81,38116,2391,5,33,4209,5,6643,5.260.238.095
14/10/2021 04:00,38.9,40028,2352,5,29,4498,4,6888,5.260.238.095
14/10/2021 05:00,66.39,43805,2287,5,27,4698,4,7021,5.260.238.095
14/10/2021 06:00,86.47,46785,2151,5,26,4798,4,6984,5.260.238.095
14/10/2021 07:00,88.46,47726,2104,5,27,4795,5,6936,5.260.238.095
14/10/2021 08:00,87.81,47573,2349,5,24,4825,5,7208,5.260.238.095
14/10/2021 09:00,86.68,47463,2577,6,22,4939,6,7550,5.260.238.095
14/10/2021 10:00,80.09,47123,2735,7,29,5129,5,7905,5.260.238.095
14/10/2021 11:00,66.41,46676,2835,9,49,5272,9,8174,5.260.238.095
14/10/2021 12:00,50.48,46146,2824,11,70,5438,12,8355,5.260.238.095
14/10/2021 13:00,45.56,46149,2955,12,89,5624,13,8693,5.260.238.095
14/10/2021 14:00,43.62,45801,3235,13,100,5811,13,9172,5.260.238.095
14/10/2021 15:00,41.71,45984,3420,13,108,6104,11,9656,5.260.238.095
14/10/2021 16:00,44.58,46726,3606,13,131,6440,13,10203,5.260.238.095
14/10/2021 17:00,43.1,47294,3686,13,171,6754,17,10641,5.260.238.095
14/10/2021 18:00,39.54,46834,3765,13,208,6988,18,10992,5.260.238.095
14/10/2021 19:00,34.27,44995,3935,12,232,7054,21,11254,5.260.238.095
14/10/2021 20:00,31.17,43676,4197,10,248,6997,20,11472,5.260.238.095
14/10/2021 21:00,24.72,41752,4416,10,255,6898,24,11603,5.260.238.095
14/10/2021 22:00,14.75,39275,4571,9,255,6724,25,11584,5.260.238.095
14/10/2021 23:00,8.8,38080,4924,11,243,6457,18,11653,5.260.238.095
15/10/2021 00:00,4.72,37498,4786,12,252,6090,13,11153,5.260.238.095
15/10/2021 01:00,4.66,37003,4644,12,254,5637,14,10561,5.260.238.095
15/10/2021 02:00,7.84,37003,4545,10,262,5312,16,10145,5.260.238.095
15/10/2021 03:00,15.46,37732,4488,7,286,5188,16,9985,5.260.238.095
15/10/2021 04:00,19.85,39690,4447,7,310,5339,17,10120,5.260.238.095
15/10/2021 05:00,26.04,43036,4480,8,329,5628,23,10468,5.260.238.095
15/10/2021 06:00,35.69,46107,4317,9,351,5954,25,10656,5.260.238.095
15/10/2021 07:00,44.42,47135,4269,10,373,6289,30,10971,5.260.238.095
15/10/2021 08:00,40.24,47368,4522,12,391,6699,38,11662,5.260.238.095
15/10/2021 09:00,30.92,47042,4782,14,406,7001,40,12243,5.260.238.095
15/10/2021 10:00,26.18,46351,4838,19,418,7249,47,12571,5.260.238.095
15/10/2021 11:00,23.92,45566,4783,28,427,7515,50,12803,5.260.238.095
15/10/2021 12:00,19.36,45121,4695,38,433,7727,51,12944,5.260.238.095
15/10/2021 13:00,20.43,44477,4681,47,439,7775,49,12991,5.260.238.095
15/10/2021 14:00,24.3,44375,4561,51,437,7709,42,12800,5.260.238.095
15/10/2021 15:00,26.88,44697,4509,58,418,7614,20,12619,5.260.238.095
15/10/2021 16:00,35.05,45414,4253,73,394,7495,22,12237,5.260.238.095
15/10/2021 17:00,41.62,45972,3969,92,372,7328,36,11797,5.260.238.095
15/10/2021 18:00,41.48,45952,3876,115,338,7228,30,11587,5.260.238.095
15/10/2021 19:00,29.31,44041,3849,134,294,7179,24,11480,5.260.238.095
15/10/2021 20:00,26.34,42811,3772,150,254,7137,19,11332,5.260.238.095
15/10/2021 21:00,25.42,41398,3606,164,223,7080,16,11089,5.260.238.095
15/10/2021 22:00,24.82,39955,3486,173,202,7012,15,10888,5.260.238.095
15/10/2021 23:00,20.67,38730,3669,73,195,7170,13,11120,5.260.238.095
16/10/2021 00:00,20.69,38394,3526,70,175,7158,19,10948,5.260.238.095
16/10/2021 01:00,19.93,37782,3552,67,180,7187,19,11005,5.260.238.095
16/10/2021 02:00,19.87,37484,3589,63,192,7166,22,11032,5.260.238.095
16/10/2021 03:00,20.4,37639,3518,58,199,7096,23,10894,5.260.238.095
16/10/2021 04:00,21.63,38491,3442,54,202,7079,23,10800,5.260.238.095
16/10/2021 05:00,21.77,39555,3445,51,193,7149,24,10862,5.260.238.095
16/10/2021 06:00,24.44,40540,3359,49,186,7227,26,10847,5.260.238.095
16/10/2021 07:00,27.19,41945,3316,46,203,7203,21,10789,5.260.238.095
16/10/2021 08:00,27.39,42992,3518,44,217,7082,16,10877,5.260.238.095
16/10/2021 09:00,24.98,43630,3729,44,237,7066,21,11097,5.260.238.095
16/10/2021 10:00,23.35,43130,3876,44,286,7418,26,11650,5.260.238.095
16/10/2021 11:00,20.34,42441,4014,44,340,7777,30,12205,5.260.238.095
16/10/2021 12:00,19.84,41790,4059,43,377,7986,38,12503,5.260.238.095
16/10/2021 13:00,19.73,41907,4051,42,389,8037,45,12564,5.260.238.095
16/10/2021 14:00,20.81,41923,3917,40,393,7898,42,12290,5.260.238.095
16/10/2021 15:00,25.31,42535,3738,40,390,7719,42,11929,5.260.238.095
16/10/2021 16:00,39.01,44158,3399,41,376,7601,42,11459,5.260.238.095
16/10/2021 17:00,48.95,45202,3038,41,357,7566,40,11042,5.260.238.095
16/10/2021 18:00,41.15,44596,2753,43,359,7542,41,10738,5.260.238.095
16/10/2021 19:00,34.88,42903,2545,45,356,7432,37,10415,5.260.238.095
16/10/2021 20:00,29.8,43020,2419,48,345,7244,39,10095,5.260.238.095
16/10/2021 21:00,28.57,41802,2353,53,342,7024,40,9812,5.260.238.095
16/10/2021 22:00,24.97,39736,2299,57,343,6821,32,9552,5.260.238.095
16/10/2021 23:00,22.36,38714,2044,64,334,6964,39,9445,5.260.238.095
17/10/2021 00:00,23.13,38238,1880,67,315,6584,37,8883,5.260.238.095
17/10/2021 01:00,22.1,37866,1781,70,302,6544,34,8731,5.260.238.095
17/10/2021 02:00,22.67,37868,1750,71,292,6473,32,8618,5.260.238.095
17/10/2021 03:00,25,39135,1607,73,277,6122,31,8110,5.260.238.095
17/10/2021 04:00,34.02,39786,1468,72,254,6087,26,7907,5.260.238.095
17/10/2021 05:00,36.06,40574,1368,71,242,6037,24,7742,5.260.238.095
17/10/2021 06:00,49.65,41589,1261,71,231,5780,21,7364,5.260.238.095
17/10/2021 07:00,67.03,43467,1134,78,225,5780,19,7236,5.260.238.095
17/10/2021 08:00,73.18,44628,972,88,229,5649,22,6960,5.260.238.095
17/10/2021 09:00,76.38,45269,838,99,247,5408,18,6610,5.260.238.095
17/10/2021 10:00,73.15,43708,768,109,258,5581,17,6733,5.260.238.095
17/10/2021 11:00,67.62,43164,762,116,265,5745,15,6903,5.260.238.095
17/10/2021 12:00,56.98,43835,736,122,266,5748,16,6888,5.260.238.095
17/10/2021 13:00,49.05,42496,659,128,255,5855,14,6911,5.260.238.095
17/10/2021 14:00,60.86,42518,549,132,243,5846,14,6784,5.260.238.095
17/10/2021 15:00,67.04,42854,522,136,233,5627,13,6531,5.260.238.095
17/10/2021 16:00,73.79,44433,482,139,220,5714,12,6567,5.260.238.095
17/10/2021 17:00,89.92,46174,425,143,204,5860,13,6645,5.260.238.095
17/10/2021 18:00,89.86,46217,410,149,193,5742,16,6510,5.260.238.095
17/10/2021 19:00,75.66,45244,458,157,179,5857,18,6669,5.260.238.095
17/10/2021 20:00,66.98,44668,379,163,164,5853,19,6578,5.260.238.095
17/10/2021 21:00,66.98,43357,343,164,152,5568,21,6248,5.260.238.095
17/10/2021 22:00,50.57,41472,350,160,137,5605,20,6272,5.260.238.095
17/10/2021 23:00,45.38,40479,295,166,111,5682,20,6274,5.260.238.095
18/10/2021 00:00,46.62,40531,299,173,94,5552,16,6134,5.321.369.048
18/10/2021 01:00,39.34,40824,281,174,83,5444,16,5998,5.321.369.048
18/10/2021 02:00,40.94,41257,337,173,78,5328,17,5933,5.321.369.048
18/10/2021 03:00,66.99,40965,365,170,69,5209,18,5831,5.321.369.048
18/10/2021 04:00,83.6,43300,428,168,58,5055,17,5726,5.321.369.048
18/10/2021 05:00,95.72,46902,503,172,61,4847,17,5600,5.321.369.048
18/10/2021 06:00,106.21,50336,555,174,73,4618,17,5437,5.321.369.048
18/10/2021 07:00,114.69,51705,633,175,87,4248,17,5160,5.321.369.048
18/10/2021 08:00,115.76,51372,755,181,85,3759,16,4796,5.321.369.048
18/10/2021 09:00,115.13,50889,827,186,76,3261,20,4370,5.321.369.048
18/10/2021 10:00,113.75,50278,821,190,89,2954,20,4074,5.321.369.048
18/10/2021 11:00,111.84,49609,874,201,115,2719,24,3933,5.321.369.048
18/10/2021 12:00,106.53,49159,945,209,132,2526,24,3836,5.321.369.048
18/10/2021 13:00,108,48557,1037,202,152,2332,30,3753,5.321.369.048
18/10/2021 14:00,107.81,48490,1015,194,159,2102,31,3501,5.321.369.048
18/10/2021 15:00,110.06,48425,1095,195,157,1948,28,3423,5.321.369.048
18/10/2021 16:00,114.08,49441,1205,201,155,2037,26,3624,5.321.369.048
18/10/2021 17:00,115.07,50374,1251,204,167,2262,25,3909,5.321.369.048
18/10/2021 18:00,114.48,50269,1387,208,183,2421,25,4224,5.321.369.048
18/10/2021 19:00,103.32,48648,1548,212,177,2370,24,4331,5.321.369.048
18/10/2021 20:00,100.03,47159,1732,204,163,2205,20,4324,5.321.369.048
18/10/2021 21:00,94.04,45369,1936,196,151,2030,17,4330,5.321.369.048
18/10/2021 22:00,86.38,43027,2105,184,131,1851,17,4288,5.321.369.048
18/10/2021 23:00,83.76,41200,1622,175,72,1421,12,3302,5.321.369.048
19/10/2021 00:00,73.22,40625,1531,185,55,1381,11,3163,5.321.369.048
19/10/2021 01:00,67.87,40259,1529,187,41,1373,8,3138,5.321.369.048
19/10/2021 02:00,50.85,40317,1512,183,31,1384,7,3117,5.321.369.048
19/10/2021 03:00,67.45,40890,1539,179,24,1462,7,3211,5.321.369.048
19/10/2021 04:00,90.52,43067,1609,176,19,1586,6,3396,5.321.369.048
19/10/2021 05:00,106.42,46785,1769,175,19,1742,7,3712,5.321.369.048
19/10/2021 06:00,120.62,49895,1870,172,26,1925,7,4000,5.321.369.048
19/10/2021 07:00,122.48,50596,1836,169,39,2069,8,4121,5.321.369.048
19/10/2021 08:00,122.1,50562,1791,169,49,2167,8,4184,5.321.369.048
19/10/2021 09:00,121.01,50563,1778,166,47,2148,7,4146,5.321.369.048
19/10/2021 10:00,120.33,50366,1793,155,39,2134,8,4129,5.321.369.048
19/10/2021 11:00,118.8,50326,1861,147,36,2288,8,4340,5.321.369.048
19/10/2021 12:00,113.19,49726,1913,141,47,2531,8,4640,5.321.369.048
19/10/2021 13:00,111.05,49601,1933,134,73,2802,9,4951,5.321.369.048
19/10/2021 14:00,106.47,49605,2028,125,103,3183,9,5448,5.321.369.048
19/10/2021 15:00,104.15,49810,2021,127,132,3642,9,5931,5.321.369.048
19/10/2021 16:00,103.85,50186,2045,131,160,4002,11,6349,5.321.369.048
19/10/2021 17:00,102.58,50759,2275,134,188,4281,13,6891,5.321.369.048
19/10/2021 18:00,97.63,49896,2602,137,207,4525,17,7488,5.321.369.048
19/10/2021 19:00,87.84,48128,2923,133,217,4656,20,7949,5.321.369.048
19/10/2021 20:00,41.52,46561,3425,129,220,4712,19,8505,5.321.369.048
19/10/2021 21:00,24.94,44455,3894,128,216,4746,19,9003,5.321.369.048
19/10/2021 22:00,20.01,42248,4305,126,213,4804,19,9467,5.321.369.048
19/10/2021 23:00,16.06,40511,4832,99,224,5782,21,10958,5.321.369.048
20/10/2021 00:00,12.88,39922,4753,95,222,5863,20,10953,5.321.369.048
20/10/2021 01:00,5,39579,4746,93,223,5979,20,11061,5.321.369.048
20/10/2021 02:00,0.52,39418,4588,85,239,5849,22,10783,5.321.369.048
20/10/2021 03:00,0.94,39598,4396,78,261,5966,24,10725,5.321.369.048
20/10/2021 04:00,14.85,41768,4309,70,284,6369,26,11058,5.321.369.048
20/10/2021 05:00,22.87,45659,4209,60,312,6521,29,11131,5.321.369.048
20/10/2021 06:00,47.68,48823,4022,49,351,6579,31,11032,5.321.369.048
20/10/2021 07:00,65.01,49450,3825,40,391,6470,35,10761,5.321.369.048
20/10/2021 08:00,44.4,49171,3746,36,411,6464,39,10696,5.321.369.048
20/10/2021 09:00,31.08,49344,3810,32,419,6393,42,10696,5.321.369.048
20/10/2021 10:00,28.15,49217,3884,28,425,6269,45,10651,5.321.369.048
20/10/2021 11:00,27.07,48509,4065,25,428,6155,47,10720,5.321.369.048
20/10/2021 12:00,26.63,47797,4202,23,426,5952,47,10650,5.321.369.048
20/10/2021 13:00,27.54,47935,4003,20,425,5713,47,10208,5.321.369.048
20/10/2021 14:00,26.67,47476,3889,18,427,5456,48,9838,5.321.369.048
20/10/2021 15:00,26.74,47518,3715,16,433,5273,48,9485,5.321.369.048
20/10/2021 16:00,45.99,48310,3391,21,456,5169,47,9084,5.321.369.048
20/10/2021 17:00,67.25,49069,3208,30,473,5154,48,8913,5.321.369.048
20/10/2021 18:00,67.5,48225,3098,42,480,5158,48,8826,5.321.369.048
20/10/2021 19:00,31.2,46321,3202,58,474,5141,49,8924,5.321.369.048
20/10/2021 20:00,24.07,45114,3445,78,468,5141,49,9181,5.321.369.048
20/10/2021 21:00,19.97,43111,3573,99,460,5174,48,9354,5.321.369.048
20/10/2021 22:00,15.94,40602,3705,111,454,5094,48,9412,5.321.369.048
20/10/2021 23:00,14.72,38825,3424,139,456,5189,45,9253,5.321.369.048
21/10/2021 00:00,14.27,38443,3280,155,448,5037,45,8965,5.321.369.048
21/10/2021 01:00,10.22,38216,3285,165,437,4894,44,8825,5.321.369.048
21/10/2021 02:00,10.18,38163,3178,176,424,4787,44,8609,5.321.369.048
21/10/2021 03:00,14.22,38799,2866,190,409,4645,43,8153,5.321.369.048
21/10/2021 04:00,17.22,40592,2566,203,395,4445,40,7649,5.321.369.048
21/10/2021 05:00,24.51,44184,2434,215,382,4204,40,7275,5.321.369.048
21/10/2021 06:00,51.61,47234,2356,226,367,3884,39,6872,5.321.369.048
21/10/2021 07:00,66.94,48428,2525,235,360,3493,37,6650,5.321.369.048
21/10/2021 08:00,67.01,48260,3031,240,351,3087,37,6746,5.321.369.048
21/10/2021 09:00,41.34,48367,3668,241,342,2801,39,7091,5.321.369.048
21/10/2021 10:00,35.79,48066,4257,241,341,2735,37,7611,5.321.369.048
21/10/2021 11:00,30.04,48128,4845,237,375,2837,31,8325,5.321.369.048
21/10/2021 12:00,25.9,47654,5349,230,433,3024,24,9060,5.321.369.048
21/10/2021 13:00,24.81,47343,5369,225,467,3353,33,9447,5.321.369.048
21/10/2021 14:00,25.04,47105,5299,224,479,3750,43,9795,5.321.369.048
21/10/2021 15:00,25.23,47239,5267,226,485,4190,47,10215,5.321.369.048
21/10/2021 16:00,26.97,48250,5123,228,488,4599,43,10481,5.321.369.048
21/10/2021 17:00,38.75,49379,4942,228,494,4966,45,10675,5.321.369.048
21/10/2021 18:00,34.93,49145,4910,225,490,5325,42,10992,5.321.369.048
21/10/2021 19:00,25,47438,5091,222,483,5635,46,11477,5.321.369.048
21/10/2021 20:00,20,46243,5258,223,487,5874,50,11892,5.321.369.048
21/10/2021 21:00,17.02,44441,5133,222,486,6087,48,11976,5.321.369.048
21/10/2021 22:00,14.33,42348,5084,220,485,6305,47,12141,5.321.369.048
21/10/2021 23:00,12.02,40909,4998,219,476,6272,52,12017,5.321.369.048
22/10/2021 00:00,13.07,40394,4814,214,478,6460,52,12018,5.321.369.048
22/10/2021 01:00,11.99,39840,4829,205,479,6557,52,12122,5.321.369.048
22/10/2021 02:00,10.18,39862,4673,194,479,6642,53,12041,5.321.369.048
22/10/2021 03:00,12.58,40540,4254,181,482,6699,52,11668,5.321.369.048
22/10/2021 04:00,15.74,42617,3935,165,483,6717,50,11350,5.321.369.048
22/10/2021 05:00,24.65,46104,3899,158,481,6653,50,11241,5.321.369.048
22/10/2021 06:00,43.98,49601,3835,161,484,6489,50,11019,5.321.369.048
22/10/2021 07:00,53.6,50896,3811,161,483,6198,51,10704,5.321.369.048
22/10/2021 08:00,36.99,50845,3903,161,486,5887,51,10488,5.321.369.048
22/10/2021 09:00,25.89,50357,4191,159,488,5692,51,10581,5.321.369.048
22/10/2021 10:00,25.01,50123,4496,156,490,5687,52,10881,5.321.369.048
22/10/2021 11:00,23.09,49303,4903,150,487,5663,52,11255,5.321.369.048
22/10/2021 12:00,20.83,48596,5182,140,479,5623,51,11475,5.321.369.048
22/10/2021 13:00,20.45,48253,5003,130,474,5587,47,11241,5.321.369.048
22/10/2021 14:00,20.69,47802,4997,131,465,5554,48,11195,5.321.369.048
22/10/2021 15:00,22.84,48121,5090,148,457,5564,26,11285,5.321.369.048
22/10/2021 16:00,25.81,48877,5077,178,454,5642,16,11367,5.321.369.048
22/10/2021 17:00,33.28,49906,5085,212,433,5711,11,11452,5.321.369.048
22/10/2021 18:00,31.09,48915,5088,236,400,5744,12,11480,5.321.369.048
22/10/2021 19:00,23.87,47242,5172,245,360,5747,13,11537,5.321.369.048
22/10/2021 20:00,20.05,45995,5368,237,326,5717,13,11661,5.321.369.048
22/10/2021 21:00,17.39,44588,5321,230,302,5694,13,11560,5.321.369.048
22/10/2021 22:00,14.65,42957,5185,235,284,5621,15,11340,5.321.369.048
22/10/2021 23:00,14.87,41473,5046,182,298,5796,34,11356,5.321.369.048
23/10/2021 00:00,14.68,40877,4894,181,301,5746,34,11156,5.321.369.048
23/10/2021 01:00,14.55,40287,4914,174,300,5647,32,11067,5.321.369.048
23/10/2021 02:00,15.24,40047,4915,172,304,5499,32,10922,5.321.369.048
23/10/2021 03:00,17.45,40205,4715,175,306,5261,35,10492,5.321.369.048
23/10/2021 04:00,19.45,41000,4498,176,309,4901,35,9919,5.321.369.048
23/10/2021 05:00,23.33,41943,4352,176,311,4483,32,9354,5.321.369.048
23/10/2021 06:00,30.12,43351,4080,172,297,4063,33,8645,5.321.369.048
23/10/2021 07:00,62.68,44757,3647,170,277,3588,35,7717,5.321.369.048
23/10/2021 08:00,81.43,46189,3108,163,258,3076,39,6644,5.321.369.048
23/10/2021 09:00,85.04,46655,2798,172,251,2585,40,5846,5.321.369.048
23/10/2021 10:00,86.92,46201,2493,180,266,2254,44,5237,5.321.369.048
23/10/2021 11:00,82.99,45786,2212,182,273,2060,44,4771,5.321.369.048
23/10/2021 12:00,84.91,45161,1955,191,278,1927,45,4396,5.321.369.048
23/10/2021 13:00,88.5,44766,1682,191,280,1759,46,3958,5.321.369.048
23/10/2021 14:00,89.02,44893,1467,184,280,1516,46,3493,5.321.369.048
23/10/2021 15:00,95.1,45716,1329,172,267,1315,45,3128,5.321.369.048
23/10/2021 16:00,114.57,47517,1204,167,245,1287,43,2946,5.321.369.048
23/10/2021 17:00,125,48485,1039,165,226,1314,44,2788,5.321.369.048
23/10/2021 18:00,124.79,47644,894,165,217,1343,41,2660,5.321.369.048
23/10/2021 19:00,112.94,45920,786,161,215,1291,42,2495,5.321.369.048
23/10/2021 20:00,103.68,45017,784,152,206,1170,39,2351,5.321.369.048
23/10/2021 21:00,93.48,43828,837,143,189,1082,35,2286,5.321.369.048
23/10/2021 22:00,87.08,42478,913,137,178,1082,28,2338,5.321.369.048
23/10/2021 23:00,78.88,41013,1424,154,175,1492,20,3265,5.321.369.048
24/10/2021 00:00,69.95,41203,1614,154,156,1523,20,3467,5.321.369.048
24/10/2021 01:00,42.78,40375,1851,154,131,1668,15,3819,5.321.369.048
24/10/2021 02:00,38.95,39939,2112,150,109,1957,13,4341,5.321.369.048
24/10/2021 03:00,30.72,39976,2272,141,91,2306,10,4820,5.321.369.048
24/10/2021 04:00,28.43,40324,2366,140,77,2706,9,5298,5.321.369.048
24/10/2021 05:00,22.71,40884,2545,134,63,3092,7,5841,5.321.369.048
24/10/2021 06:00,25.89,41902,2706,129,50,3391,6,6282,5.321.369.048
24/10/2021 07:00,32.05,43461,2757,124,40,3616,7,6544,5.321.369.048
24/10/2021 08:00,30.69,44788,2834,122,30,3751,7,6744,5.321.369.048
24/10/2021 09:00,29.99,45585,3030,124,24,3887,7,7072,5.321.369.048
24/10/2021 10:00,30,45765,3131,131,24,3969,7,7262,5.321.369.048
24/10/2021 11:00,24.98,45236,3254,136,30,3933,9,7362,5.321.369.048
24/10/2021 12:00,21.94,44792,3339,137,36,3893,9,7414,5.321.369.048
24/10/2021 13:00,20.7,44474,3182,135,41,3790,11,7159,5.321.369.048
24/10/2021 14:00,26.16,44570,2964,132,41,3692,12,6841,5.321.369.048
24/10/2021 15:00,34.99,44801,2815,131,44,3669,13,6672,5.321.369.048
24/10/2021 16:00,66.94,46281,2638,134,59,3754,12,6597,5.321.369.048
24/10/2021 17:00,66.99,47397,2621,140,85,3832,12,6690,5.321.369.048
24/10/2021 18:00,49.92,46853,2782,145,114,3905,13,6959,5.321.369.048
24/10/2021 19:00,32.58,45399,2989,153,136,3968,16,7262,5.321.369.048
24/10/2021 20:00,23.56,44330,3174,156,154,4040,18,7542,5.321.369.048
24/10/2021 21:00,19.13,42577,3195,158,175,4062,21,7611,5.321.369.048
24/10/2021 22:00,17.6,40789,2995,162,187,4055,20,7419,5.321.369.048
24/10/2021 23:00,18.49,39751,2626,251,176,4483,24,7560,5.321.369.048
25/10/2021 00:00,18.66,39136,2342,254,175,4426,23,7220,5.518.571.429
25/10/2021 01:00,19.14,38739,2218,256,173,4369,22,7038,5.518.571.429
25/10/2021 02:00,18.93,38683,2122,256,175,4309,21,6883,5.518.571.429
25/10/2021 03:00,20.95,39310,2042,256,179,4234,20,6731,5.518.571.429
25/10/2021 04:00,32.58,41656,2001,255,180,4169,20,6625,5.518.571.429
25/10/2021 05:00,52.77,45272,2147,254,183,4086,18,6688,5.518.571.429
25/10/2021 06:00,80.08,48548,2278,255,193,3959,17,6702,5.518.571.429
25/10/2021 07:00,84.78,49761,2296,256,201,3770,18,6541,5.518.571.429
25/10/2021 08:00,85.55,49641,2258,258,187,3601,20,6324,5.518.571.429
25/10/2021 09:00,82.91,49448,2291,259,170,3462,20,6202,5.518.571.429
25/10/2021 10:00,83.45,49302,2207,258,178,3377,22,6042,5.518.571.429
25/10/2021 11:00,81.9,48712,2219,257,189,3277,32,5974,5.518.571.429
25/10/2021 12:00,81.48,48160,2201,256,194,3132,33,5816,5.518.571.429
25/10/2021 13:00,81.33,47758,2052,257,195,2958,28,5490,5.518.571.429
25/10/2021 14:00,81.94,47686,1990,255,194,2849,24,5312,5.518.571.429
25/10/2021 15:00,85.62,47941,1860,250,210,2869,22,5211,5.518.571.429
25/10/2021 16:00,92.04,49110,1810,243,243,2997,22,5315,5.518.571.429
25/10/2021 17:00,94.04,49566,1834,235,276,3184,22,5551,5.518.571.429
25/10/2021 18:00,88.26,48902,1919,223,298,3306,23,5769,5.518.571.429
25/10/2021 19:00,81.21,47016,2081,211,300,3351,24,5967,5.518.571.429
25/10/2021 20:00,68.53,44999,2142,202,284,3355,23,6006,5.518.571.429
25/10/2021 21:00,55.23,43091,2092,188,262,3335,19,5896,5.518.571.429
25/10/2021 22:00,36.65,40821,1976,171,239,3277,24,5687,5.518.571.429
25/10/2021 23:00,23.08,39281,1702,145,227,3110,22,5206,5.518.571.429
26/10/2021 00:00,25.26,38779,1598,155,209,3001,20,4983,5.518.571.429
26/10/2021 01:00,25.9,38143,1497,166,192,2885,19,4759,5.518.571.429
26/10/2021 02:00,27.03,37977,1392,175,181,2793,19,4560,5.518.571.429
26/10/2021 03:00,29.85,38649,1375,180,172,2711,18,4456,5.518.571.429
26/10/2021 04:00,40.46,41025,1459,180,164,2643,16,4462,5.518.571.429
26/10/2021 05:00,82.09,44580,1668,178,158,2571,14,4589,5.518.571.429
26/10/2021 06:00,95.59,47967,1819,175,154,2502,13,4663,5.518.571.429
26/10/2021 07:00,100.29,49082,1889,177,147,2446,12,4671,5.518.571.429
26/10/2021 08:00,97.31,49031,1943,184,128,2422,15,4692,5.518.571.429
26/10/2021 09:00,95.04,49091,2026,187,106,2453,18,4790,5.518.571.429
26/10/2021 10:00,92.41,48591,2057,190,98,2456,20,4821,5.518.571.429
26/10/2021 11:00,90.89,47897,2103,186,98,2445,20,4852,5.518.571.429
26/10/2021 12:00,83.76,47243,2120,184,100,2471,17,4892,5.518.571.429
26/10/2021 13:00,82.46,46875,1974,174,105,2521,17,4791,5.518.571.429
26/10/2021 14:00,81.32,46626,1802,163,111,2640,15,4731,5.518.571.429
26/10/2021 15:00,81.52,47112,1690,157,128,2922,11,4908,5.518.571.429
26/10/2021 16:00,83.68,48323,1670,155,158,3260,12,5255,5.518.571.429
26/10/2021 17:00,87.9,49265,1715,156,191,3552,12,5626,5.518.571.429
26/10/2021 18:00,82.43,48424,1897,153,210,3752,12,6024,5.518.571.429
26/10/2021 19:00,70.85,46790,2175,141,220,3824,16,6376,5.518.571.429
26/10/2021 20:00,47.98,45714,2568,129,225,3804,12,6738,5.518.571.429
26/10/2021 21:00,31.72,43826,2919,117,220,3744,12,7012,5.518.571.429
26/10/2021 22:00,21.59,41639,3188,101,212,3658,12,7171,5.518.571.429
26/10/2021 23:00,22.88,39878,3287,92,252,3034,19,6684,5.518.571.429
27/10/2021 00:00,19.26,39332,3528,83,251,2928,19,6809,5.518.571.429
27/10/2021 01:00,17.28,38700,3815,77,237,2924,19,7072,5.518.571.429
27/10/2021 02:00,16.04,38175,3999,72,223,3060,16,7370,5.518.571.429
27/10/2021 03:00,15.96,38917,4093,69,216,3392,16,7786,5.518.571.429
27/10/2021 04:00,16.96,40970,4215,68,213,3874,19,8389,5.518.571.429
27/10/2021 05:00,22.17,44860,4492,67,210,4370,18,9157,5.518.571.429
27/10/2021 06:00,38.25,48344,4591,64,206,4781,19,9661,5.518.571.429
27/10/2021 07:00,41.84,48654,4536,61,206,5088,17,9908,5.518.571.429
27/10/2021 08:00,39.92,48783,4439,59,222,5317,17,10054,5.518.571.429
27/10/2021 09:00,39.06,48875,4573,62,253,5462,19,10369,5.518.571.429
27/10/2021 10:00,39.94,48509,4694,67,282,5461,24,10528,5.518.571.429
27/10/2021 11:00,36.87,48078,4716,70,291,5347,24,10448,5.518.571.429
27/10/2021 12:00,31.08,47207,4722,69,300,5283,29,10403,5.518.571.429
27/10/2021 13:00,28.48,46902,4515,66,317,5300,35,10233,5.518.571.429
27/10/2021 14:00,27.46,46879,4494,66,343,5343,44,10290,5.518.571.429
27/10/2021 15:00,28.16,47210,4443,70,371,5470,46,10400,5.518.571.429
27/10/2021 16:00,34.89,48000,4307,75,403,5539,46,10370,5.518.571.429
27/10/2021 17:00,39.96,48602,4218,77,427,5523,47,10292,5.518.571.429
27/10/2021 18:00,32.06,48019,4233,77,443,5438,47,10238,5.518.571.429
27/10/2021 19:00,22,46246,4327,78,454,5360,47,10266,5.518.571.429
27/10/2021 20:00,19.91,44915,4431,77,456,5181,46,10191,5.518.571.429
27/10/2021 21:00,17.77,43068,4329,75,454,4956,45,9859,5.518.571.429
27/10/2021 22:00,14.22,40729,4095,70,448,4781,42,9436,5.518.571.429
27/10/2021 23:00,14.59,38713,4101,86,432,4526,42,9187,5.518.571.429
28/10/2021 00:00,13.66,38098,3962,86,411,4545,36,9040,5.518.571.429
28/10/2021 01:00,13.16,37597,3949,87,385,4609,29,9059,5.518.571.429
28/10/2021 02:00,13.52,37608,3876,90,356,4699,26,9047,5.518.571.429
28/10/2021 03:00,13.77,38722,3746,95,326,4863,23,9053,5.518.571.429
28/10/2021 04:00,14.78,41677,3657,95,301,4993,20,9066,5.518.571.429
28/10/2021 05:00,22.11,45301,3676,91,279,5131,18,9195,5.518.571.429
28/10/2021 06:00,37.45,47144,3615,84,270,5266,18,9253,5.518.571.429
28/10/2021 07:00,49.93,47775,3515,78,264,5168,17,9042,5.518.571.429
28/10/2021 08:00,47.43,47707,3383,74,262,4982,15,8716,5.518.571.429
28/10/2021 09:00,42.75,47531,3412,75,263,4820,15,8585,5.518.571.429
28/10/2021 10:00,41.35,47576,3424,81,263,4750,17,8535,5.518.571.429
28/10/2021 11:00,37.93,46774,3370,89,259,4699,20,8437,5.518.571.429
28/10/2021 12:00,34.35,46526,3362,104,244,4620,20,8350,5.518.571.429
28/10/2021 13:00,34.58,46369,3164,121,216,4594,23,8118,5.518.571.429
28/10/2021 14:00,31.11,46443,3073,151,186,4610,29,8049,5.518.571.429
28/10/2021 15:00,36.97,47222,2990,180,158,4722,28,8078,5.518.571.429
28/10/2021 16:00,46.72,48195,2960,191,136,4800,32,8119,5.518.571.429
28/10/2021 17:00,47.82,47938,3022,195,131,4845,33,8226,5.518.571.429
28/10/2021 18:00,37.79,46680,3284,205,134,4911,31,8565,5.518.571.429
28/10/2021 19:00,27.29,45066,3610,204,143,4898,32,8887,5.518.571.429
28/10/2021 20:00,21.21,43318,3831,191,154,4886,33,9095,5.518.571.429
28/10/2021 21:00,18.15,41437,3849,177,164,4908,31,9129,5.518.571.429
28/10/2021 22:00,14.6,39619,3548,159,168,4924,33,8832,5.518.571.429
28/10/2021 23:00,15.61,38641,3106,162,175,5000,25,8468,5.518.571.429
29/10/2021 00:00,15.25,38321,2859,144,170,5044,22,8239,5.518.571.429
29/10/2021 01:00,15.19,37862,2763,121,173,5057,22,8136,5.518.571.429
29/10/2021 02:00,14.47,37832,2595,93,184,5068,24,7964,5.518.571.429
29/10/2021 03:00,15.44,38899,2525,64,190,5068,20,7867,5.518.571.429
29/10/2021 04:00,18.03,41823,2532,43,191,5035,17,7818,5.518.571.429
29/10/2021 05:00,29.14,45209,2631,27,196,4966,18,7838,5.518.571.429
29/10/2021 06:00,64.44,47566,2655,20,203,4838,16,7732,5.518.571.429
29/10/2021 07:00,67.35,47666,2686,20,208,4588,17,7519,5.518.571.429
29/10/2021 08:00,67.37,47809,2647,24,201,4346,14,7232,5.518.571.429
29/10/2021 09:00,67.25,47373,2702,28,176,4039,15,6960,5.518.571.429
29/10/2021 10:00,67.03,46858,2687,33,151,3712,18,6601,5.518.571.429
29/10/2021 11:00,62.43,46139,2662,41,148,3462,19,6332,5.518.571.429
29/10/2021 12:00,44.05,45363,2678,52,153,3216,19,6118,5.518.571.429
29/10/2021 13:00,41,45043,2573,63,158,2971,18,5783,5.518.571.429
29/10/2021 14:00,39.93,45112,2573,74,174,2764,16,5601,5.518.571.429
29/10/2021 15:00,43.38,46131,2634,90,206,2756,16,5702,5.518.571.429
29/10/2021 16:00,60.46,46691,2768,107,236,2988,17,6116,5.518.571.429
29/10/2021 17:00,65.26,46552,3003,122,254,3252,16,6647,5.518.571.429
29/10/2021 18:00,50.61,45316,3322,134,264,3471,18,7209,5.518.571.429
29/10/2021 19:00,28.74,43529,3609,142,263,3569,17,7600,5.518.571.429
29/10/2021 20:00,22.69,42176,3814,146,255,3548,19,7782,5.518.571.429
29/10/2021 21:00,18.9,40727,3849,151,248,3527,20,7795,5.518.571.429
29/10/2021 22:00,15.81,38827,3572,147,247,3537,20,7523,5.518.571.429
29/10/2021 23:00,14.97,37793,3647,167,234,3976,16,8040,5.518.571.429
30/10/2021 00:00,15.31,37075,3277,160,232,3998,16,7683,5.518.571.429
30/10/2021 01:00,15.04,36888,3034,155,229,4023,13,7454,5.518.571.429
30/10/2021 02:00,14.42,36880,2682,151,233,4019,13,7098,5.518.571.429
30/10/2021 03:00,14.24,37290,2269,148,244,4023,13,6697,5.518.571.429
30/10/2021 04:00,14.94,38323,1844,145,256,4082,14,6341,5.518.571.429
30/10/2021 05:00,17.97,39702,1523,145,267,4146,13,6094,5.518.571.429
30/10/2021 06:00,18.92,41083,1309,149,272,4174,13,5917,5.518.571.429
30/10/2021 07:00,26.61,42569,1194,155,263,4140,14,5766,5.518.571.429
30/10/2021 08:00,30.37,43472,1103,160,241,4085,14,5603,5.518.571.429
30/10/2021 09:00,30.02,43821,1183,163,206,3939,12,5503,5.518.571.429
30/10/2021 10:00,29.92,43352,1333,161,165,3652,16,5327,5.518.571.429
30/10/2021 11:00,27.08,42749,1584,158,148,3390,15,5295,5.518.571.429
30/10/2021 12:00,26.52,42242,1792,156,140,3303,14,5405,5.518.571.429
30/10/2021 13:00,21.96,42101,2002,158,138,3249,14,5561,5.518.571.429
30/10/2021 14:00,23.63,42761,2384,159,149,3197,11,5900,5.518.571.429
30/10/2021 15:00,26.36,44285,2809,159,182,3229,10,6389,5.518.571.429
30/10/2021 16:00,28,45864,3196,159,230,3302,12,6899,5.518.571.429
30/10/2021 17:00,30.88,45920,3603,153,270,3345,12,7383,5.518.571.429
30/10/2021 18:00,25.03,44703,3966,141,289,3272,13,7681,5.518.571.429
30/10/2021 19:00,19.95,43061,4159,126,292,3221,16,7814,5.518.571.429
30/10/2021 20:00,18.53,41979,4229,113,291,3086,19,7738,5.518.571.429
30/10/2021 21:00,17.44,40699,4131,102,291,3015,18,7557,5.518.571.429
30/10/2021 22:00,14.65,38580,3865,94,292,2945,18,7214,5.518.571.429
30/10/2021 23:00,15.15,36847,3148,98,313,2701,22,6282,5.518.571.429
31/10/2021 00:00,15.19,36460,2948,96,319,2621,23,6007,5.518.571.429
31/10/2021 01:00,15.85,36116,2766,90,326,2720,25,5927,5.518.571.429
31/10/2021 02:00,14.79,35676,2656,80,336,2763,25,5860,5.518.571.429
31/10/2021 03:00,14.84,36058,2443,65,339,2780,25,5652,5.518.571.429
31/10/2021 04:00,14.89,35941,2151,51,331,2801,26,5360,5.518.571.429
31/10/2021 05:00,14.76,36544,1890,38,321,2821,23,5093,5.518.571.429
31/10/2021 06:00,16.04,37378,1654,28,315,2843,26,4866,5.518.571.429
31/10/2021 07:00,17.67,38532,1463,21,303,2833,25,4645,5.518.571.429
31/10/2021 08:00,19.56,40291,1288,16,266,2843,25,4438,5.518.571.429
31/10/2021 09:00,23.93,41575,1256,14,216,2787,26,4299,5.518.571.429
31/10/2021 10:00,21.98,42156,1269,13,173,2785,25,4265,5.518.571.429
31/10/2021 11:00,21.99,42487,1368,16,157,2829,24,4394,5.518.571.429
31/10/2021 12:00,21.94,42255,1565,20,140,2807,27,4559,5.518.571.429
31/10/2021 13:00,20.5,41973,1591,26,122,2663,30,4432,5.518.571.429
31/10/2021 14:00,21.47,42138,1652,35,115,2477,26,4305,5.518.571.429
31/10/2021 15:00,22.98,43326,1839,49,128,2396,21,4433,5.518.571.429
31/10/2021 16:00,27.49,45098,2222,66,155,2494,17,4954,5.518.571.429
31/10/2021 17:00,44.56,45652,2895,87,184,2630,19,5815,5.518.571.429
31/10/2021 18:00,35.28,45467,3584,104,203,2721,21,6633,5.518.571.429
31/10/2021 19:00,22.34,44851,4232,119,211,2774,21,7357,5.518.571.429
31/10/2021 20:00,20.11,43191,4675,136,208,2697,23,7739,5.518.571.429
31/10/2021 21:00,18.63,42180,4929,144,200,2605,20,7898,5.518.571.429
31/10/2021 22:00,17.31,40996,5026,144,195,2507,21,7893,5.518.571.429
31/10/2021 23:00,15.32,38962,5141,141,197,2495,16,7990,5.518.571.429
01/11/2021 00:00,14.55,37736,4606,141,193,3032,14,7986,5.602.857.143
01/11/2021 01:00,13.96,37276,4357,141,206,3077,15,7796,5.602.857.143
01/11/2021 02:00,13.79,37426,3966,145,225,3146,16,7498,5.602.857.143
01/11/2021 03:00,12.48,38155,3529,148,245,3268,17,7207,5.602.857.143
01/11/2021 04:00,13.56,39103,3208,152,264,3470,19,7113,5.602.857.143
01/11/2021 05:00,16.55,42150,3068,154,279,3722,20,7243,5.602.857.143
01/11/2021 06:00,20.67,45561,2924,153,295,3981,20,7373,5.602.857.143
01/11/2021 07:00,39.3,48143,2813,155,302,4123,22,7415,5.602.857.143
01/11/2021 08:00,62.92,48559,2819,158,291,4169,21,7458,5.602.857.143
01/11/2021 09:00,58.76,48278,3032,153,275,4217,19,7696,5.602.857.143
01/11/2021 10:00,54.66,48340,3310,148,266,4282,20,8026,5.602.857.143
01/11/2021 11:00,44.91,47926,3647,145,264,4395,21,8472,5.602.857.143
01/11/2021 12:00,46.29,47592,3937,140,256,4451,23,8807,5.602.857.143
01/11/2021 13:00,40.77,47770,3756,141,252,4477,22,8648,5.602.857.143
01/11/2021 14:00,42.42,48189,3777,144,260,4531,21,8733,5.602.857.143
01/11/2021 15:00,51.69,48801,3851,147,279,4693,22,8992,5.602.857.143
01/11/2021 16:00,49.94,49515,3885,150,304,4858,26,9223,5.602.857.143
01/11/2021 17:00,60,49490,3873,149,320,4986,26,9354,5.602.857.143
01/11/2021 18:00,52.04,48572,3934,146,321,5080,23,9504,5.602.857.143
01/11/2021 19:00,32.1,47179,4155,141,310,5021,21,9648,5.602.857.143
01/11/2021 20:00,24.03,44954,4207,132,293,4852,21,9505,5.602.857.143
01/11/2021 21:00,21.03,43416,4064,121,283,4644,20,9132,5.602.857.143
01/11/2021 22:00,17.33,41536,3792,107,279,4421,20,8619,5.602.857.143
01/11/2021 23:00,15.19,39366,3392,247,273,4197,19,8128,5.602.857.143
02/11/2021 00:00,13.95,37414,2570,42,280,4037,21,6950,5.602.857.143
02/11/2021 01:00,13.82,37148,2327,38,278,3867,20,6530,5.602.857.143
02/11/2021 02:00,14.42,37172,2120,37,282,3709,20,6168,5.602.857.143
02/11/2021 03:00,15.51,37102,1934,37,287,3568,21,5847,5.602.857.143
02/11/2021 04:00,18.94,38846,1758,39,290,3450,20,5557,5.602.857.143
02/11/2021 05:00,36.47,42578,1583,41,287,3318,23,5252,5.602.857.143
02/11/2021 06:00,69.63,46280,1398,45,285,3187,24,4939,5.602.857.143
02/11/2021 07:00,74.39,48792,1248,52,283,3017,25,4625,5.602.857.143
02/11/2021 08:00,80.09,48741,1119,56,279,2789,24,4267,5.602.857.143
02/11/2021 09:00,79.8,47885,928,55,274,2592,28,3877,5.602.857.143
02/11/2021 10:00,79.9,47896,727,53,274,2355,29,3438,5.602.857.143
02/11/2021 11:00,81.11,47901,608,57,275,2112,31,3083,5.602.857.143
02/11/2021 12:00,82.49,47706,525,63,271,1940,32,2831,5.602.857.143
02/11/2021 13:00,84.01,47751,408,73,266,1880,30,2657,5.602.857.143
02/11/2021 14:00,84.22,47955,310,89,270,1880,28,2577,5.602.857.143
02/11/2021 15:00,84.79,48515,238,107,279,1956,29,2609,5.602.857.143
02/11/2021 16:00,85.49,49253,200,126,293,2098,31,2748,5.602.857.143
02/11/2021 17:00,85.94,49578,168,140,305,2223,35,2871,5.602.857.143
02/11/2021 18:00,85.12,48786,187,144,310,2301,34,2976,5.602.857.143
02/11/2021 19:00,79.97,47402,215,147,302,2313,32,3009,5.602.857.143
02/11/2021 20:00,74.16,45432,224,143,277,2279,30,2953,5.602.857.143
02/11/2021 21:00,70.29,43783,206,136,245,2225,27,2839,5.602.857.143
02/11/2021 22:00,64.96,41690,195,130,216,2165,24,2730,5.602.857.143
02/11/2021 23:00,54.21,39666,192,122,195,2087,23,2619,5.602.857.143
03/11/2021 00:00,55.09,38684,313,122,194,1956,20,2605,5.602.857.143
03/11/2021 01:00,49.94,38245,258,115,181,1905,20,2479,5.602.857.143
03/11/2021 02:00,42.24,37960,206,111,166,1903,17,2403,5.602.857.143
03/11/2021 03:00,45.63,38187,181,107,150,1917,17,2372,5.602.857.143
03/11/2021 04:00,49.6,39667,176,106,135,1906,17,2340,5.602.857.143
03/11/2021 05:00,64.92,42735,186,108,118,1870,16,2298,5.602.857.143
03/11/2021 06:00,79.95,46261,224,109,103,1792,15,2243,5.602.857.143
03/11/2021 07:00,85.69,48451,250,107,91,1671,14,2133,5.602.857.143
03/11/2021 08:00,90.9,48954,268,106,79,1563,14,2030,5.602.857.143
03/11/2021 09:00,89.94,48729,318,104,67,1498,14,2001,5.602.857.143
03/11/2021 10:00,89.91,48841,353,101,63,1455,13,1985,5.602.857.143
03/11/2021 11:00,88.73,48587,330,95,74,1436,13,1948,5.602.857.143
03/11/2021 12:00,88.57,48192,306,86,101,1417,13,1923,5.602.857.143
03/11/2021 13:00,90.03,48195,282,82,137,1389,14,1904,5.602.857.143
03/11/2021 14:00,90.42,48533,250,84,160,1326,18,1838,5.602.857.143
03/11/2021 15:00,91,49131,234,92,166,1281,18,1791,5.602.857.143
03/11/2021 16:00,95.73,49840,219,101,178,1274,19,1791,5.602.857.143
03/11/2021 17:00,103.44,50106,242,107,191,1280,25,1845,5.602.857.143
03/11/2021 18:00,103.79,49593,266,109,193,1275,37,1880,5.602.857.143
03/11/2021 19:00,94.38,48166,282,105,190,1220,40,1837,5.602.857.143
03/11/2021 20:00,89.22,46158,283,98,181,1141,37,1740,5.602.857.143
03/11/2021 21:00,84.98,44935,292,91,175,1069,37,1664,5.602.857.143
03/11/2021 22:00,82.36,43041,282,84,168,1012,37,1583,5.602.857.143
03/11/2021 23:00,77.85,41155,273,75,143,978,37,1506,5.602.857.143
04/11/2021 00:00,78.89,39780,251,79,138,749,23,1240,5.602.857.143
04/11/2021 01:00,78.29,39421,185,76,106,691,20,1078,5.602.857.143
04/11/2021 02:00,78.21,40306,154,75,90,624,18,961,5.602.857.143
04/11/2021 03:00,78.48,39418,179,73,88,567,15,922,5.602.857.143
04/11/2021 04:00,78.83,40766,238,69,109,526,12,954,5.602.857.143
04/11/2021 05:00,83.95,43865,375,65,142,510,12,1104,5.602.857.143
04/11/2021 06:00,96.24,47275,533,63,156,511,12,1275,5.602.857.143
04/11/2021 07:00,104.97,49366,629,62,161,506,11,1369,5.602.857.143
04/11/2021 08:00,121.14,49877,658,60,168,493,11,1390,5.602.857.143
04/11/2021 09:00,121.32,49860,696,58,171,493,10,1428,5.602.857.143
04/11/2021 10:00,116.4,49713,766,59,171,500,10,1506,5.602.857.143
04/11/2021 11:00,106.23,49369,882,57,176,520,10,1645,5.602.857.143
04/11/2021 12:00,103.82,48797,987,56,186,555,10,1794,5.602.857.143
04/11/2021 13:00,103.82,48568,1064,54,215,613,11,1957,5.602.857.143
04/11/2021 14:00,103.79,48890,1181,55,253,700,12,2201,5.602.857.143
04/11/2021 15:00,102.26,49425,1316,56,293,832,13,2510,5.602.857.143
04/11/2021 16:00,105.79,50433,1439,57,321,1017,16,2850,5.602.857.143
04/11/2021 17:00,110.26,50744,1552,58,334,1153,17,3114,5.602.857.143
04/11/2021 18:00,102.93,50070,1623,58,343,1276,18,3318,5.602.857.143
04/11/2021 19:00,97.02,48686,1686,60,337,1384,19,3486,5.602.857.143
04/11/2021 20:00,91.02,46472,1736,63,316,1451,20,3586,5.602.857.143
04/11/2021 21:00,89.37,45685,1734,67,299,1508,19,3627,5.602.857.143
04/11/2021 22:00,83.16,43780,1703,74,291,1516,18,3602,5.602.857.143
04/11/2021 23:00,78.51,41862,1694,78,297,1502,17,3588,5.602.857.143
05/11/2021 00:00,67.23,40649,2499,37,342,1983,15,4876,5.602.857.143
05/11/2021 01:00,53.3,40492,2561,45,344,1944,14,4908,5.602.857.143
05/11/2021 02:00,44.83,40227,2611,55,358,1885,15,4924,5.602.857.143
05/11/2021 03:00,53.26,40290,2682,61,377,1851,13,4984,5.602.857.143
05/11/2021 04:00,55.04,41515,2687,69,389,1831,13,4989,5.602.857.143
05/11/2021 05:00,76.44,44325,2664,79,391,1819,12,4965,5.602.857.143
05/11/2021 06:00,84.18,47496,2684,90,386,1824,12,4996,5.602.857.143
05/11/2021 07:00,91.55,50520,2591,99,367,1844,10,4911,5.602.857.143
05/11/2021 08:00,93.91,50864,2514,101,342,1856,10,4823,5.602.857.143
05/11/2021 09:00,92.35,50776,2609,102,334,1877,10,4932,5.602.857.143
05/11/2021 10:00,86.23,50388,2749,100,346,1993,9,5197,5.602.857.143
05/11/2021 11:00,83.16,49927,3079,96,358,2220,10,5763,5.602.857.143
05/11/2021 12:00,78.74,49546,3271,87,375,2539,13,6285,5.602.857.143
05/11/2021 13:00,76.43,49443,3404,74,402,2829,19,6728,5.602.857.143
05/11/2021 14:00,75.26,49228,3533,60,420,3115,37,7165,5.602.857.143
05/11/2021 15:00,72.98,49677,3607,55,419,3488,32,7601,5.602.857.143
05/11/2021 16:00,75.22,50609,3509,50,395,3881,31,7866,5.602.857.143
05/11/2021 17:00,77.43,50681,3617,45,356,4178,27,8223,5.602.857.143
05/11/2021 18:00,73.36,49929,3818,41,309,4464,22,8654,5.602.857.143
05/11/2021 19:00,57.55,48139,3976,37,289,4728,26,9056,5.602.857.143
05/11/2021 20:00,28.93,46656,4011,35,290,4995,27,9358,5.602.857.143
05/11/2021 21:00,22.2,45053,3904,38,296,5310,26,9574,5.602.857.143
05/11/2021 22:00,19.51,43562,3829,45,301,5589,26,9790,5.602.857.143
05/11/2021 23:00,16.76,41732,3732,50,328,5839,27,9976,5.602.857.143
06/11/2021 00:00,13.42,40750,3621,101,317,6460,34,10533,5.602.857.143
06/11/2021 01:00,12.31,40104,3675,94,344,6586,28,10727,5.602.857.143
06/11/2021 02:00,10.99,39647,3741,87,376,6694,25,10923,5.602.857.143
06/11/2021 03:00,10.5,39241,3802,80,407,6787,27,11103,5.602.857.143
06/11/2021 04:00,11.81,39758,3812,76,414,6887,29,11218,5.602.857.143
06/11/2021 05:00,13,40698,3819,74,409,6980,30,11312,5.602.857.143
06/11/2021 06:00,12.86,41738,3731,74,404,7018,31,11258,5.602.857.143
06/11/2021 07:00,14.68,42989,3557,73,405,6986,29,11050,5.602.857.143
06/11/2021 08:00,18.22,44281,3333,71,420,6894,31,10749,5.602.857.143
06/11/2021 09:00,22.37,45539,3268,62,446,6712,36,10524,5.602.857.143
06/11/2021 10:00,24.94,46036,3272,55,469,6400,40,10236,5.602.857.143
06/11/2021 11:00,23.84,45642,3342,55,481,6144,43,10065,5.602.857.143
06/11/2021 12:00,20.78,45167,3331,58,485,5942,45,9861,5.602.857.143
06/11/2021 13:00,21.56,45057,3346,60,484,5831,45,9766,5.602.857.143
06/11/2021 14:00,23.61,45448,3283,66,478,5672,44,9543,5.602.857.143
06/11/2021 15:00,31.11,46837,3303,73,466,5444,43,9329,5.602.857.143
06/11/2021 16:00,48.16,48420,3339,84,450,5264,41,9178,5.602.857.143
06/11/2021 17:00,50.61,48959,3547,90,434,5088,34,9193,5.602.857.143
06/11/2021 18:00,40.47,47850,3801,91,405,4951,31,9279,5.602.857.143
06/11/2021 19:00,24.9,46502,4197,91,377,4808,28,9501,5.602.857.143
06/11/2021 20:00,19.04,44733,4510,89,358,4605,25,9587,5.602.857.143
06/11/2021 21:00,18.36,43736,4624,82,353,4349,19,9427,5.602.857.143
06/11/2021 22:00,16.57,42400,4602,75,356,4075,15,9123,5.602.857.143
06/11/2021 23:00,13.98,41010,4558,67,377,3855,13,8870,5.602.857.143
07/11/2021 00:00,12.63,40081,4755,108,421,3733,26,9043,5.602.857.143
07/11/2021 01:00,10.75,39915,4729,101,424,3648,30,8932,5.602.857.143
07/11/2021 02:00,6.6,39650,4527,94,417,3597,31,8666,5.602.857.143
07/11/2021 03:00,3.71,39535,4317,87,412,3544,34,8394,5.602.857.143
07/11/2021 04:00,3.28,39806,4288,80,409,3623,42,8442,5.602.857.143
07/11/2021 05:00,4.85,40610,4363,76,404,3804,48,8695,5.602.857.143
07/11/2021 06:00,5.7,41460,4297,74,405,3913,48,8737,5.602.857.143
07/11/2021 07:00,10.76,42912,4178,74,416,3950,48,8666,5.602.857.143
07/11/2021 08:00,14.3,44190,4021,73,428,3952,46,8520,5.602.857.143
07/11/2021 09:00,19.5,45233,4008,71,439,3899,48,8465,5.602.857.143
07/11/2021 10:00,19.48,46046,4028,62,447,3819,49,8405,5.602.857.143
07/11/2021 11:00,22.49,46022,4117,55,444,3797,51,8464,5.602.857.143
07/11/2021 12:00,22.75,46092,4001,55,439,3860,51,8406,5.602.857.143
07/11/2021 13:00,26.2,46169,3885,58,436,3943,47,8369,5.602.857.143
07/11/2021 14:00,39.22,46988,3547,60,432,3994,42,8075,5.602.857.143
07/11/2021 15:00,60,48413,3139,66,423,4060,42,7730,5.602.857.143
07/11/2021 16:00,73.23,49444,2902,73,414,4095,40,7524,5.602.857.143
07/11/2021 17:00,78.5,50079,2815,84,398,4022,36,7355,5.602.857.143
07/11/2021 18:00,77.81,49498,2677,90,380,3930,30,7107,5.602.857.143
07/11/2021 19:00,77.95,48364,2657,91,378,3817,24,6967,5.602.857.143
07/11/2021 20:00,73.1,46839,2562,91,372,3693,23,6741,5.602.857.143
07/11/2021 21:00,66.86,46157,2300,89,359,3578,27,6353,5.602.857.143
07/11/2021 22:00,62.34,44761,1890,82,350,3469,25,5816,5.602.857.143
07/11/2021 23:00,48.47,42877,1575,63,347,3366,22,5373,5.602.857.143
08/11/2021 00:00,33.35,42022,1465,66,382,3029,45,4987,5.540.416.667
08/11/2021 01:00,25.68,41973,1265,70,380,2922,43,4680,5.540.416.667
08/11/2021 02:00,24.84,41970,1118,71,366,2771,41,4367,5.540.416.667
08/11/2021 03:00,42.27,42174,1012,69,348,2629,41,4099,5.540.416.667
08/11/2021 04:00,68.84,43442,841,74,320,2477,43,3755,5.540.416.667
08/11/2021 05:00,79.4,46726,697,81,286,2335,42,3441,5.540.416.667
08/11/2021 06:00,92.34,50142,622,89,260,2209,41,3221,5.540.416.667
08/11/2021 07:00,102.04,52588,627,95,243,2067,39,3071,5.540.416.667
08/11/2021 08:00,115.1,53267,632,99,223,1881,35,2870,5.540.416.667
08/11/2021 09:00,120.08,53296,633,100,204,1654,32,2623,5.540.416.667
08/11/2021 10:00,118.14,53317,607,91,200,1402,30,2330,5.540.416.667
08/11/2021 11:00,114.94,53070,650,82,195,1180,28,2135,5.540.416.667
08/11/2021 12:00,109.24,52508,638,81,184,1019,31,1953,5.540.416.667
08/11/2021 13:00,112.61,52502,605,81,168,937,29,1820,5.540.416.667
08/11/2021 14:00,115.08,52713,584,88,148,917,28,1765,5.540.416.667
08/11/2021 15:00,120.09,53385,542,102,138,945,23,1750,5.540.416.667
08/11/2021 16:00,123.44,54447,593,117,139,978,21,1848,5.540.416.667
08/11/2021 17:00,129.56,54412,704,121,138,1000,19,1982,5.540.416.667
08/11/2021 18:00,129.92,53214,827,116,131,1042,16,2132,5.540.416.667
08/11/2021 19:00,113.54,51876,1008,116,120,1080,14,2338,5.540.416.667
08/11/2021 20:00,100.9,50046,1136,114,112,1144,15,2521,5.540.416.667
08/11/2021 21:00,97.06,48619,1168,116,105,1281,15,2685,5.540.416.667
08/11/2021 22:00,88.94,46951,1204,123,96,1457,15,2895,5.540.416.667
08/11/2021 23:00,80,45192,1324,112,88,1675,13,3212,5.540.416.667
09/11/2021 00:00,76.14,44134,1497,207,81,2239,14,4038,5.540.416.667
09/11/2021 01:00,71.04,43943,1696,222,71,2741,13,4743,5.540.416.667
09/11/2021 02:00,56.01,43586,1856,231,61,3389,13,5550,5.540.416.667
09/11/2021 03:00,33.46,43514,2080,234,46,4022,12,6394,5.540.416.667
09/11/2021 04:00,27.17,44479,2360,235,31,4751,12,7389,5.540.416.667
09/11/2021 05:00,37.53,47284,2648,233,19,5488,12,8400,5.540.416.667
09/11/2021 06:00,67.33,50979,2822,229,14,6163,12,9240,5.540.416.667
09/11/2021 07:00,76.95,53034,3028,228,12,6705,13,9986,5.540.416.667
09/11/2021 08:00,77.72,53353,3134,225,13,7086,16,10474,5.540.416.667
09/11/2021 09:00,74.9,52956,3324,224,20,7463,16,11047,5.540.416.667
09/11/2021 10:00,65.25,52968,3594,218,26,7695,14,11547,5.540.416.667
09/11/2021 11:00,57.76,52392,3780,210,28,7719,14,11751,5.540.416.667
09/11/2021 12:00,55.94,51894,3949,201,37,7632,16,11835,5.540.416.667
09/11/2021 13:00,42.05,51930,4091,189,53,7371,18,11722,5.540.416.667
09/11/2021 14:00,50.16,52107,4115,179,71,6970,19,11354,5.540.416.667
09/11/2021 15:00,62.17,52426,4114,172,101,6634,23,11044,5.540.416.667
09/11/2021 16:00,69.96,53021,4103,165,144,6343,24,10779,5.540.416.667
09/11/2021 17:00,72.97,52825,4247,155,185,6174,26,10787,5.540.416.667
09/11/2021 18:00,66.76,51876,4320,140,221,5993,29,10703,5.540.416.667
09/11/2021 19:00,40.65,50325,4453,121,248,5851,32,10705,5.540.416.667
09/11/2021 20:00,25.07,48495,4448,100,269,5767,34,10618,5.540.416.667
09/11/2021 21:00,22,47251,4337,80,286,5750,41,10494,5.540.416.667
09/11/2021 22:00,16.48,45124,4174,61,306,5849,46,10436,5.540.416.667
09/11/2021 23:00,13.74,43176,4050,48,327,6007,43,10475,5.540.416.667
10/11/2021 00:00,12.35,41476,3922,36,355,6629,36,10978,5.540.416.667
10/11/2021 01:00,12.04,41063,3801,29,360,6679,36,10905,5.540.416.667
10/11/2021 02:00,12,40570,3597,22,355,6639,44,10657,5.540.416.667
10/11/2021 03:00,12.22,40647,3439,18,346,6572,44,10419,5.540.416.667
10/11/2021 04:00,12.95,42023,3220,16,343,6449,44,10072,5.540.416.667
10/11/2021 05:00,14.84,45061,2931,15,344,6367,43,9700,5.540.416.667
10/11/2021 06:00,22.73,48310,2633,16,345,6310,44,9348,5.540.416.667
10/11/2021 07:00,65.19,50582,2431,19,344,6263,44,9101,5.540.416.667
10/11/2021 08:00,71.88,50780,2174,23,342,6238,44,8821,5.540.416.667
10/11/2021 09:00,67.37,50647,1925,32,330,6330,44,8661,5.540.416.667
10/11/2021 10:00,66.85,50624,1758,41,305,6448,43,8595,5.540.416.667
10/11/2021 11:00,65.74,50202,1524,54,289,6525,43,8435,5.540.416.667
10/11/2021 12:00,65.51,49575,1350,75,278,6510,41,8254,5.540.416.667
10/11/2021 13:00,67.73,49581,1157,97,270,6471,40,8035,5.540.416.667
10/11/2021 14:00,70.03,50151,991,121,262,6467,42,7883,5.540.416.667
10/11/2021 15:00,73.03,50764,890,141,258,6537,40,7866,5.540.416.667
10/11/2021 16:00,76.54,51372,805,164,262,6599,37,7867,5.540.416.667
10/11/2021 17:00,79.81,51624,734,181,265,6690,36,7906,5.540.416.667
10/11/2021 18:00,78.18,51130,672,199,265,6782,33,7951,5.540.416.667
10/11/2021 19:00,73.08,49757,667,212,258,6769,33,7939,5.540.416.667
10/11/2021 20:00,65.91,47696,650,224,241,6707,32,7854,5.540.416.667
10/11/2021 21:00,54.98,46434,623,235,219,6623,28,7728,5.540.416.667
10/11/2021 22:00,28.43,44579,599,243,195,6518,26,7581,5.540.416.667
10/11/2021 23:00,20.65,42827,527,249,169,6396,21,7362,5.540.416.667
11/11/2021 00:00,17.2,41468,359,264,160,6480,12,7275,5.540.416.667
11/11/2021 01:00,17.14,41072,413,263,134,6356,12,7178,5.540.416.667
11/11/2021 02:00,16.66,40985,472,257,120,6247,11,7107,5.540.416.667
11/11/2021 03:00,16.95,41192,592,242,114,6138,9,7095,5.540.416.667
11/11/2021 04:00,17.83,42441,748,226,108,6074,7,7163,5.540.416.667
11/11/2021 05:00,22.05,45631,974,212,98,6097,6,7387,5.540.416.667
11/11/2021 06:00,42.28,49467,1181,204,90,6094,7,7576,5.540.416.667
11/11/2021 07:00,60.23,51494,1328,199,88,6172,6,7793,5.540.416.667
11/11/2021 08:00,69.94,51627,1445,199,92,6299,8,8043,5.540.416.667
11/11/2021 09:00,64.18,51404,1758,201,98,6432,8,8497,5.540.416.667
11/11/2021 10:00,60.26,51387,2107,204,100,6419,9,8839,5.540.416.667
11/11/2021 11:00,64.24,50998,2436,207,103,6317,14,9077,5.540.416.667
11/11/2021 12:00,60.41,50189,2644,210,118,6345,16,9333,5.540.416.667
11/11/2021 13:00,62.88,50219,2661,209,142,6503,16,9531,5.540.416.667
11/11/2021 14:00,64.92,50875,2485,204,169,6591,18,9467,5.540.416.667
11/11/2021 15:00,66.25,51185,2179,197,200,6684,20,9280,5.540.416.667
11/11/2021 16:00,72.35,52466,1899,191,233,6837,21,9181,5.540.416.667
11/11/2021 17:00,78.97,52353,1694,187,263,6997,28,9169,5.540.416.667
11/11/2021 18:00,78.84,51233,1579,182,292,7086,37,9176,5.540.416.667
11/11/2021 19:00,73.06,49753,1511,175,324,7103,39,9152,5.540.416.667
11/11/2021 20:00,69.71,48317,1338,165,341,7052,41,8937,5.540.416.667
11/11/2021 21:00,65.05,46751,1161,151,343,6957,43,8655,5.540.416.667
11/11/2021 22:00,60.37,45042,1041,134,340,6854,43,8412,5.540.416.667
11/11/2021 23:00,39.48,43387,893,115,331,6758,41,8138,5.540.416.667
12/11/2021 00:00,40.79,44014,845,124,358,6785,38,8150,5.540.416.667
12/11/2021 01:00,36.62,43122,656,103,332,6630,36,7757,5.540.416.667
12/11/2021 02:00,33.2,42592,490,86,300,6462,35,7373,5.540.416.667
12/11/2021 03:00,34.52,42428,406,72,272,6292,31,7073,5.540.416.667
12/11/2021 04:00,40.76,43256,430,60,250,6086,27,6853,5.540.416.667
12/11/2021 05:00,64.7,45413,547,53,235,5818,28,6681,5.540.416.667
12/11/2021 06:00,77.65,49460,693,52,222,5505,27,6499,5.540.416.667
12/11/2021 07:00,82.07,52221,834,54,210,5141,21,6260,5.540.416.667
12/11/2021 08:00,85.32,52827,943,56,193,4763,16,5971,5.540.416.667
12/11/2021 09:00,84.29,52970,1133,59,164,4422,15,5793,5.540.416.667
12/11/2021 10:00,84.37,52303,1285,64,138,3972,14,5473,5.540.416.667
12/11/2021 11:00,85.63,51798,1374,70,130,3390,14,4978,5.540.416.667
12/11/2021 12:00,86.52,51428,1541,84,122,2871,15,4633,5.540.416.667
12/11/2021 13:00,86.56,51067,1689,99,112,2585,13,4498,5.540.416.667
12/11/2021 14:00,86.81,51179,1852,112,101,2465,11,4541,5.540.416.667
12/11/2021 15:00,87.61,51887,1967,122,92,2478,9,4668,5.540.416.667
12/11/2021 16:00,90.07,52805,2150,133,84,2527,9,4903,5.540.416.667
12/11/2021 17:00,92.21,53228,2508,142,72,2534,8,5264,5.540.416.667
12/11/2021 18:00,88.41,52135,2878,149,60,2500,7,5594,5.540.416.667
12/11/2021 19:00,82.9,50556,3195,166,47,2389,7,5804,5.540.416.667
12/11/2021 20:00,80.3,48926,3289,179,38,2272,6,5784,5.540.416.667
12/11/2021 21:00,79.08,47642,3200,188,29,2206,6,5629,5.540.416.667
12/11/2021 22:00,73.39,46107,3022,189,20,2187,5,5423,5.540.416.667
12/11/2021 23:00,64.56,44268,2823,182,16,2185,5,5211,5.540.416.667
13/11/2021 00:00,58.97,42592,2790,100,16,2215,5,5126,5.540.416.667
13/11/2021 01:00,56.4,42060,2596,93,20,2194,5,4908,5.540.416.667
13/11/2021 02:00,49.89,41577,2466,85,24,2153,5,4733,5.540.416.667
13/11/2021 03:00,55.48,41324,2353,78,26,2115,6,4578,5.540.416.667
13/11/2021 04:00,65,41325,2236,80,34,2061,7,4418,5.540.416.667
13/11/2021 05:00,69.25,41869,2134,80,46,1990,7,4257,5.540.416.667
13/11/2021 06:00,74.03,43215,1961,68,57,1871,8,3965,5.540.416.667
13/11/2021 07:00,80.04,44641,1797,62,69,1736,11,3675,5.540.416.667
13/11/2021 08:00,83.54,46017,1565,63,75,1610,11,3324,5.540.416.667
13/11/2021 09:00,88.08,47288,1387,60,80,1526,8,3061,5.540.416.667
13/11/2021 10:00,86.66,48131,1228,68,94,1474,6,2870,5.540.416.667
13/11/2021 11:00,87.72,48381,1053,76,111,1438,6,2684,5.540.416.667
13/11/2021 12:00,87.14,48179,905,81,129,1422,6,2543,5.540.416.667
13/11/2021 13:00,86.25,48304,814,94,145,1443,7,2503,5.540.416.667
13/11/2021 14:00,86.23,48409,826,105,157,1487,7,2582,5.540.416.667
13/11/2021 15:00,88.03,49305,847,117,174,1579,7,2724,5.540.416.667
13/11/2021 16:00,91.49,50506,888,129,187,1655,7,2866,5.540.416.667
13/11/2021 17:00,92.91,51216,965,137,190,1736,8,3036,5.540.416.667
13/11/2021 18:00,91.09,50298,1083,138,184,1823,8,3236,5.540.416.667
13/11/2021 19:00,90.67,48487,1254,136,167,1963,8,3528,5.540.416.667
13/11/2021 20:00,85.64,46790,1346,131,151,2157,6,3791,5.540.416.667
13/11/2021 21:00,85.03,45758,1358,119,140,2345,6,3968,5.540.416.667
13/11/2021 22:00,81.92,44504,1374,106,130,2513,6,4129,5.540.416.667
13/11/2021 23:00,80.98,43189,1471,93,119,2685,6,4374,5.540.416.667
14/11/2021 00:00,81.71,41760,1265,68,92,2405,6,3836,5.540.416.667
14/11/2021 01:00,80.97,41224,1324,56,74,2523,6,3983,5.540.416.667
14/11/2021 02:00,78.88,40802,1378,48,62,2611,6,4105,5.540.416.667
14/11/2021 03:00,77.67,40659,1460,44,56,2665,6,4231,5.540.416.667
14/11/2021 04:00,77.82,40668,1525,47,52,2608,6,4238,5.540.416.667
14/11/2021 05:00,78.07,42075,1624,51,48,2450,6,4179,5.540.416.667
14/11/2021 06:00,78.86,42915,1655,47,49,2251,6,4008,5.540.416.667
14/11/2021 07:00,79.82,44422,1645,49,50,2019,6,3769,5.540.416.667
14/11/2021 08:00,81.96,44917,1619,52,46,1766,6,3489,5.540.416.667
14/11/2021 09:00,84.51,46234,1607,56,42,1533,7,3245,5.540.416.667
14/11/2021 10:00,88.53,47313,1591,63,45,1317,7,3023,5.540.416.667
14/11/2021 11:00,90.68,47740,1572,89,53,1146,8,2868,5.540.416.667
14/11/2021 12:00,90.42,47277,1533,102,64,1021,8,2728,5.540.416.667
14/11/2021 13:00,90.5,47470,1528,107,77,934,8,2654,5.540.416.667
14/11/2021 14:00,92.84,48028,1467,109,84,893,7,2560,5.540.416.667
14/11/2021 15:00,95.51,49076,1414,117,96,939,7,2573,5.540.416.667
14/11/2021 16:00,99.81,50513,1448,117,113,1096,7,2781,5.540.416.667
14/11/2021 17:00,100.14,51490,1483,121,120,1356,12,3092,5.540.416.667
14/11/2021 18:00,96.86,51537,1519,111,117,1728,14,3489,5.540.416.667
14/11/2021 19:00,91.28,50200,1552,116,108,2150,14,3940,5.540.416.667
14/11/2021 20:00,84.44,49655,1566,120,103,2608,13,4410,5.540.416.667
14/11/2021 21:00,83.03,48061,1576,128,100,3084,12,4900,5.540.416.667
14/11/2021 22:00,78.97,46185,1513,138,98,3490,6,5245,5.540.416.667
14/11/2021 23:00,74.26,44156,1355,150,91,3844,5,5445,5.540.416.667
15/11/2021 00:00,67.24,43842,1319,202,67,4318,6,5912,551.875
15/11/2021 01:00,64.94,43335,1174,202,61,4602,5,6044,551.875
15/11/2021 02:00,56.89,42912,1121,211,59,4793,5,6189,551.875
15/11/2021 03:00,55.28,42723,1059,224,59,4995,4,6341,551.875
15/11/2021 04:00,61.22,43310,909,225,57,5121,4,6316,551.875
15/11/2021 05:00,74.65,45638,817,224,56,5186,4,6287,551.875
15/11/2021 06:00,81.44,49514,780,226,58,5214,4,6282,551.875
15/11/2021 07:00,84.99,52843,734,223,62,5155,4,6178,551.875
15/11/2021 08:00,89.23,53470,650,220,64,5033,4,5971,551.875
15/11/2021 09:00,87.49,53444,630,220,63,4978,4,5895,551.875
15/11/2021 10:00,87.13,53474,646,220,60,4880,4,5810,551.875
15/11/2021 11:00,86.47,53629,605,216,58,4750,5,5634,551.875
15/11/2021 12:00,85.75,53368,547,208,56,4630,5,5446,551.875
15/11/2021 13:00,86.29,53147,488,195,60,4589,4,5336,551.875
15/11/2021 14:00,86.09,53147,409,181,65,4629,4,5288,551.875
15/11/2021 15:00,86.66,53152,332,163,73,4770,5,5343,551.875
15/11/2021 16:00,87.6,53616,310,146,87,4893,5,5441,551.875
15/11/2021 17:00,89.71,54116,294,130,99,4965,5,5493,551.875
15/11/2021 18:00,86.6,53054,293,112,105,5009,6,5525,551.875
15/11/2021 19:00,82.28,51710,319,94,103,5059,6,5581,551.875
15/11/2021 20:00,80.96,49935,401,78,101,5080,6,5666,551.875
15/11/2021 21:00,80.19,48697,465,63,97,5007,7,5639,551.875
15/11/2021 22:00,74.64,46594,412,51,94,4849,8,5414,551.875
15/11/2021 23:00,67.11,44672,395,41,91,4641,8,5176,551.875
16/11/2021 00:00,60,42846,388,13,80,4550,9,5040,551.875
16/11/2021 01:00,59.98,42097,358,11,70,4285,7,4731,551.875
16/11/2021 02:00,59.97,41638,301,8,65,4069,7,4450,551.875
16/11/2021 03:00,59.99,41712,258,5,62,3845,7,4177,551.875
16/11/2021 04:00,67.94,42477,260,4,61,3752,8,4085,551.875
16/11/2021 05:00,74.99,44577,289,4,62,3773,8,4136,551.875
16/11/2021 06:00,82.81,48401,353,6,64,3762,8,4193,551.875
16/11/2021 07:00,88.97,51658,430,10,67,3770,8,4285,551.875
16/11/2021 08:00,93.73,52243,460,18,69,3722,8,4277,551.875
16/11/2021 09:00,90.86,51513,496,23,67,3766,9,4361,551.875
16/11/2021 10:00,90.16,51489,554,26,56,3753,8,4397,551.875
16/11/2021 11:00,89.85,50949,615,30,44,3735,8,4432,551.875
16/11/2021 12:00,89.36,51287,683,36,42,3708,7,4476,551.875
16/11/2021 13:00,88.98,51245,723,47,47,3643,7,4467,551.875
16/11/2021 14:00,88.29,51102,705,56,54,3642,8,4465,551.875
16/11/2021 15:00,89.54,51644,687,70,63,3743,8,4571,551.875
16/11/2021 16:00,89.73,52515,713,79,74,3797,8,4671,551.875
16/11/2021 17:00,92.54,52687,775,87,81,3797,9,4749,551.875
16/11/2021 18:00,89.02,51907,851,91,81,3819,8,4850,551.875
16/11/2021 19:00,82.73,50537,944,97,75,3894,8,5018,551.875
16/11/2021 20:00,81.08,49168,1006,105,72,4042,8,5233,551.875
16/11/2021 21:00,77.67,47848,1090,112,67,4271,10,5550,551.875
16/11/2021 22:00,67.7,45784,1224,119,62,4507,11,5923,551.875
16/11/2021 23:00,44.99,43367,1375,125,60,4679,9,6248,551.875
17/11/2021 00:00,50.51,41944,1340,140,62,4461,9,6012,551.875
17/11/2021 01:00,40.09,41291,1466,136,56,4659,8,6325,551.875
17/11/2021 02:00,25.26,40544,1668,132,56,4824,9,6689,551.875
17/11/2021 03:00,22.83,40520,1921,131,60,4998,10,7120,551.875
17/11/2021 04:00,23.91,41669,2212,131,64,5143,11,7561,551.875
17/11/2021 05:00,27.01,43679,2451,132,69,5261,11,7924,551.875
17/11/2021 06:00,50.92,47321,2544,128,75,5339,11,8097,551.875
17/11/2021 07:00,79.2,50200,2613,118,82,5357,11,8181,551.875
17/11/2021 08:00,82.58,51165,2508,111,83,5285,10,7997,551.875
17/11/2021 09:00,81.23,50876,2495,109,86,5280,10,7980,551.875
17/11/2021 10:00,81.93,51202,2642,106,94,5242,12,8096,551.875
17/11/2021 11:00,82.7,51055,2879,98,104,5172,12,8265,551.875
17/11/2021 12:00,81.05,50964,3096,92,120,5060,13,8381,551.875
17/11/2021 13:00,81.09,50879,3189,86,142,4886,12,8315,551.875
17/11/2021 14:00,82.3,50912,3218,77,156,4682,12,8145,551.875
17/11/2021 15:00,83.01,51605,3210,72,168,4519,14,7983,551.875
17/11/2021 16:00,84.07,52703,3263,71,189,4378,15,7916,551.875
17/11/2021 17:00,84.7,53699,3531,70,210,4213,16,8040,551.875
17/11/2021 18:00,83.23,52572,3770,67,232,4036,17,8122,551.875
17/11/2021 19:00,74.32,51517,3934,66,251,3904,17,8172,551.875
17/11/2021 20:00,59.85,50048,4044,66,268,3831,19,8228,551.875
17/11/2021 21:00,51.2,48654,4124,66,286,3869,21,8366,551.875
17/11/2021 22:00,37.9,46879,4099,65,307,4080,24,8575,551.875
17/11/2021 23:00,20.75,44727,4035,65,326,4406,23,8855,551.875
18/11/2021 00:00,20.01,43487,3810,63,295,4600,20,8788,551.875
18/11/2021 01:00,17.07,42881,3807,60,309,4984,27,9187,551.875
18/11/2021 02:00,16.25,42413,3765,59,318,5237,29,9408,551.875
18/11/2021 03:00,16.5,42401,3679,58,323,5431,26,9517,551.875
18/11/2021 04:00,18.28,43212,3591,57,323,5544,34,9549,551.875
18/11/2021 05:00,24.27,45324,3406,57,316,5585,33,9397,551.875
18/11/2021 06:00,59.12,49078,3250,60,324,5588,39,9261,551.875
18/11/2021 07:00,83.09,52431,3200,63,323,5534,40,9160,551.875
18/11/2021 08:00,85.45,53164,3071,65,317,5393,35,8881,551.875
18/11/2021 09:00,83.43,53287,3134,68,311,5352,35,8900,551.875
18/11/2021 10:00,82.19,53156,3423,70,322,5269,32,9116,551.875
18/11/2021 11:00,80.91,52963,3909,74,335,5128,30,9476,551.875
18/11/2021 12:00,78.53,52465,4211,77,337,4974,24,9623,551.875
18/11/2021 13:00,78.07,52102,4428,83,324,4943,27,9805,551.875
18/11/2021 14:00,70.92,53053,4633,87,311,5082,25,10138,551.875
18/11/2021 15:00,71.4,53482,4719,93,293,5327,26,10458,551.875
18/11/2021 16:00,73.07,54427,4800,100,285,5600,24,10809,551.875
18/11/2021 17:00,75.43,54452,4845,108,287,5765,24,11029,551.875
18/11/2021 18:00,65.46,53493,4797,118,287,5886,27,11115,551.875
18/11/2021 19:00,32.13,52286,4722,128,285,6050,21,11206,551.875
18/11/2021 20:00,25.67,50877,4666,133,269,6276,18,11362,551.875
18/11/2021 21:00,25.1,49392,4625,138,257,6507,13,11540,551.875
18/11/2021 22:00,20.88,47666,4616,147,273,6664,13,11713,551.875
18/11/2021 23:00,14.97,45710,4583,152,301,6680,6,11722,551.875
19/11/2021 00:00,14.15,43355,4606,133,255,6557,6,11557,551.875
19/11/2021 01:00,13.75,42552,4643,142,268,6365,12,11430,551.875
19/11/2021 02:00,13.53,42007,4691,143,267,6144,11,11256,551.875
19/11/2021 03:00,13.77,41972,4685,129,261,5932,9,11016,551.875
19/11/2021 04:00,14.67,42633,4717,115,245,5777,10,10864,551.875
19/11/2021 05:00,17.85,44765,4770,104,230,5742,9,10855,551.875
19/11/2021 06:00,27.51,48208,4785,109,219,5802,9,10924,551.875
19/11/2021 07:00,58.13,52056,4829,125,207,5951,17,11129,551.875
19/11/2021 08:00,64.94,52737,4752,147,204,6143,30,11276,551.875
19/11/2021 09:00,55.27,52399,4737,161,205,6387,29,11519,551.875
19/11/2021 10:00,49.98,52682,4776,170,201,6526,24,11697,551.875
19/11/2021 11:00,43.2,52161,4746,175,203,6726,17,11867,551.875
19/11/2021 12:00,33.26,51482,4772,176,216,6894,19,12077,551.875
19/11/2021 13:00,25.59,51075,4848,172,264,7040,20,12344,551.875
19/11/2021 14:00,23.13,50717,4822,168,331,7252,33,12606,551.875
19/11/2021 15:00,22.62,51275,4814,155,387,7484,50,12890,551.875
19/11/2021 16:00,25.01,51581,4801,141,427,7809,53,13231,551.875
19/11/2021 17:00,25.28,51743,4933,121,454,8208,54,13770,551.875
19/11/2021 18:00,20.37,50900,4986,101,473,8605,53,14218,551.875
19/11/2021 19:00,17.41,49573,4888,92,485,9011,55,14531,551.875
19/11/2021 20:00,15.17,47749,4638,87,491,9270,55,14541,551.875
19/11/2021 21:00,14.72,46554,4357,79,494,9414,54,14398,551.875
19/11/2021 22:00,14.22,45091,4065,73,493,9410,55,14096,551.875
19/11/2021 23:00,13.33,43171,3752,65,491,9333,56,13697,551.875
20/11/2021 00:00,14.2,41484,3436,28,492,9303,50,13309,551.875
20/11/2021 01:00,13.95,41028,3235,21,492,9220,50,13018,551.875
20/11/2021 02:00,13.04,40554,3170,16,493,9050,50,12779,551.875
20/11/2021 03:00,13.91,40412,3170,12,493,8795,50,12520,551.875
20/11/2021 04:00,14.32,40652,3254,9,489,8423,49,12224,551.875
20/11/2021 05:00,14.92,41424,3406,8,474,8009,49,11946,551.875
20/11/2021 06:00,15.93,42750,3514,6,446,7623,47,11636,551.875
20/11/2021 07:00,17.33,44169,3603,5,406,7314,45,11373,551.875
20/11/2021 08:00,22.01,45613,3669,5,367,6979,43,11063,551.875
20/11/2021 09:00,25.11,46875,3842,4,342,6670,38,10896,551.875
20/11/2021 10:00,27.13,47677,4158,4,334,6454,38,10988,551.875
20/11/2021 11:00,26.89,47957,4393,5,336,6302,41,11077,551.875
20/11/2021 12:00,27.25,47925,4565,5,330,6125,38,11063,551.875
20/11/2021 13:00,27.64,47683,4694,5,308,5943,35,10985,551.875
20/11/2021 14:00,28.04,47937,4828,5,286,5799,28,10946,551.875
20/11/2021 15:00,39.91,48882,4834,6,281,5678,25,10824,551.875
20/11/2021 16:00,56.17,50132,4774,6,279,5613,27,10699,551.875
20/11/2021 17:00,67.24,50842,4804,7,244,5546,32,10633,551.875
20/11/2021 18:00,59.28,50020,4731,8,201,5453,31,10424,551.875
20/11/2021 19:00,39.84,48373,4680,9,199,5320,33,10241,551.875
20/11/2021 20:00,25.8,46590,4557,11,224,5191,31,10014,551.875
20/11/2021 21:00,22.46,45863,4286,11,258,5125,31,9711,551.875
20/11/2021 22:00,22.54,45085,4105,10,283,5091,32,9521,551.875
20/11/2021 23:00,19.94,43313,3893,10,305,5003,30,9241,551.875
21/11/2021 00:00,17.66,41581,4161,13,415,5141,11,9741,551.875
21/11/2021 01:00,17.1,41218,3996,12,415,5095,9,9527,551.875
21/11/2021 02:00,16.65,40930,3715,11,404,4997,9,9136,551.875
21/11/2021 03:00,16.66,40952,3368,9,396,4964,7,8744,551.875
21/11/2021 04:00,16.96,40985,2979,9,385,5011,7,8391,551.875
21/11/2021 05:00,17.86,41317,2716,8,369,4988,7,8088,551.875
21/11/2021 06:00,18.99,42403,2563,8,349,4947,6,7873,551.875
21/11/2021 07:00,20.95,44154,2521,10,331,4839,6,7707,551.875
21/11/2021 08:00,60.04,45883,2501,13,314,4702,5,7535,551.875
21/11/2021 09:00,79.44,47390,2479,15,284,4630,6,7414,551.875
21/11/2021 10:00,86.18,47739,2562,15,242,4469,7,7295,551.875
21/11/2021 11:00,88.02,48122,2633,17,211,4205,7,7073,551.875
21/11/2021 12:00,87.33,48203,2683,18,188,3988,8,6885,551.875
21/11/2021 13:00,87.92,48109,2699,17,150,3969,8,6843,551.875
21/11/2021 14:00,88.68,48474,2712,18,117,4126,9,6982,551.875
21/11/2021 15:00,90.91,49610,2726,23,99,4332,8,7188,551.875
21/11/2021 16:00,94.49,51338,2779,26,92,4439,11,7347,551.875
21/11/2021 17:00,96.86,52571,3043,28,81,4437,10,7599,551.875
21/11/2021 18:00,93.93,52254,3232,27,81,4319,11,7670,551.875
21/11/2021 19:00,92,51368,3237,25,82,4123,10,7477,551.875
21/11/2021 20:00,90,50170,3156,24,84,3907,9,7180,551.875
21/11/2021 21:00,90.65,49374,2862,21,81,3710,11,6685,551.875
21/11/2021 22:00,88.98,48642,2442,18,81,3559,12,6112,551.875
21/11/2021 23:00,88.42,46801,2103,16,94,3397,10,5620,551.875
22/11/2021 00:00,94.11,45647,940,53,101,2998,12,4104,5.354.583.333
22/11/2021 01:00,92.92,45275,761,49,93,2784,10,3697,5.354.583.333
22/11/2021 02:00,92.35,44960,588,46,80,2573,9,3296,5.354.583.333
22/11/2021 03:00,92.03,45196,501,42,68,2420,9,3040,5.354.583.333
22/11/2021 04:00,92.46,46316,438,39,60,2383,10,2930,5.354.583.333
22/11/2021 05:00,95.98,48810,443,41,54,2420,9,2967,5.354.583.333
22/11/2021 06:00,109.43,52418,593,46,49,2521,8,3217,5.354.583.333
22/11/2021 07:00,113.23,55863,716,51,39,2692,7,3505,5.354.583.333
22/11/2021 08:00,114.28,56907,875,58,26,2903,6,3868,5.354.583.333
22/11/2021 09:00,111.67,56701,1033,66,15,3141,6,4261,5.354.583.333
22/11/2021 10:00,111.27,56441,1102,72,7,3469,6,4656,5.354.583.333
22/11/2021 11:00,109.27,55864,1136,71,4,3803,6,5020,5.354.583.333
22/11/2021 12:00,108.49,55430,1301,67,6,4137,7,5518,5.354.583.333
22/11/2021 13:00,106.97,54851,1568,69,10,4372,8,6027,5.354.583.333
22/11/2021 14:00,105.72,54738,1991,78,18,4507,8,6602,5.354.583.333
22/11/2021 15:00,107.14,55587,2438,92,30,4696,8,7264,5.354.583.333
22/11/2021 16:00,108.14,56674,2768,99,44,4862,8,7781,5.354.583.333
22/11/2021 17:00,107.68,57175,3225,128,57,5030,11,8451,5.354.583.333
22/11/2021 18:00,99.37,55975,3480,159,70,5193,13,8915,5.354.583.333
22/11/2021 19:00,93.54,54557,3647,168,76,5297,15,9203,5.354.583.333
22/11/2021 20:00,89.91,52805,3857,163,91,5346,18,9475,5.354.583.333
22/11/2021 21:00,88.91,51319,3889,171,114,5379,23,9576,5.354.583.333
22/11/2021 22:00,84.4,49558,3829,190,142,5303,29,9493,5.354.583.333
22/11/2021 23:00,74.77,47677,3834,210,175,5128,36,9383,5.354.583.333
23/11/2021 00:00,69.95,46203,3624,133,235,4344,34,8370,5.354.583.333
23/11/2021 01:00,65.4,45413,3476,121,265,4022,43,7927,5.354.583.333
23/11/2021 02:00,66.73,44793,3322,107,291,3741,42,7503,5.354.583.333
23/11/2021 03:00,69.36,44519,3219,92,311,3574,34,7230,5.354.583.333
23/11/2021 04:00,77.89,45439,3134,78,313,3530,36,7091,5.354.583.333
23/11/2021 05:00,86.73,47332,2949,61,299,3626,31,6966,5.354.583.333
23/11/2021 06:00,94.34,51289,2706,46,291,3768,31,6842,5.354.583.333
23/11/2021 07:00,109.01,55293,2559,34,276,3877,27,6773,5.354.583.333
23/11/2021 08:00,112.62,55742,2319,28,248,3945,29,6569,5.354.583.333
23/11/2021 09:00,110.59,55417,2055,30,222,4065,27,6399,5.354.583.333
23/11/2021 10:00,109.14,55493,2049,33,203,4153,34,6472,5.354.583.333
23/11/2021 11:00,108.47,55335,2214,39,198,4318,31,6800,5.354.583.333
23/11/2021 12:00,105.93,54875,2402,44,194,4647,26,7313,5.354.583.333
23/11/2021 13:00,104.31,54432,2502,46,184,5109,21,7862,5.354.583.333
23/11/2021 14:00,100.73,54425,2599,44,172,5550,22,8387,5.354.583.333
23/11/2021 15:00,104.32,55216,2741,43,162,5960,16,8922,5.354.583.333
23/11/2021 16:00,104.6,56100,2878,42,146,6221,12,9299,5.354.583.333
23/11/2021 17:00,102.61,56392,3115,43,130,6311,10,9609,5.354.583.333
23/11/2021 18:00,95.76,55649,3290,44,114,6369,7,9824,5.354.583.333
23/11/2021 19:00,91.85,53902,3331,45,102,6588,8,10074,5.354.583.333
23/11/2021 20:00,86.47,52425,3237,52,97,6910,11,10307,5.354.583.333
23/11/2021 21:00,81.6,50750,3186,66,95,7143,9,10499,5.354.583.333
23/11/2021 22:00,70.93,48823,3186,81,111,7199,8,10585,5.354.583.333
23/11/2021 23:00,44.94,46800,3134,93,137,7181,10,10555,5.354.583.333
24/11/2021 00:00,28.82,45293,3248,158,208,7477,29,11120,5.354.583.333
24/11/2021 01:00,28.61,44512,3183,152,235,7284,36,10890,5.354.583.333
24/11/2021 02:00,28.78,43805,3091,106,255,6883,40,10375,5.354.583.333
24/11/2021 03:00,29.52,43724,2988,69,268,6445,42,9812,5.354.583.333
24/11/2021 04:00,35.58,44401,2882,55,275,6016,40,9268,5.354.583.333
24/11/2021 05:00,61.65,46574,2721,61,274,5480,36,8572,5.354.583.333
24/11/2021 06:00,89.87,50538,2591,72,266,4924,30,7883,5.354.583.333
24/11/2021 07:00,104.36,54257,2444,85,260,4358,24,7171,5.354.583.333
24/11/2021 08:00,112.24,54581,2213,103,257,3845,20,6438,5.354.583.333
24/11/2021 09:00,113.88,54333,2057,109,253,3414,23,5856,5.354.583.333
24/11/2021 10:00,115.19,54401,2066,109,254,3033,24,5486,5.354.583.333
24/11/2021 11:00,115,54058,2125,104,247,2797,22,5295,5.354.583.333
24/11/2021 12:00,115.33,53606,2202,88,240,2771,19,5320,5.354.583.333
24/11/2021 13:00,115.21,53186,2212,62,241,2933,16,5464,5.354.583.333
24/11/2021 14:00,114.88,53510,2191,41,234,3245,16,5727,5.354.583.333
24/11/2021 15:00,115.84,54249,2180,26,226,3599,17,6048,5.354.583.333
24/11/2021 16:00,118.38,54967,2153,21,216,3776,15,6181,5.354.583.333
24/11/2021 17:00,118.31,55329,2342,19,212,3832,16,6421,5.354.583.333
24/11/2021 18:00,114.42,54413,2454,22,214,3861,19,6570,5.354.583.333
24/11/2021 19:00,108.47,53391,2474,34,221,3952,18,6699,5.354.583.333
24/11/2021 20:00,99.55,51535,2468,48,228,4036,20,6800,5.354.583.333
24/11/2021 21:00,96.94,50316,2462,68,236,4117,20,6903,5.354.583.333
24/11/2021 22:00,90.95,48550,2464,94,244,4179,18,6999,5.354.583.333
24/11/2021 23:00,85.01,46243,2456,126,244,4167,25,7018,5.354.583.333
25/11/2021 00:00,81.58,44608,2757,191,239,4340,22,7549,5.354.583.333
25/11/2021 01:00,78.45,43620,2619,218,243,4329,23,7432,5.354.583.333
25/11/2021 02:00,78.42,43489,2478,233,243,4256,30,7240,5.354.583.333
25/11/2021 03:00,79.98,43262,2368,237,245,4130,31,7011,5.354.583.333
25/11/2021 04:00,85.57,44149,2344,234,253,3965,30,6826,5.354.583.333
25/11/2021 05:00,92.38,46519,2410,215,264,3826,26,6741,5.354.583.333
25/11/2021 06:00,103.07,50621,2531,189,272,3719,27,6738,5.354.583.333
25/11/2021 07:00,114.49,54102,2697,167,276,3667,34,6841,5.354.583.333
25/11/2021 08:00,118.25,54748,2836,146,279,3558,37,6856,5.354.583.333
25/11/2021 09:00,116.2,54664,2950,127,280,3527,41,6925,5.354.583.333
25/11/2021 10:00,114.19,54823,3189,112,275,3430,38,7044,5.354.583.333
25/11/2021 11:00,112.11,54724,3579,98,267,3287,41,7272,5.354.583.333
25/11/2021 12:00,109.98,54141,3752,83,256,3175,36,7302,5.354.583.333
25/11/2021 13:00,109.62,54459,3925,64,242,3099,35,7365,5.354.583.333
25/11/2021 14:00,110.01,54733,4020,50,237,3051,36,7394,5.354.583.333
25/11/2021 15:00,112.59,55895,4053,40,242,3129,31,7495,5.354.583.333
25/11/2021 16:00,115.47,56664,4148,32,255,3200,31,7666,5.354.583.333
25/11/2021 17:00,117.1,57355,4291,28,266,3181,33,7799,5.354.583.333
25/11/2021 18:00,116.35,56596,4087,30,259,3098,33,7507,5.354.583.333
25/11/2021 19:00,114.98,55513,3849,36,251,3017,29,7182,5.354.583.333
25/11/2021 20:00,112.59,54318,3552,43,252,2905,25,6777,5.354.583.333
25/11/2021 21:00,109.1,53086,3277,51,264,2799,23,6414,5.354.583.333
25/11/2021 22:00,103.36,51366,3038,61,277,2646,27,6049,5.354.583.333
25/11/2021 23:00,99.3,49141,2849,75,306,2458,29,5717,5.354.583.333
26/11/2021 00:00,102.62,47597,2801,77,371,2075,28,5352,5.354.583.333
26/11/2021 01:00,100.76,47194,2505,98,379,1814,23,4819,5.354.583.333
26/11/2021 02:00,102.43,46795,2156,115,379,1581,12,4243,5.354.583.333
26/11/2021 03:00,105.32,46870,1824,135,379,1401,11,3750,5.354.583.333
26/11/2021 04:00,109.69,47533,1536,153,368,1278,9,3344,5.354.583.333
26/11/2021 05:00,115.82,49690,1443,163,347,1192,7,3152,5.354.583.333
26/11/2021 06:00,136.92,53357,1313,174,331,1146,6,2970,5.354.583.333
26/11/2021 07:00,173.68,57273,1165,181,324,1089,5,2764,5.354.583.333
26/11/2021 08:00,188.19,57940,1087,184,314,1012,4,2601,5.354.583.333
26/11/2021 09:00,172.22,57825,1118,189,307,958,5,2577,5.354.583.333
26/11/2021 10:00,152.09,57977,1253,185,307,910,5,2660,5.354.583.333
26/11/2021 11:00,134.16,57527,1596,175,306,842,5,2924,5.354.583.333
26/11/2021 12:00,131.41,57226,1948,162,303,801,5,3219,5.354.583.333
26/11/2021 13:00,127.87,56830,2304,142,283,837,6,3572,5.354.583.333
26/11/2021 14:00,127.57,56766,2689,130,253,949,6,4027,5.354.583.333
26/11/2021 15:00,129.54,57421,2894,120,224,1108,7,4353,5.354.583.333
26/11/2021 16:00,136.88,58532,3008,118,201,1247,8,4582,5.354.583.333
26/11/2021 17:00,142.33,58760,3249,117,178,1344,9,4897,5.354.583.333
26/11/2021 18:00,133.43,57720,3334,115,147,1426,9,5031,5.354.583.333
26/11/2021 19:00,124.91,56329,3381,112,114,1493,10,5110,5.354.583.333
26/11/2021 20:00,114.82,54635,3300,108,87,1544,10,5049,5.354.583.333
26/11/2021 21:00,114,53469,3254,105,67,1599,9,5034,5.354.583.333
26/11/2021 22:00,110.05,51937,3249,99,57,1638,9,5052,5.354.583.333
26/11/2021 23:00,106.56,50270,3081,93,51,1657,8,4890,5.354.583.333
27/11/2021 00:00,114.84,49021,3061,220,53,1803,11,5148,5.354.583.333
27/11/2021 01:00,115.08,48559,3052,232,61,1795,12,5152,5.354.583.333
27/11/2021 02:00,115.25,47964,3123,236,75,1798,11,5243,5.354.583.333
27/11/2021 03:00,114.69,47519,3218,235,93,1813,11,5370,5.354.583.333
27/11/2021 04:00,115.72,47672,3219,235,111,1824,11,5400,5.354.583.333
27/11/2021 05:00,117.49,48439,3244,241,123,1832,11,5451,5.354.583.333
27/11/2021 06:00,116.82,49706,3234,243,136,1830,12,5455,5.354.583.333
27/11/2021 07:00,121.56,51224,3242,242,148,1829,11,5472,5.354.583.333
27/11/2021 08:00,139.08,52825,3146,242,159,1817,11,5375,5.354.583.333
27/11/2021 09:00,167.7,54247,2983,239,167,1783,13,5185,5.354.583.333
27/11/2021 10:00,180.01,55153,2922,243,172,1739,18,5094,5.354.583.333
27/11/2021 11:00,163.11,55294,2861,247,168,1698,17,4991,5.354.583.333
27/11/2021 12:00,181.93,55245,2794,247,157,1671,21,4890,5.354.583.333
27/11/2021 13:00,167.81,55209,2721,243,147,1716,22,4849,5.354.583.333
27/11/2021 14:00,181.55,55552,2667,231,135,1815,22,4870,5.354.583.333
27/11/2021 15:00,193.18,56342,2525,212,119,1903,24,4783,5.354.583.333
27/11/2021 16:00,237.06,57408,2462,187,97,1979,26,4751,5.354.583.333
27/11/2021 17:00,277.03,57679,2491,162,84,2040,26,4803,5.354.583.333
27/11/2021 18:00,250.05,57019,2464,137,79,2065,27,4772,5.354.583.333
27/11/2021 19:00,216.37,55581,2403,112,69,2070,27,4681,5.354.583.333
27/11/2021 20:00,157.97,53977,2210,94,59,2081,24,4468,5.354.583.333
27/11/2021 21:00,157.92,53207,2068,84,51,2096,20,4319,5.354.583.333
27/11/2021 22:00,129,51866,1941,76,42,2088,17,4164,5.354.583.333
27/11/2021 23:00,120.13,50507,1695,69,37,2076,15,3892,5.354.583.333
28/11/2021 00:00,177.48,49517,927,47,32,1963,7,2976,5.354.583.333
28/11/2021 01:00,142.52,48877,859,46,28,1981,7,2921,5.354.583.333
28/11/2021 02:00,139.98,48412,733,47,26,1992,6,2804,5.354.583.333
28/11/2021 03:00,137.79,48165,651,48,28,2006,5,2738,5.354.583.333
28/11/2021 04:00,140.09,48269,602,49,28,2030,5,2714,5.354.583.333
28/11/2021 05:00,164.27,48837,651,49,29,2057,5,2791,5.354.583.333
28/11/2021 06:00,163.73,49565,710,45,31,2068,5,2859,5.354.583.333
28/11/2021 07:00,158.83,51074,790,41,33,2068,5,2937,5.354.583.333
28/11/2021 08:00,179.35,52343,800,39,34,2070,5,2948,5.354.583.333
28/11/2021 09:00,195.93,53601,846,38,37,2055,5,2981,5.354.583.333
28/11/2021 10:00,200.09,54644,883,39,35,2036,5,2998,5.354.583.333
28/11/2021 11:00,207.86,55286,900,47,29,2024,5,3005,5.354.583.333
28/11/2021 12:00,208.04,55294,954,59,25,2002,5,3045,5.354.583.333
28/11/2021 13:00,193.8,55256,1035,74,33,2014,5,3161,5.354.583.333
28/11/2021 14:00,193.93,55881,1119,95,42,2083,5,3344,5.354.583.333
28/11/2021 15:00,203.05,56809,1188,121,52,2198,6,3565,5.354.583.333
28/11/2021 16:00,215.03,57740,1333,146,66,2307,6,3858,5.354.583.333
28/11/2021 17:00,243.57,58341,1553,160,78,2391,6,4188,5.354.583.333
28/11/2021 18:00,246.38,57916,1699,163,86,2451,6,4405,5.354.583.333
28/11/2021 19:00,236.66,57131,1807,155,90,2487,6,4545,5.354.583.333
28/11/2021 20:00,205.4,55965,2032,143,99,2534,6,4814,5.354.583.333
28/11/2021 21:00,184.94,55151,2281,134,118,2598,7,5138,5.354.583.333
28/11/2021 22:00,185.42,53740,2245,124,147,2621,7,5144,5.354.583.333
28/11/2021 23:00,143.65,52244,2148,111,184,2632,8,5083,5.354.583.333
29/11/2021 00:00,150.47,51336,2024,90,143,2617,6,4880,5.104.880.952
29/11/2021 01:00,146.25,50659,2106,88,178,2598,7,4977,5.104.880.952
29/11/2021 02:00,136.62,50281,2188,80,205,2544,7,5024,5.104.880.952
29/11/2021 03:00,132.24,50265,2199,64,227,2496,8,4994,5.104.880.952
29/11/2021 04:00,139.3,51081,2252,62,235,2458,10,5017,5.104.880.952
29/11/2021 05:00,151.43,53484,2448,64,244,2436,11,5203,5.104.880.952
29/11/2021 06:00,199.32,57545,2589,57,254,2409,10,5319,5.104.880.952
29/11/2021 07:00,232.77,61153,2525,50,258,2356,11,5200,5.104.880.952
29/11/2021 08:00,321.8,62031,2349,44,259,2243,12,4907,5.104.880.952
29/11/2021 09:00,319.05,62104,2074,37,259,2094,14,4478,5.104.880.952
29/11/2021 10:00,299,62179,1804,29,250,1876,15,3974,5.104.880.952
29/11/2021 11:00,299.91,61763,1525,23,237,1665,17,3467,5.104.880.952
29/11/2021 12:00,299.91,61088,1243,18,233,1491,20,3005,5.104.880.952
29/11/2021 13:00,315.71,60865,1040,15,239,1384,22,2700,5.104.880.952
29/11/2021 14:00,335.32,61184,905,13,245,1374,23,2560,5.104.880.952
29/11/2021 15:00,335.32,62035,843,12,251,1426,20,2552,5.104.880.952
29/11/2021 16:00,379.52,62890,789,12,264,1458,19,2542,5.104.880.952
29/11/2021 17:00,399.97,62925,695,13,277,1453,22,2460,5.104.880.952
29/11/2021 18:00,340.27,61671,600,15,294,1416,24,2349,5.104.880.952
29/11/2021 19:00,291.66,60607,584,17,314,1381,31,2327,5.104.880.952
29/11/2021 20:00,222.21,59167,673,20,328,1352,36,2409,5.104.880.952
29/11/2021 21:00,175.39,57843,858,25,337,1358,32,2610,5.104.880.952
29/11/2021 22:00,172.25,56201,1168,31,342,1359,32,2932,5.104.880.952
29/11/2021 23:00,128.87,54181,1679,38,347,1347,38,3449,5.104.880.952
30/11/2021 00:00,114.3,53114,2619,43,351,1310,31,4354,5.104.880.952
30/11/2021 01:00,99.94,52348,3151,50,347,1319,36,4903,5.104.880.952
30/11/2021 02:00,96.02,51466,3782,57,351,1349,36,5575,5.104.880.952
30/11/2021 03:00,94.93,51104,4259,64,346,1458,33,6160,5.104.880.952
30/11/2021 04:00,95.42,52338,4476,70,341,1626,28,6541,5.104.880.952
30/11/2021 05:00,99.38,54629,4508,75,332,1783,27,6725,5.104.880.952
30/11/2021 06:00,110.83,58450,4664,78,308,1984,25,7059,5.104.880.952
30/11/2021 07:00,128.75,61947,4677,79,277,2159,22,7214,5.104.880.952
30/11/2021 08:00,137.64,62679,4580,81,237,2218,19,7135,5.104.880.952
30/11/2021 09:00,132.27,62471,4402,84,199,2196,16,6897,5.104.880.952
30/11/2021 10:00,136.98,62656,4366,88,171,2086,15,6726,5.104.880.952
30/11/2021 11:00,131.94,62569,4406,93,156,2000,16,6671,5.104.880.952
30/11/2021 12:00,130.18,62254,4532,102,152,1997,13,6796,5.104.880.952
30/11/2021 13:00,133.98,61837,4503,115,143,2048,12,6821,5.104.880.952
30/11/2021 14:00,136.54,62125,4211,129,136,2107,11,6594,5.104.880.952
30/11/2021 15:00,150.04,62944,3866,144,125,2182,11,6328,5.104.880.952
30/11/2021 16:00,162.49,63866,3468,156,106,2160,12,5902,5.104.880.952
30/11/2021 17:00,269.94,63891,3142,170,86,2054,12,5464,5.104.880.952
30/11/2021 18:00,250.02,63015,2692,180,69,1960,13,4914,5.104.880.952
30/11/2021 19:00,205.08,61973,2307,184,60,1943,14,4508,5.104.880.952
30/11/2021 20:00,203.28,60427,1784,187,56,1963,17,4007,5.104.880.952
30/11/2021 21:00,169.91,59372,1283,189,58,2015,18,3563,5.104.880.952
30/11/2021 22:00,143.42,57389,997,188,69,2067,19,3340,5.104.880.952
30/11/2021 23:00,124.06,55189,724,184,86,2082,19,3095,5.104.880.952
01/12/2021 00:00,127.13,53443,337,189,89,2298,24,2937,5.104.880.952
01/12/2021 01:00,109.33,52772,451,182,105,2228,29,2995,5.104.880.952
01/12/2021 02:00,100.24,52299,745,179,118,2115,33,3190,5.104.880.952
01/12/2021 03:00,96.89,52268,1167,175,121,2048,32,3543,5.104.880.952
01/12/2021 04:00,96.9,52924,1709,172,117,1987,27,4012,5.104.880.952
01/12/2021 05:00,105.26,54874,2281,173,121,1936,21,4532,5.104.880.952
01/12/2021 06:00,119.84,59112,2774,176,114,1961,18,5043,5.104.880.952
01/12/2021 07:00,127.68,62433,3186,173,98,2031,15,5503,5.104.880.952
01/12/2021 08:00,133.09,63639,3295,168,78,2108,13,5662,5.104.880.952
01/12/2021 09:00,130.38,63686,3370,164,70,2240,15,5859,5.104.880.952
01/12/2021 10:00,129.41,63882,3599,159,79,2404,19,6260,5.104.880.952
01/12/2021 11:00,121.78,63337,3747,153,85,2557,20,6562,5.104.880.952
01/12/2021 12:00,120.65,63115,3941,151,84,2669,18,6863,5.104.880.952
01/12/2021 13:00,120.53,62880,4176,152,96,2749,12,7185,5.104.880.952
01/12/2021 14:00,121.27,63141,4432,150,105,2882,7,7576,5.104.880.952
01/12/2021 15:00,120.98,63980,4366,152,121,3038,5,7682,5.104.880.952
01/12/2021 16:00,126.46,65078,4299,157,149,3163,5,7773,5.104.880.952
01/12/2021 17:00,127.02,65058,4637,159,173,3240,5,8214,5.104.880.952
01/12/2021 18:00,124.32,64017,4653,163,203,3278,7,8304,5.104.880.952
01/12/2021 19:00,120.19,62617,4633,167,243,3295,7,8345,5.104.880.952
01/12/2021 20:00,120.72,60919,4601,170,281,3314,7,8373,5.104.880.952
01/12/2021 21:00,120.99,59852,4299,171,317,3354,8,8149,5.104.880.952
01/12/2021 22:00,117.91,57737,3834,175,336,3426,9,7780,5.104.880.952
01/12/2021 23:00,108.65,55626,3647,182,327,3486,10,7652,5.104.880.952
02/12/2021 00:00,98.69,53355,5066,202,361,3871,22,9522,5.104.880.952
02/12/2021 01:00,96.93,52731,4951,208,325,3978,25,9487,5.104.880.952
02/12/2021 02:00,96.35,52166,4776,208,318,4077,31,9410,5.104.880.952
02/12/2021 03:00,101.04,51930,4606,200,335,4196,30,9367,5.104.880.952
02/12/2021 04:00,103.85,53088,4467,188,357,4319,31,9362,5.104.880.952
02/12/2021 05:00,106.24,55028,4252,170,377,4346,31,9176,5.104.880.952
02/12/2021 06:00,134.7,59023,3994,150,397,4324,30,8895,5.104.880.952
02/12/2021 07:00,150,62560,3794,129,411,4258,27,8619,5.104.880.952
02/12/2021 08:00,199.94,63436,3519,110,414,4094,24,8161,5.104.880.952
02/12/2021 09:00,190.95,63089,3193,98,412,3917,23,7643,5.104.880.952
02/12/2021 10:00,190.84,63210,3007,86,415,3634,22,7164,5.104.880.952
02/12/2021 11:00,209.08,62617,2773,73,423,3286,24,6579,5.104.880.952
02/12/2021 12:00,208.75,62621,2650,63,442,2995,18,6168,5.104.880.952
02/12/2021 13:00,215.93,62609,2560,53,460,2835,14,5922,5.104.880.952
02/12/2021 14:00,250.04,62536,2465,43,464,2799,11,5782,5.104.880.952
02/12/2021 15:00,299.94,63363,2501,34,461,2802,13,5811,5.104.880.952
02/12/2021 16:00,327.73,64064,2543,30,447,2730,12,5762,5.104.880.952
02/12/2021 17:00,343.91,64193,2516,27,419,2604,9,5575,5.104.880.952
02/12/2021 18:00,286.35,63432,2491,24,395,2522,9,5441,5.104.880.952
02/12/2021 19:00,180.08,62087,2419,23,371,2468,8,5289,5.104.880.952
02/12/2021 20:00,151.91,60941,2395,24,362,2378,8,5167,5.104.880.952
02/12/2021 21:00,149.42,59813,2427,25,388,2329,9,5178,5.104.880.952
02/12/2021 22:00,136.02,57881,2481,28,408,2348,11,5276,5.104.880.952
02/12/2021 23:00,124.95,55515,2647,31,414,2312,22,5426,5.104.880.952
03/12/2021 00:00,135.27,53928,3217,37,389,2276,18,5937,5.104.880.952
03/12/2021 01:00,122.3,53402,3120,40,418,2248,22,5848,5.104.880.952
03/12/2021 02:00,114.67,52884,2914,43,437,2152,22,5568,5.104.880.952
03/12/2021 03:00,110.83,52837,2779,50,441,2042,20,5332,5.104.880.952
03/12/2021 04:00,112.97,53408,2680,59,439,1952,19,5149,5.104.880.952
03/12/2021 05:00,125.94,55431,2515,70,425,1873,27,4910,5.104.880.952
03/12/2021 06:00,146.09,59306,2257,82,399,1781,25,4544,5.104.880.952
03/12/2021 07:00,212.17,63147,2070,96,371,1670,22,4229,5.104.880.952
03/12/2021 08:00,248.96,63976,1884,109,344,1574,22,3933,5.104.880.952
03/12/2021 09:00,237.6,64025,1849,123,311,1505,21,3809,5.104.880.952
03/12/2021 10:00,198.07,63926,1899,125,276,1424,18,3742,5.104.880.952
03/12/2021 11:00,175.17,63679,1955,131,245,1356,17,3704,5.104.880.952
03/12/2021 12:00,145.42,63200,2009,141,227,1327,20,3724,5.104.880.952
03/12/2021 13:00,146.14,62709,2163,153,201,1400,19,3936,5.104.880.952
03/12/2021 14:00,145.43,62708,2439,169,168,1513,18,4307,5.104.880.952
03/12/2021 15:00,144.38,63430,2777,180,140,1651,14,4762,5.104.880.952
03/12/2021 16:00,156.2,63994,3030,187,117,1804,12,5150,5.104.880.952
03/12/2021 17:00,150.66,63853,3353,191,104,1965,9,5622,5.104.880.952
03/12/2021 18:00,138.99,62745,3459,195,106,2143,8,5911,5.104.880.952
03/12/2021 19:00,130.93,61478,3459,199,106,2304,7,6075,5.104.880.952
03/12/2021 20:00,117.39,59617,3384,200,99,2469,7,6159,5.104.880.952
03/12/2021 21:00,118.56,58174,3126,199,91,2644,6,6066,5.104.880.952
03/12/2021 22:00,118.73,56425,2782,196,87,2779,6,5850,5.104.880.952
03/12/2021 23:00,108.18,54483,2563,191,86,2876,5,5721,5.104.880.952
04/12/2021 00:00,118.45,53067,2223,55,108,2951,7,5344,5.104.880.952
04/12/2021 01:00,115.99,52275,1923,63,117,3086,8,5197,5.104.880.952
04/12/2021 02:00,117.11,51490,1668,71,136,3128,10,5013,5.104.880.952
04/12/2021 03:00,119.22,51083,1419,79,167,3136,10,4811,5.104.880.952
04/12/2021 04:00,119.9,51141,1161,92,193,3164,9,4619,5.104.880.952
04/12/2021 05:00,123.67,51780,942,105,192,3195,9,4443,5.104.880.952
04/12/2021 06:00,126.05,52944,788,119,187,3238,10,4342,5.104.880.952
04/12/2021 07:00,124.61,54460,669,129,183,3251,11,4243,5.104.880.952
04/12/2021 08:00,130.09,56023,554,135,173,3226,9,4097,5.104.880.952
04/12/2021 09:00,136.21,57493,544,140,157,3207,9,4057,5.104.880.952
04/12/2021 10:00,139.92,58305,590,145,144,3123,9,4011,5.104.880.952
04/12/2021 11:00,140.1,58497,657,151,134,3036,10,3988,5.104.880.952
04/12/2021 12:00,139.64,58435,759,161,122,3000,10,4052,5.104.880.952
04/12/2021 13:00,135.24,58291,944,175,110,3106,10,4345,5.104.880.952
04/12/2021 14:00,134.88,58603,1166,191,98,3261,9,4725,5.104.880.952
04/12/2021 15:00,135.25,59406,1550,204,87,3390,9,5240,5.104.880.952
04/12/2021 16:00,139.21,60509,1804,213,80,3530,9,5636,5.104.880.952
04/12/2021 17:00,141.35,60851,2248,218,72,3656,9,6203,5.104.880.952
04/12/2021 18:00,139,60136,2555,221,67,3770,9,6622,5.104.880.952
04/12/2021 19:00,136.16,58479,2702,222,59,3842,9,6834,5.104.880.952
04/12/2021 20:00,129.38,56979,2783,220,50,3872,9,6934,5.104.880.952
04/12/2021 21:00,126.08,56021,2833,220,44,3891,10,6998,5.104.880.952
04/12/2021 22:00,123.08,54711,2927,218,44,3906,11,7106,5.104.880.952
04/12/2021 23:00,111.82,52903,3089,209,46,3917,10,7271,5.104.880.952
05/12/2021 00:00,106.68,52456,3742,166,42,3609,12,7571,5.104.880.952
05/12/2021 01:00,103.82,51831,3966,157,44,3590,13,7770,5.104.880.952
05/12/2021 02:00,102.31,51462,4210,147,48,3580,13,7998,5.104.880.952
05/12/2021 03:00,100.7,51035,4455,137,53,3604,13,8262,5.104.880.952
05/12/2021 04:00,103.26,51155,4612,129,64,3616,13,8434,5.104.880.952
05/12/2021 05:00,104.93,51723,4768,122,75,3603,16,8584,5.104.880.952
05/12/2021 06:00,103.81,52668,4877,116,84,3559,17,8653,5.104.880.952
05/12/2021 07:00,104.34,54108,4939,111,96,3465,15,8626,5.104.880.952
05/12/2021 08:00,106.98,55431,4863,104,102,3351,15,8435,5.104.880.952
05/12/2021 09:00,118.77,57065,4704,97,97,3227,14,8139,5.104.880.952
05/12/2021 10:00,129.51,58148,4675,88,91,3074,13,7941,5.104.880.952
05/12/2021 11:00,130.47,58685,4614,75,94,2901,14,7698,5.104.880.952
05/12/2021 12:00,131.54,59001,4555,64,103,2772,14,7508,5.104.880.952
05/12/2021 13:00,131.74,59196,4691,56,118,2690,14,7569,5.104.880.952
05/12/2021 14:00,133.57,59701,4665,52,141,2652,14,7524,5.104.880.952
05/12/2021 15:00,139.97,60920,4590,50,169,2639,15,7463,5.104.880.952
05/12/2021 16:00,156.85,61931,4473,47,190,2628,16,7354,5.104.880.952
05/12/2021 17:00,180.07,62465,4439,45,196,2587,16,7283,5.104.880.952
05/12/2021 18:00,188.56,62271,4263,45,196,2530,15,7049,5.104.880.952
05/12/2021 19:00,170.06,61295,4001,46,193,2449,16,6705,5.104.880.952
05/12/2021 20:00,149.95,60110,3738,48,190,2354,14,6344,5.104.880.952
05/12/2021 21:00,147.46,59083,3398,53,189,2272,13,5925,5.104.880.952
05/12/2021 22:00,135.8,57852,3138,56,189,2186,12,5581,5.104.880.952
05/12/2021 23:00,129.6,56479,2945,58,190,2087,11,5291,5.104.880.952
06/12/2021 00:00,125.98,55225,2906,167,197,2049,12,5331,4.831.904.762
06/12/2021 01:00,122.65,55016,2767,168,200,1964,11,5110,4.831.904.762
06/12/2021 02:00,121.54,54531,2672,167,198,1881,10,4928,4.831.904.762
06/12/2021 03:00,125.9,54545,2573,165,190,1807,10,4745,4.831.904.762
06/12/2021 04:00,132.8,55155,2495,166,180,1729,10,4580,4.831.904.762
06/12/2021 05:00,150.33,56855,2435,165,167,1653,10,4430,4.831.904.762
06/12/2021 06:00,151.2,60536,2420,161,155,1577,10,4323,4.831.904.762
06/12/2021 07:00,305.28,64365,2341,147,138,1500,10,4136,4.831.904.762
06/12/2021 08:00,380.06,65670,2313,131,118,1423,9,3994,4.831.904.762
06/12/2021 09:00,365.77,65888,2219,115,101,1349,8,3792,4.831.904.762
06/12/2021 10:00,330,66009,2212,100,87,1256,8,3663,4.831.904.762
06/12/2021 11:00,266.97,65809,2225,89,77,1156,8,3555,4.831.904.762
06/12/2021 12:00,227.76,65553,2203,77,70,1084,7,3441,4.831.904.762
06/12/2021 13:00,241.34,65663,2272,66,66,1066,7,3477,4.831.904.762
06/12/2021 14:00,259.93,66130,2405,57,66,1120,7,3655,4.831.904.762
06/12/2021 15:00,299.98,67029,2612,49,71,1251,7,3990,4.831.904.762
06/12/2021 16:00,397.97,67554,2794,42,72,1390,7,4305,4.831.904.762
06/12/2021 17:00,372.55,67686,3089,37,70,1488,7,4691,4.831.904.762
06/12/2021 18:00,301.43,66665,3325,34,63,1528,7,4957,4.831.904.762
06/12/2021 19:00,188.09,65316,3455,31,55,1525,7,5073,4.831.904.762
06/12/2021 20:00,150.05,63915,3514,29,49,1517,7,5116,4.831.904.762
06/12/2021 21:00,151.92,62706,3420,27,45,1521,7,5020,4.831.904.762
06/12/2021 22:00,140.34,60796,3416,24,40,1535,7,5022,4.831.904.762
06/12/2021 23:00,127.12,57775,3402,23,37,1553,7,5022,4.831.904.762
07/12/2021 00:00,124.63,56258,3753,46,23,1486,7,5315,4.831.904.762
07/12/2021 01:00,117.49,55776,3724,43,25,1524,7,5323,4.831.904.762
07/12/2021 02:00,113.41,55334,3717,41,30,1538,7,5333,4.831.904.762
07/12/2021 03:00,113.75,55196,3742,37,35,1556,7,5377,4.831.904.762
07/12/2021 04:00,128.74,55971,3771,35,32,1572,7,5417,4.831.904.762
07/12/2021 05:00,131.99,58034,3817,34,26,1599,7,5483,4.831.904.762
07/12/2021 06:00,141.77,62180,3843,32,23,1623,7,5528,4.831.904.762
07/12/2021 07:00,266.02,65686,3855,31,21,1633,6,5546,4.831.904.762
07/12/2021 08:00,399.92,66575,3792,28,18,1594,6,5438,4.831.904.762
07/12/2021 09:00,385.33,66272,3698,24,14,1574,6,5316,4.831.904.762
07/12/2021 10:00,330.12,66246,3723,19,10,1566,6,5324,4.831.904.762
07/12/2021 11:00,289.93,65885,3851,16,7,1564,6,5444,4.831.904.762
07/12/2021 12:00,262.58,65637,3800,14,6,1572,6,5398,4.831.904.762
07/12/2021 13:00,269.99,65455,3735,14,7,1620,6,5382,4.831.904.762
07/12/2021 14:00,299.08,65598,3619,16,9,1712,6,5362,4.831.904.762
07/12/2021 15:00,265.76,66318,3642,17,12,1874,6,5551,4.831.904.762
07/12/2021 16:00,258.83,67043,3721,18,15,2062,6,5822,4.831.904.762
07/12/2021 17:00,270.06,67014,3840,18,18,2237,6,6119,4.831.904.762
07/12/2021 18:00,258.89,66104,3870,19,22,2395,6,6312,4.831.904.762
07/12/2021 19:00,198.48,65125,3831,18,28,2506,12,6395,4.831.904.762
07/12/2021 20:00,155,63676,3834,19,40,2587,12,6492,4.831.904.762
07/12/2021 21:00,148.92,62380,3794,19,51,2681,12,6557,4.831.904.762
07/12/2021 22:00,124.98,60213,3804,18,55,2775,12,6664,4.831.904.762
07/12/2021 23:00,109.96,57942,3897,17,54,2825,12,6805,4.831.904.762
08/12/2021 00:00,112.1,56056,4597,9,73,3036,6,7721,4.831.904.762
08/12/2021 01:00,105.71,55024,4772,8,83,3109,6,7978,4.831.904.762
08/12/2021 02:00,105.57,54385,4940,8,98,3166,6,8218,4.831.904.762
08/12/2021 03:00,104.25,54415,5012,7,110,3209,6,8344,4.831.904.762
08/12/2021 04:00,104.97,55119,4999,7,119,3290,6,8421,4.831.904.762
08/12/2021 05:00,110.28,57029,5012,6,128,3385,6,8537,4.831.904.762
08/12/2021 06:00,115.63,60816,5033,6,139,3460,6,8644,4.831.904.762
08/12/2021 07:00,137.66,64339,5057,5,161,3511,7,8741,4.831.904.762
08/12/2021 08:00,143.68,64884,4825,6,194,3469,10,8504,4.831.904.762
08/12/2021 09:00,143.94,64655,4654,6,205,3471,10,8346,4.831.904.762
08/12/2021 10:00,148.18,64659,4561,8,173,3467,7,8216,4.831.904.762
08/12/2021 11:00,146.54,64340,4520,10,147,3465,9,8151,4.831.904.762
08/12/2021 12:00,149.33,64139,4431,12,157,3483,11,8094,4.831.904.762
08/12/2021 13:00,151.39,64075,4321,13,187,3527,12,8060,4.831.904.762
08/12/2021 14:00,151.79,64368,4137,14,227,3539,12,7929,4.831.904.762
08/12/2021 15:00,155.5,65007,4056,13,260,3593,12,7934,4.831.904.762
08/12/2021 16:00,181.57,65566,3998,14,271,3685,11,7979,4.831.904.762
08/12/2021 17:00,193.43,65372,4018,16,262,3802,11,8109,4.831.904.762
08/12/2021 18:00,154.88,64351,3948,17,253,3884,15,8117,4.831.904.762
08/12/2021 19:00,141.53,63315,3828,18,264,3891,15,8016,4.831.904.762
08/12/2021 20:00,135.72,61773,3771,18,284,3894,21,7988,4.831.904.762
08/12/2021 21:00,132.15,60441,3665,18,299,3948,21,7951,4.831.904.762
08/12/2021 22:00,124.32,58002,3487,17,307,3999,21,7831,4.831.904.762
08/12/2021 23:00,115.15,56116,3292,16,317,4008,27,7660,4.831.904.762
09/12/2021 00:00,110.91,54645,3104,23,310,3928,24,7389,4.831.904.762
09/12/2021 01:00,106.15,53657,3010,21,319,3994,24,7368,4.831.904.762
09/12/2021 02:00,103.61,53282,2946,20,318,4057,26,7367,4.831.904.762
09/12/2021 03:00,104.47,52859,2830,17,311,4143,20,7321,4.831.904.762
09/12/2021 04:00,106.75,53606,2736,14,310,4279,22,7361,4.831.904.762
09/12/2021 05:00,113.14,55730,2684,13,313,4389,21,7420,4.831.904.762
09/12/2021 06:00,127.31,59278,2656,13,315,4450,24,7458,4.831.904.762
09/12/2021 07:00,133.3,62659,2589,12,310,4502,18,7431,4.831.904.762
09/12/2021 08:00,136.89,63237,2459,11,302,4528,16,7316,4.831.904.762
09/12/2021 09:00,136.29,63201,2309,11,286,4604,17,7227,4.831.904.762
09/12/2021 10:00,136.22,63132,2189,11,264,4600,19,7083,4.831.904.762
09/12/2021 11:00,135.03,62763,2127,13,255,4534,25,6954,4.831.904.762
09/12/2021 12:00,132.88,62547,2067,13,241,4526,27,6874,4.831.904.762
09/12/2021 13:00,134.67,62595,2007,14,236,4591,29,6877,4.831.904.762
09/12/2021 14:00,135.43,62910,1882,15,250,4593,26,6766,4.831.904.762
09/12/2021 15:00,136.08,63559,1845,17,276,4626,27,6791,4.831.904.762
09/12/2021 16:00,135.53,63743,1840,20,301,4697,28,6886,4.831.904.762
09/12/2021 17:00,133.12,63675,1907,21,314,4819,27,7088,4.831.904.762
09/12/2021 18:00,130.08,62680,1915,21,321,4885,19,7161,4.831.904.762
09/12/2021 19:00,126.88,61629,1848,23,324,4877,23,7095,4.831.904.762
09/12/2021 20:00,124.43,60327,1705,23,323,4810,24,6885,4.831.904.762
09/12/2021 21:00,123.63,58887,1649,26,326,4698,24,6723,4.831.904.762
09/12/2021 22:00,118.41,56873,1606,29,321,4551,30,6537,4.831.904.762
09/12/2021 23:00,112.09,54521,1613,31,320,4417,24,6405,4.831.904.762
10/12/2021 00:00,115.32,52609,1609,39,332,3873,31,5884,4.831.904.762
10/12/2021 01:00,114.54,51810,1618,40,330,3602,26,5616,4.831.904.762
10/12/2021 02:00,113.8,51426,1653,37,331,3279,27,5327,4.831.904.762
10/12/2021 03:00,114.52,51471,1652,33,335,3029,27,5076,4.831.904.762
10/12/2021 04:00,116.33,52099,1620,33,337,2900,28,4918,4.831.904.762
10/12/2021 05:00,121.97,53874,1577,35,341,2885,30,4868,4.831.904.762
10/12/2021 06:00,129.17,57535,1530,38,349,2892,34,4843,4.831.904.762
10/12/2021 07:00,134.39,61136,1443,38,358,2856,36,4731,4.831.904.762
10/12/2021 08:00,140.9,61911,1280,36,363,2760,36,4475,4.831.904.762
10/12/2021 09:00,141.64,61412,1111,39,366,2680,36,4232,4.831.904.762
10/12/2021 10:00,140.73,61349,943,44,369,2621,33,4010,4.831.904.762
10/12/2021 11:00,137.93,61196,794,47,368,2546,33,3788,4.831.904.762
10/12/2021 12:00,137.81,60855,646,55,360,2507,30,3598,4.831.904.762
10/12/2021 13:00,138.63,60620,568,69,347,2460,30,3474,4.831.904.762
10/12/2021 14:00,139.87,60615,518,81,331,2409,29,3368,4.831.904.762
10/12/2021 15:00,145.48,60881,481,89,314,2417,25,3326,4.831.904.762
10/12/2021 16:00,166.96,61241,434,96,292,2420,24,3266,4.831.904.762
10/12/2021 17:00,177.31,61239,341,106,265,2386,24,3122,4.831.904.762
10/12/2021 18:00,170.39,60135,309,114,239,2345,25,3032,4.831.904.762
10/12/2021 19:00,139.75,58751,291,123,206,2288,27,2935,4.831.904.762
10/12/2021 20:00,137.97,56757,258,126,166,2194,21,2765,4.831.904.762
10/12/2021 21:00,138.31,55546,188,129,128,2081,19,2545,4.831.904.762
10/12/2021 22:00,134.58,54012,158,129,100,1967,14,2368,4.831.904.762
10/12/2021 23:00,131.54,52132,145,125,78,1853,11,2212,4.831.904.762
11/12/2021 00:00,131.73,50114,70,24,63,1482,10,1649,4.831.904.762
11/12/2021 01:00,130.14,49485,93,22,51,1379,10,1555,4.831.904.762
11/12/2021 02:00,129.24,48880,134,20,42,1298,9,1503,4.831.904.762
11/12/2021 03:00,128.82,48939,203,19,35,1207,9,1473,4.831.904.762
11/12/2021 04:00,130.17,49136,258,18,30,1125,8,1439,4.831.904.762
11/12/2021 05:00,130.97,49782,277,16,25,1090,8,1416,4.831.904.762
11/12/2021 06:00,131.04,50703,306,15,22,1063,7,1413,4.831.904.762
11/12/2021 07:00,132.85,51684,361,14,21,1017,7,1420,4.831.904.762
11/12/2021 08:00,135.82,53203,358,14,22,945,7,1346,4.831.904.762
11/12/2021 09:00,147.9,54464,360,15,23,872,7,1277,4.831.904.762
11/12/2021 10:00,181.93,55419,378,18,21,791,6,1214,4.831.904.762
11/12/2021 11:00,189.95,55744,432,20,21,738,6,1217,4.831.904.762
11/12/2021 12:00,184.75,55646,510,23,20,691,5,1249,4.831.904.762
11/12/2021 13:00,149.08,55402,561,29,22,646,6,1264,4.831.904.762
11/12/2021 14:00,179.99,55494,617,37,24,627,6,1311,4.831.904.762
11/12/2021 15:00,189.72,56444,710,45,25,624,6,1410,4.831.904.762
11/12/2021 16:00,211.08,57242,752,49,25,629,6,1461,4.831.904.762
11/12/2021 17:00,220.59,57565,751,52,23,633,7,1466,4.831.904.762
11/12/2021 18:00,200.04,56802,764,53,22,628,7,1474,4.831.904.762
11/12/2021 19:00,163.99,55378,751,56,21,612,8,1448,4.831.904.762
11/12/2021 20:00,140.85,53921,708,57,21,570,8,1364,4.831.904.762
11/12/2021 21:00,137.23,52871,665,59,22,541,8,1295,4.831.904.762
11/12/2021 22:00,134.84,51406,603,60,23,520,8,1214,4.831.904.762
11/12/2021 23:00,126.53,49273,570,61,22,495,8,1156,4.831.904.762
12/12/2021 00:00,125.13,48407,523,56,24,520,8,1131,4.831.904.762
12/12/2021 01:00,113.52,47724,579,65,21,559,9,1233,4.831.904.762
12/12/2021 02:00,109.7,47315,700,68,19,626,9,1422,4.831.904.762
12/12/2021 03:00,104.46,46839,812,62,19,717,9,1619,4.831.904.762
12/12/2021 04:00,101.93,46742,989,58,22,813,8,1890,4.831.904.762
12/12/2021 05:00,99.38,47317,1252,59,23,928,8,2270,4.831.904.762
12/12/2021 06:00,103.21,48193,1519,61,25,1082,9,2696,4.831.904.762
12/12/2021 07:00,107.13,49409,1706,61,30,1285,9,3091,4.831.904.762
12/12/2021 08:00,112.73,50821,1869,57,31,1485,10,3452,4.831.904.762
12/12/2021 09:00,125.04,52259,2013,53,30,1656,10,3762,4.831.904.762
12/12/2021 10:00,130.72,53190,1866,48,26,1766,10,3716,4.831.904.762
12/12/2021 11:00,132.19,53727,1678,46,23,1827,9,3583,4.831.904.762
12/12/2021 12:00,132.64,53940,1568,46,22,1866,9,3511,4.831.904.762
12/12/2021 13:00,132.95,54072,1461,48,25,1890,8,3432,4.831.904.762
12/12/2021 14:00,133.62,54702,1357,54,28,1935,8,3382,4.831.904.762
12/12/2021 15:00,134.92,55548,1279,56,35,1994,8,3372,4.831.904.762
12/12/2021 16:00,139.79,56238,1141,55,42,2039,8,3285,4.831.904.762
12/12/2021 17:00,145.54,56262,981,53,45,2061,9,3149,4.831.904.762
12/12/2021 18:00,142.53,55761,714,50,45,2058,9,2876,4.831.904.762
12/12/2021 19:00,139.59,54935,497,48,44,1994,9,2592,4.831.904.762
12/12/2021 20:00,136.46,53850,335,48,43,1895,9,2330,4.831.904.762
12/12/2021 21:00,134.94,52769,265,49,42,1812,8,2176,4.831.904.762
12/12/2021 22:00,133.52,51458,240,49,44,1715,8,2056,4.831.904.762
12/12/2021 23:00,131.41,49407,262,49,43,1606,8,1968,4.831.904.762
13/12/2021 00:00,126,48234,327,137,33,1683,6,2186,4.730.238.095
13/12/2021 01:00,120.79,47722,356,143,29,1633,6,2167,4.730.238.095
13/12/2021 02:00,117.68,47007,395,144,26,1562,6,2133,4.730.238.095
13/12/2021 03:00,115.49,46816,510,147,24,1515,5,2201,4.730.238.095
13/12/2021 04:00,119.97,47656,733,153,23,1526,5,2440,4.730.238.095
13/12/2021 05:00,130.78,49769,928,147,22,1554,5,2656,4.730.238.095
13/12/2021 06:00,134.6,53741,1053,152,22,1571,5,2803,4.730.238.095
13/12/2021 07:00,147.01,57172,1179,155,24,1585,5,2948,4.730.238.095
13/12/2021 08:00,199.94,58107,1334,158,25,1619,5,3141,4.730.238.095
13/12/2021 09:00,196.08,57859,1474,164,26,1690,5,3359,4.730.238.095
13/12/2021 10:00,146.14,57689,1579,170,25,1790,5,3569,4.730.238.095
13/12/2021 11:00,142.51,57869,1793,170,21,1968,5,3957,4.730.238.095
13/12/2021 12:00,141.7,57557,1918,167,21,2210,5,4321,4.730.238.095
13/12/2021 13:00,139.99,57616,2020,174,23,2484,5,4706,4.730.238.095
13/12/2021 14:00,142.4,57533,2030,174,25,2780,5,5014,4.730.238.095
13/12/2021 15:00,147.75,58120,2119,174,27,3107,7,5434,4.730.238.095
13/12/2021 16:00,160.74,58615,2142,174,30,3420,7,5773,4.730.238.095
13/12/2021 17:00,144.38,58285,2130,170,34,3623,6,5963,4.730.238.095
13/12/2021 18:00,136.37,57358,2088,165,35,3716,6,6010,4.730.238.095
13/12/2021 19:00,131.55,55944,1985,159,39,3702,6,5891,4.730.238.095
13/12/2021 20:00,126.8,54178,1905,162,44,3588,6,5705,4.730.238.095
13/12/2021 21:00,126.12,52633,1774,152,50,3443,7,5426,4.730.238.095
13/12/2021 22:00,119.27,50910,1706,145,56,3258,8,5173,4.730.238.095
13/12/2021 23:00,110.83,48934,1678,136,62,3090,9,4975,4.730.238.095
14/12/2021 00:00,111.17,46950,1815,13,65,2874,13,4780,4.730.238.095
14/12/2021 01:00,106.26,46374,1941,15,72,2812,14,4854,4.730.238.095
14/12/2021 02:00,101.59,46054,1880,19,84,2774,16,4773,4.730.238.095
14/12/2021 03:00,102.64,46053,1846,23,99,2759,18,4745,4.730.238.095
14/12/2021 04:00,109.57,46618,1834,26,119,2774,19,4772,4.730.238.095
14/12/2021 05:00,116.98,48654,1699,28,141,2857,19,4744,4.730.238.095
14/12/2021 06:00,127.32,52623,1611,21,162,2948,22,4764,4.730.238.095
14/12/2021 07:00,137.96,56245,1584,23,179,2986,23,4795,4.730.238.095
14/12/2021 08:00,169.88,56867,1533,25,196,3018,28,4800,4.730.238.095
14/12/2021 09:00,180.08,56771,1499,28,211,3129,26,4893,4.730.238.095
14/12/2021 10:00,156.28,57031,1306,29,220,3212,25,4792,4.730.238.095
14/12/2021 11:00,196.69,56942,1121,29,219,3262,26,4657,4.730.238.095
14/12/2021 12:00,155.25,56780,1032,28,213,3274,22,4569,4.730.238.095
14/12/2021 13:00,152.26,56652,992,29,213,3310,16,4560,4.730.238.095
14/12/2021 14:00,153.34,57039,960,31,213,3342,11,4557,4.730.238.095
14/12/2021 15:00,169.85,57791,1079,36,214,3499,7,4835,4.730.238.095
14/12/2021 16:00,150.77,58241,1230,39,212,3770,6,5257,4.730.238.095
14/12/2021 17:00,141.82,58047,1575,41,206,4148,7,5977,4.730.238.095
14/12/2021 18:00,135.71,57366,1858,43,201,4669,10,6781,4.730.238.095
14/12/2021 19:00,127.35,56486,1967,49,193,5212,11,7432,4.730.238.095
14/12/2021 20:00,117.08,54758,2257,54,178,5744,11,8244,4.730.238.095
14/12/2021 21:00,114.48,53127,2346,59,166,6194,10,8775,4.730.238.095
14/12/2021 22:00,101.47,50807,2500,62,156,6567,8,9293,4.730.238.095
14/12/2021 23:00,64.85,48518,2770,66,147,6863,9,9855,4.730.238.095
15/12/2021 00:00,36.62,46814,3115,97,131,7559,9,10911,4.730.238.095
15/12/2021 01:00,35.03,46234,3160,114,130,7571,10,10985,4.730.238.095
15/12/2021 02:00,32.86,45795,3241,124,134,7546,10,11055,4.730.238.095
15/12/2021 03:00,32.05,45561,3261,128,142,7542,12,11085,4.730.238.095
15/12/2021 04:00,32.33,45851,3337,137,153,7541,12,11180,4.730.238.095
15/12/2021 05:00,36.64,47662,3472,150,163,7543,14,11342,4.730.238.095
15/12/2021 06:00,66.67,51466,3602,151,175,7566,14,11508,4.730.238.095
15/12/2021 07:00,103.75,54751,3635,165,197,7636,19,11652,4.730.238.095
15/12/2021 08:00,113.24,55602,3551,175,236,7639,31,11632,4.730.238.095
15/12/2021 09:00,112.08,55738,3467,188,271,7758,35,11719,4.730.238.095
15/12/2021 10:00,110.43,55855,3361,192,294,7907,35,11789,4.730.238.095
15/12/2021 11:00,110.1,55510,3494,193,310,8041,35,12073,4.730.238.095
15/12/2021 12:00,109.09,55012,3535,186,321,8128,34,12204,4.730.238.095
15/12/2021 13:00,107.88,54980,3511,158,332,8164,31,12196,4.730.238.095
15/12/2021 14:00,109.77,55187,3364,125,342,8141,26,11998,4.730.238.095
15/12/2021 15:00,110.73,55899,3424,100,351,8140,21,12036,4.730.238.095
15/12/2021 16:00,111.82,56501,3461,91,359,8119,24,12054,4.730.238.095
15/12/2021 17:00,110.88,56491,3518,85,362,8086,20,12071,4.730.238.095
15/12/2021 18:00,103.41,55573,3556,81,360,8127,20,12144,4.730.238.095
15/12/2021 19:00,86.64,54029,3350,79,357,8214,22,12022,4.730.238.095
15/12/2021 20:00,65.88,52350,3277,77,355,8325,23,12057,4.730.238.095
15/12/2021 21:00,61.61,51568,3019,78,355,8458,22,11932,4.730.238.095
15/12/2021 22:00,48,49343,2888,70,357,8586,22,11923,4.730.238.095
15/12/2021 23:00,34.8,47337,2752,63,359,8697,22,11893,4.730.238.095
16/12/2021 00:00,31.8,45505,2743,51,380,8831,35,12040,4.730.238.095
16/12/2021 01:00,30.07,45000,2677,52,376,8920,32,12057,4.730.238.095
16/12/2021 02:00,29.64,44659,2609,55,374,8918,28,11984,4.730.238.095
16/12/2021 03:00,30.15,44274,2389,59,374,8861,29,11712,4.730.238.095
16/12/2021 04:00,34.1,45138,2341,64,375,8816,32,11628,4.730.238.095
16/12/2021 05:00,51.72,46758,2284,70,375,8814,40,11583,4.730.238.095
16/12/2021 06:00,95.7,50561,2310,84,373,8854,38,11659,4.730.238.095
16/12/2021 07:00,120.88,54017,2282,102,368,8877,36,11665,4.730.238.095
16/12/2021 08:00,128.48,55149,2156,122,359,8770,35,11442,4.730.238.095
16/12/2021 09:00,128.96,55625,2035,138,345,8722,36,11276,4.730.238.095
16/12/2021 10:00,128.22,55405,1940,148,333,8685,36,11142,4.730.238.095
16/12/2021 11:00,128.11,55276,2083,152,330,8665,35,11265,4.730.238.095
16/12/2021 12:00,126.7,54751,2180,152,327,8631,33,11323,4.730.238.095
16/12/2021 13:00,123,54586,2217,149,320,8631,33,11350,4.730.238.095
16/12/2021 14:00,124.9,54713,2137,150,312,8643,32,11274,4.730.238.095
16/12/2021 15:00,126.76,55514,2216,153,309,8725,32,11435,4.730.238.095
16/12/2021 16:00,128.7,56241,2296,151,304,8773,39,11563,4.730.238.095
16/12/2021 17:00,129.94,56346,2323,142,302,8776,40,11583,4.730.238.095
16/12/2021 18:00,129.17,55688,2367,129,304,8747,42,11589,4.730.238.095
16/12/2021 19:00,126.44,54764,2231,113,303,8710,40,11397,4.730.238.095
16/12/2021 20:00,119.98,53676,2139,98,297,8677,41,11252,4.730.238.095
16/12/2021 21:00,117.39,52433,1981,87,293,8626,40,11027,4.730.238.095
16/12/2021 22:00,109.25,50549,1922,80,289,8548,40,10879,4.730.238.095
16/12/2021 23:00,81.15,48154,1822,75,278,8455,39,10669,4.730.238.095
17/12/2021 00:00,66.29,46273,1775,71,284,8433,41,10604,4.730.238.095
17/12/2021 01:00,49.27,45887,1699,72,275,8270,40,10356,4.730.238.095
17/12/2021 02:00,45.77,45368,1633,83,267,8147,40,10170,4.730.238.095
17/12/2021 03:00,44.92,45280,1561,103,265,8004,40,9973,4.730.238.095
17/12/2021 04:00,66.28,45767,1519,118,260,7808,37,9742,4.730.238.095
17/12/2021 05:00,107,47954,1340,132,256,7517,36,9281,4.730.238.095
17/12/2021 06:00,135.4,51425,1269,137,254,7159,39,8858,4.730.238.095
17/12/2021 07:00,151.31,54936,1227,146,243,6702,37,8355,4.730.238.095
17/12/2021 08:00,157.95,56219,1159,158,234,6026,31,7608,4.730.238.095
17/12/2021 09:00,160.28,56338,1074,164,237,5318,29,6822,4.730.238.095
17/12/2021 10:00,160.38,56483,1005,171,248,4625,28,6077,4.730.238.095
17/12/2021 11:00,162.33,56087,1080,179,263,4023,31,5576,4.730.238.095
17/12/2021 12:00,161.59,55611,1138,184,279,3568,31,5200,4.730.238.095
17/12/2021 13:00,160.36,55240,1210,188,268,3324,27,5017,4.730.238.095
17/12/2021 14:00,161.1,55156,1273,189,235,3280,23,5000,4.730.238.095
17/12/2021 15:00,161.1,55762,1377,189,210,3403,17,5196,4.730.238.095
17/12/2021 16:00,162.43,56129,1436,191,206,3836,15,5684,4.730.238.095
17/12/2021 17:00,160.84,56224,1398,196,210,4397,17,6218,4.730.238.095
17/12/2021 18:00,152.33,55378,1395,200,209,5025,15,6844,4.730.238.095
17/12/2021 19:00,143.97,54000,1399,200,208,5595,12,7414,4.730.238.095
17/12/2021 20:00,128.85,52319,1500,195,200,6168,14,8077,4.730.238.095
17/12/2021 21:00,119.93,50942,1348,189,190,6560,10,8297,4.730.238.095
17/12/2021 22:00,107.13,49241,1262,184,175,6829,11,8461,4.730.238.095
17/12/2021 23:00,83.35,47232,1280,174,162,7023,11,8650,4.730.238.095
18/12/2021 00:00,108.5,45463,1490,130,166,6927,15,8728,4.730.238.095
18/12/2021 01:00,95.93,44667,1582,127,153,6991,14,8867,4.730.238.095
18/12/2021 02:00,86.31,43961,1672,125,135,7022,14,8968,4.730.238.095
18/12/2021 03:00,79.51,43573,1752,122,113,6946,9,8942,4.730.238.095
18/12/2021 04:00,73.92,43390,1978,120,86,6849,7,9040,4.730.238.095
18/12/2021 05:00,68.47,43940,2097,117,84,6790,12,9100,4.730.238.095
18/12/2021 06:00,74.09,45080,2389,116,124,6730,15,9374,4.730.238.095
18/12/2021 07:00,81.18,46542,2680,113,168,6648,17,9626,4.730.238.095
18/12/2021 08:00,96.19,48207,2868,112,201,6549,18,9748,4.730.238.095
18/12/2021 09:00,104.95,49484,3005,111,235,6533,19,9903,4.730.238.095
18/12/2021 10:00,111.49,50439,3038,106,261,6540,21,9966,4.730.238.095
18/12/2021 11:00,107.65,50628,3308,100,266,6564,20,10258,4.730.238.095
18/12/2021 12:00,101.01,50352,3511,97,270,6577,22,10477,4.730.238.095
18/12/2021 13:00,90.01,50130,3597,92,276,6626,20,10611,4.730.238.095
18/12/2021 14:00,91.85,50297,3684,86,275,6704,21,10770,4.730.238.095
18/12/2021 15:00,100.86,51137,3925,80,278,6822,19,11124,4.730.238.095
18/12/2021 16:00,104.93,52236,4065,77,277,6984,18,11421,4.730.238.095
18/12/2021 17:00,106.23,52902,4224,73,270,7243,19,11829,4.730.238.095
18/12/2021 18:00,99.93,52082,4516,70,274,7574,19,12453,4.730.238.095
18/12/2021 19:00,73.02,50906,4555,67,290,7914,21,12847,4.730.238.095
18/12/2021 20:00,40.1,49218,4711,64,302,8198,21,13296,4.730.238.095
18/12/2021 21:00,34.62,48183,4585,59,315,8388,19,13366,4.730.238.095
18/12/2021 22:00,27.57,46903,4585,52,330,8448,20,13435,4.730.238.095
18/12/2021 23:00,24.76,45420,4740,48,336,8481,23,13628,4.730.238.095
19/12/2021 00:00,23.59,44220,4732,31,334,8296,33,13426,4.730.238.095
19/12/2021 01:00,22.77,43390,4861,30,328,8389,36,13644,4.730.238.095
19/12/2021 02:00,20.79,43068,4848,27,325,8464,37,13701,4.730.238.095
19/12/2021 03:00,20.28,42897,4681,23,320,8516,34,13574,4.730.238.095
19/12/2021 04:00,20.59,42801,4762,18,312,8599,31,13722,4.730.238.095
19/12/2021 05:00,22.03,43545,4811,15,305,8719,36,13886,4.730.238.095
19/12/2021 06:00,23.64,44638,4900,13,307,8779,35,14034,4.730.238.095
19/12/2021 07:00,25.05,46035,4982,12,324,8748,36,14102,4.730.238.095
19/12/2021 08:00,28.34,47192,4793,11,338,8718,38,13898,4.730.238.095
19/12/2021 09:00,32.46,48712,4506,10,345,8721,39,13621,4.730.238.095
19/12/2021 10:00,38.53,49987,4029,9,340,8720,36,13134,4.730.238.095
19/12/2021 11:00,39.96,50516,3822,10,346,8751,43,12972,4.730.238.095
19/12/2021 12:00,39.38,50525,3552,11,373,8745,38,12719,4.730.238.095
19/12/2021 13:00,45.6,50630,3237,9,380,8606,42,12274,4.730.238.095
19/12/2021 14:00,57.45,51036,2972,6,372,8359,42,11751,4.730.238.095
19/12/2021 15:00,80.08,52110,2792,6,353,8073,39,11263,4.730.238.095
19/12/2021 16:00,100.76,53048,2663,6,340,7788,39,10836,4.730.238.095
19/12/2021 17:00,124.98,53930,2583,5,335,7556,43,10522,4.730.238.095
19/12/2021 18:00,131.79,53551,2375,5,338,7291,44,10053,4.730.238.095
19/12/2021 19:00,131.66,52907,2079,5,346,7000,44,9474,4.730.238.095
19/12/2021 20:00,130.55,51788,2023,5,349,6676,44,9097,4.730.238.095
19/12/2021 21:00,130.54,51157,1999,6,347,6338,41,8731,4.730.238.095
19/12/2021 22:00,130.56,50097,1997,8,326,6005,38,8374,4.730.238.095
19/12/2021 23:00,125.78,49016,2118,10,289,5714,31,8162,4.730.238.095
20/12/2021 00:00,121.09,47664,2299,169,214,4701,22,7405,4.520.178.571
20/12/2021 01:00,119.93,47124,2244,159,212,4510,25,7150,4.520.178.571
20/12/2021 02:00,118.61,47038,2172,150,209,4255,21,6807,4.520.178.571
20/12/2021 03:00,119.92,47133,2073,147,216,4019,21,6476,4.520.178.571
20/12/2021 04:00,133.39,48218,1993,156,241,3739,23,6152,4.520.178.571
20/12/2021 05:00,150.32,50548,1831,170,263,3493,28,5785,4.520.178.571
20/12/2021 06:00,201.01,54241,1703,177,284,3334,27,5525,4.520.178.571
20/12/2021 07:00,259.93,57778,1593,180,275,3188,19,5255,4.520.178.571
20/12/2021 08:00,302.78,58741,1462,183,253,3033,19,4950,4.520.178.571
20/12/2021 09:00,290,57770,1347,180,231,2931,21,4710,4.520.178.571
20/12/2021 10:00,259.94,58125,1171,174,228,2783,20,4376,4.520.178.571
20/12/2021 11:00,259.21,57997,1010,165,226,2642,19,4062,4.520.178.571
20/12/2021 12:00,258.32,57568,855,155,218,2555,20,3803,4.520.178.571
20/12/2021 13:00,259.91,58633,681,151,204,2534,20,3590,4.520.178.571
20/12/2021 14:00,260.02,58809,572,143,184,2560,18,3477,4.520.178.571
20/12/2021 15:00,290.02,59535,523,133,167,2642,18,3483,4.520.178.571
20/12/2021 16:00,263.11,60356,489,125,165,2642,20,3441,4.520.178.571
20/12/2021 17:00,259.97,60459,448,112,167,2560,22,3309,4.520.178.571
20/12/2021 18:00,255.34,59738,390,94,165,2446,22,3117,4.520.178.571
20/12/2021 19:00,282.01,58777,301,79,164,2317,20,2881,4.520.178.571
20/12/2021 20:00,227.92,57393,253,64,159,2185,12,2673,4.520.178.571
20/12/2021 21:00,246.99,56409,219,47,152,2034,10,2462,4.520.178.571
20/12/2021 22:00,215.63,54829,199,34,129,1840,18,2220,4.520.178.571
20/12/2021 23:00,196.79,52903,174,24,102,1636,15,1951,4.520.178.571
21/12/2021 00:00,203.12,51246,194,212,87,1840,9,2342,4.520.178.571
21/12/2021 01:00,192.1,50967,218,211,76,1687,10,2202,4.520.178.571
21/12/2021 02:00,191.38,50714,252,208,78,1549,12,2099,4.520.178.571
21/12/2021 03:00,191.48,50699,297,200,88,1462,9,2056,4.520.178.571
21/12/2021 04:00,208.23,51272,326,196,92,1415,10,2039,4.520.178.571
21/12/2021 05:00,299.9,53328,358,193,94,1347,8,2000,4.520.178.571
21/12/2021 06:00,251.48,57010,399,188,106,1292,8,1993,4.520.178.571
21/12/2021 07:00,262.03,60248,414,179,118,1228,15,1954,4.520.178.571
21/12/2021 08:00,386.87,61278,413,174,131,1061,9,1788,4.520.178.571
21/12/2021 09:00,420.01,61316,430,174,137,1007,7,1755,4.520.178.571
21/12/2021 10:00,363.07,61383,451,174,110,975,6,1716,4.520.178.571
21/12/2021 11:00,328.41,61461,528,172,82,882,6,1670,4.520.178.571
21/12/2021 12:00,330.01,61331,577,165,72,801,5,1620,4.520.178.571
21/12/2021 13:00,347.98,61198,585,157,61,730,5,1538,4.520.178.571
21/12/2021 14:00,313.52,61144,541,154,57,686,5,1443,4.520.178.571
21/12/2021 15:00,409.62,62265,542,157,58,665,5,1427,4.520.178.571
21/12/2021 16:00,420.03,62493,531,162,47,695,8,1443,4.520.178.571
21/12/2021 17:00,417.76,62238,530,169,42,735,7,1483,4.520.178.571
21/12/2021 18:00,398.96,61579,540,175,39,764,7,1525,4.520.178.571
21/12/2021 19:00,324.96,60475,545,171,36,776,6,1534,4.520.178.571
21/12/2021 20:00,337.88,58902,538,164,34,834,7,1577,4.520.178.571
21/12/2021 21:00,283.97,57962,493,150,31,870,7,1551,4.520.178.571
21/12/2021 22:00,301.83,55989,479,137,29,929,6,1580,4.520.178.571
21/12/2021 23:00,250.01,53045,482,123,28,985,6,1624,4.520.178.571
22/12/2021 00:00,205.26,51589,534,117,46,1064,6,1767,4.520.178.571
22/12/2021 01:00,200.03,51086,587,107,40,1159,6,1899,4.520.178.571
22/12/2021 02:00,199.01,50689,651,99,32,1268,6,2056,4.520.178.571
22/12/2021 03:00,199.99,50501,718,95,27,1366,6,2212,4.520.178.571
22/12/2021 04:00,208.42,51102,765,92,25,1482,6,2370,4.520.178.571
22/12/2021 05:00,251.32,52894,804,91,24,1572,6,2497,4.520.178.571
22/12/2021 06:00,251.13,56452,842,88,25,1700,6,2661,4.520.178.571
22/12/2021 07:00,277.01,59640,855,80,26,1845,6,2812,4.520.178.571
22/12/2021 08:00,400.07,60537,864,69,24,1962,6,2925,4.520.178.571
22/12/2021 09:00,380.91,60408,867,63,23,2215,6,3174,4.520.178.571
22/12/2021 10:00,299.92,60723,835,58,22,2481,6,3402,4.520.178.571
22/12/2021 11:00,264.97,60638,889,53,17,2619,6,3584,4.520.178.571
22/12/2021 12:00,257.34,60660,905,49,14,2783,6,3757,4.520.178.571
22/12/2021 13:00,259.77,60550,845,46,14,2917,6,3828,4.520.178.571
22/12/2021 14:00,259.93,60929,746,45,17,2881,5,3694,4.520.178.571
22/12/2021 15:00,260.03,61313,662,46,22,2929,5,3664,4.520.178.571
22/12/2021 16:00,268.37,61711,588,50,27,3068,6,3739,4.520.178.571
22/12/2021 17:00,260.02,61541,585,52,31,3160,6,3834,4.520.178.571
22/12/2021 18:00,242.45,60624,636,52,34,3355,6,4083,4.520.178.571
22/12/2021 19:00,219.91,59710,729,54,35,3573,7,4398,4.520.178.571
22/12/2021 20:00,200.18,58310,816,55,37,3836,7,4751,4.520.178.571
22/12/2021 21:00,197.24,57087,887,55,44,4163,7,5156,4.520.178.571
22/12/2021 22:00,191.3,55010,880,54,59,4453,7,5453,4.520.178.571
22/12/2021 23:00,160.42,53170,959,53,71,4673,8,5764,4.520.178.571
23/12/2021 00:00,196.26,52080,1246,68,88,4814,7,6223,4.520.178.571
23/12/2021 01:00,174,51331,1244,66,89,4952,8,6359,4.520.178.571
23/12/2021 02:00,167.06,50488,1166,63,98,5016,8,6351,4.520.178.571
23/12/2021 03:00,165.98,50049,1096,59,112,5111,10,6388,4.520.178.571
23/12/2021 04:00,167.29,50258,1081,53,127,5211,9,6481,4.520.178.571
23/12/2021 05:00,175.17,51466,1044,48,143,5280,10,6525,4.520.178.571
23/12/2021 06:00,203.3,54058,1089,45,166,5306,10,6616,4.520.178.571
23/12/2021 07:00,214.33,56809,1168,37,194,5255,12,6666,4.520.178.571
23/12/2021 08:00,220.01,58188,1210,30,220,5214,12,6686,4.520.178.571
23/12/2021 09:00,220.19,58236,1209,28,237,5165,11,6650,4.520.178.571
23/12/2021 10:00,220.06,58635,1116,26,246,4935,10,6333,4.520.178.571
23/12/2021 11:00,218.66,58581,1039,27,262,4697,9,6034,4.520.178.571
23/12/2021 12:00,219.88,58351,950,26,269,4483,9,5737,4.520.178.571
23/12/2021 13:00,218.98,58464,781,24,275,4311,16,5407,4.520.178.571
23/12/2021 14:00,221.26,58778,590,21,281,4158,20,5070,4.520.178.571
23/12/2021 15:00,224.55,59648,478,18,279,4100,19,4894,4.520.178.571
23/12/2021 16:00,228.45,59788,427,15,280,4074,20,4816,4.520.178.571
23/12/2021 17:00,227.8,59804,384,14,278,4039,25,4740,4.520.178.571
23/12/2021 18:00,220.03,59011,342,12,276,3990,26,4646,4.520.178.571
23/12/2021 19:00,205.48,57903,308,10,270,3943,23,4554,4.520.178.571
23/12/2021 20:00,167.69,56500,282,10,256,3984,28,4560,4.520.178.571
23/12/2021 21:00,153.18,55343,254,13,235,4104,29,4635,4.520.178.571
23/12/2021 22:00,132.28,53673,248,22,212,4307,27,4816,4.520.178.571
23/12/2021 23:00,85.31,51328,244,37,194,4539,24,5038,4.520.178.571
24/12/2021 00:00,97.32,49654,384,81,170,6064,17,6716,4.520.178.571
24/12/2021 01:00,73.91,48985,440,107,146,6417,14,7124,4.520.178.571
24/12/2021 02:00,56.16,48378,505,131,130,6693,11,7470,4.520.178.571
24/12/2021 03:00,57.62,48192,647,154,118,6923,8,7850,4.520.178.571
24/12/2021 04:00,65.5,48501,980,170,112,7085,8,8355,4.520.178.571
24/12/2021 05:00,76.04,49231,1562,186,106,7192,7,9053,4.520.178.571
24/12/2021 06:00,54.69,51202,2213,197,109,7233,9,9761,4.520.178.571
24/12/2021 07:00,100.09,53484,2654,205,117,7245,15,10236,4.520.178.571
24/12/2021 08:00,139.68,55028,3006,210,127,7156,20,10519,4.520.178.571
24/12/2021 09:00,154.64,56220,3180,211,137,7075,19,10622,4.520.178.571
24/12/2021 10:00,160.18,57593,3166,215,144,6948,18,10491,4.520.178.571
24/12/2021 11:00,163.74,57972,3308,217,156,6837,15,10533,4.520.178.571
24/12/2021 12:00,163.69,57909,3244,213,173,6677,11,10318,4.520.178.571
24/12/2021 13:00,161.06,57434,2966,207,169,6607,8,9957,4.520.178.571
24/12/2021 14:00,163.67,57783,2723,201,165,6570,6,9665,4.520.178.571
24/12/2021 15:00,169.97,58163,2517,195,162,6609,7,9490,4.520.178.571
24/12/2021 16:00,189.83,58969,2316,188,135,6584,18,9241,4.520.178.571
24/12/2021 17:00,179.99,58914,2069,183,100,6477,17,8846,4.520.178.571
24/12/2021 18:00,167.23,56737,1735,170,92,6360,17,8374,4.520.178.571
24/12/2021 19:00,163.97,55222,1393,152,88,6236,31,7900,4.520.178.571
24/12/2021 20:00,161.15,54157,1130,143,80,6128,35,7516,4.520.178.571
24/12/2021 21:00,163.78,53822,993,134,88,6022,35,7272,4.520.178.571
24/12/2021 22:00,161.48,53126,961,127,119,5967,35,7209,4.520.178.571
24/12/2021 23:00,164.26,51727,958,118,156,5923,35,7190,4.520.178.571
25/12/2021 00:00,153.96,50104,1481,21,169,6216,18,7905,4.520.178.571
25/12/2021 01:00,136.87,50415,1565,34,190,6225,23,8037,4.520.178.571
25/12/2021 02:00,128.87,49334,1643,45,221,6254,26,8189,4.520.178.571
25/12/2021 03:00,99.94,48543,1639,52,246,6283,40,8260,4.520.178.571
25/12/2021 04:00,68.96,48613,1662,72,257,6311,38,8340,4.520.178.571
25/12/2021 05:00,66.83,49134,1529,100,253,6337,38,8257,4.520.178.571
25/12/2021 06:00,67.64,49945,1514,122,245,6405,37,8323,4.520.178.571
25/12/2021 07:00,95.93,50927,1489,142,242,6471,31,8375,4.520.178.571
25/12/2021 08:00,123.22,52114,1412,158,243,6545,40,8398,4.520.178.571
25/12/2021 09:00,146.27,53310,1326,165,249,6639,40,8419,4.520.178.571
25/12/2021 10:00,158.67,54334,1179,168,267,6669,37,8320,4.520.178.571
25/12/2021 11:00,172.24,54587,1067,168,275,6740,37,8287,4.520.178.571
25/12/2021 12:00,160.11,54549,995,165,268,6808,35,8271,4.520.178.571
25/12/2021 13:00,158.8,54464,946,159,257,6897,34,8293,4.520.178.571
25/12/2021 14:00,160.48,54759,929,155,245,6867,36,8232,4.520.178.571
25/12/2021 15:00,169.97,55573,981,150,254,6848,41,8274,4.520.178.571
25/12/2021 16:00,180.26,56403,977,146,282,6740,44,8189,4.520.178.571
25/12/2021 17:00,188.99,56756,966,144,314,6582,45,8051,4.520.178.571
25/12/2021 18:00,189.81,56221,1014,151,334,6387,44,7930,4.520.178.571
25/12/2021 19:00,176.94,55356,1060,161,347,6182,44,7794,4.520.178.571
25/12/2021 20:00,164.32,54337,1048,171,350,5955,42,7566,4.520.178.571
25/12/2021 21:00,170.06,53722,981,182,351,5695,42,7251,4.520.178.571
25/12/2021 22:00,158.41,52604,916,193,353,5430,41,6933,4.520.178.571
25/12/2021 23:00,145.09,51044,895,203,358,5160,42,6658,4.520.178.571
26/12/2021 00:00,137.55,51224,1005,218,383,4572,40,6218,4.520.178.571
26/12/2021 01:00,126.64,50731,975,216,390,4337,40,5958,4.520.178.571
26/12/2021 02:00,121.6,50027,916,218,400,4091,42,5667,4.520.178.571
26/12/2021 03:00,110.61,50210,842,222,409,3863,42,5378,4.520.178.571
26/12/2021 04:00,103.29,50346,745,221,404,3627,44,5041,4.520.178.571
26/12/2021 05:00,115.69,51239,614,223,385,3407,42,4671,4.520.178.571
26/12/2021 06:00,119.94,52102,472,224,354,3180,40,4270,4.520.178.571
26/12/2021 07:00,141.54,53449,360,225,299,2952,33,3869,4.520.178.571
26/12/2021 08:00,152.74,54847,309,226,243,2755,24,3557,4.520.178.571
26/12/2021 09:00,159.56,55917,272,225,197,2625,16,3335,4.520.178.571
26/12/2021 10:00,176.98,56911,256,223,145,2464,12,3100,4.520.178.571
26/12/2021 11:00,184.04,56877,266,222,111,2284,9,2892,4.520.178.571
26/12/2021 12:00,181.41,56414,265,218,89,2122,9,2703,4.520.178.571
26/12/2021 13:00,176.99,55963,279,212,79,2025,12,2607,4.520.178.571
26/12/2021 14:00,177.67,56276,307,207,71,1961,18,2564,4.520.178.571
26/12/2021 15:00,179.92,57318,368,196,68,1953,20,2605,4.520.178.571
26/12/2021 16:00,183.02,58371,490,184,69,1964,19,2726,4.520.178.571
26/12/2021 17:00,205.23,58634,651,175,65,1983,16,2890,4.520.178.571
26/12/2021 18:00,204.78,58293,854,175,59,1985,15,3088,4.520.178.571
26/12/2021 19:00,192.15,57506,1062,182,58,2015,15,3332,4.520.178.571
26/12/2021 20:00,181.45,56504,1287,187,61,2060,12,3607,4.520.178.571
26/12/2021 21:00,161.92,55754,1485,193,71,2113,10,3872,4.520.178.571
26/12/2021 22:00,158.36,54849,1716,193,86,2136,10,4141,4.520.178.571
26/12/2021 23:00,144.97,53575,1946,194,94,2076,10,4320,4.520.178.571
27/12/2021 00:00,147.39,53244,2354,134,95,2228,11,4822,5.149.672.619
27/12/2021 01:00,138.08,52591,2541,122,100,2096,12,4871,5.149.672.619
27/12/2021 02:00,136.99,52192,2795,121,103,1908,13,4940,5.149.672.619
27/12/2021 03:00,126.67,52024,2905,105,107,1760,14,4891,5.149.672.619
27/12/2021 04:00,129.91,52444,3184,86,113,1638,14,5035,5.149.672.619
27/12/2021 05:00,126.62,54203,3483,71,116,1535,17,5222,5.149.672.619
27/12/2021 06:00,150.39,56862,3813,57,117,1479,20,5486,5.149.672.619
27/12/2021 07:00,160.05,59459,3968,52,114,1452,18,5604,5.149.672.619
27/12/2021 08:00,168.42,60506,4019,48,110,1499,18,5694,5.149.672.619
27/12/2021 09:00,196.91,61215,3993,47,105,1617,15,5777,5.149.672.619
27/12/2021 10:00,200.47,62075,3837,49,91,1753,13,5743,5.149.672.619
27/12/2021 11:00,200.16,62139,3836,50,73,1897,11,5867,5.149.672.619
27/12/2021 12:00,204.31,62084,3836,53,59,2007,10,5965,5.149.672.619
27/12/2021 13:00,197.55,61786,3776,53,50,2116,9,6004,5.149.672.619
27/12/2021 14:00,185.58,61794,3787,57,47,2294,9,6194,5.149.672.619
27/12/2021 15:00,182.44,62517,3897,60,51,2553,9,6570,5.149.672.619
27/12/2021 16:00,177.97,63262,3940,63,58,2799,9,6869,5.149.672.619
27/12/2021 17:00,199.97,63134,3971,67,67,3026,10,7141,5.149.672.619
27/12/2021 18:00,199.92,62468,4004,69,78,3235,10,7396,5.149.672.619
27/12/2021 19:00,181.42,61143,3857,70,92,3479,11,7509,5.149.672.619
27/12/2021 20:00,157.39,59657,3692,74,105,3694,12,7577,5.149.672.619
27/12/2021 21:00,136.37,58570,3507,80,121,3891,15,7614,5.149.672.619
27/12/2021 22:00,119.96,56930,3291,87,141,4070,12,7601,5.149.672.619
27/12/2021 23:00,88.45,55098,3159,85,163,4203,10,7620,5.149.672.619
28/12/2021 00:00,100.28,53093,3182,49,132,4883,8,8254,5.149.672.619
28/12/2021 01:00,96.71,52557,3139,44,152,4881,9,8225,5.149.672.619
28/12/2021 02:00,80.09,52051,3216,39,176,4821,9,8261,5.149.672.619
28/12/2021 03:00,62.74,51683,3181,35,199,4766,9,8190,5.149.672.619
28/12/2021 04:00,64.91,50770,3150,29,224,4778,9,8190,5.149.672.619
28/12/2021 05:00,79.49,53192,3121,25,251,4904,11,8312,5.149.672.619
28/12/2021 06:00,101.54,55747,3130,22,273,4999,12,8436,5.149.672.619
28/12/2021 07:00,119.22,56638,3215,18,291,5002,14,8540,5.149.672.619
28/12/2021 08:00,129.04,57536,3248,14,304,4946,18,8530,5.149.672.619
28/12/2021 09:00,137.03,57864,3190,10,310,4844,17,8371,5.149.672.619
28/12/2021 10:00,141.09,58473,3025,8,313,4672,17,8035,5.149.672.619
28/12/2021 11:00,142.48,58809,2882,8,320,4485,17,7712,5.149.672.619
28/12/2021 12:00,139.98,58735,2770,7,333,4266,19,7395,5.149.672.619
28/12/2021 13:00,135.5,58772,2657,8,360,3941,22,6988,5.149.672.619
28/12/2021 14:00,143.98,58873,2621,9,384,3580,26,6620,5.149.672.619
28/12/2021 15:00,146.57,60651,2620,11,401,3318,26,6376,5.149.672.619
28/12/2021 16:00,147.36,60935,2617,12,411,3019,27,6086,5.149.672.619
28/12/2021 17:00,152.01,60664,2527,13,412,2737,28,5717,5.149.672.619
28/12/2021 18:00,152.44,60101,2435,14,410,2483,30,5372,5.149.672.619
28/12/2021 19:00,152.3,58774,2196,18,410,2233,30,4887,5.149.672.619
28/12/2021 20:00,140.53,57217,1895,23,408,1986,29,4341,5.149.672.619
28/12/2021 21:00,139.9,56063,1542,29,406,1732,28,3737,5.149.672.619
28/12/2021 22:00,134.52,54250,1294,33,404,1495,25,3251,5.149.672.619
28/12/2021 23:00,124.38,52219,1119,34,401,1290,26,2870,5.149.672.619
29/12/2021 00:00,125.43,50664,444,20,378,1020,23,1885,5.149.672.619
29/12/2021 01:00,126.89,49954,360,22,363,874,19,1638,5.149.672.619
29/12/2021 02:00,126.18,49461,305,25,347,754,16,1447,5.149.672.619
29/12/2021 03:00,124.97,49265,258,32,332,672,15,1309,5.149.672.619
29/12/2021 04:00,125.81,49813,218,43,316,596,13,1186,5.149.672.619
29/12/2021 05:00,128.77,51288,154,48,305,543,11,1061,5.149.672.619
29/12/2021 06:00,141.86,53812,111,54,296,493,11,965,5.149.672.619
29/12/2021 07:00,173.22,56585,91,68,285,455,11,910,5.149.672.619
29/12/2021 08:00,185.78,57572,89,85,271,421,10,876,5.149.672.619
29/12/2021 09:00,194.97,57939,105,97,251,378,11,842,5.149.672.619
29/12/2021 10:00,195.03,58614,120,104,231,355,10,820,5.149.672.619
29/12/2021 11:00,194.97,58971,133,109,208,330,10,790,5.149.672.619
29/12/2021 12:00,195.19,58897,157,113,189,304,9,772,5.149.672.619
29/12/2021 13:00,195.68,58511,187,116,176,280,8,767,5.149.672.619
29/12/2021 14:00,196.76,58949,303,127,168,270,8,876,5.149.672.619
29/12/2021 15:00,194.11,59576,467,141,164,292,7,1071,5.149.672.619
29/12/2021 16:00,189.98,60390,639,158,160,354,7,1318,5.149.672.619
29/12/2021 17:00,192.96,60242,862,171,156,430,6,1625,5.149.672.619
29/12/2021 18:00,180.21,59107,1109,182,156,518,6,1971,5.149.672.619
29/12/2021 19:00,161.46,57812,1310,190,157,634,7,2298,5.149.672.619
29/12/2021 20:00,140.66,56472,1528,196,153,780,8,2665,5.149.672.619
29/12/2021 21:00,130.14,55333,1767,202,149,966,8,3092,5.149.672.619
29/12/2021 22:00,121.68,53723,2016,205,144,1207,8,3580,5.149.672.619
29/12/2021 23:00,104.31,51580,2354,206,137,1492,8,4197,5.149.672.619
30/12/2021 00:00,90.18,49867,2731,209,88,2805,6,5839,5.149.672.619
30/12/2021 01:00,62.55,49212,2786,210,73,3176,6,6251,5.149.672.619
30/12/2021 02:00,47.02,48863,2942,210,63,3472,6,6693,5.149.672.619
30/12/2021 03:00,33.2,48662,2985,204,55,3741,6,6991,5.149.672.619
30/12/2021 04:00,34.94,48601,3074,198,52,4018,6,7348,5.149.672.619
30/12/2021 05:00,55,49599,3075,193,49,4366,6,7689,5.149.672.619
30/12/2021 06:00,69.8,51630,3129,192,49,4697,7,8074,5.149.672.619
30/12/2021 07:00,91.56,53850,3177,190,53,4888,7,8315,5.149.672.619
30/12/2021 08:00,103.74,54896,3123,185,55,5030,8,8401,5.149.672.619
30/12/2021 09:00,110.37,55626,3057,178,57,5108,9,8409,5.149.672.619
30/12/2021 10:00,120,56553,2997,172,59,4994,9,8231,5.149.672.619
30/12/2021 11:00,123.42,56998,3025,162,62,4768,9,8026,5.149.672.619
30/12/2021 12:00,125.83,56587,2841,151,72,4473,10,7547,5.149.672.619
30/12/2021 13:00,122.22,56609,2846,138,88,4124,11,7207,5.149.672.619
30/12/2021 14:00,119.99,56544,2864,125,102,3924,11,7026,5.149.672.619
30/12/2021 15:00,120,56694,3212,115,120,3953,12,7412,5.149.672.619
30/12/2021 16:00,119.9,57178,3300,104,140,4063,15,7622,5.149.672.619
30/12/2021 17:00,128.87,57213,3596,97,161,4179,17,8050,5.149.672.619
30/12/2021 18:00,123.55,56096,3970,92,183,4325,18,8588,5.149.672.619
30/12/2021 19:00,114.98,55113,4080,90,205,4471,19,8865,5.149.672.619
30/12/2021 20:00,93.69,53647,3999,90,219,4611,17,8936,5.149.672.619
30/12/2021 21:00,89.97,52222,3808,91,234,4764,18,8915,5.149.672.619
30/12/2021 22:00,76.96,50585,3488,91,246,4827,15,8667,5.149.672.619
30/12/2021 23:00,68.02,48466,3315,87,245,4844,14,8505,5.149.672.619
31/12/2021 00:00,49.66,46024,2861,59,250,5361,20,8551,5.149.672.619
31/12/2021 01:00,35.78,45241,2624,58,248,5297,19,8246,5.149.672.619
31/12/2021 02:00,32.57,44561,2525,56,253,5126,21,7981,5.149.672.619
31/12/2021 03:00,31.54,43914,2448,54,256,4944,18,7720,5.149.672.619
31/12/2021 04:00,32.4,44349,2649,52,267,4761,22,7751,5.149.672.619
31/12/2021 05:00,32,45493,2843,53,289,4591,17,7793,5.149.672.619
31/12/2021 06:00,34.9,47247,3121,57,305,4493,19,7995,5.149.672.619
31/12/2021 07:00,47.32,48963,3401,61,307,4417,19,8205,5.149.672.619
31/12/2021 08:00,52.66,50314,3495,66,304,4294,19,8178,5.149.672.619
31/12/2021 09:00,64.59,51282,3465,72,295,4096,18,7946,5.149.672.619
31/12/2021 10:00,70.3,52201,3416,84,280,3857,19,7656,5.149.672.619
31/12/2021 11:00,80.55,52607,3547,96,266,3666,16,7591,5.149.672.619
31/12/2021 12:00,88.13,52684,3483,104,252,3480,13,7332,5.149.672.619
31/12/2021 13:00,88.87,52719,3374,112,233,3385,14,7118,5.149.672.619
31/12/2021 14:00,93.7,53060,3371,126,209,3333,13,7052,5.149.672.619
31/12/2021 15:00,100.3,53836,3471,135,192,3374,15,7187,5.149.672.619
31/12/2021 16:00,114.96,54530,3475,146,186,3454,13,7274,5.149.672.619
31/12/2021 17:00,117.53,54516,3502,163,185,3552,11,7413,5.149.672.619
31/12/2021 18:00,96.74,53366,3553,178,175,3694,8,7608,5.149.672.619
31/12/2021 19:00,74.84,51485,3549,186,170,3904,6,7815,5.149.672.619
31/12/2021 20:00,54.88,49761,3414,187,166,4183,7,7957,5.149.672.619
31/12/2021 21:00,53.81,49049,3236,188,164,4459,7,8054,5.149.672.619
31/12/2021 22:00,50.87,48119,3063,180,160,4784,6,8193,5.149.672.619
31/12/2021 23:00,46.58,45732,2831,165,159,5080,9,8244,5.149.672.619
